公投案編號,縣市,行政區,村里,投開票所,投票權人數,同意票數,不同意票數,有效票數,無效票數,投票人數
公投第１２案,連江縣,,,,11205,3599,1925,5524,240,5764
公投第１２案,金門縣,,,,122695,26932,14773,41705,2222,43927
公投第１２案,宜蘭縣,,,,386089,119746,83726,203472,12663,216135
公投第１２案,新竹縣,,,,445051,150580,92309,242889,10969,253858
公投第１２案,苗栗縣,,,,461580,153026,95793,248819,14539,263358
公投第１２案,彰化縣,,,,1066994,356924,224371,581295,35062,616357
公投第１２案,南投縣,,,,427089,143356,91565,234921,14026,248947
公投第１２案,雲林縣,,,,584480,170393,114101,284494,20533,305027
公投第１２案,嘉義縣,,,,442775,132636,81825,214461,13955,228416
公投第１２案,屏東縣,,,,711720,216753,136224,352977,23852,376829
公投第１２案,臺東縣,,,,185996,57826,34122,91948,5646,97594
公投第１２案,花蓮縣,,,,278059,86680,53334,140014,8000,148014
公投第１２案,澎湖縣,,,,90405,24658,14157,38815,2388,41203
公投第１２案,基隆市,,,,320030,96333,62976,159309,7189,166498
公投第１２案,新竹市,,,,351775,116724,75092,191816,8539,200355
公投第１２案,嘉義市,,,,221553,73821,44563,118384,4721,123105
公投第１２案,臺北市,,,,2228430,732239,506433,1238672,55460,1294132
公投第１２案,高雄市,,,,2353342,857170,491490,1348660,58799,1407459
公投第１２案,新北市,,,,3375513,1070300,712548,1782848,92282,1875130
公投第１２案,臺中市,,,,2295642,777273,490959,1268232,68562,1336794
公投第１２案,臺南市,,,,1594821,494543,297390,791933,40579,832512
公投第１２案,桃園市,,,,1801823,540236,352795,893031,40531,933562
公投第１２案,連江縣,北竿鄉,,,2125,713,347,1060,51,1111
公投第１２案,連江縣,莒光鄉,,,1481,467,289,756,36,792
公投第１２案,連江縣,東引鄉,,,1138,325,225,550,28,578
公投第１２案,連江縣,南竿鄉,,,6461,2094,1064,3158,125,3283
公投第１２案,金門縣,烏坵鄉,,,567,113,46,159,6,165
公投第１２案,金門縣,烈嶼鄉,,,11676,2711,1293,4004,251,4255
公投第１２案,金門縣,金寧鄉,,,28162,5802,3895,9697,496,10193
公投第１２案,金門縣,金城鎮,,,37815,8177,4455,12632,612,13244
公投第１２案,金門縣,金湖鎮,,,25915,5863,3118,8981,515,9496
公投第１２案,金門縣,金沙鎮,,,18560,4266,1966,6232,342,6574
公投第１２案,宜蘭縣,蘇澳鎮,,,34512,10125,7865,17990,1472,19462
公投第１２案,宜蘭縣,宜蘭市,,,79167,25673,17297,42970,2111,45081
公投第１２案,宜蘭縣,羅東鎮,,,57686,18673,12875,31548,1743,33291
公投第１２案,宜蘭縣,員山鄉,,,28131,8311,5917,14228,1048,15276
公投第１２案,宜蘭縣,壯圍鄉,,,21447,6976,4687,11663,891,12554
公投第１２案,宜蘭縣,冬山鄉,,,45405,13199,9936,23135,1316,24451
公投第１２案,宜蘭縣,礁溪鄉,,,31084,9089,6782,15871,1029,16900
公投第１２案,宜蘭縣,頭城鎮,,,25135,7489,5317,12806,1006,13812
公投第１２案,宜蘭縣,南澳鄉,,,4644,1900,879,2779,128,2907
公投第１２案,宜蘭縣,五結鄉,,,34892,10228,7412,17640,1126,18766
公投第１２案,宜蘭縣,大同鄉,,,4935,2548,867,3415,145,3560
公投第１２案,宜蘭縣,三星鄉,,,19051,5535,3892,9427,648,10075
公投第１２案,新竹縣,尖石鄉,,,7364,2848,1278,4126,169,4295
公投第１２案,新竹縣,竹東鎮,,,78794,25690,15323,41013,1817,42830
公投第１２案,新竹縣,湖口鄉,,,63511,21141,13123,34264,1569,35833
公投第１２案,新竹縣,關西鎮,,,24712,8351,4999,13350,783,14133
公投第１２案,新竹縣,新埔鎮,,,28894,9575,5965,15540,831,16371
公投第１２案,新竹縣,竹北市,,,137129,47451,29863,77314,2796,80110
公投第１２案,新竹縣,峨眉鄉,,,5068,1841,1018,2859,215,3074
公投第１２案,新竹縣,新豐鄉,,,45790,15412,9190,24602,1075,25677
公投第１２案,新竹縣,五峰鄉,,,3997,1357,756,2113,90,2203
公投第１２案,新竹縣,北埔鄉,,,8180,2705,1710,4415,247,4662
公投第１２案,新竹縣,寶山鄉,,,12973,4360,2952,7312,373,7685
公投第１２案,新竹縣,芎林鄉,,,17293,6128,3570,9698,545,10243
公投第１２案,新竹縣,橫山鄉,,,11346,3721,2562,6283,459,6742
公投第１２案,苗栗縣,通霄鎮,,,29709,9439,5897,15336,979,16315
公投第１２案,苗栗縣,頭屋鄉,,,9390,3572,2202,5774,346,6120
公投第１２案,苗栗縣,後龍鎮,,,30948,9377,6583,15960,1180,17140
公投第１２案,苗栗縣,苗栗市,,,74249,25845,15204,41049,1875,42924
公投第１２案,苗栗縣,泰安鄉,,,5180,2032,1249,3281,180,3461
公投第１２案,苗栗縣,三灣鄉,,,5852,1914,1269,3183,227,3410
公投第１２案,苗栗縣,獅潭鄉,,,3968,1166,700,1866,177,2043
公投第１２案,苗栗縣,南庄鄉,,,8784,2369,1691,4060,283,4343
公投第１２案,苗栗縣,銅鑼鄉,,,15424,4785,3303,8088,556,8644
公投第１２案,苗栗縣,造橋鄉,,,11027,3616,2359,5975,448,6423
公投第１２案,苗栗縣,西湖鄉,,,6382,1975,1337,3312,223,3535
公投第１２案,苗栗縣,三義鄉,,,13889,4765,2951,7716,437,8153
公投第１２案,苗栗縣,公館鄉,,,28318,9209,6429,15638,1092,16730
公投第１２案,苗栗縣,頭份市,,,83617,28607,16747,45354,2239,47593
公投第１２案,苗栗縣,大湖鄉,,,12653,3818,2459,6277,492,6769
公投第１２案,苗栗縣,苑裡鎮,,,38890,12787,8254,21041,1412,22453
公投第１２案,苗栗縣,卓蘭鎮,,,14772,4969,3120,8089,602,8691
公投第１２案,苗栗縣,竹南鎮,,,68528,22781,14039,36820,1791,38611
公投第１２案,彰化縣,員林市,,,102028,33660,21760,55420,2842,58262
公投第１２案,彰化縣,埤頭鄉,,,25677,7832,5029,12861,1146,14007
公投第１２案,彰化縣,溪州鄉,,,25405,7390,4986,12376,905,13281
公投第１２案,彰化縣,大城鄉,,,14713,3240,2026,5266,488,5754
公投第１２案,彰化縣,永靖鄉,,,31239,10584,7076,17660,1094,18754
公投第１２案,彰化縣,芬園鄉,,,20408,6526,4148,10674,743,11417
公投第１２案,彰化縣,埔心鄉,,,29642,10317,6885,17202,1169,18371
公投第１２案,彰化縣,埔鹽鄉,,,28026,9874,6020,15894,1024,16918
公投第１２案,彰化縣,二水鄉,,,13339,4983,2611,7594,547,8141
公投第１２案,彰化縣,大村鄉,,,31492,10702,6852,17554,1069,18623
公投第１２案,彰化縣,花壇鄉,,,38924,14186,7908,22094,1169,23263
公投第１２案,彰化縣,線西鄉,,,14065,4751,3117,7868,566,8434
公投第１２案,彰化縣,芳苑鄉,,,29291,8085,5166,13251,1238,14489
公投第１２案,彰化縣,竹塘鄉,,,12821,3755,2717,6472,558,7030
公投第１２案,彰化縣,二林鎮,,,42976,13211,8115,21326,1492,22818
公投第１２案,彰化縣,福興鄉,,,39745,12923,7536,20459,1253,21712
公投第１２案,彰化縣,社頭鄉,,,36306,11701,8292,19993,1153,21146
公投第１２案,彰化縣,田尾鄉,,,23179,7969,4930,12899,879,13778
公投第１２案,彰化縣,田中鎮,,,35391,12217,7289,19506,1162,20668
公投第１２案,彰化縣,彰化市,,,190995,68788,41730,110518,5319,115837
公投第１２案,彰化縣,伸港鄉,,,30407,9720,6433,16153,1105,17258
公投第１２案,彰化縣,溪湖鎮,,,45147,15354,9656,25010,1558,26568
公投第１２案,彰化縣,秀水鄉,,,32394,11216,7005,18221,1120,19341
公投第１２案,彰化縣,和美鎮,,,75286,24610,16291,40901,2138,43039
公投第１２案,彰化縣,鹿港鎮,,,70505,23865,15045,38910,2357,41267
公投第１２案,彰化縣,北斗鎮,,,27593,9465,5748,15213,968,16181
公投第１２案,南投縣,南投市,,,84328,30688,18233,48921,2370,51291
公投第１２案,南投縣,中寮鄉,,,13181,4197,2902,7099,559,7658
公投第１２案,南投縣,仁愛鄉,,,12589,4375,2503,6878,397,7275
公投第１２案,南投縣,水里鄉,,,15458,4880,3232,8112,557,8669
公投第１２案,南投縣,國姓鄉,,,16597,5242,3437,8679,657,9336
公投第１２案,南投縣,信義鄉,,,13299,5655,2337,7992,504,8496
公投第１２案,南投縣,魚池鄉,,,13958,4019,3031,7050,600,7650
公投第１２案,南投縣,鹿谷鄉,,,15941,4657,3348,8005,616,8621
公投第１２案,南投縣,名間鄉,,,33408,11518,7257,18775,1354,20129
公投第１２案,南投縣,竹山鎮,,,47034,14445,10060,24505,1530,26035
公投第１２案,南投縣,集集鎮,,,9611,2990,2213,5203,387,5590
公投第１２案,南投縣,草屯鎮,,,82922,27781,18359,46140,2277,48417
公投第１２案,南投縣,埔里鎮,,,68763,22909,14653,37562,2218,39780
公投第１２案,雲林縣,口湖鄉,,,24193,6409,4123,10532,1122,11654
公投第１２案,雲林縣,水林鄉,,,22508,5377,3703,9080,863,9943
公投第１２案,雲林縣,林內鄉,,,15551,4885,3241,8126,715,8841
公投第１２案,雲林縣,古坑鄉,,,27477,8316,5364,13680,1001,14681
公投第１２案,雲林縣,斗南鎮,,,38138,12689,8180,20869,1151,22020
公投第１２案,雲林縣,虎尾鎮,,,58167,17512,12095,29607,1658,31265
公投第１２案,雲林縣,斗六市,,,89761,29976,19543,49519,2309,51828
公投第１２案,雲林縣,元長鄉,,,22830,5559,3683,9242,736,9978
公投第１２案,雲林縣,土庫鎮,,,24412,7060,4803,11863,1003,12866
公投第１２案,雲林縣,崙背鄉,,,21050,5759,3820,9579,797,10376
公投第１２案,雲林縣,四湖鄉,,,20983,4509,3123,7632,766,8398
公投第１２案,雲林縣,麥寮鄉,,,37119,10179,6888,17067,1232,18299
公投第１２案,雲林縣,東勢鄉,,,13239,3613,2464,6077,553,6630
公投第１２案,雲林縣,大埤鄉,,,16509,4704,3339,8043,570,8613
公投第１２案,雲林縣,莿桐鄉,,,24570,7420,5098,12518,1094,13612
公投第１２案,雲林縣,北港鎮,,,33958,10470,6854,17324,1331,18655
公投第１２案,雲林縣,臺西鄉,,,21125,5471,3451,8922,809,9731
公投第１２案,雲林縣,褒忠鄉,,,11381,3162,2292,5454,428,5882
公投第１２案,雲林縣,西螺鎮,,,38142,11288,7807,19095,1400,20495
公投第１２案,雲林縣,二崙鄉,,,23367,6035,4230,10265,995,11260
公投第１２案,嘉義縣,布袋鎮,,,23965,6938,4035,10973,850,11823
公投第１２案,嘉義縣,太保市,,,31568,9940,6382,16322,830,17152
公投第１２案,嘉義縣,溪口鄉,,,13105,4086,2363,6449,445,6894
公投第１２案,嘉義縣,六腳鄉,,,20821,5217,3177,8394,643,9037
公投第１２案,嘉義縣,番路鄉,,,10156,3278,2041,5319,383,5702
公投第１２案,嘉義縣,大埔鄉,,,3999,1280,822,2102,98,2200
公投第１２案,嘉義縣,新港鄉,,,27342,8563,5310,13873,1096,14969
公投第１２案,嘉義縣,水上鄉,,,43857,13744,8519,22263,1312,23575
公投第１２案,嘉義縣,阿里山鄉,,,4691,1277,835,2112,90,2202
公投第１２案,嘉義縣,東石鄉,,,21915,5453,2984,8437,768,9205
公投第１２案,嘉義縣,大林鎮,,,26922,8075,5293,13368,815,14183
公投第１２案,嘉義縣,朴子市,,,35191,10800,6642,17442,1017,18459
公投第１２案,嘉義縣,梅山鄉,,,17083,5569,3298,8867,660,9527
公投第１２案,嘉義縣,義竹鄉,,,16647,4946,2911,7857,681,8538
公投第１２案,嘉義縣,鹿草鄉,,,13937,3713,2360,6073,556,6629
公投第１２案,嘉義縣,竹崎鄉,,,31228,9650,5888,15538,926,16464
公投第１２案,嘉義縣,中埔鄉,,,39139,10814,6970,17784,991,18775
公投第１２案,嘉義縣,民雄鄉,,,61209,19293,11995,31288,1794,33082
公投第１２案,屏東縣,獅子鄉,,,4230,1814,748,2562,97,2659
公投第１２案,屏東縣,瑪家鄉,,,5663,2430,1185,3615,159,3774
公投第１２案,屏東縣,牡丹鄉,,,4314,1042,744,1786,66,1852
公投第１２案,屏東縣,鹽埔鄉,,,22402,6444,4323,10767,873,11640
公投第１２案,屏東縣,屏東市,,,170148,53638,33114,86752,4173,90925
公投第１２案,屏東縣,竹田鄉,,,15353,5021,3157,8178,678,8856
公投第１２案,屏東縣,萬巒鄉,,,17945,5074,3640,8714,665,9379
公投第１２案,屏東縣,南州鄉,,,9479,2779,1937,4716,408,5124
公投第１２案,屏東縣,新園鄉,,,30706,9147,5827,14974,1277,16251
公投第１２案,屏東縣,林邊鄉,,,15691,5149,3009,8158,667,8825
公投第１２案,屏東縣,崁頂鄉,,,12270,3662,2334,5996,489,6485
公投第１２案,屏東縣,佳冬鄉,,,17063,4877,2953,7830,739,8569
公投第１２案,屏東縣,內埔鄉,,,47558,13292,8506,21798,1402,23200
公投第１２案,屏東縣,春日鄉,,,3923,1095,605,1700,48,1748
公投第１２案,屏東縣,枋山鄉,,,4856,1441,899,2340,185,2525
公投第１２案,屏東縣,來義鄉,,,6257,2423,1131,3554,192,3746
公投第１２案,屏東縣,里港鄉,,,22128,6740,4569,11309,985,12294
公投第１２案,屏東縣,恆春鎮,,,25661,6419,4918,11337,776,12113
公投第１２案,屏東縣,潮州鎮,,,46444,14538,8696,23234,1257,24491
公投第１２案,屏東縣,長治鄉,,,26256,8236,5259,13495,958,14453
公投第１２案,屏東縣,萬丹鄉,,,43478,13536,8355,21891,1574,23465
公投第１２案,屏東縣,九如鄉,,,19132,5776,3695,9471,895,10366
公投第１２案,屏東縣,琉球鄉,,,10706,2812,1611,4423,331,4754
公投第１２案,屏東縣,三地門鄉,,,6373,2519,1274,3793,197,3990
公投第１２案,屏東縣,麟洛鄉,,,9970,3544,2001,5545,321,5866
公投第１２案,屏東縣,東港鎮,,,39495,11765,7877,19642,1502,21144
公投第１２案,屏東縣,枋寮鄉,,,21394,6469,4070,10539,982,11521
公投第１２案,屏東縣,霧臺鄉,,,2950,1573,609,2182,80,2262
公投第１２案,屏東縣,車城鄉,,,7595,1698,1269,2967,242,3209
公投第１２案,屏東縣,滿州鄉,,,7206,1674,1268,2942,114,3056
公投第１２案,屏東縣,泰武鄉,,,4344,1763,992,2755,140,2895
公投第１２案,屏東縣,新埤鄉,,,9033,2559,1660,4219,377,4596
公投第１２案,屏東縣,高樹鄉,,,21697,5804,3989,9793,1003,10796
公投第１２案,臺東縣,臺東市,,,87803,28924,16982,45906,2266,48172
公投第１２案,臺東縣,長濱鄉,,,6484,1623,931,2554,262,2816
公投第１２案,臺東縣,卑南鄉,,,14976,4552,2778,7330,596,7926
公投第１２案,臺東縣,關山鎮,,,7509,2116,1392,3508,240,3748
公投第１２案,臺東縣,綠島鄉,,,3579,945,585,1530,62,1592
公投第１２案,臺東縣,延平鄉,,,2930,1062,548,1610,97,1707
公投第１２案,臺東縣,蘭嶼鄉,,,4181,854,741,1595,80,1675
公投第１２案,臺東縣,大武鄉,,,5266,1903,682,2585,198,2783
公投第１２案,臺東縣,東河鄉,,,7635,1990,1176,3166,248,3414
公投第１２案,臺東縣,鹿野鄉,,,6936,1689,1217,2906,232,3138
公投第１２案,臺東縣,池上鄉,,,7162,1704,1294,2998,306,3304
公投第１２案,臺東縣,太麻里鄉,,,9666,3374,1678,5052,299,5351
公投第１２案,臺東縣,海端鄉,,,3278,1002,680,1682,89,1771
公投第１２案,臺東縣,金峰鄉,,,3028,1285,627,1912,89,2001
公投第１２案,臺東縣,達仁鄉,,,3137,1207,566,1773,102,1875
公投第１２案,臺東縣,成功鎮,,,12426,3596,2245,5841,480,6321
公投第１２案,花蓮縣,光復鄉,,,11417,3542,2088,5630,434,6064
公投第１２案,花蓮縣,花蓮市,,,84807,27589,16285,43874,1893,45767
公投第１２案,花蓮縣,吉安鄉,,,72116,22580,14036,36616,1685,38301
公投第１２案,花蓮縣,鳳林鎮,,,9676,3083,1883,4966,414,5380
公投第１２案,花蓮縣,瑞穗鄉,,,10279,2976,1826,4802,425,5227
公投第１２案,花蓮縣,玉里鎮,,,20650,5927,3385,9312,821,10133
公投第１２案,花蓮縣,豐濱鄉,,,4395,1271,774,2045,132,2177
公投第１２案,花蓮縣,萬榮鄉,,,5269,1857,1096,2953,176,3129
公投第１２案,花蓮縣,秀林鄉,,,12562,3727,2490,6217,348,6565
公投第１２案,花蓮縣,新城鄉,,,17029,5272,3498,8770,504,9274
公投第１２案,花蓮縣,壽豐鄉,,,15847,4999,3250,8249,625,8874
公投第１２案,花蓮縣,富里鄉,,,9065,2126,1656,3782,391,4173
公投第１２案,花蓮縣,卓溪鄉,,,4947,1731,1067,2798,152,2950
公投第１２案,澎湖縣,西嶼鄉,,,7382,1439,866,2305,260,2565
公投第１２案,澎湖縣,馬公市,,,53655,15859,9152,25011,1337,26348
公投第１２案,澎湖縣,湖西鄉,,,12741,3346,1956,5302,346,5648
公投第１２案,澎湖縣,白沙鄉,,,8625,2284,1171,3455,241,3696
公投第１２案,澎湖縣,七美鄉,,,3374,553,396,949,83,1032
公投第１２案,澎湖縣,望安鄉,,,4628,1177,616,1793,121,1914
公投第１２案,基隆市,中正區,,,45545,12322,8255,20577,1109,21686
公投第１２案,基隆市,中山區,,,41856,12443,8188,20631,959,21590
公投第１２案,基隆市,安樂區,,,70396,21005,14155,35160,1473,36633
公投第１２案,基隆市,暖暖區,,,33225,10325,6694,17019,640,17659
公投第１２案,基隆市,仁愛區,,,36738,11401,7385,18786,1047,19833
公投第１２案,基隆市,信義區,,,46014,14305,9162,23467,869,24336
公投第１２案,基隆市,七堵區,,,46256,14532,9137,23669,1092,24761
公投第１２案,新竹市,香山區,,,64896,21414,13573,34987,1784,36771
公投第１２案,新竹市,北區,,,123122,40483,25931,66414,3115,69529
公投第１２案,新竹市,東區,,,163757,54827,35588,90415,3640,94055
公投第１２案,嘉義市,西區,,,120906,40415,24335,64750,2648,67398
公投第１２案,嘉義市,東區,,,100647,33406,20228,53634,2073,55707
公投第１２案,臺北市,中正區,,,128292,42868,29334,72202,3032,75234
公投第１２案,臺北市,北投區,,,213250,68267,47236,115503,5336,120839
公投第１２案,臺北市,中山區,,,195148,62130,44981,107111,4939,112050
公投第１２案,臺北市,萬華區,,,164020,50898,36257,87155,4721,91876
公投第１２案,臺北市,信義區,,,190444,62853,43324,106177,4836,111013
公投第１２案,臺北市,松山區,,,169278,57656,38733,96389,4247,100636
公投第１２案,臺北市,南港區,,,101907,33203,23931,57134,2300,59434
公投第１２案,臺北市,大同區,,,107557,34138,25407,59545,3208,62753
公投第１２案,臺北市,文山區,,,227211,78865,51554,130419,5657,136076
公投第１２案,臺北市,大安區,,,252645,83730,56964,140694,5604,146298
公投第１２案,臺北市,士林區,,,241854,78172,54400,132572,6590,139162
公投第１２案,臺北市,內湖區,,,236824,79459,54312,133771,4990,138761
公投第１２案,高雄市,阿蓮區,,,24534,7823,5018,12841,656,13497
公投第１２案,高雄市,鳳山區,,,300510,112232,62692,174924,6965,181889
公投第１２案,高雄市,湖內區,,,25729,8678,5207,13885,732,14617
公投第１２案,高雄市,路竹區,,,43850,15241,9468,24709,1503,26212
公投第１２案,高雄市,美濃區,,,35311,11579,6583,18162,1388,19550
公投第１２案,高雄市,桃源區,,,3498,1448,715,2163,62,2225
公投第１２案,高雄市,那瑪夏區,,,2424,1091,506,1597,82,1679
公投第１２案,高雄市,茂林區,,,1615,701,376,1077,46,1123
公投第１２案,高雄市,甲仙區,,,5417,1563,957,2520,207,2727
公投第１２案,高雄市,左營區,,,161367,62982,33114,96096,3192,99288
公投第１２案,高雄市,鼓山區,,,114979,42789,24371,67160,2404,69564
公投第１２案,高雄市,杉林區,,,10607,2899,1789,4688,364,5052
公投第１２案,高雄市,三民區,,,289519,105825,62821,168646,6010,174656
公投第１２案,高雄市,苓雅區,,,146786,56526,31867,88393,3280,91673
公投第１２案,高雄市,旗津區,,,24860,8235,4564,12799,698,13497
公投第１２案,高雄市,前鎮區,,,161797,58902,33299,92201,4172,96373
公投第１２案,高雄市,前金區,,,23928,8879,5187,14066,568,14634
公投第１２案,高雄市,小港區,,,132733,47424,28577,76001,3188,79189
公投第１２案,高雄市,新興區,,,44355,16846,9906,26752,1008,27760
公投第１２案,高雄市,六龜區,,,11501,3037,1953,4990,511,5501
公投第１２案,高雄市,大樹區,,,36772,12360,7416,19776,1194,20970
公投第１２案,高雄市,岡山區,,,81244,31396,17088,48484,2081,50565
公投第１２案,高雄市,鳥松區,,,39191,14437,8605,23042,1027,24069
公投第１２案,高雄市,仁武區,,,73611,26855,15402,42257,1566,43823
公投第１２案,高雄市,大社區,,,30046,10157,6617,16774,811,17585
公投第１２案,高雄市,田寮區,,,6671,1881,1163,3044,265,3309
公投第１２案,高雄市,橋頭區,,,32565,12605,6914,19519,1173,20692
公投第１２案,高雄市,永安區,,,12001,4384,2848,7232,408,7640
公投第１２案,高雄市,內門區,,,13002,3884,2209,6093,452,6545
公投第１２案,高雄市,大寮區,,,97309,34853,19237,54090,2508,56598
公投第１２案,高雄市,茄萣區,,,26212,8596,4999,13595,832,14427
公投第１２案,高雄市,楠梓區,,,153132,55883,31845,87728,3809,91537
公投第１２案,高雄市,旗山區,,,31996,10513,6610,17123,1209,18332
公投第１２案,高雄市,林園區,,,59129,19699,12191,31890,1675,33565
公投第１２案,高雄市,彌陀區,,,16487,6341,3444,9785,556,10341
公投第１２案,高雄市,鹽埕區,,,21617,8007,4481,12488,430,12918
公投第１２案,高雄市,燕巢區,,,26012,8895,5268,14163,924,15087
公投第１２案,高雄市,梓官區,,,31025,11724,6183,17907,843,18750
公投第１２案,新北市,深坑區,,,20624,6399,4483,10882,607,11489
公投第１２案,新北市,金山區,,,18978,5228,3653,8881,753,9634
公投第１２案,新北市,平溪區,,,4321,1218,703,1921,197,2118
公投第１２案,新北市,烏來區,,,5264,1773,1018,2791,98,2889
公投第１２案,新北市,萬里區,,,19297,5433,3538,8971,694,9665
公投第１２案,新北市,八里區,,,32970,9599,6978,16577,952,17529
公投第１２案,新北市,三芝區,,,20119,5384,3787,9171,653,9824
公投第１２案,新北市,石門區,,,10528,2955,2092,5047,420,5467
公投第１２案,新北市,林口區,,,86203,27446,18805,46251,2146,48397
公投第１２案,新北市,五股區,,,72443,22210,14665,36875,2067,38942
公投第１２案,新北市,坪林區,,,5891,1714,1089,2803,230,3033
公投第１２案,新北市,石碇區,,,6861,1895,1359,3254,273,3527
公投第１２案,新北市,鶯歌區,,,71645,21315,14996,36311,1824,38135
公投第１２案,新北市,樹林區,,,152102,47189,32946,80135,4367,84502
公投第１２案,新北市,汐止區,,,173831,52092,35719,87811,4490,92301
公投第１２案,新北市,土城區,,,200783,62655,42571,105226,5597,110823
公投第１２案,新北市,三峽區,,,94291,28622,18860,47482,2425,49907
公投第１２案,新北市,淡水區,,,147272,44720,29981,74701,3366,78067
公投第１２案,新北市,三重區,,,329846,101972,72085,174057,10832,184889
公投第１２案,新北市,新店區,,,264053,88798,54809,143607,6412,150019
公投第１２案,新北市,中和區,,,355978,117533,72733,190266,8702,198968
公投第１２案,新北市,新莊區,,,344981,111089,76839,187928,9684,197612
公投第１２案,新北市,永和區,,,187798,65391,41209,106600,4783,111383
公投第１２案,新北市,板橋區,,,463411,153500,98590,252090,12520,264610
公投第１２案,新北市,泰山區,,,64252,20423,13613,34036,1602,35638
公投第１２案,新北市,貢寮區,,,11279,2649,1939,4588,452,5040
公投第１２案,新北市,蘆洲區,,,167457,49602,35657,85259,4595,89854
公投第１２案,新北市,雙溪區,,,7999,2122,1476,3598,311,3909
公投第１２案,新北市,瑞芳區,,,35036,9374,6355,15729,1230,16959
公投第１２案,臺中市,西區,,,95040,32508,20953,53461,2515,55976
公投第１２案,臺中市,烏日區,,,61705,20786,13436,34222,2079,36301
公投第１２案,臺中市,大里區,,,171769,56856,35523,92379,4759,97138
公投第１２案,臺中市,北區,,,124621,41580,26168,67748,3069,70817
公投第１２案,臺中市,霧峰區,,,55225,19150,12175,31325,2203,33528
公投第１２案,臺中市,豐原區,,,136658,47705,30372,78077,4368,82445
公投第１２案,臺中市,龍井區,,,63584,20803,13219,34022,2017,36039
公投第１２案,臺中市,大雅區,,,77189,25855,16532,42387,2133,44520
公投第１２案,臺中市,后里區,,,44962,14278,10266,24544,1693,26237
公投第１２案,臺中市,中區,,,14696,4828,3021,7849,483,8332
公投第１２案,臺中市,西屯區,,,183814,62843,39525,102368,4617,106985
公投第１２案,臺中市,北屯區,,,227720,77474,47717,125191,5818,131009
公投第１２案,臺中市,東區,,,64291,22105,14057,36162,1954,38116
公投第１２案,臺中市,神岡區,,,54565,18494,12285,30779,1839,32618
公投第１２案,臺中市,潭子區,,,89487,30585,18753,49338,2484,51822
公投第１２案,臺中市,大甲區,,,63069,21418,13192,34610,2050,36660
公投第１２案,臺中市,大肚區,,,47457,15756,10368,26124,1642,27766
公投第１２案,臺中市,大安區,,,16520,5373,3626,8999,770,9769
公投第１２案,臺中市,外埔區,,,27059,9162,5824,14986,939,15925
公投第１２案,臺中市,東勢區,,,43181,15459,8291,23750,1700,25450
公投第１２案,臺中市,沙鹿區,,,74207,24395,15729,40124,2327,42451
公投第１２案,臺中市,南屯區,,,135448,48668,29856,78524,3659,82183
公投第１２案,臺中市,太平區,,,157926,50405,31955,82360,4450,86810
公投第１２案,臺中市,和平區,,,9498,3507,2116,5623,334,5957
公投第１２案,臺中市,石岡區,,,12880,4303,2820,7123,535,7658
公投第１２案,臺中市,清水區,,,71528,23845,15541,39386,2684,42070
公投第１２案,臺中市,南區,,,103643,37710,23028,60738,3118,63856
公投第１２案,臺中市,梧棲區,,,47040,14659,10642,25301,1655,26956
公投第１２案,臺中市,新社區,,,20860,6763,3969,10732,668,11400
公投第１２案,臺南市,西港區,,,21564,5967,3791,9758,590,10348
公投第１２案,臺南市,後壁區,,,20841,5708,3399,9107,809,9916
公投第１２案,臺南市,大內區,,,8654,2472,1449,3921,353,4274
公投第１２案,臺南市,永康區,,,195001,61149,37817,98966,3575,102541
公投第１２案,臺南市,山上區,,,6511,1677,1053,2730,217,2947
公投第１２案,臺南市,七股區,,,19950,6034,3102,9136,529,9665
公投第１２案,臺南市,鹽水區,,,22121,6222,3916,10138,690,10828
公投第１２案,臺南市,左鎮區,,,4418,1294,651,1945,128,2073
公投第１２案,臺南市,安南區,,,159654,49901,30383,80284,4050,84334
公投第１２案,臺南市,龍崎區,,,3713,1106,639,1745,116,1861
公投第１２案,臺南市,學甲區,,,22567,6362,3995,10357,565,10922
公投第１２案,臺南市,白河區,,,24894,6314,4007,10321,787,11108
公投第１２案,臺南市,麻豆區,,,37963,10865,7111,17976,1072,19048
公投第１２案,臺南市,柳營區,,,18804,5488,3282,8770,728,9498
公投第１２案,臺南市,下營區,,,20947,5843,3463,9306,801,10107
公投第１２案,臺南市,東山區,,,18471,4205,2542,6747,551,7298
公投第１２案,臺南市,新營區,,,64949,19145,12148,31293,1479,32772
公投第１２案,臺南市,東區,,,153359,51215,30051,81266,3271,84537
公投第１２案,臺南市,歸仁區,,,57387,18463,11144,29607,1391,30998
公投第１２案,臺南市,南區,,,108650,34717,19769,54486,2355,56841
公投第１２案,臺南市,南化區,,,7786,2076,1360,3436,311,3747
公投第１２案,臺南市,安定區,,,26104,8558,4965,13523,769,14292
公投第１２案,臺南市,楠西區,,,8528,2258,1348,3606,313,3919
公投第１２案,臺南市,玉井區,,,12357,3583,2062,5645,516,6161
公投第１２案,臺南市,善化區,,,39950,12284,7483,19767,1089,20856
公投第１２案,臺南市,新市區,,,30386,9683,6045,15728,761,16489
公投第１２案,臺南市,將軍區,,,17754,5090,2608,7698,715,8413
公投第１２案,臺南市,北門區,,,9925,2592,1437,4029,229,4258
公投第１２案,臺南市,佳里區,,,50407,15891,9346,25237,1497,26734
公投第１２案,臺南市,新化區,,,37296,11884,7090,18974,1304,20278
公投第１２案,臺南市,中西區,,,65261,21715,13138,34853,1683,36536
公投第１２案,臺南市,北區,,,110906,36584,21480,58064,2423,60487
公投第１２案,臺南市,六甲區,,,19144,4985,3615,8600,810,9410
公投第１２案,臺南市,官田區,,,18675,5317,3399,8716,619,9335
公投第１２案,臺南市,安平區,,,55379,17056,10422,27478,906,28384
公投第１２案,臺南市,關廟區,,,29913,9556,5839,15395,908,16303
公投第１２案,臺南市,仁德區,,,64632,21284,12041,33325,1669,34994
公投第１２案,桃園市,新屋區,,,41461,12741,9152,21893,1322,23215
公投第１２案,桃園市,平鎮區,,,183560,57526,36277,93803,4065,97868
公投第１２案,桃園市,大溪區,,,78285,23559,15578,39137,2367,41504
公投第１２案,桃園市,中壢區,,,334402,104348,65472,169820,7067,176887
公投第１２案,桃園市,大園區,,,73900,20740,14918,35658,1561,37219
公投第１２案,桃園市,八德區,,,165065,47532,31746,79278,4186,83464
公投第１２案,桃園市,龜山區,,,131702,36552,25742,62294,2890,65184
公投第１２案,桃園市,蘆竹區,,,129252,38396,25321,63717,2654,66371
公投第１２案,桃園市,觀音區,,,55149,15302,11210,26512,1509,28021
公投第１２案,桃園市,桃園區,,,359790,104081,71688,175769,7425,183194
公投第１２案,桃園市,龍潭區,,,101574,33953,18573,52526,2211,54737
公投第１２案,桃園市,楊梅區,,,137917,41994,25313,67307,2989,70296
公投第１２案,桃園市,復興區,,,9766,3512,1805,5317,285,5602
公投第１２案,連江縣,南竿鄉,介壽村,1,1967,626,345,971,43,1014
公投第１２案,連江縣,南竿鄉,福沃村、復興村,2,1837,543,298,841,43,884
公投第１２案,連江縣,南竿鄉,清水村、珠螺村,3,1114,369,200,569,16,585
公投第１２案,連江縣,南竿鄉,馬祖村、津沙村、四維村、仁愛村,4,1543,556,221,777,23,800
公投第１２案,連江縣,北竿鄉,后沃村、橋仔村、塘岐村,5,1515,514,263,777,37,814
公投第１２案,連江縣,北竿鄉,坂里村、白沙村、芹壁村,6,610,199,84,283,14,297
公投第１２案,連江縣,莒光鄉,田沃村、西坵村、青帆村,7,698,203,133,336,15,351
公投第１２案,連江縣,莒光鄉,大坪村、福正村,8,783,264,156,420,21,441
公投第１２案,連江縣,東引鄉,樂華村、中柳村,9,1138,325,225,550,28,578
公投第１２案,金門縣,金城鎮,東門里,1,1396,311,169,480,24,504
公投第１２案,金門縣,金城鎮,東門里,2,1831,434,239,673,21,694
公投第１２案,金門縣,金城鎮,東門里,3,1750,396,213,609,32,641
公投第１２案,金門縣,金城鎮,南門里,4,1889,434,228,662,56,718
公投第１２案,金門縣,金城鎮,南門里,5,1675,289,228,517,19,536
公投第１２案,金門縣,金城鎮,南門里,6,1901,506,242,748,33,781
公投第１２案,金門縣,金城鎮,西門里,7,1610,288,224,512,46,558
公投第１２案,金門縣,金城鎮,西門里,8,1687,385,190,575,29,604
公投第１２案,金門縣,金城鎮,西門里,9,1594,393,178,571,10,581
公投第１２案,金門縣,金城鎮,西門里,10,1726,379,209,588,24,612
公投第１２案,金門縣,金城鎮,西門里,11,1733,414,190,604,27,631
公投第１２案,金門縣,金城鎮,西門里,12,1532,392,217,609,19,628
公投第１２案,金門縣,金城鎮,北門里,13,2079,444,244,688,30,718
公投第１２案,金門縣,金城鎮,北門里,14,2033,414,218,632,23,655
公投第１２案,金門縣,金城鎮,賢庵里,15,2517,542,310,852,30,882
公投第１２案,金門縣,金城鎮,賢庵里,16,2083,455,235,690,37,727
公投第１２案,金門縣,金城鎮,金水里,17,2140,465,234,699,35,734
公投第１２案,金門縣,金城鎮,古城里,18,2435,422,257,679,37,716
公投第１２案,金門縣,金城鎮,古城里,19,1353,216,103,319,27,346
公投第１２案,金門縣,金城鎮,珠沙里,20,1574,300,180,480,19,499
公投第１２案,金門縣,金城鎮,珠沙里,21,1277,298,147,445,34,479
公投第１２案,金門縣,金寧鄉,古寧村,22,1735,325,168,493,48,541
公投第１２案,金門縣,金寧鄉,古寧村,23,1537,297,155,452,34,486
公投第１２案,金門縣,金寧鄉,安美村,24,1766,334,232,566,29,595
公投第１２案,金門縣,金寧鄉,安美村,25,1015,230,131,361,14,375
公投第１２案,金門縣,金寧鄉,安美村,26,1726,397,191,588,31,619
公投第１２案,金門縣,金寧鄉,湖埔村,27,1691,313,197,510,28,538
公投第１２案,金門縣,金寧鄉,湖埔村,28,2044,387,449,836,30,866
公投第１２案,金門縣,金寧鄉,湖埔村,29,1848,472,257,729,35,764
公投第１２案,金門縣,金寧鄉,湖埔村,30,1735,397,193,590,22,612
公投第１２案,金門縣,金寧鄉,榜林村,31,1795,381,221,602,25,627
公投第１２案,金門縣,金寧鄉,榜林村,32,1834,371,171,542,40,582
公投第１２案,金門縣,金寧鄉,榜林村,33,1528,283,204,487,25,512
公投第１２案,金門縣,金寧鄉,盤山村,34,1473,339,198,537,31,568
公投第１２案,金門縣,金寧鄉,盤山村,35,1679,365,210,575,26,601
公投第１２案,金門縣,金寧鄉,盤山村,36,1921,338,569,907,26,933
公投第１２案,金門縣,金寧鄉,盤山村,37,1298,274,178,452,16,468
公投第１２案,金門縣,金寧鄉,后盤村,38,1537,299,171,470,36,506
公投第１２案,金門縣,烈嶼鄉,林湖村,39,1647,466,216,682,40,722
公投第１２案,金門縣,烈嶼鄉,林湖村,40,1733,397,192,589,28,617
公投第１２案,金門縣,烈嶼鄉,黃埔村,41,1635,383,185,568,39,607
公投第１２案,金門縣,烈嶼鄉,西口村,42,1296,266,158,424,16,440
公投第１２案,金門縣,烈嶼鄉,西口村,43,1099,210,112,322,33,355
公投第１２案,金門縣,烈嶼鄉,上林村,44,1425,312,140,452,32,484
公投第１２案,金門縣,烈嶼鄉,上岐村,45,1412,344,160,504,21,525
公投第１２案,金門縣,烈嶼鄉,上岐村,46,1429,333,130,463,42,505
公投第１２案,金門縣,烏坵鄉,大坵村,47,275,49,26,75,3,78
公投第１２案,金門縣,烏坵鄉,小坵村,48,292,64,20,84,3,87
公投第１２案,金門縣,金湖鎮,新市里,49,1348,333,187,520,20,540
公投第１２案,金門縣,金湖鎮,新市里,50,1386,275,186,461,29,490
公投第１２案,金門縣,金湖鎮,新市里,51,1403,356,213,569,36,605
公投第１２案,金門縣,金湖鎮,山外里,52,1771,448,198,646,28,674
公投第１２案,金門縣,金湖鎮,山外里,53,1493,323,201,524,33,557
公投第１２案,金門縣,金湖鎮,溪湖里,54,1510,339,149,488,49,537
公投第１２案,金門縣,金湖鎮,蓮庵里,55,1607,391,180,571,38,609
公投第１２案,金門縣,金湖鎮,料羅里,56,2006,414,206,620,45,665
公投第１２案,金門縣,金湖鎮,新湖里,57,1780,370,245,615,27,642
公投第１２案,金門縣,金湖鎮,新湖里,58,1739,403,211,614,21,635
公投第１２案,金門縣,金湖鎮,新湖里,59,1384,294,166,460,19,479
公投第１２案,金門縣,金湖鎮,新湖里,60,1400,322,178,500,27,527
公投第１２案,金門縣,金湖鎮,新湖里,61,1325,370,195,565,20,585
公投第１２案,金門縣,金湖鎮,正義里,62,1236,241,145,386,30,416
公投第１２案,金門縣,金湖鎮,正義里,63,1382,295,151,446,36,482
公投第１２案,金門縣,金湖鎮,瓊林里,64,1631,394,147,541,19,560
公投第１２案,金門縣,金湖鎮,瓊林里,65,1514,295,160,455,38,493
公投第１２案,金門縣,金沙鎮,汶沙里,66,1909,420,200,620,36,656
公投第１２案,金門縣,金沙鎮,汶沙里,67,1524,407,185,592,33,625
公投第１２案,金門縣,金沙鎮,汶沙里,68,1673,339,180,519,28,547
公投第１２案,金門縣,金沙鎮,何斗里,69,2003,430,177,607,53,660
公投第１２案,金門縣,金沙鎮,浦山里,70,1212,313,161,474,21,495
公投第１２案,金門縣,金沙鎮,浦山里,71,1126,259,133,392,18,410
公投第１２案,金門縣,金沙鎮,西園里,72,1540,325,129,454,25,479
公投第１２案,金門縣,金沙鎮,官嶼里,73,1216,236,114,350,26,376
公投第１２案,金門縣,金沙鎮,官嶼里,74,950,172,79,251,9,260
公投第１２案,金門縣,金沙鎮,三山里,75,1895,482,185,667,34,701
公投第１２案,金門縣,金沙鎮,大洋里,76,1135,307,135,442,22,464
公投第１２案,金門縣,金沙鎮,光前里,77,1252,267,147,414,24,438
公投第１２案,金門縣,金沙鎮,光前里,78,1125,309,141,450,13,463
公投第１２案,宜蘭縣,宜蘭市,民族里,1,982,307,213,520,13,533
公投第１２案,宜蘭縣,宜蘭市,民族里,2,1270,426,246,672,30,702
公投第１２案,宜蘭縣,宜蘭市,建軍里,3,849,265,199,464,10,474
公投第１２案,宜蘭縣,宜蘭市,建軍里,4,756,247,174,421,21,442
公投第１２案,宜蘭縣,宜蘭市,泰山里,5,1107,332,198,530,32,562
公投第１２案,宜蘭縣,宜蘭市,泰山里,6,893,287,182,469,29,498
公投第１２案,宜蘭縣,宜蘭市,負郭里,7,912,286,192,478,28,506
公投第１２案,宜蘭縣,宜蘭市,負郭里,8,1335,438,279,717,35,752
公投第１２案,宜蘭縣,宜蘭市,負郭里,9,686,203,147,350,18,368
公投第１２案,宜蘭縣,宜蘭市,思源里,10,1366,501,294,795,33,828
公投第１２案,宜蘭縣,宜蘭市,思源里,11,1363,428,331,759,18,777
公投第１２案,宜蘭縣,宜蘭市,思源里,12,1540,517,345,862,27,889
公投第１２案,宜蘭縣,宜蘭市,七結里,13,1341,449,300,749,14,763
公投第１２案,宜蘭縣,宜蘭市,七結里,14,1209,425,241,666,23,689
公投第１２案,宜蘭縣,宜蘭市,文化里,15,900,278,217,495,24,519
公投第１２案,宜蘭縣,宜蘭市,文化里,16,980,314,186,500,19,519
公投第１２案,宜蘭縣,宜蘭市,文化里,17,1165,343,287,630,26,656
公投第１２案,宜蘭縣,宜蘭市,復興里,18,904,299,187,486,20,506
公投第１２案,宜蘭縣,宜蘭市,復興里,19,813,276,172,448,20,468
公投第１２案,宜蘭縣,宜蘭市,復興里,20,978,301,222,523,23,546
公投第１２案,宜蘭縣,宜蘭市,民權里,21,1282,350,217,567,19,586
公投第１２案,宜蘭縣,宜蘭市,民權里,22,465,160,103,263,11,274
公投第１２案,宜蘭縣,宜蘭市,神農里,23,669,239,130,369,27,396
公投第１２案,宜蘭縣,宜蘭市,神農里,24,923,309,197,506,20,526
公投第１２案,宜蘭縣,宜蘭市,神農里,25,1006,314,209,523,13,536
公投第１２案,宜蘭縣,宜蘭市,大新里,26,762,307,169,476,28,504
公投第１２案,宜蘭縣,宜蘭市,新民里,27,727,289,162,451,18,469
公投第１２案,宜蘭縣,宜蘭市,新民里,28,833,347,182,529,36,565
公投第１２案,宜蘭縣,宜蘭市,進士里,29,1143,379,245,624,31,655
公投第１２案,宜蘭縣,宜蘭市,進士里,30,979,309,227,536,12,548
公投第１２案,宜蘭縣,宜蘭市,南橋里,31,1214,388,253,641,44,685
公投第１２案,宜蘭縣,宜蘭市,凱旋里,32,1283,421,272,693,52,745
公投第１２案,宜蘭縣,宜蘭市,南津里,33,946,308,219,527,27,554
公投第１２案,宜蘭縣,宜蘭市,南津里,34,1090,304,248,552,36,588
公投第１２案,宜蘭縣,宜蘭市,建業里,35,943,331,210,541,19,560
公投第１２案,宜蘭縣,宜蘭市,建業里,36,774,276,196,472,27,499
公投第１２案,宜蘭縣,宜蘭市,擺厘里,37,968,335,235,570,19,589
公投第１２案,宜蘭縣,宜蘭市,擺厘里,38,926,315,233,548,23,571
公投第１２案,宜蘭縣,宜蘭市,擺厘里,39,1019,337,250,587,25,612
公投第１２案,宜蘭縣,宜蘭市,延平里,40,1084,350,232,582,35,617
公投第１２案,宜蘭縣,宜蘭市,延平里,41,1095,355,219,574,22,596
公投第１２案,宜蘭縣,宜蘭市,延平里,42,1083,328,269,597,26,623
公投第１２案,宜蘭縣,宜蘭市,成功里,43,1108,349,217,566,28,594
公投第１２案,宜蘭縣,宜蘭市,成功里,44,848,285,194,479,17,496
公投第１２案,宜蘭縣,宜蘭市,成功里,45,1095,347,237,584,25,609
公投第１２案,宜蘭縣,宜蘭市,東村里,46,1110,350,249,599,29,628
公投第１２案,宜蘭縣,宜蘭市,東村里,47,1104,375,239,614,32,646
公投第１２案,宜蘭縣,宜蘭市,新東里,48,1134,390,255,645,22,667
公投第１２案,宜蘭縣,宜蘭市,新東里,49,1146,365,266,631,31,662
公投第１２案,宜蘭縣,宜蘭市,新東里,50,876,322,186,508,27,535
公投第１２案,宜蘭縣,宜蘭市,黎明里,51,905,268,205,473,36,509
公投第１２案,宜蘭縣,宜蘭市,黎明里,52,910,296,217,513,22,535
公投第１２案,宜蘭縣,宜蘭市,七張里,53,1434,403,299,702,33,735
公投第１２案,宜蘭縣,宜蘭市,孝廉里,54,1152,357,230,587,52,639
公投第１２案,宜蘭縣,宜蘭市,東門里,55,966,330,216,546,36,582
公投第１２案,宜蘭縣,宜蘭市,小東里,56,711,228,162,390,26,416
公投第１２案,宜蘭縣,宜蘭市,小東里,57,884,312,197,509,28,537
公投第１２案,宜蘭縣,宜蘭市,菜園里,58,1326,415,307,722,45,767
公投第１２案,宜蘭縣,宜蘭市,慈安里,59,909,260,199,459,17,476
公投第１２案,宜蘭縣,宜蘭市,慈安里,60,894,278,186,464,26,490
公投第１２案,宜蘭縣,宜蘭市,中興里,61,1259,359,259,618,22,640
公投第１２案,宜蘭縣,宜蘭市,中興里,62,789,237,162,399,18,417
公投第１２案,宜蘭縣,宜蘭市,中興里,63,867,281,172,453,28,481
公投第１２案,宜蘭縣,宜蘭市,新生里,64,1454,426,337,763,49,812
公投第１２案,宜蘭縣,宜蘭市,新生里,65,1130,442,233,675,16,691
公投第１２案,宜蘭縣,宜蘭市,茭白里,66,1087,304,220,524,11,535
公投第１２案,宜蘭縣,宜蘭市,茭白里,67,938,311,226,537,43,580
公投第１２案,宜蘭縣,宜蘭市,北津里,68,1285,409,280,689,29,718
公投第１２案,宜蘭縣,宜蘭市,北津里,69,952,292,216,508,23,531
公投第１２案,宜蘭縣,宜蘭市,梅洲里,70,948,311,216,527,45,572
公投第１２案,宜蘭縣,宜蘭市,梅洲里,71,1160,340,234,574,40,614
公投第１２案,宜蘭縣,宜蘭市,梅洲里,72,1015,325,235,560,44,604
公投第１２案,宜蘭縣,宜蘭市,南門里,73,424,142,107,249,14,263
公投第１２案,宜蘭縣,宜蘭市,南門里,74,964,325,207,532,41,573
公投第１２案,宜蘭縣,宜蘭市,中山里,75,959,296,182,478,40,518
公投第１２案,宜蘭縣,宜蘭市,西門里,76,814,297,198,495,22,517
公投第１２案,宜蘭縣,宜蘭市,西門里,77,885,302,206,508,19,527
公投第１２案,宜蘭縣,宜蘭市,北門里,78,1162,371,257,628,42,670
公投第１２案,宜蘭縣,羅東鎮,開明里,79,689,219,165,384,23,407
公投第１２案,宜蘭縣,羅東鎮,開明里,80,718,242,140,382,18,400
公投第１２案,宜蘭縣,羅東鎮,大新里,81,1475,456,310,766,53,819
公投第１２案,宜蘭縣,羅東鎮,東安里,82,1466,450,312,762,38,800
公投第１２案,宜蘭縣,羅東鎮,東安里,83,1075,316,263,579,27,606
公投第１２案,宜蘭縣,羅東鎮,東安里,84,963,292,217,509,28,537
公投第１２案,宜蘭縣,羅東鎮,新群里,85,1511,444,307,751,64,815
公投第１２案,宜蘭縣,羅東鎮,新群里,86,1166,328,284,612,30,642
公投第１２案,宜蘭縣,羅東鎮,羅莊里,87,1273,376,317,693,47,740
公投第１２案,宜蘭縣,羅東鎮,羅莊里,88,1735,553,335,888,27,915
公投第１２案,宜蘭縣,羅東鎮,南昌里,89,1487,486,331,817,34,851
公投第１２案,宜蘭縣,羅東鎮,南昌里,90,837,256,218,474,29,503
公投第１２案,宜蘭縣,羅東鎮,南豪里,91,1312,449,296,745,48,793
公投第１２案,宜蘭縣,羅東鎮,成功里,92,1502,467,275,742,61,803
公投第１２案,宜蘭縣,羅東鎮,仁德里,93,1138,346,232,578,24,602
公投第１２案,宜蘭縣,羅東鎮,仁和里,94,1010,293,244,537,29,566
公投第１２案,宜蘭縣,羅東鎮,中山里,95,1373,472,272,744,52,796
公投第１２案,宜蘭縣,羅東鎮,漢民里,96,1089,374,232,606,27,633
公投第１２案,宜蘭縣,羅東鎮,漢民里,97,1304,384,285,669,42,711
公投第１２案,宜蘭縣,羅東鎮,漢民里,98,1288,365,293,658,39,697
公投第１２案,宜蘭縣,羅東鎮,維揚里,99,1036,334,261,595,47,642
公投第１２案,宜蘭縣,羅東鎮,維揚里,100,969,364,225,589,31,620
公投第１２案,宜蘭縣,羅東鎮,維揚里,101,985,314,244,558,35,593
公投第１２案,宜蘭縣,羅東鎮,西安里,102,1420,441,345,786,49,835
公投第１２案,宜蘭縣,羅東鎮,西安里,103,1430,443,331,774,46,820
公投第１２案,宜蘭縣,羅東鎮,北成里,104,1075,342,246,588,46,634
公投第１２案,宜蘭縣,羅東鎮,北成里,105,879,290,216,506,25,531
公投第１２案,宜蘭縣,羅東鎮,北成里,106,850,256,208,464,11,475
公投第１２案,宜蘭縣,羅東鎮,國華里,107,1111,365,275,640,24,664
公投第１２案,宜蘭縣,羅東鎮,國華里,108,1139,427,257,684,30,714
公投第１２案,宜蘭縣,羅東鎮,國華里,109,1130,396,267,663,35,698
公投第１２案,宜蘭縣,羅東鎮,國華里,110,980,322,225,547,32,579
公投第１２案,宜蘭縣,羅東鎮,賢文里,111,1431,524,241,765,39,804
公投第１２案,宜蘭縣,羅東鎮,賢文里,112,1109,360,250,610,25,635
公投第１２案,宜蘭縣,羅東鎮,賢文里,113,1083,361,229,590,25,615
公投第１２案,宜蘭縣,羅東鎮,公正里,114,1404,462,310,772,44,816
公投第１２案,宜蘭縣,羅東鎮,公正里,115,1288,424,280,704,37,741
公投第１２案,宜蘭縣,羅東鎮,集祥里,116,1183,321,199,520,27,547
公投第１２案,宜蘭縣,羅東鎮,信義里,117,1105,373,253,626,36,662
公投第１２案,宜蘭縣,羅東鎮,信義里,118,987,334,241,575,31,606
公投第１２案,宜蘭縣,羅東鎮,信義里,119,773,277,165,442,32,474
公投第１２案,宜蘭縣,羅東鎮,樹林里,120,1366,448,389,837,32,869
公投第１２案,宜蘭縣,羅東鎮,樹林里,121,907,329,231,560,25,585
公投第１２案,宜蘭縣,羅東鎮,樹林里,122,1158,428,270,698,22,720
公投第１２案,宜蘭縣,羅東鎮,竹林里,123,977,306,205,511,53,564
公投第１２案,宜蘭縣,羅東鎮,竹林里,124,972,295,202,497,35,532
公投第１２案,宜蘭縣,羅東鎮,竹林里,125,977,341,211,552,29,581
公投第１２案,宜蘭縣,羅東鎮,仁愛里,126,1398,489,293,782,44,826
公投第１２案,宜蘭縣,羅東鎮,仁愛里,127,1022,327,226,553,24,577
公投第１２案,宜蘭縣,羅東鎮,仁愛里,128,1131,412,252,664,32,696
公投第１２案,宜蘭縣,蘇澳鎮,龍德里,129,1194,345,299,644,31,675
公投第１２案,宜蘭縣,蘇澳鎮,龍德里,130,1128,337,251,588,33,621
公投第１２案,宜蘭縣,蘇澳鎮,龍德里,131,1042,311,284,595,46,641
公投第１２案,宜蘭縣,蘇澳鎮,頂寮里,132,997,305,254,559,28,587
公投第１２案,宜蘭縣,蘇澳鎮,永榮里,133,1303,383,298,681,58,739
公投第１２案,宜蘭縣,蘇澳鎮,永榮里,134,1260,381,310,691,61,752
公投第１２案,宜蘭縣,蘇澳鎮,永榮里,135,1130,330,265,595,46,641
公投第１２案,宜蘭縣,蘇澳鎮,存仁里,136,559,152,139,291,26,317
公投第１２案,宜蘭縣,蘇澳鎮,存仁里,137,351,90,76,166,17,183
公投第１２案,宜蘭縣,蘇澳鎮,港邊里,138,889,250,199,449,49,498
公投第１２案,宜蘭縣,蘇澳鎮,港邊里,139,434,118,106,224,17,241
公投第１２案,宜蘭縣,蘇澳鎮,隘丁里,140,835,283,199,482,29,511
公投第１２案,宜蘭縣,蘇澳鎮,隘丁里,141,975,293,228,521,40,561
公投第１２案,宜蘭縣,蘇澳鎮,隘丁里,142,1135,331,287,618,57,675
公投第１２案,宜蘭縣,蘇澳鎮,新城里,143,788,273,204,477,37,514
公投第１２案,宜蘭縣,蘇澳鎮,新城里,144,469,135,105,240,19,259
公投第１２案,宜蘭縣,蘇澳鎮,聖愛里,145,811,244,176,420,24,444
公投第１２案,宜蘭縣,蘇澳鎮,聖愛里,146,867,262,201,463,14,477
公投第１２案,宜蘭縣,蘇澳鎮,聖愛里,147,1139,350,258,608,35,643
公投第１２案,宜蘭縣,蘇澳鎮,聖湖里,148,1146,327,239,566,36,602
公投第１２案,宜蘭縣,蘇澳鎮,聖湖里,149,1154,332,282,614,39,653
公投第１２案,宜蘭縣,蘇澳鎮,蘇西里,150,908,213,239,452,18,470
公投第１２案,宜蘭縣,蘇澳鎮,蘇西里,151,656,201,140,341,23,364
公投第１２案,宜蘭縣,蘇澳鎮,蘇西里,152,834,287,194,481,43,524
公投第１２案,宜蘭縣,蘇澳鎮,蘇北里,153,1025,337,237,574,41,615
公投第１２案,宜蘭縣,蘇澳鎮,蘇南里,154,455,140,112,252,12,264
公投第１２案,宜蘭縣,蘇澳鎮,蘇東里,155,535,181,101,282,32,314
公投第１２案,宜蘭縣,蘇澳鎮,長安里,156,536,173,141,314,28,342
公投第１２案,宜蘭縣,蘇澳鎮,永光里,157,451,145,122,267,9,276
公投第１２案,宜蘭縣,蘇澳鎮,永春里,158,593,172,131,303,30,333
公投第１２案,宜蘭縣,蘇澳鎮,永樂里,159,441,130,103,233,21,254
公投第１２案,宜蘭縣,蘇澳鎮,南安里,160,954,288,214,502,46,548
公投第１２案,宜蘭縣,蘇澳鎮,南正里,161,952,271,198,469,52,521
公投第１２案,宜蘭縣,蘇澳鎮,南成里,162,1125,304,239,543,52,595
公投第１２案,宜蘭縣,蘇澳鎮,南興里,163,763,240,133,373,59,432
公投第１２案,宜蘭縣,蘇澳鎮,南興里,164,706,162,128,290,29,319
公投第１２案,宜蘭縣,蘇澳鎮,南寧里,165,1068,282,184,466,54,520
公投第１２案,宜蘭縣,蘇澳鎮,南建里,166,666,186,160,346,42,388
公投第１２案,宜蘭縣,蘇澳鎮,南建里,167,574,141,124,265,64,329
公投第１２案,宜蘭縣,蘇澳鎮,東澳里,168,351,72,87,159,6,165
公投第１２案,宜蘭縣,蘇澳鎮,南強里,169,717,233,132,365,40,405
公投第１２案,宜蘭縣,蘇澳鎮,朝陽里,170,373,96,40,136,19,155
公投第１２案,宜蘭縣,蘇澳鎮,朝陽里,171,223,39,46,85,10,95
公投第１２案,宜蘭縣,頭城鎮,石城里,172,292,58,37,95,12,107
公投第１２案,宜蘭縣,頭城鎮,大里里,173,688,181,159,340,30,370
公投第１２案,宜蘭縣,頭城鎮,龜山里,174,688,200,154,354,42,396
公投第１２案,宜蘭縣,頭城鎮,大溪里,175,879,238,174,412,39,451
公投第１２案,宜蘭縣,頭城鎮,合興里,176,335,93,89,182,22,204
公投第１２案,宜蘭縣,頭城鎮,更新里,177,624,242,126,368,24,392
公投第１２案,宜蘭縣,頭城鎮,更新里,178,732,193,129,322,23,345
公投第１２案,宜蘭縣,頭城鎮,外澳里,179,892,206,180,386,33,419
公投第１２案,宜蘭縣,頭城鎮,港口里,180,690,164,126,290,23,313
公投第１２案,宜蘭縣,頭城鎮,武營里,181,842,250,172,422,30,452
公投第１２案,宜蘭縣,頭城鎮,武營里,182,736,211,169,380,31,411
公投第１２案,宜蘭縣,頭城鎮,大坑里,183,788,226,162,388,15,403
公投第１２案,宜蘭縣,頭城鎮,大坑里,184,560,136,132,268,19,287
公投第１２案,宜蘭縣,頭城鎮,城東里,185,712,257,146,403,22,425
公投第１２案,宜蘭縣,頭城鎮,城北里,186,502,177,126,303,19,322
公投第１２案,宜蘭縣,頭城鎮,城西里,187,569,202,128,330,28,358
公投第１２案,宜蘭縣,頭城鎮,城南里,188,633,212,127,339,22,361
公投第１２案,宜蘭縣,頭城鎮,竹安里,189,1132,271,223,494,44,538
公投第１２案,宜蘭縣,頭城鎮,竹安里,190,1035,283,188,471,25,496
公投第１２案,宜蘭縣,頭城鎮,新建里,191,847,282,192,474,30,504
公投第１２案,宜蘭縣,頭城鎮,新建里,192,1172,367,260,627,37,664
公投第１２案,宜蘭縣,頭城鎮,拔雅里,193,896,235,200,435,35,470
公投第１２案,宜蘭縣,頭城鎮,拔雅里,194,1075,322,276,598,23,621
公投第１２案,宜蘭縣,頭城鎮,福成里,195,931,267,233,500,46,546
公投第１２案,宜蘭縣,頭城鎮,金面里,196,1021,349,181,530,31,561
公投第１２案,宜蘭縣,頭城鎮,金面里,197,709,200,122,322,29,351
公投第１２案,宜蘭縣,頭城鎮,金盈里,198,689,248,156,404,38,442
公投第１２案,宜蘭縣,頭城鎮,頂埔里,199,615,211,143,354,30,384
公投第１２案,宜蘭縣,頭城鎮,頂埔里,200,759,218,163,381,34,415
公投第１２案,宜蘭縣,頭城鎮,下埔里,201,917,320,181,501,63,564
公投第１２案,宜蘭縣,頭城鎮,中崙里,202,1045,327,218,545,58,603
公投第１２案,宜蘭縣,頭城鎮,二城里,203,1130,343,245,588,49,637
公投第１２案,宜蘭縣,礁溪鄉,白雲村,204,1122,320,212,532,29,561
公投第１２案,宜蘭縣,礁溪鄉,白雲村,205,505,145,103,248,19,267
公投第１２案,宜蘭縣,礁溪鄉,玉石村,206,988,292,198,490,24,514
公投第１２案,宜蘭縣,礁溪鄉,玉石村,207,971,291,213,504,18,522
公投第１２案,宜蘭縣,礁溪鄉,德陽村,208,1246,344,238,582,41,623
公投第１２案,宜蘭縣,礁溪鄉,德陽村,209,1655,411,355,766,25,791
公投第１２案,宜蘭縣,礁溪鄉,德陽村,210,1132,277,216,493,20,513
公投第１２案,宜蘭縣,礁溪鄉,大忠村,211,783,265,159,424,19,443
公投第１２案,宜蘭縣,礁溪鄉,大忠村,212,928,287,188,475,25,500
公投第１２案,宜蘭縣,礁溪鄉,大忠村,213,848,270,161,431,28,459
公投第１２案,宜蘭縣,礁溪鄉,大義村,214,663,221,169,390,32,422
公投第１２案,宜蘭縣,礁溪鄉,六結村,215,608,195,129,324,17,341
公投第１２案,宜蘭縣,礁溪鄉,六結村,216,833,289,153,442,31,473
公投第１２案,宜蘭縣,礁溪鄉,二龍村,217,1233,314,259,573,24,597
公投第１２案,宜蘭縣,礁溪鄉,時潮村,218,854,226,203,429,51,480
公投第１２案,宜蘭縣,礁溪鄉,時潮村,219,575,144,138,282,23,305
公投第１２案,宜蘭縣,礁溪鄉,玉田村,220,835,239,195,434,35,469
公投第１２案,宜蘭縣,礁溪鄉,玉田村,221,1305,386,318,704,44,748
公投第１２案,宜蘭縣,礁溪鄉,三民村,222,830,233,182,415,45,460
公投第１２案,宜蘭縣,礁溪鄉,三民村,223,649,215,175,390,38,428
公投第１２案,宜蘭縣,礁溪鄉,三民村,224,923,233,194,427,37,464
公投第１２案,宜蘭縣,礁溪鄉,林美村,225,1177,308,218,526,32,558
公投第１２案,宜蘭縣,礁溪鄉,白鵝村,226,840,252,181,433,29,462
公投第１２案,宜蘭縣,礁溪鄉,玉光村,227,1051,331,237,568,31,599
公投第１２案,宜蘭縣,礁溪鄉,光武村,228,1339,380,272,652,38,690
公投第１２案,宜蘭縣,礁溪鄉,吳沙村,229,1194,405,268,673,35,708
公投第１２案,宜蘭縣,礁溪鄉,吳沙村,230,1314,455,297,752,37,789
公投第１２案,宜蘭縣,礁溪鄉,龍潭村,231,1125,307,285,592,33,625
公投第１２案,宜蘭縣,礁溪鄉,龍潭村,232,1207,359,311,670,54,724
公投第１２案,宜蘭縣,礁溪鄉,龍潭村,233,979,280,222,502,47,549
公投第１２案,宜蘭縣,礁溪鄉,匏崙村,234,954,288,242,530,54,584
公投第１２案,宜蘭縣,礁溪鄉,二結村,235,418,127,91,218,14,232
公投第１２案,宜蘭縣,壯圍鄉,吉祥村,236,1435,499,315,814,57,871
公投第１２案,宜蘭縣,壯圍鄉,吉祥村,237,1049,362,246,608,24,632
公投第１２案,宜蘭縣,壯圍鄉,古結村,238,1068,333,286,619,41,660
公投第１２案,宜蘭縣,壯圍鄉,美福村,239,868,280,173,453,52,505
公投第１２案,宜蘭縣,壯圍鄉,美福村,240,967,304,206,510,33,543
公投第１２案,宜蘭縣,壯圍鄉,新南村,241,940,309,226,535,48,583
公投第１２案,宜蘭縣,壯圍鄉,東港村,242,975,281,175,456,28,484
公投第１２案,宜蘭縣,壯圍鄉,復興村,243,797,260,179,439,50,489
公投第１２案,宜蘭縣,壯圍鄉,復興村,244,808,270,170,440,35,475
公投第１２案,宜蘭縣,壯圍鄉,過嶺村,245,911,290,202,492,58,550
公投第１２案,宜蘭縣,壯圍鄉,過嶺村,246,612,178,113,291,26,317
公投第１２案,宜蘭縣,壯圍鄉,永鎮村,247,790,281,179,460,44,504
公投第１２案,宜蘭縣,壯圍鄉,忠孝村,248,878,277,205,482,46,528
公投第１２案,宜蘭縣,壯圍鄉,忠孝村,249,723,250,191,441,37,478
公投第１２案,宜蘭縣,壯圍鄉,忠孝村,250,737,238,137,375,25,400
公投第１２案,宜蘭縣,壯圍鄉,古亭村,251,686,227,153,380,34,414
公投第１２案,宜蘭縣,壯圍鄉,古亭村,252,895,286,191,477,11,488
公投第１２案,宜蘭縣,壯圍鄉,功勞村,253,1237,453,262,715,43,758
公投第１２案,宜蘭縣,壯圍鄉,美城村,254,1134,353,249,602,49,651
公投第１２案,宜蘭縣,壯圍鄉,美城村,255,1107,371,211,582,42,624
公投第１２案,宜蘭縣,壯圍鄉,新社村,256,1057,381,229,610,37,647
公投第１２案,宜蘭縣,壯圍鄉,大福村,257,1051,282,226,508,40,548
公投第１２案,宜蘭縣,壯圍鄉,大福村,258,722,211,163,374,31,405
公投第１２案,宜蘭縣,員山鄉,員山村,259,1393,396,293,689,38,727
公投第１２案,宜蘭縣,員山鄉,員山村,260,895,271,170,441,24,465
公投第１２案,宜蘭縣,員山鄉,員山村,261,1231,409,211,620,49,669
公投第１２案,宜蘭縣,員山鄉,員山村,262,1098,338,204,542,25,567
公投第１２案,宜蘭縣,員山鄉,員山村,263,1031,315,201,516,30,546
公投第１２案,宜蘭縣,員山鄉,尚德村,264,1030,289,212,501,56,557
公投第１２案,宜蘭縣,員山鄉,尚德村,265,1168,301,223,524,36,560
公投第１２案,宜蘭縣,員山鄉,惠好村,266,809,242,182,424,40,464
公投第１２案,宜蘭縣,員山鄉,惠好村,267,778,228,185,413,36,449
公投第１２案,宜蘭縣,員山鄉,七賢村,268,1465,469,333,802,45,847
公投第１２案,宜蘭縣,員山鄉,深溝村,269,979,328,212,540,45,585
公投第１２案,宜蘭縣,員山鄉,深溝村,270,860,259,193,452,31,483
公投第１２案,宜蘭縣,員山鄉,蓁巷村,271,1205,302,251,553,48,601
公投第１２案,宜蘭縣,員山鄉,內城村,272,1082,377,203,580,32,612
公投第１２案,宜蘭縣,員山鄉,內城村,273,412,133,98,231,16,247
公投第１２案,宜蘭縣,員山鄉,中華村,274,403,114,71,185,14,199
公投第１２案,宜蘭縣,員山鄉,中華村,275,232,52,42,94,10,104
公投第１２案,宜蘭縣,員山鄉,永和村,276,944,278,207,485,28,513
公投第１２案,宜蘭縣,員山鄉,永和村,277,894,273,185,458,45,503
公投第１２案,宜蘭縣,員山鄉,頭分村,278,1356,462,263,725,35,760
公投第１２案,宜蘭縣,員山鄉,枕山村,279,780,250,175,425,34,459
公投第１２案,宜蘭縣,員山鄉,枕山村,280,932,358,200,558,33,591
公投第１２案,宜蘭縣,員山鄉,枕山村,281,583,159,115,274,30,304
公投第１２案,宜蘭縣,員山鄉,同樂村,282,900,286,177,463,40,503
公投第１２案,宜蘭縣,員山鄉,同樂村,283,747,222,170,392,22,414
公投第１２案,宜蘭縣,員山鄉,同樂村,284,788,135,263,398,37,435
公投第１２案,宜蘭縣,員山鄉,湖東村,285,884,223,202,425,42,467
公投第１２案,宜蘭縣,員山鄉,逸仙村,286,857,233,185,418,29,447
公投第１２案,宜蘭縣,員山鄉,湖北村,287,1016,278,229,507,17,524
公投第１２案,宜蘭縣,員山鄉,湖西村,288,690,150,127,277,31,308
公投第１２案,宜蘭縣,員山鄉,湖西村,289,689,181,135,316,50,366
公投第１２案,宜蘭縣,冬山鄉,珍珠村,290,807,258,184,442,44,486
公投第１２案,宜蘭縣,冬山鄉,珍珠村,291,817,264,200,464,21,485
公投第１２案,宜蘭縣,冬山鄉,補城村,292,1156,348,275,623,36,659
公投第１２案,宜蘭縣,冬山鄉,三奇村,293,892,246,204,450,36,486
公投第１２案,宜蘭縣,冬山鄉,大興村,294,897,298,230,528,0,528
公投第１２案,宜蘭縣,冬山鄉,東城村,295,1392,442,372,814,29,843
公投第１２案,宜蘭縣,冬山鄉,香和村,296,1471,433,376,809,34,843
公投第１２案,宜蘭縣,冬山鄉,香和村,297,1435,383,284,667,22,689
公投第１２案,宜蘭縣,冬山鄉,南興村,298,1519,428,327,755,36,791
公投第１２案,宜蘭縣,冬山鄉,南興村,299,1456,459,345,804,35,839
公投第１２案,宜蘭縣,冬山鄉,安平村,300,711,252,166,418,21,439
公投第１２案,宜蘭縣,冬山鄉,冬山村,301,694,218,167,385,19,404
公投第１２案,宜蘭縣,冬山鄉,太和村,302,1526,485,424,909,56,965
公投第１２案,宜蘭縣,冬山鄉,八寶村,303,884,249,215,464,25,489
公投第１２案,宜蘭縣,冬山鄉,丸山村,304,1465,400,65,465,54,519
公投第１２案,宜蘭縣,冬山鄉,中山村,305,488,157,103,260,25,285
公投第１２案,宜蘭縣,冬山鄉,順安村,306,1218,359,244,603,48,651
公投第１２案,宜蘭縣,冬山鄉,順安村,307,1291,344,274,618,45,663
公投第１２案,宜蘭縣,冬山鄉,順安村,308,1324,378,262,640,33,673
公投第１２案,宜蘭縣,冬山鄉,順安村,309,1160,234,304,538,38,576
公投第１２案,宜蘭縣,冬山鄉,永美村,310,1246,370,253,623,51,674
公投第１２案,宜蘭縣,冬山鄉,永美村,311,1754,492,381,873,41,914
公投第１２案,宜蘭縣,冬山鄉,武淵村,312,1217,331,284,615,34,649
公投第１２案,宜蘭縣,冬山鄉,群英村,313,1495,377,299,676,45,721
公投第１２案,宜蘭縣,冬山鄉,群英村,314,937,239,236,475,36,511
公投第１２案,宜蘭縣,冬山鄉,群英村,315,1101,305,242,547,33,580
公投第１２案,宜蘭縣,冬山鄉,群英村,316,1118,325,221,546,40,586
公投第１２案,宜蘭縣,冬山鄉,清溝村,317,1301,421,300,721,31,752
公投第１２案,宜蘭縣,冬山鄉,清溝村,318,1225,343,288,631,25,656
公投第１２案,宜蘭縣,冬山鄉,清溝村,319,1206,371,295,666,40,706
公投第１２案,宜蘭縣,冬山鄉,鹿埔村,320,1278,366,252,618,33,651
公投第１２案,宜蘭縣,冬山鄉,鹿埔村,321,1151,324,244,568,36,604
公投第１２案,宜蘭縣,冬山鄉,得安村,322,1094,321,183,504,38,542
公投第１２案,宜蘭縣,冬山鄉,廣興村,323,1247,385,283,668,39,707
公投第１２案,宜蘭縣,冬山鄉,廣興村,324,1247,332,260,592,40,632
公投第１２案,宜蘭縣,冬山鄉,廣安村,325,979,293,223,516,22,538
公投第１２案,宜蘭縣,冬山鄉,廣安村,326,698,259,147,406,17,423
公投第１２案,宜蘭縣,冬山鄉,柯林村,327,1726,513,366,879,39,918
公投第１２案,宜蘭縣,冬山鄉,大進村,328,782,197,158,355,19,374
公投第１２案,宜蘭縣,五結鄉,三興村,329,1076,303,213,516,36,552
公投第１２案,宜蘭縣,五結鄉,三興村,330,944,251,229,480,22,502
公投第１２案,宜蘭縣,五結鄉,二結村,331,836,286,181,467,25,492
公投第１２案,宜蘭縣,五結鄉,二結村,332,937,296,206,502,31,533
公投第１２案,宜蘭縣,五結鄉,鎮安村,333,1255,369,263,632,31,663
公投第１２案,宜蘭縣,五結鄉,鎮安村,334,1270,373,268,641,46,687
公投第１２案,宜蘭縣,五結鄉,上四村,335,801,226,163,389,26,415
公投第１２案,宜蘭縣,五結鄉,上四村,336,802,224,172,396,23,419
公投第１２案,宜蘭縣,五結鄉,中興村,337,1306,366,262,628,26,654
公投第１２案,宜蘭縣,五結鄉,四結村,338,1190,346,249,595,32,627
公投第１２案,宜蘭縣,五結鄉,四結村,339,1316,397,286,683,25,708
公投第１２案,宜蘭縣,五結鄉,福興村,340,965,301,223,524,26,550
公投第１２案,宜蘭縣,五結鄉,福興村,341,814,230,177,407,31,438
公投第１２案,宜蘭縣,五結鄉,五結村,342,1254,358,251,609,46,655
公投第１２案,宜蘭縣,五結鄉,五結村,343,1060,360,223,583,22,605
公投第１２案,宜蘭縣,五結鄉,五結村,344,1323,404,307,711,28,739
公投第１２案,宜蘭縣,五結鄉,協和村,345,1120,356,244,600,40,640
公投第１２案,宜蘭縣,五結鄉,協和村,346,893,269,189,458,20,478
公投第１２案,宜蘭縣,五結鄉,協和村,347,1220,338,258,596,49,645
公投第１２案,宜蘭縣,五結鄉,大吉村,348,924,302,211,513,24,537
公投第１２案,宜蘭縣,五結鄉,大吉村,349,933,324,214,538,29,567
公投第１２案,宜蘭縣,五結鄉,大吉村,350,986,315,183,498,30,528
公投第１２案,宜蘭縣,五結鄉,大吉村,351,748,240,140,380,28,408
公投第１２案,宜蘭縣,五結鄉,孝威村,352,1550,452,325,777,60,837
公投第１２案,宜蘭縣,五結鄉,錦眾村,353,629,202,140,342,21,363
公投第１２案,宜蘭縣,五結鄉,錦眾村,354,806,200,212,412,31,443
公投第１２案,宜蘭縣,五結鄉,利澤村,355,956,261,204,465,38,503
公投第１２案,宜蘭縣,五結鄉,利澤村,356,1066,323,164,487,32,519
公投第１２案,宜蘭縣,五結鄉,成興村,357,1513,383,305,688,63,751
公投第１２案,宜蘭縣,五結鄉,成興村,358,1566,436,346,782,47,829
公投第１２案,宜蘭縣,五結鄉,季新村,359,894,244,198,442,54,496
公投第１２案,宜蘭縣,五結鄉,季新村,360,1235,290,251,541,45,586
公投第１２案,宜蘭縣,五結鄉,季新村,361,704,203,155,358,39,397
公投第１２案,宜蘭縣,三星鄉,員山村,362,215,72,39,111,8,119
公投第１２案,宜蘭縣,三星鄉,天山村,363,523,158,68,226,15,241
公投第１２案,宜蘭縣,三星鄉,天福村,364,745,205,158,363,27,390
公投第１２案,宜蘭縣,三星鄉,萬德村,365,617,181,117,298,23,321
公投第１２案,宜蘭縣,三星鄉,貴林村,366,497,161,82,243,23,266
公投第１２案,宜蘭縣,三星鄉,萬富村,367,735,220,154,374,41,415
公投第１２案,宜蘭縣,三星鄉,雙賢村,368,583,185,119,304,23,327
公投第１２案,宜蘭縣,三星鄉,人和村,369,436,126,85,211,24,235
公投第１２案,宜蘭縣,三星鄉,義德村,370,1224,370,248,618,35,653
公投第１２案,宜蘭縣,三星鄉,集慶村,371,1151,351,202,553,24,577
公投第１２案,宜蘭縣,三星鄉,月眉村,372,870,266,192,458,22,480
公投第１２案,宜蘭縣,三星鄉,拱照村,373,1284,298,198,496,41,537
公投第１２案,宜蘭縣,三星鄉,行健村,374,897,275,216,491,42,533
公投第１２案,宜蘭縣,三星鄉,大隱村,375,1439,445,295,740,40,780
公投第１２案,宜蘭縣,三星鄉,大隱村,376,1445,400,292,692,44,736
公投第１２案,宜蘭縣,三星鄉,大隱村,377,1402,400,304,704,40,744
公投第１２案,宜蘭縣,三星鄉,大義村,378,1230,369,253,622,27,649
公投第１２案,宜蘭縣,三星鄉,尚武村,379,774,230,160,390,42,432
公投第１２案,宜蘭縣,三星鄉,大洲村,380,827,177,273,450,32,482
公投第１２案,宜蘭縣,三星鄉,大洲村,381,736,225,159,384,25,409
公投第１２案,宜蘭縣,三星鄉,尾塹村,382,1421,421,278,699,50,749
公投第１２案,宜蘭縣,大同鄉,寒溪村,383,893,409,140,549,31,580
公投第１２案,宜蘭縣,大同鄉,崙埤村,384,632,310,132,442,20,462
公投第１２案,宜蘭縣,大同鄉,松羅村,385,684,319,129,448,15,463
公投第１２案,宜蘭縣,大同鄉,復興村,386,264,120,45,165,12,177
公投第１２案,宜蘭縣,大同鄉,英士村,387,337,172,54,226,4,230
公投第１２案,宜蘭縣,大同鄉,樂水村,388,404,267,53,320,6,326
公投第１２案,宜蘭縣,大同鄉,太平村,389,55,15,8,23,4,27
公投第１２案,宜蘭縣,大同鄉,茂安村,390,199,100,48,148,8,156
公投第１２案,宜蘭縣,大同鄉,四季村,391,787,474,127,601,15,616
公投第１２案,宜蘭縣,大同鄉,南山村,392,680,362,131,493,30,523
公投第１２案,宜蘭縣,南澳鄉,東岳村,393,444,186,96,282,4,286
公投第１２案,宜蘭縣,南澳鄉,南澳村,394,1210,414,188,602,14,616
公投第１２案,宜蘭縣,南澳鄉,碧候村,395,962,451,160,611,32,643
公投第１２案,宜蘭縣,南澳鄉,金岳村,396,411,171,73,244,15,259
公投第１２案,宜蘭縣,南澳鄉,武塔村,397,447,201,92,293,23,316
公投第１２案,宜蘭縣,南澳鄉,金洋村,398,475,239,109,348,20,368
公投第１２案,宜蘭縣,南澳鄉,澳花村,399,695,238,161,399,20,419
公投第１２案,新竹縣,竹北市,鹿場里,1,1319,524,310,834,19,853
公投第１２案,新竹縣,竹北市,鹿場里,2,1321,408,376,784,21,805
公投第１２案,新竹縣,竹北市,鹿場里,3,1272,481,303,784,23,807
公投第１２案,新竹縣,竹北市,鹿場里,4,1467,523,303,826,24,850
公投第１２案,新竹縣,竹北市,鹿場里,5,1226,405,299,704,8,712
公投第１２案,新竹縣,竹北市,鹿場里,6,1412,512,288,800,12,812
公投第１２案,新竹縣,竹北市,鹿場里,7,1400,542,329,871,13,884
公投第１２案,新竹縣,竹北市,東平里,8,1415,515,333,848,30,878
公投第１２案,新竹縣,竹北市,東平里,9,1361,460,325,785,22,807
公投第１２案,新竹縣,竹北市,東平里,10,1515,477,344,821,17,838
公投第１２案,新竹縣,竹北市,東平里,11,1495,517,357,874,22,896
公投第１２案,新竹縣,竹北市,東平里,12,1417,469,345,814,26,840
公投第１２案,新竹縣,竹北市,東平里,13,1548,470,390,860,33,893
公投第１２案,新竹縣,竹北市,東平里,14,1434,434,345,779,19,798
公投第１２案,新竹縣,竹北市,中興里,15,1385,472,308,780,36,816
公投第１２案,新竹縣,竹北市,中興里,16,1247,481,283,764,30,794
公投第１２案,新竹縣,竹北市,中興里,17,1373,448,322,770,28,798
公投第１２案,新竹縣,竹北市,中興里,18,1345,472,372,844,15,859
公投第１２案,新竹縣,竹北市,中興里,19,1165,399,243,642,33,675
公投第１２案,新竹縣,竹北市,隘口里,20,1164,426,302,728,26,754
公投第１２案,新竹縣,竹北市,隘口里,21,1212,421,303,724,33,757
公投第１２案,新竹縣,竹北市,東海里,22,1507,468,271,739,32,771
公投第１２案,新竹縣,竹北市,東海里,23,1576,515,281,796,45,841
公投第１２案,新竹縣,竹北市,東興里,24,1464,473,344,817,18,835
公投第１２案,新竹縣,竹北市,東興里,25,1428,445,350,795,23,818
公投第１２案,新竹縣,竹北市,東興里,26,1442,367,345,712,15,727
公投第１２案,新竹縣,竹北市,東興里,27,1415,483,322,805,41,846
公投第１２案,新竹縣,竹北市,北興里,28,1666,493,346,839,16,855
公投第１２案,新竹縣,竹北市,北興里,29,1751,546,370,916,24,940
公投第１２案,新竹縣,竹北市,十興里,30,1196,448,276,724,18,742
公投第１２案,新竹縣,竹北市,十興里,31,1235,461,256,717,26,743
公投第１２案,新竹縣,竹北市,十興里,32,1204,412,260,672,14,686
公投第１２案,新竹縣,竹北市,十興里,33,1308,470,309,779,26,805
公投第１２案,新竹縣,竹北市,十興里,34,1233,418,279,697,19,716
公投第１２案,新竹縣,竹北市,興安里,35,1129,453,206,659,18,677
公投第１２案,新竹縣,竹北市,興安里,36,1069,414,226,640,19,659
公投第１２案,新竹縣,竹北市,興安里,37,1114,453,243,696,18,714
公投第１２案,新竹縣,竹北市,文化里,38,1103,420,252,672,22,694
公投第１２案,新竹縣,竹北市,文化里,39,1029,393,253,646,24,670
公投第１２案,新竹縣,竹北市,文化里,40,1133,457,247,704,23,727
公投第１２案,新竹縣,竹北市,斗崙里,41,1301,453,296,749,10,759
公投第１２案,新竹縣,竹北市,斗崙里,42,1798,589,426,1015,33,1048
公投第１２案,新竹縣,竹北市,斗崙里,43,1427,525,308,833,18,851
公投第１２案,新竹縣,竹北市,斗崙里,44,1462,588,303,891,19,910
公投第１２案,新竹縣,竹北市,中崙里,45,1342,501,330,831,26,857
公投第１２案,新竹縣,竹北市,中崙里,46,1480,516,329,845,24,869
公投第１２案,新竹縣,竹北市,中崙里,47,1645,551,359,910,20,930
公投第１２案,新竹縣,竹北市,中崙里,48,1256,457,322,779,22,801
公投第１２案,新竹縣,竹北市,北崙里,49,1181,418,283,701,22,723
公投第１２案,新竹縣,竹北市,北崙里,50,1329,503,342,845,31,876
公投第１２案,新竹縣,竹北市,北崙里,51,1228,494,282,776,20,796
公投第１２案,新竹縣,竹北市,新崙里,52,1552,503,346,849,27,876
公投第１２案,新竹縣,竹北市,新崙里,53,1480,520,353,873,22,895
公投第１２案,新竹縣,竹北市,新崙里,54,1487,459,345,804,25,829
公投第１２案,新竹縣,竹北市,新崙里,55,1470,485,295,780,29,809
公投第１２案,新竹縣,竹北市,竹北里,56,1477,503,265,768,22,790
公投第１２案,新竹縣,竹北市,竹北里,57,1611,609,340,949,28,977
公投第１２案,新竹縣,竹北市,竹北里,58,1555,563,314,877,34,911
公投第１２案,新竹縣,竹北市,竹北里,59,1468,471,301,772,29,801
公投第１２案,新竹縣,竹北市,竹仁里,60,1509,558,304,862,37,899
公投第１２案,新竹縣,竹北市,竹仁里,61,1602,633,230,863,27,890
公投第１２案,新竹縣,竹北市,竹仁里,62,1448,571,276,847,24,871
公投第１２案,新竹縣,竹北市,竹仁里,63,1318,490,290,780,22,802
公投第１２案,新竹縣,竹北市,竹仁里,64,1634,605,365,970,39,1009
公投第１２案,新竹縣,竹北市,竹仁里,65,1345,487,148,635,46,681
公投第１２案,新竹縣,竹北市,福德里,66,958,427,207,634,8,642
公投第１２案,新竹縣,竹北市,福德里,67,1112,432,248,680,25,705
公投第１２案,新竹縣,竹北市,福德里,68,1134,405,229,634,38,672
公投第１２案,新竹縣,竹北市,竹義里,69,1483,504,328,832,33,865
公投第１２案,新竹縣,竹北市,竹義里,70,1332,442,272,714,36,750
公投第１２案,新竹縣,竹北市,竹義里,71,1482,472,271,743,21,764
公投第１２案,新竹縣,竹北市,竹義里,72,1449,368,234,602,21,623
公投第１２案,新竹縣,竹北市,泰和里,73,1319,465,234,699,22,721
公投第１２案,新竹縣,竹北市,泰和里,74,1332,431,271,702,28,730
公投第１２案,新竹縣,竹北市,泰和里,75,1412,432,300,732,22,754
公投第１２案,新竹縣,竹北市,泰和里,76,1640,544,314,858,28,886
公投第１２案,新竹縣,竹北市,新社里,77,1323,451,276,727,32,759
公投第１２案,新竹縣,竹北市,新社里,78,1428,491,314,805,48,853
公投第１２案,新竹縣,竹北市,新社里,79,1533,518,351,869,26,895
公投第１２案,新竹縣,竹北市,新社里,80,1346,429,282,711,26,737
公投第１２案,新竹縣,竹北市,新社里,81,1219,421,214,635,34,669
公投第１２案,新竹縣,竹北市,新國里,82,1466,539,309,848,50,898
公投第１２案,新竹縣,竹北市,新國里,83,1147,340,260,600,32,632
公投第１２案,新竹縣,竹北市,新國里,84,1529,431,289,720,39,759
公投第１２案,新竹縣,竹北市,新國里,85,1522,554,294,848,33,881
公投第１２案,新竹縣,竹北市,聯興里,86,1383,474,312,786,45,831
公投第１２案,新竹縣,竹北市,聯興里,87,1569,512,375,887,29,916
公投第１２案,新竹縣,竹北市,聯興里,88,1506,516,274,790,25,815
公投第１２案,新竹縣,竹北市,麻園里,89,877,312,179,491,17,508
公投第１２案,新竹縣,竹北市,麻園里,90,1074,352,250,602,26,628
公投第１２案,新竹縣,竹北市,溪州里,91,1089,429,250,679,30,709
公投第１２案,新竹縣,竹北市,溪州里,92,1336,459,291,750,43,793
公投第１２案,新竹縣,竹北市,新庄里,93,1058,362,211,573,34,607
公投第１２案,新竹縣,竹北市,白地里,94,937,360,222,582,43,625
公投第１２案,新竹縣,竹北市,白地里,95,1206,399,255,654,36,690
公投第１２案,新竹縣,竹北市,新港里,96,1205,392,296,688,33,721
公投第１２案,新竹縣,竹北市,大眉里,97,1718,563,411,974,57,1031
公投第１２案,新竹縣,竹北市,大義里,98,917,309,191,500,30,530
公投第１２案,新竹縣,竹北市,大義里,99,668,240,147,387,22,409
公投第１２案,新竹縣,竹北市,尚義里,100,824,261,192,453,24,477
公投第１２案,新竹縣,竹北市,尚義里,101,782,277,150,427,41,468
公投第１２案,新竹縣,竹北市,崇義里,102,977,352,199,551,48,599
公投第１２案,新竹縣,竹北市,崇義里,103,937,289,193,482,24,506
公投第１２案,新竹縣,竹東鎮,上坪里,104,309,85,64,149,6,155
公投第１２案,新竹縣,竹東鎮,瑞峰里,105,416,119,79,198,20,218
公投第１２案,新竹縣,竹東鎮,軟橋里,106,386,107,89,196,7,203
公投第１２案,新竹縣,竹東鎮,員崠里,107,950,409,60,469,23,492
公投第１２案,新竹縣,竹東鎮,員崠里,108,1275,437,219,656,24,680
公投第１２案,新竹縣,竹東鎮,上舘里,109,1213,384,245,629,28,657
公投第１２案,新竹縣,竹東鎮,上舘里,110,1548,534,309,843,32,875
公投第１２案,新竹縣,竹東鎮,上舘里,111,1246,395,236,631,31,662
公投第１２案,新竹縣,竹東鎮,上舘里,112,1252,318,235,553,28,581
公投第１２案,新竹縣,竹東鎮,上舘里,113,1359,437,259,696,27,723
公投第１２案,新竹縣,竹東鎮,上舘里,114,1255,391,258,649,29,678
公投第１２案,新竹縣,竹東鎮,上舘里,115,1304,446,274,720,32,752
公投第１２案,新竹縣,竹東鎮,東寧里,116,1292,417,271,688,40,728
公投第１２案,新竹縣,竹東鎮,東寧里,117,1111,360,204,564,20,584
公投第１２案,新竹縣,竹東鎮,東寧里,118,880,302,191,493,37,530
公投第１２案,新竹縣,竹東鎮,中正里,119,670,236,139,375,20,395
公投第１２案,新竹縣,竹東鎮,中正里,120,1244,425,266,691,35,726
公投第１２案,新竹縣,竹東鎮,大鄉里,121,1126,346,229,575,35,610
公投第１２案,新竹縣,竹東鎮,大鄉里,122,1073,344,200,544,48,592
公投第１２案,新竹縣,竹東鎮,大鄉里,123,1215,402,263,665,31,696
公投第１２案,新竹縣,竹東鎮,大鄉里,124,1155,414,233,647,15,662
公投第１２案,新竹縣,竹東鎮,中山里,125,852,271,195,466,24,490
公投第１２案,新竹縣,竹東鎮,中山里,126,875,331,177,508,19,527
公投第１２案,新竹縣,竹東鎮,南華里,127,1070,424,204,628,26,654
公投第１２案,新竹縣,竹東鎮,東華里,128,704,233,137,370,19,389
公投第１２案,新竹縣,竹東鎮,商華里,129,951,229,127,356,26,382
公投第１２案,新竹縣,竹東鎮,商華里,130,984,334,228,562,11,573
公投第１２案,新竹縣,竹東鎮,商華里,131,1113,302,189,491,15,506
公投第１２案,新竹縣,竹東鎮,竹東里,132,595,228,108,336,20,356
公投第１２案,新竹縣,竹東鎮,竹東里,133,762,273,164,437,33,470
公投第１２案,新竹縣,竹東鎮,忠孝里,134,763,250,158,408,18,426
公投第１２案,新竹縣,竹東鎮,忠孝里,135,813,265,150,415,17,432
公投第１２案,新竹縣,竹東鎮,鷄林里,136,1310,390,218,608,30,638
公投第１２案,新竹縣,竹東鎮,鷄林里,137,1434,351,321,672,33,705
公投第１２案,新竹縣,竹東鎮,鷄林里,138,1131,396,225,621,25,646
公投第１２案,新竹縣,竹東鎮,仁愛里,139,967,300,218,518,14,532
公投第１２案,新竹縣,竹東鎮,仁愛里,140,1196,369,215,584,29,613
公投第１２案,新竹縣,竹東鎮,仁愛里,141,1154,410,228,638,19,657
公投第１２案,新竹縣,竹東鎮,榮樂里,142,715,251,159,410,30,440
公投第１２案,新竹縣,竹東鎮,榮樂里,143,685,235,156,391,20,411
公投第１２案,新竹縣,竹東鎮,榮華里,144,1352,433,252,685,33,718
公投第１２案,新竹縣,竹東鎮,榮華里,145,1407,493,266,759,47,806
公投第１２案,新竹縣,竹東鎮,榮華里,146,1362,496,234,730,23,753
公投第１２案,新竹縣,竹東鎮,榮華里,147,1330,510,233,743,31,774
公投第１２案,新竹縣,竹東鎮,榮華里,148,1441,481,258,739,45,784
公投第１２案,新竹縣,竹東鎮,五豐里,149,1248,375,258,633,20,653
公投第１２案,新竹縣,竹東鎮,五豐里,150,1263,339,234,573,11,584
公投第１２案,新竹縣,竹東鎮,五豐里,151,1232,351,246,597,24,621
公投第１２案,新竹縣,竹東鎮,五豐里,152,1143,321,196,517,24,541
公投第１２案,新竹縣,竹東鎮,五豐里,153,1529,515,305,820,24,844
公投第１２案,新竹縣,竹東鎮,五豐里,154,1140,361,239,600,28,628
公投第１２案,新竹縣,竹東鎮,陸豐里,155,570,208,141,349,17,366
公投第１２案,新竹縣,竹東鎮,三重里,156,1345,412,236,648,24,672
公投第１２案,新竹縣,竹東鎮,三重里,157,1381,437,264,701,41,742
公投第１２案,新竹縣,竹東鎮,三重里,158,1379,445,292,737,28,765
公投第１２案,新竹縣,竹東鎮,三重里,159,1033,386,194,580,23,603
公投第１２案,新竹縣,竹東鎮,三重里,160,1066,357,205,562,25,587
公投第１２案,新竹縣,竹東鎮,二重里,161,938,358,169,527,29,556
公投第１２案,新竹縣,竹東鎮,二重里,162,952,365,194,559,30,589
公投第１２案,新竹縣,竹東鎮,二重里,163,1468,561,285,846,36,882
公投第１２案,新竹縣,竹東鎮,二重里,164,1915,513,450,963,21,984
公投第１２案,新竹縣,竹東鎮,二重里,165,1220,393,231,624,25,649
公投第１２案,新竹縣,竹東鎮,二重里,166,1166,319,198,517,17,534
公投第１２案,新竹縣,竹東鎮,二重里,167,1492,460,255,715,18,733
公投第１２案,新竹縣,竹東鎮,二重里,168,1245,405,233,638,31,669
公投第１２案,新竹縣,竹東鎮,頭重里,169,1083,367,228,595,30,625
公投第１２案,新竹縣,竹東鎮,頭重里,170,1102,322,268,590,20,610
公投第１２案,新竹縣,竹東鎮,頭重里,171,1068,374,124,498,23,521
公投第１２案,新竹縣,竹東鎮,頭重里,172,1097,385,222,607,19,626
公投第１２案,新竹縣,竹東鎮,員山里,173,962,327,182,509,19,528
公投第１２案,新竹縣,竹東鎮,員山里,174,909,301,216,517,17,534
公投第１２案,新竹縣,竹東鎮,柯湖里,175,603,170,115,285,18,303
公投第１２案,新竹縣,新埔鎮,新埔里,176,983,364,200,564,25,589
公投第１２案,新竹縣,新埔鎮,新生里,177,597,209,142,351,18,369
公投第１２案,新竹縣,新埔鎮,新民里,178,1070,378,212,590,21,611
公投第１２案,新竹縣,新埔鎮,田新里,179,935,365,175,540,24,564
公投第１２案,新竹縣,新埔鎮,田新里,180,753,255,163,418,19,437
公投第１２案,新竹縣,新埔鎮,田新里,181,838,321,207,528,24,552
公投第１２案,新竹縣,新埔鎮,旱坑里,182,924,294,200,494,34,528
公投第１２案,新竹縣,新埔鎮,旱坑里,183,905,248,195,443,19,462
公投第１２案,新竹縣,新埔鎮,五埔里,184,948,342,174,516,23,539
公投第１２案,新竹縣,新埔鎮,五埔里,185,1017,347,203,550,38,588
公投第１２案,新竹縣,新埔鎮,四座里,186,1176,444,248,692,30,722
公投第１２案,新竹縣,新埔鎮,四座里,187,1122,423,243,666,32,698
公投第１２案,新竹縣,新埔鎮,四座里,188,1022,266,211,477,17,494
公投第１２案,新竹縣,新埔鎮,照門里,189,1429,393,281,674,40,714
公投第１２案,新竹縣,新埔鎮,清水里,190,451,171,106,277,28,305
公投第１２案,新竹縣,新埔鎮,鹿鳴里,191,724,220,179,399,18,417
公投第１２案,新竹縣,新埔鎮,新北里,192,617,209,152,361,34,395
公投第１２案,新竹縣,新埔鎮,巨埔里,193,1144,365,270,635,49,684
公投第１２案,新竹縣,新埔鎮,內立里,194,1139,382,242,624,35,659
公投第１２案,新竹縣,新埔鎮,寶石里,195,861,304,170,474,16,490
公投第１２案,新竹縣,新埔鎮,文山里,196,1093,299,234,533,28,561
公投第１２案,新竹縣,新埔鎮,文山里,197,978,294,179,473,31,504
公投第１２案,新竹縣,新埔鎮,文山里,198,1040,320,166,486,21,507
公投第１２案,新竹縣,新埔鎮,文山里,199,1160,381,212,593,28,621
公投第１２案,新竹縣,新埔鎮,上寮里,200,950,341,213,554,26,580
公投第１２案,新竹縣,新埔鎮,上寮里,201,882,302,175,477,24,501
公投第１２案,新竹縣,新埔鎮,下寮里,202,1281,425,276,701,41,742
公投第１２案,新竹縣,新埔鎮,下寮里,203,1212,376,244,620,30,650
公投第１２案,新竹縣,新埔鎮,南平里,204,1013,311,144,455,31,486
公投第１２案,新竹縣,新埔鎮,北平里,205,630,226,149,375,27,402
公投第１２案,新竹縣,關西鎮,東興里,206,480,175,120,295,13,308
公投第１２案,新竹縣,關西鎮,西安里,207,903,341,177,518,25,543
公投第１２案,新竹縣,關西鎮,西安里,208,1020,334,227,561,33,594
公投第１２案,新竹縣,關西鎮,南雄里,209,705,275,129,404,11,415
公投第１２案,新竹縣,關西鎮,北斗里,210,1056,341,209,550,26,576
公投第１２案,新竹縣,關西鎮,北斗里,211,1275,401,262,663,32,695
公投第１２案,新竹縣,關西鎮,北斗里,212,1287,441,273,714,42,756
公投第１２案,新竹縣,關西鎮,北山里,213,771,259,161,420,46,466
公投第１２案,新竹縣,關西鎮,仁安里,214,1046,325,205,530,42,572
公投第１２案,新竹縣,關西鎮,南山里,215,1030,374,201,575,29,604
公投第１２案,新竹縣,關西鎮,東安里,216,1208,410,244,654,34,688
公投第１２案,新竹縣,關西鎮,東安里,217,1095,357,174,531,16,547
公投第１２案,新竹縣,關西鎮,東安里,218,1350,409,251,660,55,715
公投第１２案,新竹縣,關西鎮,東山里,219,846,335,177,512,25,537
公投第１２案,新竹縣,關西鎮,東光里,220,1362,453,248,701,46,747
公投第１２案,新竹縣,關西鎮,南新里,221,903,287,169,456,21,477
公投第１２案,新竹縣,關西鎮,新富里,222,551,148,104,252,19,271
公投第１２案,新竹縣,關西鎮,玉山里,223,461,102,73,175,16,191
公投第１２案,新竹縣,關西鎮,金山里,224,572,185,109,294,25,319
公投第１２案,新竹縣,關西鎮,錦山里,225,943,259,216,475,36,511
公投第１２案,新竹縣,關西鎮,大同里,226,808,270,167,437,36,473
公投第１２案,新竹縣,關西鎮,石光里,227,923,374,208,582,20,602
公投第１２案,新竹縣,關西鎮,石光里,228,903,313,203,516,21,537
公投第１２案,新竹縣,關西鎮,東平里,229,977,359,181,540,36,576
公投第１２案,新竹縣,關西鎮,上林里,230,824,304,179,483,34,517
公投第１２案,新竹縣,關西鎮,新力里,231,559,217,129,346,16,362
公投第１２案,新竹縣,關西鎮,南和里,232,854,303,203,506,28,534
公投第１２案,新竹縣,湖口鄉,和興村,233,1393,409,279,688,36,724
公投第１２案,新竹縣,湖口鄉,和興村,234,1505,510,330,840,33,873
公投第１２案,新竹縣,湖口鄉,東興村,235,1188,446,289,735,33,768
公投第１２案,新竹縣,湖口鄉,東興村,236,1267,434,269,703,35,738
公投第１２案,新竹縣,湖口鄉,東興村,237,1668,568,363,931,24,955
公投第１２案,新竹縣,湖口鄉,德盛村,238,1719,576,380,956,42,998
公投第１２案,新竹縣,湖口鄉,德盛村,239,1162,413,276,689,33,722
公投第１２案,新竹縣,湖口鄉,德盛村,240,1833,502,353,855,47,902
公投第１２案,新竹縣,湖口鄉,愛勢村,241,1444,496,300,796,32,828
公投第１２案,新竹縣,湖口鄉,愛勢村,242,1347,517,276,793,45,838
公投第１２案,新竹縣,湖口鄉,愛勢村,243,1202,433,270,703,17,720
公投第１２案,新竹縣,湖口鄉,仁勢村,244,851,311,184,495,23,518
公投第１２案,新竹縣,湖口鄉,孝勢村,245,1272,443,279,722,44,766
公投第１２案,新竹縣,湖口鄉,中勢村,246,1275,453,248,701,28,729
公投第１２案,新竹縣,湖口鄉,中勢村,247,1560,669,264,933,39,972
公投第１２案,新竹縣,湖口鄉,中正村,248,1147,420,261,681,56,737
公投第１２案,新竹縣,湖口鄉,中正村,249,1729,601,334,935,42,977
公投第１２案,新竹縣,湖口鄉,信勢村,250,1402,448,270,718,38,756
公投第１２案,新竹縣,湖口鄉,信勢村,251,1183,410,256,666,39,705
公投第１２案,新竹縣,湖口鄉,信勢村,252,1282,430,303,733,29,762
公投第１２案,新竹縣,湖口鄉,信勢村,253,1335,458,296,754,52,806
公投第１２案,新竹縣,湖口鄉,信義村,254,1493,554,357,911,23,934
公投第１２案,新竹縣,湖口鄉,信義村,255,1877,616,388,1004,15,1019
公投第１２案,新竹縣,湖口鄉,波羅村,256,1082,406,213,619,44,663
公投第１２案,新竹縣,湖口鄉,波羅村,257,1115,383,255,638,49,687
公投第１２案,新竹縣,湖口鄉,長嶺村,258,1193,356,236,592,36,628
公投第１２案,新竹縣,湖口鄉,長嶺村,259,1947,615,384,999,47,1046
公投第１２案,新竹縣,湖口鄉,長安村,260,1125,363,276,639,38,677
公投第１２案,新竹縣,湖口鄉,湖口村,261,1050,342,224,566,43,609
公投第１２案,新竹縣,湖口鄉,湖口村,262,1733,574,401,975,31,1006
公投第１２案,新竹縣,湖口鄉,湖鏡村,263,1284,443,281,724,34,758
公投第１２案,新竹縣,湖口鄉,湖鏡村,264,1062,398,205,603,31,634
公投第１２案,新竹縣,湖口鄉,湖南村,265,1547,542,302,844,38,882
公投第１２案,新竹縣,湖口鄉,中興村,266,1494,475,254,729,26,755
公投第１２案,新竹縣,湖口鄉,中興村,267,1634,467,284,751,28,779
公投第１２案,新竹縣,湖口鄉,中興村,268,1444,387,279,666,20,686
公投第１２案,新竹縣,湖口鄉,中興村,269,1324,426,266,692,14,706
公投第１２案,新竹縣,湖口鄉,鳳凰村,270,1058,347,226,573,28,601
公投第１２案,新竹縣,湖口鄉,鳳凰村,271,1220,308,203,511,24,535
公投第１２案,新竹縣,湖口鄉,鳳凰村,272,1333,432,290,722,28,750
公投第１２案,新竹縣,湖口鄉,鳳凰村,273,1461,433,291,724,43,767
公投第１２案,新竹縣,湖口鄉,勝利村,274,1429,475,299,774,29,803
公投第１２案,新竹縣,湖口鄉,勝利村,275,1506,416,282,698,21,719
公投第１２案,新竹縣,湖口鄉,勝利村,276,1103,421,214,635,36,671
公投第１２案,新竹縣,湖口鄉,鳳山村,277,1495,448,265,713,28,741
公投第１２案,新竹縣,湖口鄉,鳳山村,278,752,265,143,408,27,435
公投第１２案,新竹縣,湖口鄉,鳳山村,279,986,302,225,527,21,548
公投第１２案,新竹縣,新豐鄉,福興村,280,1080,336,206,542,36,578
公投第１２案,新竹縣,新豐鄉,青埔村,281,887,272,178,450,20,470
公投第１２案,新竹縣,新豐鄉,青埔村,282,954,280,225,505,31,536
公投第１２案,新竹縣,新豐鄉,中崙村,283,1003,350,199,549,27,576
公投第１２案,新竹縣,新豐鄉,中崙村,284,1106,340,241,581,23,604
公投第１２案,新竹縣,新豐鄉,中崙村,285,1123,372,245,617,38,655
公投第１２案,新竹縣,新豐鄉,瑞興村,286,891,275,212,487,41,528
公投第１２案,新竹縣,新豐鄉,瑞興村,287,874,242,179,421,18,439
公投第１２案,新竹縣,新豐鄉,後湖村,288,824,251,200,451,22,473
公投第１２案,新竹縣,新豐鄉,後湖村,289,975,285,173,458,31,489
公投第１２案,新竹縣,新豐鄉,坡頭村,290,847,300,188,488,30,518
公投第１２案,新竹縣,新豐鄉,埔和村,291,1477,471,320,791,45,836
公投第１２案,新竹縣,新豐鄉,埔和村,292,1266,359,271,630,43,673
公投第１２案,新竹縣,新豐鄉,新豐村,293,1029,313,203,516,44,560
公投第１２案,新竹縣,新豐鄉,新豐村,294,1063,344,208,552,27,579
公投第１２案,新竹縣,新豐鄉,員山村,295,1055,364,237,601,14,615
公投第１２案,新竹縣,新豐鄉,員山村,296,1445,495,298,793,20,813
公投第１２案,新竹縣,新豐鄉,忠孝村,297,1413,517,332,849,19,868
公投第１２案,新竹縣,新豐鄉,忠孝村,298,971,383,211,594,28,622
公投第１２案,新竹縣,新豐鄉,忠孝村,299,1135,415,249,664,22,686
公投第１２案,新竹縣,新豐鄉,山崎村,300,1269,410,236,646,35,681
公投第１２案,新竹縣,新豐鄉,山崎村,301,1257,428,258,686,29,715
公投第１２案,新竹縣,新豐鄉,山崎村,302,1662,595,339,934,32,966
公投第１２案,新竹縣,新豐鄉,上坑村,303,1486,453,298,751,20,771
公投第１２案,新竹縣,新豐鄉,鳳坑村,304,1067,389,248,637,33,670
公投第１２案,新竹縣,新豐鄉,重興村,305,1302,517,242,759,29,788
公投第１２案,新竹縣,新豐鄉,重興村,306,1410,483,279,762,31,793
公投第１２案,新竹縣,新豐鄉,重興村,307,1267,462,212,674,21,695
公投第１２案,新竹縣,新豐鄉,重興村,308,1258,398,211,609,23,632
公投第１２案,新竹縣,新豐鄉,崎頂村,309,1217,385,121,506,21,527
公投第１２案,新竹縣,新豐鄉,崎頂村,310,1456,490,286,776,26,802
公投第１２案,新竹縣,新豐鄉,松林村,311,1157,425,230,655,24,679
公投第１２案,新竹縣,新豐鄉,松林村,312,1089,387,170,557,21,578
公投第１２案,新竹縣,新豐鄉,松林村,313,1160,407,246,653,16,669
公投第１２案,新竹縣,新豐鄉,松林村,314,976,406,193,599,15,614
公投第１２案,新竹縣,新豐鄉,松柏村,315,1443,478,305,783,32,815
公投第１２案,新竹縣,新豐鄉,松柏村,316,1247,377,236,613,21,634
公投第１２案,新竹縣,新豐鄉,松柏村,317,1411,492,278,770,24,794
公投第１２案,新竹縣,新豐鄉,松柏村,318,1238,466,227,693,43,736
公投第１２案,新竹縣,芎林鄉,華龍村,319,417,140,92,232,15,247
公投第１２案,新竹縣,芎林鄉,五龍村,320,534,206,150,356,24,380
公投第１２案,新竹縣,芎林鄉,秀湖村,321,963,331,208,539,27,566
公投第１２案,新竹縣,芎林鄉,永興村,322,418,154,101,255,17,272
公投第１２案,新竹縣,芎林鄉,石潭村,323,1312,443,256,699,29,728
公投第１２案,新竹縣,芎林鄉,石潭村,324,1354,385,271,656,30,686
公投第１２案,新竹縣,芎林鄉,新鳳村,325,785,261,190,451,26,477
公投第１２案,新竹縣,芎林鄉,新鳳村,326,797,260,160,420,69,489
公投第１２案,新竹縣,芎林鄉,中坑村,327,623,245,136,381,21,402
公投第１２案,新竹縣,芎林鄉,水坑村,328,759,335,104,439,15,454
公投第１２案,新竹縣,芎林鄉,文林村,329,1272,382,222,604,45,649
公投第１２案,新竹縣,芎林鄉,文林村,330,1129,418,224,642,33,675
公投第１２案,新竹縣,芎林鄉,芎林村,331,713,279,142,421,24,445
公投第１２案,新竹縣,芎林鄉,芎林村,332,839,321,178,499,24,523
公投第１２案,新竹縣,芎林鄉,上山村,333,1123,466,250,716,28,744
公投第１２案,新竹縣,芎林鄉,上山村,334,981,376,204,580,15,595
公投第１２案,新竹縣,芎林鄉,上山村,335,1078,383,235,618,40,658
公投第１２案,新竹縣,芎林鄉,上山村,336,1094,372,202,574,23,597
公投第１２案,新竹縣,芎林鄉,下山村,337,1102,371,245,616,40,656
公投第１２案,新竹縣,橫山鄉,橫山村,338,1231,403,286,689,62,751
公投第１２案,新竹縣,橫山鄉,橫山村,339,1041,357,229,586,44,630
公投第１２案,新竹縣,橫山鄉,橫山村,340,1132,362,291,653,33,686
公投第１２案,新竹縣,橫山鄉,田寮村,341,859,313,189,502,34,536
公投第１２案,新竹縣,橫山鄉,南昌村,342,204,70,44,114,7,121
公投第１２案,新竹縣,橫山鄉,豐鄉村,343,222,55,42,97,5,102
公投第１２案,新竹縣,橫山鄉,豐田村,344,338,109,79,188,31,219
公投第１２案,新竹縣,橫山鄉,內灣村,345,916,248,226,474,21,495
公投第１２案,新竹縣,橫山鄉,力行村,346,573,145,84,229,13,242
公投第１２案,新竹縣,橫山鄉,力行村,347,275,95,84,179,12,191
公投第１２案,新竹縣,橫山鄉,福興村,348,463,137,76,213,16,229
公投第１２案,新竹縣,橫山鄉,沙坑村,349,690,238,169,407,35,442
公投第１２案,新竹縣,橫山鄉,沙坑村,350,288,88,52,140,11,151
公投第１２案,新竹縣,橫山鄉,新興村,351,685,249,155,404,40,444
公投第１２案,新竹縣,橫山鄉,新興村,352,868,298,205,503,34,537
公投第１２案,新竹縣,橫山鄉,大肚村,353,1561,554,351,905,61,966
公投第１２案,新竹縣,北埔鄉,北埔村,354,1158,377,215,592,21,613
公投第１２案,新竹縣,北埔鄉,南興村,355,1238,425,277,702,39,741
公投第１２案,新竹縣,北埔鄉,大湖村,356,580,180,145,325,17,342
公投第１２案,新竹縣,北埔鄉,埔尾村,357,931,322,200,522,27,549
公投第１２案,新竹縣,北埔鄉,埔尾村,358,1653,552,333,885,49,934
公投第１２案,新竹縣,北埔鄉,水磜村,359,845,248,200,448,37,485
公投第１２案,新竹縣,北埔鄉,南埔村,360,384,137,74,211,11,222
公投第１２案,新竹縣,北埔鄉,大林村,361,763,265,147,412,17,429
公投第１２案,新竹縣,北埔鄉,南坑村,362,333,102,67,169,16,185
公投第１２案,新竹縣,北埔鄉,外坪村,363,295,97,52,149,13,162
公投第１２案,新竹縣,寶山鄉,雙溪村,364,1158,390,248,638,47,685
公投第１２案,新竹縣,寶山鄉,雙溪村,365,1437,468,367,835,22,857
公投第１２案,新竹縣,寶山鄉,雙新村,366,1470,463,336,799,39,838
公投第１２案,新竹縣,寶山鄉,雙新村,367,1170,399,271,670,40,710
公投第１２案,新竹縣,寶山鄉,大崎村,368,1900,654,403,1057,47,1104
公投第１２案,新竹縣,寶山鄉,三峰村,369,1056,324,199,523,19,542
公投第１２案,新竹縣,寶山鄉,新城村,370,1205,443,276,719,39,758
公投第１２案,新竹縣,寶山鄉,寶斗村,371,766,248,161,409,32,441
公投第１２案,新竹縣,寶山鄉,深井村,372,846,281,207,488,31,519
公投第１２案,新竹縣,寶山鄉,寶山村,373,804,269,190,459,34,493
公投第１２案,新竹縣,寶山鄉,油田村,374,607,213,148,361,13,374
公投第１２案,新竹縣,寶山鄉,山湖村,375,554,208,146,354,10,364
公投第１２案,新竹縣,峨眉鄉,峨眉村,376,879,341,195,536,39,575
公投第１２案,新竹縣,峨眉鄉,中盛村,377,683,255,141,396,37,433
公投第１２案,新竹縣,峨眉鄉,石井村,378,604,210,127,337,30,367
公投第１２案,新竹縣,峨眉鄉,七星村,379,339,137,56,193,6,199
公投第１２案,新竹縣,峨眉鄉,七星村,380,276,70,50,120,5,125
公投第１２案,新竹縣,峨眉鄉,富興村,381,1406,542,255,797,61,858
公投第１２案,新竹縣,峨眉鄉,湖光村,382,462,177,90,267,22,289
公投第１２案,新竹縣,峨眉鄉,湖光村,383,419,109,104,213,15,228
公投第１２案,新竹縣,尖石鄉,嘉樂村,384,474,156,90,246,5,251
公投第１２案,新竹縣,尖石鄉,嘉樂村,385,357,148,56,204,5,209
公投第１２案,新竹縣,尖石鄉,義興村,386,225,63,31,94,17,111
公投第１２案,新竹縣,尖石鄉,義興村,387,374,156,62,218,9,227
公投第１２案,新竹縣,尖石鄉,新樂村,388,773,298,123,421,13,434
公投第１２案,新竹縣,尖石鄉,新樂村,389,490,269,74,343,8,351
公投第１２案,新竹縣,尖石鄉,錦屏村,390,531,185,78,263,7,270
公投第１２案,新竹縣,尖石鄉,錦屏村,391,660,271,122,393,15,408
公投第１２案,新竹縣,尖石鄉,梅花村,392,613,301,111,412,19,431
公投第１２案,新竹縣,尖石鄉,玉峰村,393,593,202,115,317,3,320
公投第１２案,新竹縣,尖石鄉,玉峰村,394,575,210,113,323,16,339
公投第１２案,新竹縣,尖石鄉,玉峰村,395,126,59,19,78,6,84
公投第１２案,新竹縣,尖石鄉,秀巒村,396,499,204,68,272,8,280
公投第１２案,新竹縣,尖石鄉,秀巒村,397,785,207,144,351,28,379
公投第１２案,新竹縣,尖石鄉,秀巒村,398,289,119,72,191,10,201
公投第１２案,新竹縣,五峰鄉,大隘村,399,672,287,130,417,15,432
公投第１２案,新竹縣,五峰鄉,大隘村,400,713,212,134,346,17,363
公投第１２案,新竹縣,五峰鄉,桃山村,401,594,163,101,264,10,274
公投第１２案,新竹縣,五峰鄉,桃山村,402,896,300,152,452,32,484
公投第１２案,新竹縣,五峰鄉,花園村,403,727,275,124,399,9,408
公投第１２案,新竹縣,五峰鄉,竹林村,404,395,120,115,235,7,242
公投第１２案,苗栗縣,苗栗市,中苗里,1,1087,381,221,602,25,627
公投第１２案,苗栗縣,苗栗市,青苗里,2,1018,361,182,543,28,571
公投第１２案,苗栗縣,苗栗市,維祥里,3,1156,375,245,620,18,638
公投第１２案,苗栗縣,苗栗市,維祥里,4,1118,385,202,587,29,616
公投第１２案,苗栗縣,苗栗市,維祥里,5,1084,382,215,597,37,634
公投第１２案,苗栗縣,苗栗市,維新里,6,1203,398,278,676,41,717
公投第１２案,苗栗縣,苗栗市,維新里,7,1306,509,242,751,36,787
公投第１２案,苗栗縣,苗栗市,維新里,8,1193,425,264,689,32,721
公投第１２案,苗栗縣,苗栗市,玉清里,9,1115,403,241,644,15,659
公投第１２案,苗栗縣,苗栗市,玉清里,10,1119,436,212,648,38,686
公投第１２案,苗栗縣,苗栗市,玉華里,11,1132,400,269,669,27,696
公投第１２案,苗栗縣,苗栗市,玉華里,12,1289,457,250,707,38,745
公投第１２案,苗栗縣,苗栗市,玉華里,13,1264,432,292,724,32,756
公投第１２案,苗栗縣,苗栗市,綠苗里,14,870,331,142,473,22,495
公投第１２案,苗栗縣,苗栗市,高苗里,15,1008,306,178,484,29,513
公投第１２案,苗栗縣,苗栗市,高苗里,16,1078,342,210,552,20,572
公投第１２案,苗栗縣,苗栗市,高苗里,17,1077,386,247,633,22,655
公投第１２案,苗栗縣,苗栗市,新苗里,18,880,322,170,492,27,519
公投第１２案,苗栗縣,苗栗市,玉苗里,19,894,294,178,472,31,503
公投第１２案,苗栗縣,苗栗市,大同里,20,522,187,96,283,22,305
公投第１２案,苗栗縣,苗栗市,恭敬里,21,1376,519,302,821,47,868
公投第１２案,苗栗縣,苗栗市,水源里,22,1391,463,276,739,31,770
公投第１２案,苗栗縣,苗栗市,水源里,23,1081,389,234,623,30,653
公投第１２案,苗栗縣,苗栗市,勝利里,24,1272,424,261,685,26,711
公投第１２案,苗栗縣,苗栗市,勝利里,25,1112,459,221,680,36,716
公投第１２案,苗栗縣,苗栗市,勝利里,26,813,326,200,526,21,547
公投第１２案,苗栗縣,苗栗市,勝利里,27,767,268,152,420,18,438
公投第１２案,苗栗縣,苗栗市,清華里,28,1010,342,219,561,17,578
公投第１２案,苗栗縣,苗栗市,清華里,29,1182,426,215,641,25,666
公投第１２案,苗栗縣,苗栗市,清華里,30,965,350,187,537,19,556
公投第１２案,苗栗縣,苗栗市,上苗里,31,607,224,130,354,11,365
公投第１２案,苗栗縣,苗栗市,上苗里,32,990,370,220,590,24,614
公投第１２案,苗栗縣,苗栗市,北苗里,33,1230,379,214,593,61,654
公投第１２案,苗栗縣,苗栗市,北苗里,34,1372,476,287,763,35,798
公投第１２案,苗栗縣,苗栗市,北苗里,35,1213,421,253,674,39,713
公投第１２案,苗栗縣,苗栗市,北苗里,36,1272,452,242,694,31,725
公投第１２案,苗栗縣,苗栗市,嘉盛里,37,1221,494,229,723,28,751
公投第１２案,苗栗縣,苗栗市,嘉盛里,38,1104,371,230,601,46,647
公投第１２案,苗栗縣,苗栗市,嘉盛里,39,1171,374,244,618,12,630
公投第１２案,苗栗縣,苗栗市,福星里,40,1392,471,281,752,34,786
公投第１２案,苗栗縣,苗栗市,福星里,41,1356,468,297,765,31,796
公投第１２案,苗栗縣,苗栗市,福星里,42,1387,481,285,766,41,807
公投第１２案,苗栗縣,苗栗市,福安里,43,1206,409,240,649,25,674
公投第１２案,苗栗縣,苗栗市,福安里,44,1004,362,253,615,25,640
公投第１２案,苗栗縣,苗栗市,福安里,45,1202,400,256,656,19,675
公投第１２案,苗栗縣,苗栗市,嘉新里,46,1052,375,240,615,26,641
公投第１２案,苗栗縣,苗栗市,嘉新里,47,873,334,188,522,20,542
公投第１２案,苗栗縣,苗栗市,嘉新里,48,975,407,210,617,35,652
公投第１２案,苗栗縣,苗栗市,建功里,49,1003,409,206,615,28,643
公投第１２案,苗栗縣,苗栗市,建功里,50,1000,345,226,571,14,585
公投第１２案,苗栗縣,苗栗市,建功里,51,1047,259,197,456,34,490
公投第１２案,苗栗縣,苗栗市,建功里,52,1025,392,211,603,26,629
公投第１２案,苗栗縣,苗栗市,福麗里,53,1130,333,261,594,17,611
公投第１２案,苗栗縣,苗栗市,福麗里,54,1146,388,238,626,26,652
公投第１２案,苗栗縣,苗栗市,福麗里,55,1432,505,301,806,26,832
公投第１２案,苗栗縣,苗栗市,福麗里,56,1492,463,215,678,36,714
公投第１２案,苗栗縣,苗栗市,文山里,57,1125,424,242,666,27,693
公投第１２案,苗栗縣,苗栗市,文山里,58,1241,408,253,661,34,695
公投第１２案,苗栗縣,苗栗市,文山里,59,1278,476,261,737,34,771
公投第１２案,苗栗縣,苗栗市,文聖里,60,1293,446,266,712,18,730
公投第１２案,苗栗縣,苗栗市,文聖里,61,1342,438,253,691,25,716
公投第１２案,苗栗縣,苗栗市,文聖里,62,857,273,179,452,26,478
公投第１２案,苗栗縣,苗栗市,新川里,63,1180,386,231,617,30,647
公投第１２案,苗栗縣,苗栗市,南勢里,64,1072,361,255,616,20,636
公投第１２案,苗栗縣,苗栗市,南勢里,65,912,295,183,478,30,508
公投第１２案,苗栗縣,苗栗市,新英里,66,796,258,145,403,23,426
公投第１２案,苗栗縣,苗栗市,新英里,67,869,240,181,421,19,440
公投第１２案,苗栗縣,公館鄉,館中村,68,789,298,195,493,30,523
公投第１２案,苗栗縣,公館鄉,館中村,69,792,306,195,501,24,525
公投第１２案,苗栗縣,公館鄉,館東村,70,1117,411,255,666,51,717
公投第１２案,苗栗縣,公館鄉,館東村,71,1255,452,294,746,45,791
公投第１２案,苗栗縣,公館鄉,館南村,72,1141,373,278,651,31,682
公投第１２案,苗栗縣,公館鄉,館南村,73,1172,376,273,649,38,687
公投第１２案,苗栗縣,公館鄉,館南村,74,1100,382,278,660,37,697
公投第１２案,苗栗縣,公館鄉,中義村,75,1232,363,250,613,38,651
公投第１２案,苗栗縣,公館鄉,中義村,76,1081,319,211,530,44,574
公投第１２案,苗栗縣,公館鄉,玉泉村,77,1250,460,277,737,41,778
公投第１２案,苗栗縣,公館鄉,玉泉村,78,1081,369,232,601,30,631
公投第１２案,苗栗縣,公館鄉,大坑村,79,964,288,213,501,52,553
公投第１２案,苗栗縣,公館鄉,福基村,80,1038,356,224,580,48,628
公投第１２案,苗栗縣,公館鄉,福德村,81,360,122,92,214,13,227
公投第１２案,苗栗縣,公館鄉,福星村,82,865,278,185,463,35,498
公投第１２案,苗栗縣,公館鄉,福星村,83,1166,371,257,628,24,652
公投第１２案,苗栗縣,公館鄉,石墻村,84,719,246,153,399,30,429
公投第１２案,苗栗縣,公館鄉,石墻村,85,788,236,161,397,38,435
公投第１２案,苗栗縣,公館鄉,開礦村,86,303,97,87,184,18,202
公投第１２案,苗栗縣,公館鄉,五谷村,87,1322,441,307,748,49,797
公投第１２案,苗栗縣,公館鄉,五谷村,88,933,262,228,490,44,534
公投第１２案,苗栗縣,公館鄉,玉谷村,89,1455,428,300,728,62,790
公投第１２案,苗栗縣,公館鄉,鶴岡村,90,1615,512,397,909,89,998
公投第１２案,苗栗縣,公館鄉,鶴山村,91,1451,466,277,743,63,806
公投第１２案,苗栗縣,公館鄉,尖山村,92,1462,447,376,823,59,882
公投第１２案,苗栗縣,公館鄉,仁安村,93,1317,373,323,696,41,737
公投第１２案,苗栗縣,公館鄉,南河村,94,221,77,46,123,8,131
公投第１２案,苗栗縣,公館鄉,北河村,95,329,100,65,165,10,175
公投第１２案,苗栗縣,頭屋鄉,頭屋村,96,1335,551,284,835,59,894
公投第１２案,苗栗縣,頭屋鄉,頭屋村,97,1168,483,271,754,75,829
公投第１２案,苗栗縣,頭屋鄉,獅潭村,98,792,312,178,490,29,519
公投第１２案,苗栗縣,頭屋鄉,獅潭村,99,918,391,243,634,24,658
公投第１２案,苗栗縣,頭屋鄉,北坑村,100,725,273,164,437,28,465
公投第１２案,苗栗縣,頭屋鄉,曲洞村,101,899,300,227,527,28,555
公投第１２案,苗栗縣,頭屋鄉,飛鳳村,102,369,122,53,175,8,183
公投第１２案,苗栗縣,頭屋鄉,象山村,103,844,282,207,489,15,504
公投第１２案,苗栗縣,頭屋鄉,象山村,104,1007,342,247,589,25,614
公投第１２案,苗栗縣,頭屋鄉,明德村,105,794,289,192,481,22,503
公投第１２案,苗栗縣,頭屋鄉,明德村,106,211,94,49,143,14,157
公投第１２案,苗栗縣,頭屋鄉,鳴鳳村,107,328,133,87,220,19,239
公投第１２案,苗栗縣,銅鑼鄉,銅鑼村,108,887,313,201,514,34,548
公投第１２案,苗栗縣,銅鑼鄉,銅鑼村,109,1052,353,224,577,54,631
公投第１２案,苗栗縣,銅鑼鄉,銅鑼村,110,1347,472,316,788,35,823
公投第１２案,苗栗縣,銅鑼鄉,銅鑼村,111,1177,351,279,630,36,666
公投第１２案,苗栗縣,銅鑼鄉,樟樹村,112,1268,369,281,650,31,681
公投第１２案,苗栗縣,銅鑼鄉,九湖村,113,1185,324,224,548,36,584
公投第１２案,苗栗縣,銅鑼鄉,福興村,114,1029,351,218,569,28,597
公投第１２案,苗栗縣,銅鑼鄉,朝陽村,115,905,321,173,494,29,523
公投第１２案,苗栗縣,銅鑼鄉,朝陽村,116,750,267,178,445,23,468
公投第１２案,苗栗縣,銅鑼鄉,竹森村,117,1080,335,185,520,39,559
公投第１２案,苗栗縣,銅鑼鄉,中平村,118,1108,326,224,550,56,606
公投第１２案,苗栗縣,銅鑼鄉,中平村,119,862,226,197,423,34,457
公投第１２案,苗栗縣,銅鑼鄉,中平村,120,1216,347,272,619,27,646
公投第１２案,苗栗縣,銅鑼鄉,興隆村,121,588,160,118,278,25,303
公投第１２案,苗栗縣,銅鑼鄉,盛隆村,122,429,110,90,200,35,235
公投第１２案,苗栗縣,銅鑼鄉,新隆村,123,541,160,123,283,34,317
公投第１２案,苗栗縣,三義鄉,廣盛村,124,853,327,163,490,34,524
公投第１２案,苗栗縣,三義鄉,廣盛村,125,983,401,191,592,20,612
公投第１２案,苗栗縣,三義鄉,廣盛村,126,1080,351,246,597,51,648
公投第１２案,苗栗縣,三義鄉,廣盛村,127,1216,406,219,625,24,649
公投第１２案,苗栗縣,三義鄉,勝興村,128,1017,356,224,580,25,605
公投第１２案,苗栗縣,三義鄉,勝興村,129,1180,388,215,603,30,633
公投第１２案,苗栗縣,三義鄉,勝興村,130,1198,422,247,669,15,684
公投第１２案,苗栗縣,三義鄉,龍騰村,131,417,131,95,226,15,241
公投第１２案,苗栗縣,三義鄉,双湖村,132,991,297,206,503,20,523
公投第１２案,苗栗縣,三義鄉,双湖村,133,834,295,171,466,24,490
公投第１２案,苗栗縣,三義鄉,双潭村,134,622,199,143,342,25,367
公投第１２案,苗栗縣,三義鄉,双潭村,135,749,232,182,414,46,460
公投第１２案,苗栗縣,三義鄉,西湖村,136,692,261,176,437,23,460
公投第１２案,苗栗縣,三義鄉,西湖村,137,759,311,184,495,40,535
公投第１２案,苗栗縣,三義鄉,鯉魚潭村,138,629,180,141,321,15,336
公投第１２案,苗栗縣,三義鄉,鯉魚潭村,139,669,208,148,356,30,386
公投第１２案,苗栗縣,西湖鄉,高埔村,140,601,167,152,319,23,342
公投第１２案,苗栗縣,西湖鄉,下埔村,141,566,190,132,322,19,341
公投第１２案,苗栗縣,西湖鄉,五湖村,142,843,263,187,450,26,476
公投第１２案,苗栗縣,西湖鄉,四湖村,143,648,195,128,323,19,342
公投第１２案,苗栗縣,西湖鄉,三湖村,144,936,255,176,431,46,477
公投第１２案,苗栗縣,西湖鄉,龍洞村,145,461,133,107,240,8,248
公投第１２案,苗栗縣,西湖鄉,金獅村,146,515,183,98,281,17,298
公投第１２案,苗栗縣,西湖鄉,湖東村,147,1141,365,209,574,41,615
公投第１２案,苗栗縣,西湖鄉,二湖村,148,671,224,148,372,24,396
公投第１２案,苗栗縣,通霄鎮,通東里,149,1142,384,247,631,41,672
公投第１２案,苗栗縣,通霄鎮,通西里,150,884,345,196,541,36,577
公投第１２案,苗栗縣,通霄鎮,通西里,151,1068,362,201,563,44,607
公投第１２案,苗栗縣,通霄鎮,平元里,152,1009,378,248,626,24,650
公投第１２案,苗栗縣,通霄鎮,平元里,153,859,359,187,546,17,563
公投第１２案,苗栗縣,通霄鎮,平安里,154,1040,361,226,587,22,609
公投第１２案,苗栗縣,通霄鎮,平安里,155,1008,301,177,478,19,497
公投第１２案,苗栗縣,通霄鎮,圳頭里,156,686,237,145,382,26,408
公投第１２案,苗栗縣,通霄鎮,梅南里,157,761,315,178,493,28,521
公投第１２案,苗栗縣,通霄鎮,梅南里,158,790,266,139,405,12,417
公投第１２案,苗栗縣,通霄鎮,通南里,159,966,311,201,512,22,534
公投第１２案,苗栗縣,通霄鎮,通南里,160,972,314,158,472,33,505
公投第１２案,苗栗縣,通霄鎮,通南里,161,771,286,129,415,30,445
公投第１２案,苗栗縣,通霄鎮,內湖里,162,758,191,154,345,20,365
公投第１２案,苗栗縣,通霄鎮,內湖里,163,1078,331,215,546,39,585
公投第１２案,苗栗縣,通霄鎮,楓樹里,164,459,105,74,179,20,199
公投第１２案,苗栗縣,通霄鎮,烏眉里,165,894,255,150,405,44,449
公投第１２案,苗栗縣,通霄鎮,福龍里,166,402,92,59,151,8,159
公投第１２案,苗栗縣,通霄鎮,福源里,167,802,249,162,411,24,435
公投第１２案,苗栗縣,通霄鎮,城北里,168,684,175,170,345,14,359
公投第１２案,苗栗縣,通霄鎮,城南里,169,943,281,125,406,34,440
公投第１２案,苗栗縣,通霄鎮,南和里,170,790,267,175,442,38,480
公投第１２案,苗栗縣,通霄鎮,福興里,171,673,187,101,288,9,297
公投第１２案,苗栗縣,通霄鎮,坪頂里,172,1232,358,241,599,53,652
公投第１２案,苗栗縣,通霄鎮,五南里,173,1286,454,256,710,48,758
公投第１２案,苗栗縣,通霄鎮,五北里,174,649,224,141,365,23,388
公投第１２案,苗栗縣,通霄鎮,五北里,175,769,220,136,356,32,388
公投第１２案,苗栗縣,通霄鎮,通灣里,176,1148,343,237,580,52,632
公投第１２案,苗栗縣,通霄鎮,通灣里,177,1138,298,225,523,52,575
公投第１２案,苗栗縣,通霄鎮,新埔里,178,1121,339,234,573,14,587
公投第１２案,苗栗縣,通霄鎮,內島里,179,769,224,181,405,22,427
公投第１２案,苗栗縣,通霄鎮,白東里,180,616,157,137,294,18,312
公投第１２案,苗栗縣,通霄鎮,白東里,181,799,250,147,397,41,438
公投第１２案,苗栗縣,通霄鎮,白西里,182,743,220,145,365,20,385
公投第１２案,苗栗縣,苑裡鎮,苑東里,183,873,319,170,489,34,523
公投第１２案,苗栗縣,苑裡鎮,苑東里,184,1346,458,297,755,40,795
公投第１２案,苗栗縣,苑裡鎮,苑南里,185,951,384,211,595,38,633
公投第１２案,苗栗縣,苑裡鎮,苑南里,186,615,239,105,344,13,357
公投第１２案,苗栗縣,苑裡鎮,苑北里,187,878,338,174,512,44,556
公投第１２案,苗栗縣,苑裡鎮,西平里,188,767,294,152,446,27,473
公投第１２案,苗栗縣,苑裡鎮,西平里,189,776,262,161,423,25,448
公投第１２案,苗栗縣,苑裡鎮,苑港里,190,1231,393,211,604,65,669
公投第１２案,苗栗縣,苑裡鎮,西勢里,191,1145,395,254,649,37,686
公投第１２案,苗栗縣,苑裡鎮,西勢里,192,850,281,169,450,26,476
公投第１２案,苗栗縣,苑裡鎮,海岸里,193,1052,333,216,549,38,587
公投第１２案,苗栗縣,苑裡鎮,房裡里,194,1114,349,243,592,47,639
公投第１２案,苗栗縣,苑裡鎮,房裡里,195,1136,367,262,629,49,678
公投第１２案,苗栗縣,苑裡鎮,客庄里,196,1194,394,245,639,44,683
公投第１２案,苗栗縣,苑裡鎮,客庄里,197,1579,545,313,858,53,911
公投第１２案,苗栗縣,苑裡鎮,客庄里,198,1149,421,246,667,45,712
公投第１２案,苗栗縣,苑裡鎮,中正里,199,1057,360,238,598,45,643
公投第１２案,苗栗縣,苑裡鎮,中正里,200,1101,295,247,542,24,566
公投第１２案,苗栗縣,苑裡鎮,苑坑里,201,912,245,167,412,35,447
公投第１２案,苗栗縣,苑裡鎮,水坡里,202,652,202,138,340,27,367
公投第１２案,苗栗縣,苑裡鎮,新復里,203,1348,432,303,735,45,780
公投第１２案,苗栗縣,苑裡鎮,山脚里,204,733,209,158,367,16,383
公投第１２案,苗栗縣,苑裡鎮,山脚里,205,662,205,128,333,11,344
公投第１２案,苗栗縣,苑裡鎮,舊社里,206,893,302,184,486,29,515
公投第１２案,苗栗縣,苑裡鎮,舊社里,207,910,304,213,517,31,548
公投第１２案,苗栗縣,苑裡鎮,福田里,208,1270,398,258,656,53,709
公投第１２案,苗栗縣,苑裡鎮,石鎮里,209,545,166,105,271,21,292
公投第１２案,苗栗縣,苑裡鎮,蕉埔里,210,792,302,159,461,42,503
公投第１２案,苗栗縣,苑裡鎮,南勢里,211,726,224,179,403,14,417
公投第１２案,苗栗縣,苑裡鎮,泰田里,212,827,217,138,355,16,371
公投第１２案,苗栗縣,苑裡鎮,泰田里,213,782,255,185,440,31,471
公投第１２案,苗栗縣,苑裡鎮,上舘里,214,788,256,152,408,28,436
公投第１２案,苗栗縣,苑裡鎮,上舘里,215,846,246,188,434,33,467
公投第１２案,苗栗縣,苑裡鎮,玉田里,216,828,267,197,464,41,505
公投第１２案,苗栗縣,苑裡鎮,玉田里,217,943,301,203,504,47,551
公投第１２案,苗栗縣,苑裡鎮,社苓里,218,1082,354,258,612,30,642
公投第１２案,苗栗縣,苑裡鎮,社苓里,219,1234,405,295,700,48,748
公投第１２案,苗栗縣,苑裡鎮,山柑里,220,1434,420,314,734,54,788
公投第１２案,苗栗縣,苑裡鎮,田心里,221,987,339,205,544,27,571
公投第１２案,苗栗縣,苑裡鎮,田心里,222,882,311,213,524,39,563
公投第１２案,苗栗縣,後龍鎮,南龍里,223,590,206,118,324,25,349
公投第１２案,苗栗縣,後龍鎮,南龍里,224,883,312,213,525,43,568
公投第１２案,苗栗縣,後龍鎮,中龍里,225,793,262,205,467,30,497
公投第１２案,苗栗縣,後龍鎮,北龍里,226,732,252,169,421,21,442
公投第１２案,苗栗縣,後龍鎮,北龍里,227,592,213,134,347,17,364
公投第１２案,苗栗縣,後龍鎮,大庄里,228,1113,355,265,620,47,667
公投第１２案,苗栗縣,後龍鎮,大庄里,229,1195,385,262,647,30,677
公投第１２案,苗栗縣,後龍鎮,大庄里,230,997,368,220,588,34,622
公投第１２案,苗栗縣,後龍鎮,大庄里,231,913,256,184,440,21,461
公投第１２案,苗栗縣,後龍鎮,東明里,232,641,163,143,306,34,340
公投第１２案,苗栗縣,後龍鎮,東明里,233,848,229,187,416,36,452
公投第１２案,苗栗縣,後龍鎮,灣寶里,234,1264,387,249,636,65,701
公投第１２案,苗栗縣,後龍鎮,海寶里,235,965,265,210,475,28,503
公投第１２案,苗栗縣,後龍鎮,豐富里,236,1216,481,320,801,51,852
公投第１２案,苗栗縣,後龍鎮,校椅里,237,977,301,203,504,27,531
公投第１２案,苗栗縣,後龍鎮,埔頂里,238,943,285,158,443,33,476
公投第１２案,苗栗縣,後龍鎮,埔頂里,239,910,283,195,478,44,522
公投第１２案,苗栗縣,後龍鎮,埔頂里,240,851,255,185,440,34,474
公投第１２案,苗栗縣,後龍鎮,新民里,241,725,257,184,441,22,463
公投第１２案,苗栗縣,後龍鎮,新民里,242,650,214,155,369,21,390
公投第１２案,苗栗縣,後龍鎮,復興里,243,706,198,137,335,34,369
公投第１２案,苗栗縣,後龍鎮,大山里,244,748,220,188,408,29,437
公投第１２案,苗栗縣,後龍鎮,大山里,245,801,195,155,350,27,377
公投第１２案,苗栗縣,後龍鎮,溪洲里,246,1107,352,230,582,43,625
公投第１２案,苗栗縣,後龍鎮,溪洲里,247,1197,335,258,593,53,646
公投第１２案,苗栗縣,後龍鎮,外埔里,248,1036,288,192,480,48,528
公投第１２案,苗栗縣,後龍鎮,海埔里,249,913,229,161,390,36,426
公投第１２案,苗栗縣,後龍鎮,秀水里,250,719,248,153,401,39,440
公投第１２案,苗栗縣,後龍鎮,水尾里,251,1037,333,212,545,54,599
公投第１２案,苗栗縣,後龍鎮,龍津里,252,601,166,126,292,15,307
公投第１２案,苗栗縣,後龍鎮,龍坑里,253,1269,285,255,540,43,583
公投第１２案,苗栗縣,後龍鎮,福寧里,254,735,186,146,332,35,367
公投第１２案,苗栗縣,後龍鎮,中和里,255,422,69,67,136,12,148
公投第１２案,苗栗縣,後龍鎮,中和里,256,625,205,142,347,16,363
公投第１２案,苗栗縣,後龍鎮,南港里,257,1234,339,202,541,33,574
公投第１２案,苗栗縣,造橋鄉,造橋村,258,1171,471,254,725,45,770
公投第１２案,苗栗縣,造橋鄉,造橋村,259,889,305,196,501,29,530
公投第１２案,苗栗縣,造橋鄉,平興村,260,479,144,86,230,9,239
公投第１２案,苗栗縣,造橋鄉,豐湖村,261,1024,393,180,573,31,604
公投第１２案,苗栗縣,造橋鄉,大西村,262,1214,337,264,601,57,658
公投第１２案,苗栗縣,造橋鄉,大西村,263,1071,301,221,522,39,561
公投第１２案,苗栗縣,造橋鄉,大西村,264,1157,345,212,557,51,608
公投第１２案,苗栗縣,造橋鄉,錦水村,265,512,183,100,283,19,302
公投第１２案,苗栗縣,造橋鄉,大龍村,266,491,154,135,289,20,309
公投第１２案,苗栗縣,造橋鄉,朝陽村,267,1272,415,305,720,47,767
公投第１２案,苗栗縣,造橋鄉,談文村,268,785,256,169,425,27,452
公投第１２案,苗栗縣,造橋鄉,龍昇村,269,962,312,237,549,74,623
公投第１２案,苗栗縣,竹南鎮,竹南里,270,1086,374,261,635,22,657
公投第１２案,苗栗縣,竹南鎮,竹南里,271,826,272,187,459,32,491
公投第１２案,苗栗縣,竹南鎮,照南里,272,1051,318,210,528,32,560
公投第１２案,苗栗縣,竹南鎮,照南里,273,1235,465,231,696,35,731
公投第１２案,苗栗縣,竹南鎮,照南里,274,1016,353,209,562,57,619
公投第１２案,苗栗縣,竹南鎮,正南里,275,1472,475,289,764,33,797
公投第１２案,苗栗縣,竹南鎮,正南里,276,1301,411,218,629,22,651
公投第１２案,苗栗縣,竹南鎮,新南里,277,1544,460,292,752,34,786
公投第１２案,苗栗縣,竹南鎮,新南里,278,1512,488,318,806,24,830
公投第１２案,苗栗縣,竹南鎮,新南里,279,1463,469,271,740,43,783
公投第１２案,苗栗縣,竹南鎮,大厝里,280,1073,318,219,537,21,558
公投第１２案,苗栗縣,竹南鎮,大厝里,281,1453,508,317,825,22,847
公投第１２案,苗栗縣,竹南鎮,大厝里,282,1245,478,244,722,21,743
公投第１２案,苗栗縣,竹南鎮,大厝里,283,1487,549,313,862,27,889
公投第１２案,苗栗縣,竹南鎮,營盤里,284,1018,354,216,570,33,603
公投第１２案,苗栗縣,竹南鎮,營盤里,285,1105,364,265,629,29,658
公投第１２案,苗栗縣,竹南鎮,營盤里,286,1322,404,264,668,37,705
公投第１２案,苗栗縣,竹南鎮,聖福里,287,1140,409,233,642,18,660
公投第１２案,苗栗縣,竹南鎮,聖福里,288,1067,408,214,622,33,655
公投第１２案,苗栗縣,竹南鎮,聖福里,289,1136,427,254,681,35,716
公投第１２案,苗栗縣,竹南鎮,竹興里,290,1253,392,239,631,22,653
公投第１２案,苗栗縣,竹南鎮,竹興里,291,963,295,184,479,35,514
公投第１２案,苗栗縣,竹南鎮,竹興里,292,1021,277,247,524,33,557
公投第１２案,苗栗縣,竹南鎮,龍山里,293,1154,398,266,664,34,698
公投第１２案,苗栗縣,竹南鎮,龍山里,294,1042,342,229,571,29,600
公投第１２案,苗栗縣,竹南鎮,天文里,295,1293,452,265,717,28,745
公投第１２案,苗栗縣,竹南鎮,天文里,296,816,302,170,472,16,488
公投第１２案,苗栗縣,竹南鎮,龍鳳里,297,989,305,224,529,34,563
公投第１２案,苗栗縣,竹南鎮,龍鳳里,298,1122,421,229,650,29,679
公投第１２案,苗栗縣,竹南鎮,山佳里,299,1111,302,202,504,20,524
公投第１２案,苗栗縣,竹南鎮,山佳里,300,1036,392,181,573,42,615
公投第１２案,苗栗縣,竹南鎮,山佳里,301,1112,349,184,533,27,560
公投第１２案,苗栗縣,竹南鎮,山佳里,302,1348,458,235,693,10,703
公投第１２案,苗栗縣,竹南鎮,佳興里,303,1114,369,261,630,24,654
公投第１２案,苗栗縣,竹南鎮,佳興里,304,1119,409,229,638,36,674
公投第１２案,苗栗縣,竹南鎮,佳興里,305,878,318,157,475,25,500
公投第１２案,苗栗縣,竹南鎮,中港里,306,1059,383,239,622,32,654
公投第１２案,苗栗縣,竹南鎮,中華里,307,869,298,199,497,27,524
公投第１２案,苗栗縣,竹南鎮,中華里,308,800,253,172,425,25,450
公投第１２案,苗栗縣,竹南鎮,中華里,309,1165,433,242,675,36,711
公投第１２案,苗栗縣,竹南鎮,中英里,310,791,288,146,434,29,463
公投第１２案,苗栗縣,竹南鎮,中英里,311,677,242,129,371,20,391
公投第１２案,苗栗縣,竹南鎮,中美里,312,797,282,204,486,35,521
公投第１２案,苗栗縣,竹南鎮,中美里,313,1191,405,240,645,22,667
公投第１２案,苗栗縣,竹南鎮,開元里,314,1027,330,198,528,21,549
公投第１２案,苗栗縣,竹南鎮,海口里,315,1341,450,311,761,28,789
公投第１２案,苗栗縣,竹南鎮,海口里,316,1378,440,234,674,30,704
公投第１２案,苗栗縣,竹南鎮,海口里,317,1216,410,241,651,30,681
公投第１２案,苗栗縣,竹南鎮,港墘里,318,1570,546,272,818,31,849
公投第１２案,苗栗縣,竹南鎮,港墘里,319,538,192,129,321,17,338
公投第１２案,苗栗縣,竹南鎮,公舘里,320,1166,362,201,563,23,586
公投第１２案,苗栗縣,竹南鎮,大埔里,321,1488,445,313,758,23,781
公投第１２案,苗栗縣,竹南鎮,大埔里,322,1449,416,290,706,25,731
公投第１２案,苗栗縣,竹南鎮,大埔里,323,1182,389,235,624,40,664
公投第１２案,苗栗縣,竹南鎮,頂埔里,324,1175,341,275,616,54,670
公投第１２案,苗栗縣,竹南鎮,頂埔里,325,983,318,218,536,34,570
公投第１２案,苗栗縣,竹南鎮,崎頂里,326,492,173,118,291,18,309
公投第１２案,苗栗縣,竹南鎮,崎頂里,327,1074,343,236,579,44,623
公投第１２案,苗栗縣,竹南鎮,崎頂里,328,852,248,191,439,35,474
公投第１２案,苗栗縣,竹南鎮,崎頂里,329,1297,414,248,662,25,687
公投第１２案,苗栗縣,竹南鎮,公義里,330,1028,295,231,526,33,559
公投第１２案,苗栗縣,頭份市,流東里,331,915,301,149,450,48,498
公投第１２案,苗栗縣,頭份市,流東里,332,1292,438,241,679,57,736
公投第１２案,苗栗縣,頭份市,珊湖里,333,928,321,206,527,26,553
公投第１２案,苗栗縣,頭份市,珊湖里,334,835,299,134,433,14,447
公投第１２案,苗栗縣,頭份市,斗煥里,335,1070,357,213,570,19,589
公投第１２案,苗栗縣,頭份市,斗煥里,336,879,279,171,450,13,463
公投第１２案,苗栗縣,頭份市,斗煥里,337,1039,333,189,522,21,543
公投第１２案,苗栗縣,頭份市,新華里,338,1129,398,227,625,35,660
公投第１２案,苗栗縣,頭份市,新華里,339,1041,318,215,533,39,572
公投第１２案,苗栗縣,頭份市,新華里,340,1546,474,282,756,45,801
公投第１２案,苗栗縣,頭份市,興隆里,341,935,341,201,542,43,585
公投第１２案,苗栗縣,頭份市,興隆里,342,1180,354,229,583,36,619
公投第１２案,苗栗縣,頭份市,興隆里,343,1499,459,289,748,31,779
公投第１２案,苗栗縣,頭份市,興隆里,344,747,243,154,397,9,406
公投第１２案,苗栗縣,頭份市,上埔里,345,1406,472,272,744,34,778
公投第１２案,苗栗縣,頭份市,上埔里,346,1193,375,260,635,40,675
公投第１２案,苗栗縣,頭份市,土牛里,347,948,327,190,517,41,558
公投第１２案,苗栗縣,頭份市,頭份里,348,869,293,165,458,17,475
公投第１２案,苗栗縣,頭份市,頭份里,349,1142,391,242,633,34,667
公投第１２案,苗栗縣,頭份市,頭份里,350,1286,407,281,688,26,714
公投第１２案,苗栗縣,頭份市,忠孝里,351,903,315,198,513,27,540
公投第１２案,苗栗縣,頭份市,忠孝里,352,1186,439,260,699,36,735
公投第１２案,苗栗縣,頭份市,忠孝里,353,1016,382,209,591,13,604
公投第１２案,苗栗縣,頭份市,自強里,354,985,330,206,536,23,559
公投第１２案,苗栗縣,頭份市,自強里,355,1037,323,211,534,30,564
公投第１２案,苗栗縣,頭份市,信義里,356,947,372,70,442,22,464
公投第１２案,苗栗縣,頭份市,仁愛里,357,890,313,180,493,28,521
公投第１２案,苗栗縣,頭份市,仁愛里,358,646,235,145,380,32,412
公投第１２案,苗栗縣,頭份市,上興里,359,975,512,18,530,49,579
公投第１２案,苗栗縣,頭份市,上興里,360,1015,232,154,386,11,397
公投第１２案,苗栗縣,頭份市,下興里,361,1399,532,291,823,56,879
公投第１２案,苗栗縣,頭份市,下興里,362,1143,371,274,645,41,686
公投第１２案,苗栗縣,頭份市,和平里,363,1030,424,211,635,37,672
公投第１２案,苗栗縣,頭份市,山下里,364,1338,460,281,741,37,778
公投第１２案,苗栗縣,頭份市,山下里,365,1450,504,274,778,21,799
公投第１２案,苗栗縣,頭份市,山下里,366,1042,382,213,595,16,611
公投第１２案,苗栗縣,頭份市,後庄里,367,1326,481,288,769,30,799
公投第１２案,苗栗縣,頭份市,後庄里,368,1270,477,301,778,24,802
公投第１２案,苗栗縣,頭份市,後庄里,369,1288,421,273,694,37,731
公投第１２案,苗栗縣,頭份市,合興里,370,1243,488,244,732,22,754
公投第１２案,苗栗縣,頭份市,合興里,371,1280,495,240,735,21,756
公投第１２案,苗栗縣,頭份市,文化里,372,1618,573,307,880,34,914
公投第１２案,苗栗縣,頭份市,文化里,373,1759,578,329,907,40,947
公投第１２案,苗栗縣,頭份市,中興里,374,1264,481,243,724,31,755
公投第１２案,苗栗縣,頭份市,中興里,375,1326,441,309,750,18,768
公投第１２案,苗栗縣,頭份市,蟠桃里,376,1551,526,331,857,20,877
公投第１２案,苗栗縣,頭份市,蟠桃里,377,1574,494,270,764,48,812
公投第１２案,苗栗縣,頭份市,建國里,378,1262,423,268,691,37,728
公投第１２案,苗栗縣,頭份市,建國里,379,1171,427,228,655,33,688
公投第１２案,苗栗縣,頭份市,建國里,380,1074,426,246,672,27,699
公投第１２案,苗栗縣,頭份市,成功里,381,1141,428,241,669,21,690
公投第１２案,苗栗縣,頭份市,成功里,382,1259,410,297,707,28,735
公投第１２案,苗栗縣,頭份市,成功里,383,1186,391,251,642,19,661
公投第１２案,苗栗縣,頭份市,民族里,384,1121,354,209,563,22,585
公投第１２案,苗栗縣,頭份市,民族里,385,847,277,190,467,20,487
公投第１２案,苗栗縣,頭份市,民權里,386,993,333,245,578,21,599
公投第１２案,苗栗縣,頭份市,民權里,387,1055,349,205,554,26,580
公投第１２案,苗栗縣,頭份市,東庄里,388,1655,601,218,819,34,853
公投第１２案,苗栗縣,頭份市,東庄里,389,1799,575,341,916,74,990
公投第１２案,苗栗縣,頭份市,田寮里,390,1141,401,226,627,36,663
公投第１２案,苗栗縣,頭份市,田寮里,391,1431,472,280,752,32,784
公投第１２案,苗栗縣,頭份市,田寮里,392,1412,385,269,654,28,682
公投第１２案,苗栗縣,頭份市,民生里,393,1074,329,217,546,20,566
公投第１２案,苗栗縣,頭份市,民生里,394,1245,429,276,705,38,743
公投第１２案,苗栗縣,頭份市,蘆竹里,395,1344,401,350,751,51,802
公投第１２案,苗栗縣,頭份市,尖山里,396,1363,470,306,776,66,842
公投第１２案,苗栗縣,頭份市,廣興里,397,898,336,203,539,34,573
公投第１２案,苗栗縣,頭份市,尖下里,398,1182,393,260,653,62,715
公投第１２案,苗栗縣,頭份市,尖下里,399,1413,495,262,757,26,783
公投第１２案,苗栗縣,頭份市,濫坑里,400,991,354,247,601,15,616
公投第１２案,苗栗縣,頭份市,濫坑里,401,1180,387,272,659,37,696
公投第１２案,苗栗縣,三灣鄉,三灣村,402,996,344,227,571,25,596
公投第１２案,苗栗縣,三灣鄉,三灣村,403,1205,440,234,674,42,716
公投第１２案,苗栗縣,三灣鄉,內灣村,404,635,205,157,362,26,388
公投第１２案,苗栗縣,三灣鄉,銅鏡村,405,862,296,160,456,40,496
公投第１２案,苗栗縣,三灣鄉,頂寮村,406,238,67,39,106,12,118
公投第１２案,苗栗縣,三灣鄉,北埔村,407,541,147,129,276,18,294
公投第１２案,苗栗縣,三灣鄉,大河村,408,578,150,122,272,27,299
公投第１２案,苗栗縣,三灣鄉,大坪村,409,405,155,102,257,22,279
公投第１２案,苗栗縣,三灣鄉,永和村,410,392,110,99,209,15,224
公投第１２案,苗栗縣,南庄鄉,東村,411,1155,331,270,601,41,642
公投第１２案,苗栗縣,南庄鄉,西村,412,650,180,159,339,34,373
公投第１２案,苗栗縣,南庄鄉,南江村,413,1353,402,253,655,44,699
公投第１２案,苗栗縣,南庄鄉,田美村,414,813,181,145,326,29,355
公投第１２案,苗栗縣,南庄鄉,獅山村,415,837,207,132,339,21,360
公投第１２案,苗栗縣,南庄鄉,南富村,416,1093,333,214,547,31,578
公投第１２案,苗栗縣,南庄鄉,員林村,417,1048,320,211,531,44,575
公投第１２案,苗栗縣,南庄鄉,蓬萊村,418,872,244,177,421,25,446
公投第１２案,苗栗縣,南庄鄉,東河村,419,963,171,130,301,14,315
公投第１２案,苗栗縣,大湖鄉,大湖村,420,744,239,144,383,23,406
公投第１２案,苗栗縣,大湖鄉,大湖村,421,881,288,172,460,27,487
公投第１２案,苗栗縣,大湖鄉,明湖村,422,596,196,118,314,26,340
公投第１２案,苗栗縣,大湖鄉,大寮村,423,1260,353,245,598,57,655
公投第１２案,苗栗縣,大湖鄉,靜湖村,424,867,271,162,433,24,457
公投第１２案,苗栗縣,大湖鄉,靜湖村,425,923,310,179,489,31,520
公投第１２案,苗栗縣,大湖鄉,富興村,426,1395,425,247,672,64,736
公投第１２案,苗栗縣,大湖鄉,大南村,427,561,122,73,195,17,212
公投第１２案,苗栗縣,大湖鄉,南湖村,428,638,225,123,348,24,372
公投第１２案,苗栗縣,大湖鄉,東興村,429,754,219,149,368,32,400
公投第１２案,苗栗縣,大湖鄉,武榮村,430,501,141,103,244,8,252
公投第１２案,苗栗縣,大湖鄉,義和村,431,652,192,148,340,20,360
公投第１２案,苗栗縣,大湖鄉,義和村,432,843,213,174,387,28,415
公投第１２案,苗栗縣,大湖鄉,栗林村,433,1020,295,210,505,73,578
公投第１２案,苗栗縣,大湖鄉,新開村,434,1018,329,212,541,38,579
公投第１２案,苗栗縣,獅潭鄉,百壽村,435,328,77,46,123,7,130
公投第１２案,苗栗縣,獅潭鄉,永興村,436,565,135,89,224,28,252
公投第１２案,苗栗縣,獅潭鄉,新店村,437,911,293,171,464,60,524
公投第１２案,苗栗縣,獅潭鄉,和興村,438,568,146,107,253,18,271
公投第１２案,苗栗縣,獅潭鄉,豐林村,439,580,180,124,304,37,341
公投第１２案,苗栗縣,獅潭鄉,新豐村,440,333,107,57,164,7,171
公投第１２案,苗栗縣,獅潭鄉,竹木村,441,683,228,106,334,20,354
公投第１２案,苗栗縣,卓蘭鎮,老庄里,442,961,431,114,545,39,584
公投第１２案,苗栗縣,卓蘭鎮,老庄里,443,1017,319,219,538,39,577
公投第１２案,苗栗縣,卓蘭鎮,新榮里,444,1095,378,273,651,55,706
公投第１２案,苗栗縣,卓蘭鎮,中街里,445,745,285,154,439,21,460
公投第１２案,苗栗縣,卓蘭鎮,新厝里,446,783,240,156,396,37,433
公投第１２案,苗栗縣,卓蘭鎮,新厝里,447,745,233,127,360,14,374
公投第１２案,苗栗縣,卓蘭鎮,豐田里,448,999,313,173,486,26,512
公投第１２案,苗栗縣,卓蘭鎮,西坪里,449,671,235,145,380,38,418
公投第１２案,苗栗縣,卓蘭鎮,苗豐里,450,734,232,199,431,52,483
公投第１２案,苗栗縣,卓蘭鎮,上新里,451,865,318,186,504,38,542
公投第１２案,苗栗縣,卓蘭鎮,上新里,452,828,315,171,486,41,527
公投第１２案,苗栗縣,卓蘭鎮,上新里,453,386,129,85,214,31,245
公投第１２案,苗栗縣,卓蘭鎮,內灣里,454,688,229,184,413,31,444
公投第１２案,苗栗縣,卓蘭鎮,內灣里,455,792,256,202,458,34,492
公投第１２案,苗栗縣,卓蘭鎮,內灣里,456,729,231,174,405,26,431
公投第１２案,苗栗縣,卓蘭鎮,坪林里,457,1093,277,222,499,35,534
公投第１２案,苗栗縣,卓蘭鎮,坪林里,458,615,213,128,341,25,366
公投第１２案,苗栗縣,卓蘭鎮,西坪里,459,86,33,13,46,1,47
公投第１２案,苗栗縣,卓蘭鎮,景山里,460,940,302,195,497,19,516
公投第１２案,苗栗縣,泰安鄉,八卦村,461,325,72,70,142,7,149
公投第１２案,苗栗縣,泰安鄉,錦水村,462,484,154,116,270,16,286
公投第１２案,苗栗縣,泰安鄉,錦水村,463,666,277,168,445,43,488
公投第１２案,苗栗縣,泰安鄉,清安村,464,574,242,116,358,31,389
公投第１２案,苗栗縣,泰安鄉,清安村,465,333,108,60,168,8,176
公投第１２案,苗栗縣,泰安鄉,大興村,466,495,223,117,340,9,349
公投第１２案,苗栗縣,泰安鄉,中興村,467,544,225,153,378,22,400
公投第１２案,苗栗縣,泰安鄉,梅園村,468,500,167,127,294,22,316
公投第１２案,苗栗縣,泰安鄉,象鼻村,469,670,318,146,464,16,480
公投第１２案,苗栗縣,泰安鄉,士林村,470,589,246,176,422,6,428
公投第１２案,彰化縣,彰化市,桃源里,1,871,315,101,416,17,433
公投第１２案,彰化縣,彰化市,桃源里,2,751,210,129,339,26,365
公投第１２案,彰化縣,彰化市,桃源里,3,923,334,247,581,30,611
公投第１２案,彰化縣,彰化市,東興里,4,779,276,177,453,31,484
公投第１２案,彰化縣,彰化市,東興里,5,779,267,186,453,26,479
公投第１２案,彰化縣,彰化市,華北里,6,720,260,159,419,17,436
公投第１２案,彰化縣,彰化市,華北里,7,749,261,164,425,22,447
公投第１２案,彰化縣,彰化市,華陽里,8,767,290,180,470,34,504
公投第１２案,彰化縣,彰化市,華陽里,9,1047,395,228,623,40,663
公投第１２案,彰化縣,彰化市,大同里,10,1027,336,216,552,37,589
公投第１２案,彰化縣,彰化市,永生里,11,1249,433,244,677,35,712
公投第１２案,彰化縣,彰化市,建寶里,12,1136,442,216,658,21,679
公投第１２案,彰化縣,彰化市,建寶里,13,1169,463,229,692,34,726
公投第１２案,彰化縣,彰化市,光南里,14,766,296,174,470,18,488
公投第１２案,彰化縣,彰化市,光南里,15,643,276,100,376,16,392
公投第１２案,彰化縣,彰化市,介壽里,16,1251,466,253,719,28,747
公投第１２案,彰化縣,彰化市,介壽里,17,1301,302,180,482,26,508
公投第１２案,彰化縣,彰化市,延平里,18,1280,471,278,749,28,777
公投第１２案,彰化縣,彰化市,延平里,19,1179,467,241,708,24,732
公投第１２案,彰化縣,彰化市,延平里,20,1168,426,232,658,31,689
公投第１２案,彰化縣,彰化市,延平里,21,1218,436,254,690,28,718
公投第１２案,彰化縣,彰化市,延平里,22,1351,551,315,866,17,883
公投第１２案,彰化縣,彰化市,延平里,23,1204,384,321,705,20,725
公投第１２案,彰化縣,彰化市,延平里,24,1189,437,255,692,23,715
公投第１２案,彰化縣,彰化市,延和里,25,1207,430,237,667,34,701
公投第１２案,彰化縣,彰化市,延和里,26,1161,424,240,664,30,694
公投第１２案,彰化縣,彰化市,延和里,27,1166,388,253,641,28,669
公投第１２案,彰化縣,彰化市,延和里,28,1362,490,317,807,28,835
公投第１２案,彰化縣,彰化市,南興里,29,1236,447,289,736,36,772
公投第１２案,彰化縣,彰化市,南興里,30,1065,373,239,612,31,643
公投第１２案,彰化縣,彰化市,南興里,31,1199,428,263,691,32,723
公投第１２案,彰化縣,彰化市,南興里,32,1233,433,293,726,16,742
公投第１２案,彰化縣,彰化市,南興里,33,1245,462,238,700,24,724
公投第１２案,彰化縣,彰化市,南興里,34,1153,430,261,691,27,718
公投第１２案,彰化縣,彰化市,南瑤里,35,1045,357,220,577,17,594
公投第１２案,彰化縣,彰化市,南瑤里,36,1097,386,253,639,11,650
公投第１２案,彰化縣,彰化市,南瑤里,37,1190,420,249,669,28,697
公投第１２案,彰化縣,彰化市,南瑤里,38,1106,418,255,673,20,693
公投第１２案,彰化縣,彰化市,南瑤里,39,1097,384,254,638,25,663
公投第１２案,彰化縣,彰化市,南瑤里,40,1048,354,255,609,33,642
公投第１２案,彰化縣,彰化市,南瑤里,41,980,384,213,597,21,618
公投第１２案,彰化縣,彰化市,成功里,42,707,259,174,433,15,448
公投第１２案,彰化縣,彰化市,成功里,43,809,285,180,465,26,491
公投第１２案,彰化縣,彰化市,福安里,44,1008,361,237,598,35,633
公投第１２案,彰化縣,彰化市,西安里,45,901,292,192,484,30,514
公投第１２案,彰化縣,彰化市,西安里,46,951,327,204,531,20,551
公投第１２案,彰化縣,彰化市,西安里,47,1076,381,240,621,26,647
公投第１２案,彰化縣,彰化市,彰安里,48,1022,353,202,555,19,574
公投第１２案,彰化縣,彰化市,彰安里,49,894,337,185,522,28,550
公投第１２案,彰化縣,彰化市,彰安里,50,1016,389,215,604,28,632
公投第１２案,彰化縣,彰化市,中央里,51,771,294,178,472,27,499
公投第１２案,彰化縣,彰化市,富貴里,52,868,295,215,510,26,536
公投第１２案,彰化縣,彰化市,民權里,53,1135,401,242,643,45,688
公投第１２案,彰化縣,彰化市,萬壽里,54,910,304,280,584,38,622
公投第１２案,彰化縣,彰化市,長樂里,55,1004,368,251,619,21,640
公投第１２案,彰化縣,彰化市,西興里,56,1077,382,262,644,29,673
公投第１２案,彰化縣,彰化市,西興里,57,1258,500,294,794,35,829
公投第１２案,彰化縣,彰化市,西興里,58,1025,424,204,628,26,654
公投第１２案,彰化縣,彰化市,西勢里,59,1177,445,270,715,38,753
公投第１２案,彰化縣,彰化市,西勢里,60,1262,436,261,697,31,728
公投第１２案,彰化縣,彰化市,西勢里,61,1209,461,249,710,44,754
公投第１２案,彰化縣,彰化市,忠權里,62,1041,393,238,631,29,660
公投第１２案,彰化縣,彰化市,忠權里,63,1075,445,211,656,24,680
公投第１２案,彰化縣,彰化市,忠權里,64,1029,383,191,574,25,599
公投第１２案,彰化縣,彰化市,忠孝里,65,1203,407,261,668,37,705
公投第１２案,彰化縣,彰化市,五權里,66,1014,376,186,562,29,591
公投第１２案,彰化縣,彰化市,五權里,67,1069,395,226,621,25,646
公投第１２案,彰化縣,彰化市,五權里,68,969,330,184,514,15,529
公投第１２案,彰化縣,彰化市,五權里,69,1105,362,215,577,20,597
公投第１２案,彰化縣,彰化市,平和里,70,981,376,227,603,32,635
公投第１２案,彰化縣,彰化市,平和里,71,1095,393,268,661,39,700
公投第１２案,彰化縣,彰化市,平和里,72,1087,431,224,655,23,678
公投第１２案,彰化縣,彰化市,平和里,73,1050,346,288,634,17,651
公投第１２案,彰化縣,彰化市,崙平里,74,1252,444,301,745,26,771
公投第１２案,彰化縣,彰化市,崙平里,75,1113,387,228,615,22,637
公投第１２案,彰化縣,彰化市,崙平里,76,1009,365,243,608,28,636
公投第１２案,彰化縣,彰化市,崙平里,77,999,346,213,559,28,587
公投第１２案,彰化縣,彰化市,崙平里,78,997,333,232,565,22,587
公投第１２案,彰化縣,彰化市,向陽里,79,1145,424,297,721,22,743
公投第１２案,彰化縣,彰化市,向陽里,80,1227,436,282,718,29,747
公投第１２案,彰化縣,彰化市,向陽里,81,1208,434,302,736,23,759
公投第１２案,彰化縣,彰化市,向陽里,82,1598,560,348,908,21,929
公投第１２案,彰化縣,彰化市,莿桐里,83,890,300,208,508,41,549
公投第１２案,彰化縣,彰化市,莿桐里,84,1104,406,100,506,47,553
公投第１２案,彰化縣,彰化市,莿桐里,85,1097,379,236,615,21,636
公投第１２案,彰化縣,彰化市,南美里,86,799,291,146,437,32,469
公投第１２案,彰化縣,彰化市,南美里,87,1000,381,212,593,31,624
公投第１２案,彰化縣,彰化市,南安里,88,1153,418,223,641,40,681
公投第１２案,彰化縣,彰化市,南安里,89,977,361,204,565,45,610
公投第１２案,彰化縣,彰化市,東芳里,90,1201,407,258,665,30,695
公投第１２案,彰化縣,彰化市,東芳里,91,1057,357,263,620,47,667
公投第１２案,彰化縣,彰化市,東芳里,92,1238,406,276,682,49,731
公投第１２案,彰化縣,彰化市,磚磘里,93,1210,453,253,706,41,747
公投第１２案,彰化縣,彰化市,磚磘里,94,1026,389,221,610,28,638
公投第１２案,彰化縣,彰化市,磚磘里,95,1061,381,264,645,35,680
公投第１２案,彰化縣,彰化市,卦山里,96,1213,430,257,687,38,725
公投第１２案,彰化縣,彰化市,卦山里,97,1264,471,281,752,24,776
公投第１２案,彰化縣,彰化市,光復里,98,691,279,168,447,19,466
公投第１２案,彰化縣,彰化市,永福里,99,893,334,202,536,40,576
公投第１２案,彰化縣,彰化市,光華里,100,733,279,143,422,38,460
公投第１２案,彰化縣,彰化市,中正里,101,692,261,159,420,27,447
公投第１２案,彰化縣,彰化市,中正里,102,728,233,178,411,32,443
公投第１２案,彰化縣,彰化市,中山里,103,773,313,166,479,27,506
公投第１２案,彰化縣,彰化市,龍山里,104,975,324,190,514,18,532
公投第１２案,彰化縣,彰化市,龍山里,105,908,350,184,534,27,561
公投第１２案,彰化縣,彰化市,新興里,106,1156,453,282,735,12,747
公投第１２案,彰化縣,彰化市,新興里,107,1235,430,289,719,36,755
公投第１２案,彰化縣,彰化市,新興里,108,1376,473,272,745,40,785
公投第１２案,彰化縣,彰化市,新興里,109,1389,504,274,778,14,792
公投第１２案,彰化縣,彰化市,新華里,110,846,324,203,527,32,559
公投第１２案,彰化縣,彰化市,新華里,111,859,344,193,537,21,558
公投第１２案,彰化縣,彰化市,興北里,112,781,258,209,467,17,484
公投第１２案,彰化縣,彰化市,興北里,113,875,306,194,500,24,524
公投第１２案,彰化縣,彰化市,信義里,114,816,287,178,465,21,486
公投第１２案,彰化縣,彰化市,民生里,115,687,319,101,420,27,447
公投第１２案,彰化縣,彰化市,民生里,116,727,287,164,451,24,475
公投第１２案,彰化縣,彰化市,文化里,117,662,275,136,411,20,431
公投第１２案,彰化縣,彰化市,文化里,118,633,260,134,394,13,407
公投第１２案,彰化縣,彰化市,陽明里,119,906,353,210,563,31,594
公投第１２案,彰化縣,彰化市,陽明里,120,853,305,161,466,26,492
公投第１２案,彰化縣,彰化市,萬安里,121,1027,384,235,619,31,650
公投第１２案,彰化縣,彰化市,萬安里,122,993,406,201,607,30,637
公投第１２案,彰化縣,彰化市,萬安里,123,848,299,191,490,32,522
公投第１２案,彰化縣,彰化市,萬安里,124,1118,441,244,685,20,705
公投第１２案,彰化縣,彰化市,下廍里,125,1263,482,260,742,32,774
公投第１２案,彰化縣,彰化市,下廍里,126,1268,543,242,785,43,828
公投第１２案,彰化縣,彰化市,下廍里,127,1258,492,243,735,34,769
公投第１２案,彰化縣,彰化市,下廍里,128,1212,485,258,743,16,759
公投第１２案,彰化縣,彰化市,茄苳里,129,924,336,193,529,44,573
公投第１２案,彰化縣,彰化市,茄南里,130,939,353,226,579,22,601
公投第１２案,彰化縣,彰化市,茄南里,131,953,379,237,616,32,648
公投第１２案,彰化縣,彰化市,茄南里,132,981,387,241,628,20,648
公投第１２案,彰化縣,彰化市,寶廍里,133,1249,463,275,738,46,784
公投第１２案,彰化縣,彰化市,古夷里,134,817,308,184,492,26,518
公投第１２案,彰化縣,彰化市,古夷里,135,872,296,209,505,33,538
公投第１２案,彰化縣,彰化市,古夷里,136,689,231,155,386,24,410
公投第１２案,彰化縣,彰化市,阿夷里,137,1156,474,227,701,29,730
公投第１２案,彰化縣,彰化市,阿夷里,138,1291,432,288,720,24,744
公投第１２案,彰化縣,彰化市,阿夷里,139,1139,405,240,645,27,672
公投第１２案,彰化縣,彰化市,阿夷里,140,1125,426,242,668,34,702
公投第１２案,彰化縣,彰化市,阿夷里,141,1258,441,240,681,42,723
公投第１２案,彰化縣,彰化市,阿夷里,142,1123,403,234,637,31,668
公投第１２案,彰化縣,彰化市,阿夷里,143,1175,415,246,661,42,703
公投第１２案,彰化縣,彰化市,和調里,144,862,329,220,549,22,571
公投第１２案,彰化縣,彰化市,和調里,145,872,279,219,498,27,525
公投第１２案,彰化縣,彰化市,和調里,146,897,370,189,559,19,578
公投第１２案,彰化縣,彰化市,復興里,147,1003,345,211,556,24,580
公投第１２案,彰化縣,彰化市,復興里,148,915,342,185,527,19,546
公投第１２案,彰化縣,彰化市,復興里,149,1158,400,235,635,33,668
公投第１２案,彰化縣,彰化市,復興里,150,1084,378,274,652,33,685
公投第１２案,彰化縣,彰化市,中庄里,151,1372,440,289,729,44,773
公投第１２案,彰化縣,彰化市,中庄里,152,1113,430,228,658,23,681
公投第１２案,彰化縣,彰化市,竹中里,153,800,272,198,470,37,507
公投第１２案,彰化縣,彰化市,竹中里,154,885,289,222,511,25,536
公投第１２案,彰化縣,彰化市,香山里,155,1000,370,245,615,16,631
公投第１２案,彰化縣,彰化市,香山里,156,1159,386,243,629,23,652
公投第１２案,彰化縣,彰化市,香山里,157,1123,246,370,616,26,642
公投第１２案,彰化縣,彰化市,牛埔里,158,907,334,227,561,41,602
公投第１２案,彰化縣,彰化市,牛埔里,159,989,344,186,530,34,564
公投第１２案,彰化縣,彰化市,牛埔里,160,1012,354,253,607,34,641
公投第１２案,彰化縣,彰化市,台鳳里,161,1033,362,192,554,21,575
公投第１２案,彰化縣,彰化市,台鳳里,162,1116,387,263,650,32,682
公投第１２案,彰化縣,彰化市,台鳳里,163,1154,429,267,696,16,712
公投第１２案,彰化縣,彰化市,台鳳里,164,1064,379,256,635,24,659
公投第１２案,彰化縣,彰化市,國聖里,165,770,297,183,480,31,511
公投第１２案,彰化縣,彰化市,國聖里,166,889,301,219,520,37,557
公投第１２案,彰化縣,彰化市,國聖里,167,786,283,178,461,42,503
公投第１２案,彰化縣,彰化市,福山里,168,1120,326,242,568,44,612
公投第１２案,彰化縣,彰化市,福山里,169,1269,422,250,672,27,699
公投第１２案,彰化縣,彰化市,福山里,170,1159,410,268,678,28,706
公投第１２案,彰化縣,彰化市,福山里,171,1184,429,251,680,46,726
公投第１２案,彰化縣,彰化市,福山里,172,1089,377,226,603,31,634
公投第１２案,彰化縣,彰化市,福山里,173,968,347,219,566,39,605
公投第１２案,彰化縣,彰化市,安溪里,174,930,340,186,526,23,549
公投第１２案,彰化縣,彰化市,安溪里,175,973,358,220,578,27,605
公投第１２案,彰化縣,彰化市,三村里,176,1184,349,241,590,31,621
公投第１２案,彰化縣,彰化市,大竹里,177,1002,364,226,590,33,623
公投第１２案,彰化縣,彰化市,大竹里,178,1148,406,223,629,21,650
公投第１２案,彰化縣,彰化市,大竹里,179,1112,377,233,610,36,646
公投第１２案,彰化縣,彰化市,田中里,180,907,326,264,590,39,629
公投第１２案,彰化縣,彰化市,快官里,181,1112,388,242,630,52,682
公投第１２案,彰化縣,彰化市,竹巷里,182,823,252,177,429,29,458
公投第１２案,彰化縣,彰化市,福田里,183,1276,429,272,701,62,763
公投第１２案,彰化縣,彰化市,石牌里,184,1161,418,227,645,26,671
公投第１２案,彰化縣,花壇鄉,花壇村,185,901,356,171,527,26,553
公投第１２案,彰化縣,花壇鄉,花壇村,186,1042,371,250,621,34,655
公投第１２案,彰化縣,花壇鄉,花壇村,187,1314,454,266,720,13,733
公投第１２案,彰化縣,花壇鄉,金墩村,188,808,319,165,484,32,516
公投第１２案,彰化縣,花壇鄉,金墩村,189,1019,373,186,559,30,589
公投第１２案,彰化縣,花壇鄉,中庄村,190,1144,434,229,663,49,712
公投第１２案,彰化縣,花壇鄉,中庄村,191,1240,570,120,690,55,745
公投第１２案,彰化縣,花壇鄉,崙雅村,192,1425,591,246,837,43,880
公投第１２案,彰化縣,花壇鄉,劉厝村,193,1095,452,228,680,29,709
公投第１２案,彰化縣,花壇鄉,南口村,194,910,339,173,512,37,549
公投第１２案,彰化縣,花壇鄉,南口村,195,982,412,175,587,28,615
公投第１２案,彰化縣,花壇鄉,北口村,196,1070,345,235,580,20,600
公投第１２案,彰化縣,花壇鄉,北口村,197,700,236,149,385,17,402
公投第１２案,彰化縣,花壇鄉,中口村,198,764,305,173,478,28,506
公投第１２案,彰化縣,花壇鄉,文德村,199,953,361,214,575,32,607
公投第１２案,彰化縣,花壇鄉,文德村,200,974,337,202,539,18,557
公投第１２案,彰化縣,花壇鄉,文德村,201,1111,402,199,601,46,647
公投第１２案,彰化縣,花壇鄉,白沙村,202,1101,434,199,633,43,676
公投第１２案,彰化縣,花壇鄉,白沙村,203,1110,368,230,598,26,624
公投第１２案,彰化縣,花壇鄉,白沙村,204,1262,442,253,695,41,736
公投第１２案,彰化縣,花壇鄉,白沙村,205,1103,382,250,632,21,653
公投第１２案,彰化縣,花壇鄉,岩竹村,206,1347,419,249,668,42,710
公投第１２案,彰化縣,花壇鄉,長沙村,207,1169,378,230,608,29,637
公投第１２案,彰化縣,花壇鄉,長沙村,208,1274,475,252,727,44,771
公投第１２案,彰化縣,花壇鄉,長沙村,209,1280,514,246,760,29,789
公投第１２案,彰化縣,花壇鄉,長沙村,210,1244,491,215,706,27,733
公投第１２案,彰化縣,花壇鄉,橋頭村,211,1159,265,378,643,43,686
公投第１２案,彰化縣,花壇鄉,橋頭村,212,1042,392,237,629,29,658
公投第１２案,彰化縣,花壇鄉,橋頭村,213,1111,383,218,601,29,630
公投第１２案,彰化縣,花壇鄉,灣雅村,214,893,335,203,538,33,571
公投第１２案,彰化縣,花壇鄉,灣東村,215,953,329,204,533,34,567
公投第１２案,彰化縣,花壇鄉,三春村,216,987,321,212,533,31,564
公投第１２案,彰化縣,花壇鄉,三春村,217,925,347,220,567,42,609
公投第１２案,彰化縣,花壇鄉,永春村,218,951,345,192,537,24,561
公投第１２案,彰化縣,花壇鄉,永春村,219,955,332,194,526,21,547
公投第１２案,彰化縣,花壇鄉,長春村,220,895,336,180,516,30,546
公投第１２案,彰化縣,花壇鄉,長春村,221,711,241,165,406,14,420
公投第１２案,彰化縣,芬園鄉,舊社村,222,958,345,174,519,19,538
公投第１２案,彰化縣,芬園鄉,舊社村,223,794,249,175,424,33,457
公投第１２案,彰化縣,芬園鄉,大埔村,224,1415,390,292,682,65,747
公投第１２案,彰化縣,芬園鄉,竹林村,225,927,336,197,533,32,565
公投第１２案,彰化縣,芬園鄉,竹林村,226,831,278,168,446,28,474
公投第１２案,彰化縣,芬園鄉,楓坑村,227,570,193,131,324,13,337
公投第１２案,彰化縣,芬園鄉,社口村,228,1227,354,261,615,41,656
公投第１２案,彰化縣,芬園鄉,社口村,229,1238,393,241,634,49,683
公投第１２案,彰化縣,芬園鄉,茄荖村,230,1362,426,294,720,67,787
公投第１２案,彰化縣,芬園鄉,茄荖村,231,989,355,188,543,45,588
公投第１２案,彰化縣,芬園鄉,嘉興村,232,1054,386,245,631,42,673
公投第１２案,彰化縣,芬園鄉,嘉興村,233,607,250,126,376,25,401
公投第１２案,彰化縣,芬園鄉,芬園村,234,882,298,209,507,29,536
公投第１２案,彰化縣,芬園鄉,縣庄村,235,1143,342,191,533,27,560
公投第１２案,彰化縣,芬園鄉,圳墘村,236,661,207,117,324,19,343
公投第１２案,彰化縣,芬園鄉,溪頭村,237,838,286,137,423,5,428
公投第１２案,彰化縣,芬園鄉,溪頭村,238,847,237,189,426,20,446
公投第１２案,彰化縣,芬園鄉,進芬村,239,987,335,219,554,38,592
公投第１２案,彰化縣,芬園鄉,同安村,240,1217,364,225,589,52,641
公投第１２案,彰化縣,芬園鄉,中崙村,241,865,234,159,393,56,449
公投第１２案,彰化縣,芬園鄉,大竹村,242,996,268,210,478,38,516
公投第１２案,彰化縣,鹿港鎮,大有里,243,1140,411,275,686,33,719
公投第１２案,彰化縣,鹿港鎮,中興里,244,511,175,113,288,18,306
公投第１２案,彰化縣,鹿港鎮,洛津里,245,857,265,154,419,21,440
公投第１２案,彰化縣,鹿港鎮,順興里,246,946,359,220,579,35,614
公投第１２案,彰化縣,鹿港鎮,埔崙里,247,945,315,221,536,29,565
公投第１２案,彰化縣,鹿港鎮,埔崙里,248,1097,384,244,628,31,659
公投第１２案,彰化縣,鹿港鎮,埔崙里,249,1479,437,289,726,23,749
公投第１２案,彰化縣,鹿港鎮,埔崙里,250,1425,480,322,802,48,850
公投第１２案,彰化縣,鹿港鎮,新宮里,251,880,304,191,495,63,558
公投第１２案,彰化縣,鹿港鎮,玉順里,252,1183,388,245,633,42,675
公投第１２案,彰化縣,鹿港鎮,東石里,253,1047,365,239,604,45,649
公投第１２案,彰化縣,鹿港鎮,東石里,254,1097,334,260,594,16,610
公投第１２案,彰化縣,鹿港鎮,東石里,255,1030,343,211,554,39,593
公投第１２案,彰化縣,鹿港鎮,東石里,256,1161,378,269,647,30,677
公投第１２案,彰化縣,鹿港鎮,郭厝里,257,540,192,119,311,33,344
公投第１２案,彰化縣,鹿港鎮,永安里,258,1135,365,250,615,31,646
公投第１２案,彰化縣,鹿港鎮,永安里,259,1155,399,232,631,40,671
公投第１２案,彰化縣,鹿港鎮,永安里,260,1127,395,274,669,30,699
公投第１２案,彰化縣,鹿港鎮,永安里,261,1045,361,229,590,34,624
公投第１２案,彰化縣,鹿港鎮,景福里,262,1127,389,223,612,54,666
公投第１２案,彰化縣,鹿港鎮,泰興里,263,1178,467,268,735,28,763
公投第１２案,彰化縣,鹿港鎮,長興里,264,284,108,56,164,5,169
公投第１２案,彰化縣,鹿港鎮,興化里,265,584,194,135,329,21,350
公投第１２案,彰化縣,鹿港鎮,龍山里,266,659,274,139,413,24,437
公投第１２案,彰化縣,鹿港鎮,菜園里,267,915,339,194,533,18,551
公投第１２案,彰化縣,鹿港鎮,街尾里,268,1079,410,239,649,29,678
公投第１２案,彰化縣,鹿港鎮,街尾里,269,1129,430,257,687,46,733
公投第１２案,彰化縣,鹿港鎮,詔安里,270,1273,416,248,664,44,708
公投第１２案,彰化縣,鹿港鎮,詔安里,271,706,235,120,355,27,382
公投第１２案,彰化縣,鹿港鎮,海埔里,272,1137,329,234,563,69,632
公投第１２案,彰化縣,鹿港鎮,海埔里,273,1195,391,245,636,27,663
公投第１２案,彰化縣,鹿港鎮,海埔里,274,1225,385,229,614,49,663
公投第１２案,彰化縣,鹿港鎮,洋厝里,275,957,254,330,584,46,630
公投第１２案,彰化縣,鹿港鎮,洋厝里,276,758,221,134,355,46,401
公投第１２案,彰化縣,鹿港鎮,洋厝里,277,723,246,166,412,29,441
公投第１２案,彰化縣,鹿港鎮,草中里,278,984,331,197,528,30,558
公投第１２案,彰化縣,鹿港鎮,草中里,279,1018,387,232,619,33,652
公投第１２案,彰化縣,鹿港鎮,草中里,280,1165,360,243,603,43,646
公投第１２案,彰化縣,鹿港鎮,頭南里,281,1161,338,228,566,51,617
公投第１２案,彰化縣,鹿港鎮,頭南里,282,1020,328,196,524,38,562
公投第１２案,彰化縣,鹿港鎮,山崙里,283,1068,372,207,579,37,616
公投第１２案,彰化縣,鹿港鎮,山崙里,284,1024,420,219,639,28,667
公投第１２案,彰化縣,鹿港鎮,山崙里,285,974,339,208,547,63,610
公投第１２案,彰化縣,鹿港鎮,頂番里,286,1505,469,296,765,54,819
公投第１２案,彰化縣,鹿港鎮,頂番里,287,1092,299,263,562,44,606
公投第１２案,彰化縣,鹿港鎮,頂番里,288,1223,413,277,690,52,742
公投第１２案,彰化縣,鹿港鎮,頭崙里,289,1572,488,274,762,23,785
公投第１２案,彰化縣,鹿港鎮,頭崙里,290,1003,340,240,580,42,622
公投第１２案,彰化縣,鹿港鎮,溝墘里,291,933,329,210,539,24,563
公投第１２案,彰化縣,鹿港鎮,溝墘里,292,1093,383,245,628,35,663
公投第１２案,彰化縣,鹿港鎮,溝墘里,293,907,307,191,498,19,517
公投第１２案,彰化縣,鹿港鎮,溝墘里,294,1219,433,223,656,30,686
公投第１２案,彰化縣,鹿港鎮,廖厝里,295,1397,499,344,843,41,884
公投第１２案,彰化縣,鹿港鎮,廖厝里,296,1229,436,240,676,32,708
公投第１２案,彰化縣,鹿港鎮,廖厝里,297,1444,507,267,774,24,798
公投第１２案,彰化縣,鹿港鎮,東崎里,298,1227,439,251,690,42,732
公投第１２案,彰化縣,鹿港鎮,東崎里,299,1187,438,238,676,44,720
公投第１２案,彰化縣,鹿港鎮,東崎里,300,1296,440,250,690,28,718
公投第１２案,彰化縣,鹿港鎮,東崎里,301,1451,426,283,709,50,759
公投第１２案,彰化縣,鹿港鎮,頂厝里,302,1299,424,247,671,61,732
公投第１２案,彰化縣,鹿港鎮,頂厝里,303,1298,474,307,781,27,808
公投第１２案,彰化縣,鹿港鎮,頂厝里,304,1458,520,285,805,33,838
公投第１２案,彰化縣,鹿港鎮,頂厝里,305,1138,403,244,647,45,692
公投第１２案,彰化縣,鹿港鎮,頂厝里,306,1170,362,278,640,46,686
公投第１２案,彰化縣,鹿港鎮,頂厝里,307,1221,423,288,711,35,746
公投第１２案,彰化縣,福興鄉,三汴村,308,1363,402,326,728,39,767
公投第１２案,彰化縣,福興鄉,萬豐村,309,821,256,190,446,23,469
公投第１２案,彰化縣,福興鄉,元中村,310,1256,382,220,602,66,668
公投第１２案,彰化縣,福興鄉,外中村,311,1166,328,252,580,59,639
公投第１２案,彰化縣,福興鄉,外埔村,312,1464,436,286,722,46,768
公投第１２案,彰化縣,福興鄉,大崙村,313,1251,343,278,621,41,662
公投第１２案,彰化縣,福興鄉,番婆村,314,1465,435,307,742,37,779
公投第１２案,彰化縣,福興鄉,番婆村,315,960,267,190,457,21,478
公投第１２案,彰化縣,福興鄉,橋頭村,316,1323,422,240,662,53,715
公投第１２案,彰化縣,福興鄉,橋頭村,317,1365,464,249,713,41,754
公投第１２案,彰化縣,福興鄉,社尾村,318,1458,408,250,658,28,686
公投第１２案,彰化縣,福興鄉,番社村,319,1492,479,280,759,41,800
公投第１２案,彰化縣,福興鄉,西勢村,320,888,316,152,468,20,488
公投第１２案,彰化縣,福興鄉,西勢村,321,1054,500,100,600,34,634
公投第１２案,彰化縣,福興鄉,同安村,322,1043,311,184,495,27,522
公投第１２案,彰化縣,福興鄉,同安村,323,1340,427,265,692,48,740
公投第１２案,彰化縣,福興鄉,秀厝村,324,1085,309,229,538,36,574
公投第１２案,彰化縣,福興鄉,秀厝村,325,1392,454,259,713,26,739
公投第１２案,彰化縣,福興鄉,福興村,326,1316,500,230,730,45,775
公投第１２案,彰化縣,福興鄉,福興村,327,1255,463,268,731,29,760
公投第１２案,彰化縣,福興鄉,福興村,328,1101,408,242,650,25,675
公投第１２案,彰化縣,福興鄉,福南村,329,1167,406,196,602,50,652
公投第１２案,彰化縣,福興鄉,福南村,330,1393,429,275,704,34,738
公投第１２案,彰化縣,福興鄉,鎮平村,331,1216,432,222,654,42,696
公投第１２案,彰化縣,福興鄉,三和村,332,1063,342,193,535,29,564
公投第１２案,彰化縣,福興鄉,二港村,333,1306,406,250,656,48,704
公投第１２案,彰化縣,福興鄉,福寶村,334,1287,371,202,573,41,614
公投第１２案,彰化縣,福興鄉,頂粘村,335,994,335,197,532,26,558
公投第１２案,彰化縣,福興鄉,頂粘村,336,1311,469,221,690,50,740
公投第１２案,彰化縣,福興鄉,廈粘村,337,926,347,187,534,24,558
公投第１２案,彰化縣,福興鄉,廈粘村,338,995,286,202,488,31,519
公投第１２案,彰化縣,福興鄉,麥厝村,339,1079,414,209,623,49,672
公投第１２案,彰化縣,福興鄉,麥厝村,340,1150,376,185,561,44,605
公投第１２案,彰化縣,秀水鄉,秀水村,341,1066,572,27,599,68,667
公投第１２案,彰化縣,秀水鄉,秀水村,342,620,226,143,369,28,397
公投第１２案,彰化縣,秀水鄉,安溪村,343,876,278,171,449,9,458
公投第１２案,彰化縣,秀水鄉,安溪村,344,1196,445,261,706,29,735
公投第１２案,彰化縣,秀水鄉,莊雅村,345,1369,449,304,753,36,789
公投第１２案,彰化縣,秀水鄉,莊雅村,346,1273,434,271,705,52,757
公投第１２案,彰化縣,秀水鄉,陝西村,347,1433,439,322,761,44,805
公投第１２案,彰化縣,秀水鄉,金興村,348,967,333,215,548,26,574
公投第１２案,彰化縣,秀水鄉,金興村,349,921,331,206,537,15,552
公投第１２案,彰化縣,秀水鄉,安東村,350,689,262,146,408,27,435
公投第１２案,彰化縣,秀水鄉,安東村,351,688,237,152,389,32,421
公投第１２案,彰化縣,秀水鄉,安東村,352,1252,432,308,740,42,782
公投第１２案,彰化縣,秀水鄉,安東村,353,1281,412,301,713,34,747
公投第１２案,彰化縣,秀水鄉,鶴鳴村,354,754,242,163,405,22,427
公投第１２案,彰化縣,秀水鄉,鶴鳴村,355,1024,348,188,536,51,587
公投第１２案,彰化縣,秀水鄉,鶴鳴村,356,1433,468,304,772,20,792
公投第１２案,彰化縣,秀水鄉,馬興村,357,1366,483,349,832,49,881
公投第１２案,彰化縣,秀水鄉,馬興村,358,895,294,209,503,41,544
公投第１２案,彰化縣,秀水鄉,義興村,359,1386,407,306,713,41,754
公投第１２案,彰化縣,秀水鄉,福安村,360,896,312,174,486,58,544
公投第１２案,彰化縣,秀水鄉,福安村,361,804,309,201,510,30,540
公投第１２案,彰化縣,秀水鄉,福安村,362,827,316,188,504,20,524
公投第１２案,彰化縣,秀水鄉,福安村,363,996,339,225,564,29,593
公投第１２案,彰化縣,秀水鄉,福安村,364,931,323,251,574,46,620
公投第１２案,彰化縣,秀水鄉,埔崙村,365,715,229,157,386,23,409
公投第１２案,彰化縣,秀水鄉,埔崙村,366,1229,441,289,730,38,768
公投第１２案,彰化縣,秀水鄉,曾厝村,367,890,266,171,437,26,463
公投第１２案,彰化縣,秀水鄉,曾厝村,368,811,257,215,472,37,509
公投第１２案,彰化縣,秀水鄉,金陵村,369,786,280,175,455,34,489
公投第１２案,彰化縣,秀水鄉,金陵村,370,931,312,206,518,25,543
公投第１２案,彰化縣,秀水鄉,下崙村,371,1265,463,265,728,45,773
公投第１２案,彰化縣,秀水鄉,下崙村,372,824,277,142,419,43,462
公投第１２案,彰化縣,和美鎮,竹營里,373,1341,432,273,705,36,741
公投第１２案,彰化縣,和美鎮,竹營里,374,1480,462,262,724,48,772
公投第１２案,彰化縣,和美鎮,竹營里,375,1529,507,312,819,40,859
公投第１２案,彰化縣,和美鎮,竹營里,376,1711,528,330,858,23,881
公投第１２案,彰化縣,和美鎮,和東里,377,1057,347,250,597,23,620
公投第１２案,彰化縣,和美鎮,和東里,378,1032,342,246,588,33,621
公投第１２案,彰化縣,和美鎮,和東里,379,1015,370,229,599,29,628
公投第１２案,彰化縣,和美鎮,和東里,380,1209,436,267,703,32,735
公投第１２案,彰化縣,和美鎮,和南里,381,430,153,90,243,9,252
公投第１２案,彰化縣,和美鎮,和北里,382,856,292,174,466,18,484
公投第１２案,彰化縣,和美鎮,和北里,383,966,376,183,559,24,583
公投第１２案,彰化縣,和美鎮,和西里,384,1059,350,204,554,30,584
公投第１２案,彰化縣,和美鎮,和西里,385,1117,355,247,602,34,636
公投第１２案,彰化縣,和美鎮,和西里,386,1066,339,221,560,31,591
公投第１２案,彰化縣,和美鎮,四張里,387,1252,395,258,653,32,685
公投第１２案,彰化縣,和美鎮,四張里,388,1528,473,298,771,34,805
公投第１２案,彰化縣,和美鎮,頭前里,389,826,261,209,470,26,496
公投第１２案,彰化縣,和美鎮,頭前里,390,854,278,188,466,20,486
公投第１２案,彰化縣,和美鎮,面前里,391,1387,400,301,701,46,747
公投第１２案,彰化縣,和美鎮,面前里,392,765,294,168,462,20,482
公投第１２案,彰化縣,和美鎮,鎮平里,393,1438,451,258,709,43,752
公投第１２案,彰化縣,和美鎮,鎮平里,394,1396,490,294,784,48,832
公投第１２案,彰化縣,和美鎮,大霞里,395,658,222,150,372,16,388
公投第１２案,彰化縣,和美鎮,大霞里,396,809,299,192,491,24,515
公投第１２案,彰化縣,和美鎮,源埤里,397,932,332,178,510,9,519
公投第１２案,彰化縣,和美鎮,源埤里,398,888,300,161,461,26,487
公投第１２案,彰化縣,和美鎮,南佃里,399,1144,411,250,661,39,700
公投第１２案,彰化縣,和美鎮,南佃里,400,1077,354,230,584,30,614
公投第１２案,彰化縣,和美鎮,雅溝里,401,1349,398,273,671,43,714
公投第１２案,彰化縣,和美鎮,山犁里,402,1155,401,290,691,31,722
公投第１２案,彰化縣,和美鎮,山犁里,403,1253,436,235,671,27,698
公投第１２案,彰化縣,和美鎮,山犁里,404,1252,407,259,666,27,693
公投第１２案,彰化縣,和美鎮,山犁里,405,1474,434,321,755,31,786
公投第１２案,彰化縣,和美鎮,仁愛里,406,1396,415,269,684,47,731
公投第１２案,彰化縣,和美鎮,仁愛里,407,1348,436,267,703,28,731
公投第１２案,彰化縣,和美鎮,嘉犁里,408,999,334,256,590,30,620
公投第１２案,彰化縣,和美鎮,嘉犁里,409,911,314,219,533,32,565
公投第１２案,彰化縣,和美鎮,詔安里,410,1005,346,236,582,16,598
公投第１２案,彰化縣,和美鎮,詔安里,411,967,337,194,531,35,566
公投第１２案,彰化縣,和美鎮,鐵山里,412,1308,447,291,738,28,766
公投第１２案,彰化縣,和美鎮,鐵山里,413,1324,443,267,710,40,750
公投第１２案,彰化縣,和美鎮,柑井里,414,1102,356,261,617,42,659
公投第１２案,彰化縣,和美鎮,柑井里,415,1124,378,214,592,34,626
公投第１２案,彰化縣,和美鎮,柑井里,416,1211,388,272,660,45,705
公投第１２案,彰化縣,和美鎮,竹園里,417,884,361,208,569,29,598
公投第１２案,彰化縣,和美鎮,新庄里,418,1119,303,310,613,37,650
公投第１２案,彰化縣,和美鎮,新庄里,419,1300,302,394,696,42,738
公投第１２案,彰化縣,和美鎮,犁盛里,420,1104,339,234,573,30,603
公投第１２案,彰化縣,和美鎮,犁盛里,421,1213,440,263,703,44,747
公投第１２案,彰化縣,和美鎮,中寮里,422,1127,416,146,562,15,577
公投第１２案,彰化縣,和美鎮,中圍里,423,919,282,221,503,25,528
公投第１２案,彰化縣,和美鎮,中圍里,424,987,351,215,566,32,598
公投第１２案,彰化縣,和美鎮,中圍里,425,958,316,248,564,28,592
公投第１２案,彰化縣,和美鎮,糖友里,426,1362,490,270,760,32,792
公投第１２案,彰化縣,和美鎮,糖友里,427,1461,478,305,783,29,812
公投第１２案,彰化縣,和美鎮,糖友里,428,1405,474,314,788,24,812
公投第１２案,彰化縣,和美鎮,還社里,429,860,293,199,492,28,520
公投第１２案,彰化縣,和美鎮,塗厝里,430,875,297,170,467,24,491
公投第１２案,彰化縣,和美鎮,塗厝里,431,871,249,224,473,36,509
公投第１２案,彰化縣,和美鎮,地潭里,432,883,297,214,511,40,551
公投第１２案,彰化縣,和美鎮,湖內里,433,1224,356,271,627,54,681
公投第１２案,彰化縣,和美鎮,嘉寶里,434,1075,328,243,571,30,601
公投第１２案,彰化縣,和美鎮,嘉寶里,435,956,294,210,504,39,543
公投第１２案,彰化縣,和美鎮,月眉里,436,1037,304,249,553,37,590
公投第１２案,彰化縣,和美鎮,月眉里,437,1011,338,218,556,22,578
公投第１２案,彰化縣,和美鎮,月眉里,438,1023,309,245,554,36,590
公投第１２案,彰化縣,和美鎮,好修里,439,719,209,156,365,30,395
公投第１２案,彰化縣,和美鎮,好修里,440,913,265,217,482,36,518
公投第１２案,彰化縣,伸港鄉,大同村,441,1182,321,239,560,49,609
公投第１２案,彰化縣,伸港鄉,大同村,442,1166,421,264,685,35,720
公投第１２案,彰化縣,伸港鄉,海尾村,443,966,330,207,537,26,563
公投第１２案,彰化縣,伸港鄉,海尾村,444,873,287,172,459,33,492
公投第１２案,彰化縣,伸港鄉,全興村,445,812,293,162,455,38,493
公投第１２案,彰化縣,伸港鄉,全興村,446,875,259,200,459,32,491
公投第１２案,彰化縣,伸港鄉,溪底村,447,904,264,202,466,44,510
公投第１２案,彰化縣,伸港鄉,溪底村,448,1008,309,212,521,39,560
公投第１２案,彰化縣,伸港鄉,定興村,449,1154,381,249,630,53,683
公投第１２案,彰化縣,伸港鄉,定興村,450,1486,466,253,719,64,783
公投第１２案,彰化縣,伸港鄉,什股村,451,1095,351,223,574,36,610
公投第１２案,彰化縣,伸港鄉,什股村,452,1087,320,219,539,17,556
公投第１２案,彰化縣,伸港鄉,泉州村,453,1085,359,239,598,51,649
公投第１２案,彰化縣,伸港鄉,泉州村,454,908,319,198,517,26,543
公投第１２案,彰化縣,伸港鄉,泉厝村,455,1264,432,289,721,35,756
公投第１２案,彰化縣,伸港鄉,曾家村,456,854,274,162,436,42,478
公投第１２案,彰化縣,伸港鄉,曾家村,457,846,239,156,395,35,430
公投第１２案,彰化縣,伸港鄉,蚵寮村,458,1143,308,223,531,80,611
公投第１２案,彰化縣,伸港鄉,新港村,459,1357,425,309,734,27,761
公投第１２案,彰化縣,伸港鄉,新港村,460,1349,390,317,707,45,752
公投第１２案,彰化縣,伸港鄉,新港村,461,1154,391,237,628,48,676
公投第１２案,彰化縣,伸港鄉,新港村,462,1279,387,277,664,31,695
公投第１２案,彰化縣,伸港鄉,埤墘村,463,1317,446,290,736,40,776
公投第１２案,彰化縣,伸港鄉,七嘉村,464,990,347,222,569,38,607
公投第１２案,彰化縣,伸港鄉,七嘉村,465,852,308,178,486,20,506
公投第１２案,彰化縣,伸港鄉,七嘉村,466,1178,393,271,664,16,680
公投第１２案,彰化縣,伸港鄉,汴頭村,467,1088,335,223,558,60,618
公投第１２案,彰化縣,伸港鄉,汴頭村,468,1135,365,240,605,45,650
公投第１２案,彰化縣,線西鄉,線西村,469,1071,391,216,607,24,631
公投第１２案,彰化縣,線西鄉,線西村,470,1166,433,233,666,35,701
公投第１２案,彰化縣,線西鄉,頂庄村,471,1269,424,293,717,38,755
公投第１２案,彰化縣,線西鄉,寓埔村,472,1138,381,226,607,44,651
公投第１２案,彰化縣,線西鄉,寓埔村,473,1128,388,281,669,53,722
公投第１２案,彰化縣,線西鄉,塭仔村,474,1275,409,285,694,78,772
公投第１２案,彰化縣,線西鄉,溝內村,475,1187,390,271,661,48,709
公投第１２案,彰化縣,線西鄉,下犁村,476,991,320,226,546,59,605
公投第１２案,彰化縣,線西鄉,下犁村,477,938,323,207,530,36,566
公投第１２案,彰化縣,線西鄉,頂犁村,478,1276,376,256,632,51,683
公投第１２案,彰化縣,線西鄉,頂犁村,479,1285,420,294,714,46,760
公投第１２案,彰化縣,線西鄉,德興村,480,1341,496,329,825,54,879
公投第１２案,彰化縣,員林市,崙雅里,481,1087,361,186,547,16,563
公投第１２案,彰化縣,員林市,崙雅里,482,1353,395,288,683,37,720
公投第１２案,彰化縣,員林市,振興里,483,1313,416,242,658,44,702
公投第１２案,彰化縣,員林市,振興里,484,1328,385,232,617,29,646
公投第１２案,彰化縣,員林市,林厝里,485,1055,334,235,569,28,597
公投第１２案,彰化縣,員林市,林厝里,486,959,302,200,502,30,532
公投第１２案,彰化縣,員林市,林厝里,487,772,252,169,421,31,452
公投第１２案,彰化縣,員林市,出水里,488,831,200,283,483,31,514
公投第１２案,彰化縣,員林市,出水里,489,854,215,163,378,10,388
公投第１２案,彰化縣,員林市,湖水里,490,1190,329,178,507,28,535
公投第１２案,彰化縣,員林市,大峯里,491,726,210,164,374,23,397
公投第１２案,彰化縣,員林市,鎮興里,492,1124,343,247,590,42,632
公投第１２案,彰化縣,員林市,鎮興里,493,860,256,169,425,31,456
公投第１２案,彰化縣,員林市,浮圳里,494,1122,391,241,632,41,673
公投第１２案,彰化縣,員林市,浮圳里,495,1075,368,200,568,46,614
公投第１２案,彰化縣,員林市,西東里,496,993,308,203,511,39,550
公投第１２案,彰化縣,員林市,西東里,497,967,302,190,492,30,522
公投第１２案,彰化縣,員林市,南東里,498,1008,338,206,544,37,581
公投第１２案,彰化縣,員林市,南東里,499,804,264,166,430,26,456
公投第１２案,彰化縣,員林市,中東里,500,867,272,193,465,22,487
公投第１２案,彰化縣,員林市,中東里,501,885,278,183,461,20,481
公投第１２案,彰化縣,員林市,東北里,502,1097,292,218,510,17,527
公投第１２案,彰化縣,員林市,東北里,503,1255,370,279,649,33,682
公投第１２案,彰化縣,員林市,東和里,504,1063,353,232,585,33,618
公投第１２案,彰化縣,員林市,民生里,505,925,303,200,503,15,518
公投第１２案,彰化縣,員林市,民生里,506,947,337,191,528,31,559
公投第１２案,彰化縣,員林市,民生里,507,916,331,190,521,27,548
公投第１２案,彰化縣,員林市,黎明里,508,862,150,298,448,30,478
公投第１２案,彰化縣,員林市,黎明里,509,987,339,208,547,17,564
公投第１２案,彰化縣,員林市,惠來里,510,1085,349,215,564,32,596
公投第１２案,彰化縣,員林市,惠來里,511,1110,368,245,613,25,638
公投第１２案,彰化縣,員林市,惠來里,512,1095,354,218,572,16,588
公投第１２案,彰化縣,員林市,惠來里,513,1278,446,307,753,31,784
公投第１２案,彰化縣,員林市,惠來里,514,1109,359,258,617,38,655
公投第１２案,彰化縣,員林市,中央里,515,1055,348,217,565,40,605
公投第１２案,彰化縣,員林市,中央里,516,876,302,176,478,36,514
公投第１２案,彰化縣,員林市,溝皂里,517,1115,325,205,530,27,557
公投第１２案,彰化縣,員林市,溝皂里,518,1186,425,243,668,21,689
公投第１２案,彰化縣,員林市,大饒里,519,995,356,208,564,37,601
公投第１２案,彰化縣,員林市,大饒里,520,999,319,211,530,17,547
公投第１２案,彰化縣,員林市,大饒里,521,1201,372,263,635,25,660
公投第１２案,彰化縣,員林市,大明里,522,1342,446,278,724,30,754
公投第１２案,彰化縣,員林市,大明里,523,1086,360,221,581,22,603
公投第１２案,彰化縣,員林市,萬年里,524,854,259,169,428,31,459
公投第１２案,彰化縣,員林市,萬年里,525,1064,369,211,580,25,605
公投第１２案,彰化縣,員林市,萬年里,526,879,312,203,515,16,531
公投第１２案,彰化縣,員林市,萬年里,527,827,312,221,533,29,562
公投第１２案,彰化縣,員林市,中正里,528,867,316,165,481,10,491
公投第１２案,彰化縣,員林市,中正里,529,1201,431,225,656,23,679
公投第１２案,彰化縣,員林市,中正里,530,1106,409,213,622,0,622
公投第１２案,彰化縣,員林市,仁美里,531,845,291,180,471,35,506
公投第１２案,彰化縣,員林市,仁美里,532,894,392,105,497,29,526
公投第１２案,彰化縣,員林市,仁美里,533,849,290,186,476,26,502
公投第１２案,彰化縣,員林市,新興里,534,747,279,168,447,28,475
公投第１２案,彰化縣,員林市,和平里,535,884,308,208,516,32,548
公投第１２案,彰化縣,員林市,和平里,536,900,287,158,445,28,473
公投第１２案,彰化縣,員林市,和平里,537,1040,323,206,529,17,546
公投第１２案,彰化縣,員林市,光明里,538,831,270,190,460,15,475
公投第１２案,彰化縣,員林市,中山里,539,591,213,145,358,34,392
公投第１２案,彰化縣,員林市,三條里,540,1330,402,296,698,26,724
公投第１２案,彰化縣,員林市,三條里,541,1295,412,295,707,30,737
公投第１２案,彰化縣,員林市,忠孝里,542,1283,409,267,676,41,717
公投第１２案,彰化縣,員林市,忠孝里,543,943,345,207,552,21,573
公投第１２案,彰化縣,員林市,仁愛里,544,1388,507,303,810,52,862
公投第１２案,彰化縣,員林市,三和里,545,1176,407,257,664,30,694
公投第１２案,彰化縣,員林市,三和里,546,867,296,149,445,11,456
公投第１２案,彰化縣,員林市,三和里,547,1121,320,264,584,35,619
公投第１２案,彰化縣,員林市,三和里,548,1190,374,236,610,23,633
公投第１２案,彰化縣,員林市,三和里,549,945,353,190,543,23,566
公投第１２案,彰化縣,員林市,三和里,550,906,327,198,525,22,547
公投第１２案,彰化縣,員林市,三橋里,551,978,332,230,562,38,600
公投第１２案,彰化縣,員林市,三橋里,552,949,527,182,709,34,743
公投第１２案,彰化縣,員林市,三橋里,553,949,335,216,551,24,575
公投第１２案,彰化縣,員林市,三愛里,554,1006,340,204,544,26,570
公投第１２案,彰化縣,員林市,三愛里,555,889,312,183,495,33,528
公投第１２案,彰化縣,員林市,三愛里,556,923,337,219,556,19,575
公投第１２案,彰化縣,員林市,三信里,557,1209,452,260,712,32,744
公投第１２案,彰化縣,員林市,三信里,558,1075,384,236,620,29,649
公投第１２案,彰化縣,員林市,三多里,559,1342,482,319,801,34,835
公投第１２案,彰化縣,員林市,三多里,560,1039,378,291,669,24,693
公投第１２案,彰化縣,員林市,三義里,561,1131,373,205,578,55,633
公投第１２案,彰化縣,員林市,三義里,562,1356,380,294,674,29,703
公投第１２案,彰化縣,員林市,新生里,563,1370,427,298,725,50,775
公投第１２案,彰化縣,員林市,新生里,564,1090,323,274,597,39,636
公投第１２案,彰化縣,員林市,新生里,565,821,301,216,517,19,536
公投第１２案,彰化縣,員林市,新生里,566,910,319,203,522,22,544
公投第１２案,彰化縣,員林市,南平里,567,1203,413,243,656,32,688
公投第１２案,彰化縣,員林市,南平里,568,1378,413,332,745,32,777
公投第１２案,彰化縣,員林市,南平里,569,1352,438,299,737,33,770
公投第１２案,彰化縣,員林市,南平里,570,1060,400,237,637,22,659
公投第１２案,彰化縣,員林市,南興里,571,1317,415,272,687,38,725
公投第１２案,彰化縣,員林市,南興里,572,1120,364,217,581,27,608
公投第１２案,彰化縣,員林市,南興里,573,1025,343,172,515,37,552
公投第１２案,彰化縣,員林市,南興里,574,1097,364,227,591,40,631
公投第１２案,彰化縣,員林市,源潭里,575,859,256,231,487,45,532
公投第１２案,彰化縣,員林市,源潭里,576,837,269,181,450,22,472
公投第１２案,彰化縣,員林市,大埔里,577,1090,398,254,652,34,686
公投第１２案,彰化縣,員林市,大埔里,578,1073,249,231,480,40,520
公投第１２案,彰化縣,大村鄉,大村村,579,1426,493,361,854,53,907
公投第１２案,彰化縣,大村鄉,大村村,580,1726,608,407,1015,62,1077
公投第１２案,彰化縣,大村鄉,茄苳村,581,797,298,174,472,39,511
公投第１２案,彰化縣,大村鄉,茄苳村,582,745,279,153,432,13,445
公投第１２案,彰化縣,大村鄉,田洋村,583,1125,417,227,644,50,694
公投第１２案,彰化縣,大村鄉,貢旗村,584,1486,470,345,815,54,869
公投第１２案,彰化縣,大村鄉,南勢村,585,1426,464,313,777,57,834
公投第１２案,彰化縣,大村鄉,大橋村,586,824,307,184,491,34,525
公投第１２案,彰化縣,大村鄉,大橋村,587,1177,358,227,585,40,625
公投第１２案,彰化縣,大村鄉,加錫村,588,1478,484,339,823,59,882
公投第１２案,彰化縣,大村鄉,大崙村,589,779,238,167,405,18,423
公投第１２案,彰化縣,大村鄉,大崙村,590,812,291,196,487,35,522
公投第１２案,彰化縣,大村鄉,新興村,591,1161,367,232,599,41,640
公投第１２案,彰化縣,大村鄉,擺塘村,592,1238,390,263,653,22,675
公投第１２案,彰化縣,大村鄉,擺塘村,593,1259,424,262,686,42,728
公投第１２案,彰化縣,大村鄉,過溝村,594,1412,453,326,779,42,821
公投第１２案,彰化縣,大村鄉,過溝村,595,1401,470,305,775,36,811
公投第１２案,彰化縣,大村鄉,村上村,596,1395,494,315,809,39,848
公投第１２案,彰化縣,大村鄉,美港村,597,996,314,247,561,36,597
公投第１２案,彰化縣,大村鄉,美港村,598,1047,350,231,581,32,613
公投第１２案,彰化縣,大村鄉,美港村,599,985,342,210,552,40,592
公投第１２案,彰化縣,大村鄉,黃厝村,600,1054,367,258,625,35,660
公投第１２案,彰化縣,大村鄉,黃厝村,601,1200,428,258,686,27,713
公投第１２案,彰化縣,大村鄉,福興村,602,1003,333,232,565,53,618
公投第１２案,彰化縣,大村鄉,福興村,603,1046,508,36,544,34,578
公投第１２案,彰化縣,大村鄉,平和村,604,1189,372,294,666,45,711
公投第１２案,彰化縣,大村鄉,平和村,605,1305,383,290,673,31,704
公投第１２案,彰化縣,永靖鄉,浮圳村,606,1255,366,249,615,49,664
公投第１２案,彰化縣,永靖鄉,東寧村,607,889,325,180,505,43,548
公投第１２案,彰化縣,永靖鄉,東寧村,608,1026,333,228,561,21,582
公投第１２案,彰化縣,永靖鄉,光雲村,609,724,260,162,422,30,452
公投第１２案,彰化縣,永靖鄉,光雲村,610,924,302,200,502,51,553
公投第１２案,彰化縣,永靖鄉,五汴村,611,659,236,160,396,24,420
公投第１２案,彰化縣,永靖鄉,五汴村,612,734,221,187,408,24,432
公投第１２案,彰化縣,永靖鄉,永興村,613,758,221,146,367,12,379
公投第１２案,彰化縣,永靖鄉,永興村,614,848,327,192,519,35,554
公投第１２案,彰化縣,永靖鄉,崙子村,615,1404,411,280,691,62,753
公投第１２案,彰化縣,永靖鄉,永東村,616,792,301,216,517,31,548
公投第１２案,彰化縣,永靖鄉,永西村,617,695,246,185,431,19,450
公投第１２案,彰化縣,永靖鄉,永西村,618,821,307,185,492,17,509
公投第１２案,彰化縣,永靖鄉,永南村,619,1064,346,269,615,58,673
公投第１２案,彰化縣,永靖鄉,永南村,620,840,285,172,457,30,487
公投第１２案,彰化縣,永靖鄉,永北村,621,1079,382,255,637,28,665
公投第１２案,彰化縣,永靖鄉,永北村,622,1048,398,229,627,28,655
公投第１２案,彰化縣,永靖鄉,港西村,623,960,338,255,593,27,620
公投第１２案,彰化縣,永靖鄉,港西村,624,798,260,216,476,22,498
公投第１２案,彰化縣,永靖鄉,五福村,625,796,252,236,488,40,528
公投第１２案,彰化縣,永靖鄉,五福村,626,662,221,133,354,31,385
公投第１２案,彰化縣,永靖鄉,湳港村,627,1040,346,231,577,33,610
公投第１２案,彰化縣,永靖鄉,新莊村,628,1025,315,246,561,31,592
公投第１２案,彰化縣,永靖鄉,瑚璉村,629,1357,525,309,834,42,876
公投第１２案,彰化縣,永靖鄉,瑚璉村,630,1236,429,280,709,45,754
公投第１２案,彰化縣,永靖鄉,獨鰲村,631,871,287,227,514,29,543
公投第１２案,彰化縣,永靖鄉,敦厚村,632,706,219,141,360,26,386
公投第１２案,彰化縣,永靖鄉,崙美村,633,770,259,205,464,33,497
公投第１２案,彰化縣,永靖鄉,同安村,634,669,268,158,426,21,447
公投第１２案,彰化縣,永靖鄉,同仁村,635,862,288,195,483,26,509
公投第１２案,彰化縣,永靖鄉,湳墘村,636,847,279,172,451,28,479
公投第１２案,彰化縣,永靖鄉,四芳村,637,668,241,140,381,49,430
公投第１２案,彰化縣,永靖鄉,福興村,638,1073,357,202,559,21,580
公投第１２案,彰化縣,永靖鄉,竹子村,639,1339,433,235,668,28,696
公投第１２案,彰化縣,溪湖鎮,光平里,640,1221,380,265,645,29,674
公投第１２案,彰化縣,溪湖鎮,平和里,641,638,241,147,388,21,409
公投第１２案,彰化縣,溪湖鎮,太平里,642,817,274,171,445,42,487
公投第１２案,彰化縣,溪湖鎮,太平里,643,968,362,202,564,22,586
公投第１２案,彰化縣,溪湖鎮,光華里,644,448,178,106,284,11,295
公投第１２案,彰化縣,溪湖鎮,湖東里,645,1123,363,227,590,39,629
公投第１２案,彰化縣,溪湖鎮,湖東里,646,1166,364,259,623,36,659
公投第１２案,彰化縣,溪湖鎮,湖東里,647,1151,378,234,612,40,652
公投第１２案,彰化縣,溪湖鎮,湖東里,648,1249,445,256,701,21,722
公投第１２案,彰化縣,溪湖鎮,中山里,649,1146,398,252,650,33,683
公投第１２案,彰化縣,溪湖鎮,中山里,650,1199,425,229,654,62,716
公投第１２案,彰化縣,溪湖鎮,西溪里,651,895,273,204,477,44,521
公投第１２案,彰化縣,溪湖鎮,西溪里,652,964,350,221,571,18,589
公投第１２案,彰化縣,溪湖鎮,中竹里,653,851,271,213,484,27,511
公投第１２案,彰化縣,溪湖鎮,東寮里,654,1072,390,197,587,28,615
公投第１２案,彰化縣,溪湖鎮,東寮里,655,1113,399,229,628,39,667
公投第１２案,彰化縣,溪湖鎮,東寮里,656,1090,364,257,621,34,655
公投第１２案,彰化縣,溪湖鎮,西寮里,657,1193,402,278,680,39,719
公投第１２案,彰化縣,溪湖鎮,西寮里,658,952,361,196,557,41,598
公投第１２案,彰化縣,溪湖鎮,大突里,659,1172,390,352,742,37,779
公投第１２案,彰化縣,溪湖鎮,大突里,660,1027,328,226,554,38,592
公投第１２案,彰化縣,溪湖鎮,大突里,661,1188,453,265,718,28,746
公投第１２案,彰化縣,溪湖鎮,北勢里,662,1403,441,279,720,35,755
公投第１２案,彰化縣,溪湖鎮,汴頭里,663,1397,395,274,669,55,724
公投第１２案,彰化縣,溪湖鎮,汴頭里,664,1636,547,337,884,52,936
公投第１２案,彰化縣,溪湖鎮,大竹里,665,1298,593,226,819,50,869
公投第１２案,彰化縣,溪湖鎮,大竹里,666,1214,414,233,647,51,698
公投第１２案,彰化縣,溪湖鎮,湖西里,667,1297,455,296,751,25,776
公投第１２案,彰化縣,溪湖鎮,湖西里,668,968,349,228,577,28,605
公投第１２案,彰化縣,溪湖鎮,田中里,669,839,283,186,469,37,506
公投第１２案,彰化縣,溪湖鎮,河東里,670,907,297,220,517,34,551
公投第１２案,彰化縣,溪湖鎮,河東里,671,898,287,167,454,23,477
公投第１２案,彰化縣,溪湖鎮,頂庄里,672,650,248,172,420,29,449
公投第１２案,彰化縣,溪湖鎮,忠覺里,673,1279,421,262,683,54,737
公投第１２案,彰化縣,溪湖鎮,湳底里,674,730,292,149,441,30,471
公投第１２案,彰化縣,溪湖鎮,大庭里,675,1407,470,303,773,55,828
公投第１２案,彰化縣,溪湖鎮,媽厝里,676,1273,378,208,586,53,639
公投第１２案,彰化縣,溪湖鎮,番婆里,677,988,313,191,504,43,547
公投第１２案,彰化縣,溪湖鎮,番婆里,678,754,273,179,452,29,481
公投第１２案,彰化縣,溪湖鎮,西勢里,679,1052,277,211,488,39,527
公投第１２案,彰化縣,溪湖鎮,西勢里,680,1149,361,221,582,39,621
公投第１２案,彰化縣,溪湖鎮,東溪里,681,1365,471,328,799,68,867
公投第１２案,彰化縣,埔鹽鄉,埔鹽村,682,958,356,211,567,29,596
公投第１２案,彰化縣,埔鹽鄉,埔鹽村,683,754,299,163,462,19,481
公投第１２案,彰化縣,埔鹽鄉,埔南村,684,757,294,190,484,17,501
公投第１２案,彰化縣,埔鹽鄉,埔南村,685,806,275,208,483,22,505
公投第１２案,彰化縣,埔鹽鄉,廍子村,686,1280,435,298,733,29,762
公投第１２案,彰化縣,埔鹽鄉,出水村,687,928,309,211,520,30,550
公投第１２案,彰化縣,埔鹽鄉,南港村,688,895,313,241,554,38,592
公投第１２案,彰化縣,埔鹽鄉,南港村,689,815,320,162,482,46,528
公投第１２案,彰化縣,埔鹽鄉,打廉村,690,957,318,210,528,32,560
公投第１２案,彰化縣,埔鹽鄉,豐澤村,691,1338,485,256,741,56,797
公投第１２案,彰化縣,埔鹽鄉,崑崙村,692,1106,353,232,585,55,640
公投第１２案,彰化縣,埔鹽鄉,角樹村,693,690,300,181,481,20,501
公投第１２案,彰化縣,埔鹽鄉,瓦磘村,694,1230,399,262,661,0,661
公投第１２案,彰化縣,埔鹽鄉,好修村,695,847,280,207,487,23,510
公投第１２案,彰化縣,埔鹽鄉,好修村,696,897,356,184,540,22,562
公投第１２案,彰化縣,埔鹽鄉,西湖村,697,882,282,205,487,44,531
公投第１２案,彰化縣,埔鹽鄉,西湖村,698,1180,449,233,682,34,716
公投第１２案,彰化縣,埔鹽鄉,大有村,699,1215,404,251,655,50,705
公投第１２案,彰化縣,埔鹽鄉,新興村,700,422,170,89,259,23,282
公投第１２案,彰化縣,埔鹽鄉,永平村,701,1106,378,198,576,43,619
公投第１２案,彰化縣,埔鹽鄉,永樂村,702,874,338,183,521,46,567
公投第１２案,彰化縣,埔鹽鄉,石埤村,703,1445,466,291,757,99,856
公投第１２案,彰化縣,埔鹽鄉,天盛村,704,875,303,197,500,46,546
公投第１２案,彰化縣,埔鹽鄉,太平村,705,837,274,152,426,24,450
公投第１２案,彰化縣,埔鹽鄉,太平村,706,685,265,125,390,23,413
公投第１２案,彰化縣,埔鹽鄉,新水村,707,733,270,176,446,24,470
公投第１２案,彰化縣,埔鹽鄉,新水村,708,798,295,172,467,34,501
公投第１２案,彰化縣,埔鹽鄉,三省村,709,1381,479,270,749,45,794
公投第１２案,彰化縣,埔鹽鄉,南新村,710,1335,409,262,671,51,722
公投第１２案,彰化縣,埔心鄉,東門村,711,1139,374,293,667,47,714
公投第１２案,彰化縣,埔心鄉,東門村,712,1217,402,285,687,42,729
公投第１２案,彰化縣,埔心鄉,東門村,713,1248,445,296,741,37,778
公投第１２案,彰化縣,埔心鄉,埔心村,714,1248,442,300,742,65,807
公投第１２案,彰化縣,埔心鄉,義民村,715,916,346,195,541,26,567
公投第１２案,彰化縣,埔心鄉,義民村,716,625,223,172,395,16,411
公投第１２案,彰化縣,埔心鄉,油車村,717,1271,371,297,668,59,727
公投第１２案,彰化縣,埔心鄉,瓦北村,718,608,239,132,371,26,397
公投第１２案,彰化縣,埔心鄉,瓦北村,719,1132,405,269,674,57,731
公投第１２案,彰化縣,埔心鄉,瓦中村,720,1027,374,227,601,49,650
公投第１２案,彰化縣,埔心鄉,瓦中村,721,926,328,215,543,49,592
公投第１２案,彰化縣,埔心鄉,瓦南村,722,778,241,199,440,42,482
公投第１２案,彰化縣,埔心鄉,瓦南村,723,660,261,148,409,22,431
公投第１２案,彰化縣,埔心鄉,經口村,724,1330,439,325,764,49,813
公投第１２案,彰化縣,埔心鄉,經口村,725,991,317,254,571,24,595
公投第１２案,彰化縣,埔心鄉,太平村,726,985,364,220,584,29,613
公投第１２案,彰化縣,埔心鄉,太平村,727,1034,319,244,563,29,592
公投第１２案,彰化縣,埔心鄉,大華村,728,612,213,153,366,36,402
公投第１２案,彰化縣,埔心鄉,仁里村,729,1236,408,329,737,53,790
公投第１２案,彰化縣,埔心鄉,舊舘村,730,775,269,188,457,34,491
公投第１２案,彰化縣,埔心鄉,舊舘村,731,738,258,210,468,28,496
公投第１２案,彰化縣,埔心鄉,南舘村,732,1036,353,256,609,31,640
公投第１２案,彰化縣,埔心鄉,新舘村,733,975,325,200,525,41,566
公投第１２案,彰化縣,埔心鄉,芎蕉村,734,885,291,195,486,36,522
公投第１２案,彰化縣,埔心鄉,芎蕉村,735,939,300,247,547,48,595
公投第１２案,彰化縣,埔心鄉,羅厝村,736,689,250,149,399,20,419
公投第１２案,彰化縣,埔心鄉,羅厝村,737,659,242,135,377,27,404
公投第１２案,彰化縣,埔心鄉,梧鳳村,738,910,287,204,491,22,513
公投第１２案,彰化縣,埔心鄉,二重村,739,1352,494,353,847,47,894
公投第１２案,彰化縣,埔心鄉,埤霞村,740,759,249,161,410,32,442
公投第１２案,彰化縣,埔心鄉,埤脚村,741,942,488,34,522,46,568
公投第１２案,彰化縣,田中鎮,香山里,742,854,279,166,445,36,481
公投第１２案,彰化縣,田中鎮,碧峰里,743,963,289,178,467,25,492
公投第１２案,彰化縣,田中鎮,碧峰里,744,175,27,13,40,5,45
公投第１２案,彰化縣,田中鎮,東源里,745,739,233,148,381,15,396
公投第１２案,彰化縣,田中鎮,復興里,746,826,279,149,428,22,450
公投第１２案,彰化縣,田中鎮,復興里,747,741,288,142,430,20,450
公投第１２案,彰化縣,田中鎮,平和里,748,506,130,105,235,17,252
公投第１２案,彰化縣,田中鎮,平和里,749,1001,382,191,573,47,620
公投第１２案,彰化縣,田中鎮,頂潭里,750,1281,441,253,694,49,743
公投第１２案,彰化縣,田中鎮,新庄里,751,1035,356,215,571,27,598
公投第１２案,彰化縣,田中鎮,新庄里,752,1327,501,239,740,39,779
公投第１２案,彰化縣,田中鎮,中潭里,753,844,311,186,497,26,523
公投第１２案,彰化縣,田中鎮,中潭里,754,913,310,191,501,30,531
公投第１２案,彰化縣,田中鎮,龍潭里,755,613,248,129,377,29,406
公投第１２案,彰化縣,田中鎮,北路里,756,1382,501,268,769,51,820
公投第１２案,彰化縣,田中鎮,北路里,757,1034,416,221,637,38,675
公投第１２案,彰化縣,田中鎮,北路里,758,935,392,204,596,21,617
公投第１２案,彰化縣,田中鎮,西路里,759,1301,446,263,709,45,754
公投第１２案,彰化縣,田中鎮,西路里,760,1100,371,256,627,22,649
公投第１２案,彰化縣,田中鎮,東路里,761,1071,375,246,621,33,654
公投第１２案,彰化縣,田中鎮,南路里,762,1163,436,238,674,45,719
公投第１２案,彰化縣,田中鎮,中路里,763,809,326,191,517,21,538
公投第１２案,彰化縣,田中鎮,中路里,764,1155,524,162,686,33,719
公投第１２案,彰化縣,田中鎮,梅州里,765,1270,434,256,690,41,731
公投第１２案,彰化縣,田中鎮,三安里,766,870,262,193,455,37,492
公投第１２案,彰化縣,田中鎮,三安里,767,736,259,130,389,38,427
公投第１２案,彰化縣,田中鎮,大崙里,768,1335,393,267,660,40,700
公投第１２案,彰化縣,田中鎮,沙崙里,769,876,252,215,467,34,501
公投第１２案,彰化縣,田中鎮,沙崙里,770,898,268,193,461,40,501
公投第１２案,彰化縣,田中鎮,新民里,771,1298,460,283,743,24,767
公投第１２案,彰化縣,田中鎮,新民里,772,1451,454,319,773,45,818
公投第１２案,彰化縣,田中鎮,新民里,773,1475,462,348,810,31,841
公投第１２案,彰化縣,田中鎮,三民里,774,766,223,142,365,36,401
公投第１２案,彰化縣,田中鎮,三民里,775,810,250,168,418,27,445
公投第１２案,彰化縣,田中鎮,三光里,776,953,292,242,534,35,569
公投第１２案,彰化縣,田中鎮,大社里,777,885,347,179,526,38,564
公投第１２案,彰化縣,社頭鄉,社頭村,778,791,228,212,440,27,467
公投第１２案,彰化縣,社頭鄉,社頭村,779,984,313,216,529,32,561
公投第１２案,彰化縣,社頭鄉,社頭村,780,990,300,227,527,14,541
公投第１２案,彰化縣,社頭鄉,廣興村,781,1016,389,201,590,42,632
公投第１２案,彰化縣,社頭鄉,廣興村,782,1091,355,264,619,40,659
公投第１２案,彰化縣,社頭鄉,廣興村,783,1236,401,289,690,53,743
公投第１２案,彰化縣,社頭鄉,廣興村,784,1203,389,255,644,23,667
公投第１２案,彰化縣,社頭鄉,東興村,785,753,237,168,405,22,427
公投第１２案,彰化縣,社頭鄉,東興村,786,725,231,130,361,27,388
公投第１２案,彰化縣,社頭鄉,松竹村,787,1023,324,244,568,56,624
公投第１２案,彰化縣,社頭鄉,舊社村,788,562,201,161,362,21,383
公投第１２案,彰化縣,社頭鄉,舊社村,789,1049,337,228,565,27,592
公投第１２案,彰化縣,社頭鄉,廣福村,790,933,307,224,531,31,562
公投第１２案,彰化縣,社頭鄉,橋頭村,791,990,313,261,574,31,605
公投第１２案,彰化縣,社頭鄉,橋頭村,792,1076,344,224,568,25,593
公投第１２案,彰化縣,社頭鄉,新厝村,793,742,264,178,442,16,458
公投第１２案,彰化縣,社頭鄉,新厝村,794,672,227,148,375,14,389
公投第１２案,彰化縣,社頭鄉,張厝村,795,1235,377,223,600,29,629
公投第１２案,彰化縣,社頭鄉,湳底村,796,750,250,174,424,29,453
公投第１２案,彰化縣,社頭鄉,湳底村,797,895,278,177,455,33,488
公投第１２案,彰化縣,社頭鄉,仁雅村,798,688,253,142,395,18,413
公投第１２案,彰化縣,社頭鄉,仁雅村,799,870,312,160,472,21,493
公投第１２案,彰化縣,社頭鄉,仁雅村,800,1140,413,255,668,20,688
公投第１２案,彰化縣,社頭鄉,里仁村,801,985,350,199,549,33,582
公投第１２案,彰化縣,社頭鄉,美雅村,802,1266,137,602,739,49,788
公投第１２案,彰化縣,社頭鄉,崙雅村,803,937,318,201,519,35,554
公投第１２案,彰化縣,社頭鄉,清水村,804,1219,383,279,662,29,691
公投第１２案,彰化縣,社頭鄉,山湖村,805,1165,490,245,735,46,781
公投第１２案,彰化縣,社頭鄉,埤斗村,806,986,332,214,546,45,591
公投第１２案,彰化縣,社頭鄉,仁和村,807,724,237,198,435,24,459
公投第１２案,彰化縣,社頭鄉,平和村,808,1015,359,200,559,33,592
公投第１２案,彰化縣,社頭鄉,協和村,809,1116,334,211,545,26,571
公投第１２案,彰化縣,社頭鄉,協和村,810,1061,318,232,550,27,577
公投第１２案,彰化縣,社頭鄉,泰安村,811,992,325,229,554,41,595
公投第１２案,彰化縣,社頭鄉,朝興村,812,1092,348,237,585,27,612
公投第１２案,彰化縣,社頭鄉,龍井村,813,828,293,185,478,31,509
公投第１２案,彰化縣,社頭鄉,湳雅村,814,787,231,160,391,33,424
公投第１２案,彰化縣,社頭鄉,湳雅村,815,719,203,139,342,23,365
公投第１２案,彰化縣,二水鄉,復興村,816,1028,306,238,544,65,609
公投第１２案,彰化縣,二水鄉,十五村,817,689,225,167,392,41,433
公投第１２案,彰化縣,二水鄉,合和村,818,871,281,154,435,42,477
公投第１２案,彰化縣,二水鄉,上豊村,819,953,453,86,539,34,573
公投第１２案,彰化縣,二水鄉,過圳村,820,624,207,113,320,27,347
公投第１２案,彰化縣,二水鄉,五伯村,821,645,244,158,402,30,432
公投第１２案,彰化縣,二水鄉,文化村,822,986,401,213,614,37,651
公投第１２案,彰化縣,二水鄉,光化村,823,943,399,181,580,44,624
公投第１２案,彰化縣,二水鄉,聖化村,824,455,185,93,278,5,283
公投第１２案,彰化縣,二水鄉,二水村,825,831,500,50,550,30,580
公投第１２案,彰化縣,二水鄉,惠民村,826,831,280,214,494,25,519
公投第１２案,彰化縣,二水鄉,裕民村,827,1013,353,197,550,27,577
公投第１２案,彰化縣,二水鄉,大園村,828,796,304,169,473,32,505
公投第１２案,彰化縣,二水鄉,修仁村,829,781,240,174,414,38,452
公投第１２案,彰化縣,二水鄉,合興村,830,692,212,139,351,20,371
公投第１２案,彰化縣,二水鄉,源泉村,831,635,198,150,348,26,374
公投第１２案,彰化縣,二水鄉,倡和村,832,566,195,115,310,24,334
公投第１２案,彰化縣,北斗鎮,中寮里,833,925,331,146,477,45,522
公投第１２案,彰化縣,北斗鎮,中寮里,834,869,328,165,493,39,532
公投第１２案,彰化縣,北斗鎮,中寮里,835,855,334,190,524,29,553
公投第１２案,彰化縣,北斗鎮,大道里,836,1065,412,224,636,39,675
公投第１２案,彰化縣,北斗鎮,大道里,837,828,278,184,462,44,506
公投第１２案,彰化縣,北斗鎮,西德里,838,1124,402,240,642,36,678
公投第１２案,彰化縣,北斗鎮,西德里,839,1096,379,258,637,36,673
公投第１２案,彰化縣,北斗鎮,西德里,840,1213,428,254,682,33,715
公投第１２案,彰化縣,北斗鎮,西德里,841,1164,359,234,593,53,646
公投第１２案,彰化縣,北斗鎮,西安里,842,730,247,150,397,20,417
公投第１２案,彰化縣,北斗鎮,西安里,843,878,284,189,473,22,495
公投第１２案,彰化縣,北斗鎮,光復里,844,833,325,164,489,25,514
公投第１２案,彰化縣,北斗鎮,光復里,845,957,331,216,547,23,570
公投第１２案,彰化縣,北斗鎮,新政里,846,783,259,161,420,28,448
公投第１２案,彰化縣,北斗鎮,重慶里,847,573,162,134,296,25,321
公投第１２案,彰化縣,北斗鎮,五權里,848,672,206,145,351,29,380
公投第１２案,彰化縣,北斗鎮,七星里,849,695,218,133,351,30,381
公投第１２案,彰化縣,北斗鎮,七星里,850,747,218,154,372,30,402
公投第１２案,彰化縣,北斗鎮,居仁里,851,643,243,150,393,20,413
公投第１２案,彰化縣,北斗鎮,居仁里,852,662,222,150,372,27,399
公投第１２案,彰化縣,北斗鎮,東光里,853,1085,422,236,658,39,697
公投第１２案,彰化縣,北斗鎮,東光里,854,1121,435,190,625,44,669
公投第１２案,彰化縣,北斗鎮,文昌里,855,830,307,174,481,29,510
公投第１２案,彰化縣,北斗鎮,文昌里,856,975,307,208,515,29,544
公投第１２案,彰化縣,北斗鎮,文昌里,857,1212,380,259,639,27,666
公投第１２案,彰化縣,北斗鎮,中和里,858,1302,478,260,738,43,781
公投第１２案,彰化縣,北斗鎮,新生里,859,1077,313,193,506,33,539
公投第１２案,彰化縣,北斗鎮,新生里,860,917,279,190,469,40,509
公投第１２案,彰化縣,北斗鎮,大新里,861,825,257,189,446,21,467
公投第１２案,彰化縣,北斗鎮,大新里,862,937,321,208,529,30,559
公投第１２案,彰化縣,田尾鄉,田尾村,863,1284,378,248,626,45,671
公投第１２案,彰化縣,田尾鄉,溪畔村,864,1187,417,259,676,51,727
公投第１２案,彰化縣,田尾鄉,打簾村,865,1033,367,221,588,42,630
公投第１２案,彰化縣,田尾鄉,打簾村,866,696,280,123,403,24,427
公投第１２案,彰化縣,田尾鄉,正義村,867,872,333,176,509,29,538
公投第１２案,彰化縣,田尾鄉,北曾村,868,680,213,142,355,22,377
公投第１２案,彰化縣,田尾鄉,北曾村,869,875,313,213,526,33,559
公投第１２案,彰化縣,田尾鄉,南曾村,870,1337,439,247,686,44,730
公投第１２案,彰化縣,田尾鄉,饒平村,871,1376,507,282,789,52,841
公投第１２案,彰化縣,田尾鄉,饒平村,872,1186,467,233,700,37,737
公投第１２案,彰化縣,田尾鄉,豐田村,873,874,353,208,561,45,606
公投第１２案,彰化縣,田尾鄉,仁里村,874,647,207,140,347,19,366
公投第１２案,彰化縣,田尾鄉,仁里村,875,959,360,193,553,22,575
公投第１２案,彰化縣,田尾鄉,新厝村,876,263,82,48,130,14,144
公投第１２案,彰化縣,田尾鄉,溪頂村,877,618,202,106,308,29,337
公投第１２案,彰化縣,田尾鄉,柳鳳村,878,938,368,214,582,20,602
公投第１２案,彰化縣,田尾鄉,陸豐村,879,880,327,196,523,41,564
公投第１２案,彰化縣,田尾鄉,海豐村,880,804,249,158,407,23,430
公投第１２案,彰化縣,田尾鄉,海豐村,881,592,171,140,311,18,329
公投第１２案,彰化縣,田尾鄉,睦宜村,882,1079,394,235,629,60,689
公投第１２案,彰化縣,田尾鄉,新生村,883,1336,407,318,725,52,777
公投第１２案,彰化縣,田尾鄉,北鎮村,884,1198,367,248,615,37,652
公投第１２案,彰化縣,田尾鄉,南鎮村,885,621,190,130,320,35,355
公投第１２案,彰化縣,田尾鄉,福田村,886,760,223,172,395,19,414
公投第１２案,彰化縣,田尾鄉,新興村,887,1084,355,280,635,66,701
公投第１２案,彰化縣,埤頭鄉,和豊村,888,1178,340,186,526,45,571
公投第１２案,彰化縣,埤頭鄉,和豊村,889,1290,381,265,646,38,684
公投第１２案,彰化縣,埤頭鄉,興農村,890,973,258,224,482,52,534
公投第１２案,彰化縣,埤頭鄉,興農村,891,783,233,156,389,31,420
公投第１２案,彰化縣,埤頭鄉,埤頭村,892,733,215,162,377,41,418
公投第１２案,彰化縣,埤頭鄉,埤頭村,893,899,263,208,471,58,529
公投第１２案,彰化縣,埤頭鄉,豊崙村,894,965,277,210,487,57,544
公投第１２案,彰化縣,埤頭鄉,豊崙村,895,1356,440,228,668,46,714
公投第１２案,彰化縣,埤頭鄉,崙子村,896,1265,395,256,651,43,694
公投第１２案,彰化縣,埤頭鄉,永豊村,897,877,342,161,503,39,542
公投第１２案,彰化縣,埤頭鄉,永豊村,898,705,211,135,346,36,382
公投第１２案,彰化縣,埤頭鄉,合興村,899,1062,387,236,623,34,657
公投第１２案,彰化縣,埤頭鄉,合興村,900,1300,463,246,709,41,750
公投第１２案,彰化縣,埤頭鄉,合興村,901,923,323,169,492,48,540
公投第１２案,彰化縣,埤頭鄉,平原村,902,1085,335,193,528,43,571
公投第１２案,彰化縣,埤頭鄉,平原村,903,1103,357,239,596,58,654
公投第１２案,彰化縣,埤頭鄉,崙腳村,904,735,216,150,366,22,388
公投第１２案,彰化縣,埤頭鄉,元埔村,905,574,145,142,287,29,316
公投第１２案,彰化縣,埤頭鄉,芙朝村,906,767,219,129,348,39,387
公投第１２案,彰化縣,埤頭鄉,芙朝村,907,737,234,139,373,34,407
公投第１２案,彰化縣,埤頭鄉,新庄村,908,1058,194,191,385,53,438
公投第１２案,彰化縣,埤頭鄉,陸嘉村,909,826,219,145,364,63,427
公投第１２案,彰化縣,埤頭鄉,竹圍村,910,1082,302,182,484,66,550
公投第１２案,彰化縣,埤頭鄉,中和村,911,737,252,154,406,42,448
公投第１２案,彰化縣,埤頭鄉,中和村,912,711,207,151,358,16,374
公投第１２案,彰化縣,埤頭鄉,庄內村,913,1043,349,203,552,48,600
公投第１２案,彰化縣,埤頭鄉,大湖村,914,910,275,169,444,24,468
公投第１２案,彰化縣,溪州鄉,溪厝村,915,778,264,141,405,27,432
公投第１２案,彰化縣,溪州鄉,溪厝村,916,1061,298,206,504,24,528
公投第１２案,彰化縣,溪州鄉,坑厝村,917,701,225,118,343,24,367
公投第１２案,彰化縣,溪州鄉,瓦厝村,918,879,337,181,518,30,548
公投第１２案,彰化縣,溪州鄉,溪州村,919,654,160,243,403,29,432
公投第１２案,彰化縣,溪州鄉,溪州村,920,878,296,188,484,21,505
公投第１２案,彰化縣,溪州鄉,尾厝村,921,942,344,210,554,28,582
公投第１２案,彰化縣,溪州鄉,尾厝村,922,871,294,165,459,25,484
公投第１２案,彰化縣,溪州鄉,東州村,923,1047,364,170,534,23,557
公投第１２案,彰化縣,溪州鄉,東州村,924,858,264,210,474,34,508
公投第１２案,彰化縣,溪州鄉,舊眉村,925,1409,374,227,601,50,651
公投第１２案,彰化縣,溪州鄉,圳寮村,926,792,266,148,414,11,425
公投第１２案,彰化縣,溪州鄉,圳寮村,927,714,210,140,350,36,386
公投第１２案,彰化縣,溪州鄉,西畔村,928,1109,292,204,496,45,541
公投第１２案,彰化縣,溪州鄉,西畔村,929,962,210,187,397,38,435
公投第１２案,彰化縣,溪州鄉,柑園村,930,1157,288,194,482,48,530
公投第１２案,彰化縣,溪州鄉,成功村,931,952,278,182,460,38,498
公投第１２案,彰化縣,溪州鄉,成功村,932,887,245,192,437,40,477
公投第１２案,彰化縣,溪州鄉,大庄村,933,866,185,164,349,36,385
公投第１２案,彰化縣,溪州鄉,大庄村,934,1010,241,198,439,49,488
公投第１２案,彰化縣,溪州鄉,榮光村,935,853,220,189,409,19,428
公投第１２案,彰化縣,溪州鄉,潮洋村,936,843,235,164,399,41,440
公投第１２案,彰化縣,溪州鄉,張厝村,937,711,148,109,257,15,272
公投第１２案,彰化縣,溪州鄉,菜公村,938,851,272,150,422,50,472
公投第１２案,彰化縣,溪州鄉,三條村,939,883,250,163,413,32,445
公投第１２案,彰化縣,溪州鄉,三圳村,940,1247,384,207,591,43,634
公投第１２案,彰化縣,溪州鄉,水尾村,941,1490,446,336,782,49,831
公投第１２案,彰化縣,二林鎮,豐田里,942,731,182,111,293,31,324
公投第１２案,彰化縣,二林鎮,豐田里,943,1025,329,220,549,40,589
公投第１２案,彰化縣,二林鎮,豐田里,944,784,246,187,433,22,455
公投第１２案,彰化縣,二林鎮,東和里,945,892,315,175,490,28,518
公投第１２案,彰化縣,二林鎮,東和里,946,1256,423,268,691,42,733
公投第１２案,彰化縣,二林鎮,南光里,947,1043,314,218,532,41,573
公投第１２案,彰化縣,二林鎮,南光里,948,1076,349,271,620,29,649
公投第１２案,彰化縣,二林鎮,南光里,949,1082,353,252,605,37,642
公投第１２案,彰化縣,二林鎮,西平里,950,1427,640,97,737,41,778
公投第１２案,彰化縣,二林鎮,北平里,951,1030,290,195,485,42,527
公投第１２案,彰化縣,二林鎮,北平里,952,1033,280,219,499,37,536
公投第１２案,彰化縣,二林鎮,北平里,953,977,289,216,505,38,543
公投第１２案,彰化縣,二林鎮,中西里,954,683,204,130,334,19,353
公投第１２案,彰化縣,二林鎮,中西里,955,975,290,159,449,63,512
公投第１２案,彰化縣,二林鎮,廣興里,956,1336,342,214,556,49,605
公投第１２案,彰化縣,二林鎮,香田里,957,1019,248,189,437,48,485
公投第１２案,彰化縣,二林鎮,外竹里,958,1003,217,190,407,37,444
公投第１２案,彰化縣,二林鎮,興華里,959,1151,386,220,606,44,650
公投第１２案,彰化縣,二林鎮,東興里,960,1598,521,320,841,69,910
公投第１２案,彰化縣,二林鎮,後厝里,961,1488,470,283,753,50,803
公投第１２案,彰化縣,二林鎮,後厝里,962,1771,609,330,939,51,990
公投第１２案,彰化縣,二林鎮,頂厝里,963,1360,321,231,552,35,587
公投第１２案,彰化縣,二林鎮,趙甲里,964,1613,436,272,708,50,758
公投第１２案,彰化縣,二林鎮,振興里,965,1228,362,215,577,64,641
公投第１２案,彰化縣,二林鎮,萬興里,966,771,264,159,423,16,439
公投第１２案,彰化縣,二林鎮,永興里,967,858,302,185,487,21,508
公投第１２案,彰化縣,二林鎮,永興里,968,661,183,116,299,4,303
公投第１２案,彰化縣,二林鎮,西庄里,969,1268,353,230,583,56,639
公投第１２案,彰化縣,二林鎮,梅芳里,970,1081,321,187,508,22,530
公投第１２案,彰化縣,二林鎮,華崙里,971,1213,351,216,567,27,594
公投第１２案,彰化縣,二林鎮,華崙里,972,1328,427,284,711,29,740
公投第１２案,彰化縣,二林鎮,華崙里,973,1118,298,181,479,55,534
公投第１２案,彰化縣,二林鎮,萬合里,974,1157,399,196,595,40,635
公投第１２案,彰化縣,二林鎮,東勢里,975,972,285,164,449,30,479
公投第１２案,彰化縣,二林鎮,大永里,976,902,269,183,452,33,485
公投第１２案,彰化縣,二林鎮,原斗里,977,1273,489,278,767,37,804
公投第１２案,彰化縣,二林鎮,西斗里,978,1087,329,229,558,29,587
公投第１２案,彰化縣,二林鎮,東華里,979,987,327,198,525,64,589
公投第１２案,彰化縣,二林鎮,復豐里,980,719,198,127,325,22,347
公投第１２案,彰化縣,大城鄉,山腳村,981,1288,263,166,429,26,455
公投第１２案,彰化縣,大城鄉,潭墘村,982,1104,232,145,377,51,428
公投第１２案,彰化縣,大城鄉,大城村,983,964,328,174,502,39,541
公投第１２案,彰化縣,大城鄉,東城村,984,1312,351,202,553,55,608
公投第１２案,彰化縣,大城鄉,西城村,985,853,208,114,322,44,366
公投第１２案,彰化縣,大城鄉,上山村,986,518,108,59,167,17,184
公投第１２案,彰化縣,大城鄉,上山村,987,574,136,92,228,22,250
公投第１２案,彰化縣,大城鄉,永和村,988,702,130,109,239,29,268
公投第１２案,彰化縣,大城鄉,公館村,989,376,55,54,109,10,119
公投第１２案,彰化縣,大城鄉,公館村,990,693,135,64,199,18,217
公投第１２案,彰化縣,大城鄉,豐美村,991,877,206,140,346,41,387
公投第１２案,彰化縣,大城鄉,三豐村,992,655,101,87,188,18,206
公投第１２案,彰化縣,大城鄉,菜寮村,993,1103,254,140,394,31,425
公投第１２案,彰化縣,大城鄉,東港村,994,1192,221,169,390,27,417
公投第１２案,彰化縣,大城鄉,西港村,995,917,211,128,339,22,361
公投第１２案,彰化縣,大城鄉,頂庄村,996,686,137,75,212,18,230
公投第１２案,彰化縣,大城鄉,臺西村,997,899,164,108,272,20,292
公投第１２案,彰化縣,芳苑鄉,芳苑村,998,940,183,117,300,37,337
公投第１２案,彰化縣,芳苑鄉,芳中村,999,403,97,50,147,23,170
公投第１２案,彰化縣,芳苑鄉,仁愛村,1000,756,215,135,350,30,380
公投第１２案,彰化縣,芳苑鄉,信義村,1001,548,97,60,157,21,178
公投第１２案,彰化縣,芳苑鄉,後寮村,1002,997,294,188,482,40,522
公投第１２案,彰化縣,芳苑鄉,三合村,1003,1300,307,235,542,52,594
公投第１２案,彰化縣,芳苑鄉,三合村,1004,859,223,180,403,40,443
公投第１２案,彰化縣,芳苑鄉,永興村,1005,734,220,151,371,14,385
公投第１２案,彰化縣,芳苑鄉,永興村,1006,636,155,126,281,24,305
公投第１２案,彰化縣,芳苑鄉,新街村,1007,808,196,138,334,49,383
公投第１２案,彰化縣,芳苑鄉,路上村,1008,668,143,119,262,33,295
公投第１２案,彰化縣,芳苑鄉,路平村,1009,744,184,160,344,34,378
公投第１２案,彰化縣,芳苑鄉,三成村,1010,1026,311,176,487,59,546
公投第１２案,彰化縣,芳苑鄉,福榮村,1011,586,138,93,231,14,245
公投第１２案,彰化縣,芳苑鄉,頂廍村,1012,593,161,119,280,35,315
公投第１２案,彰化縣,芳苑鄉,王功村,1013,1071,353,171,524,44,568
公投第１２案,彰化縣,芳苑鄉,王功村,1014,1060,228,179,407,53,460
公投第１２案,彰化縣,芳苑鄉,博愛村,1015,708,252,122,374,18,392
公投第１２案,彰化縣,芳苑鄉,和平村,1016,735,209,120,329,36,365
公投第１２案,彰化縣,芳苑鄉,興仁村,1017,571,181,125,306,30,336
公投第１２案,彰化縣,芳苑鄉,興仁村,1018,729,193,101,294,30,324
公投第１２案,彰化縣,芳苑鄉,民生村,1019,674,219,104,323,35,358
公投第１２案,彰化縣,芳苑鄉,新寶村,1020,846,242,169,411,24,435
公投第１２案,彰化縣,芳苑鄉,新寶村,1021,806,299,148,447,29,476
公投第１２案,彰化縣,芳苑鄉,五俊村,1022,470,118,65,183,15,198
公投第１２案,彰化縣,芳苑鄉,草湖村,1023,1124,351,221,572,44,616
公投第１２案,彰化縣,芳苑鄉,草湖村,1024,317,83,52,135,17,152
公投第１２案,彰化縣,芳苑鄉,建平村,1025,1158,272,173,445,54,499
公投第１２案,彰化縣,芳苑鄉,建平村,1026,967,286,148,434,29,463
公投第１２案,彰化縣,芳苑鄉,崙腳村,1027,762,217,148,365,44,409
公投第１２案,彰化縣,芳苑鄉,文津村,1028,1086,248,197,445,36,481
公投第１２案,彰化縣,芳苑鄉,新生村,1029,747,210,128,338,30,368
公投第１２案,彰化縣,芳苑鄉,新生村,1030,653,143,101,244,22,266
公投第１２案,彰化縣,芳苑鄉,漢寶村,1031,872,306,164,470,44,514
公投第１２案,彰化縣,芳苑鄉,漢寶村,1032,1235,423,268,691,54,745
公投第１２案,彰化縣,芳苑鄉,漢寶村,1033,1102,328,215,543,45,588
公投第１２案,彰化縣,竹塘鄉,竹元村,1034,1168,388,244,632,48,680
公投第１２案,彰化縣,竹塘鄉,竹塘村,1035,965,336,222,558,17,575
公投第１２案,彰化縣,竹塘鄉,竹塘村,1036,960,339,221,560,42,602
公投第１２案,彰化縣,竹塘鄉,小西村,1037,743,161,278,439,42,481
公投第１２案,彰化縣,竹塘鄉,民靖村,1038,751,172,135,307,36,343
公投第１２案,彰化縣,竹塘鄉,五庄村,1039,792,230,124,354,31,385
公投第１２案,彰化縣,竹塘鄉,五庄村,1040,733,196,145,341,15,356
公投第１２案,彰化縣,竹塘鄉,樹腳村,1041,657,207,123,330,29,359
公投第１２案,彰化縣,竹塘鄉,田頭村,1042,1063,329,202,531,40,571
公投第１２案,彰化縣,竹塘鄉,新廣村,1043,1114,328,252,580,60,640
公投第１２案,彰化縣,竹塘鄉,溪墘村,1044,506,198,119,317,22,339
公投第１２案,彰化縣,竹塘鄉,竹林村,1045,823,193,190,383,44,427
公投第１２案,彰化縣,竹塘鄉,土庫村,1046,654,184,130,314,23,337
公投第１２案,彰化縣,竹塘鄉,內新村,1047,577,170,87,257,15,272
公投第１２案,彰化縣,竹塘鄉,長安村,1048,772,205,159,364,47,411
公投第１２案,彰化縣,竹塘鄉,永安村,1049,543,119,86,205,47,252
公投第１２案,南投縣,南投市,龍泉里,1,927,343,205,548,21,569
公投第１２案,南投縣,南投市,康壽里,2,667,282,149,431,24,455
公投第１２案,南投縣,南投市,康壽里,3,773,285,193,478,18,496
公投第１２案,南投縣,南投市,三民里,4,818,304,185,489,29,518
公投第１２案,南投縣,南投市,仁和里,5,525,211,125,336,20,356
公投第１２案,南投縣,南投市,南投里,6,575,218,143,361,22,383
公投第１２案,南投縣,南投市,彰仁里,7,368,161,88,249,7,256
公投第１２案,南投縣,南投市,崇文里,8,956,420,182,602,31,633
公投第１２案,南投縣,南投市,三興里,9,1245,412,240,652,20,672
公投第１２案,南投縣,南投市,三興里,10,1484,527,303,830,12,842
公投第１２案,南投縣,南投市,三興里,11,1191,491,264,755,28,783
公投第１２案,南投縣,南投市,三興里,12,1506,537,339,876,44,920
公投第１２案,南投縣,南投市,三和里,13,1070,376,268,644,31,675
公投第１２案,南投縣,南投市,三和里,14,670,265,142,407,21,428
公投第１２案,南投縣,南投市,三和里,15,1050,418,246,664,37,701
公投第１２案,南投縣,南投市,嘉興里,16,1122,352,230,582,34,616
公投第１２案,南投縣,南投市,嘉興里,17,984,285,244,529,29,558
公投第１２案,南投縣,南投市,嘉和里,18,1062,405,273,678,31,709
公投第１２案,南投縣,南投市,嘉和里,19,1053,359,236,595,46,641
公投第１２案,南投縣,南投市,嘉和里,20,1104,373,290,663,39,702
公投第１２案,南投縣,南投市,嘉和里,21,1192,383,281,664,31,695
公投第１２案,南投縣,南投市,平和里,22,960,352,179,531,20,551
公投第１２案,南投縣,南投市,平和里,23,906,344,179,523,35,558
公投第１２案,南投縣,南投市,平和里,24,957,367,201,568,30,598
公投第１２案,南投縣,南投市,平和里,25,997,394,230,624,31,655
公投第１２案,南投縣,南投市,平和里,26,1008,378,222,600,30,630
公投第１２案,南投縣,南投市,平和里,27,1164,408,255,663,23,686
公投第１２案,南投縣,南投市,振興里,28,587,197,139,336,14,350
公投第１２案,南投縣,南投市,振興里,29,734,216,171,387,29,416
公投第１２案,南投縣,南投市,振興里,30,724,238,151,389,43,432
公投第１２案,南投縣,南投市,千秋里,31,1003,376,196,572,27,599
公投第１２案,南投縣,南投市,軍功里,32,1356,488,268,756,33,789
公投第１２案,南投縣,南投市,軍功里,33,1373,396,318,714,40,754
公投第１２案,南投縣,南投市,軍功里,34,1452,485,296,781,34,815
公投第１２案,南投縣,南投市,軍功里,35,362,130,73,203,10,213
公投第１２案,南投縣,南投市,東山里,36,389,114,99,213,22,235
公投第１２案,南投縣,南投市,營南里,37,1276,450,337,787,43,830
公投第１２案,南投縣,南投市,營南里,38,1089,410,254,664,50,714
公投第１２案,南投縣,南投市,營北里,39,921,325,224,549,44,593
公投第１２案,南投縣,南投市,營北里,40,892,387,219,606,14,620
公投第１２案,南投縣,南投市,營北里,41,1050,421,245,666,29,695
公投第１２案,南投縣,南投市,營北里,42,1078,419,233,652,31,683
公投第１２案,南投縣,南投市,營北里,43,1078,411,241,652,16,668
公投第１２案,南投縣,南投市,營北里,44,861,366,226,592,32,624
公投第１２案,南投縣,南投市,內興里,45,1221,454,241,695,41,736
公投第１２案,南投縣,南投市,內興里,46,1105,432,215,647,23,670
公投第１２案,南投縣,南投市,內興里,47,1230,447,287,734,23,757
公投第１２案,南投縣,南投市,內興里,48,1092,424,227,651,24,675
公投第１２案,南投縣,南投市,內興里,49,1286,511,293,804,22,826
公投第１２案,南投縣,南投市,內興里,50,655,268,161,429,28,457
公投第１２案,南投縣,南投市,內新里,51,719,273,180,453,18,471
公投第１２案,南投縣,南投市,內新里,52,720,238,187,425,17,442
公投第１２案,南投縣,南投市,光輝里,53,509,211,115,326,16,342
公投第１２案,南投縣,南投市,光榮里,54,492,187,81,268,15,283
公投第１２案,南投縣,南投市,光榮里,55,616,249,113,362,13,375
公投第１２案,南投縣,南投市,光明里,56,1010,421,189,610,28,638
公投第１２案,南投縣,南投市,光華里,57,848,341,154,495,16,511
公投第１２案,南投縣,南投市,漳興里,58,1387,534,320,854,39,893
公投第１２案,南投縣,南投市,漳興里,59,1245,499,274,773,33,806
公投第１２案,南投縣,南投市,漳和里,60,1199,590,89,679,28,707
公投第１２案,南投縣,南投市,漳和里,61,1288,487,266,753,42,795
公投第１２案,南投縣,南投市,漳和里,62,1040,370,223,593,30,623
公投第１２案,南投縣,南投市,漳和里,63,1070,375,259,634,29,663
公投第１２案,南投縣,南投市,漳和里,64,1299,481,311,792,27,819
公投第１２案,南投縣,南投市,漳和里,65,1122,441,239,680,32,712
公投第１２案,南投縣,南投市,平山里,66,1414,506,304,810,34,844
公投第１２案,南投縣,南投市,平山里,67,1121,403,234,637,33,670
公投第１２案,南投縣,南投市,平山里,68,1434,498,310,808,21,829
公投第１２案,南投縣,南投市,平山里,69,1393,481,253,734,39,773
公投第１２案,南投縣,南投市,新興里,70,1059,387,208,595,19,614
公投第１２案,南投縣,南投市,新興里,71,1218,434,254,688,23,711
公投第１２案,南投縣,南投市,新興里,72,1293,296,409,705,17,722
公投第１２案,南投縣,南投市,新興里,73,1337,416,238,654,22,676
公投第１２案,南投縣,南投市,永豐里,74,876,326,213,539,26,565
公投第１２案,南投縣,南投市,永豐里,75,971,410,126,536,26,562
公投第１２案,南投縣,南投市,永豐里,76,1012,339,233,572,23,595
公投第１２案,南投縣,南投市,福興里,77,973,333,192,525,30,555
公投第１２案,南投縣,南投市,福興里,78,1002,397,226,623,23,646
公投第１２案,南投縣,南投市,福興里,79,1024,312,264,576,37,613
公投第１２案,南投縣,南投市,鳳山里,80,1122,285,222,507,87,594
公投第１２案,南投縣,南投市,永興里,81,790,228,150,378,22,400
公投第１２案,南投縣,南投市,鳳鳴里,82,647,164,125,289,18,307
公投第１２案,南投縣,南投市,福山里,83,950,477,44,521,45,566
公投第１２案,南投縣,南投市,福山里,84,980,284,222,506,26,532
公投第１２案,南投縣,埔里鎮,東門里,85,828,277,192,469,33,502
公投第１２案,南投縣,埔里鎮,東門里,86,786,283,178,461,31,492
公投第１２案,南投縣,埔里鎮,東門里,87,1062,370,210,580,29,609
公投第１２案,南投縣,埔里鎮,杷城里,88,1201,416,299,715,36,751
公投第１２案,南投縣,埔里鎮,杷城里,89,1415,464,303,767,26,793
公投第１２案,南投縣,埔里鎮,枇杷里,90,1282,415,286,701,24,725
公投第１２案,南投縣,埔里鎮,枇杷里,91,859,313,159,472,40,512
公投第１２案,南投縣,埔里鎮,枇杷里,92,1288,423,269,692,56,748
公投第１２案,南投縣,埔里鎮,枇杷里,93,1330,429,307,736,25,761
公投第１２案,南投縣,埔里鎮,枇杷里,94,1416,434,299,733,36,769
公投第１２案,南投縣,埔里鎮,枇杷里,95,1283,390,239,629,23,652
公投第１２案,南投縣,埔里鎮,水頭里,96,1151,341,316,657,47,704
公投第１２案,南投縣,埔里鎮,水頭里,97,1193,366,239,605,30,635
公投第１２案,南投縣,埔里鎮,水頭里,98,1471,473,315,788,64,852
公投第１２案,南投縣,埔里鎮,麒麟里,99,1044,282,187,469,64,533
公投第１２案,南投縣,埔里鎮,珠格里,100,1122,393,232,625,40,665
公投第１２案,南投縣,埔里鎮,溪南里,101,1129,482,218,700,29,729
公投第１２案,南投縣,埔里鎮,西門里,102,901,309,186,495,13,508
公投第１２案,南投縣,埔里鎮,西門里,103,997,310,190,500,44,544
公投第１２案,南投縣,埔里鎮,西門里,104,1209,392,253,645,37,682
公投第１２案,南投縣,埔里鎮,南門里,105,838,346,180,526,29,555
公投第１２案,南投縣,埔里鎮,北門里,106,1226,357,224,581,33,614
公投第１２案,南投縣,埔里鎮,北門里,107,1263,454,287,741,53,794
公投第１２案,南投縣,埔里鎮,北安里,108,1045,380,241,621,16,637
公投第１２案,南投縣,埔里鎮,北安里,109,1120,415,255,670,33,703
公投第１２案,南投縣,埔里鎮,北安里,110,1062,398,259,657,36,693
公投第１２案,南投縣,埔里鎮,北梅里,111,1022,343,220,563,37,600
公投第１２案,南投縣,埔里鎮,北梅里,112,1051,363,212,575,22,597
公投第１２案,南投縣,埔里鎮,北梅里,113,1106,354,246,600,25,625
公投第１２案,南投縣,埔里鎮,泰安里,114,1098,374,225,599,25,624
公投第１２案,南投縣,埔里鎮,泰安里,115,1067,369,245,614,18,632
公投第１２案,南投縣,埔里鎮,大湳里,116,725,180,214,394,35,429
公投第１２案,南投縣,埔里鎮,大湳里,117,905,295,227,522,26,548
公投第１２案,南投縣,埔里鎮,蜈蚣里,118,1179,373,238,611,30,641
公投第１２案,南投縣,埔里鎮,蜈蚣里,119,944,291,186,477,20,497
公投第１２案,南投縣,埔里鎮,蜈蚣里,120,465,152,86,238,31,269
公投第１２案,南投縣,埔里鎮,同聲里,121,1133,363,235,598,44,642
公投第１２案,南投縣,埔里鎮,同聲里,122,1100,350,222,572,32,604
公投第１２案,南投縣,埔里鎮,清新里,123,1155,417,241,658,39,697
公投第１２案,南投縣,埔里鎮,清新里,124,1254,482,141,623,49,672
公投第１２案,南投縣,埔里鎮,清新里,125,1296,403,256,659,40,699
公投第１２案,南投縣,埔里鎮,薰化里,126,1023,399,230,629,35,664
公投第１２案,南投縣,埔里鎮,大城里,127,964,279,206,485,17,502
公投第１２案,南投縣,埔里鎮,大城里,128,986,329,228,557,26,583
公投第１２案,南投縣,埔里鎮,大城里,129,1016,341,248,589,27,616
公投第１２案,南投縣,埔里鎮,大城里,130,898,311,194,505,32,537
公投第１２案,南投縣,埔里鎮,大城里,131,980,317,248,565,30,595
公投第１２案,南投縣,埔里鎮,大城里,132,933,330,207,537,31,568
公投第１２案,南投縣,埔里鎮,籃城里,133,929,349,271,620,33,653
公投第１２案,南投縣,埔里鎮,桃米里,134,1032,340,222,562,31,593
公投第１２案,南投縣,埔里鎮,成功里,135,315,93,54,147,4,151
公投第１２案,南投縣,埔里鎮,南村里,136,1363,406,275,681,52,733
公投第１２案,南投縣,埔里鎮,愛蘭里,137,725,257,158,415,28,443
公投第１２案,南投縣,埔里鎮,愛蘭里,138,705,245,161,406,21,427
公投第１２案,南投縣,埔里鎮,鐵山里,139,751,281,157,438,27,465
公投第１２案,南投縣,埔里鎮,鐵山里,140,932,398,114,512,22,534
公投第１２案,南投縣,埔里鎮,房里里,141,956,303,239,542,30,572
公投第１２案,南投縣,埔里鎮,房里里,142,376,113,92,205,11,216
公投第１２案,南投縣,埔里鎮,向善里,143,682,209,160,369,38,407
公投第１２案,南投縣,埔里鎮,一新里,144,990,470,136,606,40,646
公投第１２案,南投縣,埔里鎮,合成里,145,1324,352,248,600,66,666
公投第１２案,南投縣,埔里鎮,合成里,146,298,70,62,132,16,148
公投第１２案,南投縣,埔里鎮,廣成里,147,1170,354,231,585,72,657
公投第１２案,南投縣,埔里鎮,史港里,148,604,180,163,343,18,361
公投第１２案,南投縣,埔里鎮,福興里,149,999,302,214,516,37,553
公投第１２案,南投縣,埔里鎮,牛眠里,150,923,273,186,459,20,479
公投第１２案,南投縣,埔里鎮,牛眠里,151,887,304,201,505,32,537
公投第１２案,南投縣,埔里鎮,牛眠里,152,981,283,231,514,22,536
公投第１２案,南投縣,草屯鎮,玉峰里,153,998,385,225,610,18,628
公投第１２案,南投縣,草屯鎮,玉峰里,154,1127,355,249,604,26,630
公投第１２案,南投縣,草屯鎮,明正里,155,1401,446,290,736,20,756
公投第１２案,南投縣,草屯鎮,明正里,156,1110,357,244,601,30,631
公投第１２案,南投縣,草屯鎮,明正里,157,1285,420,306,726,35,761
公投第１２案,南投縣,草屯鎮,炎峰里,158,936,334,180,514,26,540
公投第１２案,南投縣,草屯鎮,炎峰里,159,1141,366,264,630,40,670
公投第１２案,南投縣,草屯鎮,中正里,160,705,270,162,432,12,444
公投第１２案,南投縣,草屯鎮,和平里,161,1121,457,239,696,17,713
公投第１２案,南投縣,草屯鎮,中山里,162,877,346,213,559,21,580
公投第１２案,南投縣,草屯鎮,中山里,163,1401,462,307,769,51,820
公投第１２案,南投縣,草屯鎮,敦和里,164,1267,437,232,669,31,700
公投第１２案,南投縣,草屯鎮,敦和里,165,1214,393,281,674,47,721
公投第１２案,南投縣,草屯鎮,敦和里,166,1259,410,298,708,44,752
公投第１２案,南投縣,草屯鎮,敦和里,167,1442,520,332,852,24,876
公投第１２案,南投縣,草屯鎮,敦和里,168,1273,458,284,742,24,766
公投第１２案,南投縣,草屯鎮,山腳里,169,1145,381,252,633,27,660
公投第１２案,南投縣,草屯鎮,山腳里,170,1279,448,258,706,23,729
公投第１２案,南投縣,草屯鎮,山腳里,171,1158,384,235,619,34,653
公投第１２案,南投縣,草屯鎮,山腳里,172,1335,530,316,846,34,880
公投第１２案,南投縣,草屯鎮,山腳里,173,1178,461,276,737,31,768
公投第１２案,南投縣,草屯鎮,山腳里,174,1327,433,327,760,27,787
公投第１２案,南投縣,草屯鎮,新厝里,175,1000,369,217,586,23,609
公投第１２案,南投縣,草屯鎮,新厝里,176,1257,431,276,707,34,741
公投第１２案,南投縣,草屯鎮,新厝里,177,883,349,206,555,16,571
公投第１２案,南投縣,草屯鎮,上林里,178,1121,361,236,597,24,621
公投第１２案,南投縣,草屯鎮,上林里,179,1043,359,235,594,27,621
公投第１２案,南投縣,草屯鎮,上林里,180,979,379,212,591,12,603
公投第１２案,南投縣,草屯鎮,碧峰里,181,1048,303,228,531,22,553
公投第１２案,南投縣,草屯鎮,碧峰里,182,1009,331,229,560,28,588
公投第１２案,南投縣,草屯鎮,碧峰里,183,1138,380,211,591,31,622
公投第１２案,南投縣,草屯鎮,碧峰里,184,1197,386,261,647,24,671
公投第１２案,南投縣,草屯鎮,碧洲里,185,1364,483,289,772,41,813
公投第１２案,南投縣,草屯鎮,碧洲里,186,1059,365,236,601,39,640
公投第１２案,南投縣,草屯鎮,復興里,187,1108,344,276,620,41,661
公投第１２案,南投縣,草屯鎮,復興里,188,879,304,180,484,21,505
公投第１２案,南投縣,草屯鎮,復興里,189,957,351,180,531,36,567
公投第１２案,南投縣,草屯鎮,御史里,190,1395,409,250,659,14,673
公投第１２案,南投縣,草屯鎮,御史里,191,1101,397,263,660,27,687
公投第１２案,南投縣,草屯鎮,御史里,192,1297,375,301,676,24,700
公投第１２案,南投縣,草屯鎮,御史里,193,877,215,172,387,27,414
公投第１２案,南投縣,草屯鎮,御史里,194,1376,356,323,679,33,712
公投第１２案,南投縣,草屯鎮,新豐里,195,1008,352,251,603,41,644
公投第１２案,南投縣,草屯鎮,新豐里,196,1080,367,261,628,40,668
公投第１２案,南投縣,草屯鎮,新豐里,197,1017,288,234,522,46,568
公投第１２案,南投縣,草屯鎮,新豐里,198,961,329,256,585,27,612
公投第１２案,南投縣,草屯鎮,新庄里,199,1160,371,317,688,27,715
公投第１２案,南投縣,草屯鎮,新庄里,200,1121,374,253,627,33,660
公投第１２案,南投縣,草屯鎮,新庄里,201,1243,370,319,689,32,721
公投第１２案,南投縣,草屯鎮,加老里,202,932,319,221,540,25,565
公投第１２案,南投縣,草屯鎮,加老里,203,1323,485,327,812,48,860
公投第１２案,南投縣,草屯鎮,石川里,204,1518,469,286,755,45,800
公投第１２案,南投縣,草屯鎮,北投里,205,923,324,232,556,26,582
公投第１２案,南投縣,草屯鎮,北投里,206,970,310,194,504,36,540
公投第１２案,南投縣,草屯鎮,北投里,207,1026,345,241,586,27,613
公投第１２案,南投縣,草屯鎮,富寮里,208,1466,448,335,783,47,830
公投第１２案,南投縣,草屯鎮,富寮里,209,1180,403,239,642,38,680
公投第１２案,南投縣,草屯鎮,富寮里,210,1006,385,224,609,16,625
公投第１２案,南投縣,草屯鎮,富寮里,211,1000,290,189,479,26,505
公投第１２案,南投縣,草屯鎮,富寮里,212,1128,386,285,671,20,691
公投第１２案,南投縣,草屯鎮,富寮里,213,623,209,134,343,9,352
公投第１２案,南投縣,草屯鎮,北勢里,214,707,226,166,392,30,422
公投第１２案,南投縣,草屯鎮,北勢里,215,719,233,148,381,24,405
公投第１２案,南投縣,草屯鎮,北勢里,216,527,139,100,239,20,259
公投第１２案,南投縣,草屯鎮,中原里,217,1183,410,247,657,43,700
公投第１２案,南投縣,草屯鎮,中原里,218,869,408,103,511,29,540
公投第１２案,南投縣,草屯鎮,南埔里,219,1132,346,224,570,23,593
公投第１２案,南投縣,草屯鎮,南埔里,220,949,310,226,536,36,572
公投第１２案,南投縣,草屯鎮,南埔里,221,965,322,246,568,19,587
公投第１２案,南投縣,草屯鎮,南埔里,222,1068,335,228,563,30,593
公投第１２案,南投縣,草屯鎮,坪頂里,223,1024,334,236,570,55,625
公投第１２案,南投縣,草屯鎮,土城里,224,642,209,121,330,22,352
公投第１２案,南投縣,草屯鎮,土城里,225,1017,300,205,505,34,539
公投第１２案,南投縣,草屯鎮,平林里,226,1092,375,230,605,25,630
公投第１２案,南投縣,草屯鎮,雙冬里,227,1170,361,252,613,49,662
公投第１２案,南投縣,草屯鎮,雙冬里,228,1106,349,278,627,43,670
公投第１２案,南投縣,竹山鎮,竹山里,229,1170,408,247,655,50,705
公投第１２案,南投縣,竹山鎮,竹山里,230,850,303,191,494,41,535
公投第１２案,南投縣,竹山鎮,中正里,231,621,188,132,320,23,343
公投第１２案,南投縣,竹山鎮,中山里,232,905,284,200,484,28,512
公投第１２案,南投縣,竹山鎮,中山里,233,1099,309,204,513,43,556
公投第１２案,南投縣,竹山鎮,中山里,234,1214,363,247,610,42,652
公投第１２案,南投縣,竹山鎮,中山里,235,1287,422,314,736,43,779
公投第１２案,南投縣,竹山鎮,雲林里,236,1191,416,219,635,44,679
公投第１２案,南投縣,竹山鎮,雲林里,237,1118,367,231,598,40,638
公投第１２案,南投縣,竹山鎮,雲林里,238,1278,441,168,609,24,633
公投第１２案,南投縣,竹山鎮,竹圍里,239,1153,374,249,623,51,674
公投第１２案,南投縣,竹山鎮,竹圍里,240,1243,352,277,629,40,669
公投第１２案,南投縣,竹山鎮,桂林里,241,1308,410,283,693,44,737
公投第１２案,南投縣,竹山鎮,桂林里,242,1358,417,291,708,32,740
公投第１２案,南投縣,竹山鎮,桂林里,243,1044,337,207,544,32,576
公投第１２案,南投縣,竹山鎮,下坪里,244,511,186,105,291,30,321
公投第１２案,南投縣,竹山鎮,下坪里,245,682,205,161,366,6,372
公投第１２案,南投縣,竹山鎮,中和里,246,989,278,210,488,26,514
公投第１２案,南投縣,竹山鎮,中崎里,247,1378,429,302,731,41,772
公投第１２案,南投縣,竹山鎮,秀林里,248,217,58,54,112,3,115
公投第１２案,南投縣,竹山鎮,秀林里,249,479,136,134,270,18,288
公投第１２案,南投縣,竹山鎮,大鞍里,250,430,122,82,204,10,214
公投第１２案,南投縣,竹山鎮,延和里,251,1437,443,333,776,35,811
公投第１２案,南投縣,竹山鎮,延和里,252,1286,428,312,740,35,775
公投第１２案,南投縣,竹山鎮,延和里,253,1080,392,233,625,33,658
公投第１２案,南投縣,竹山鎮,延和里,254,1070,327,246,573,26,599
公投第１２案,南投縣,竹山鎮,延祥里,255,1295,430,285,715,30,745
公投第１２案,南投縣,竹山鎮,延祥里,256,1047,364,201,565,39,604
公投第１２案,南投縣,竹山鎮,延祥里,257,1300,417,289,706,0,706
公投第１２案,南投縣,竹山鎮,延正里,258,908,230,181,411,21,432
公投第１２案,南投縣,竹山鎮,延正里,259,821,182,193,375,46,421
公投第１２案,南投縣,竹山鎮,延平里,260,1320,420,314,734,33,767
公投第１２案,南投縣,竹山鎮,延平里,261,967,284,189,473,33,506
公投第１２案,南投縣,竹山鎮,延平里,262,595,155,136,291,15,306
公投第１２案,南投縣,竹山鎮,延山里,263,859,241,170,411,66,477
公投第１２案,南投縣,竹山鎮,山崇里,264,1196,381,235,616,35,651
公投第１２案,南投縣,竹山鎮,山崇里,265,649,199,143,342,29,371
公投第１２案,南投縣,竹山鎮,社寮里,266,1341,394,307,701,55,756
公投第１２案,南投縣,竹山鎮,中央里,267,1222,383,219,602,41,643
公投第１２案,南投縣,竹山鎮,富州里,268,602,188,143,331,19,350
公投第１２案,南投縣,竹山鎮,田子里,269,617,169,156,325,21,346
公投第１２案,南投縣,竹山鎮,硘磘里,270,793,267,189,456,32,488
公投第１２案,南投縣,竹山鎮,硘磘里,271,922,286,224,510,13,523
公投第１２案,南投縣,竹山鎮,德興里,272,366,110,72,182,15,197
公投第１２案,南投縣,竹山鎮,德興里,273,509,101,125,226,6,232
公投第１２案,南投縣,竹山鎮,福興里,274,193,63,45,108,3,111
公投第１２案,南投縣,竹山鎮,福興里,275,406,116,123,239,13,252
公投第１２案,南投縣,竹山鎮,鯉魚里,276,495,134,102,236,16,252
公投第１２案,南投縣,竹山鎮,鯉魚里,277,307,66,38,104,12,116
公投第１２案,南投縣,竹山鎮,坪頂里,278,440,124,80,204,32,236
公投第１２案,南投縣,竹山鎮,瑞竹里,279,577,165,122,287,27,314
公投第１２案,南投縣,竹山鎮,桶頭里,280,486,104,87,191,24,215
公投第１２案,南投縣,竹山鎮,桶頭里,281,403,77,60,137,14,151
公投第１２案,南投縣,集集鎮,集集里,282,1070,355,266,621,30,651
公投第１２案,南投縣,集集鎮,和平里,283,918,318,207,525,33,558
公投第１２案,南投縣,集集鎮,林尾里,284,581,196,128,324,28,352
公投第１２案,南投縣,集集鎮,田寮里,285,1194,408,274,682,38,720
公投第１２案,南投縣,集集鎮,隘寮里,286,488,120,90,210,15,225
公投第１２案,南投縣,集集鎮,玉映里,287,504,167,123,290,25,315
公投第１２案,南投縣,集集鎮,吳厝里,288,910,300,179,479,84,563
公投第１２案,南投縣,集集鎮,八張里,289,773,178,272,450,36,486
公投第１２案,南投縣,集集鎮,八張里,290,709,225,164,389,13,402
公投第１２案,南投縣,集集鎮,永昌里,291,960,313,216,529,27,556
公投第１２案,南投縣,集集鎮,廣明里,292,503,151,107,258,17,275
公投第１２案,南投縣,集集鎮,廣明里,293,419,103,88,191,21,212
公投第１２案,南投縣,集集鎮,富山里,294,582,156,99,255,20,275
公投第１２案,南投縣,名間鄉,南雅村,295,1050,388,310,698,34,732
公投第１２案,南投縣,名間鄉,中正村,296,920,323,189,512,49,561
公投第１２案,南投縣,名間鄉,中正村,297,727,254,198,452,23,475
公投第１２案,南投縣,名間鄉,中正村,298,861,327,202,529,25,554
公投第１２案,南投縣,名間鄉,中正村,299,897,319,182,501,24,525
公投第１２案,南投縣,名間鄉,中山村,300,1055,369,250,619,30,649
公投第１２案,南投縣,名間鄉,中山村,301,1184,402,246,648,49,697
公投第１２案,南投縣,名間鄉,濁水村,302,783,250,156,406,40,446
公投第１２案,南投縣,名間鄉,濁水村,303,781,292,168,460,28,488
公投第１２案,南投縣,名間鄉,新民村,304,977,326,197,523,36,559
公投第１２案,南投縣,名間鄉,炭寮村,305,1015,337,208,545,30,575
公投第１２案,南投縣,名間鄉,新街村,306,914,321,222,543,21,564
公投第１２案,南投縣,名間鄉,新街村,307,1028,358,210,568,26,594
公投第１２案,南投縣,名間鄉,新街村,308,1018,343,235,578,39,617
公投第１２案,南投縣,名間鄉,新街村,309,1274,420,295,715,45,760
公投第１２案,南投縣,名間鄉,東湖村,310,755,242,175,417,37,454
公投第１２案,南投縣,名間鄉,東湖村,311,895,313,228,541,51,592
公投第１２案,南投縣,名間鄉,仁和村,312,892,450,55,505,25,530
公投第１２案,南投縣,名間鄉,萬丹村,313,951,294,214,508,44,552
公投第１２案,南投縣,名間鄉,田仔村,314,1261,410,273,683,43,726
公投第１２案,南投縣,名間鄉,大坑村,315,768,242,170,412,31,443
公投第１２案,南投縣,名間鄉,大庄村,316,962,318,227,545,41,586
公投第１２案,南投縣,名間鄉,大庄村,317,867,288,197,485,50,535
公投第１２案,南投縣,名間鄉,廍下村,318,930,318,192,510,56,566
公投第１２案,南投縣,名間鄉,赤水村,319,641,206,141,347,42,389
公投第１２案,南投縣,名間鄉,赤水村,320,530,152,114,266,19,285
公投第１２案,南投縣,名間鄉,竹圍村,321,931,307,199,506,52,558
公投第１２案,南投縣,名間鄉,三崙村,322,1127,346,263,609,43,652
公投第１２案,南投縣,名間鄉,三崙村,323,443,160,116,276,20,296
公投第１２案,南投縣,名間鄉,松山村,324,870,321,177,498,36,534
公投第１２案,南投縣,名間鄉,松山村,325,621,209,152,361,32,393
公投第１２案,南投縣,名間鄉,松柏村,326,1179,392,213,605,39,644
公投第１２案,南投縣,名間鄉,崁腳村,327,881,335,179,514,49,563
公投第１２案,南投縣,名間鄉,埔中村,328,876,364,189,553,43,596
公投第１２案,南投縣,名間鄉,新厝村,329,783,273,167,440,36,476
公投第１２案,南投縣,名間鄉,新光村,330,778,243,152,395,30,425
公投第１２案,南投縣,名間鄉,新光村,331,983,306,196,502,36,538
公投第１２案,南投縣,鹿谷鄉,鹿谷村,332,934,293,155,448,38,486
公投第１２案,南投縣,鹿谷鄉,鹿谷村,333,940,284,219,503,36,539
公投第１２案,南投縣,鹿谷鄉,彰雅村,334,852,224,200,424,34,458
公投第１２案,南投縣,鹿谷鄉,彰雅村,335,451,114,85,199,16,215
公投第１２案,南投縣,鹿谷鄉,廣興村,336,810,276,194,470,26,496
公投第１２案,南投縣,鹿谷鄉,廣興村,337,1142,398,263,661,52,713
公投第１２案,南投縣,鹿谷鄉,永隆村,338,766,200,159,359,19,378
公投第１２案,南投縣,鹿谷鄉,永隆村,339,884,280,197,477,41,518
公投第１２案,南投縣,鹿谷鄉,鳳凰村,340,811,217,200,417,43,460
公投第１２案,南投縣,鹿谷鄉,鳳凰村,341,581,134,124,258,19,277
公投第１２案,南投縣,鹿谷鄉,內湖村,342,578,160,112,272,23,295
公投第１２案,南投縣,鹿谷鄉,內湖村,343,467,148,116,264,15,279
公投第１２案,南投縣,鹿谷鄉,和雅村,344,622,213,105,318,28,346
公投第１２案,南投縣,鹿谷鄉,竹林村,345,740,205,153,358,26,384
公投第１２案,南投縣,鹿谷鄉,竹林村,346,767,241,158,399,34,433
公投第１２案,南投縣,鹿谷鄉,竹豐村,347,909,279,215,494,38,532
公投第１２案,南投縣,鹿谷鄉,初鄉村,348,713,213,142,355,21,376
公投第１２案,南投縣,鹿谷鄉,初鄉村,349,717,173,135,308,28,336
公投第１２案,南投縣,鹿谷鄉,秀峰村,350,794,222,149,371,35,406
公投第１２案,南投縣,鹿谷鄉,清水村,351,726,221,135,356,15,371
公投第１２案,南投縣,鹿谷鄉,瑞田村,352,737,162,132,294,29,323
公投第１２案,南投縣,中寮鄉,廣興村,353,822,278,183,461,44,505
公投第１２案,南投縣,中寮鄉,崁頂村,354,253,98,46,144,11,155
公投第１２案,南投縣,中寮鄉,崁頂村,355,221,50,37,87,7,94
公投第１２案,南投縣,中寮鄉,八仙村,356,353,97,56,153,5,158
公投第１２案,南投縣,中寮鄉,八仙村,357,427,106,115,221,16,237
公投第１２案,南投縣,中寮鄉,福盛村,358,406,120,86,206,24,230
公投第１２案,南投縣,中寮鄉,福盛村,359,307,84,67,151,11,162
公投第１２案,南投縣,中寮鄉,和興村,360,661,218,157,375,29,404
公投第１２案,南投縣,中寮鄉,復興村,361,290,102,73,175,19,194
公投第１２案,南投縣,中寮鄉,永平村,362,973,297,243,540,31,571
公投第１２案,南投縣,中寮鄉,永平村,363,754,273,161,434,24,458
公投第１２案,南投縣,中寮鄉,中寮村,364,662,197,156,353,16,369
公投第１２案,南投縣,中寮鄉,廣福村,365,490,150,86,236,17,253
公投第１２案,南投縣,中寮鄉,永福村,366,335,101,66,167,9,176
公投第１２案,南投縣,中寮鄉,永福村,367,990,329,207,536,40,576
公投第１２案,南投縣,中寮鄉,義和村,368,461,167,110,277,21,298
公投第１２案,南投縣,中寮鄉,義和村,369,614,211,148,359,22,381
公投第１２案,南投縣,中寮鄉,清水村,370,895,255,201,456,58,514
公投第１２案,南投縣,中寮鄉,內城村,371,465,170,84,254,12,266
公投第１２案,南投縣,中寮鄉,龍安村,372,682,192,163,355,50,405
公投第１２案,南投縣,中寮鄉,爽文村,373,490,160,109,269,34,303
公投第１２案,南投縣,中寮鄉,龍岩村,374,643,219,150,369,27,396
公投第１２案,南投縣,中寮鄉,永芳村,375,459,172,98,270,15,285
公投第１２案,南投縣,中寮鄉,永和村,376,528,151,100,251,17,268
公投第１２案,南投縣,魚池鄉,魚池村,377,922,275,220,495,37,532
公投第１２案,南投縣,魚池鄉,魚池村,378,1098,343,252,595,56,651
公投第１２案,南投縣,魚池鄉,東池村,379,720,174,186,360,27,387
公投第１２案,南投縣,魚池鄉,東池村,380,860,264,206,470,38,508
公投第１２案,南投縣,魚池鄉,大林村,381,514,137,96,233,30,263
公投第１２案,南投縣,魚池鄉,大林村,382,574,154,121,275,16,291
公投第１２案,南投縣,魚池鄉,東光村,383,1249,369,253,622,54,676
公投第１２案,南投縣,魚池鄉,共和村,384,293,88,96,184,10,194
公投第１２案,南投縣,魚池鄉,共和村,385,513,125,127,252,26,278
公投第１２案,南投縣,魚池鄉,共和村,386,186,60,37,97,6,103
公投第１２案,南投縣,魚池鄉,新城村,387,841,220,192,412,33,445
公投第１２案,南投縣,魚池鄉,新城村,388,270,81,58,139,31,170
公投第１２案,南投縣,魚池鄉,新城村,389,275,72,61,133,21,154
公投第１２案,南投縣,魚池鄉,大雁村,390,282,73,50,123,8,131
公投第１２案,南投縣,魚池鄉,大雁村,391,392,111,66,177,19,196
公投第１２案,南投縣,魚池鄉,五城村,392,556,158,118,276,29,305
公投第１２案,南投縣,魚池鄉,五城村,393,176,58,35,93,4,97
公投第１２案,南投縣,魚池鄉,中明村,394,578,138,121,259,17,276
公投第１２案,南投縣,魚池鄉,中明村,395,439,118,89,207,17,224
公投第１２案,南投縣,魚池鄉,水社村,396,844,311,160,471,26,497
公投第１２案,南投縣,魚池鄉,日月村,397,868,255,201,456,32,488
公投第１２案,南投縣,魚池鄉,頭社村,398,405,110,70,180,10,190
公投第１２案,南投縣,魚池鄉,頭社村,399,537,178,106,284,22,306
公投第１２案,南投縣,魚池鄉,武登村,400,335,99,72,171,13,184
公投第１２案,南投縣,魚池鄉,武登村,401,231,48,38,86,18,104
公投第１２案,南投縣,國姓鄉,國姓村,402,964,333,224,557,44,601
公投第１２案,南投縣,國姓鄉,國姓村,403,736,241,158,399,16,415
公投第１２案,南投縣,國姓鄉,石門村,404,801,253,188,441,35,476
公投第１２案,南投縣,國姓鄉,石門村,405,964,315,220,535,13,548
公投第１２案,南投縣,國姓鄉,大旗村,406,686,209,142,351,37,388
公投第１２案,南投縣,國姓鄉,長流村,407,661,201,130,331,31,362
公投第１２案,南投縣,國姓鄉,長流村,408,730,203,149,352,30,382
公投第１２案,南投縣,國姓鄉,長豐村,409,774,225,181,406,30,436
公投第１２案,南投縣,國姓鄉,長福村,410,706,204,202,406,13,419
公投第１２案,南投縣,國姓鄉,北港村,411,1012,349,178,527,48,575
公投第１２案,南投縣,國姓鄉,北港村,412,868,230,163,393,19,412
公投第１２案,南投縣,國姓鄉,福龜村,413,918,345,187,532,25,557
公投第１２案,南投縣,國姓鄉,福龜村,414,937,313,173,486,53,539
公投第１２案,南投縣,國姓鄉,乾溝村,415,815,242,173,415,36,451
公投第１２案,南投縣,國姓鄉,柑林村,416,1134,391,245,636,50,686
公投第１２案,南投縣,國姓鄉,大石村,417,714,207,151,358,28,386
公投第１２案,南投縣,國姓鄉,北山村,418,1095,366,187,553,42,595
公投第１２案,南投縣,國姓鄉,北山村,419,448,134,83,217,20,237
公投第１２案,南投縣,國姓鄉,南港村,420,1064,317,194,511,62,573
公投第１２案,南投縣,國姓鄉,南港村,421,570,164,109,273,25,298
公投第１２案,南投縣,水里鄉,水里村,422,757,242,151,393,30,423
公投第１２案,南投縣,水里鄉,新城村,423,554,154,132,286,27,313
公投第１２案,南投縣,水里鄉,新城村,424,999,308,238,546,33,579
公投第１２案,南投縣,水里鄉,中央村,425,616,212,108,320,19,339
公投第１２案,南投縣,水里鄉,城中村,426,875,337,165,502,29,531
公投第１２案,南投縣,水里鄉,農富村,427,480,172,108,280,12,292
公投第１２案,南投縣,水里鄉,車埕村,428,450,156,72,228,20,248
公投第１２案,南投縣,水里鄉,新興村,429,643,170,151,321,35,356
公投第１２案,南投縣,水里鄉,北埔村,430,1004,356,208,564,26,590
公投第１２案,南投縣,水里鄉,南光村,431,741,231,147,378,29,407
公投第１２案,南投縣,水里鄉,南光村,432,802,269,187,456,15,471
公投第１２案,南投縣,水里鄉,鉅工村,433,998,365,237,602,38,640
公投第１２案,南投縣,水里鄉,永豐村,434,800,220,181,401,42,443
公投第１２案,南投縣,水里鄉,永豐村,435,589,184,167,351,17,368
公投第１２案,南投縣,水里鄉,民和村,436,887,264,161,425,46,471
公投第１２案,南投縣,水里鄉,頂崁村,437,1217,339,257,596,40,636
公投第１２案,南投縣,水里鄉,新山村,438,205,51,26,77,2,79
公投第１２案,南投縣,水里鄉,郡坑村,439,330,132,56,188,21,209
公投第１２案,南投縣,水里鄉,上安村,440,1100,314,234,548,35,583
公投第１２案,南投縣,水里鄉,興隆村,441,275,70,29,99,4,103
公投第１２案,南投縣,水里鄉,永興村,442,318,80,55,135,1,136
公投第１２案,南投縣,水里鄉,玉峰村,443,818,254,162,416,36,452
公投第１２案,南投縣,信義鄉,明德村,444,1201,445,195,640,40,680
公投第１２案,南投縣,信義鄉,明德村,445,329,119,45,164,13,177
公投第１２案,南投縣,信義鄉,愛國村,446,516,157,102,259,15,274
公投第１２案,南投縣,信義鄉,自強村,447,424,107,75,182,18,200
公投第１２案,南投縣,信義鄉,自強村,448,321,103,61,164,6,170
公投第１２案,南投縣,信義鄉,豐丘村,449,648,286,113,399,31,430
公投第１２案,南投縣,信義鄉,新鄉村,450,584,311,97,408,32,440
公投第１２案,南投縣,信義鄉,羅娜村,451,1376,707,173,880,26,906
公投第１２案,南投縣,信義鄉,望美村,452,979,455,154,609,27,636
公投第１２案,南投縣,信義鄉,望美村,453,530,256,114,370,30,400
公投第１２案,南投縣,信義鄉,同富村,454,961,319,174,493,23,516
公投第１２案,南投縣,信義鄉,同富村,455,464,155,90,245,12,257
公投第１２案,南投縣,信義鄉,神木村,456,517,163,118,281,27,308
公投第１２案,南投縣,信義鄉,神木村,457,149,50,34,84,5,89
公投第１２案,南投縣,信義鄉,東埔村,458,1020,578,159,737,27,764
公投第１２案,南投縣,信義鄉,人和村,459,929,436,144,580,61,641
公投第１２案,南投縣,信義鄉,人和村,460,274,75,45,120,10,130
公投第１２案,南投縣,信義鄉,地利村,461,900,445,154,599,36,635
公投第１２案,南投縣,信義鄉,雙龍村,462,617,266,146,412,39,451
公投第１２案,南投縣,信義鄉,潭南村,463,560,222,144,366,26,392
公投第１２案,南投縣,仁愛鄉,南豐村,464,973,436,121,557,23,580
公投第１２案,南投縣,仁愛鄉,南豐村,465,296,90,52,142,8,150
公投第１２案,南投縣,仁愛鄉,大同村,466,900,243,186,429,17,446
公投第１２案,南投縣,仁愛鄉,大同村,467,460,152,123,275,23,298
公投第１２案,南投縣,仁愛鄉,大同村,468,305,100,70,170,13,183
公投第１２案,南投縣,仁愛鄉,榮興村,469,58,15,3,18,2,20
公投第１２案,南投縣,仁愛鄉,春陽村,470,952,310,149,459,17,476
公投第１２案,南投縣,仁愛鄉,精英村,471,679,212,100,312,14,326
公投第１２案,南投縣,仁愛鄉,都達村,472,623,235,106,341,28,369
公投第１２案,南投縣,仁愛鄉,合作村,473,597,99,227,326,12,338
公投第１２案,南投縣,仁愛鄉,發祥村,474,384,146,85,231,17,248
公投第１２案,南投縣,仁愛鄉,發祥村,475,121,42,19,61,1,62
公投第１２案,南投縣,仁愛鄉,發祥村,476,264,121,43,164,5,169
公投第１２案,南投縣,仁愛鄉,力行村,477,509,239,136,375,16,391
公投第１２案,南投縣,仁愛鄉,翠華村,478,338,119,67,186,21,207
公投第１２案,南投縣,仁愛鄉,翠華村,479,169,41,34,75,4,79
公投第１２案,南投縣,仁愛鄉,親愛村,480,613,171,105,276,17,293
公投第１２案,南投縣,仁愛鄉,親愛村,481,404,104,77,181,9,190
公投第１２案,南投縣,仁愛鄉,親愛村,482,134,47,26,73,4,77
公投第１２案,南投縣,仁愛鄉,萬豐村,483,630,235,156,391,22,413
公投第１２案,南投縣,仁愛鄉,法治村,484,763,206,150,356,15,371
公投第１２案,南投縣,仁愛鄉,中正村,485,889,388,151,539,35,574
公投第１２案,南投縣,仁愛鄉,互助村,486,672,261,141,402,37,439
公投第１２案,南投縣,仁愛鄉,互助村,487,447,163,96,259,13,272
公投第１２案,南投縣,仁愛鄉,新生村,488,409,200,80,280,24,304
公投第１２案,雲林縣,麥寮鄉,麥豐村,1,1497,351,250,601,57,658
公投第１２案,雲林縣,麥寮鄉,麥豐村,2,1738,489,340,829,45,874
公投第１２案,雲林縣,麥寮鄉,麥豐村,3,1921,553,352,905,52,957
公投第１２案,雲林縣,麥寮鄉,麥豐村,4,1832,566,269,835,51,886
公投第１２案,雲林縣,麥寮鄉,麥津村,5,1340,328,244,572,44,616
公投第１２案,雲林縣,麥寮鄉,麥津村,6,1138,272,230,502,52,554
公投第１２案,雲林縣,麥寮鄉,麥津村,7,1551,442,280,722,40,762
公投第１２案,雲林縣,麥寮鄉,瓦磘村,8,715,156,133,289,28,317
公投第１２案,雲林縣,麥寮鄉,瓦磘村,9,1194,270,201,471,41,512
公投第１２案,雲林縣,麥寮鄉,興華村,10,1023,260,188,448,40,488
公投第１２案,雲林縣,麥寮鄉,興華村,11,1558,337,240,577,30,607
公投第１２案,雲林縣,麥寮鄉,海豐村,12,1187,251,214,465,20,485
公投第１２案,雲林縣,麥寮鄉,海豐村,13,983,250,150,400,22,422
公投第１２案,雲林縣,麥寮鄉,後安村,14,1363,332,268,600,64,664
公投第１２案,雲林縣,麥寮鄉,後安村,15,1596,432,273,705,63,768
公投第１２案,雲林縣,麥寮鄉,中興村,16,1469,459,331,790,74,864
公投第１２案,雲林縣,麥寮鄉,三盛村,17,964,216,163,379,56,435
公投第１２案,雲林縣,麥寮鄉,三盛村,18,1038,274,151,425,30,455
公投第１２案,雲林縣,麥寮鄉,崙後村,19,1230,341,281,622,0,622
公投第１２案,雲林縣,麥寮鄉,崙後村,20,1329,343,264,607,40,647
公投第１２案,雲林縣,麥寮鄉,橋頭村,21,1129,368,187,555,54,609
公投第１２案,雲林縣,麥寮鄉,橋頭村,22,1241,383,269,652,47,699
公投第１２案,雲林縣,麥寮鄉,橋頭村,23,1471,456,304,760,46,806
公投第１２案,雲林縣,麥寮鄉,新吉村,24,1107,337,240,577,59,636
公投第１２案,雲林縣,麥寮鄉,施厝村,25,1636,540,307,847,59,906
公投第１２案,雲林縣,麥寮鄉,施厝村,26,1755,487,328,815,41,856
公投第１２案,雲林縣,麥寮鄉,雷厝村,27,1158,406,229,635,43,678
公投第１２案,雲林縣,麥寮鄉,雷厝村,28,956,280,202,482,34,516
公投第１２案,雲林縣,臺西鄉,臺西村,29,1238,395,242,637,47,684
公投第１２案,雲林縣,臺西鄉,海南村,30,1091,324,160,484,35,519
公投第１２案,雲林縣,臺西鄉,海北村,31,1098,328,199,527,54,581
公投第１２案,雲林縣,臺西鄉,海口村,32,1048,276,153,429,22,451
公投第１２案,雲林縣,臺西鄉,海口村,33,1025,277,178,455,42,497
公投第１２案,雲林縣,臺西鄉,山寮村,34,850,250,145,395,37,432
公投第１２案,雲林縣,臺西鄉,溪頂村,35,1460,391,201,592,53,645
公投第１２案,雲林縣,臺西鄉,牛厝村,36,1180,227,161,388,53,441
公投第１２案,雲林縣,臺西鄉,牛厝村,37,710,118,101,219,20,239
公投第１２案,雲林縣,臺西鄉,泉州村,38,620,165,100,265,12,277
公投第１２案,雲林縣,臺西鄉,五榔村,39,449,105,86,191,24,215
公投第１２案,雲林縣,臺西鄉,光華村,40,687,135,109,244,38,282
公投第１２案,雲林縣,臺西鄉,五港村,41,1247,317,194,511,48,559
公投第１２案,雲林縣,臺西鄉,五港村,42,583,130,69,199,10,209
公投第１２案,雲林縣,臺西鄉,富琦村,43,1042,262,194,456,55,511
公投第１２案,雲林縣,臺西鄉,富琦村,44,472,116,89,205,15,220
公投第１２案,雲林縣,臺西鄉,永豐村,45,1409,394,198,592,19,611
公投第１２案,雲林縣,臺西鄉,和豐村,46,1061,310,192,502,65,567
公投第１２案,雲林縣,臺西鄉,和豐村,47,993,245,163,408,25,433
公投第１２案,雲林縣,臺西鄉,和豐村,48,1013,250,172,422,71,493
公投第１２案,雲林縣,臺西鄉,蚊港村,49,1233,313,246,559,42,601
公投第１２案,雲林縣,臺西鄉,蚊港村,50,616,143,99,242,22,264
公投第１２案,雲林縣,東勢鄉,月眉村,51,1207,273,225,498,46,544
公投第１２案,雲林縣,東勢鄉,復興村,52,540,174,124,298,28,326
公投第１２案,雲林縣,東勢鄉,嘉隆村,53,896,232,144,376,23,399
公投第１２案,雲林縣,東勢鄉,嘉隆村,54,728,201,166,367,27,394
公投第１２案,雲林縣,東勢鄉,東南村,55,1533,519,312,831,53,884
公投第１２案,雲林縣,東勢鄉,東北村,56,1203,421,245,666,54,720
公投第１２案,雲林縣,東勢鄉,龍潭村,57,817,211,132,343,49,392
公投第１２案,雲林縣,東勢鄉,程海村,58,546,180,118,298,27,325
公投第１２案,雲林縣,東勢鄉,昌南村,59,853,237,149,386,52,438
公投第１２案,雲林縣,東勢鄉,安南村,60,856,198,122,320,53,373
公投第１２案,雲林縣,東勢鄉,同安村,61,923,205,203,408,40,448
公投第１２案,雲林縣,東勢鄉,同安村,62,1022,291,204,495,34,529
公投第１２案,雲林縣,東勢鄉,四美村,63,634,129,95,224,18,242
公投第１２案,雲林縣,東勢鄉,四美村,64,394,102,63,165,13,178
公投第１２案,雲林縣,東勢鄉,新坤村,65,1087,240,162,402,36,438
公投第１２案,雲林縣,褒忠鄉,中民村,66,923,293,182,475,47,522
公投第１２案,雲林縣,褒忠鄉,中民村,67,993,350,207,557,29,586
公投第１２案,雲林縣,褒忠鄉,埔姜村,68,748,207,161,368,28,396
公投第１２案,雲林縣,褒忠鄉,埔姜村,69,702,204,145,349,11,360
公投第１２案,雲林縣,褒忠鄉,中勝村,70,752,242,130,372,16,388
公投第１２案,雲林縣,褒忠鄉,中勝村,71,756,241,161,402,13,415
公投第１２案,雲林縣,褒忠鄉,馬鳴村,72,490,153,87,240,18,258
公投第１２案,雲林縣,褒忠鄉,馬鳴村,73,1034,241,199,440,33,473
公投第１２案,雲林縣,褒忠鄉,新湖村,74,470,106,103,209,22,231
公投第１２案,雲林縣,褒忠鄉,新湖村,75,737,190,162,352,22,374
公投第１２案,雲林縣,褒忠鄉,有才村,76,878,235,177,412,32,444
公投第１２案,雲林縣,褒忠鄉,田洋村,77,778,198,140,338,52,390
公投第１２案,雲林縣,褒忠鄉,龍岩村,78,1224,312,263,575,39,614
公投第１２案,雲林縣,褒忠鄉,潮厝村,79,896,190,175,365,66,431
公投第１２案,雲林縣,土庫鎮,忠正里,80,809,273,204,477,39,516
公投第１２案,雲林縣,土庫鎮,順天里,81,896,328,187,515,24,539
公投第１２案,雲林縣,土庫鎮,宮北里,82,687,205,170,375,31,406
公投第１２案,雲林縣,土庫鎮,宮北里,83,702,278,173,451,24,475
公投第１２案,雲林縣,土庫鎮,越港里,84,1032,384,228,612,31,643
公投第１２案,雲林縣,土庫鎮,溪邊里,85,697,174,150,324,47,371
公投第１２案,雲林縣,土庫鎮,溪邊里,86,427,108,84,192,34,226
公投第１２案,雲林縣,土庫鎮,石廟里,87,1451,471,341,812,44,856
公投第１２案,雲林縣,土庫鎮,石廟里,88,1283,424,297,721,23,744
公投第１２案,雲林縣,土庫鎮,興新里,89,634,146,129,275,17,292
公投第１２案,雲林縣,土庫鎮,興新里,90,796,237,178,415,25,440
公投第１２案,雲林縣,土庫鎮,奮起里,91,745,182,120,302,31,333
公投第１２案,雲林縣,土庫鎮,奮起里,92,576,136,124,260,28,288
公投第１２案,雲林縣,土庫鎮,埤腳里,93,743,169,138,307,48,355
公投第１２案,雲林縣,土庫鎮,埤腳里,94,534,122,99,221,17,238
公投第１２案,雲林縣,土庫鎮,後埔里,95,1199,287,203,490,57,547
公投第１２案,雲林縣,土庫鎮,後埔里,96,1077,275,207,482,64,546
公投第１２案,雲林縣,土庫鎮,崙內里,97,819,248,119,367,19,386
公投第１２案,雲林縣,土庫鎮,崙內里,98,684,214,138,352,20,372
公投第１２案,雲林縣,土庫鎮,大荖里,99,843,282,152,434,37,471
公投第１２案,雲林縣,土庫鎮,東平里,100,916,267,179,446,46,492
公投第１２案,雲林縣,土庫鎮,東平里,101,948,253,188,441,38,479
公投第１２案,雲林縣,土庫鎮,南平里,102,914,275,197,472,28,500
公投第１２案,雲林縣,土庫鎮,南平里,103,860,266,69,335,48,383
公投第１２案,雲林縣,土庫鎮,西平里,104,929,257,177,434,41,475
公投第１２案,雲林縣,土庫鎮,西平里,105,875,242,138,380,44,424
公投第１２案,雲林縣,土庫鎮,北平里,106,896,219,138,357,34,391
公投第１２案,雲林縣,土庫鎮,新庄里,107,757,161,149,310,37,347
公投第１２案,雲林縣,土庫鎮,新庄里,108,683,177,127,304,27,331
公投第１２案,雲林縣,虎尾鎮,東仁里,109,1347,415,294,709,35,744
公投第１２案,雲林縣,虎尾鎮,東仁里,110,1258,434,274,708,34,742
公投第１２案,雲林縣,虎尾鎮,新興里,111,785,258,163,421,27,448
公投第１２案,雲林縣,虎尾鎮,新興里,112,890,257,144,401,37,438
公投第１２案,雲林縣,虎尾鎮,公安里,113,1413,501,301,802,49,851
公投第１２案,雲林縣,虎尾鎮,公安里,114,1431,498,334,832,39,871
公投第１２案,雲林縣,虎尾鎮,德興里,115,1224,371,250,621,39,660
公投第１２案,雲林縣,虎尾鎮,德興里,116,1325,380,254,634,27,661
公投第１２案,雲林縣,虎尾鎮,中山里,117,941,279,246,525,48,573
公投第１２案,雲林縣,虎尾鎮,西安里,118,1613,526,337,863,23,886
公投第１２案,雲林縣,虎尾鎮,西安里,119,1641,493,345,838,34,872
公投第１２案,雲林縣,虎尾鎮,立仁里,120,1200,418,271,689,25,714
公投第１２案,雲林縣,虎尾鎮,立仁里,121,1294,434,279,713,47,760
公投第１２案,雲林縣,虎尾鎮,立仁里,122,1273,427,280,707,21,728
公投第１２案,雲林縣,虎尾鎮,安慶里,123,1438,505,348,853,33,886
公投第１２案,雲林縣,虎尾鎮,平和里,124,1361,474,287,761,28,789
公投第１２案,雲林縣,虎尾鎮,平和里,125,1444,522,311,833,38,871
公投第１２案,雲林縣,虎尾鎮,平和里,126,1490,528,378,906,32,938
公投第１２案,雲林縣,虎尾鎮,興南里,127,1307,464,332,796,39,835
公投第１２案,雲林縣,虎尾鎮,興南里,128,967,254,219,473,18,491
公投第１２案,雲林縣,虎尾鎮,新吉里,129,1865,594,361,955,29,984
公投第１２案,雲林縣,虎尾鎮,新吉里,130,1880,613,399,1012,35,1047
公投第１２案,雲林縣,虎尾鎮,穎川里,131,1099,322,238,560,25,585
公投第１２案,雲林縣,虎尾鎮,穎川里,132,901,320,176,496,21,517
公投第１２案,雲林縣,虎尾鎮,延平里,133,1120,329,253,582,30,612
公投第１２案,雲林縣,虎尾鎮,建國里,134,545,112,112,224,12,236
公投第１２案,雲林縣,虎尾鎮,埒內里,135,1420,422,306,728,45,773
公投第１２案,雲林縣,虎尾鎮,埒內里,136,1248,357,259,616,25,641
公投第１２案,雲林縣,虎尾鎮,堀頭里,137,799,261,154,415,23,438
公投第１２案,雲林縣,虎尾鎮,安溪里,138,836,229,173,402,45,447
公投第１２案,雲林縣,虎尾鎮,安溪里,139,924,237,178,415,36,451
公投第１２案,雲林縣,虎尾鎮,興中里,140,1648,431,277,708,22,730
公投第１２案,雲林縣,虎尾鎮,廉使里,141,1616,401,297,698,80,778
公投第１２案,雲林縣,虎尾鎮,廉使里,142,1546,435,303,738,46,784
公投第１２案,雲林縣,虎尾鎮,惠來里,143,1283,372,269,641,29,670
公投第１２案,雲林縣,虎尾鎮,惠來里,144,1078,316,228,544,25,569
公投第１２案,雲林縣,虎尾鎮,頂溪里,145,1313,359,256,615,40,655
公投第１２案,雲林縣,虎尾鎮,頂溪里,146,1284,327,274,601,31,632
公投第１２案,雲林縣,虎尾鎮,中溪里,147,1356,385,282,667,61,728
公投第１２案,雲林縣,虎尾鎮,下溪里,148,1504,461,313,774,48,822
公投第１２案,雲林縣,虎尾鎮,東屯里,149,1224,297,231,528,29,557
公投第１２案,雲林縣,虎尾鎮,西屯里,150,1509,403,257,660,51,711
公投第１２案,雲林縣,虎尾鎮,芳草里,151,855,151,160,311,55,366
公投第１２案,雲林縣,虎尾鎮,墾地里,152,1549,367,285,652,69,721
公投第１２案,雲林縣,虎尾鎮,北溪里,153,851,231,163,394,20,414
公投第１２案,雲林縣,虎尾鎮,三合里,154,1272,342,244,586,53,639
公投第１２案,雲林縣,四湖鄉,四湖村,155,1082,266,174,440,41,481
公投第１２案,雲林縣,四湖鄉,四湖村,156,676,194,142,336,36,372
公投第１２案,雲林縣,四湖鄉,湖西村,157,862,259,150,409,21,430
公投第１２案,雲林縣,四湖鄉,湖西村,158,477,109,74,183,9,192
公投第１２案,雲林縣,四湖鄉,湖西村,159,952,309,198,507,37,544
公投第１２案,雲林縣,四湖鄉,新庄村,160,650,129,107,236,14,250
公投第１２案,雲林縣,四湖鄉,溪底村,161,969,241,168,409,21,430
公投第１２案,雲林縣,四湖鄉,鹿場村,162,925,179,141,320,55,375
公投第１２案,雲林縣,四湖鄉,蔡厝村,163,914,182,193,375,24,399
公投第１２案,雲林縣,四湖鄉,湖寮村,164,759,120,85,205,38,243
公投第１２案,雲林縣,四湖鄉,施湖村,165,1219,235,184,419,51,470
公投第１２案,雲林縣,四湖鄉,羊調村,166,937,186,107,293,31,324
公投第１２案,雲林縣,四湖鄉,內湖村,167,773,149,93,242,18,260
公投第１２案,雲林縣,四湖鄉,飛東村,168,555,115,80,195,30,225
公投第１２案,雲林縣,四湖鄉,飛沙村,169,876,161,121,282,27,309
公投第１２案,雲林縣,四湖鄉,三姓村,170,360,74,50,124,15,139
公投第１２案,雲林縣,四湖鄉,崙北村,171,885,143,98,241,27,268
公投第１２案,雲林縣,四湖鄉,崙北村,172,833,154,107,261,25,286
公投第１２案,雲林縣,四湖鄉,崙南村,173,785,184,109,293,33,326
公投第１２案,雲林縣,四湖鄉,廣溝村,174,705,198,102,300,39,339
公投第１２案,雲林縣,四湖鄉,箔子村,175,927,203,104,307,31,338
公投第１２案,雲林縣,四湖鄉,箔東村,176,1058,198,141,339,48,387
公投第１２案,雲林縣,四湖鄉,林厝村,177,1071,224,143,367,42,409
公投第１２案,雲林縣,四湖鄉,林東村,178,1022,137,132,269,20,289
公投第１２案,雲林縣,四湖鄉,溪尾村,179,711,160,120,280,33,313
公投第１２案,雲林縣,元長鄉,長南村,180,915,304,139,443,21,464
公投第１２案,雲林縣,元長鄉,長南村,181,1284,380,213,593,22,615
公投第１２案,雲林縣,元長鄉,長南村,182,1150,296,213,509,39,548
公投第１２案,雲林縣,元長鄉,長北村,183,744,190,111,301,34,335
公投第１２案,雲林縣,元長鄉,長北村,184,790,240,130,370,24,394
公投第１２案,雲林縣,元長鄉,子茂村,185,1356,297,215,512,54,566
公投第１２案,雲林縣,元長鄉,後湖村,186,739,176,146,322,37,359
公投第１２案,雲林縣,元長鄉,山內村,187,965,203,164,367,33,400
公投第１２案,雲林縣,元長鄉,合和村,188,1080,223,185,408,56,464
公投第１２案,雲林縣,元長鄉,五塊村,189,948,199,150,349,40,389
公投第１２案,雲林縣,元長鄉,潭西村,190,762,116,106,222,23,245
公投第１２案,雲林縣,元長鄉,潭東村,191,582,145,109,254,19,273
公投第１２案,雲林縣,元長鄉,客厝村,192,865,190,125,315,14,329
公投第１２案,雲林縣,元長鄉,卓運村,193,362,54,21,75,9,84
公投第１２案,雲林縣,元長鄉,頂寮村,194,1162,268,182,450,23,473
公投第１２案,雲林縣,元長鄉,下寮村,195,1527,377,258,635,14,649
公投第１２案,雲林縣,元長鄉,龍岩村,196,1006,263,169,432,58,490
公投第１２案,雲林縣,元長鄉,西莊村,197,855,222,130,352,17,369
公投第１２案,雲林縣,元長鄉,鹿北村,198,1181,303,206,509,50,559
公投第１２案,雲林縣,元長鄉,鹿南村,199,864,208,123,331,28,359
公投第１２案,雲林縣,元長鄉,瓦磘村,200,667,147,104,251,20,271
公投第１２案,雲林縣,元長鄉,瓦磘村,201,878,205,132,337,23,360
公投第１２案,雲林縣,元長鄉,內寮村,202,610,145,73,218,6,224
公投第１２案,雲林縣,元長鄉,崙仔村,203,837,221,128,349,52,401
公投第１２案,雲林縣,元長鄉,新吉村,204,701,187,151,338,20,358
公投第１２案,雲林縣,口湖鄉,口湖村,205,1134,309,252,561,48,609
公投第１２案,雲林縣,口湖鄉,湖東村,206,1225,346,238,584,82,666
公投第１２案,雲林縣,口湖鄉,頂湖村,207,647,161,87,248,28,276
公投第１２案,雲林縣,口湖鄉,埔南村,208,709,184,152,336,21,357
公投第１２案,雲林縣,口湖鄉,埔北村,209,900,225,145,370,63,433
公投第１２案,雲林縣,口湖鄉,謝厝村,210,1011,252,208,460,51,511
公投第１２案,雲林縣,口湖鄉,蚵寮村,211,1437,400,191,591,28,619
公投第１２案,雲林縣,口湖鄉,下崙村,212,848,164,116,280,12,292
公投第１２案,雲林縣,口湖鄉,下崙村,213,1193,281,183,464,26,490
公投第１２案,雲林縣,口湖鄉,崙中村,214,759,141,103,244,43,287
公投第１２案,雲林縣,口湖鄉,崙中村,215,815,169,157,326,46,372
公投第１２案,雲林縣,口湖鄉,崙東村,216,1460,426,244,670,59,729
公投第１２案,雲林縣,口湖鄉,青蚶村,217,556,108,80,188,11,199
公投第１２案,雲林縣,口湖鄉,港東村,218,1532,395,265,660,53,713
公投第１２案,雲林縣,口湖鄉,港西村,219,847,235,148,383,15,398
公投第１２案,雲林縣,口湖鄉,台子村,220,374,80,90,170,12,182
公投第１２案,雲林縣,口湖鄉,台子村,221,1508,399,288,687,149,836
公投第１２案,雲林縣,口湖鄉,成龍村,222,951,311,168,479,55,534
公投第１２案,雲林縣,口湖鄉,梧南村,223,910,269,192,461,65,526
公投第１２案,雲林縣,口湖鄉,梧南村,224,879,271,210,481,36,517
公投第１２案,雲林縣,口湖鄉,梧北村,225,1213,314,189,503,91,594
公投第１２案,雲林縣,口湖鄉,水井村,226,952,278,153,431,48,479
公投第１２案,雲林縣,口湖鄉,後厝村,227,720,306,41,347,42,389
公投第１２案,雲林縣,口湖鄉,湖口村,228,1006,222,154,376,26,402
公投第１２案,雲林縣,口湖鄉,過港村,229,607,163,69,232,12,244
公投第１２案,雲林縣,水林鄉,水北村,230,1355,326,303,629,47,676
公投第１２案,雲林縣,水林鄉,水北村,231,887,256,190,446,17,463
公投第１２案,雲林縣,水林鄉,水南村,232,1234,373,264,637,34,671
公投第１２案,雲林縣,水林鄉,水南村,233,763,198,160,358,16,374
公投第１２案,雲林縣,水林鄉,萬興村,234,721,157,116,273,35,308
公投第１２案,雲林縣,水林鄉,尖山村,235,647,100,128,228,15,243
公投第１２案,雲林縣,水林鄉,大溝村,236,989,226,158,384,53,437
公投第１２案,雲林縣,水林鄉,順興村,237,837,183,128,311,23,334
公投第１２案,雲林縣,水林鄉,大山村,238,1081,245,141,386,21,407
公投第１２案,雲林縣,水林鄉,後寮村,239,704,191,122,313,24,337
公投第１２案,雲林縣,水林鄉,春埔村,240,1006,272,168,440,61,501
公投第１２案,雲林縣,水林鄉,西井村,241,651,147,109,256,9,265
公投第１２案,雲林縣,水林鄉,車港村,242,607,130,102,232,18,250
公投第１２案,雲林縣,水林鄉,蘇秦村,243,1033,214,163,377,59,436
公投第１２案,雲林縣,水林鄉,灣東村,244,631,124,69,193,13,206
公投第１２案,雲林縣,水林鄉,灣西村,245,961,230,147,377,39,416
公投第１２案,雲林縣,水林鄉,蕃薯村,246,951,223,138,361,64,425
公投第１２案,雲林縣,水林鄉,山腳村,247,838,212,139,351,22,373
公投第１２案,雲林縣,水林鄉,松北村,248,1055,288,148,436,67,503
公投第１２案,雲林縣,水林鄉,松中村,249,512,89,67,156,22,178
公投第１２案,雲林縣,水林鄉,松西村,250,671,133,93,226,19,245
公投第１２案,雲林縣,水林鄉,欍埔村,251,693,111,76,187,36,223
公投第１２案,雲林縣,水林鄉,塭底村,252,689,135,84,219,26,245
公投第１２案,雲林縣,水林鄉,海埔村,253,1022,270,171,441,56,497
公投第１２案,雲林縣,水林鄉,土厝村,254,1191,302,165,467,37,504
公投第１２案,雲林縣,水林鄉,溪墘村,255,779,242,154,396,30,426
公投第１２案,雲林縣,北港鎮,東陽里,256,724,244,139,383,45,428
公投第１２案,雲林縣,北港鎮,光民里,257,688,227,171,398,48,446
公投第１２案,雲林縣,北港鎮,東華里,258,452,162,79,241,27,268
公投第１２案,雲林縣,北港鎮,南安里,259,866,304,160,464,35,499
公投第１２案,雲林縣,北港鎮,中和里,260,336,118,62,180,12,192
公投第１２案,雲林縣,北港鎮,義民里,261,395,129,71,200,16,216
公投第１２案,雲林縣,北港鎮,共榮里,262,376,136,84,220,19,239
公投第１２案,雲林縣,北港鎮,西勢里,263,950,307,209,516,29,545
公投第１２案,雲林縣,北港鎮,仁和里,264,512,204,99,303,31,334
公投第１２案,雲林縣,北港鎮,賜福里,265,324,105,69,174,27,201
公投第１２案,雲林縣,北港鎮,公舘里,266,546,182,98,280,25,305
公投第１２案,雲林縣,北港鎮,大同里,267,433,162,95,257,14,271
公投第１２案,雲林縣,北港鎮,大同里,268,751,232,156,388,44,432
公投第１２案,雲林縣,北港鎮,仁安里,269,442,175,79,254,19,273
公投第１２案,雲林縣,北港鎮,華勝里,270,1151,343,276,619,49,668
公投第１２案,雲林縣,北港鎮,華勝里,271,1224,397,282,679,39,718
公投第１２案,雲林縣,北港鎮,華勝里,272,1211,390,247,637,34,671
公投第１２案,雲林縣,北港鎮,華勝里,273,1326,425,275,700,57,757
公投第１２案,雲林縣,北港鎮,光復里,274,744,243,215,458,25,483
公投第１２案,雲林縣,北港鎮,光復里,275,977,349,238,587,39,626
公投第１２案,雲林縣,北港鎮,扶朝里,276,960,310,183,493,42,535
公投第１２案,雲林縣,北港鎮,水埔里,277,494,117,69,186,10,196
公投第１２案,雲林縣,北港鎮,新街里,278,1364,449,304,753,37,790
公投第１２案,雲林縣,北港鎮,新街里,279,1123,362,250,612,50,662
公投第１２案,雲林縣,北港鎮,新街里,280,1451,476,312,788,38,826
公投第１２案,雲林縣,北港鎮,新街里,281,1162,385,269,654,44,698
公投第１２案,雲林縣,北港鎮,新街里,282,1130,334,223,557,35,592
公投第１２案,雲林縣,北港鎮,劉厝里,283,1149,334,236,570,37,607
公投第１２案,雲林縣,北港鎮,後溝里,284,533,125,98,223,17,240
公投第１２案,雲林縣,北港鎮,後溝里,285,433,162,111,273,20,293
公投第１２案,雲林縣,北港鎮,新厝里,286,377,130,55,185,5,190
公投第１２案,雲林縣,北港鎮,府番里,287,809,194,140,334,24,358
公投第１２案,雲林縣,北港鎮,草湖里,288,1397,371,234,605,49,654
公投第１２案,雲林縣,北港鎮,溝皂里,289,1145,279,190,469,61,530
公投第１２案,雲林縣,北港鎮,番溝里,290,828,158,110,268,50,318
公投第１２案,雲林縣,北港鎮,大北里,291,557,145,72,217,12,229
公投第１２案,雲林縣,北港鎮,好收里,292,1060,287,191,478,30,508
公投第１２案,雲林縣,北港鎮,好收里,293,577,164,89,253,34,287
公投第１２案,雲林縣,北港鎮,樹腳里,294,931,205,160,365,48,413
公投第１２案,雲林縣,北港鎮,樹腳里,295,1018,302,216,518,35,553
公投第１２案,雲林縣,北港鎮,樹腳里,296,1032,347,238,585,19,604
公投第１２案,雲林縣,崙背鄉,東明村,297,1176,375,235,610,52,662
公投第１２案,雲林縣,崙背鄉,西榮村,298,1439,414,280,694,36,730
公投第１２案,雲林縣,崙背鄉,南陽村,299,1027,345,218,563,50,613
公投第１２案,雲林縣,崙背鄉,南陽村,300,1259,423,250,673,41,714
公投第１２案,雲林縣,崙背鄉,崙前村,301,1058,286,205,491,25,516
公投第１２案,雲林縣,崙背鄉,崙前村,302,998,276,166,442,25,467
公投第１２案,雲林縣,崙背鄉,羅厝村,303,968,295,156,451,34,485
公投第１２案,雲林縣,崙背鄉,羅厝村,304,1055,308,198,506,48,554
公投第１２案,雲林縣,崙背鄉,港尾村,305,1315,336,235,571,60,631
公投第１２案,雲林縣,崙背鄉,阿勸村,306,1027,176,144,320,25,345
公投第１２案,雲林縣,崙背鄉,阿勸村,307,997,322,202,524,69,593
公投第１２案,雲林縣,崙背鄉,五魁村,308,807,253,150,403,22,425
公投第１２案,雲林縣,崙背鄉,大有村,309,698,144,119,263,26,289
公投第１２案,雲林縣,崙背鄉,大有村,310,804,168,159,327,49,376
公投第１２案,雲林縣,崙背鄉,豐榮村,311,867,242,166,408,28,436
公投第１２案,雲林縣,崙背鄉,豐榮村,312,886,198,154,352,29,381
公投第１２案,雲林縣,崙背鄉,草湖村,313,1476,308,244,552,66,618
公投第１２案,雲林縣,崙背鄉,舊庄村,314,1159,233,150,383,28,411
公投第１２案,雲林縣,崙背鄉,水尾村,315,1220,426,224,650,56,706
公投第１２案,雲林縣,崙背鄉,枋南村,316,814,231,165,396,28,424
公投第１２案,雲林縣,二崙鄉,崙東村,317,1463,354,298,652,34,686
公投第１２案,雲林縣,二崙鄉,崙西村,318,1738,466,308,774,39,813
公投第１２案,雲林縣,二崙鄉,來惠村,319,625,158,108,266,36,302
公投第１２案,雲林縣,二崙鄉,來惠村,320,1018,269,200,469,36,505
公投第１２案,雲林縣,二崙鄉,三和村,321,448,96,80,176,7,183
公投第１２案,雲林縣,二崙鄉,三和村,322,1048,204,159,363,48,411
公投第１２案,雲林縣,二崙鄉,湳仔村,323,1161,312,264,576,58,634
公投第１２案,雲林縣,二崙鄉,田尾村,324,991,278,209,487,29,516
公投第１２案,雲林縣,二崙鄉,田尾村,325,849,277,183,460,43,503
公投第１２案,雲林縣,二崙鄉,定安村,326,890,236,177,413,37,450
公投第１２案,雲林縣,二崙鄉,永定村,327,1427,364,271,635,74,709
公投第１２案,雲林縣,二崙鄉,大華村,328,891,357,100,457,18,475
公投第１２案,雲林縣,二崙鄉,義庄村,329,757,173,131,304,26,330
公投第１２案,雲林縣,二崙鄉,楊賢村,330,1497,394,241,635,98,733
公投第１２案,雲林縣,二崙鄉,港後村,331,1171,301,209,510,52,562
公投第１２案,雲林縣,二崙鄉,港後村,332,686,215,144,359,46,405
公投第１２案,雲林縣,二崙鄉,大義村,333,864,192,115,307,80,387
公投第１２案,雲林縣,二崙鄉,油車村,334,1073,318,230,548,68,616
公投第１２案,雲林縣,二崙鄉,油車村,335,696,165,117,282,16,298
公投第１２案,雲林縣,二崙鄉,大庄村,336,1271,273,183,456,39,495
公投第１２案,雲林縣,二崙鄉,庄西村,337,912,213,160,373,37,410
公投第１２案,雲林縣,二崙鄉,大同村,338,861,211,157,368,29,397
公投第１２案,雲林縣,二崙鄉,復興村,339,1030,209,186,395,45,440
公投第１２案,雲林縣,西螺鎮,振興里,340,1590,452,335,787,58,845
公投第１２案,雲林縣,西螺鎮,大園里,341,1741,517,381,898,61,959
公投第１２案,雲林縣,西螺鎮,廣福里,342,1080,398,262,660,37,697
公投第１２案,雲林縣,西螺鎮,廣福里,343,1040,392,228,620,53,673
公投第１２案,雲林縣,西螺鎮,正興里,344,1346,469,286,755,35,790
公投第１２案,雲林縣,西螺鎮,正興里,345,1625,550,296,846,49,895
公投第１２案,雲林縣,西螺鎮,永安里,346,354,139,78,217,18,235
公投第１２案,雲林縣,西螺鎮,中和里,347,580,196,108,304,18,322
公投第１２案,雲林縣,西螺鎮,福興里,348,591,211,149,360,14,374
公投第１２案,雲林縣,西螺鎮,光華里,349,1050,343,245,588,32,620
公投第１２案,雲林縣,西螺鎮,中興里,350,1147,400,265,665,42,707
公投第１２案,雲林縣,西螺鎮,中興里,351,1602,461,353,814,49,863
公投第１２案,雲林縣,西螺鎮,漢光里,352,1452,434,312,746,33,779
公投第１２案,雲林縣,西螺鎮,漢光里,353,1578,481,357,838,49,887
公投第１２案,雲林縣,西螺鎮,漢光里,354,1305,403,236,639,33,672
公投第１２案,雲林縣,西螺鎮,新安里,355,1327,353,253,606,34,640
公投第１２案,雲林縣,西螺鎮,新豐里,356,1516,419,339,758,46,804
公投第１２案,雲林縣,西螺鎮,大新里,357,828,200,154,354,17,371
公投第１２案,雲林縣,西螺鎮,大新里,358,788,201,117,318,18,336
公投第１２案,雲林縣,西螺鎮,埤頭里,359,863,240,176,416,45,461
公投第１２案,雲林縣,西螺鎮,東興里,360,984,272,175,447,76,523
公投第１２案,雲林縣,西螺鎮,鹿場里,361,1514,466,293,759,66,825
公投第１２案,雲林縣,西螺鎮,廣興里,362,870,254,177,431,40,471
公投第１２案,雲林縣,西螺鎮,頂湳里,363,971,278,193,471,51,522
公投第１２案,雲林縣,西螺鎮,吳厝里,364,1304,317,240,557,50,607
公投第１２案,雲林縣,西螺鎮,九隆里,365,726,192,149,341,18,359
公投第１２案,雲林縣,西螺鎮,下湳里,366,823,231,187,418,31,449
公投第１２案,雲林縣,西螺鎮,七座里,367,886,204,156,360,12,372
公投第１２案,雲林縣,西螺鎮,公舘里,368,1373,350,276,626,58,684
公投第１２案,雲林縣,西螺鎮,詔安里,369,983,290,209,499,49,548
公投第１２案,雲林縣,西螺鎮,河南里,370,1014,300,211,511,43,554
公投第１２案,雲林縣,西螺鎮,安定里,371,939,242,186,428,53,481
公投第１２案,雲林縣,西螺鎮,安定里,372,866,240,171,411,30,441
公投第１２案,雲林縣,西螺鎮,福田里,373,1486,393,254,647,82,729
公投第１２案,雲林縣,莿桐鄉,莿桐村,374,1507,475,325,800,50,850
公投第１２案,雲林縣,莿桐鄉,莿桐村,375,1300,414,258,672,36,708
公投第１２案,雲林縣,莿桐鄉,莿桐村,376,1272,432,247,679,77,756
公投第１２案,雲林縣,莿桐鄉,甘厝村,377,861,240,183,423,41,464
公投第１２案,雲林縣,莿桐鄉,甘西村,378,1565,409,296,705,61,766
公投第１２案,雲林縣,莿桐鄉,興桐村,379,577,183,106,289,16,305
公投第１２案,雲林縣,莿桐鄉,興桐村,380,636,170,109,279,27,306
公投第１２案,雲林縣,莿桐鄉,義和村,381,1110,311,230,541,37,578
公投第１２案,雲林縣,莿桐鄉,埔子村,382,973,284,247,531,60,591
公投第１２案,雲林縣,莿桐鄉,埔子村,383,985,281,214,495,59,554
公投第１２案,雲林縣,莿桐鄉,大美村,384,1707,550,390,940,80,1020
公投第１２案,雲林縣,莿桐鄉,大美村,385,1284,409,273,682,52,734
公投第１２案,雲林縣,莿桐鄉,埔尾村,386,1293,434,265,699,43,742
公投第１２案,雲林縣,莿桐鄉,興貴村,387,900,282,192,474,36,510
公投第１２案,雲林縣,莿桐鄉,興貴村,388,1040,317,230,547,74,621
公投第１２案,雲林縣,莿桐鄉,饒平村,389,1165,336,241,577,26,603
公投第１２案,雲林縣,莿桐鄉,四合村,390,871,259,188,447,48,495
公投第１２案,雲林縣,莿桐鄉,四合村,391,885,297,189,486,56,542
公投第１２案,雲林縣,莿桐鄉,麻園村,392,1489,395,290,685,49,734
公投第１２案,雲林縣,莿桐鄉,五華村,393,1347,359,217,576,97,673
公投第１２案,雲林縣,莿桐鄉,六合村,394,1150,365,257,622,46,668
公投第１２案,雲林縣,莿桐鄉,六合村,395,653,218,151,369,23,392
公投第１２案,雲林縣,林內鄉,林南村,396,1036,393,221,614,42,656
公投第１２案,雲林縣,林內鄉,林中村,397,1490,472,335,807,32,839
公投第１２案,雲林縣,林內鄉,林中村,398,1491,474,275,749,55,804
公投第１２案,雲林縣,林內鄉,林中村,399,671,208,113,321,37,358
公投第１２案,雲林縣,林內鄉,林北村,400,1436,419,307,726,136,862
公投第１２案,雲林縣,林內鄉,林北村,401,751,238,163,401,44,445
公投第１２案,雲林縣,林內鄉,坪頂村,402,535,174,113,287,13,300
公投第１２案,雲林縣,林內鄉,林茂村,403,811,182,175,357,33,390
公投第１２案,雲林縣,林內鄉,九芎村,404,1339,424,282,706,64,770
公投第１２案,雲林縣,林內鄉,九芎村,405,1286,432,230,662,51,713
公投第１２案,雲林縣,林內鄉,湖本村,406,646,191,141,332,27,359
公投第１２案,雲林縣,林內鄉,烏塗村,407,1158,364,245,609,42,651
公投第１２案,雲林縣,林內鄉,烏麻村,408,1090,345,229,574,44,618
公投第１２案,雲林縣,林內鄉,重興村,409,950,320,208,528,62,590
公投第１２案,雲林縣,林內鄉,重興村,410,861,249,204,453,33,486
公投第１２案,雲林縣,斗六市,信義里,411,644,192,149,341,16,357
公投第１２案,雲林縣,斗六市,四維里,412,617,199,136,335,17,352
公投第１２案,雲林縣,斗六市,太平里,413,764,277,188,465,39,504
公投第１２案,雲林縣,斗六市,中和里,414,784,283,187,470,22,492
公投第１２案,雲林縣,斗六市,光興里,415,760,262,163,425,22,447
公投第１２案,雲林縣,斗六市,鎮西里,416,1881,632,449,1081,58,1139
公投第１２案,雲林縣,斗六市,鎮西里,417,1829,604,352,956,49,1005
公投第１２案,雲林縣,斗六市,鎮東里,418,1255,488,282,770,26,796
公投第１２案,雲林縣,斗六市,鎮東里,419,1090,445,231,676,27,703
公投第１２案,雲林縣,斗六市,文化里,420,1103,396,240,636,39,675
公投第１２案,雲林縣,斗六市,文化里,421,1176,417,260,677,41,718
公投第１２案,雲林縣,斗六市,三平里,422,1529,527,317,844,25,869
公投第１２案,雲林縣,斗六市,三平里,423,1335,474,284,758,42,800
公投第１２案,雲林縣,斗六市,三平里,424,1770,602,396,998,42,1040
公投第１２案,雲林縣,斗六市,明德里,425,1308,418,306,724,20,744
公投第１２案,雲林縣,斗六市,明德里,426,2171,692,430,1122,45,1167
公投第１２案,雲林縣,斗六市,鎮北里,427,1193,405,276,681,28,709
公投第１２案,雲林縣,斗六市,鎮北里,428,1572,617,330,947,29,976
公投第１２案,雲林縣,斗六市,公誠里,429,1009,363,200,563,17,580
公投第１２案,雲林縣,斗六市,公誠里,430,1195,421,302,723,32,755
公投第１２案,雲林縣,斗六市,忠孝里,431,1415,531,300,831,46,877
公投第１２案,雲林縣,斗六市,仁愛里,432,1101,387,257,644,32,676
公投第１２案,雲林縣,斗六市,八德里,433,1648,569,350,919,22,941
公投第１２案,雲林縣,斗六市,八德里,434,1588,514,296,810,22,832
公投第１２案,雲林縣,斗六市,公正里,435,1392,478,319,797,30,827
公投第１２案,雲林縣,斗六市,公正里,436,1422,467,334,801,30,831
公投第１２案,雲林縣,斗六市,重光里,437,1187,346,202,548,32,580
公投第１２案,雲林縣,斗六市,重光里,438,1142,333,233,566,32,598
公投第１２案,雲林縣,斗六市,林頭里,439,1421,504,342,846,33,879
公投第１２案,雲林縣,斗六市,林頭里,440,1261,431,271,702,26,728
公投第１２案,雲林縣,斗六市,林頭里,441,1506,469,328,797,30,827
公投第１２案,雲林縣,斗六市,成功里,442,1214,413,285,698,35,733
公投第１２案,雲林縣,斗六市,成功里,443,1362,500,319,819,47,866
公投第１２案,雲林縣,斗六市,鎮南里,444,1097,353,238,591,25,616
公投第１２案,雲林縣,斗六市,鎮南里,445,1262,462,246,708,32,740
公投第１２案,雲林縣,斗六市,鎮南里,446,1154,361,247,608,25,633
公投第１２案,雲林縣,斗六市,社口里,447,847,298,184,482,26,508
公投第１２案,雲林縣,斗六市,社口里,448,1439,475,337,812,21,833
公投第１２案,雲林縣,斗六市,龍潭里,449,1747,610,412,1022,51,1073
公投第１２案,雲林縣,斗六市,嘉東里,450,1418,473,320,793,27,820
公投第１２案,雲林縣,斗六市,崙峰里,451,1112,373,233,606,32,638
公投第１２案,雲林縣,斗六市,崙峰里,452,1302,431,298,729,29,758
公投第１２案,雲林縣,斗六市,溝埧里,453,669,255,168,423,17,440
公投第１２案,雲林縣,斗六市,江厝里,454,752,235,171,406,29,435
公投第１２案,雲林縣,斗六市,江厝里,455,1450,471,305,776,26,802
公投第１２案,雲林縣,斗六市,三光里,456,555,189,105,294,29,323
公投第１２案,雲林縣,斗六市,久安里,457,1470,461,283,744,28,772
公投第１２案,雲林縣,斗六市,久安里,458,927,346,199,545,16,561
公投第１２案,雲林縣,斗六市,虎溪里,459,1893,631,438,1069,34,1103
公投第１２案,雲林縣,斗六市,虎溪里,460,1708,556,367,923,63,986
公投第１２案,雲林縣,斗六市,虎溪里,461,1773,501,333,834,51,885
公投第１２案,雲林縣,斗六市,保庄里,462,1412,516,288,804,34,838
公投第１２案,雲林縣,斗六市,保庄里,463,1354,479,329,808,41,849
公投第１２案,雲林縣,斗六市,保庄里,464,1267,431,274,705,19,724
公投第１２案,雲林縣,斗六市,保庄里,465,1273,395,286,681,20,701
公投第１２案,雲林縣,斗六市,長平里,466,1748,528,334,862,49,911
公投第１２案,雲林縣,斗六市,榴中里,467,1238,412,257,669,61,730
公投第１２案,雲林縣,斗六市,榴中里,468,1648,517,320,837,47,884
公投第１２案,雲林縣,斗六市,榴中里,469,1520,509,375,884,35,919
公投第１２案,雲林縣,斗六市,榴北里,470,1087,345,225,570,29,599
公投第１２案,雲林縣,斗六市,榴南里,471,1904,594,443,1037,52,1089
公投第１２案,雲林縣,斗六市,梅林里,472,702,236,165,401,36,437
公投第１２案,雲林縣,斗六市,梅林里,473,1111,395,241,636,40,676
公投第１２案,雲林縣,斗六市,湖山里,474,1123,309,227,536,37,573
公投第１２案,雲林縣,斗六市,長安里,475,1146,329,255,584,44,628
公投第１２案,雲林縣,斗六市,長安里,476,1786,524,404,928,35,963
公投第１２案,雲林縣,斗六市,溪洲里,477,1023,324,232,556,38,594
公投第１２案,雲林縣,斗六市,溪洲里,478,2072,644,444,1088,61,1149
公投第１２案,雲林縣,斗六市,十三里,479,1128,352,246,598,17,615
公投第１２案,雲林縣,大埤鄉,北和村,480,750,212,164,376,27,403
公投第１２案,雲林縣,大埤鄉,吉田村,481,719,188,163,351,22,373
公投第１２案,雲林縣,大埤鄉,豐岡村,482,603,192,118,310,13,323
公投第１２案,雲林縣,大埤鄉,聯美村,483,1106,268,214,482,51,533
公投第１２案,雲林縣,大埤鄉,南和村,484,1495,432,316,748,44,792
公投第１２案,雲林縣,大埤鄉,南和村,485,600,187,151,338,22,360
公投第１２案,雲林縣,大埤鄉,大德村,486,1004,307,244,551,43,594
公投第１２案,雲林縣,大埤鄉,松竹村,487,948,222,155,377,22,399
公投第１２案,雲林縣,大埤鄉,豐田村,488,1539,449,332,781,50,831
公投第１２案,雲林縣,大埤鄉,尚義村,489,1430,366,287,653,44,697
公投第１２案,雲林縣,大埤鄉,尚義村,490,465,141,82,223,18,241
公投第１２案,雲林縣,大埤鄉,嘉興村,491,1307,385,228,613,48,661
公投第１２案,雲林縣,大埤鄉,嘉興村,492,474,145,96,241,9,250
公投第１２案,雲林縣,大埤鄉,三結村,493,1220,408,271,679,56,735
公投第１２案,雲林縣,大埤鄉,怡然村,494,733,235,138,373,18,391
公投第１２案,雲林縣,大埤鄉,北鎮村,495,681,225,128,353,24,377
公投第１２案,雲林縣,大埤鄉,興安村,496,712,162,125,287,18,305
公投第１２案,雲林縣,大埤鄉,西鎮村,497,723,180,127,307,41,348
公投第１２案,雲林縣,斗南鎮,東仁里,498,1166,413,271,684,30,714
公投第１２案,雲林縣,斗南鎮,西岐里,499,1135,439,254,693,25,718
公投第１２案,雲林縣,斗南鎮,西岐里,500,975,360,222,582,23,605
公投第１２案,雲林縣,斗南鎮,大同里,501,1459,509,336,845,31,876
公投第１２案,雲林縣,斗南鎮,大同里,502,1351,436,319,755,40,795
公投第１２案,雲林縣,斗南鎮,南昌里,503,1321,428,283,711,37,748
公投第１２案,雲林縣,斗南鎮,南昌里,504,907,294,181,475,25,500
公投第１２案,雲林縣,斗南鎮,北銘里,505,1473,527,350,877,52,929
公投第１２案,雲林縣,斗南鎮,中天里,506,1277,462,313,775,28,803
公投第１２案,雲林縣,斗南鎮,林子里,507,1333,413,297,710,47,757
公投第１２案,雲林縣,斗南鎮,石龜里,508,777,254,153,407,25,432
公投第１２案,雲林縣,斗南鎮,石溪里,509,877,269,187,456,28,484
公投第１２案,雲林縣,斗南鎮,靖興里,510,899,267,184,451,40,491
公投第１２案,雲林縣,斗南鎮,新南里,511,688,205,106,311,23,334
公投第１２案,雲林縣,斗南鎮,阿丹里,512,1147,382,199,581,27,608
公投第１２案,雲林縣,斗南鎮,將軍里,513,1709,538,402,940,60,1000
公投第１２案,雲林縣,斗南鎮,舊社里,514,1042,391,219,610,31,641
公投第１２案,雲林縣,斗南鎮,舊社里,515,1631,511,353,864,39,903
公投第１２案,雲林縣,斗南鎮,明昌里,516,1702,587,391,978,63,1041
公投第１２案,雲林縣,斗南鎮,明昌里,517,1564,535,344,879,48,927
公投第１２案,雲林縣,斗南鎮,僑真里,518,910,257,159,416,20,436
公投第１２案,雲林縣,斗南鎮,僑真里,519,1276,456,288,744,45,789
公投第１２案,雲林縣,斗南鎮,大東里,520,897,268,170,438,8,446
公投第１２案,雲林縣,斗南鎮,埤麻里,521,803,262,162,424,27,451
公投第１２案,雲林縣,斗南鎮,西伯里,522,866,286,181,467,39,506
公投第１２案,雲林縣,斗南鎮,新崙里,523,852,257,206,463,40,503
公投第１２案,雲林縣,斗南鎮,新崙里,524,671,208,150,358,28,386
公投第１２案,雲林縣,斗南鎮,東明里,525,981,315,197,512,26,538
公投第１２案,雲林縣,斗南鎮,新光里,526,1129,310,218,528,16,544
公投第１２案,雲林縣,斗南鎮,新光里,527,1586,540,340,880,61,941
公投第１２案,雲林縣,斗南鎮,田頭里,528,1243,446,274,720,48,768
公投第１２案,雲林縣,斗南鎮,田頭里,529,984,313,176,489,25,514
公投第１２案,雲林縣,斗南鎮,小東里,530,1507,551,295,846,46,892
公投第１２案,雲林縣,古坑鄉,棋盤村,531,1126,355,244,599,30,629
公投第１２案,雲林縣,古坑鄉,棋盤村,532,994,287,200,487,41,528
公投第１２案,雲林縣,古坑鄉,新庄村,533,1517,443,327,770,53,823
公投第１２案,雲林縣,古坑鄉,東和村,534,1302,433,253,686,38,724
公投第１２案,雲林縣,古坑鄉,東和村,535,1772,498,352,850,54,904
公投第１２案,雲林縣,古坑鄉,荷苞村,536,1122,376,212,588,56,644
公投第１２案,雲林縣,古坑鄉,荷苞村,537,304,62,45,107,3,110
公投第１２案,雲林縣,古坑鄉,高林村,538,1169,388,220,608,74,682
公投第１２案,雲林縣,古坑鄉,水碓村,539,1255,354,229,583,73,656
公投第１２案,雲林縣,古坑鄉,田心村,540,1078,375,243,618,35,653
公投第１２案,雲林縣,古坑鄉,古坑村,541,943,278,171,449,22,471
公投第１２案,雲林縣,古坑鄉,古坑村,542,1300,393,217,610,64,674
公投第１２案,雲林縣,古坑鄉,朝陽村,543,964,304,158,462,40,502
公投第１２案,雲林縣,古坑鄉,朝陽村,544,1144,364,224,588,32,620
公投第１２案,雲林縣,古坑鄉,西平村,545,1482,444,281,725,71,796
公投第１２案,雲林縣,古坑鄉,湳仔村,546,688,223,143,366,26,392
公投第１２案,雲林縣,古坑鄉,永光村,547,998,288,190,478,34,512
公投第１２案,雲林縣,古坑鄉,永光村,548,1140,383,240,623,31,654
公投第１２案,雲林縣,古坑鄉,永昌村,549,1102,324,236,560,42,602
公投第１２案,雲林縣,古坑鄉,永昌村,550,956,302,176,478,29,507
公投第１２案,雲林縣,古坑鄉,麻園村,551,695,189,179,368,19,387
公投第１２案,雲林縣,古坑鄉,崁腳村,552,1233,369,221,590,31,621
公投第１２案,雲林縣,古坑鄉,華南村,553,285,67,43,110,11,121
公投第１２案,雲林縣,古坑鄉,華山村,554,734,190,105,295,10,305
公投第１２案,雲林縣,古坑鄉,桂林村,555,1150,323,264,587,49,636
公投第１２案,雲林縣,古坑鄉,樟湖村,556,453,141,95,236,14,250
公投第１２案,雲林縣,古坑鄉,草嶺村,557,571,163,96,259,19,278
公投第１２案,嘉義縣,太保市,太保里,1,1210,391,252,643,37,680
公投第１２案,嘉義縣,太保市,太保里,2,1076,347,230,577,31,608
公投第１２案,嘉義縣,太保市,後庄里,3,488,138,89,227,23,250
公投第１２案,嘉義縣,太保市,前潭里,4,1475,420,286,706,47,753
公投第１２案,嘉義縣,太保市,後潭里,5,790,214,144,358,22,380
公投第１２案,嘉義縣,太保市,後潭里,6,883,265,161,426,22,448
公投第１２案,嘉義縣,太保市,梅埔里,7,758,199,163,362,24,386
公投第１２案,嘉義縣,太保市,梅埔里,8,389,107,60,167,4,171
公投第１２案,嘉義縣,太保市,春珠里,9,1101,296,185,481,34,515
公投第１２案,嘉義縣,太保市,崙頂里,10,853,327,147,474,10,484
公投第１２案,嘉義縣,太保市,安仁里,11,224,46,40,86,6,92
公投第１２案,嘉義縣,太保市,安仁里,12,662,188,108,296,33,329
公投第１２案,嘉義縣,太保市,安仁里,13,1630,626,316,942,29,971
公投第１２案,嘉義縣,太保市,東勢里,14,913,272,164,436,22,458
公投第１２案,嘉義縣,太保市,東勢里,15,779,268,158,426,8,434
公投第１２案,嘉義縣,太保市,新埤里,16,1278,376,270,646,70,716
公投第１２案,嘉義縣,太保市,舊埤里,17,819,251,130,381,24,405
公投第１２案,嘉義縣,太保市,舊埤里,18,1573,448,362,810,18,828
公投第１２案,嘉義縣,太保市,田尾里,19,481,147,109,256,14,270
公投第１２案,嘉義縣,太保市,田尾里,20,245,86,58,144,4,148
公投第１２案,嘉義縣,太保市,港尾里,21,317,108,67,175,9,184
公投第１２案,嘉義縣,太保市,港尾里,22,258,80,57,137,4,141
公投第１２案,嘉義縣,太保市,過溝里,23,611,204,105,309,24,333
公投第１２案,嘉義縣,太保市,過溝里,24,1526,533,337,870,32,902
公投第１２案,嘉義縣,太保市,過溝里,25,1196,363,307,670,14,684
公投第１２案,嘉義縣,太保市,麻寮里,26,1536,454,324,778,57,835
公投第１２案,嘉義縣,太保市,麻寮里,27,1481,466,318,784,44,828
公投第１２案,嘉義縣,太保市,麻寮里,28,1450,451,313,764,34,798
公投第１２案,嘉義縣,太保市,南新里,29,840,295,157,452,16,468
公投第１２案,嘉義縣,太保市,南新里,30,989,356,215,571,12,583
公投第１２案,嘉義縣,太保市,北新里,31,1529,516,303,819,41,860
公投第１２案,嘉義縣,太保市,北新里,32,1511,490,329,819,37,856
公投第１２案,嘉義縣,太保市,埤鄉里,33,697,212,118,330,24,354
公投第１２案,嘉義縣,鹿草鄉,後寮村,34,522,127,83,210,34,244
公投第１２案,嘉義縣,鹿草鄉,鹿東村,35,563,154,127,281,23,304
公投第１２案,嘉義縣,鹿草鄉,鹿草村,36,1304,364,240,604,47,651
公投第１２案,嘉義縣,鹿草鄉,西井村,37,1312,365,266,631,29,660
公投第１２案,嘉義縣,鹿草鄉,豊稠村,38,320,95,53,148,1,149
公投第１２案,嘉義縣,鹿草鄉,豊稠村,39,418,58,49,107,3,110
公投第１２案,嘉義縣,鹿草鄉,重寮村,40,1025,223,174,397,54,451
公投第１２案,嘉義縣,鹿草鄉,施家村,41,451,99,73,172,23,195
公投第１２案,嘉義縣,鹿草鄉,下潭村,42,830,257,126,383,61,444
公投第１２案,嘉義縣,鹿草鄉,光潭村,43,1050,307,148,455,44,499
公投第１２案,嘉義縣,鹿草鄉,碧潭村,44,972,211,148,359,42,401
公投第１２案,嘉義縣,鹿草鄉,松竹村,45,962,266,147,413,32,445
公投第１２案,嘉義縣,鹿草鄉,竹山村,46,678,185,129,314,36,350
公投第１２案,嘉義縣,鹿草鄉,竹山村,47,262,91,35,126,12,138
公投第１２案,嘉義縣,鹿草鄉,後堀村,48,906,214,150,364,34,398
公投第１２案,嘉義縣,鹿草鄉,後堀村,49,306,67,38,105,5,110
公投第１２案,嘉義縣,鹿草鄉,三角村,50,1062,324,184,508,42,550
公投第１２案,嘉義縣,鹿草鄉,三角村,51,373,118,73,191,14,205
公投第１２案,嘉義縣,鹿草鄉,下麻村,52,324,99,65,164,11,175
公投第１２案,嘉義縣,鹿草鄉,下麻村,53,297,89,52,141,9,150
公投第１２案,嘉義縣,水上鄉,水上村,54,1024,320,182,502,19,521
公投第１２案,嘉義縣,水上鄉,水上村,55,1015,333,253,586,29,615
公投第１２案,嘉義縣,水上鄉,水上村,56,1932,593,317,910,40,950
公投第１２案,嘉義縣,水上鄉,水頭村,57,1170,374,286,660,28,688
公投第１２案,嘉義縣,水上鄉,水頭村,58,1305,450,267,717,49,766
公投第１２案,嘉義縣,水上鄉,粗溪村,59,1242,325,227,552,43,595
公投第１２案,嘉義縣,水上鄉,粗溪村,60,324,89,60,149,17,166
公投第１２案,嘉義縣,水上鄉,下寮村,61,622,206,111,317,14,331
公投第１２案,嘉義縣,水上鄉,下寮村,62,1216,364,225,589,52,641
公投第１２案,嘉義縣,水上鄉,三和村,63,1020,327,218,545,19,564
公投第１２案,嘉義縣,水上鄉,三和村,64,771,274,184,458,25,483
公投第１２案,嘉義縣,水上鄉,回歸村,65,441,162,102,264,15,279
公投第１２案,嘉義縣,水上鄉,大堀村,66,626,266,127,393,26,419
公投第１２案,嘉義縣,水上鄉,大堀村,67,570,192,136,328,14,342
公投第１２案,嘉義縣,水上鄉,大堀村,68,368,102,76,178,14,192
公投第１２案,嘉義縣,水上鄉,大崙村,69,1037,305,179,484,56,540
公投第１２案,嘉義縣,水上鄉,大崙村,70,1065,341,202,543,39,582
公投第１２案,嘉義縣,水上鄉,塗溝村,71,802,281,183,464,45,509
公投第１２案,嘉義縣,水上鄉,龍德村,72,1948,605,380,985,45,1030
公投第１２案,嘉義縣,水上鄉,溪洲村,73,1028,333,163,496,35,531
公投第１２案,嘉義縣,水上鄉,三鎮村,74,641,214,136,350,25,375
公投第１２案,嘉義縣,水上鄉,靖和村,75,408,152,81,233,13,246
公投第１２案,嘉義縣,水上鄉,南和村,76,794,263,166,429,30,459
公投第１２案,嘉義縣,水上鄉,南和村,77,569,143,115,258,15,273
公投第１２案,嘉義縣,水上鄉,柳新村,78,806,225,200,425,28,453
公投第１２案,嘉義縣,水上鄉,柳新村,79,960,281,235,516,44,560
公投第１２案,嘉義縣,水上鄉,柳林村,80,2035,654,417,1071,43,1114
公投第１２案,嘉義縣,水上鄉,柳鄉村,81,1987,639,395,1034,57,1091
公投第１２案,嘉義縣,水上鄉,內溪村,82,1154,403,209,612,39,651
公投第１２案,嘉義縣,水上鄉,寬士村,83,2208,620,449,1069,60,1129
公投第１２案,嘉義縣,水上鄉,寬士村,84,2102,577,335,912,36,948
公投第１２案,嘉義縣,水上鄉,民生村,85,1309,418,206,624,50,674
公投第１２案,嘉義縣,水上鄉,民生村,86,1671,560,300,860,49,909
公投第１２案,嘉義縣,水上鄉,義興村,87,822,245,167,412,37,449
公投第１２案,嘉義縣,水上鄉,中庄村,88,1772,603,288,891,41,932
公投第１２案,嘉義縣,水上鄉,忠和村,89,1919,596,376,972,49,1021
公投第１２案,嘉義縣,水上鄉,南鄉村,90,912,272,172,444,13,457
公投第１２案,嘉義縣,水上鄉,三界村,91,992,332,166,498,20,518
公投第１２案,嘉義縣,水上鄉,國姓村,92,1270,305,228,533,39,572
公投第１２案,嘉義縣,民雄鄉,東榮村,93,1267,423,270,693,39,732
公投第１２案,嘉義縣,民雄鄉,東榮村,94,1030,304,191,495,31,526
公投第１２案,嘉義縣,民雄鄉,中樂村,95,1590,576,315,891,58,949
公投第１２案,嘉義縣,民雄鄉,西安村,96,1673,520,331,851,17,868
公投第１２案,嘉義縣,民雄鄉,西安村,97,1718,556,396,952,39,991
公投第１２案,嘉義縣,民雄鄉,寮頂村,98,1040,347,238,585,36,621
公投第１２案,嘉義縣,民雄鄉,寮頂村,99,1100,333,232,565,29,594
公投第１２案,嘉義縣,民雄鄉,福權村,100,1559,449,299,748,59,807
公投第１２案,嘉義縣,民雄鄉,東湖村,101,1862,513,385,898,55,953
公投第１２案,嘉義縣,民雄鄉,頂崙村,102,1435,438,315,753,56,809
公投第１２案,嘉義縣,民雄鄉,菁埔村,103,1751,528,305,833,90,923
公投第１２案,嘉義縣,民雄鄉,中和村,104,933,304,189,493,44,537
公投第１２案,嘉義縣,民雄鄉,平和村,105,827,290,199,489,28,517
公投第１２案,嘉義縣,民雄鄉,西昌村,106,843,250,147,397,28,425
公投第１２案,嘉義縣,民雄鄉,豊收村,107,1774,567,331,898,38,936
公投第１２案,嘉義縣,民雄鄉,豊收村,108,385,107,64,171,11,182
公投第１２案,嘉義縣,民雄鄉,三興村,109,1306,450,284,734,39,773
公投第１２案,嘉義縣,民雄鄉,東興村,110,535,168,124,292,28,320
公投第１２案,嘉義縣,民雄鄉,鎮北村,111,1055,336,245,581,41,622
公投第１２案,嘉義縣,民雄鄉,北斗村,112,1476,488,280,768,39,807
公投第１２案,嘉義縣,民雄鄉,北斗村,113,1583,514,256,770,29,799
公投第１２案,嘉義縣,民雄鄉,北斗村,114,758,188,159,347,23,370
公投第１２案,嘉義縣,民雄鄉,北斗村,115,1354,398,250,648,29,677
公投第１２案,嘉義縣,民雄鄉,双福村,116,1202,433,220,653,54,707
公投第１２案,嘉義縣,民雄鄉,双福村,117,1175,398,217,615,34,649
公投第１２案,嘉義縣,民雄鄉,福樂村,118,1423,432,271,703,27,730
公投第１２案,嘉義縣,民雄鄉,福樂村,119,1612,538,298,836,20,856
公投第１２案,嘉義縣,民雄鄉,福樂村,120,1695,552,375,927,23,950
公投第１２案,嘉義縣,民雄鄉,福樂村,121,1665,503,282,785,33,818
公投第１２案,嘉義縣,民雄鄉,大崎村,122,1019,307,161,468,34,502
公投第１２案,嘉義縣,民雄鄉,大崎村,123,1352,421,249,670,37,707
公投第１２案,嘉義縣,民雄鄉,秀林村,124,1620,478,361,839,65,904
公投第１２案,嘉義縣,民雄鄉,秀林村,125,943,235,199,434,40,474
公投第１２案,嘉義縣,民雄鄉,松山村,126,1720,456,304,760,41,801
公投第１２案,嘉義縣,民雄鄉,興中村,127,1875,588,311,899,60,959
公投第１２案,嘉義縣,民雄鄉,興南村,128,1305,409,288,697,35,732
公投第１２案,嘉義縣,民雄鄉,興南村,129,1441,425,286,711,43,754
公投第１２案,嘉義縣,民雄鄉,金興村,130,1413,485,275,760,39,799
公投第１２案,嘉義縣,民雄鄉,金興村,131,1560,511,281,792,46,838
公投第１２案,嘉義縣,民雄鄉,福興村,132,2004,656,410,1066,54,1120
公投第１２案,嘉義縣,民雄鄉,文隆村,133,1354,467,294,761,48,809
公投第１２案,嘉義縣,民雄鄉,文隆村,134,1076,369,208,577,20,597
公投第１２案,嘉義縣,民雄鄉,山中村,135,1629,560,300,860,67,927
公投第１２案,嘉義縣,民雄鄉,山中村,136,1977,623,351,974,41,1015
公投第１２案,嘉義縣,民雄鄉,中央村,137,1295,400,249,649,47,696
公投第１２案,嘉義縣,新港鄉,宮前村,138,1087,364,208,572,30,602
公投第１２案,嘉義縣,新港鄉,宮前村,139,1116,431,243,674,44,718
公投第１２案,嘉義縣,新港鄉,宮後村,140,740,261,133,394,19,413
公投第１２案,嘉義縣,新港鄉,宮後村,141,827,245,149,394,46,440
公投第１２案,嘉義縣,新港鄉,大興村,142,704,275,133,408,31,439
公投第１２案,嘉義縣,新港鄉,大興村,143,768,264,182,446,39,485
公投第１２案,嘉義縣,新港鄉,福德村,144,761,261,164,425,35,460
公投第１２案,嘉義縣,新港鄉,福德村,145,850,231,176,407,46,453
公投第１２案,嘉義縣,新港鄉,古民村,146,1327,406,249,655,56,711
公投第１２案,嘉義縣,新港鄉,中庄村,147,756,247,164,411,12,423
公投第１２案,嘉義縣,新港鄉,中庄村,148,816,269,154,423,44,467
公投第１２案,嘉義縣,新港鄉,大潭村,149,667,206,125,331,23,354
公投第１２案,嘉義縣,新港鄉,大潭村,150,942,284,191,475,42,517
公投第１２案,嘉義縣,新港鄉,西庄村,151,918,249,158,407,37,444
公投第１２案,嘉義縣,新港鄉,埤子村,152,554,178,86,264,11,275
公投第１２案,嘉義縣,新港鄉,南崙村,153,929,270,160,430,36,466
公投第１２案,嘉義縣,新港鄉,北崙村,154,487,103,76,179,28,207
公投第１２案,嘉義縣,新港鄉,海瀛村,155,487,144,98,242,28,270
公投第１２案,嘉義縣,新港鄉,月眉村,156,836,236,167,403,40,443
公投第１２案,嘉義縣,新港鄉,月眉村,157,845,255,187,442,33,475
公投第１２案,嘉義縣,新港鄉,月潭村,158,834,252,175,427,40,467
公投第１２案,嘉義縣,新港鄉,月潭村,159,753,227,161,388,37,425
公投第１２案,嘉義縣,新港鄉,溪北村,160,1328,394,259,653,52,705
公投第１２案,嘉義縣,新港鄉,菜公村,161,969,301,220,521,37,558
公投第１２案,嘉義縣,新港鄉,中洋村,162,1043,333,247,580,44,624
公投第１２案,嘉義縣,新港鄉,三間村,163,1400,507,294,801,44,845
公投第１２案,嘉義縣,新港鄉,安和村,164,1017,258,119,377,21,398
公投第１２案,嘉義縣,新港鄉,潭大村,165,1132,354,166,520,31,551
公投第１２案,嘉義縣,新港鄉,南港村,166,1037,294,206,500,44,544
公投第１２案,嘉義縣,新港鄉,板頭村,167,563,192,100,292,40,332
公投第１２案,嘉義縣,新港鄉,共和村,168,849,272,160,432,26,458
公投第１２案,嘉義縣,大林鎮,東林里,169,483,160,90,250,20,270
公投第１２案,嘉義縣,大林鎮,西林里,170,1823,593,395,988,42,1030
公投第１２案,嘉義縣,大林鎮,吉林里,171,955,316,214,530,18,548
公投第１２案,嘉義縣,大林鎮,平林里,172,1436,427,301,728,34,762
公投第１２案,嘉義縣,大林鎮,平林里,173,1390,415,315,730,51,781
公投第１２案,嘉義縣,大林鎮,平林里,174,1512,500,321,821,46,867
公投第１２案,嘉義縣,大林鎮,平林里,175,1536,501,331,832,41,873
公投第１２案,嘉義縣,大林鎮,明華里,176,1165,320,217,537,30,567
公投第１２案,嘉義縣,大林鎮,明和里,177,1730,548,428,976,51,1027
公投第１２案,嘉義縣,大林鎮,排路里,178,602,163,102,265,8,273
公投第１２案,嘉義縣,大林鎮,西結里,179,716,179,147,326,32,358
公投第１２案,嘉義縣,大林鎮,湖北里,180,625,150,111,261,12,273
公投第１２案,嘉義縣,大林鎮,大糖里,181,193,43,28,71,4,75
公投第１２案,嘉義縣,大林鎮,大美里,182,1642,454,254,708,60,768
公投第１２案,嘉義縣,大林鎮,過溪里,183,1465,464,265,729,45,774
公投第１２案,嘉義縣,大林鎮,中坑里,184,928,238,144,382,35,417
公投第１２案,嘉義縣,大林鎮,中坑里,185,361,80,57,137,22,159
公投第１２案,嘉義縣,大林鎮,上林里,186,814,287,117,404,15,419
公投第１２案,嘉義縣,大林鎮,中林里,187,1579,439,302,741,33,774
公投第１２案,嘉義縣,大林鎮,三和里,188,2041,577,424,1001,65,1066
公投第１２案,嘉義縣,大林鎮,溝背里,189,931,276,167,443,36,479
公投第１２案,嘉義縣,大林鎮,義和里,190,675,209,123,332,30,362
公投第１２案,嘉義縣,大林鎮,內林里,191,655,214,113,327,18,345
公投第１２案,嘉義縣,大林鎮,三角里,192,833,241,141,382,34,416
公投第１２案,嘉義縣,大林鎮,三村里,193,832,281,186,467,33,500
公投第１２案,嘉義縣,溪口鄉,溪東村,194,1318,457,256,713,52,765
公投第１２案,嘉義縣,溪口鄉,溪西村,195,677,221,150,371,29,400
公投第１２案,嘉義縣,溪口鄉,溪北村,196,417,138,72,210,12,222
公投第１２案,嘉義縣,溪口鄉,溪北村,197,273,85,61,146,16,162
公投第１２案,嘉義縣,溪口鄉,柳溝村,198,908,314,183,497,37,534
公投第１２案,嘉義縣,溪口鄉,柳溝村,199,386,100,73,173,7,180
公投第１２案,嘉義縣,溪口鄉,疊溪村,200,1039,324,212,536,42,578
公投第１２案,嘉義縣,溪口鄉,妙崙村,201,708,187,115,302,31,333
公投第１２案,嘉義縣,溪口鄉,坪頂村,202,909,272,176,448,19,467
公投第１２案,嘉義縣,溪口鄉,柴林村,203,786,258,144,402,33,435
公投第１２案,嘉義縣,溪口鄉,林腳村,204,807,261,150,411,15,426
公投第１２案,嘉義縣,溪口鄉,美南村,205,1168,337,158,495,21,516
公投第１２案,嘉義縣,溪口鄉,美北村,206,1052,370,185,555,39,594
公投第１２案,嘉義縣,溪口鄉,本厝村,207,565,159,101,260,25,285
公投第１２案,嘉義縣,溪口鄉,本厝村,208,388,129,63,192,18,210
公投第１２案,嘉義縣,溪口鄉,游西村,209,701,209,100,309,17,326
公投第１２案,嘉義縣,溪口鄉,游東村,210,1003,265,164,429,32,461
公投第１２案,嘉義縣,梅山鄉,梅東村,211,1041,308,219,527,24,551
公投第１２案,嘉義縣,梅山鄉,梅東村,212,1245,426,275,701,56,757
公投第１２案,嘉義縣,梅山鄉,梅南村,213,917,336,213,549,32,581
公投第１２案,嘉義縣,梅山鄉,梅北村,214,1189,584,40,624,41,665
公投第１２案,嘉義縣,梅山鄉,梅北村,215,1388,442,290,732,45,777
公投第１２案,嘉義縣,梅山鄉,梅北村,216,1827,571,383,954,43,997
公投第１２案,嘉義縣,梅山鄉,過山村,217,545,184,123,307,36,343
公投第１２案,嘉義縣,梅山鄉,圳南村,218,407,104,56,160,23,183
公投第１２案,嘉義縣,梅山鄉,圳北村,219,636,222,135,357,17,374
公投第１２案,嘉義縣,梅山鄉,双溪村,220,576,186,122,308,32,340
公投第１２案,嘉義縣,梅山鄉,大南村,221,1674,549,332,881,52,933
公投第１２案,嘉義縣,梅山鄉,安靖村,222,858,229,155,384,11,395
公投第１２案,嘉義縣,梅山鄉,永興村,223,526,199,115,314,18,332
公投第１２案,嘉義縣,梅山鄉,半天村,224,372,87,74,161,24,185
公投第１２案,嘉義縣,梅山鄉,太平村,225,506,138,97,235,19,254
公投第１２案,嘉義縣,梅山鄉,太興村,226,433,169,101,270,38,308
公投第１２案,嘉義縣,梅山鄉,龍眼村,227,404,98,51,149,18,167
公投第１２案,嘉義縣,梅山鄉,碧湖村,228,293,65,75,140,8,148
公投第１２案,嘉義縣,梅山鄉,瑞峯村,229,712,217,174,391,57,448
公投第１２案,嘉義縣,梅山鄉,瑞里村,230,602,225,116,341,32,373
公投第１２案,嘉義縣,梅山鄉,太和村,231,515,128,99,227,25,252
公投第１２案,嘉義縣,梅山鄉,太和村,232,417,102,53,155,9,164
公投第１２案,嘉義縣,朴子市,安福里,233,1183,371,257,628,18,646
公投第１２案,嘉義縣,朴子市,安福里,234,755,234,155,389,27,416
公投第１２案,嘉義縣,朴子市,平和里,235,1253,396,257,653,29,682
公投第１２案,嘉義縣,朴子市,平和里,236,1078,371,234,605,47,652
公投第１２案,嘉義縣,朴子市,內厝里,237,1117,394,254,648,37,685
公投第１２案,嘉義縣,朴子市,開元里,238,387,144,76,220,12,232
公投第１２案,嘉義縣,朴子市,順天里,239,633,228,106,334,25,359
公投第１２案,嘉義縣,朴子市,中正里,240,650,217,139,356,15,371
公投第１２案,嘉義縣,朴子市,博厚里,241,825,317,180,497,31,528
公投第１２案,嘉義縣,朴子市,文化里,242,810,287,132,419,34,453
公投第１２案,嘉義縣,朴子市,文化里,243,940,353,172,525,29,554
公投第１２案,嘉義縣,朴子市,永和里,244,905,273,182,455,36,491
公投第１２案,嘉義縣,朴子市,永和里,245,1605,466,275,741,29,770
公投第１２案,嘉義縣,朴子市,竹圍里,246,1479,509,308,817,33,850
公投第１２案,嘉義縣,朴子市,竹圍里,247,1218,399,274,673,32,705
公投第１２案,嘉義縣,朴子市,竹圍里,248,1496,497,324,821,37,858
公投第１２案,嘉義縣,朴子市,新寮里,249,667,191,158,349,19,368
公投第１２案,嘉義縣,朴子市,双溪里,250,627,154,91,245,12,257
公投第１２案,嘉義縣,朴子市,溪口里,251,791,245,131,376,23,399
公投第１２案,嘉義縣,朴子市,德興里,252,1034,287,213,500,73,573
公投第１２案,嘉義縣,朴子市,仁和里,253,1710,475,354,829,23,852
公投第１２案,嘉義縣,朴子市,大鄉里,254,1671,508,277,785,37,822
公投第１２案,嘉義縣,朴子市,大鄉里,255,1547,429,256,685,27,712
公投第１２案,嘉義縣,朴子市,大葛里,256,1602,375,255,630,38,668
公投第１２案,嘉義縣,朴子市,大葛里,257,1302,469,247,716,26,742
公投第１２案,嘉義縣,朴子市,佳禾里,258,740,225,131,356,25,381
公投第１２案,嘉義縣,朴子市,竹村里,259,1054,346,231,577,46,623
公投第１２案,嘉義縣,朴子市,崁前里,260,907,233,149,382,10,392
公投第１２案,嘉義縣,朴子市,崁後里,261,720,178,123,301,13,314
公投第１２案,嘉義縣,朴子市,順安里,262,251,74,62,136,15,151
公投第１２案,嘉義縣,朴子市,德家里,263,767,184,118,302,41,343
公投第１２案,嘉義縣,朴子市,新庄里,264,702,236,127,363,30,393
公投第１２案,嘉義縣,朴子市,梅華里,265,1038,322,147,469,32,501
公投第１２案,嘉義縣,朴子市,松華里,266,1228,273,161,434,25,459
公投第１２案,嘉義縣,朴子市,南竹里,267,499,140,86,226,31,257
公投第１２案,嘉義縣,六腳鄉,蒜頭村,268,1165,312,179,491,32,523
公投第１２案,嘉義縣,六腳鄉,蒜東村,269,825,182,107,289,15,304
公投第１２案,嘉義縣,六腳鄉,蒜南村,270,850,220,145,365,30,395
公投第１２案,嘉義縣,六腳鄉,工廠村,271,222,73,43,116,16,132
公投第１２案,嘉義縣,六腳鄉,灣南村,272,1216,362,211,573,34,607
公投第１２案,嘉義縣,六腳鄉,灣北村,273,1200,276,170,446,38,484
公投第１２案,嘉義縣,六腳鄉,雙涵村,274,877,236,139,375,44,419
公投第１２案,嘉義縣,六腳鄉,塗師村,275,644,163,84,247,31,278
公投第１２案,嘉義縣,六腳鄉,三義村,276,594,122,103,225,11,236
公投第１２案,嘉義縣,六腳鄉,三義村,277,167,30,18,48,2,50
公投第１２案,嘉義縣,六腳鄉,正義村,278,204,33,38,71,3,74
公投第１２案,嘉義縣,六腳鄉,正義村,279,234,49,43,92,2,94
公投第１２案,嘉義縣,六腳鄉,正義村,280,361,93,43,136,10,146
公投第１２案,嘉義縣,六腳鄉,正義村,281,592,193,109,302,35,337
公投第１２案,嘉義縣,六腳鄉,溪厝村,282,619,176,114,290,26,316
公投第１２案,嘉義縣,六腳鄉,港美村,283,714,164,101,265,24,289
公投第１２案,嘉義縣,六腳鄉,豐美村,284,1051,300,204,504,36,540
公投第１２案,嘉義縣,六腳鄉,六斗村,285,934,283,173,456,31,487
公投第１２案,嘉義縣,六腳鄉,崙陽村,286,1044,277,203,480,39,519
公投第１２案,嘉義縣,六腳鄉,蘇厝村,287,1476,404,231,635,36,671
公投第１２案,嘉義縣,六腳鄉,竹本村,288,618,129,87,216,19,235
公投第１２案,嘉義縣,六腳鄉,永賢村,289,478,108,34,142,20,162
公投第１２案,嘉義縣,六腳鄉,魚寮村,290,642,149,64,213,22,235
公投第１２案,嘉義縣,六腳鄉,潭墘村,291,883,185,114,299,5,304
公投第１２案,嘉義縣,六腳鄉,六腳村,292,739,159,95,254,3,257
公投第１２案,嘉義縣,六腳鄉,六南村,293,554,126,75,201,17,218
公投第１２案,嘉義縣,六腳鄉,崩山村,294,649,133,80,213,19,232
公投第１２案,嘉義縣,六腳鄉,古林村,295,689,165,82,247,26,273
公投第１２案,嘉義縣,六腳鄉,更寮村,296,455,95,72,167,15,182
公投第１２案,嘉義縣,六腳鄉,更寮村,297,125,20,16,36,2,38
公投第１２案,嘉義縣,東石鄉,東石村,298,1915,569,301,870,66,936
公投第１２案,嘉義縣,東石鄉,猿樹村,299,938,191,146,337,44,381
公投第１２案,嘉義縣,東石鄉,型厝村,300,1366,258,148,406,26,432
公投第１２案,嘉義縣,東石鄉,塭港村,301,1676,443,226,669,10,679
公投第１２案,嘉義縣,東石鄉,三家村,302,1151,279,146,425,58,483
公投第１２案,嘉義縣,東石鄉,永屯村,303,716,185,105,290,33,323
公投第１２案,嘉義縣,東石鄉,海埔村,304,387,100,47,147,7,154
公投第１２案,嘉義縣,東石鄉,龍港村,305,864,159,96,255,20,275
公投第１２案,嘉義縣,東石鄉,副瀨村,306,910,183,111,294,20,314
公投第１２案,嘉義縣,東石鄉,下揖村,307,760,175,108,283,15,298
公投第１２案,嘉義縣,東石鄉,頂揖村,308,166,63,20,83,6,89
公投第１２案,嘉義縣,東石鄉,頂揖村,309,212,47,24,71,9,80
公投第１２案,嘉義縣,東石鄉,溪下村,310,993,212,106,318,29,347
公投第１２案,嘉義縣,東石鄉,港口村,311,306,66,45,111,11,122
公投第１２案,嘉義縣,東石鄉,鰲鼓村,312,1046,250,127,377,34,411
公投第１２案,嘉義縣,東石鄉,鰲鼓村,313,235,44,34,78,12,90
公投第１２案,嘉義縣,東石鄉,港墘村,314,1226,307,184,491,67,558
公投第１２案,嘉義縣,東石鄉,蔦松村,315,843,187,134,321,45,366
公投第１２案,嘉義縣,東石鄉,圍潭村,316,693,186,96,282,20,302
公投第１２案,嘉義縣,東石鄉,洲仔村,317,839,260,118,378,34,412
公投第１２案,嘉義縣,東石鄉,東崙村,318,363,98,48,146,12,158
公投第１２案,嘉義縣,東石鄉,東崙村,319,321,69,38,107,8,115
公投第１２案,嘉義縣,東石鄉,西崙村,320,1083,347,186,533,63,596
公投第１２案,嘉義縣,東石鄉,塭仔村,321,901,240,137,377,41,418
公投第１２案,嘉義縣,東石鄉,網寮村,322,1216,300,126,426,29,455
公投第１２案,嘉義縣,東石鄉,掌潭村,323,418,139,72,211,39,250
公投第１２案,嘉義縣,東石鄉,掌潭村,324,371,96,55,151,10,161
公投第１２案,嘉義縣,布袋鎮,岱江里,325,614,206,91,297,13,310
公投第１２案,嘉義縣,布袋鎮,九龍里,326,372,103,58,161,10,171
公投第１２案,嘉義縣,布袋鎮,岑海里,327,914,272,192,464,46,510
公投第１２案,嘉義縣,布袋鎮,岑海里,328,1198,384,218,602,46,648
公投第１２案,嘉義縣,布袋鎮,興中里,329,1113,300,174,474,54,528
公投第１２案,嘉義縣,布袋鎮,光復里,330,992,317,179,496,49,545
公投第１２案,嘉義縣,布袋鎮,光復里,331,689,219,119,338,19,357
公投第１２案,嘉義縣,布袋鎮,見龍里,332,882,256,161,417,46,463
公投第１２案,嘉義縣,布袋鎮,新厝里,333,731,230,124,354,28,382
公投第１２案,嘉義縣,布袋鎮,龍江里,334,779,264,146,410,21,431
公投第１２案,嘉義縣,布袋鎮,振寮里,335,762,191,114,305,38,343
公投第１２案,嘉義縣,布袋鎮,西安里,336,1184,302,197,499,36,535
公投第１２案,嘉義縣,布袋鎮,中安里,337,1423,366,168,534,44,578
公投第１２案,嘉義縣,布袋鎮,東安里,338,1351,323,194,517,49,566
公投第１２案,嘉義縣,布袋鎮,樹林里,339,275,91,35,126,2,128
公投第１２案,嘉義縣,布袋鎮,樹林里,340,243,62,45,107,10,117
公投第１２案,嘉義縣,布袋鎮,貴舍里,341,661,223,107,330,33,363
公投第１２案,嘉義縣,布袋鎮,永安里,342,1145,346,168,514,33,547
公投第１２案,嘉義縣,布袋鎮,東港里,343,936,251,170,421,26,447
公投第１２案,嘉義縣,布袋鎮,東港里,344,958,256,166,422,32,454
公投第１２案,嘉義縣,布袋鎮,江山里,345,298,79,50,129,13,142
公投第１２案,嘉義縣,布袋鎮,菜舖里,346,428,144,89,233,24,257
公投第１２案,嘉義縣,布袋鎮,考試里,347,121,29,18,47,3,50
公投第１２案,嘉義縣,布袋鎮,考試里,348,174,29,16,45,6,51
公投第１２案,嘉義縣,布袋鎮,新岑里,349,953,256,166,422,36,458
公投第１２案,嘉義縣,布袋鎮,新民里,350,1292,399,243,642,52,694
公投第１２案,嘉義縣,布袋鎮,復興里,351,1127,356,217,573,33,606
公投第１２案,嘉義縣,布袋鎮,復興里,352,1244,349,214,563,33,596
公投第１２案,嘉義縣,布袋鎮,好美里,353,1106,335,196,531,15,546
公投第１２案,嘉義縣,義竹鄉,岸腳村,354,482,147,65,212,21,233
公投第１２案,嘉義縣,義竹鄉,岸腳村,355,223,75,46,121,13,134
公投第１２案,嘉義縣,義竹鄉,義竹村,356,1529,458,311,769,69,838
公投第１２案,嘉義縣,義竹鄉,六桂村,357,1175,360,267,627,43,670
公投第１２案,嘉義縣,義竹鄉,仁里村,358,886,325,187,512,40,552
公投第１２案,嘉義縣,義竹鄉,傳芳村,359,743,190,123,313,23,336
公投第１２案,嘉義縣,義竹鄉,頭竹村,360,1236,364,247,611,70,681
公投第１２案,嘉義縣,義竹鄉,五厝村,361,377,106,74,180,14,194
公投第１２案,嘉義縣,義竹鄉,中平村,362,338,87,55,142,14,156
公投第１２案,嘉義縣,義竹鄉,中平村,363,102,40,14,54,6,60
公投第１２案,嘉義縣,義竹鄉,埤前村,364,763,218,124,342,23,365
公投第１２案,嘉義縣,義竹鄉,平溪村,365,429,142,90,232,20,252
公投第１２案,嘉義縣,義竹鄉,後鎮村,366,427,130,71,201,13,214
公投第１２案,嘉義縣,義竹鄉,北華村,367,607,186,109,295,41,336
公投第１２案,嘉義縣,義竹鄉,新店村,368,1486,396,257,653,46,699
公投第１２案,嘉義縣,義竹鄉,東過村,369,835,285,154,439,45,484
公投第１２案,嘉義縣,義竹鄉,西過村,370,816,189,123,312,43,355
公投第１２案,嘉義縣,義竹鄉,官和村,371,833,202,146,348,37,385
公投第１２案,嘉義縣,義竹鄉,官順村,372,433,137,62,199,14,213
公投第１２案,嘉義縣,義竹鄉,新富村,373,558,139,102,241,8,249
公投第１２案,嘉義縣,義竹鄉,東光村,374,602,175,111,286,31,317
公投第１２案,嘉義縣,義竹鄉,東光村,375,140,37,17,54,2,56
公投第１２案,嘉義縣,義竹鄉,東榮村,376,393,105,60,165,20,185
公投第１２案,嘉義縣,義竹鄉,龍蛟村,377,585,272,4,276,18,294
公投第１２案,嘉義縣,義竹鄉,溪洲村,378,526,131,68,199,4,203
公投第１２案,嘉義縣,義竹鄉,溪洲村,379,123,50,24,74,3,77
公投第１２案,嘉義縣,中埔鄉,富收村,380,1046,228,196,424,18,442
公投第１２案,嘉義縣,中埔鄉,富收村,381,1788,509,288,797,48,845
公投第１２案,嘉義縣,中埔鄉,和睦村,382,1730,470,308,778,33,811
公投第１２案,嘉義縣,中埔鄉,和睦村,383,1581,456,284,740,39,779
公投第１２案,嘉義縣,中埔鄉,和美村,384,1594,419,233,652,28,680
公投第１２案,嘉義縣,中埔鄉,和美村,385,1801,524,368,892,31,923
公投第１２案,嘉義縣,中埔鄉,和美村,386,1862,570,308,878,45,923
公投第１２案,嘉義縣,中埔鄉,和美村,387,1803,530,302,832,23,855
公投第１２案,嘉義縣,中埔鄉,和興村,388,1481,495,253,748,32,780
公投第１２案,嘉義縣,中埔鄉,和興村,389,1366,404,284,688,42,730
公投第１２案,嘉義縣,中埔鄉,和興村,390,1599,434,247,681,38,719
公投第１２案,嘉義縣,中埔鄉,和興村,391,1196,365,225,590,30,620
公投第１２案,嘉義縣,中埔鄉,中埔村,392,1809,482,308,790,41,831
公投第１２案,嘉義縣,中埔鄉,塩舘村,393,953,282,173,455,18,473
公投第１２案,嘉義縣,中埔鄉,金蘭村,394,1441,384,233,617,54,671
公投第１２案,嘉義縣,中埔鄉,隆興村,395,1882,512,309,821,50,871
公投第１２案,嘉義縣,中埔鄉,義仁村,396,1470,432,268,700,23,723
公投第１２案,嘉義縣,中埔鄉,社口村,397,1699,402,306,708,50,758
公投第１２案,嘉義縣,中埔鄉,社口村,398,422,86,82,168,10,178
公投第１２案,嘉義縣,中埔鄉,灣潭村,399,1030,291,193,484,34,518
公投第１２案,嘉義縣,中埔鄉,裕民村,400,879,252,166,418,24,442
公投第１２案,嘉義縣,中埔鄉,龍門村,401,828,216,147,363,14,377
公投第１２案,嘉義縣,中埔鄉,石硦村,402,881,277,203,480,27,507
公投第１２案,嘉義縣,中埔鄉,石硦村,403,296,88,52,140,8,148
公投第１２案,嘉義縣,中埔鄉,頂埔村,404,979,252,180,432,47,479
公投第１２案,嘉義縣,中埔鄉,同仁村,405,1268,313,229,542,35,577
公投第１２案,嘉義縣,中埔鄉,同仁村,406,670,134,85,219,11,230
公投第１２案,嘉義縣,中埔鄉,深坑村,407,754,223,161,384,47,431
公投第１２案,嘉義縣,中埔鄉,三層村,408,648,207,123,330,28,358
公投第１２案,嘉義縣,中埔鄉,瑞豐村,409,741,141,148,289,13,302
公投第１２案,嘉義縣,中埔鄉,沄水村,410,518,152,85,237,6,243
公投第１２案,嘉義縣,中埔鄉,沄水村,411,482,124,89,213,31,244
公投第１２案,嘉義縣,中埔鄉,東興村,412,348,80,73,153,5,158
公投第１２案,嘉義縣,中埔鄉,中崙村,413,294,80,61,141,8,149
公投第１２案,嘉義縣,竹崎鄉,竹崎村,414,1312,429,263,692,41,733
公投第１２案,嘉義縣,竹崎鄉,竹崎村,415,1210,418,263,681,15,696
公投第１２案,嘉義縣,竹崎鄉,和平村,416,991,314,209,523,31,554
公投第１２案,嘉義縣,竹崎鄉,和平村,417,1207,392,218,610,42,652
公投第１２案,嘉義縣,竹崎鄉,坑頭村,418,752,224,137,361,11,372
公投第１２案,嘉義縣,竹崎鄉,沙坑村,419,833,295,167,462,32,494
公投第１２案,嘉義縣,竹崎鄉,獅埜村,420,1220,418,230,648,45,693
公投第１２案,嘉義縣,竹崎鄉,義和村,421,616,239,136,375,12,387
公投第１２案,嘉義縣,竹崎鄉,義仁村,422,1031,317,160,477,54,531
公投第１２案,嘉義縣,竹崎鄉,灣橋村,423,1292,398,246,644,27,671
公投第１２案,嘉義縣,竹崎鄉,灣橋村,424,1995,655,396,1051,52,1103
公投第１２案,嘉義縣,竹崎鄉,灣橋村,425,1996,593,323,916,35,951
公投第１２案,嘉義縣,竹崎鄉,鹿滿村,426,1449,447,277,724,39,763
公投第１２案,嘉義縣,竹崎鄉,紫雲村,427,1420,467,269,736,34,770
公投第１２案,嘉義縣,竹崎鄉,內埔村,428,1590,549,289,838,49,887
公投第１２案,嘉義縣,竹崎鄉,昇平村,429,771,219,142,361,30,391
公投第１２案,嘉義縣,竹崎鄉,昇平村,430,1014,269,180,449,31,480
公投第１２案,嘉義縣,竹崎鄉,桃源村,431,327,83,47,130,8,138
公投第１２案,嘉義縣,竹崎鄉,桃源村,432,687,174,162,336,27,363
公投第１２案,嘉義縣,竹崎鄉,白杞村,433,641,181,124,305,22,327
公投第１２案,嘉義縣,竹崎鄉,塘興村,434,474,171,89,260,4,264
公投第１２案,嘉義縣,竹崎鄉,塘興村,435,383,99,82,181,12,193
公投第１２案,嘉義縣,竹崎鄉,義隆村,436,619,201,148,349,30,379
公投第１２案,嘉義縣,竹崎鄉,龍山村,437,214,57,36,93,6,99
公投第１２案,嘉義縣,竹崎鄉,龍山村,438,1568,445,320,765,61,826
公投第１２案,嘉義縣,竹崎鄉,文峯村,439,658,175,123,298,17,315
公投第１２案,嘉義縣,竹崎鄉,金獅村,440,434,138,94,232,23,255
公投第１２案,嘉義縣,竹崎鄉,復金村,441,917,309,171,480,22,502
公投第１２案,嘉義縣,竹崎鄉,復金村,442,981,245,196,441,40,481
公投第１２案,嘉義縣,竹崎鄉,緞繻村,443,789,231,123,354,17,371
公投第１２案,嘉義縣,竹崎鄉,緞繻村,444,108,17,9,26,2,28
公投第１２案,嘉義縣,竹崎鄉,仁壽村,445,235,48,25,73,2,75
公投第１２案,嘉義縣,竹崎鄉,中和村,446,331,86,51,137,5,142
公投第１２案,嘉義縣,竹崎鄉,中和村,447,450,163,106,269,13,282
公投第１２案,嘉義縣,竹崎鄉,光華村,448,462,116,52,168,20,188
公投第１２案,嘉義縣,竹崎鄉,光華村,449,251,68,25,93,15,108
公投第１２案,嘉義縣,番路鄉,江西村,450,1174,398,267,665,48,713
公投第１２案,嘉義縣,番路鄉,內甕村,451,449,151,117,268,12,280
公投第１２案,嘉義縣,番路鄉,新福村,452,753,244,185,429,32,461
公投第１２案,嘉義縣,番路鄉,新福村,453,551,132,101,233,30,263
公投第１２案,嘉義縣,番路鄉,下坑村,454,1791,550,392,942,64,1006
公投第１２案,嘉義縣,番路鄉,番路村,455,849,303,194,497,41,538
公投第１２案,嘉義縣,番路鄉,民和村,456,866,299,176,475,28,503
公投第１２案,嘉義縣,番路鄉,觸口村,457,800,264,148,412,28,440
公投第１２案,嘉義縣,番路鄉,觸口村,458,444,136,96,232,24,256
公投第１２案,嘉義縣,番路鄉,大湖村,459,635,178,76,254,12,266
公投第１２案,嘉義縣,番路鄉,公田村,460,319,102,34,136,13,149
公投第１２案,嘉義縣,番路鄉,公田村,461,642,242,109,351,28,379
公投第１２案,嘉義縣,番路鄉,公興村,462,509,139,77,216,16,232
公投第１２案,嘉義縣,番路鄉,草山村,463,162,67,26,93,1,94
公投第１２案,嘉義縣,番路鄉,草山村,464,212,73,43,116,6,122
公投第１２案,嘉義縣,大埔鄉,大埔村,465,1468,469,291,760,48,808
公投第１２案,嘉義縣,大埔鄉,和平村,466,320,79,43,122,4,126
公投第１２案,嘉義縣,大埔鄉,和平村,467,304,87,84,171,4,175
公投第１２案,嘉義縣,大埔鄉,永樂村,468,184,60,33,93,0,93
公投第１２案,嘉義縣,大埔鄉,永樂村,469,234,82,69,151,6,157
公投第１２案,嘉義縣,大埔鄉,茄苳村,470,495,149,105,254,10,264
公投第１２案,嘉義縣,大埔鄉,茄苳村,471,199,70,37,107,6,113
公投第１２案,嘉義縣,大埔鄉,茄苳村,472,226,63,45,108,7,115
公投第１２案,嘉義縣,大埔鄉,西興村,473,569,221,115,336,13,349
公投第１２案,嘉義縣,阿里山鄉,中山村,474,371,106,72,178,4,182
公投第１２案,嘉義縣,阿里山鄉,中正村,475,197,55,26,81,4,85
公投第１２案,嘉義縣,阿里山鄉,香林村,476,152,36,32,68,5,73
公投第１２案,嘉義縣,阿里山鄉,十字村,477,231,49,25,74,5,79
公投第１２案,嘉義縣,阿里山鄉,十字村,478,72,9,11,20,1,21
公投第１２案,嘉義縣,阿里山鄉,豐山村,479,311,83,43,126,3,129
公投第１２案,嘉義縣,阿里山鄉,來吉村,480,306,100,57,157,6,163
公投第１２案,嘉義縣,阿里山鄉,樂野村,481,970,251,183,434,11,445
公投第１２案,嘉義縣,阿里山鄉,達邦村,482,827,242,183,425,29,454
公投第１２案,嘉義縣,阿里山鄉,里佳村,483,238,67,62,129,2,131
公投第１２案,嘉義縣,阿里山鄉,山美村,484,479,84,61,145,8,153
公投第１２案,嘉義縣,阿里山鄉,新美村,485,291,78,42,120,7,127
公投第１２案,嘉義縣,阿里山鄉,茶山村,486,246,117,38,155,5,160
公投第１２案,屏東縣,屏東市,端正里,1,237,72,47,119,9,128
公投第１２案,屏東縣,屏東市,武廟里,2,294,95,52,147,19,166
公投第１２案,屏東縣,屏東市,大同里,3,582,164,141,305,10,315
公投第１２案,屏東縣,屏東市,光榮里,4,713,237,167,404,16,420
公投第１２案,屏東縣,屏東市,民權里,5,572,181,119,300,19,319
公投第１２案,屏東縣,屏東市,泰安里,6,455,170,105,275,6,281
公投第１２案,屏東縣,屏東市,文明里,7,249,77,67,144,1,145
公投第１２案,屏東縣,屏東市,維新里,8,1315,403,215,618,29,647
公投第１２案,屏東縣,屏東市,維新里,9,1373,340,292,632,37,669
公投第１２案,屏東縣,屏東市,大埔里,10,713,249,172,421,23,444
公投第１２案,屏東縣,屏東市,必信里,11,573,209,131,340,29,369
公投第１２案,屏東縣,屏東市,崇禮里,12,297,116,71,187,16,203
公投第１２案,屏東縣,屏東市,崇智里,13,409,164,100,264,17,281
公投第１２案,屏東縣,屏東市,慶春里,14,286,83,65,148,12,160
公投第１２案,屏東縣,屏東市,楠樹里,15,421,156,96,252,9,261
公投第１２案,屏東縣,屏東市,扶風里,16,569,201,105,306,16,322
公投第１２案,屏東縣,屏東市,安樂里,17,459,118,117,235,13,248
公投第１２案,屏東縣,屏東市,平和里,18,672,241,170,411,21,432
公投第１２案,屏東縣,屏東市,金泉里,19,668,206,181,387,36,423
公投第１２案,屏東縣,屏東市,勝豐里,20,411,153,90,243,12,255
公投第１２案,屏東縣,屏東市,橋南里,21,768,263,159,422,21,443
公投第１２案,屏東縣,屏東市,橋南里,22,786,242,177,419,19,438
公投第１２案,屏東縣,屏東市,橋北里,23,890,325,175,500,29,529
公投第１２案,屏東縣,屏東市,大連里,24,1353,475,254,729,32,761
公投第１２案,屏東縣,屏東市,大連里,25,1386,471,240,711,27,738
公投第１２案,屏東縣,屏東市,大連里,26,1413,452,288,740,24,764
公投第１２案,屏東縣,屏東市,大連里,27,1272,470,187,657,32,689
公投第１２案,屏東縣,屏東市,大連里,28,1287,420,261,681,22,703
公投第１２案,屏東縣,屏東市,大連里,29,1311,468,263,731,32,763
公投第１２案,屏東縣,屏東市,大連里,30,1285,447,262,709,17,726
公投第１２案,屏東縣,屏東市,豐田里,31,1297,442,269,711,32,743
公投第１２案,屏東縣,屏東市,豐田里,32,1361,280,440,720,29,749
公投第１２案,屏東縣,屏東市,豐田里,33,1381,423,252,675,38,713
公投第１２案,屏東縣,屏東市,豐榮里,34,1258,432,273,705,43,748
公投第１２案,屏東縣,屏東市,豐榮里,35,1259,434,244,678,33,711
公投第１２案,屏東縣,屏東市,豐源里,36,1076,373,207,580,17,597
公投第１２案,屏東縣,屏東市,豐源里,37,1162,408,253,661,14,675
公投第１２案,屏東縣,屏東市,豐源里,38,1318,446,287,733,24,757
公投第１２案,屏東縣,屏東市,長春里,39,939,261,242,503,24,527
公投第１２案,屏東縣,屏東市,長春里,40,972,348,196,544,19,563
公投第１２案,屏東縣,屏東市,瑞光里,41,1535,512,331,843,35,878
公投第１２案,屏東縣,屏東市,瑞光里,42,1419,404,246,650,38,688
公投第１２案,屏東縣,屏東市,瑞光里,43,1398,400,277,677,18,695
公投第１２案,屏東縣,屏東市,瑞光里,44,1405,424,283,707,43,750
公投第１２案,屏東縣,屏東市,瑞光里,45,1486,485,299,784,32,816
公投第１２案,屏東縣,屏東市,湖南里,46,1061,346,212,558,35,593
公投第１２案,屏東縣,屏東市,湖西里,47,1540,405,293,698,58,756
公投第１２案,屏東縣,屏東市,歸心里,48,1141,325,220,545,20,565
公投第１２案,屏東縣,屏東市,清溪里,49,1247,335,263,598,32,630
公投第１２案,屏東縣,屏東市,清溪里,50,1446,416,278,694,42,736
公投第１２案,屏東縣,屏東市,清溪里,51,1303,466,254,720,23,743
公投第１２案,屏東縣,屏東市,大武里,52,1253,403,254,657,32,689
公投第１２案,屏東縣,屏東市,大武里,53,1315,426,257,683,33,716
公投第１２案,屏東縣,屏東市,大武里,54,1425,401,294,695,32,727
公投第１２案,屏東縣,屏東市,大武里,55,1423,446,269,715,27,742
公投第１２案,屏東縣,屏東市,大武里,56,1400,487,262,749,41,790
公投第１２案,屏東縣,屏東市,大武里,57,1359,450,307,757,32,789
公投第１２案,屏東縣,屏東市,崇武里,58,1328,472,222,694,24,718
公投第１２案,屏東縣,屏東市,崇武里,59,1539,528,262,790,26,816
公投第１２案,屏東縣,屏東市,凌雲里,60,391,80,59,139,7,146
公投第１２案,屏東縣,屏東市,永昌里,61,200,76,30,106,11,117
公投第１２案,屏東縣,屏東市,永順里,62,328,85,67,152,16,168
公投第１２案,屏東縣,屏東市,鵬程里,63,231,78,41,119,3,122
公投第１２案,屏東縣,屏東市,安鎮里,64,945,291,184,475,55,530
公投第１２案,屏東縣,屏東市,安鎮里,65,1053,295,220,515,50,565
公投第１２案,屏東縣,屏東市,永光里,66,1043,296,201,497,40,537
公投第１２案,屏東縣,屏東市,長安里,67,1061,315,188,503,56,559
公投第１２案,屏東縣,屏東市,長安里,68,876,261,180,441,18,459
公投第１２案,屏東縣,屏東市,前進里,69,1468,426,252,678,74,752
公投第１２案,屏東縣,屏東市,前進里,70,1454,420,257,677,50,727
公投第１２案,屏東縣,屏東市,大洲里,71,1205,378,283,661,23,684
公投第１２案,屏東縣,屏東市,新興里,72,1284,349,277,626,32,658
公投第１２案,屏東縣,屏東市,新興里,73,1219,376,211,587,28,615
公投第１２案,屏東縣,屏東市,公館里,74,1544,512,317,829,58,887
公投第１２案,屏東縣,屏東市,新生里,75,1485,467,284,751,59,810
公投第１２案,屏東縣,屏東市,新生里,76,1387,438,289,727,42,769
公投第１２案,屏東縣,屏東市,新生里,77,953,303,167,470,22,492
公投第１２案,屏東縣,屏東市,新生里,78,1603,503,332,835,44,879
公投第１２案,屏東縣,屏東市,頂宅里,79,535,153,117,270,26,296
公投第１２案,屏東縣,屏東市,頂柳里,80,1119,333,233,566,33,599
公投第１２案,屏東縣,屏東市,大湖里,81,847,301,154,455,23,478
公投第１２案,屏東縣,屏東市,大湖里,82,923,292,206,498,54,552
公投第１２案,屏東縣,屏東市,龍華里,83,1227,370,235,605,33,638
公投第１２案,屏東縣,屏東市,龍華里,84,1039,342,207,549,28,577
公投第１２案,屏東縣,屏東市,玉成里,85,1485,437,290,727,67,794
公投第１２案,屏東縣,屏東市,擇仁里,86,867,274,166,440,32,472
公投第１２案,屏東縣,屏東市,建國里,87,918,304,179,483,28,511
公投第１２案,屏東縣,屏東市,萬年里,88,663,196,120,316,30,346
公投第１２案,屏東縣,屏東市,厚生里,89,1215,326,239,565,21,586
公投第１２案,屏東縣,屏東市,厚生里,90,1628,445,300,745,58,803
公投第１２案,屏東縣,屏東市,一心里,91,1209,377,265,642,34,676
公投第１２案,屏東縣,屏東市,義勇里,92,1110,421,270,691,20,711
公投第１２案,屏東縣,屏東市,光華里,93,684,211,110,321,11,332
公投第１２案,屏東縣,屏東市,永安里,94,1349,390,206,596,26,622
公投第１２案,屏東縣,屏東市,永安里,95,1457,440,262,702,43,745
公投第１２案,屏東縣,屏東市,永安里,96,1447,467,305,772,22,794
公投第１２案,屏東縣,屏東市,永安里,97,1354,386,281,667,17,684
公投第１２案,屏東縣,屏東市,永安里,98,1583,514,316,830,55,885
公投第１２案,屏東縣,屏東市,崇蘭里,99,1707,595,271,866,18,884
公投第１２案,屏東縣,屏東市,崇蘭里,100,1637,475,306,781,25,806
公投第１２案,屏東縣,屏東市,崇蘭里,101,1459,452,249,701,8,709
公投第１２案,屏東縣,屏東市,崇蘭里,102,1759,595,324,919,33,952
公投第１２案,屏東縣,屏東市,崇蘭里,103,1950,653,337,990,41,1031
公投第１２案,屏東縣,屏東市,崇蘭里,104,1729,572,324,896,29,925
公投第１２案,屏東縣,屏東市,崇蘭里,105,1592,522,283,805,26,831
公投第１２案,屏東縣,屏東市,潭墘里,106,1437,445,219,664,27,691
公投第１２案,屏東縣,屏東市,潭墘里,107,1204,390,211,601,25,626
公投第１２案,屏東縣,屏東市,潭墘里,108,1340,454,255,709,30,739
公投第１２案,屏東縣,屏東市,潭墘里,109,1322,444,250,694,25,719
公投第１２案,屏東縣,屏東市,潭墘里,110,1462,457,253,710,39,749
公投第１２案,屏東縣,屏東市,潭墘里,111,3241,1018,524,1542,48,1590
公投第１２案,屏東縣,屏東市,潭墘里,112,1477,456,254,710,18,728
公投第１２案,屏東縣,屏東市,永城里,113,821,236,145,381,21,402
公投第１２案,屏東縣,屏東市,永城里,114,1099,300,178,478,23,501
公投第１２案,屏東縣,屏東市,空翔里,115,1688,562,282,844,33,877
公投第１２案,屏東縣,屏東市,廣興里,116,1167,349,217,566,37,603
公投第１２案,屏東縣,屏東市,廣興里,117,915,283,179,462,29,491
公投第１２案,屏東縣,屏東市,勝利里,118,1683,319,196,515,14,529
公投第１２案,屏東縣,屏東市,勝利里,119,1497,466,281,747,16,763
公投第１２案,屏東縣,屏東市,勝利里,120,1129,351,214,565,31,596
公投第１２案,屏東縣,屏東市,勝利里,121,1232,399,242,641,27,668
公投第１２案,屏東縣,屏東市,斯文里,122,853,291,144,435,31,466
公投第１２案,屏東縣,屏東市,斯文里,123,869,287,206,493,17,510
公投第１２案,屏東縣,屏東市,華山里,124,1169,389,246,635,35,670
公投第１２案,屏東縣,屏東市,華山里,125,1058,377,193,570,26,596
公投第１２案,屏東縣,屏東市,華山里,126,1344,392,252,644,26,670
公投第１２案,屏東縣,屏東市,華山里,127,1299,394,284,678,25,703
公投第１２案,屏東縣,屏東市,溝美里,128,1204,359,247,606,6,612
公投第１２案,屏東縣,屏東市,溝美里,129,1123,359,212,571,27,598
公投第１２案,屏東縣,屏東市,三山里,130,1318,372,236,608,26,634
公投第１２案,屏東縣,屏東市,海豐里,131,865,280,199,479,35,514
公投第１２案,屏東縣,屏東市,仁義里,132,1100,313,195,508,23,531
公投第１２案,屏東縣,屏東市,北興里,133,1215,362,218,580,24,604
公投第１２案,屏東縣,屏東市,北興里,134,1370,484,224,708,21,729
公投第１２案,屏東縣,屏東市,北興里,135,1240,447,197,644,16,660
公投第１２案,屏東縣,屏東市,北興里,136,1168,392,250,642,24,666
公投第１２案,屏東縣,屏東市,北興里,137,1079,360,209,569,24,593
公投第１２案,屏東縣,屏東市,北勢里,138,1289,452,267,719,28,747
公投第１２案,屏東縣,屏東市,北勢里,139,1115,360,209,569,27,596
公投第１２案,屏東縣,屏東市,中正里,140,1491,441,344,785,38,823
公投第１２案,屏東縣,屏東市,中正里,141,1411,431,233,664,25,689
公投第１２案,屏東縣,屏東市,中正里,142,1803,558,335,893,21,914
公投第１２案,屏東縣,屏東市,興樂里,143,744,263,152,415,14,429
公投第１２案,屏東縣,屏東市,明正里,144,678,218,142,360,11,371
公投第１２案,屏東縣,屏東市,太平里,145,681,229,159,388,18,406
公投第１２案,屏東縣,屏東市,信和里,146,1535,407,293,700,33,733
公投第１２案,屏東縣,屏東市,和興里,147,954,310,179,489,50,539
公投第１２案,屏東縣,屏東市,仁愛里,148,1018,386,204,590,27,617
公投第１２案,屏東縣,屏東市,仁愛里,149,1154,358,276,634,22,656
公投第１２案,屏東縣,潮州鎮,潮州里,150,504,179,109,288,17,305
公投第１２案,屏東縣,潮州鎮,光華里,151,1711,512,274,786,32,818
公投第１２案,屏東縣,潮州鎮,光華里,152,1634,495,335,830,20,850
公投第１２案,屏東縣,潮州鎮,光華里,153,1414,414,237,651,28,679
公投第１２案,屏東縣,潮州鎮,同榮里,154,603,216,133,349,30,379
公投第１２案,屏東縣,潮州鎮,彭城里,155,896,262,184,446,44,490
公投第１２案,屏東縣,潮州鎮,三星里,156,1285,418,226,644,27,671
公投第１２案,屏東縣,潮州鎮,三星里,157,1744,722,110,832,37,869
公投第１２案,屏東縣,潮州鎮,三星里,158,1071,359,232,591,31,622
公投第１２案,屏東縣,潮州鎮,三星里,159,1209,427,248,675,39,714
公投第１２案,屏東縣,潮州鎮,三共里,160,1159,357,233,590,29,619
公投第１２案,屏東縣,潮州鎮,三共里,161,1296,368,259,627,39,666
公投第１２案,屏東縣,潮州鎮,三共里,162,1466,492,270,762,29,791
公投第１２案,屏東縣,潮州鎮,三共里,163,1130,392,231,623,31,654
公投第１２案,屏東縣,潮州鎮,三共里,164,1439,405,338,743,40,783
公投第１２案,屏東縣,潮州鎮,三和里,165,897,294,182,476,51,527
公投第１２案,屏東縣,潮州鎮,三和里,166,1225,430,252,682,25,707
公投第１２案,屏東縣,潮州鎮,九塊里,167,1158,323,230,553,34,587
公投第１２案,屏東縣,潮州鎮,九塊里,168,481,110,87,197,23,220
公投第１２案,屏東縣,潮州鎮,新生里,169,972,316,196,512,37,549
公投第１２案,屏東縣,潮州鎮,新榮里,170,1245,428,274,702,36,738
公投第１２案,屏東縣,潮州鎮,五魁里,171,1415,455,256,711,44,755
公投第１２案,屏東縣,潮州鎮,蓬萊里,172,1255,373,214,587,17,604
公投第１２案,屏東縣,潮州鎮,蓬萊里,173,1058,270,160,430,21,451
公投第１２案,屏東縣,潮州鎮,八爺里,174,1187,303,283,586,28,614
公投第１２案,屏東縣,潮州鎮,八爺里,175,1083,381,195,576,36,612
公投第１２案,屏東縣,潮州鎮,永春里,176,1590,471,277,748,33,781
公投第１２案,屏東縣,潮州鎮,永春里,177,1543,494,320,814,37,851
公投第１２案,屏東縣,潮州鎮,永春里,178,1631,480,299,779,34,813
公投第１２案,屏東縣,潮州鎮,永春里,179,1159,378,237,615,19,634
公投第１２案,屏東縣,潮州鎮,永春里,180,1099,365,239,604,17,621
公投第１２案,屏東縣,潮州鎮,富春里,181,1200,347,212,559,41,600
公投第１２案,屏東縣,潮州鎮,光春里,182,1391,415,243,658,46,704
公投第１２案,屏東縣,潮州鎮,興美里,183,881,295,173,468,48,516
公投第１２案,屏東縣,潮州鎮,檨子里,184,454,146,69,215,17,232
公投第１２案,屏東縣,潮州鎮,泗林里,185,1658,550,317,867,43,910
公投第１２案,屏東縣,潮州鎮,四春里,186,822,257,152,409,17,426
公投第１２案,屏東縣,潮州鎮,四春里,187,948,251,162,413,22,435
公投第１２案,屏東縣,潮州鎮,崙東里,188,1194,278,186,464,39,503
公投第１２案,屏東縣,潮州鎮,崙東里,189,337,110,62,172,19,191
公投第１２案,屏東縣,東港鎮,新勝里,190,981,369,190,559,34,593
公投第１２案,屏東縣,東港鎮,新勝里,191,1070,401,204,605,38,643
公投第１２案,屏東縣,東港鎮,頂新里,192,527,215,105,320,27,347
公投第１２案,屏東縣,東港鎮,頂中里,193,395,137,89,226,20,246
公投第１２案,屏東縣,東港鎮,東和里,194,659,189,129,318,20,338
公投第１２案,屏東縣,東港鎮,興台里,195,513,159,105,264,23,287
公投第１２案,屏東縣,東港鎮,興東里,196,1732,326,526,852,44,896
公投第１２案,屏東縣,東港鎮,興東里,197,1779,531,384,915,40,955
公投第１２案,屏東縣,東港鎮,興東里,198,1270,382,227,609,33,642
公投第１２案,屏東縣,東港鎮,興東里,199,1327,400,270,670,32,702
公投第１２案,屏東縣,東港鎮,興東里,200,1242,405,256,661,37,698
公投第１２案,屏東縣,東港鎮,興東里,201,1607,521,307,828,60,888
公投第１２案,屏東縣,東港鎮,興農里,202,1305,380,242,622,28,650
公投第１２案,屏東縣,東港鎮,中興里,203,695,210,161,371,20,391
公投第１２案,屏東縣,東港鎮,朝安里,204,1076,366,234,600,60,660
公投第１２案,屏東縣,東港鎮,朝安里,205,567,171,102,273,19,292
公投第１２案,屏東縣,東港鎮,八德里,206,806,252,158,410,27,437
公投第１２案,屏東縣,東港鎮,東隆里,207,1227,420,226,646,41,687
公投第１２案,屏東縣,東港鎮,豐漁里,208,599,171,105,276,51,327
公投第１２案,屏東縣,東港鎮,盛漁里,209,1354,344,196,540,40,580
公投第１２案,屏東縣,東港鎮,興漁里,210,734,210,141,351,39,390
公投第１２案,屏東縣,東港鎮,興漁里,211,1107,325,232,557,78,635
公投第１２案,屏東縣,東港鎮,鎮海里,212,1198,350,189,539,56,595
公投第１２案,屏東縣,東港鎮,鎮海里,213,1614,444,300,744,76,820
公投第１２案,屏東縣,東港鎮,嘉蓮里,214,826,221,176,397,29,426
公投第１２案,屏東縣,東港鎮,嘉蓮里,215,912,290,193,483,37,520
公投第１２案,屏東縣,東港鎮,南平里,216,432,132,64,196,28,224
公投第１２案,屏東縣,東港鎮,南平里,217,1204,377,228,605,69,674
公投第１２案,屏東縣,東港鎮,船頭里,218,1304,416,259,675,51,726
公投第１２案,屏東縣,東港鎮,船頭里,219,1317,402,302,704,46,750
公投第１２案,屏東縣,東港鎮,船頭里,220,1387,433,248,681,28,709
公投第１２案,屏東縣,東港鎮,船頭里,221,1310,340,235,575,37,612
公投第１２案,屏東縣,東港鎮,下廍里,222,1228,343,234,577,41,618
公投第１２案,屏東縣,東港鎮,下廍里,223,766,181,156,337,36,373
公投第１２案,屏東縣,東港鎮,大潭里,224,823,239,208,447,45,492
公投第１２案,屏東縣,東港鎮,大潭里,225,755,181,122,303,15,318
公投第１２案,屏東縣,東港鎮,興和里,226,1094,309,248,557,71,628
公投第１２案,屏東縣,東港鎮,共和里,227,753,223,126,349,26,375
公投第１２案,屏東縣,恆春鎮,城南里,228,902,253,177,430,20,450
公投第１２案,屏東縣,恆春鎮,城北里,229,969,289,233,522,32,554
公投第１２案,屏東縣,恆春鎮,城北里,230,1280,325,272,597,36,633
公投第１２案,屏東縣,恆春鎮,城西里,231,1133,331,246,577,36,613
公投第１２案,屏東縣,恆春鎮,網紗里,232,1552,362,282,644,14,658
公投第１２案,屏東縣,恆春鎮,網紗里,233,1485,321,256,577,45,622
公投第１２案,屏東縣,恆春鎮,仁壽里,234,896,234,215,449,32,481
公投第１２案,屏東縣,恆春鎮,茄湖里,235,531,112,117,229,21,250
公投第１２案,屏東縣,恆春鎮,頭溝里,236,478,124,94,218,8,226
公投第１２案,屏東縣,恆春鎮,四溝里,237,1020,261,183,444,45,489
公投第１２案,屏東縣,恆春鎮,德和里,238,924,203,228,431,20,451
公投第１２案,屏東縣,恆春鎮,龍水里,239,1079,231,217,448,22,470
公投第１２案,屏東縣,恆春鎮,山海里,240,775,190,117,307,22,329
公投第１２案,屏東縣,恆春鎮,山海里,241,813,233,170,403,40,443
公投第１２案,屏東縣,恆春鎮,大光里,242,1104,308,185,493,36,529
公投第１２案,屏東縣,恆春鎮,大光里,243,1110,250,208,458,42,500
公投第１２案,屏東縣,恆春鎮,水泉里,244,692,136,121,257,40,297
公投第１２案,屏東縣,恆春鎮,水泉里,245,708,128,111,239,12,251
公投第１２案,屏東縣,恆春鎮,山腳里,246,1505,414,281,695,32,727
公投第１２案,屏東縣,恆春鎮,山腳里,247,1111,290,204,494,26,520
公投第１２案,屏東縣,恆春鎮,山腳里,248,1543,397,264,661,49,710
公投第１２案,屏東縣,恆春鎮,南灣里,249,828,191,134,325,18,343
公投第１２案,屏東縣,恆春鎮,南灣里,250,844,227,178,405,40,445
公投第１２案,屏東縣,恆春鎮,墾丁里,251,1253,329,231,560,49,609
公投第１２案,屏東縣,恆春鎮,鵝鑾里,252,1126,280,194,474,39,513
公投第１２案,屏東縣,萬丹鄉,香社村,253,1527,415,238,653,31,684
公投第１２案,屏東縣,萬丹鄉,新庄村,254,1147,325,199,524,47,571
公投第１２案,屏東縣,萬丹鄉,新庄村,255,949,278,177,455,31,486
公投第１２案,屏東縣,萬丹鄉,新鐘村,256,990,293,163,456,27,483
公投第１２案,屏東縣,萬丹鄉,新鐘村,257,1022,320,166,486,18,504
公投第１２案,屏東縣,萬丹鄉,水仙村,258,545,218,121,339,32,371
公投第１２案,屏東縣,萬丹鄉,興全村,259,1159,432,219,651,37,688
公投第１２案,屏東縣,萬丹鄉,興安村,260,837,276,182,458,47,505
公投第１２案,屏東縣,萬丹鄉,甘棠村,261,392,125,53,178,15,193
公投第１２案,屏東縣,萬丹鄉,萬惠村,262,847,304,159,463,27,490
公投第１２案,屏東縣,萬丹鄉,萬全村,263,1149,335,226,561,34,595
公投第１２案,屏東縣,萬丹鄉,萬全村,264,1131,369,215,584,34,618
公投第１２案,屏東縣,萬丹鄉,萬全村,265,1178,352,219,571,39,610
公投第１２案,屏東縣,萬丹鄉,萬後村,266,711,229,180,409,19,428
公投第１２案,屏東縣,萬丹鄉,萬安村,267,595,224,140,364,17,381
公投第１２案,屏東縣,萬丹鄉,萬生村,268,1403,468,297,765,46,811
公投第１２案,屏東縣,萬丹鄉,寶厝村,269,1094,341,203,544,24,568
公投第１２案,屏東縣,萬丹鄉,寶厝村,270,1158,380,237,617,47,664
公投第１２案,屏東縣,萬丹鄉,四維村,271,963,342,213,555,48,603
公投第１２案,屏東縣,萬丹鄉,四維村,272,1062,350,210,560,35,595
公投第１２案,屏東縣,萬丹鄉,竹林村,273,1684,542,279,821,64,885
公投第１２案,屏東縣,萬丹鄉,水泉村,274,1702,491,321,812,33,845
公投第１２案,屏東縣,萬丹鄉,田厝村,275,976,332,211,543,32,575
公投第１２案,屏東縣,萬丹鄉,崙頂村,276,1013,306,197,503,56,559
公投第１２案,屏東縣,萬丹鄉,崙頂村,277,847,149,214,363,26,389
公投第１２案,屏東縣,萬丹鄉,厦北村,278,1570,510,310,820,92,912
公投第１２案,屏東縣,萬丹鄉,厦南村,279,1411,410,234,644,57,701
公投第１２案,屏東縣,萬丹鄉,後村村,280,1046,351,200,551,55,606
公投第１２案,屏東縣,萬丹鄉,灣內村,281,1385,384,292,676,33,709
公投第１２案,屏東縣,萬丹鄉,上村村,282,804,262,148,410,38,448
公投第１２案,屏東縣,萬丹鄉,加興村,283,1284,372,278,650,55,705
公投第１２案,屏東縣,萬丹鄉,社口村,284,1430,421,252,673,35,708
公投第１２案,屏東縣,萬丹鄉,磚寮村,285,960,333,227,560,42,602
公投第１２案,屏東縣,萬丹鄉,社皮村,286,786,272,171,443,40,483
公投第１２案,屏東縣,萬丹鄉,社皮村,287,1158,364,223,587,61,648
公投第１２案,屏東縣,萬丹鄉,社中村,288,1647,403,260,663,58,721
公投第１２案,屏東縣,萬丹鄉,社上村,289,1666,439,281,720,58,778
公投第１２案,屏東縣,萬丹鄉,廣安村,290,1023,356,221,577,51,628
公投第１２案,屏東縣,萬丹鄉,廣安村,291,1227,463,219,682,33,715
公投第１２案,屏東縣,長治鄉,進興村,292,1018,330,204,534,39,573
公投第１２案,屏東縣,長治鄉,進興村,293,1614,520,314,834,52,886
公投第１２案,屏東縣,長治鄉,新潭村,294,1848,604,404,1008,50,1058
公投第１２案,屏東縣,長治鄉,新潭村,295,1707,570,336,906,55,961
公投第１２案,屏東縣,長治鄉,潭頭村,296,972,334,194,528,24,552
公投第１２案,屏東縣,長治鄉,潭頭村,297,989,318,214,532,42,574
公投第１２案,屏東縣,長治鄉,香楊村,298,735,244,175,419,26,445
公投第１２案,屏東縣,長治鄉,香楊村,299,1813,474,369,843,54,897
公投第１２案,屏東縣,長治鄉,長興村,300,1073,359,255,614,37,651
公投第１２案,屏東縣,長治鄉,崙上村,301,1654,506,325,831,49,880
公投第１２案,屏東縣,長治鄉,德榮村,302,1205,366,181,547,39,586
公投第１２案,屏東縣,長治鄉,德和村,303,758,222,177,399,35,434
公投第１２案,屏東縣,長治鄉,復興村,304,1492,474,292,766,61,827
公投第１２案,屏東縣,長治鄉,德成村,305,884,300,181,481,34,515
公投第１２案,屏東縣,長治鄉,德協村,306,1090,365,224,589,37,626
公投第１２案,屏東縣,長治鄉,繁榮村,307,1422,354,263,617,80,697
公投第１２案,屏東縣,長治鄉,繁昌村,308,845,268,158,426,40,466
公投第１２案,屏東縣,長治鄉,繁昌村,309,925,296,170,466,70,536
公投第１２案,屏東縣,長治鄉,繁隆村,310,1138,374,237,611,22,633
公投第１２案,屏東縣,長治鄉,繁華村,311,1242,392,245,637,66,703
公投第１２案,屏東縣,長治鄉,繁華村,312,1159,337,199,536,16,552
公投第１２案,屏東縣,長治鄉,榮華村,313,673,229,142,371,30,401
公投第１２案,屏東縣,麟洛鄉,新田村,314,788,236,181,417,32,449
公投第１２案,屏東縣,麟洛鄉,新田村,315,1386,630,176,806,32,838
公投第１２案,屏東縣,麟洛鄉,麟頂村,316,957,321,232,553,34,587
公投第１２案,屏東縣,麟洛鄉,麟蹄村,317,731,241,179,420,32,452
公投第１２案,屏東縣,麟洛鄉,麟蹄村,318,806,285,189,474,30,504
公投第１２案,屏東縣,麟洛鄉,麟趾村,319,1207,358,250,608,17,625
公投第１２案,屏東縣,麟洛鄉,麟趾村,320,1340,435,314,749,68,817
公投第１２案,屏東縣,麟洛鄉,田中村,321,1221,529,182,711,40,751
公投第１２案,屏東縣,麟洛鄉,田心村,322,851,293,170,463,23,486
公投第１２案,屏東縣,麟洛鄉,田道村,323,683,216,128,344,13,357
公投第１２案,屏東縣,九如鄉,九清村,324,1491,462,319,781,55,836
公投第１２案,屏東縣,九如鄉,九塊村,325,1375,410,288,698,42,740
公投第１２案,屏東縣,九如鄉,九明村,326,1678,479,314,793,56,849
公投第１２案,屏東縣,九如鄉,大坵村,327,1166,364,253,617,68,685
公投第１２案,屏東縣,九如鄉,玉水村,328,1276,305,136,441,40,481
公投第１２案,屏東縣,九如鄉,玉泉村,329,1033,353,196,549,36,585
公投第１２案,屏東縣,九如鄉,玉泉村,330,577,223,130,353,44,397
公投第１２案,屏東縣,九如鄉,東寧村,331,649,234,122,356,43,399
公投第１２案,屏東縣,九如鄉,東寧村,332,1999,618,382,1000,96,1096
公投第１２案,屏東縣,九如鄉,東寧村,333,1766,521,334,855,65,920
公投第１２案,屏東縣,九如鄉,三塊村,334,1600,421,329,750,89,839
公投第１２案,屏東縣,九如鄉,耆老村,335,1248,390,245,635,50,685
公投第１２案,屏東縣,九如鄉,後庄村,336,1792,555,367,922,117,1039
公投第１２案,屏東縣,九如鄉,洽興村,337,1482,441,280,721,94,815
公投第１２案,屏東縣,里港鄉,玉田村,338,1552,533,312,845,70,915
公投第１２案,屏東縣,里港鄉,玉田村,339,1480,443,290,733,55,788
公投第１２案,屏東縣,里港鄉,塔樓村,340,1534,383,277,660,34,694
公投第１２案,屏東縣,里港鄉,潮厝村,341,1578,492,312,804,51,855
公投第１２案,屏東縣,里港鄉,大平村,342,1127,385,253,638,35,673
公投第１２案,屏東縣,里港鄉,永春村,343,845,270,191,461,38,499
公投第１２案,屏東縣,里港鄉,春林村,344,1282,376,254,630,47,677
公投第１２案,屏東縣,里港鄉,過江村,345,981,318,208,526,44,570
公投第１２案,屏東縣,里港鄉,過江村,346,1031,314,234,548,51,599
公投第１２案,屏東縣,里港鄉,鐵店村,347,1423,416,331,747,120,867
公投第１２案,屏東縣,里港鄉,茄苳村,348,363,113,54,167,13,180
公投第１２案,屏東縣,里港鄉,茄苳村,349,1203,363,257,620,85,705
公投第１２案,屏東縣,里港鄉,載興村,350,1027,331,251,582,57,639
公投第１２案,屏東縣,里港鄉,載興村,351,1384,391,295,686,46,732
公投第１２案,屏東縣,里港鄉,土庫村,352,1512,453,277,730,56,786
公投第１２案,屏東縣,里港鄉,土庫村,353,522,201,96,297,11,308
公投第１２案,屏東縣,里港鄉,三廍村,354,822,242,170,412,47,459
公投第１２案,屏東縣,里港鄉,三廍村,355,1007,261,206,467,62,529
公投第１２案,屏東縣,里港鄉,中和村,356,956,296,194,490,47,537
公投第１２案,屏東縣,里港鄉,瀰力村,357,499,159,107,266,16,282
公投第１２案,屏東縣,鹽埔鄉,鹽北村,358,951,326,151,477,29,506
公投第１２案,屏東縣,鹽埔鄉,鹽北村,359,899,252,174,426,24,450
公投第１２案,屏東縣,鹽埔鄉,鹽中村,360,1116,247,208,455,23,478
公投第１２案,屏東縣,鹽埔鄉,鹽中村,361,1241,354,241,595,35,630
公投第１２案,屏東縣,鹽埔鄉,鹽南村,362,770,206,160,366,41,407
公投第１２案,屏東縣,鹽埔鄉,鹽南村,363,962,312,164,476,34,510
公投第１２案,屏東縣,鹽埔鄉,仕絨村,364,1041,361,220,581,52,633
公投第１２案,屏東縣,鹽埔鄉,高朗村,365,1367,361,295,656,56,712
公投第１２案,屏東縣,鹽埔鄉,高朗村,366,1465,341,237,578,58,636
公投第１２案,屏東縣,鹽埔鄉,振興村,367,894,208,173,381,39,420
公投第１２案,屏東縣,鹽埔鄉,振興村,368,958,224,185,409,5,414
公投第１２案,屏東縣,鹽埔鄉,久愛村,369,924,272,163,435,60,495
公投第１２案,屏東縣,鹽埔鄉,新圍村,370,1598,431,296,727,40,767
公投第１２案,屏東縣,鹽埔鄉,新圍村,371,1550,470,276,746,86,832
公投第１２案,屏東縣,鹽埔鄉,新二村,372,1127,355,198,553,51,604
公投第１２案,屏東縣,鹽埔鄉,新二村,373,1150,362,252,614,58,672
公投第１２案,屏東縣,鹽埔鄉,新二村,374,1233,367,275,642,38,680
公投第１２案,屏東縣,鹽埔鄉,彭厝村,375,984,329,208,537,58,595
公投第１２案,屏東縣,鹽埔鄉,洛陽村,376,1619,494,335,829,62,891
公投第１２案,屏東縣,鹽埔鄉,永隆村,377,553,172,112,284,24,308
公投第１２案,屏東縣,高樹鄉,高樹村,378,883,306,183,489,66,555
公投第１２案,屏東縣,高樹鄉,高樹村,379,1255,360,104,464,30,494
公投第１２案,屏東縣,高樹鄉,長榮村,380,1278,400,243,643,31,674
公投第１２案,屏東縣,高樹鄉,東興村,381,738,197,126,323,25,348
公投第１２案,屏東縣,高樹鄉,東振村,382,585,147,119,266,12,278
公投第１２案,屏東縣,高樹鄉,源泉村,383,1012,313,202,515,80,595
公投第１２案,屏東縣,高樹鄉,建興村,384,1148,294,221,515,61,576
公投第１２案,屏東縣,高樹鄉,大埔村,385,591,144,123,267,37,304
公投第１２案,屏東縣,高樹鄉,菜寮村,386,786,204,113,317,52,369
公投第１２案,屏東縣,高樹鄉,司馬村,387,649,165,105,270,23,293
公投第１２案,屏東縣,高樹鄉,舊寮村,388,1229,289,176,465,57,522
公投第１２案,屏東縣,高樹鄉,新豐村,389,1446,324,230,554,60,614
公投第１２案,屏東縣,高樹鄉,泰山村,390,899,187,165,352,12,364
公投第１２案,屏東縣,高樹鄉,泰山村,391,922,241,186,427,47,474
公投第１２案,屏東縣,高樹鄉,南華村,392,1259,293,239,532,64,596
公投第１２案,屏東縣,高樹鄉,廣福村,393,1056,284,175,459,15,474
公投第１２案,屏東縣,高樹鄉,廣興村,394,1116,263,246,509,51,560
公投第１２案,屏東縣,高樹鄉,舊庄村,395,1020,294,219,513,64,577
公投第１２案,屏東縣,高樹鄉,田子村,396,1055,305,210,515,61,576
公投第１２案,屏東縣,高樹鄉,鹽樹村,397,738,234,177,411,35,446
公投第１２案,屏東縣,高樹鄉,鹽樹村,398,493,121,90,211,30,241
公投第１２案,屏東縣,高樹鄉,新南村,399,1539,439,337,776,90,866
公投第１２案,屏東縣,萬巒鄉,萬巒村,400,1239,269,326,595,33,628
公投第１２案,屏東縣,萬巒鄉,萬全村,401,759,256,146,402,37,439
公投第１２案,屏東縣,萬巒鄉,萬和村,402,932,324,169,493,65,558
公投第１２案,屏東縣,萬巒鄉,萬和村,403,769,264,157,421,46,467
公投第１２案,屏東縣,萬巒鄉,鹿寮村,404,920,267,181,448,54,502
公投第１２案,屏東縣,萬巒鄉,硫黃村,405,560,173,132,305,20,325
公投第１２案,屏東縣,萬巒鄉,泗溝村,406,1120,313,192,505,32,537
公投第１２案,屏東縣,萬巒鄉,五溝村,407,1048,174,332,506,25,531
公投第１２案,屏東縣,萬巒鄉,成德村,408,1438,368,243,611,48,659
公投第１２案,屏東縣,萬巒鄉,赤山村,409,834,216,162,378,37,415
公投第１２案,屏東縣,萬巒鄉,赤山村,410,813,228,167,395,37,432
公投第１２案,屏東縣,萬巒鄉,萬金村,411,1020,276,241,517,25,542
公投第１２案,屏東縣,萬巒鄉,萬金村,412,1007,343,237,580,40,620
公投第１２案,屏東縣,萬巒鄉,佳佐村,413,1648,407,263,670,59,729
公投第１２案,屏東縣,萬巒鄉,佳和村,414,1437,455,257,712,33,745
公投第１２案,屏東縣,萬巒鄉,新厝村,415,1228,349,190,539,21,560
公投第１２案,屏東縣,萬巒鄉,新置村,416,597,210,122,332,28,360
公投第１２案,屏東縣,萬巒鄉,新置村,417,576,182,123,305,25,330
公投第１２案,屏東縣,內埔鄉,內埔村,418,1305,333,241,574,32,606
公投第１２案,屏東縣,內埔鄉,內埔村,419,1287,375,218,593,32,625
公投第１２案,屏東縣,內埔鄉,內埔村,420,1387,392,237,629,17,646
公投第１２案,屏東縣,內埔鄉,內田村,421,1540,410,281,691,37,728
公投第１２案,屏東縣,內埔鄉,內田村,422,1605,468,282,750,38,788
公投第１２案,屏東縣,內埔鄉,興南村,423,1326,463,253,716,54,770
公投第１２案,屏東縣,內埔鄉,義亭村,424,591,168,129,297,37,334
公投第１２案,屏東縣,內埔鄉,美和村,425,1123,289,205,494,41,535
公投第１２案,屏東縣,內埔鄉,美和村,426,1079,328,187,515,19,534
公投第１２案,屏東縣,內埔鄉,和興村,427,1485,447,288,735,36,771
公投第１２案,屏東縣,內埔鄉,和興村,428,1248,431,256,687,28,715
公投第１２案,屏東縣,內埔鄉,東寧村,429,1569,452,309,761,47,808
公投第１２案,屏東縣,內埔鄉,東寧村,430,1493,387,282,669,44,713
公投第１２案,屏東縣,內埔鄉,東寧村,431,1420,385,267,652,19,671
公投第１２案,屏東縣,內埔鄉,豐田村,432,1334,386,262,648,47,695
公投第１２案,屏東縣,內埔鄉,豐田村,433,1519,418,278,696,46,742
公投第１２案,屏東縣,內埔鄉,振豐村,434,784,224,115,339,44,383
公投第１２案,屏東縣,內埔鄉,振豐村,435,888,269,195,464,44,508
公投第１２案,屏東縣,內埔鄉,富田村,436,747,225,117,342,11,353
公投第１２案,屏東縣,內埔鄉,富田村,437,1168,311,184,495,26,521
公投第１２案,屏東縣,內埔鄉,竹圍村,438,546,154,131,285,27,312
公投第１２案,屏東縣,內埔鄉,竹圍村,439,1278,367,224,591,48,639
公投第１２案,屏東縣,內埔鄉,東勢村,440,1348,366,201,567,50,617
公投第１２案,屏東縣,內埔鄉,東勢村,441,1550,356,240,596,60,656
公投第１２案,屏東縣,內埔鄉,東片村,442,947,347,177,524,52,576
公投第１２案,屏東縣,內埔鄉,上樹村,443,1097,182,331,513,49,562
公投第１２案,屏東縣,內埔鄉,老埤村,444,1128,238,193,431,50,481
公投第１２案,屏東縣,內埔鄉,老埤村,445,1253,265,169,434,31,465
公投第１２案,屏東縣,內埔鄉,中林村,446,1525,436,224,660,19,679
公投第１２案,屏東縣,內埔鄉,龍泉村,447,1215,344,248,592,53,645
公投第１２案,屏東縣,內埔鄉,龍泉村,448,1216,327,181,508,24,532
公投第１２案,屏東縣,內埔鄉,龍潭村,449,1353,371,227,598,20,618
公投第１２案,屏東縣,內埔鄉,龍潭村,450,1026,316,179,495,23,518
公投第１２案,屏東縣,內埔鄉,建興村,451,862,234,140,374,30,404
公投第１２案,屏東縣,內埔鄉,大新村,452,921,241,144,385,23,408
公投第１２案,屏東縣,內埔鄉,大新村,453,854,259,155,414,27,441
公投第１２案,屏東縣,內埔鄉,黎明村,454,1230,359,181,540,31,571
公投第１２案,屏東縣,內埔鄉,黎明村,455,1204,370,185,555,21,576
公投第１２案,屏東縣,內埔鄉,隘寮村,456,1301,356,212,568,33,601
公投第１２案,屏東縣,內埔鄉,水門村,457,806,243,178,421,32,453
公投第１２案,屏東縣,竹田鄉,竹田村,458,1503,501,290,791,54,845
公投第１２案,屏東縣,竹田鄉,竹南村,459,899,344,178,522,32,554
公投第１２案,屏東縣,竹田鄉,糶糴村,460,716,260,153,413,37,450
公投第１２案,屏東縣,竹田鄉,履豐村,461,581,212,146,358,25,383
公投第１２案,屏東縣,竹田鄉,頭崙村,462,1327,407,261,668,75,743
公投第１２案,屏東縣,竹田鄉,二崙村,463,997,337,215,552,67,619
公投第１２案,屏東縣,竹田鄉,美崙村,464,649,184,142,326,34,360
公投第１２案,屏東縣,竹田鄉,南勢村,465,476,209,120,329,18,347
公投第１２案,屏東縣,竹田鄉,西勢村,466,1259,419,268,687,52,739
公投第１２案,屏東縣,竹田鄉,西勢村,467,1227,373,225,598,46,644
公投第１２案,屏東縣,竹田鄉,福田村,468,504,174,126,300,22,322
公投第１２案,屏東縣,竹田鄉,永豐村,469,860,263,162,425,42,467
公投第１２案,屏東縣,竹田鄉,六巷村,470,800,238,176,414,22,436
公投第１２案,屏東縣,竹田鄉,泗洲村,471,1134,373,233,606,54,660
公投第１２案,屏東縣,竹田鄉,大湖村,472,1229,374,237,611,44,655
公投第１２案,屏東縣,竹田鄉,鳳明村,473,1192,353,225,578,54,632
公投第１２案,屏東縣,新埤鄉,新埤村,474,1712,504,311,815,37,852
公投第１２案,屏東縣,新埤鄉,新埤村,475,314,95,56,151,26,177
公投第１２案,屏東縣,新埤鄉,建功村,476,752,202,178,380,27,407
公投第１２案,屏東縣,新埤鄉,建功村,477,334,106,59,165,17,182
公投第１２案,屏東縣,新埤鄉,打鐵村,478,957,325,183,508,37,545
公投第１２案,屏東縣,新埤鄉,南豐村,479,764,239,157,396,55,451
公投第１２案,屏東縣,新埤鄉,萬隆村,480,373,113,73,186,26,212
公投第１２案,屏東縣,新埤鄉,萬隆村,481,678,170,118,288,28,316
公投第１２案,屏東縣,新埤鄉,萬隆村,482,701,181,125,306,21,327
公投第１２案,屏東縣,新埤鄉,餉潭村,483,1323,291,210,501,44,545
公投第１２案,屏東縣,新埤鄉,箕湖村,484,541,180,103,283,29,312
公投第１２案,屏東縣,新埤鄉,箕湖村,485,584,153,87,240,30,270
公投第１２案,屏東縣,枋寮鄉,枋寮村,486,1213,387,252,639,45,684
公投第１２案,屏東縣,枋寮鄉,新龍村,487,891,299,177,476,46,522
公投第１２案,屏東縣,枋寮鄉,保生村,488,970,289,159,448,47,495
公投第１２案,屏東縣,枋寮鄉,中寮村,489,629,189,129,318,23,341
公投第１２案,屏東縣,枋寮鄉,安樂村,490,840,277,190,467,32,499
公投第１２案,屏東縣,枋寮鄉,安樂村,491,774,266,157,423,31,454
公投第１２案,屏東縣,枋寮鄉,隆山村,492,1379,366,302,668,51,719
公投第１２案,屏東縣,枋寮鄉,隆山村,493,1502,486,302,788,50,838
公投第１２案,屏東縣,枋寮鄉,隆山村,494,1276,363,248,611,56,667
公投第１２案,屏東縣,枋寮鄉,天時村,495,964,300,164,464,57,521
公投第１２案,屏東縣,枋寮鄉,天時村,496,1005,322,212,534,80,614
公投第１２案,屏東縣,枋寮鄉,地利村,497,734,219,143,362,26,388
公投第１２案,屏東縣,枋寮鄉,地利村,498,725,253,123,376,42,418
公投第１２案,屏東縣,枋寮鄉,人和村,499,1046,283,211,494,57,551
公投第１２案,屏東縣,枋寮鄉,人和村,500,1067,342,215,557,56,613
公投第１２案,屏東縣,枋寮鄉,內寮村,501,718,153,93,246,41,287
公投第１２案,屏東縣,枋寮鄉,新開村,502,903,230,159,389,41,430
公投第１２案,屏東縣,枋寮鄉,東海村,503,1387,420,226,646,58,704
公投第１２案,屏東縣,枋寮鄉,東海村,504,1367,465,229,694,61,755
公投第１２案,屏東縣,枋寮鄉,大庄村,505,618,227,135,362,30,392
公投第１２案,屏東縣,枋寮鄉,太源村,506,959,211,159,370,21,391
公投第１２案,屏東縣,枋寮鄉,玉泉村,507,427,122,85,207,31,238
公投第１２案,屏東縣,新園鄉,瓦磘村,508,820,248,190,438,34,472
公投第１２案,屏東縣,新園鄉,瓦磘村,509,843,301,164,465,47,512
公投第１２案,屏東縣,新園鄉,仙吉村,510,1242,346,252,598,45,643
公投第１２案,屏東縣,新園鄉,仙吉村,511,1290,420,276,696,46,742
公投第１２案,屏東縣,新園鄉,田洋村,512,1073,333,202,535,36,571
公投第１２案,屏東縣,新園鄉,田洋村,513,1088,279,238,517,78,595
公投第１２案,屏東縣,新園鄉,港墘村,514,845,247,146,393,27,420
公投第１２案,屏東縣,新園鄉,內庄村,515,862,262,180,442,31,473
公投第１２案,屏東縣,新園鄉,新東村,516,1183,311,222,533,56,589
公投第１２案,屏東縣,新園鄉,新東村,517,1109,341,211,552,59,611
公投第１２案,屏東縣,新園鄉,新園村,518,1119,285,222,507,20,527
公投第１２案,屏東縣,新園鄉,新園村,519,1152,335,201,536,35,571
公投第１２案,屏東縣,新園鄉,港西村,520,1030,344,183,527,47,574
公投第１２案,屏東縣,新園鄉,港西村,521,1104,302,220,522,66,588
公投第１２案,屏東縣,新園鄉,烏龍村,522,1240,343,226,569,31,600
公投第１２案,屏東縣,新園鄉,興龍村,523,1120,253,197,450,21,471
公投第１２案,屏東縣,新園鄉,興龍村,524,1074,315,245,560,64,624
公投第１２案,屏東縣,新園鄉,中洲村,525,849,227,145,372,29,401
公投第１２案,屏東縣,新園鄉,中洲村,526,749,185,166,351,59,410
公投第１２案,屏東縣,新園鄉,南龍村,527,1416,391,270,661,62,723
公投第１２案,屏東縣,新園鄉,五房村,528,895,278,170,448,45,493
公投第１２案,屏東縣,新園鄉,五房村,529,933,312,158,470,50,520
公投第１２案,屏東縣,新園鄉,五房村,530,972,321,170,491,31,522
公投第１２案,屏東縣,新園鄉,鹽埔村,531,1454,442,200,642,40,682
公投第１２案,屏東縣,新園鄉,鹽埔村,532,1653,573,328,901,64,965
公投第１２案,屏東縣,新園鄉,鹽埔村,533,1270,394,213,607,36,643
公投第１２案,屏東縣,新園鄉,共和村,534,1123,377,229,606,78,684
公投第１２案,屏東縣,新園鄉,共和村,535,1198,382,203,585,40,625
公投第１２案,屏東縣,崁頂鄉,崁頂村,536,1190,343,212,555,35,590
公投第１２案,屏東縣,崁頂鄉,崁頂村,537,1044,351,206,557,42,599
公投第１２案,屏東縣,崁頂鄉,園寮村,538,818,244,165,409,47,456
公投第１２案,屏東縣,崁頂鄉,園寮村,539,1214,368,221,589,41,630
公投第１２案,屏東縣,崁頂鄉,力社村,540,1325,402,223,625,25,650
公投第１２案,屏東縣,崁頂鄉,圍內村,541,1253,419,244,663,56,719
公投第１２案,屏東縣,崁頂鄉,洲子村,542,1039,324,167,491,37,528
公投第１２案,屏東縣,崁頂鄉,北勢村,543,813,199,155,354,42,396
公投第１２案,屏東縣,崁頂鄉,北勢村,544,736,224,133,357,15,372
公投第１２案,屏東縣,崁頂鄉,越溪村,545,934,266,225,491,39,530
公投第１２案,屏東縣,崁頂鄉,港東村,546,900,228,183,411,63,474
公投第１２案,屏東縣,崁頂鄉,港東村,547,1004,294,200,494,47,541
公投第１２案,屏東縣,林邊鄉,林邊村,548,1458,524,277,801,68,869
公投第１２案,屏東縣,林邊鄉,光林村,549,891,338,169,507,25,532
公投第１２案,屏東縣,林邊鄉,光林村,550,695,265,130,395,27,422
公投第１２案,屏東縣,林邊鄉,永樂村,551,1015,364,213,577,32,609
公投第１２案,屏東縣,林邊鄉,永樂村,552,1171,402,232,634,47,681
公投第１２案,屏東縣,林邊鄉,永樂村,553,1003,317,182,499,43,542
公投第１２案,屏東縣,林邊鄉,中林村,554,725,274,160,434,28,462
公投第１２案,屏東縣,林邊鄉,仁和村,555,841,299,168,467,37,504
公投第１２案,屏東縣,林邊鄉,仁和村,556,793,276,164,440,34,474
公投第１２案,屏東縣,林邊鄉,田厝村,557,919,317,197,514,33,547
公投第１２案,屏東縣,林邊鄉,崎峯村,558,1283,366,250,616,53,669
公投第１２案,屏東縣,林邊鄉,水利村,559,783,206,147,353,39,392
公投第１２案,屏東縣,林邊鄉,水利村,560,1033,298,181,479,43,522
公投第１２案,屏東縣,林邊鄉,竹林村,561,1186,343,218,561,80,641
公投第１２案,屏東縣,林邊鄉,竹林村,562,773,218,156,374,49,423
公投第１２案,屏東縣,林邊鄉,鎮安村,563,1122,342,165,507,29,536
公投第１２案,屏東縣,南州鄉,溪洲村,564,872,283,142,425,51,476
公投第１２案,屏東縣,南州鄉,溪洲村,565,794,249,159,408,30,438
公投第１２案,屏東縣,南州鄉,溪南村,566,962,305,214,519,43,562
公投第１２案,屏東縣,南州鄉,七塊村,567,1033,316,223,539,41,580
公投第１２案,屏東縣,南州鄉,萬華村,568,1007,215,260,475,46,521
公投第１２案,屏東縣,南州鄉,仁里村,569,466,157,103,260,18,278
公投第１２案,屏東縣,南州鄉,溪北村,570,708,236,156,392,25,417
公投第１２案,屏東縣,南州鄉,米崙村,571,1044,305,229,534,57,591
公投第１２案,屏東縣,南州鄉,壽元村,572,1071,272,170,442,39,481
公投第１２案,屏東縣,南州鄉,同安村,573,979,283,194,477,29,506
公投第１２案,屏東縣,南州鄉,南安村,574,543,158,87,245,29,274
公投第１２案,屏東縣,佳冬鄉,佳冬村,575,1472,376,270,646,41,687
公投第１２案,屏東縣,佳冬鄉,六根村,576,1360,363,208,571,43,614
公投第１２案,屏東縣,佳冬鄉,賴家村,577,804,280,129,409,60,469
公投第１２案,屏東縣,佳冬鄉,萬建村,578,925,245,174,419,67,486
公投第１２案,屏東縣,佳冬鄉,萬建村,579,855,230,146,376,18,394
公投第１２案,屏東縣,佳冬鄉,石光村,580,981,272,178,450,39,489
公投第１２案,屏東縣,佳冬鄉,石光村,581,1007,267,182,449,53,502
公投第１２案,屏東縣,佳冬鄉,玉光村,582,872,231,136,367,49,416
公投第１２案,屏東縣,佳冬鄉,玉光村,583,1255,306,222,528,50,578
公投第１２案,屏東縣,佳冬鄉,昌隆村,584,995,360,154,514,60,574
公投第１２案,屏東縣,佳冬鄉,豐隆村,585,734,175,123,298,26,324
公投第１２案,屏東縣,佳冬鄉,大同村,586,1178,293,211,504,30,534
公投第１２案,屏東縣,佳冬鄉,羌園村,587,1095,282,195,477,52,529
公投第１２案,屏東縣,佳冬鄉,燄溫村,588,1097,386,200,586,68,654
公投第１２案,屏東縣,佳冬鄉,塭豐村,589,1273,415,197,612,51,663
公投第１２案,屏東縣,佳冬鄉,塭豐村,590,1160,396,228,624,32,656
公投第１２案,屏東縣,琉球鄉,本福村,591,1111,275,177,452,19,471
公投第１２案,屏東縣,琉球鄉,本福村,592,972,244,158,402,36,438
公投第１２案,屏東縣,琉球鄉,中福村,593,1278,408,214,622,39,661
公投第１２案,屏東縣,琉球鄉,漁福村,594,976,297,158,455,40,495
公投第１２案,屏東縣,琉球鄉,大福村,595,1658,452,275,727,60,787
公投第１２案,屏東縣,琉球鄉,南福村,596,1146,280,112,392,29,421
公投第１２案,屏東縣,琉球鄉,天福村,597,1079,224,161,385,35,420
公投第１２案,屏東縣,琉球鄉,上福村,598,1613,381,211,592,25,617
公投第１２案,屏東縣,琉球鄉,杉福村,599,873,251,145,396,48,444
公投第１２案,屏東縣,車城鄉,海口村,600,737,149,129,278,32,310
公投第１２案,屏東縣,車城鄉,田中村,601,647,119,96,215,26,241
公投第１２案,屏東縣,車城鄉,福興村,602,491,124,88,212,21,233
公投第１２案,屏東縣,車城鄉,福興村,603,856,211,178,389,22,411
公投第１２案,屏東縣,車城鄉,福安村,604,554,166,87,253,8,261
公投第１２案,屏東縣,車城鄉,統埔村,605,388,80,57,137,7,144
公投第１２案,屏東縣,車城鄉,溫泉村,606,922,174,159,333,40,373
公投第１２案,屏東縣,車城鄉,保力村,607,597,120,81,201,8,209
公投第１２案,屏東縣,車城鄉,保力村,608,623,115,92,207,15,222
公投第１２案,屏東縣,車城鄉,新街村,609,425,100,82,182,19,201
公投第１２案,屏東縣,車城鄉,埔墘村,610,428,132,76,208,9,217
公投第１２案,屏東縣,車城鄉,射寮村,611,504,103,67,170,10,180
公投第１２案,屏東縣,車城鄉,後灣村,612,423,105,77,182,25,207
公投第１２案,屏東縣,滿州鄉,滿州村,613,1575,364,342,706,1,707
公投第１２案,屏東縣,滿州鄉,里德村,614,420,110,77,187,11,198
公投第１２案,屏東縣,滿州鄉,响林村,615,602,206,126,332,18,350
公投第１２案,屏東縣,滿州鄉,永靖村,616,1302,297,194,491,16,507
公投第１２案,屏東縣,滿州鄉,港口村,617,1314,336,228,564,19,583
公投第１２案,屏東縣,滿州鄉,長樂村,618,1308,202,167,369,25,394
公投第１２案,屏東縣,滿州鄉,九棚村,619,367,74,64,138,13,151
公投第１２案,屏東縣,滿州鄉,港仔村,620,318,85,70,155,11,166
公投第１２案,屏東縣,枋山鄉,枋山村,621,604,262,72,334,32,366
公投第１２案,屏東縣,枋山鄉,枋山村,622,428,152,92,244,21,265
公投第１２案,屏東縣,枋山鄉,加祿村,623,928,306,218,524,54,578
公投第１２案,屏東縣,枋山鄉,加祿村,624,972,275,208,483,19,502
公投第１２案,屏東縣,枋山鄉,楓港村,625,1041,262,176,438,41,479
公投第１２案,屏東縣,枋山鄉,善餘村,626,883,184,133,317,18,335
公投第１２案,屏東縣,三地門鄉,大社村,627,616,205,104,309,9,318
公投第１２案,屏東縣,三地門鄉,德文村,628,572,207,105,312,46,358
公投第１２案,屏東縣,三地門鄉,達來村,629,323,151,47,198,5,203
公投第１２案,屏東縣,三地門鄉,三地村,630,1448,557,313,870,34,904
公投第１２案,屏東縣,三地門鄉,賽嘉村,631,726,271,116,387,6,393
公投第１２案,屏東縣,三地門鄉,口社村,632,554,176,116,292,13,305
公投第１２案,屏東縣,三地門鄉,馬兒村,633,346,136,93,229,9,238
公投第１２案,屏東縣,三地門鄉,安坡村,634,458,247,83,330,7,337
公投第１２案,屏東縣,三地門鄉,青山村,635,692,323,128,451,19,470
公投第１２案,屏東縣,三地門鄉,青葉村,636,638,246,169,415,49,464
公投第１２案,屏東縣,霧臺鄉,霧台村,637,346,171,89,260,11,271
公投第１２案,屏東縣,霧臺鄉,霧台村,638,677,355,141,496,23,519
公投第１２案,屏東縣,霧臺鄉,霧台村,639,162,70,24,94,2,96
公投第１２案,屏東縣,霧臺鄉,吉露村,640,189,84,26,110,8,118
公投第１２案,屏東縣,霧臺鄉,阿禮村,641,296,180,50,230,4,234
公投第１２案,屏東縣,霧臺鄉,好茶村,642,483,295,102,397,10,407
公投第１２案,屏東縣,霧臺鄉,佳暮村,643,347,144,87,231,6,237
公投第１２案,屏東縣,霧臺鄉,大武村,644,450,274,90,364,16,380
公投第１２案,屏東縣,瑪家鄉,瑪家村,645,455,143,101,244,4,248
公投第１２案,屏東縣,瑪家鄉,北葉村,646,821,341,189,530,19,549
公投第１２案,屏東縣,瑪家鄉,三和村,647,635,267,166,433,34,467
公投第１２案,屏東縣,瑪家鄉,三和村,648,695,374,124,498,28,526
公投第１２案,屏東縣,瑪家鄉,三和村,649,671,351,132,483,21,504
公投第１２案,屏東縣,瑪家鄉,凉山村,650,1057,441,192,633,24,657
公投第１２案,屏東縣,瑪家鄉,佳義村,651,900,326,198,524,20,544
公投第１２案,屏東縣,瑪家鄉,排灣村,652,429,187,83,270,9,279
公投第１２案,屏東縣,泰武鄉,佳平村,653,669,270,137,407,8,415
公投第１２案,屏東縣,泰武鄉,佳平村,654,190,82,35,117,7,124
公投第１２案,屏東縣,泰武鄉,武潭村,655,922,321,248,569,38,607
公投第１２案,屏東縣,泰武鄉,平和村,656,598,272,175,447,14,461
公投第１２案,屏東縣,泰武鄉,萬安村,657,771,334,136,470,33,503
公投第１２案,屏東縣,泰武鄉,佳興村,658,414,207,79,286,17,303
公投第１２案,屏東縣,泰武鄉,泰武村,659,780,277,182,459,23,482
公投第１２案,屏東縣,來義鄉,來義村,660,917,413,150,563,61,624
公投第１２案,屏東縣,來義鄉,義林村,661,361,144,87,231,3,234
公投第１２案,屏東縣,來義鄉,義林村,662,216,101,31,132,3,135
公投第１２案,屏東縣,來義鄉,丹林村,663,445,251,71,322,15,337
公投第１２案,屏東縣,來義鄉,丹林村,664,280,121,53,174,8,182
公投第１２案,屏東縣,來義鄉,古樓村,665,1097,437,175,612,36,648
公投第１２案,屏東縣,來義鄉,文樂村,666,840,353,191,544,21,565
公投第１２案,屏東縣,來義鄉,望嘉村,667,889,286,160,446,10,456
公投第１２案,屏東縣,來義鄉,南和村,668,1212,317,213,530,35,565
公投第１２案,屏東縣,春日鄉,春日村,669,909,270,120,390,8,398
公投第１２案,屏東縣,春日鄉,古華村,670,663,243,115,358,11,369
公投第１２案,屏東縣,春日鄉,士文村,671,304,90,29,119,1,120
公投第１２案,屏東縣,春日鄉,七佳村,672,928,271,182,453,15,468
公投第１２案,屏東縣,春日鄉,歸崇村,673,641,144,79,223,8,231
公投第１２案,屏東縣,春日鄉,力里村,674,478,77,80,157,5,162
公投第１２案,屏東縣,獅子鄉,楓林村,675,751,307,104,411,12,423
公投第１２案,屏東縣,獅子鄉,丹路村,676,776,301,134,435,26,461
公投第１２案,屏東縣,獅子鄉,草埔村,677,711,377,110,487,14,501
公投第１２案,屏東縣,獅子鄉,內文村,678,243,102,75,177,12,189
公投第１２案,屏東縣,獅子鄉,竹坑村,679,325,155,67,222,9,231
公投第１２案,屏東縣,獅子鄉,獅子村,680,476,151,107,258,7,265
公投第１２案,屏東縣,獅子鄉,內獅村,681,602,319,81,400,14,414
公投第１２案,屏東縣,獅子鄉,南世村,682,346,102,70,172,3,175
公投第１２案,屏東縣,牡丹鄉,石門村,683,342,79,62,141,2,143
公投第１２案,屏東縣,牡丹鄉,石門村,684,1306,356,272,628,34,662
公投第１２案,屏東縣,牡丹鄉,牡丹村,685,693,120,80,200,2,202
公投第１２案,屏東縣,牡丹鄉,東源村,686,437,139,57,196,9,205
公投第１２案,屏東縣,牡丹鄉,旭海村,687,392,108,82,190,6,196
公投第１２案,屏東縣,牡丹鄉,高士村,688,593,164,136,300,8,308
公投第１２案,屏東縣,牡丹鄉,四林村,689,551,76,55,131,5,136
公投第１２案,臺東縣,臺東市,文化里,1,874,267,147,414,22,436
公投第１２案,臺東縣,臺東市,民族里,2,1469,557,307,864,47,911
公投第１２案,臺東縣,臺東市,自強里,3,1259,429,249,678,28,706
公投第１２案,臺東縣,臺東市,自強里,4,1399,440,262,702,31,733
公投第１２案,臺東縣,臺東市,自強里,5,1363,518,293,811,31,842
公投第１２案,臺東縣,臺東市,民生里,6,1651,550,319,869,34,903
公投第１２案,臺東縣,臺東市,民生里,7,1490,536,354,890,39,929
公投第１２案,臺東縣,臺東市,寶桑里,8,859,265,170,435,26,461
公投第１２案,臺東縣,臺東市,民權里,9,890,304,210,514,28,542
公投第１２案,臺東縣,臺東市,四維里,10,651,233,121,354,23,377
公投第１２案,臺東縣,臺東市,中華里,11,1650,452,315,767,43,810
公投第１２案,臺東縣,臺東市,仁愛里,12,724,249,180,429,22,451
公投第１２案,臺東縣,臺東市,強國里,13,632,207,149,356,26,382
公投第１２案,臺東縣,臺東市,大同里,14,771,274,158,432,33,465
公投第１２案,臺東縣,臺東市,成功里,15,798,264,150,414,15,429
公投第１２案,臺東縣,臺東市,建國里,16,1299,408,263,671,49,720
公投第１２案,臺東縣,臺東市,中正里,17,811,289,173,462,26,488
公投第１２案,臺東縣,臺東市,中山里,18,764,298,169,467,26,493
公投第１２案,臺東縣,臺東市,興國里,19,784,244,167,411,13,424
公投第１２案,臺東縣,臺東市,鐵花里,20,427,127,89,216,7,223
公投第１２案,臺東縣,臺東市,東海里,21,1292,452,181,633,27,660
公投第１２案,臺東縣,臺東市,東海里,22,1501,516,344,860,16,876
公投第１２案,臺東縣,臺東市,復國里,23,601,174,120,294,18,312
公投第１２案,臺東縣,臺東市,復興里,24,417,116,98,214,6,220
公投第１２案,臺東縣,臺東市,新興里,25,1001,351,183,534,33,567
公投第１２案,臺東縣,臺東市,新生里,26,1638,591,327,918,36,954
公投第１２案,臺東縣,臺東市,新生里,27,1576,548,292,840,36,876
公投第１２案,臺東縣,臺東市,新生里,28,1595,564,292,856,41,897
公投第１２案,臺東縣,臺東市,新生里,29,1734,603,330,933,33,966
公投第１２案,臺東縣,臺東市,中心里,30,1476,497,321,818,34,852
公投第１２案,臺東縣,臺東市,中心里,31,1545,556,345,901,28,929
公投第１２案,臺東縣,臺東市,馬蘭里,32,1313,514,247,761,33,794
公投第１２案,臺東縣,臺東市,馬蘭里,33,1338,517,268,785,35,820
公投第１２案,臺東縣,臺東市,光明里,34,1312,455,259,714,27,741
公投第１２案,臺東縣,臺東市,光明里,35,1265,467,235,702,30,732
公投第１２案,臺東縣,臺東市,豐年里,36,1407,392,264,656,27,683
公投第１２案,臺東縣,臺東市,豐年里,37,1552,480,254,734,28,762
公投第１２案,臺東縣,臺東市,豐樂里,38,1445,455,297,752,63,815
公投第１２案,臺東縣,臺東市,永樂里,39,2098,719,456,1175,45,1220
公投第１２案,臺東縣,臺東市,康樂里,40,1324,508,228,736,57,793
公投第１２案,臺東縣,臺東市,豐榮里,41,1598,568,297,865,23,888
公投第１２案,臺東縣,臺東市,豐榮里,42,1513,496,300,796,19,815
公投第１２案,臺東縣,臺東市,豐榮里,43,1679,513,309,822,28,850
公投第１２案,臺東縣,臺東市,豐榮里,44,1414,473,268,741,31,772
公投第１２案,臺東縣,臺東市,豐榮里,45,1798,603,334,937,28,965
公投第１２案,臺東縣,臺東市,豐谷里,46,1749,517,288,805,47,852
公投第１２案,臺東縣,臺東市,豐谷里,47,1709,559,322,881,44,925
公投第１２案,臺東縣,臺東市,豐谷里,48,1629,533,288,821,41,862
公投第１２案,臺東縣,臺東市,豐里里,49,1116,362,195,557,41,598
公投第１２案,臺東縣,臺東市,豐里里,50,1259,328,230,558,24,582
公投第１２案,臺東縣,臺東市,豐原里,51,1232,326,221,547,34,581
公投第１２案,臺東縣,臺東市,富岡里,52,1505,466,239,705,69,774
公投第１２案,臺東縣,臺東市,富豐里,53,836,230,136,366,38,404
公投第１２案,臺東縣,臺東市,南榮里,54,1294,432,262,694,42,736
公投第１２案,臺東縣,臺東市,南榮里,55,1350,429,257,686,37,723
公投第１２案,臺東縣,臺東市,岩灣里,56,2162,738,405,1143,54,1197
公投第１２案,臺東縣,臺東市,卑南里,57,1627,573,348,921,46,967
公投第１２案,臺東縣,臺東市,卑南里,58,1140,381,248,629,49,678
公投第１２案,臺東縣,臺東市,南王里,59,1359,411,290,701,36,737
公投第１２案,臺東縣,臺東市,南王里,60,1329,446,268,714,25,739
公投第１２案,臺東縣,臺東市,豐田里,61,990,324,164,488,28,516
公投第１２案,臺東縣,臺東市,豐田里,62,1038,355,200,555,43,598
公投第１２案,臺東縣,臺東市,新園里,63,1597,510,292,802,44,846
公投第１２案,臺東縣,臺東市,建和里,64,1385,411,286,697,50,747
公投第１２案,臺東縣,臺東市,建興里,65,939,247,182,429,20,449
公投第１２案,臺東縣,臺東市,建業里,66,1258,331,209,540,42,582
公投第１２案,臺東縣,臺東市,知本里,67,1350,397,256,653,9,662
公投第１２案,臺東縣,臺東市,建農里,68,1058,306,169,475,31,506
公投第１２案,臺東縣,臺東市,建農里,69,895,273,133,406,21,427
公投第１２案,臺東縣,成功鎮,信義里,70,516,124,104,228,30,258
公投第１２案,臺東縣,成功鎮,信義里,71,960,344,206,550,36,586
公投第１２案,臺東縣,成功鎮,信義里,72,365,121,38,159,14,173
公投第１２案,臺東縣,成功鎮,和平里,73,747,220,104,324,21,345
公投第１２案,臺東縣,成功鎮,忠仁里,74,339,108,40,148,12,160
公投第１２案,臺東縣,成功鎮,忠仁里,75,995,277,172,449,26,475
公投第１２案,臺東縣,成功鎮,忠仁里,76,863,247,197,444,39,483
公投第１２案,臺東縣,成功鎮,忠智里,77,931,255,213,468,42,510
公投第１２案,臺東縣,成功鎮,忠智里,78,970,290,179,469,27,496
公投第１２案,臺東縣,成功鎮,三民里,79,1365,383,263,646,58,704
公投第１２案,臺東縣,成功鎮,三民里,80,1366,445,229,674,49,723
公投第１２案,臺東縣,成功鎮,三仙里,81,516,154,83,237,27,264
公投第１２案,臺東縣,成功鎮,三仙里,82,887,242,148,390,30,420
公投第１２案,臺東縣,成功鎮,忠孝里,83,488,109,93,202,17,219
公投第１２案,臺東縣,成功鎮,忠孝里,84,481,104,72,176,20,196
公投第１２案,臺東縣,成功鎮,博愛里,85,373,109,47,156,10,166
公投第１２案,臺東縣,成功鎮,博愛里,86,264,64,57,121,22,143
公投第１２案,臺東縣,關山鎮,里壠里,87,909,316,189,505,34,539
公投第１２案,臺東縣,關山鎮,里壠里,88,790,187,123,310,29,339
公投第１２案,臺東縣,關山鎮,中福里,89,828,284,187,471,30,501
公投第１２案,臺東縣,關山鎮,新福里,90,887,228,149,377,20,397
公投第１２案,臺東縣,關山鎮,豐泉里,91,1137,348,247,595,26,621
公投第１２案,臺東縣,關山鎮,月眉里,92,732,202,123,325,25,350
公投第１２案,臺東縣,關山鎮,德高里,93,912,263,175,438,37,475
公投第１２案,臺東縣,關山鎮,德高里,94,779,185,120,305,15,320
公投第１２案,臺東縣,關山鎮,電光里,95,535,103,79,182,24,206
公投第１２案,臺東縣,卑南鄉,賓朗村,96,1041,350,218,568,38,606
公投第１２案,臺東縣,卑南鄉,賓朗村,97,1165,314,239,553,36,589
公投第１２案,臺東縣,卑南鄉,美農村,98,219,54,39,93,9,102
公投第１２案,臺東縣,卑南鄉,美農村,99,460,121,80,201,21,222
公投第１２案,臺東縣,卑南鄉,美農村,100,387,84,54,138,17,155
公投第１２案,臺東縣,卑南鄉,初鹿村,101,767,198,139,337,26,363
公投第１２案,臺東縣,卑南鄉,初鹿村,102,503,161,97,258,15,273
公投第１２案,臺東縣,卑南鄉,明峰村,103,727,194,113,307,45,352
公投第１２案,臺東縣,卑南鄉,明峰村,104,436,128,76,204,27,231
公投第１２案,臺東縣,卑南鄉,嘉豐村,105,261,49,39,88,8,96
公投第１２案,臺東縣,卑南鄉,嘉豐村,106,215,60,47,107,10,117
公投第１２案,臺東縣,卑南鄉,太平村,107,1442,491,265,756,54,810
公投第１２案,臺東縣,卑南鄉,太平村,108,527,199,56,255,9,264
公投第１２案,臺東縣,卑南鄉,太平村,109,1046,342,200,542,40,582
公投第１２案,臺東縣,卑南鄉,泰安村,110,1110,317,228,545,52,597
公投第１２案,臺東縣,卑南鄉,利嘉村,111,1105,352,236,588,47,635
公投第１２案,臺東縣,卑南鄉,東興村,112,1167,481,201,682,55,737
公投第１２案,臺東縣,卑南鄉,溫泉村,113,968,247,187,434,39,473
公投第１２案,臺東縣,卑南鄉,溫泉村,114,159,32,26,58,2,60
公投第１２案,臺東縣,卑南鄉,富山村,115,488,122,81,203,17,220
公投第１２案,臺東縣,卑南鄉,富源村,116,347,105,86,191,13,204
公投第１２案,臺東縣,卑南鄉,利吉村,117,436,151,71,222,16,238
公投第１２案,臺東縣,鹿野鄉,鹿野村,118,522,107,80,187,10,197
公投第１２案,臺東縣,鹿野鄉,鹿野村,119,574,163,128,291,20,311
公投第１２案,臺東縣,鹿野鄉,龍田村,120,1055,213,172,385,29,414
公投第１２案,臺東縣,鹿野鄉,永安村,121,1104,284,210,494,25,519
公投第１２案,臺東縣,鹿野鄉,永安村,122,342,86,54,140,14,154
公投第１２案,臺東縣,鹿野鄉,瑞隆村,123,895,246,149,395,28,423
公投第１２案,臺東縣,鹿野鄉,瑞源村,124,864,237,159,396,29,425
公投第１２案,臺東縣,鹿野鄉,瑞和村,125,675,154,104,258,34,292
公投第１２案,臺東縣,鹿野鄉,瑞豐村,126,435,115,81,196,19,215
公投第１２案,臺東縣,鹿野鄉,瑞豐村,127,470,84,80,164,24,188
公投第１２案,臺東縣,池上鄉,福原村,128,992,262,186,448,30,478
公投第１２案,臺東縣,池上鄉,福原村,129,929,285,192,477,41,518
公投第１２案,臺東縣,池上鄉,福文村,130,434,93,93,186,25,211
公投第１２案,臺東縣,池上鄉,福文村,131,703,150,128,278,28,306
公投第１２案,臺東縣,池上鄉,慶豐村,132,654,142,122,264,21,285
公投第１２案,臺東縣,池上鄉,大坡村,133,324,55,59,114,15,129
公投第１２案,臺東縣,池上鄉,大埔村,134,794,187,145,332,27,359
公投第１２案,臺東縣,池上鄉,新興村,135,856,220,143,363,50,413
公投第１２案,臺東縣,池上鄉,錦園村,136,344,73,60,133,11,144
公投第１２案,臺東縣,池上鄉,萬安村,137,311,85,64,149,24,173
公投第１２案,臺東縣,池上鄉,富興村,138,386,78,44,122,15,137
公投第１２案,臺東縣,池上鄉,振興村,139,435,74,58,132,19,151
公投第１２案,臺東縣,東河鄉,都蘭村,140,290,65,44,109,19,128
公投第１２案,臺東縣,東河鄉,都蘭村,141,620,236,100,336,23,359
公投第１２案,臺東縣,東河鄉,都蘭村,142,1196,428,259,687,58,745
公投第１２案,臺東縣,東河鄉,興昌村,143,918,273,143,416,38,454
公投第１２案,臺東縣,東河鄉,隆昌村,144,555,160,89,249,12,261
公投第１２案,臺東縣,東河鄉,東河村,145,977,250,148,398,29,427
公投第１２案,臺東縣,東河鄉,泰源村,146,1197,221,159,380,15,395
公投第１２案,臺東縣,東河鄉,北源村,147,867,110,81,191,21,212
公投第１２案,臺東縣,東河鄉,北源村,148,345,93,46,139,9,148
公投第１２案,臺東縣,東河鄉,北源村,149,408,90,67,157,14,171
公投第１２案,臺東縣,東河鄉,尚德村,150,262,64,40,104,10,114
公投第１２案,臺東縣,長濱鄉,寧埔村,151,536,160,114,274,35,309
公投第１２案,臺東縣,長濱鄉,寧埔村,152,689,135,75,210,20,230
公投第１２案,臺東縣,長濱鄉,竹湖村,153,913,295,138,433,71,504
公投第１２案,臺東縣,長濱鄉,長濱村,154,1268,299,169,468,22,490
公投第１２案,臺東縣,長濱鄉,長濱村,155,725,235,108,343,28,371
公投第１２案,臺東縣,長濱鄉,忠勇村,156,532,79,75,154,6,160
公投第１２案,臺東縣,長濱鄉,三間村,157,660,136,107,243,36,279
公投第１２案,臺東縣,長濱鄉,三間村,158,336,75,38,113,8,121
公投第１２案,臺東縣,長濱鄉,三間村,159,195,41,15,56,8,64
公投第１２案,臺東縣,長濱鄉,樟原村,160,25,9,2,11,2,13
公投第１２案,臺東縣,長濱鄉,樟原村,161,605,159,90,249,26,275
公投第１２案,臺東縣,太麻里鄉,美和村,162,722,225,129,354,32,386
公投第１２案,臺東縣,太麻里鄉,美和村,163,575,192,84,276,25,301
公投第１２案,臺東縣,太麻里鄉,三和村,164,623,178,115,293,22,315
公投第１２案,臺東縣,太麻里鄉,華源村,165,622,183,95,278,24,302
公投第１２案,臺東縣,太麻里鄉,北里村,166,560,175,94,269,14,283
公投第１２案,臺東縣,太麻里鄉,大王村,167,957,399,144,543,27,570
公投第１２案,臺東縣,太麻里鄉,大王村,168,809,241,144,385,30,415
公投第１２案,臺東縣,太麻里鄉,泰和村,169,673,236,156,392,25,417
公投第１２案,臺東縣,太麻里鄉,泰和村,170,737,211,145,356,23,379
公投第１２案,臺東縣,太麻里鄉,香蘭村,171,424,154,74,228,14,242
公投第１２案,臺東縣,太麻里鄉,香蘭村,172,374,108,62,170,9,179
公投第１２案,臺東縣,太麻里鄉,金崙村,173,829,385,152,537,11,548
公投第１２案,臺東縣,太麻里鄉,金崙村,174,869,399,119,518,11,529
公投第１２案,臺東縣,太麻里鄉,多良村,175,223,80,31,111,10,121
公投第１２案,臺東縣,太麻里鄉,多良村,176,669,208,134,342,22,364
公投第１２案,臺東縣,大武鄉,南興村,177,568,266,71,337,14,351
公投第１２案,臺東縣,大武鄉,尚武村,178,1474,416,263,679,57,736
公投第１２案,臺東縣,大武鄉,大武村,179,1327,641,23,664,46,710
公投第１２案,臺東縣,大武鄉,大鳥村,180,1134,286,201,487,55,542
公投第１２案,臺東縣,大武鄉,大竹村,181,386,151,65,216,6,222
公投第１２案,臺東縣,大武鄉,大竹村,182,377,143,59,202,20,222
公投第１２案,臺東縣,綠島鄉,南寮村,183,1474,376,240,616,18,634
公投第１２案,臺東縣,綠島鄉,中寮村,184,1082,289,163,452,20,472
公投第１２案,臺東縣,綠島鄉,公舘村,185,813,220,142,362,19,381
公投第１２案,臺東縣,綠島鄉,公舘村,186,210,60,40,100,5,105
公投第１２案,臺東縣,海端鄉,加拿村,187,497,150,102,252,11,263
公投第１２案,臺東縣,海端鄉,崁頂村,188,569,183,131,314,16,330
公投第１２案,臺東縣,海端鄉,海端村,189,971,296,171,467,21,488
公投第１２案,臺東縣,海端鄉,廣原村,190,728,224,144,368,26,394
公投第１２案,臺東縣,海端鄉,霧鹿村,191,259,67,70,137,11,148
公投第１２案,臺東縣,海端鄉,利稻村,192,254,82,62,144,4,148
公投第１２案,臺東縣,延平鄉,桃源村,193,1014,335,191,526,34,560
公投第１２案,臺東縣,延平鄉,紅葉村,194,426,162,111,273,25,298
公投第１２案,臺東縣,延平鄉,永康村,195,315,151,48,199,10,209
公投第１２案,臺東縣,延平鄉,武陵村,196,579,249,101,350,15,365
公投第１２案,臺東縣,延平鄉,鸞山村,197,596,165,97,262,13,275
公投第１２案,臺東縣,金峰鄉,嘉蘭村,198,1241,472,218,690,32,722
公投第１２案,臺東縣,金峰鄉,正興村,199,601,283,138,421,13,434
公投第１２案,臺東縣,金峰鄉,新興村,200,520,226,144,370,22,392
公投第１２案,臺東縣,金峰鄉,賓茂村,201,336,111,71,182,7,189
公投第１２案,臺東縣,金峰鄉,歷坵村,202,330,193,56,249,15,264
公投第１２案,臺東縣,達仁鄉,安朔村,203,246,117,34,151,3,154
公投第１２案,臺東縣,達仁鄉,安朔村,204,340,185,37,222,3,225
公投第１２案,臺東縣,達仁鄉,南田村,205,296,112,67,179,16,195
公投第１２案,臺東縣,達仁鄉,森永村,206,429,175,95,270,23,293
公投第１２案,臺東縣,達仁鄉,新化村,207,331,155,64,219,15,234
公投第１２案,臺東縣,達仁鄉,台坂村,208,628,192,96,288,11,299
公投第１２案,臺東縣,達仁鄉,土坂村,209,867,271,173,444,31,475
公投第１２案,臺東縣,蘭嶼鄉,椰油村,210,943,192,182,374,21,395
公投第１２案,臺東縣,蘭嶼鄉,紅頭村,211,1238,273,226,499,27,526
公投第１２案,臺東縣,蘭嶼鄉,東清村,212,1240,271,190,461,14,475
公投第１２案,臺東縣,蘭嶼鄉,朗島村,213,760,118,143,261,18,279
公投第１２案,花蓮縣,花蓮市,民德里,1,1522,553,298,851,17,868
公投第１２案,花蓮縣,花蓮市,民勤里,2,1114,426,215,641,11,652
公投第１２案,花蓮縣,花蓮市,民勤里,3,670,234,126,360,17,377
公投第１２案,花蓮縣,花蓮市,民勤里,4,1397,471,245,716,22,738
公投第１２案,花蓮縣,花蓮市,民意里,5,470,131,94,225,14,239
公投第１２案,花蓮縣,花蓮市,民意里,6,838,274,143,417,20,437
公投第１２案,花蓮縣,花蓮市,民意里,7,721,199,103,302,18,320
公投第１２案,花蓮縣,花蓮市,民心里,8,918,303,198,501,33,534
公投第１２案,花蓮縣,花蓮市,民享里,9,1539,478,303,781,31,812
公投第１２案,花蓮縣,花蓮市,民享里,10,1403,480,241,721,27,748
公投第１２案,花蓮縣,花蓮市,民孝里,11,1068,344,203,547,21,568
公投第１２案,花蓮縣,花蓮市,民孝里,12,1167,415,209,624,21,645
公投第１２案,花蓮縣,花蓮市,民孝里,13,1259,477,242,719,37,756
公投第１２案,花蓮縣,花蓮市,民運里,14,1071,404,80,484,40,524
公投第１２案,花蓮縣,花蓮市,民運里,15,925,330,190,520,9,529
公投第１２案,花蓮縣,花蓮市,民政里,16,1141,431,254,685,29,714
公投第１２案,花蓮縣,花蓮市,民政里,17,1163,392,208,600,16,616
公投第１２案,花蓮縣,花蓮市,民政里,18,1279,478,237,715,32,747
公投第１２案,花蓮縣,花蓮市,民立里,19,1512,486,246,732,19,751
公投第１２案,花蓮縣,花蓮市,民樂里,20,615,210,113,323,11,334
公投第１２案,花蓮縣,花蓮市,民有里,21,606,221,132,353,7,360
公投第１２案,花蓮縣,花蓮市,民主里,22,559,169,106,275,9,284
公投第１２案,花蓮縣,花蓮市,民族里,23,442,143,91,234,14,248
公投第１２案,花蓮縣,花蓮市,民生里,24,1114,342,212,554,27,581
公投第１２案,花蓮縣,花蓮市,民權里,25,416,141,89,230,11,241
公投第１２案,花蓮縣,花蓮市,主商里,26,577,216,125,341,14,355
公投第１２案,花蓮縣,花蓮市,主勤里,27,810,266,204,470,24,494
公投第１２案,花蓮縣,花蓮市,主工里,28,538,182,106,288,20,308
公投第１２案,花蓮縣,花蓮市,主信里,29,566,170,119,289,21,310
公投第１２案,花蓮縣,花蓮市,主義里,30,469,175,89,264,9,273
公投第１２案,花蓮縣,花蓮市,主睦里,31,565,201,111,312,14,326
公投第１２案,花蓮縣,花蓮市,主計里,32,816,258,135,393,18,411
公投第１２案,花蓮縣,花蓮市,主和里,33,911,268,184,452,29,481
公投第１２案,花蓮縣,花蓮市,主和里,34,1029,309,202,511,26,537
公投第１２案,花蓮縣,花蓮市,主和里,35,1043,390,196,586,31,617
公投第１２案,花蓮縣,花蓮市,主學里,36,856,302,175,477,18,495
公投第１２案,花蓮縣,花蓮市,主學里,37,979,302,226,528,16,544
公投第１２案,花蓮縣,花蓮市,主農里,38,1331,431,294,725,28,753
公投第１２案,花蓮縣,花蓮市,主農里,39,1228,402,276,678,19,697
公投第１２案,花蓮縣,花蓮市,主農里,40,955,319,210,529,19,548
公投第１２案,花蓮縣,花蓮市,主安里,41,1268,385,239,624,22,646
公投第１２案,花蓮縣,花蓮市,主安里,42,1230,363,240,603,41,644
公投第１２案,花蓮縣,花蓮市,主權里,43,1369,477,265,742,31,773
公投第１２案,花蓮縣,花蓮市,主權里,44,1435,409,252,661,20,681
公投第１２案,花蓮縣,花蓮市,主權里,45,1164,389,231,620,19,639
公投第１２案,花蓮縣,花蓮市,主權里,46,1249,441,270,711,30,741
公投第１２案,花蓮縣,花蓮市,主力里,47,1184,383,227,610,46,656
公投第１２案,花蓮縣,花蓮市,主力里,48,1490,467,290,757,30,787
公投第１２案,花蓮縣,花蓮市,國風里,49,1022,378,228,606,38,644
公投第１２案,花蓮縣,花蓮市,國風里,50,1135,364,237,601,37,638
公投第１２案,花蓮縣,花蓮市,國風里,51,1084,384,202,586,24,610
公投第１２案,花蓮縣,花蓮市,國威里,52,1339,288,196,484,17,501
公投第１２案,花蓮縣,花蓮市,國威里,53,501,199,90,289,12,301
公投第１２案,花蓮縣,花蓮市,國治里,54,904,321,169,490,14,504
公投第１２案,花蓮縣,花蓮市,國安里,55,490,175,116,291,13,304
公投第１２案,花蓮縣,花蓮市,國光里,56,1192,342,216,558,23,581
公投第１２案,花蓮縣,花蓮市,國防里,57,869,243,172,415,20,435
公投第１２案,花蓮縣,花蓮市,國華里,58,1267,397,246,643,34,677
公投第１２案,花蓮縣,花蓮市,國華里,59,959,336,193,529,27,556
公投第１２案,花蓮縣,花蓮市,國魂里,60,993,345,178,523,21,544
公投第１２案,花蓮縣,花蓮市,國魂里,61,982,315,205,520,32,552
公投第１２案,花蓮縣,花蓮市,國聯里,62,1311,371,249,620,24,644
公投第１２案,花蓮縣,花蓮市,國聯里,63,1455,424,292,716,34,750
公投第１２案,花蓮縣,花蓮市,國盛里,64,1151,331,192,523,15,538
公投第１２案,花蓮縣,花蓮市,國盛里,65,1237,363,228,591,21,612
公投第１２案,花蓮縣,花蓮市,國盛里,66,1339,383,238,621,25,646
公投第１２案,花蓮縣,花蓮市,國強里,67,715,238,158,396,20,416
公投第１２案,花蓮縣,花蓮市,國強里,68,1000,311,221,532,26,558
公投第１２案,花蓮縣,花蓮市,國富里,69,1410,420,243,663,36,699
公投第１２案,花蓮縣,花蓮市,國富里,70,1303,430,244,674,19,693
公投第１２案,花蓮縣,花蓮市,國富里,71,1256,415,233,648,26,674
公投第１２案,花蓮縣,花蓮市,國富里,72,1105,416,187,603,33,636
公投第１２案,花蓮縣,花蓮市,國裕里,73,1089,325,210,535,23,558
公投第１２案,花蓮縣,花蓮市,國裕里,74,1043,315,184,499,29,528
公投第１２案,花蓮縣,花蓮市,國裕里,75,1080,374,219,593,25,618
公投第１２案,花蓮縣,花蓮市,國裕里,76,971,337,193,530,19,549
公投第１２案,花蓮縣,花蓮市,國慶里,77,1068,348,244,592,21,613
公投第１２案,花蓮縣,花蓮市,國興里,78,1379,408,255,663,31,694
公投第１２案,花蓮縣,花蓮市,國興里,79,1362,418,263,681,36,717
公投第１２案,花蓮縣,花蓮市,國興里,80,1323,440,287,727,30,757
公投第１２案,花蓮縣,花蓮市,國福里,81,1482,398,253,651,30,681
公投第１２案,花蓮縣,新城鄉,新城村,82,367,110,86,196,16,212
公投第１２案,花蓮縣,新城鄉,新城村,83,929,274,182,456,15,471
公投第１２案,花蓮縣,新城鄉,順安村,84,590,158,149,307,50,357
公投第１２案,花蓮縣,新城鄉,順安村,85,307,92,64,156,17,173
公投第１２案,花蓮縣,新城鄉,康樂村,86,260,91,57,148,12,160
公投第１２案,花蓮縣,新城鄉,康樂村,87,1283,390,291,681,37,718
公投第１２案,花蓮縣,新城鄉,康樂村,88,885,290,148,438,23,461
公投第１２案,花蓮縣,新城鄉,大漢村,89,770,243,186,429,20,449
公投第１２案,花蓮縣,新城鄉,大漢村,90,1363,447,255,702,39,741
公投第１２案,花蓮縣,新城鄉,大漢村,91,366,103,76,179,15,194
公投第１２案,花蓮縣,新城鄉,北埔村,92,1163,345,211,556,33,589
公投第１２案,花蓮縣,新城鄉,北埔村,93,1605,512,303,815,39,854
公投第１２案,花蓮縣,新城鄉,北埔村,94,1194,407,214,621,39,660
公投第１２案,花蓮縣,新城鄉,佳林村,95,979,333,198,531,25,556
公投第１２案,花蓮縣,新城鄉,嘉里村,96,1485,474,320,794,35,829
公投第１２案,花蓮縣,新城鄉,嘉里村,97,1070,319,220,539,20,559
公投第１２案,花蓮縣,新城鄉,嘉里村,98,1164,356,257,613,22,635
公投第１２案,花蓮縣,新城鄉,嘉新村,99,880,233,199,432,38,470
公投第１２案,花蓮縣,新城鄉,嘉新村,100,369,95,82,177,9,186
公投第１２案,花蓮縣,秀林鄉,和平村,101,867,236,193,429,24,453
公投第１２案,花蓮縣,秀林鄉,和平村,102,575,154,136,290,15,305
公投第１２案,花蓮縣,秀林鄉,崇德村,103,1373,314,227,541,32,573
公投第１２案,花蓮縣,秀林鄉,富世村,104,1644,492,258,750,43,793
公投第１２案,花蓮縣,秀林鄉,富世村,105,162,47,39,86,4,90
公投第１２案,花蓮縣,秀林鄉,秀林村,106,384,109,77,186,17,203
公投第１２案,花蓮縣,秀林鄉,秀林村,107,1382,372,267,639,37,676
公投第１２案,花蓮縣,秀林鄉,景美村,108,1125,338,236,574,28,602
公投第１２案,花蓮縣,秀林鄉,景美村,109,627,173,128,301,18,319
公投第１２案,花蓮縣,秀林鄉,佳民村,110,987,344,215,559,41,600
公投第１２案,花蓮縣,秀林鄉,水源村,111,1139,387,272,659,45,704
公投第１２案,花蓮縣,秀林鄉,銅門村,112,1213,428,223,651,14,665
公投第１２案,花蓮縣,秀林鄉,文蘭村,113,754,230,161,391,23,414
公投第１２案,花蓮縣,秀林鄉,文蘭村,114,330,103,58,161,7,168
公投第１２案,花蓮縣,吉安鄉,永安村,115,1059,333,199,532,28,560
公投第１２案,花蓮縣,吉安鄉,永安村,116,983,304,210,514,32,546
公投第１２案,花蓮縣,吉安鄉,永安村,117,1031,334,213,547,18,565
公投第１２案,花蓮縣,吉安鄉,永安村,118,1105,341,201,542,29,571
公投第１２案,花蓮縣,吉安鄉,太昌村,119,1107,363,191,554,29,583
公投第１２案,花蓮縣,吉安鄉,太昌村,120,1179,331,233,564,27,591
公投第１２案,花蓮縣,吉安鄉,太昌村,121,1453,353,275,628,37,665
公投第１２案,花蓮縣,吉安鄉,慶豐村,122,1432,476,327,803,40,843
公投第１２案,花蓮縣,吉安鄉,慶豐村,123,1320,438,263,701,28,729
公投第１２案,花蓮縣,吉安鄉,慶豐村,124,1356,401,278,679,24,703
公投第１２案,花蓮縣,吉安鄉,慶豐村,125,1295,396,254,650,28,678
公投第１２案,花蓮縣,吉安鄉,慶豐村,126,1467,461,294,755,44,799
公投第１２案,花蓮縣,吉安鄉,吉安村,127,1515,492,268,760,32,792
公投第１２案,花蓮縣,吉安鄉,吉安村,128,1063,346,249,595,36,631
公投第１２案,花蓮縣,吉安鄉,吉安村,129,1284,330,220,550,20,570
公投第１２案,花蓮縣,吉安鄉,吉安村,130,1380,469,280,749,24,773
公投第１２案,花蓮縣,吉安鄉,福興村,131,1297,429,270,699,35,734
公投第１２案,花蓮縣,吉安鄉,福興村,132,1662,459,334,793,65,858
公投第１２案,花蓮縣,吉安鄉,南華村,133,1563,461,247,708,50,758
公投第１２案,花蓮縣,吉安鄉,干城村,134,1288,365,225,590,33,623
公投第１２案,花蓮縣,吉安鄉,永興村,135,907,321,177,498,25,523
公投第１２案,花蓮縣,吉安鄉,永興村,136,917,250,202,452,22,474
公投第１２案,花蓮縣,吉安鄉,永興村,137,1021,286,223,509,17,526
公投第１２案,花蓮縣,吉安鄉,稻香村,138,1033,387,197,584,30,614
公投第１２案,花蓮縣,吉安鄉,稻香村,139,966,348,179,527,28,555
公投第１２案,花蓮縣,吉安鄉,稻香村,140,1188,373,214,587,41,628
公投第１２案,花蓮縣,吉安鄉,南昌村,141,1480,448,300,748,27,775
公投第１２案,花蓮縣,吉安鄉,南昌村,142,1393,391,254,645,30,675
公投第１２案,花蓮縣,吉安鄉,南昌村,143,1193,370,219,589,29,618
公投第１２案,花蓮縣,吉安鄉,宜昌村,144,1445,429,248,677,27,704
公投第１２案,花蓮縣,吉安鄉,宜昌村,145,1301,395,268,663,57,720
公投第１２案,花蓮縣,吉安鄉,宜昌村,146,1215,355,307,662,29,691
公投第１２案,花蓮縣,吉安鄉,北昌村,147,1135,368,216,584,27,611
公投第１２案,花蓮縣,吉安鄉,北昌村,148,1223,434,234,668,27,695
公投第１２案,花蓮縣,吉安鄉,北昌村,149,1274,500,267,767,33,800
公投第１２案,花蓮縣,吉安鄉,北昌村,150,1124,342,225,567,29,596
公投第１２案,花蓮縣,吉安鄉,北昌村,151,1158,371,255,626,24,650
公投第１２案,花蓮縣,吉安鄉,北昌村,152,1157,380,253,633,16,649
公投第１２案,花蓮縣,吉安鄉,勝安村,153,1258,404,264,668,27,695
公投第１２案,花蓮縣,吉安鄉,勝安村,154,1257,382,271,653,21,674
公投第１２案,花蓮縣,吉安鄉,勝安村,155,1245,384,246,630,22,652
公投第１２案,花蓮縣,吉安鄉,勝安村,156,1166,388,245,633,16,649
公投第１２案,花蓮縣,吉安鄉,仁里村,157,1358,453,227,680,33,713
公投第１２案,花蓮縣,吉安鄉,仁里村,158,1214,409,197,606,23,629
公投第１２案,花蓮縣,吉安鄉,仁里村,159,1151,371,227,598,22,620
公投第１２案,花蓮縣,吉安鄉,仁里村,160,1157,383,245,628,20,648
公投第１２案,花蓮縣,吉安鄉,仁里村,161,1161,388,244,632,23,655
公投第１２案,花蓮縣,吉安鄉,東昌村,162,1304,435,282,717,20,737
公投第１２案,花蓮縣,吉安鄉,東昌村,163,1367,439,252,691,32,723
公投第１２案,花蓮縣,吉安鄉,東昌村,164,1411,396,249,645,22,667
公投第１２案,花蓮縣,吉安鄉,東昌村,165,1409,447,206,653,31,684
公投第１２案,花蓮縣,吉安鄉,仁安村,166,1125,323,199,522,22,544
公投第１２案,花蓮縣,吉安鄉,仁安村,167,1213,377,249,626,43,669
公投第１２案,花蓮縣,吉安鄉,仁和村,168,1141,392,211,603,23,626
公投第１２案,花蓮縣,吉安鄉,仁和村,169,1156,347,186,533,17,550
公投第１２案,花蓮縣,吉安鄉,仁和村,170,1092,335,207,542,25,567
公投第１２案,花蓮縣,吉安鄉,仁和村,171,1026,260,178,438,30,468
公投第１２案,花蓮縣,吉安鄉,光華村,172,804,256,158,414,14,428
公投第１２案,花蓮縣,吉安鄉,光華村,173,1132,381,224,605,22,627
公投第１２案,花蓮縣,壽豐鄉,溪口村,174,1052,327,182,509,35,544
公投第１２案,花蓮縣,壽豐鄉,樹湖村,175,357,117,74,191,27,218
公投第１２案,花蓮縣,壽豐鄉,豐山村,176,1022,264,213,477,41,518
公投第１２案,花蓮縣,壽豐鄉,豐山村,177,875,313,202,515,33,548
公投第１２案,花蓮縣,壽豐鄉,豐裡村,178,691,250,148,398,27,425
公投第１２案,花蓮縣,壽豐鄉,豐裡村,179,708,230,117,347,20,367
公投第１２案,花蓮縣,壽豐鄉,豐坪村,180,894,264,168,432,43,475
公投第１２案,花蓮縣,壽豐鄉,壽豐村,181,746,226,153,379,30,409
公投第１２案,花蓮縣,壽豐鄉,壽豐村,182,881,251,202,453,25,478
公投第１２案,花蓮縣,壽豐鄉,共和村,183,695,257,151,408,24,432
公投第１２案,花蓮縣,壽豐鄉,光榮村,184,816,275,210,485,35,520
公投第１２案,花蓮縣,壽豐鄉,池南村,185,773,229,135,364,32,396
公投第１２案,花蓮縣,壽豐鄉,平和村,186,1029,349,190,539,50,589
公投第１２案,花蓮縣,壽豐鄉,平和村,187,407,150,91,241,17,258
公投第１２案,花蓮縣,壽豐鄉,志學村,188,1139,386,244,630,32,662
公投第１２案,花蓮縣,壽豐鄉,志學村,189,996,303,245,548,26,574
公投第１２案,花蓮縣,壽豐鄉,志學村,190,414,117,62,179,10,189
公投第１２案,花蓮縣,壽豐鄉,米棧村,191,270,90,60,150,7,157
公投第１２案,花蓮縣,壽豐鄉,月眉村,192,836,259,181,440,48,488
公投第１２案,花蓮縣,壽豐鄉,鹽寮村,193,507,157,124,281,29,310
公投第１２案,花蓮縣,壽豐鄉,水璉村,194,739,185,98,283,34,317
公投第１２案,花蓮縣,鳳林鎮,鳳仁里,195,1192,445,243,688,49,737
公投第１２案,花蓮縣,鳳林鎮,鳳義里,196,639,196,114,310,15,325
公投第１２案,花蓮縣,鳳林鎮,鳳禮里,197,601,234,137,371,30,401
公投第１２案,花蓮縣,鳳林鎮,鳳智里,198,1137,420,267,687,43,730
公投第１２案,花蓮縣,鳳林鎮,鳳信里,199,742,220,159,379,38,417
公投第１２案,花蓮縣,鳳林鎮,鳳信里,200,610,214,116,330,21,351
公投第１２案,花蓮縣,鳳林鎮,山興里,201,295,86,82,168,24,192
公投第１２案,花蓮縣,鳳林鎮,山興里,202,218,52,21,73,4,77
公投第１２案,花蓮縣,鳳林鎮,大榮里,203,720,175,138,313,19,332
公投第１２案,花蓮縣,鳳林鎮,大榮里,204,528,166,104,270,20,290
公投第１２案,花蓮縣,鳳林鎮,北林里,205,560,147,121,268,26,294
公投第１２案,花蓮縣,鳳林鎮,南平里,206,541,196,71,267,24,291
公投第１２案,花蓮縣,鳳林鎮,林榮里,207,818,260,148,408,55,463
公投第１２案,花蓮縣,鳳林鎮,長橋里,208,984,246,147,393,37,430
公投第１２案,花蓮縣,鳳林鎮,森榮里,209,91,26,15,41,9,50
公投第１２案,花蓮縣,光復鄉,大華村,210,1295,445,239,684,47,731
公投第１２案,花蓮縣,光復鄉,大安村,211,859,296,177,473,29,502
公投第１２案,花蓮縣,光復鄉,大平村,212,958,372,160,532,43,575
公投第１２案,花蓮縣,光復鄉,大馬村,213,1011,357,183,540,51,591
公投第１２案,花蓮縣,光復鄉,大同村,214,1041,407,154,561,45,606
公投第１２案,花蓮縣,光復鄉,東富村,215,821,231,186,417,40,457
公投第１２案,花蓮縣,光復鄉,東富村,216,188,27,18,45,4,49
公投第１２案,花蓮縣,光復鄉,西富村,217,514,138,122,260,23,283
公投第１２案,花蓮縣,光復鄉,西富村,218,446,111,76,187,12,199
公投第１２案,花蓮縣,光復鄉,南富村,219,851,274,178,452,27,479
公投第１２案,花蓮縣,光復鄉,北富村,220,932,240,155,395,19,414
公投第１２案,花蓮縣,光復鄉,大進村,221,471,159,91,250,18,268
公投第１２案,花蓮縣,光復鄉,大全村,222,640,180,137,317,38,355
公投第１２案,花蓮縣,光復鄉,大全村,223,116,21,24,45,3,48
公投第１２案,花蓮縣,光復鄉,大興村,224,496,110,67,177,4,181
公投第１２案,花蓮縣,光復鄉,大富村,225,324,77,58,135,11,146
公投第１２案,花蓮縣,光復鄉,大豐村,226,454,97,63,160,20,180
公投第１２案,花蓮縣,豐濱鄉,靜浦村,227,717,193,128,321,30,351
公投第１２案,花蓮縣,豐濱鄉,港口村,228,751,152,151,303,24,327
公投第１２案,花蓮縣,豐濱鄉,豐濱村,229,613,179,97,276,22,298
公投第１２案,花蓮縣,豐濱鄉,豐濱村,230,809,313,144,457,17,474
公投第１２案,花蓮縣,豐濱鄉,豐濱村,231,357,102,36,138,12,150
公投第１２案,花蓮縣,豐濱鄉,新社村,232,669,207,116,323,18,341
公投第１２案,花蓮縣,豐濱鄉,磯崎村,233,479,125,102,227,9,236
公投第１２案,花蓮縣,萬榮鄉,西林村,234,1072,349,206,555,49,604
公投第１２案,花蓮縣,萬榮鄉,見晴村,235,560,204,109,313,6,319
公投第１２案,花蓮縣,萬榮鄉,萬榮村,236,773,279,178,457,27,484
公投第１２案,花蓮縣,萬榮鄉,明利村,237,661,199,122,321,10,331
公投第１２案,花蓮縣,萬榮鄉,馬遠村,238,442,164,102,266,18,284
公投第１２案,花蓮縣,萬榮鄉,馬遠村,239,675,216,131,347,14,361
公投第１２案,花蓮縣,萬榮鄉,紅葉村,240,1086,446,248,694,52,746
公投第１２案,花蓮縣,瑞穗鄉,瑞穗村,241,813,291,144,435,39,474
公投第１２案,花蓮縣,瑞穗鄉,瑞穗村,242,1091,342,199,541,69,610
公投第１２案,花蓮縣,瑞穗鄉,瑞美村,243,839,286,159,445,35,480
公投第１２案,花蓮縣,瑞穗鄉,瑞美村,244,975,342,178,520,37,557
公投第１２案,花蓮縣,瑞穗鄉,瑞良村,245,546,167,81,248,13,261
公投第１２案,花蓮縣,瑞穗鄉,瑞祥村,246,1002,318,195,513,56,569
公投第１２案,花蓮縣,瑞穗鄉,瑞北村,247,593,123,130,253,27,280
公投第１２案,花蓮縣,瑞穗鄉,舞鶴村,248,965,285,229,514,40,554
公投第１２案,花蓮縣,瑞穗鄉,鶴岡村,249,863,259,178,437,41,478
公投第１２案,花蓮縣,瑞穗鄉,奇美村,250,340,65,39,104,8,112
公投第１２案,花蓮縣,瑞穗鄉,富源村,251,764,208,121,329,24,353
公投第１２案,花蓮縣,瑞穗鄉,富民村,252,868,148,100,248,12,260
公投第１２案,花蓮縣,瑞穗鄉,富興村,253,620,142,73,215,24,239
公投第１２案,花蓮縣,玉里鎮,中城里,254,1008,319,197,516,32,548
公投第１２案,花蓮縣,玉里鎮,中城里,255,939,343,188,531,30,561
公投第１２案,花蓮縣,玉里鎮,中城里,256,1256,399,227,626,32,658
公投第１２案,花蓮縣,玉里鎮,中城里,257,929,275,199,474,33,507
公投第１２案,花蓮縣,玉里鎮,中城里,258,979,283,217,500,36,536
公投第１２案,花蓮縣,玉里鎮,國武里,259,1244,400,248,648,81,729
公投第１２案,花蓮縣,玉里鎮,啟模里,260,847,234,153,387,31,418
公投第１２案,花蓮縣,玉里鎮,啟模里,261,772,211,139,350,32,382
公投第１２案,花蓮縣,玉里鎮,泰昌里,262,558,158,104,262,18,280
公投第１２案,花蓮縣,玉里鎮,泰昌里,263,800,151,98,249,12,261
公投第１２案,花蓮縣,玉里鎮,永昌里,264,1286,367,195,562,40,602
公投第１２案,花蓮縣,玉里鎮,源城里,265,1246,332,200,532,66,598
公投第１２案,花蓮縣,玉里鎮,長良里,266,647,183,121,304,45,349
公投第１２案,花蓮縣,玉里鎮,樂合里,267,990,270,101,371,21,392
公投第１２案,花蓮縣,玉里鎮,東豐里,268,530,172,68,240,27,267
公投第１２案,花蓮縣,玉里鎮,觀音里,269,979,263,131,394,34,428
公投第１２案,花蓮縣,玉里鎮,觀音里,270,557,225,55,280,40,320
公投第１２案,花蓮縣,玉里鎮,松浦里,271,434,131,59,190,20,210
公投第１２案,花蓮縣,玉里鎮,松浦里,272,1065,216,125,341,55,396
公投第１２案,花蓮縣,玉里鎮,春日里,273,866,278,127,405,63,468
公投第１２案,花蓮縣,玉里鎮,德武里,274,769,246,137,383,18,401
公投第１２案,花蓮縣,玉里鎮,三民里,275,869,204,139,343,28,371
公投第１２案,花蓮縣,玉里鎮,大禹里,276,1080,267,157,424,27,451
公投第１２案,花蓮縣,富里鄉,吳江村,277,467,92,98,190,20,210
公投第１２案,花蓮縣,富里鄉,東里村,278,1032,220,153,373,33,406
公投第１２案,花蓮縣,富里鄉,萬寧村,279,638,161,111,272,21,293
公投第１２案,花蓮縣,富里鄉,新興村,280,591,188,94,282,40,322
公投第１２案,花蓮縣,富里鄉,竹田村,281,1087,295,243,538,55,593
公投第１２案,花蓮縣,富里鄉,羅山村,282,431,117,94,211,13,224
公投第１２案,花蓮縣,富里鄉,石牌村,283,893,236,165,401,34,435
公投第１２案,花蓮縣,富里鄉,明里村,284,361,78,54,132,17,149
公投第１２案,花蓮縣,富里鄉,富里村,285,1362,262,237,499,49,548
公投第１２案,花蓮縣,富里鄉,永豐村,286,458,104,102,206,32,238
公投第１２案,花蓮縣,富里鄉,豐南村,287,621,98,83,181,29,210
公投第１２案,花蓮縣,富里鄉,富南村,288,493,117,107,224,19,243
公投第１２案,花蓮縣,富里鄉,學田村,289,631,158,115,273,29,302
公投第１２案,花蓮縣,卓溪鄉,崙山村,290,533,153,132,285,13,298
公投第１２案,花蓮縣,卓溪鄉,立山村,291,522,218,103,321,19,340
公投第１２案,花蓮縣,卓溪鄉,立山村,292,493,208,108,316,7,323
公投第１２案,花蓮縣,卓溪鄉,太平村,293,701,255,167,422,19,441
公投第１２案,花蓮縣,卓溪鄉,卓溪村,294,746,277,139,416,27,443
公投第１２案,花蓮縣,卓溪鄉,卓清村,295,616,217,144,361,28,389
公投第１２案,花蓮縣,卓溪鄉,卓清村,296,405,133,64,197,6,203
公投第１２案,花蓮縣,卓溪鄉,古風村,297,329,91,74,165,12,177
公投第１２案,花蓮縣,卓溪鄉,古風村,298,428,130,93,223,15,238
公投第１２案,花蓮縣,卓溪鄉,古風村,299,174,49,43,92,6,98
公投第１２案,澎湖縣,馬公市,復興里,1,481,135,81,216,10,226
公投第１２案,澎湖縣,馬公市,長安里,2,558,182,90,272,16,288
公投第１２案,澎湖縣,馬公市,中央里,3,533,175,65,240,24,264
公投第１２案,澎湖縣,馬公市,啟明里,4,922,287,167,454,27,481
公投第１２案,澎湖縣,馬公市,重慶里,5,1021,338,192,530,28,558
公投第１２案,澎湖縣,馬公市,中興里,6,793,241,135,376,30,406
公投第１２案,澎湖縣,馬公市,光復里,7,954,307,181,488,25,513
公投第１２案,澎湖縣,馬公市,光復里,8,1001,309,179,488,18,506
公投第１２案,澎湖縣,馬公市,光明里,9,1192,316,190,506,29,535
公投第１２案,澎湖縣,馬公市,光榮里,10,1402,424,202,626,32,658
公投第１２案,澎湖縣,馬公市,光榮里,11,1389,473,224,697,28,725
公投第１２案,澎湖縣,馬公市,光榮里,12,1339,426,242,668,30,698
公投第１２案,澎湖縣,馬公市,朝陽里,13,1254,282,293,575,33,608
公投第１２案,澎湖縣,馬公市,朝陽里,14,1194,364,201,565,36,601
公投第１２案,澎湖縣,馬公市,朝陽里,15,1393,420,213,633,40,673
公投第１２案,澎湖縣,馬公市,朝陽里,16,1440,476,247,723,28,751
公投第１２案,澎湖縣,馬公市,陽明里,17,1215,332,224,556,45,601
公投第１２案,澎湖縣,馬公市,陽明里,18,1284,389,203,592,41,633
公投第１２案,澎湖縣,馬公市,重光里,19,1512,479,224,703,41,744
公投第１２案,澎湖縣,馬公市,西衛里,20,1181,331,196,527,43,570
公投第１２案,澎湖縣,馬公市,西衛里,21,1348,425,226,651,28,679
公投第１２案,澎湖縣,馬公市,西衛里,22,1391,444,249,693,19,712
公投第１２案,澎湖縣,馬公市,西衛里,23,2124,334,594,928,14,942
公投第１２案,澎湖縣,馬公市,西文里,24,1500,461,245,706,36,742
公投第１２案,澎湖縣,馬公市,西文里,25,1582,540,213,753,27,780
公投第１２案,澎湖縣,馬公市,東文里,26,1638,476,295,771,28,799
公投第１２案,澎湖縣,馬公市,東文里,27,1554,504,276,780,34,814
公投第１２案,澎湖縣,馬公市,案山里,28,980,224,138,362,22,384
公投第１２案,澎湖縣,馬公市,案山里,29,892,278,153,431,19,450
公投第１２案,澎湖縣,馬公市,光華里,30,778,192,115,307,14,321
公投第１２案,澎湖縣,馬公市,前寮里,31,930,297,155,452,27,479
公投第１２案,澎湖縣,馬公市,石泉里,32,1481,573,271,844,24,868
公投第１２案,澎湖縣,馬公市,石泉里,33,1128,409,179,588,15,603
公投第１２案,澎湖縣,馬公市,菜園里,34,415,141,73,214,15,229
公投第１２案,澎湖縣,馬公市,東衛里,35,1120,355,172,527,33,560
公投第１２案,澎湖縣,馬公市,東衛里,36,950,301,189,490,26,516
公投第１２案,澎湖縣,馬公市,安宅里,37,627,168,94,262,19,281
公投第１２案,澎湖縣,馬公市,興仁里,38,1055,339,188,527,25,552
公投第１２案,澎湖縣,馬公市,烏崁里,39,989,309,181,490,31,521
公投第１２案,澎湖縣,馬公市,鐵線里,40,591,169,132,301,29,330
公投第１２案,澎湖縣,馬公市,鎖港里,41,1387,381,228,609,53,662
公投第１２案,澎湖縣,馬公市,鎖港里,42,1079,263,167,430,40,470
公投第１２案,澎湖縣,馬公市,山水里,43,797,257,114,371,33,404
公投第１２案,澎湖縣,馬公市,山水里,44,903,276,136,412,19,431
公投第１２案,澎湖縣,馬公市,五德里,45,376,91,62,153,21,174
公投第１２案,澎湖縣,馬公市,井垵里,46,371,101,84,185,10,195
公投第１２案,澎湖縣,馬公市,嵵裡里,47,1173,306,174,480,16,496
公投第１２案,澎湖縣,馬公市,風櫃里,48,1389,331,174,505,18,523
公投第１２案,澎湖縣,馬公市,虎井里,49,761,124,65,189,25,214
公投第１２案,澎湖縣,馬公市,桶盤里,50,288,104,61,165,13,178
公投第１２案,澎湖縣,湖西鄉,湖西村,51,1120,367,182,549,35,584
公投第１２案,澎湖縣,湖西鄉,湖東村,52,332,94,39,133,8,141
公投第１２案,澎湖縣,湖西鄉,青螺村,53,242,66,28,94,2,96
公投第１２案,澎湖縣,湖西鄉,白坑村,54,293,70,38,108,7,115
公投第１２案,澎湖縣,湖西鄉,南寮村,55,666,162,88,250,27,277
公投第１２案,澎湖縣,湖西鄉,北寮村,56,326,89,59,148,15,163
公投第１２案,澎湖縣,湖西鄉,紅羅村,57,732,182,109,291,11,302
公投第１２案,澎湖縣,湖西鄉,西溪村,58,651,174,110,284,16,300
公投第１２案,澎湖縣,湖西鄉,成功村,59,744,208,111,319,19,338
公投第１２案,澎湖縣,湖西鄉,東石村,60,134,40,32,72,1,73
公投第１２案,澎湖縣,湖西鄉,沙港村,61,794,184,98,282,17,299
公投第１２案,澎湖縣,湖西鄉,中西村,62,216,53,23,76,2,78
公投第１２案,澎湖縣,湖西鄉,鼎灣村,63,664,123,65,188,9,197
公投第１２案,澎湖縣,湖西鄉,潭邊村,64,279,79,48,127,9,136
公投第１２案,澎湖縣,湖西鄉,許家村,65,296,96,56,152,2,154
公投第１２案,澎湖縣,湖西鄉,城北村,66,257,69,50,119,3,122
公投第１２案,澎湖縣,湖西鄉,太武村,67,89,15,12,27,2,29
公投第１２案,澎湖縣,湖西鄉,隘門村,68,815,208,167,375,25,400
公投第１２案,澎湖縣,湖西鄉,林投村,69,975,238,139,377,20,397
公投第１２案,澎湖縣,湖西鄉,尖山村,70,648,173,120,293,27,320
公投第１２案,澎湖縣,湖西鄉,龍門村,71,893,227,142,369,24,393
公投第１２案,澎湖縣,湖西鄉,龍門村,72,846,248,135,383,55,438
公投第１２案,澎湖縣,湖西鄉,菓葉村,73,729,181,105,286,10,296
公投第１２案,澎湖縣,白沙鄉,中屯村,74,514,141,106,247,10,257
公投第１２案,澎湖縣,白沙鄉,講美村,75,657,227,101,328,12,340
公投第１２案,澎湖縣,白沙鄉,城前村,76,109,46,21,67,5,72
公投第１２案,澎湖縣,白沙鄉,鎮海村,77,156,39,27,66,3,69
公投第１２案,澎湖縣,白沙鄉,港子村,78,293,67,49,116,6,122
公投第１２案,澎湖縣,白沙鄉,岐頭村,79,231,45,23,68,3,71
公投第１２案,澎湖縣,白沙鄉,小赤村,80,161,48,32,80,7,87
公投第１２案,澎湖縣,白沙鄉,赤崁村,81,1705,497,256,753,37,790
公投第１２案,澎湖縣,白沙鄉,瓦硐村,82,285,76,42,118,9,127
公投第１２案,澎湖縣,白沙鄉,後寮村,83,723,133,85,218,13,231
公投第１２案,澎湖縣,白沙鄉,通梁村,84,774,158,106,264,21,285
公投第１２案,澎湖縣,白沙鄉,吉貝村,85,1429,323,139,462,57,519
公投第１２案,澎湖縣,白沙鄉,鳥嶼村,86,1084,366,100,466,42,508
公投第１２案,澎湖縣,白沙鄉,員貝村,87,251,70,52,122,5,127
公投第１２案,澎湖縣,白沙鄉,大倉村,88,253,48,32,80,11,91
公投第１２案,澎湖縣,西嶼鄉,橫礁村,89,283,31,18,49,1,50
公投第１２案,澎湖縣,西嶼鄉,合界村,90,424,58,51,109,12,121
公投第１２案,澎湖縣,西嶼鄉,竹灣村,91,826,153,102,255,37,292
公投第１２案,澎湖縣,西嶼鄉,小門村,92,282,58,45,103,7,110
公投第１２案,澎湖縣,西嶼鄉,大池村,93,661,141,95,236,29,265
公投第１２案,澎湖縣,西嶼鄉,二崁村,94,141,17,11,28,2,30
公投第１２案,澎湖縣,西嶼鄉,池東村,95,635,139,57,196,7,203
公投第１２案,澎湖縣,西嶼鄉,池西村,96,216,56,14,70,5,75
公投第１２案,澎湖縣,西嶼鄉,赤馬村,97,572,74,45,119,20,139
公投第１２案,澎湖縣,西嶼鄉,內垵村,98,1267,299,156,455,62,517
公投第１２案,澎湖縣,西嶼鄉,外垵村,99,942,189,104,293,22,315
公投第１２案,澎湖縣,西嶼鄉,外垵村,100,1133,224,168,392,56,448
公投第１２案,澎湖縣,望安鄉,東安村,101,734,188,119,307,24,331
公投第１２案,澎湖縣,望安鄉,西安村,102,454,140,39,179,11,190
公投第１２案,澎湖縣,望安鄉,中社村,103,300,73,33,106,6,112
公投第１２案,澎湖縣,望安鄉,水垵村,104,471,126,79,205,34,239
公投第１２案,澎湖縣,望安鄉,將軍村,105,672,151,87,238,8,246
公投第１２案,澎湖縣,望安鄉,將軍村,106,742,208,83,291,23,314
公投第１２案,澎湖縣,望安鄉,東吉村,107,264,82,25,107,4,111
公投第１２案,澎湖縣,望安鄉,東坪村,108,476,126,88,214,4,218
公投第１２案,澎湖縣,望安鄉,西坪村,109,208,37,23,60,2,62
公投第１２案,澎湖縣,望安鄉,花嶼村,110,307,46,40,86,5,91
公投第１２案,澎湖縣,七美鄉,東湖村,111,248,28,33,61,6,67
公投第１２案,澎湖縣,七美鄉,西湖村,112,581,104,79,183,21,204
公投第１２案,澎湖縣,七美鄉,中和村,113,641,121,78,199,29,228
公投第１２案,澎湖縣,七美鄉,平和村,114,382,74,42,116,4,120
公投第１２案,澎湖縣,七美鄉,海豐村,115,351,44,44,88,3,91
公投第１２案,澎湖縣,七美鄉,南港村,116,1171,182,120,302,20,322
公投第１２案,基隆市,中正區,長潭里,1,466,148,92,240,16,256
公投第１２案,基隆市,中正區,砂子里,2,1262,293,241,534,22,556
公投第１２案,基隆市,中正區,砂子里,3,1171,295,213,508,51,559
公投第１２案,基隆市,中正區,砂子里,4,2823,643,419,1062,13,1075
公投第１２案,基隆市,中正區,八斗里,5,1474,380,244,624,39,663
公投第１２案,基隆市,中正區,碧砂里,6,1271,299,206,505,50,555
公投第１２案,基隆市,中正區,新富里,7,2707,758,384,1142,35,1177
公投第１２案,基隆市,中正區,新富里,8,1545,446,249,695,55,750
公投第１２案,基隆市,中正區,新富里,9,761,205,103,308,15,323
公投第１２案,基隆市,中正區,新豐里,10,1352,358,278,636,22,658
公投第１２案,基隆市,中正區,新豐里,11,1413,414,232,646,19,665
公投第１２案,基隆市,中正區,新豐里,12,2665,699,404,1103,41,1144
公投第１２案,基隆市,中正區,平寮里,13,1261,327,226,553,47,600
公投第１２案,基隆市,中正區,社寮里,14,1753,335,497,832,53,885
公投第１２案,基隆市,中正區,和憲里,15,984,255,162,417,29,446
公投第１２案,基隆市,中正區,海濱里,16,1166,363,181,544,24,568
公投第１２案,基隆市,中正區,正濱里,17,973,271,180,451,23,474
公投第１２案,基隆市,中正區,中正里,18,1694,350,272,622,21,643
公投第１２案,基隆市,中正區,中濱里,19,1270,362,258,620,21,641
公投第１２案,基隆市,中正區,建國里,20,1090,352,198,550,26,576
公投第１２案,基隆市,中正區,建國里,21,870,274,174,448,20,468
公投第１２案,基隆市,中正區,砂灣里,22,1138,313,229,542,30,572
公投第１２案,基隆市,中正區,砂灣里,23,862,212,178,390,33,423
公投第１２案,基隆市,中正區,真砂里,24,1341,399,305,704,40,744
公投第１２案,基隆市,中正區,正砂里,25,859,273,163,436,33,469
公投第１２案,基隆市,中正區,正砂里,26,1457,396,250,646,27,673
公投第１２案,基隆市,中正區,中砂里,27,1594,376,240,616,41,657
公投第１２案,基隆市,中正區,入船里,28,802,225,169,394,35,429
公投第１２案,基隆市,中正區,正船里,29,1267,379,215,594,29,623
公投第１２案,基隆市,中正區,中船里,30,1175,318,254,572,49,621
公投第１２案,基隆市,中正區,港通里,31,1210,396,248,644,38,682
公投第１２案,基隆市,中正區,義重里,32,1037,305,217,522,28,550
公投第１２案,基隆市,中正區,正義里,33,1219,384,225,609,34,643
公投第１２案,基隆市,中正區,信義里,34,904,285,167,452,22,474
公投第１２案,基隆市,中正區,德義里,35,709,234,182,416,28,444
公投第１２案,基隆市,信義區,仁壽里,36,1096,362,227,589,26,615
公投第１２案,基隆市,信義區,仁義里,37,1232,418,287,705,34,739
公投第１２案,基隆市,信義區,義昭里,38,1184,386,264,650,21,671
公投第１２案,基隆市,信義區,義幸里,39,1133,417,212,629,38,667
公投第１２案,基隆市,信義區,義幸里,40,1188,405,241,646,22,668
公投第１２案,基隆市,信義區,義民里,41,725,259,145,404,23,427
公投第１２案,基隆市,信義區,義和里,42,1524,435,260,695,29,724
公投第１２案,基隆市,信義區,智慧里,43,736,230,157,387,30,417
公投第１２案,基隆市,信義區,智誠里,44,611,195,117,312,16,328
公投第１２案,基隆市,信義區,智誠里,45,951,299,162,461,13,474
公投第１２案,基隆市,信義區,禮儀里,46,1616,531,296,827,30,857
公投第１２案,基隆市,信義區,禮東里,47,1516,466,339,805,21,826
公投第１２案,基隆市,信義區,信綠里,48,1049,330,199,529,25,554
公投第１２案,基隆市,信義區,信綠里,49,1069,309,228,537,24,561
公投第１２案,基隆市,信義區,東信里,50,727,240,163,403,22,425
公投第１２案,基隆市,信義區,東信里,51,929,323,214,537,18,555
公投第１２案,基隆市,信義區,東信里,52,1118,399,268,667,25,692
公投第１２案,基隆市,信義區,東信里,53,1339,438,284,722,32,754
公投第１２案,基隆市,信義區,東光里,54,999,348,169,517,14,531
公投第１２案,基隆市,信義區,東光里,55,764,246,157,403,9,412
公投第１２案,基隆市,信義區,東明里,56,1555,456,271,727,30,757
公投第１２案,基隆市,信義區,東明里,57,2015,608,369,977,23,1000
公投第１２案,基隆市,信義區,東安里,58,1268,441,248,689,29,718
公投第１２案,基隆市,信義區,東安里,59,1569,492,311,803,33,836
公投第１２案,基隆市,信義區,孝賢里,60,1985,341,587,928,32,960
公投第１２案,基隆市,信義區,孝賢里,61,1476,544,241,785,26,811
公投第１２案,基隆市,信義區,孝忠里,62,1493,484,339,823,20,843
公投第１２案,基隆市,信義區,孝忠里,63,1249,459,289,748,20,768
公投第１２案,基隆市,信義區,孝忠里,64,1559,455,305,760,23,783
公投第１２案,基隆市,信義區,孝忠里,65,1168,348,215,563,17,580
公投第１２案,基隆市,信義區,孝忠里,66,1602,514,294,808,21,829
公投第１２案,基隆市,信義區,孝德里,67,1485,417,239,656,33,689
公投第１２案,基隆市,信義區,孝德里,68,1009,324,180,504,22,526
公投第１２案,基隆市,信義區,孝深里,69,2016,511,322,833,33,866
公投第１２案,基隆市,信義區,孝深里,70,1764,464,296,760,10,770
公投第１２案,基隆市,信義區,孝岡里,71,1295,411,267,678,25,703
公投第１２案,基隆市,仁愛區,林泉里,72,1782,481,280,761,76,837
公投第１２案,基隆市,仁愛區,花崗里,73,1055,362,208,570,28,598
公投第１２案,基隆市,仁愛區,虹橋里,74,1558,454,278,732,19,751
公投第１２案,基隆市,仁愛區,水錦里,75,1736,548,346,894,37,931
公投第１２案,基隆市,仁愛區,智仁里,76,1243,427,281,708,25,733
公投第１２案,基隆市,仁愛區,智仁里,77,1109,377,224,601,26,627
公投第１２案,基隆市,仁愛區,和明里,78,1684,604,330,934,36,970
公投第１２案,基隆市,仁愛區,忠勇里,79,919,267,213,480,32,512
公投第１２案,基隆市,仁愛區,玉田里,80,991,279,217,496,15,511
公投第１２案,基隆市,仁愛區,仁德里,81,876,281,190,471,15,486
公投第１２案,基隆市,仁愛區,博愛里,82,1046,336,246,582,32,614
公投第１２案,基隆市,仁愛區,博愛里,83,434,159,87,246,17,263
公投第１２案,基隆市,仁愛區,福仁里,84,764,259,156,415,39,454
公投第１２案,基隆市,仁愛區,誠仁里,85,968,303,181,484,19,503
公投第１２案,基隆市,仁愛區,吉仁里,86,1326,365,282,647,42,689
公投第１２案,基隆市,仁愛區,吉仁里,87,1315,307,238,545,35,580
公投第１２案,基隆市,仁愛區,育仁里,88,775,270,158,428,22,450
公投第１２案,基隆市,仁愛區,英仁里,89,652,193,156,349,27,376
公投第１２案,基隆市,仁愛區,英仁里,90,674,222,137,359,20,379
公投第１２案,基隆市,仁愛區,龍門里,91,789,292,94,386,27,413
公投第１２案,基隆市,仁愛區,德厚里,92,1715,521,332,853,51,904
公投第１２案,基隆市,仁愛區,曲水里,93,849,258,173,431,31,462
公投第１２案,基隆市,仁愛區,崇文里,94,875,294,173,467,20,487
公投第１２案,基隆市,仁愛區,文安里,95,851,228,177,405,29,434
公投第１２案,基隆市,仁愛區,兆連里,96,735,234,174,408,19,427
公投第１２案,基隆市,仁愛區,獅球里,97,1009,280,223,503,40,543
公投第１２案,基隆市,仁愛區,書院里,98,1082,325,179,504,37,541
公投第１２案,基隆市,仁愛區,朝棟里,99,1278,362,264,626,38,664
公投第１２案,基隆市,仁愛區,朝棟里,100,1519,526,310,836,40,876
公投第１２案,基隆市,仁愛區,光華里,101,1336,358,216,574,30,604
公投第１２案,基隆市,仁愛區,光華里,102,1178,420,260,680,26,706
公投第１２案,基隆市,仁愛區,明德里,103,708,210,143,353,29,382
公投第１２案,基隆市,仁愛區,同風里,104,567,203,134,337,18,355
公投第１２案,基隆市,仁愛區,文昌里,105,751,215,166,381,36,417
公投第１２案,基隆市,仁愛區,新店里,106,589,181,159,340,14,354
公投第１２案,基隆市,中山區,新建里,107,796,224,168,392,24,416
公投第１２案,基隆市,中山區,安民里,108,1036,398,206,604,38,642
公投第１２案,基隆市,中山區,安平里,109,756,271,152,423,19,442
公投第１２案,基隆市,中山區,中山里,110,957,258,201,459,18,477
公投第１２案,基隆市,中山區,民治里,111,802,266,165,431,9,440
公投第１２案,基隆市,中山區,中興里,112,1263,382,257,639,37,676
公投第１２案,基隆市,中山區,仁正里,113,778,251,176,427,21,448
公投第１２案,基隆市,中山區,健民里,114,1180,378,231,609,49,658
公投第１２案,基隆市,中山區,通化里,115,990,302,165,467,24,491
公投第１２案,基隆市,中山區,居仁里,116,1332,339,212,551,25,576
公投第１２案,基隆市,中山區,通明里,117,848,220,155,375,28,403
公投第１２案,基隆市,中山區,通明里,118,922,268,168,436,20,456
公投第１２案,基隆市,中山區,和平里,119,459,149,110,259,14,273
公投第１２案,基隆市,中山區,仙洞里,120,574,173,98,271,19,290
公投第１２案,基隆市,中山區,太白里,121,877,250,181,431,24,455
公投第１２案,基隆市,中山區,協和里,122,1584,402,307,709,16,725
公投第１２案,基隆市,中山區,文化里,123,1319,296,184,480,19,499
公投第１２案,基隆市,中山區,德安里,124,1938,553,400,953,47,1000
公投第１２案,基隆市,中山區,德安里,125,1877,495,389,884,27,911
公投第１２案,基隆市,中山區,德和里,126,2088,670,425,1095,32,1127
公投第１２案,基隆市,中山區,德和里,127,1946,603,423,1026,30,1056
公投第１２案,基隆市,中山區,德和里,128,1353,446,276,722,45,767
公投第１２案,基隆市,中山區,中和里,129,1317,397,262,659,37,696
公投第１２案,基隆市,中山區,中和里,130,870,262,215,477,20,497
公投第１２案,基隆市,中山區,中和里,131,1322,409,290,699,27,726
公投第１２案,基隆市,中山區,中和里,132,1295,358,243,601,13,614
公投第１２案,基隆市,中山區,中和里,133,756,269,157,426,34,460
公投第１２案,基隆市,中山區,和慶里,134,1602,431,293,724,24,748
公投第１２案,基隆市,中山區,和慶里,135,1568,452,274,726,27,753
公投第１２案,基隆市,中山區,和慶里,136,1404,455,258,713,23,736
公投第１２案,基隆市,中山區,和慶里,137,1909,581,337,918,26,944
公投第１２案,基隆市,中山區,西康里,138,1642,432,278,710,52,762
公投第１２案,基隆市,中山區,西定里,139,932,285,171,456,26,482
公投第１２案,基隆市,中山區,西華里,140,849,301,182,483,34,517
公投第１２案,基隆市,中山區,西榮里,141,715,217,179,396,31,427
公投第１２案,基隆市,安樂區,新西里,142,1361,390,239,629,52,681
公投第１２案,基隆市,安樂區,西川里,143,1213,354,231,585,22,607
公投第１２案,基隆市,安樂區,定國里,144,1026,273,172,445,23,468
公投第１２案,基隆市,安樂區,定邦里,145,1038,379,211,590,39,629
公投第１２案,基隆市,安樂區,慈仁里,146,897,247,223,470,50,520
公投第１２案,基隆市,安樂區,干城里,147,1401,431,276,707,42,749
公投第１２案,基隆市,安樂區,干城里,148,641,142,91,233,11,244
公投第１２案,基隆市,安樂區,永康里,149,1472,393,328,721,30,751
公投第１２案,基隆市,安樂區,永康里,150,472,143,105,248,16,264
公投第１２案,基隆市,安樂區,安和里,151,841,286,199,485,21,506
公投第１２案,基隆市,安樂區,樂一里,152,571,163,132,295,15,310
公投第１２案,基隆市,安樂區,嘉仁里,153,1901,542,396,938,31,969
公投第１２案,基隆市,安樂區,嘉仁里,154,1349,389,270,659,40,699
公投第１２案,基隆市,安樂區,三民里,155,1225,359,246,605,23,628
公投第１２案,基隆市,安樂區,三民里,156,1351,420,291,711,39,750
公投第１２案,基隆市,安樂區,壯觀里,157,1601,526,360,886,28,914
公投第１２案,基隆市,安樂區,壯觀里,158,2513,757,483,1240,31,1271
公投第１２案,基隆市,安樂區,四維里,159,1613,526,314,840,32,872
公投第１２案,基隆市,安樂區,四維里,160,1731,600,318,918,23,941
公投第１２案,基隆市,安樂區,四維里,161,1424,474,351,825,20,845
公投第１２案,基隆市,安樂區,五福里,162,1806,522,350,872,45,917
公投第１２案,基隆市,安樂區,五福里,163,1679,565,333,898,41,939
公投第１２案,基隆市,安樂區,六合里,164,1902,578,407,985,31,1016
公投第１２案,基隆市,安樂區,六合里,165,2040,572,440,1012,27,1039
公投第１２案,基隆市,安樂區,七賢里,166,1313,416,253,669,41,710
公投第１２案,基隆市,安樂區,七賢里,167,1243,256,242,498,26,524
公投第１２案,基隆市,安樂區,長樂里,168,1759,507,378,885,19,904
公投第１２案,基隆市,安樂區,長樂里,169,694,235,186,421,17,438
公投第１２案,基隆市,安樂區,長樂里,170,866,393,139,532,19,551
公投第１２案,基隆市,安樂區,鶯歌里,171,1557,410,259,669,17,686
公投第１２案,基隆市,安樂區,鶯歌里,172,1411,413,281,694,25,719
公投第１２案,基隆市,安樂區,鶯安里,173,1568,532,344,876,16,892
公投第１２案,基隆市,安樂區,鶯安里,174,1400,440,255,695,30,725
公投第１２案,基隆市,安樂區,鶯安里,175,1531,512,271,783,10,793
公投第１２案,基隆市,安樂區,興寮里,176,1673,464,337,801,21,822
公投第１２案,基隆市,安樂區,興寮里,177,1054,304,223,527,35,562
公投第１２案,基隆市,安樂區,興寮里,178,1923,490,312,802,25,827
公投第１２案,基隆市,安樂區,外寮里,179,1960,641,378,1019,34,1053
公投第１２案,基隆市,安樂區,外寮里,180,1962,518,296,814,138,952
公投第１２案,基隆市,安樂區,新崙里,181,2117,630,432,1062,38,1100
公投第１２案,基隆市,安樂區,新崙里,182,1829,461,390,851,36,887
公投第１２案,基隆市,安樂區,武崙里,183,1529,428,290,718,22,740
公投第１２案,基隆市,安樂區,武崙里,184,1869,555,377,932,22,954
公投第１２案,基隆市,安樂區,武崙里,185,1140,374,248,622,15,637
公投第１２案,基隆市,安樂區,中崙里,186,1641,445,373,818,32,850
公投第１２案,基隆市,安樂區,內寮里,187,1279,362,267,629,35,664
公投第１２案,基隆市,安樂區,內寮里,188,1360,395,290,685,18,703
公投第１２案,基隆市,安樂區,內寮里,189,1399,418,317,735,31,766
公投第１２案,基隆市,安樂區,內寮里,190,1251,375,251,626,19,645
公投第１２案,基隆市,暖暖區,八西里,191,1431,392,287,679,30,709
公投第１２案,基隆市,暖暖區,八中里,192,456,153,85,238,5,243
公投第１２案,基隆市,暖暖區,八堵里,193,637,218,129,347,17,364
公投第１２案,基隆市,暖暖區,八南里,194,735,264,156,420,23,443
公投第１２案,基隆市,暖暖區,過港里,195,1078,299,197,496,34,530
公投第１２案,基隆市,暖暖區,過港里,196,1238,333,254,587,33,620
公投第１２案,基隆市,暖暖區,過港里,197,1325,400,257,657,22,679
公投第１２案,基隆市,暖暖區,暖暖里,198,1475,466,298,764,32,796
公投第１２案,基隆市,暖暖區,暖暖里,199,1179,324,231,555,22,577
公投第１２案,基隆市,暖暖區,暖同里,200,1110,398,236,634,25,659
公投第１２案,基隆市,暖暖區,暖同里,201,1443,385,254,639,19,658
公投第１２案,基隆市,暖暖區,暖東里,202,415,114,101,215,11,226
公投第１２案,基隆市,暖暖區,暖西里,203,1378,397,281,678,16,694
公投第１２案,基隆市,暖暖區,暖西里,204,1570,472,318,790,32,822
公投第１２案,基隆市,暖暖區,暖西里,205,1603,565,331,896,47,943
公投第１２案,基隆市,暖暖區,碇內里,206,1267,399,308,707,28,735
公投第１２案,基隆市,暖暖區,碇內里,207,1359,421,269,690,28,718
公投第１２案,基隆市,暖暖區,碇和里,208,970,350,196,546,30,576
公投第１２案,基隆市,暖暖區,碇和里,209,1002,318,205,523,14,537
公投第１２案,基隆市,暖暖區,碇和里,210,944,280,184,464,25,489
公投第１２案,基隆市,暖暖區,碇祥里,211,1500,505,325,830,19,849
公投第１２案,基隆市,暖暖區,碇祥里,212,1442,360,225,585,14,599
公投第１２案,基隆市,暖暖區,碇祥里,213,1165,386,233,619,13,632
公投第１２案,基隆市,暖暖區,碇祥里,214,1610,508,293,801,24,825
公投第１２案,基隆市,暖暖區,碇安里,215,1328,436,283,719,22,741
公投第１２案,基隆市,暖暖區,碇安里,216,1173,396,224,620,10,630
公投第１２案,基隆市,暖暖區,碇安里,217,1019,331,248,579,27,606
公投第１２案,基隆市,暖暖區,碇安里,218,1373,455,286,741,18,759
公投第１２案,基隆市,七堵區,長興里,219,1258,480,218,698,38,736
公投第１２案,基隆市,七堵區,長興里,220,1237,377,286,663,32,695
公投第１２案,基隆市,七堵區,長興里,221,1259,388,261,649,19,668
公投第１２案,基隆市,七堵區,正光里,222,1120,334,211,545,34,579
公投第１２案,基隆市,七堵區,正光里,223,1344,392,217,609,46,655
公投第１２案,基隆市,七堵區,正明里,224,1011,370,219,589,32,621
公投第１２案,基隆市,七堵區,正明里,225,925,301,196,497,9,506
公投第１２案,基隆市,七堵區,富民里,226,1735,583,349,932,40,972
公投第１２案,基隆市,七堵區,富民里,227,1833,605,398,1003,35,1038
公投第１２案,基隆市,七堵區,永平里,228,938,309,209,518,18,536
公投第１２案,基隆市,七堵區,永平里,229,962,332,207,539,35,574
公投第１２案,基隆市,七堵區,永安里,230,1191,419,239,658,23,681
公投第１２案,基隆市,七堵區,永安里,231,999,323,224,547,29,576
公投第１２案,基隆市,七堵區,八德里,232,282,62,68,130,9,139
公投第１２案,基隆市,七堵區,八德里,233,1243,344,255,599,41,640
公投第１２案,基隆市,七堵區,自強里,234,1092,343,204,547,35,582
公投第１２案,基隆市,七堵區,泰安里,235,1246,378,268,646,25,671
公投第１２案,基隆市,七堵區,泰安里,236,1722,509,337,846,33,879
公投第１２案,基隆市,七堵區,泰安里,237,1318,392,292,684,32,716
公投第１２案,基隆市,七堵區,六堵里,238,975,303,154,457,22,479
公投第１２案,基隆市,七堵區,六堵里,239,1285,373,278,651,24,675
公投第１２案,基隆市,七堵區,堵南里,240,1077,300,181,481,40,521
公投第１２案,基隆市,七堵區,堵南里,241,989,283,163,446,26,472
公投第１２案,基隆市,七堵區,長安里,242,1193,342,230,572,26,598
公投第１２案,基隆市,七堵區,長安里,243,1273,367,266,633,31,664
公投第１２案,基隆市,七堵區,堵北里,244,1774,557,350,907,52,959
公投第１２案,基隆市,七堵區,堵北里,245,1689,498,358,856,52,908
公投第１２案,基隆市,七堵區,百福里,246,1355,477,187,664,29,693
公投第１２案,基隆市,七堵區,百福里,247,1512,500,235,735,33,768
公投第１２案,基隆市,七堵區,百福里,248,1486,437,280,717,18,735
公投第１２案,基隆市,七堵區,百福里,249,1706,515,328,843,29,872
公投第１２案,基隆市,七堵區,實踐里,250,1384,465,267,732,31,763
公投第１２案,基隆市,七堵區,實踐里,251,1045,389,218,607,26,633
公投第１２案,基隆市,七堵區,實踐里,252,1374,413,292,705,30,735
公投第１２案,基隆市,七堵區,瑪南里,253,428,148,83,231,5,236
公投第１２案,基隆市,七堵區,瑪東里,254,326,105,75,180,19,199
公投第１２案,基隆市,七堵區,瑪西里,255,351,155,88,243,9,252
公投第１２案,基隆市,七堵區,友一里,256,1871,530,353,883,18,901
公投第１２案,基隆市,七堵區,友二里,257,448,134,93,227,7,234
公投第１２案,新竹市,東區,育賢里,1,1512,289,213,502,16,518
公投第１２案,新竹市,東區,親仁里,2,953,346,218,564,21,585
公投第１２案,新竹市,東區,親仁里,3,729,266,140,406,16,422
公投第１２案,新竹市,東區,東門里,4,566,200,128,328,26,354
公投第１２案,新竹市,東區,成功里,5,640,208,158,366,17,383
公投第１２案,新竹市,東區,榮光里,6,305,92,65,157,16,173
公投第１２案,新竹市,東區,中正里,7,563,214,114,328,19,347
公投第１２案,新竹市,東區,錦華里,8,741,248,163,411,10,421
公投第１２案,新竹市,東區,錦華里,9,1041,355,245,600,13,613
公投第１２案,新竹市,東區,文華里,10,1615,524,318,842,30,872
公投第１２案,新竹市,東區,文華里,11,1287,443,272,715,32,747
公投第１２案,新竹市,東區,文華里,12,1554,541,326,867,31,898
公投第１２案,新竹市,東區,復中里,13,1388,474,335,809,16,825
公投第１２案,新竹市,東區,復中里,14,1419,519,306,825,26,851
公投第１２案,新竹市,東區,復中里,15,1355,434,289,723,34,757
公投第１２案,新竹市,東區,復興里,16,1490,488,323,811,33,844
公投第１２案,新竹市,東區,復興里,17,1615,537,359,896,25,921
公投第１２案,新竹市,東區,復興里,18,1672,567,381,948,23,971
公投第１２案,新竹市,東區,三民里,19,1062,343,256,599,27,626
公投第１２案,新竹市,東區,三民里,20,1315,443,285,728,25,753
公投第１２案,新竹市,東區,三民里,21,1000,355,203,558,37,595
公投第１２案,新竹市,東區,三民里,22,1337,472,294,766,33,799
公投第１２案,新竹市,東區,東園里,23,1747,563,365,928,23,951
公投第１２案,新竹市,東區,東園里,24,1600,555,383,938,20,958
公投第１２案,新竹市,東區,東園里,25,1158,372,248,620,36,656
公投第１２案,新竹市,東區,東園里,26,828,302,212,514,27,541
公投第１２案,新竹市,東區,公園里,27,1573,484,351,835,39,874
公投第１２案,新竹市,東區,公園里,28,1550,553,306,859,29,888
公投第１２案,新竹市,東區,建華里,29,1317,438,289,727,28,755
公投第１２案,新竹市,東區,建華里,30,1040,371,249,620,29,649
公投第１２案,新竹市,東區,東山里,31,935,374,177,551,16,567
公投第１２案,新竹市,東區,東山里,32,1074,359,235,594,22,616
公投第１２案,新竹市,東區,東山里,33,1133,412,257,669,30,699
公投第１２案,新竹市,東區,綠水里,34,1262,443,287,730,40,770
公投第１２案,新竹市,東區,綠水里,35,1199,426,237,663,27,690
公投第１２案,新竹市,東區,綠水里,36,1226,462,273,735,34,769
公投第１２案,新竹市,東區,綠水里,37,1377,516,338,854,31,885
公投第１２案,新竹市,東區,綠水里,38,991,373,246,619,17,636
公投第１２案,新竹市,東區,東勢里,39,1271,445,273,718,44,762
公投第１２案,新竹市,東區,東勢里,40,1012,395,234,629,24,653
公投第１２案,新竹市,東區,光復里,41,1001,350,206,556,33,589
公投第１２案,新竹市,東區,光復里,42,1603,486,334,820,44,864
公投第１２案,新竹市,東區,前溪里,43,1236,380,288,668,34,702
公投第１２案,新竹市,東區,前溪里,44,1532,455,263,718,29,747
公投第１２案,新竹市,東區,水源里,45,1306,455,264,719,29,748
公投第１２案,新竹市,東區,水源里,46,1073,342,251,593,39,632
公投第１２案,新竹市,東區,水源里,47,952,318,211,529,20,549
公投第１２案,新竹市,東區,千甲里,48,1298,400,241,641,30,671
公投第１２案,新竹市,東區,千甲里,49,778,272,166,438,14,452
公投第１２案,新竹市,東區,豐功里,50,1195,392,281,673,31,704
公投第１２案,新竹市,東區,豐功里,51,1569,516,296,812,56,868
公投第１２案,新竹市,東區,豐功里,52,1533,543,386,929,33,962
公投第１２案,新竹市,東區,武功里,53,1336,533,255,788,27,815
公投第１２案,新竹市,東區,武功里,54,1367,515,267,782,30,812
公投第１２案,新竹市,東區,武功里,55,1289,490,266,756,33,789
公投第１２案,新竹市,東區,軍功里,56,960,329,205,534,15,549
公投第１２案,新竹市,東區,軍功里,57,843,329,190,519,20,539
公投第１２案,新竹市,東區,軍功里,58,948,349,207,556,23,579
公投第１２案,新竹市,東區,立功里,59,915,326,167,493,29,522
公投第１２案,新竹市,東區,建功里,60,1801,646,364,1010,35,1045
公投第１２案,新竹市,東區,建功里,61,1079,373,239,612,21,633
公投第１２案,新竹市,東區,建功里,62,676,273,143,416,8,424
公投第１２案,新竹市,東區,光明里,63,1132,385,246,631,46,677
公投第１２案,新竹市,東區,光明里,64,251,77,68,145,7,152
公投第１２案,新竹市,東區,光明里,65,1620,577,320,897,33,930
公投第１２案,新竹市,東區,龍山里,66,1479,444,332,776,25,801
公投第１２案,新竹市,東區,龍山里,67,1402,404,333,737,19,756
公投第１２案,新竹市,東區,龍山里,68,1280,410,274,684,38,722
公投第１２案,新竹市,東區,龍山里,69,1228,393,321,714,18,732
公投第１２案,新竹市,東區,龍山里,70,1157,333,298,631,7,638
公投第１２案,新竹市,東區,龍山里,71,1354,449,288,737,30,767
公投第１２案,新竹市,東區,科園里,72,1334,504,338,842,25,867
公投第１２案,新竹市,東區,科園里,73,1234,438,298,736,29,765
公投第１２案,新竹市,東區,科園里,74,1398,540,325,865,29,894
公投第１２案,新竹市,東區,科園里,75,928,339,214,553,18,571
公投第１２案,新竹市,東區,科園里,76,1368,503,329,832,25,857
公投第１２案,新竹市,東區,埔頂里,77,1215,381,289,670,20,690
公投第１２案,新竹市,東區,埔頂里,78,1067,328,226,554,21,575
公投第１２案,新竹市,東區,埔頂里,79,1194,322,320,642,19,661
公投第１２案,新竹市,東區,埔頂里,80,1193,339,287,626,17,643
公投第１２案,新竹市,東區,新莊里,81,1388,438,318,756,53,809
公投第１２案,新竹市,東區,新莊里,82,1267,466,256,722,31,753
公投第１２案,新竹市,東區,新莊里,83,1299,424,294,718,21,739
公投第１２案,新竹市,東區,新莊里,84,1288,418,298,716,25,741
公投第１２案,新竹市,東區,關新里,85,1228,395,338,733,17,750
公投第１２案,新竹市,東區,關新里,86,1135,375,309,684,10,694
公投第１２案,新竹市,東區,關新里,87,1237,421,345,766,21,787
公投第１２案,新竹市,東區,關東里,88,1135,357,229,586,31,617
公投第１２案,新竹市,東區,關東里,89,1165,393,198,591,26,617
公投第１２案,新竹市,東區,關東里,90,1124,377,232,609,24,633
公投第１２案,新竹市,東區,關東里,91,1210,411,276,687,25,712
公投第１２案,新竹市,東區,金山里,92,1323,423,260,683,34,717
公投第１２案,新竹市,東區,金山里,93,1207,398,234,632,33,665
公投第１２案,新竹市,東區,金山里,94,1264,380,241,621,26,647
公投第１２案,新竹市,東區,金山里,95,1248,371,298,669,17,686
公投第１２案,新竹市,東區,仙水里,96,1400,503,336,839,27,866
公投第１２案,新竹市,東區,仙水里,97,1473,491,370,861,24,885
公投第１２案,新竹市,東區,仙水里,98,1367,439,298,737,29,766
公投第１２案,新竹市,東區,仙宮里,99,1233,423,288,711,18,729
公投第１２案,新竹市,東區,關帝里,100,507,181,96,277,11,288
公投第１２案,新竹市,東區,南門里,101,714,248,154,402,23,425
公投第１２案,新竹市,東區,南市里,102,875,300,193,493,24,517
公投第１２案,新竹市,東區,福德里,103,1396,490,276,766,35,801
公投第１２案,新竹市,東區,振興里,104,1232,383,262,645,31,676
公投第１２案,新竹市,東區,振興里,105,1323,385,302,687,33,720
公投第１２案,新竹市,東區,振興里,106,1516,435,285,720,15,735
公投第１２案,新竹市,東區,振興里,107,1453,427,294,721,24,745
公投第１２案,新竹市,東區,新興里,108,880,315,173,488,29,517
公投第１２案,新竹市,東區,新興里,109,1058,373,200,573,21,594
公投第１２案,新竹市,東區,新興里,110,1061,346,230,576,24,600
公投第１２案,新竹市,東區,寺前里,111,710,254,135,389,34,423
公投第１２案,新竹市,東區,竹蓮里,112,752,275,152,427,35,462
公投第１２案,新竹市,東區,下竹里,113,475,168,120,288,15,303
公投第１２案,新竹市,東區,頂竹里,114,880,280,172,452,32,484
公投第１２案,新竹市,東區,頂竹里,115,989,320,243,563,22,585
公投第１２案,新竹市,東區,頂竹里,116,1059,354,221,575,38,613
公投第１２案,新竹市,東區,南大里,117,607,217,126,343,28,371
公投第１２案,新竹市,東區,南大里,118,815,273,170,443,35,478
公投第１２案,新竹市,東區,新光里,119,777,298,160,458,27,485
公投第１２案,新竹市,東區,新光里,120,1399,402,275,677,34,711
公投第１２案,新竹市,東區,新光里,121,1216,394,261,655,26,681
公投第１２案,新竹市,東區,光鎮里,122,1062,332,198,530,30,560
公投第１２案,新竹市,東區,光鎮里,123,1046,371,235,606,19,625
公投第１２案,新竹市,東區,光鎮里,124,1332,428,270,698,13,711
公投第１２案,新竹市,東區,高峰里,125,1350,421,313,734,37,771
公投第１２案,新竹市,東區,高峰里,126,1438,471,267,738,18,756
公投第１２案,新竹市,東區,高峰里,127,1414,472,253,725,29,754
公投第１２案,新竹市,東區,高峰里,128,1476,502,336,838,29,867
公投第１２案,新竹市,東區,湖濱里,129,1326,479,298,777,40,817
公投第１２案,新竹市,東區,湖濱里,130,927,361,219,580,21,601
公投第１２案,新竹市,東區,湖濱里,131,1273,427,277,704,32,736
公投第１２案,新竹市,東區,柴橋里,132,1315,399,278,677,30,707
公投第１２案,新竹市,東區,柴橋里,133,1413,471,309,780,35,815
公投第１２案,新竹市,東區,柴橋里,134,1064,344,236,580,28,608
公投第１２案,新竹市,東區,柴橋里,135,1244,466,293,759,24,783
公投第１２案,新竹市,東區,明湖里,136,1160,380,230,610,4,614
公投第１２案,新竹市,東區,明湖里,137,1398,410,280,690,15,705
公投第１２案,新竹市,東區,明湖里,138,1384,336,217,553,18,571
公投第１２案,新竹市,東區,明湖里,139,874,297,214,511,29,540
公投第１２案,新竹市,北區,中央里,140,477,147,108,255,14,269
公投第１２案,新竹市,北區,西門里,141,535,201,108,309,19,328
公投第１２案,新竹市,北區,潛園里,142,746,246,162,408,40,448
公投第１２案,新竹市,北區,石坊里,143,546,171,116,287,15,302
公投第１２案,新竹市,北區,仁德里,144,711,236,179,415,27,442
公投第１２案,新竹市,北區,崇禮里,145,1143,362,226,588,28,616
公投第１２案,新竹市,北區,興南里,146,1370,435,269,704,30,734
公投第１２案,新竹市,北區,育英里,147,1390,455,271,726,32,758
公投第１２案,新竹市,北區,育英里,148,962,336,201,537,17,554
公投第１２案,新竹市,北區,育英里,149,1237,397,278,675,18,693
公投第１２案,新竹市,北區,台溪里,150,1604,446,300,746,52,798
公投第１２案,新竹市,北區,曲溪里,151,758,241,123,364,24,388
公投第１２案,新竹市,北區,曲溪里,152,1320,429,236,665,29,694
公投第１２案,新竹市,北區,曲溪里,153,1519,452,276,728,48,776
公投第１２案,新竹市,北區,曲溪里,154,347,82,47,129,5,134
公投第１２案,新竹市,北區,曲溪里,155,1212,427,270,697,25,722
公投第１２案,新竹市,北區,西雅里,156,1484,479,306,785,30,815
公投第１２案,新竹市,北區,西雅里,157,1428,434,316,750,43,793
公投第１２案,新竹市,北區,客雅里,158,1128,426,214,640,24,664
公投第１２案,新竹市,北區,客雅里,159,638,199,151,350,12,362
公投第１２案,新竹市,北區,中雅里,160,1222,462,215,677,39,716
公投第１２案,新竹市,北區,中雅里,161,1076,346,223,569,19,588
公投第１２案,新竹市,北區,中雅里,162,937,379,216,595,22,617
公投第１２案,新竹市,北區,南勢里,163,1394,428,297,725,47,772
公投第１２案,新竹市,北區,南勢里,164,1568,471,328,799,20,819
公投第１２案,新竹市,北區,南勢里,165,1159,386,283,669,38,707
公投第１２案,新竹市,北區,大鵬里,166,252,58,46,104,1,105
公投第１２案,新竹市,北區,大同里,167,761,280,191,471,12,483
公投第１２案,新竹市,北區,中山里,168,788,245,202,447,26,473
公投第１２案,新竹市,北區,中興里,169,561,215,123,338,24,362
公投第１２案,新竹市,北區,新民里,170,1558,450,312,762,68,830
公投第１２案,新竹市,北區,長和里,171,1398,390,296,686,26,712
公投第１２案,新竹市,北區,北門里,172,957,308,197,505,29,534
公投第１２案,新竹市,北區,民富里,173,1195,411,259,670,31,701
公投第１２案,新竹市,北區,民富里,174,1236,353,240,593,23,616
公投第１２案,新竹市,北區,民富里,175,1255,351,275,626,44,670
公投第１２案,新竹市,北區,民富里,176,1114,360,249,609,33,642
公投第１２案,新竹市,北區,磐石里,177,1396,437,314,751,28,779
公投第１２案,新竹市,北區,磐石里,178,1456,508,299,807,30,837
公投第１２案,新竹市,北區,磐石里,179,1374,445,291,736,21,757
公投第１２案,新竹市,北區,磐石里,180,1070,326,217,543,33,576
公投第１２案,新竹市,北區,新雅里,181,1142,365,237,602,44,646
公投第１２案,新竹市,北區,新雅里,182,1103,332,241,573,23,596
公投第１２案,新竹市,北區,新雅里,183,1190,392,248,640,41,681
公投第１２案,新竹市,北區,新雅里,184,1089,411,245,656,21,677
公投第１２案,新竹市,北區,文雅里,185,1272,380,223,603,17,620
公投第１２案,新竹市,北區,文雅里,186,1306,434,271,705,46,751
公投第１２案,新竹市,北區,文雅里,187,1328,416,305,721,26,747
公投第１２案,新竹市,北區,水田里,188,1457,437,303,740,33,773
公投第１２案,新竹市,北區,水田里,189,1492,483,311,794,38,832
公投第１２案,新竹市,北區,光田里,190,1160,387,270,657,46,703
公投第１２案,新竹市,北區,光田里,191,971,324,203,527,48,575
公投第１２案,新竹市,北區,光華里,192,1401,263,170,433,21,454
公投第１２案,新竹市,北區,光華里,193,1340,429,316,745,29,774
公投第１２案,新竹市,北區,光華里,194,1371,456,340,796,24,820
公投第１２案,新竹市,北區,金華里,195,1267,393,290,683,27,710
公投第１２案,新竹市,北區,金華里,196,1073,409,250,659,20,679
公投第１２案,新竹市,北區,金華里,197,1159,401,254,655,24,679
公投第１２案,新竹市,北區,金華里,198,1294,430,282,712,21,733
公投第１２案,新竹市,北區,湳雅里,199,1442,507,273,780,23,803
公投第１２案,新竹市,北區,湳雅里,200,1270,433,295,728,22,750
公投第１２案,新竹市,北區,金雅里,201,1179,476,278,754,19,773
公投第１２案,新竹市,北區,金雅里,202,949,363,210,573,27,600
公投第１２案,新竹市,北區,湳中里,203,1163,384,267,651,31,682
公投第１２案,新竹市,北區,湳中里,204,1334,419,310,729,14,743
公投第１２案,新竹市,北區,湳中里,205,1415,453,314,767,32,799
公投第１２案,新竹市,北區,湳中里,206,1305,463,310,773,21,794
公投第１２案,新竹市,北區,湳中里,207,1200,402,254,656,26,682
公投第１２案,新竹市,北區,舊社里,208,1106,340,280,620,36,656
公投第１２案,新竹市,北區,舊社里,209,1044,371,132,503,25,528
公投第１２案,新竹市,北區,舊社里,210,1061,357,247,604,25,629
公投第１２案,新竹市,北區,舊社里,211,1518,514,330,844,58,902
公投第１２案,新竹市,北區,舊社里,212,1220,438,295,733,26,759
公投第１２案,新竹市,北區,金竹里,213,1475,502,350,852,13,865
公投第１２案,新竹市,北區,金竹里,214,1373,462,251,713,37,750
公投第１２案,新竹市,北區,金竹里,215,1450,533,290,823,24,847
公投第１２案,新竹市,北區,金竹里,216,1423,506,299,805,24,829
公投第１２案,新竹市,北區,武陵里,217,1059,403,192,595,17,612
公投第１２案,新竹市,北區,武陵里,218,1130,430,223,653,34,687
公投第１２案,新竹市,北區,武陵里,219,1208,474,246,720,31,751
公投第１２案,新竹市,北區,武陵里,220,1226,503,225,728,33,761
公投第１２案,新竹市,北區,福林里,221,1175,406,256,662,28,690
公投第１２案,新竹市,北區,福林里,222,1371,385,386,771,28,799
公投第１２案,新竹市,北區,福林里,223,1306,438,244,682,38,720
公投第１２案,新竹市,北區,境福里,224,1340,460,249,709,24,733
公投第１２案,新竹市,北區,境福里,225,1111,370,277,647,39,686
公投第１２案,新竹市,北區,境福里,226,1197,458,273,731,37,768
公投第１２案,新竹市,北區,境福里,227,1008,371,188,559,26,585
公投第１２案,新竹市,北區,士林里,228,946,331,184,515,13,528
公投第１２案,新竹市,北區,士林里,229,705,253,143,396,34,430
公投第１２案,新竹市,北區,古賢里,230,848,277,176,453,54,507
公投第１２案,新竹市,北區,南寮里,231,1295,389,276,665,34,699
公投第１２案,新竹市,北區,南寮里,232,1467,457,279,736,28,764
公投第１２案,新竹市,北區,南寮里,233,1659,427,318,745,35,780
公投第１２案,新竹市,北區,南寮里,234,1297,403,254,657,27,684
公投第１２案,新竹市,北區,康樂里,235,1374,475,272,747,44,791
公投第１２案,新竹市,北區,康樂里,236,1457,499,299,798,45,843
公投第１２案,新竹市,北區,中寮里,237,1072,377,229,606,27,633
公投第１２案,新竹市,北區,中寮里,238,1350,405,287,692,36,728
公投第１２案,新竹市,北區,中寮里,239,971,341,246,587,23,610
公投第１２案,新竹市,北區,海濱里,240,1450,486,303,789,62,851
公投第１２案,新竹市,北區,海濱里,241,895,298,195,493,18,511
公投第１２案,新竹市,北區,海濱里,242,1378,452,280,732,25,757
公投第１２案,新竹市,北區,港北里,243,1609,461,322,783,64,847
公投第１２案,新竹市,北區,舊港里,244,594,179,135,314,33,347
公投第１２案,新竹市,香山區,頂埔里,245,1443,472,282,754,29,783
公投第１２案,新竹市,香山區,頂埔里,246,1241,371,290,661,23,684
公投第１２案,新竹市,香山區,頂埔里,247,1194,371,265,636,26,662
公投第１２案,新竹市,香山區,頂埔里,248,1081,358,237,595,8,603
公投第１２案,新竹市,香山區,頂福里,249,807,274,188,462,18,480
公投第１２案,新竹市,香山區,頂福里,250,1760,541,371,912,46,958
公投第１２案,新竹市,香山區,頂福里,251,1635,532,344,876,38,914
公投第１２案,新竹市,香山區,中埔里,252,1473,516,319,835,34,869
公投第１２案,新竹市,香山區,中埔里,253,1408,505,287,792,15,807
公投第１２案,新竹市,香山區,牛埔里,254,1318,397,228,625,26,651
公投第１２案,新竹市,香山區,牛埔里,255,1337,461,260,721,36,757
公投第１２案,新竹市,香山區,牛埔里,256,1862,542,387,929,26,955
公投第１２案,新竹市,香山區,埔前里,257,1067,364,220,584,22,606
公投第１２案,新竹市,香山區,埔前里,258,863,306,189,495,34,529
公投第１２案,新竹市,香山區,埔前里,259,1198,425,273,698,42,740
公投第１２案,新竹市,香山區,樹下里,260,1138,371,279,650,44,694
公投第１２案,新竹市,香山區,樹下里,261,957,360,224,584,43,627
公投第１２案,新竹市,香山區,浸水里,262,1348,470,283,753,46,799
公投第１２案,新竹市,香山區,浸水里,263,1023,385,254,639,50,689
公投第１２案,新竹市,香山區,虎林里,264,970,357,177,534,23,557
公投第１２案,新竹市,香山區,虎林里,265,1318,441,290,731,38,769
公投第１２案,新竹市,香山區,虎山里,266,1088,304,265,569,39,608
公投第１２案,新竹市,香山區,虎山里,267,903,285,168,453,16,469
公投第１２案,新竹市,香山區,虎山里,268,1012,330,238,568,29,597
公投第１２案,新竹市,香山區,虎山里,269,1014,354,190,544,35,579
公投第１２案,新竹市,香山區,虎山里,270,1238,438,265,703,31,734
公投第１２案,新竹市,香山區,港南里,271,1182,351,264,615,44,659
公投第１２案,新竹市,香山區,港南里,272,1331,506,296,802,52,854
公投第１２案,新竹市,香山區,東香里,273,976,382,231,613,16,629
公投第１２案,新竹市,香山區,東香里,274,834,268,180,448,17,465
公投第１２案,新竹市,香山區,東香里,275,919,312,189,501,31,532
公投第１２案,新竹市,香山區,東香里,276,1188,397,279,676,27,703
公投第１２案,新竹市,香山區,香村里,277,1086,365,235,600,39,639
公投第１２案,新竹市,香山區,香村里,278,1144,444,242,686,27,713
公投第１２案,新竹市,香山區,香村里,279,1112,402,229,631,37,668
公投第１２案,新竹市,香山區,香山里,280,1476,513,298,811,44,855
公投第１２案,新竹市,香山區,香山里,281,1291,451,253,704,30,734
公投第１２案,新竹市,香山區,香山里,282,1464,556,320,876,31,907
公投第１２案,新竹市,香山區,大庄里,283,1427,523,278,801,48,849
公投第１２案,新竹市,香山區,大庄里,284,1336,428,284,712,36,748
公投第１２案,新竹市,香山區,美山里,285,1131,306,223,529,31,560
公投第１２案,新竹市,香山區,朝山里,286,1070,377,232,609,42,651
公投第１２案,新竹市,香山區,朝山里,287,1006,357,219,576,43,619
公投第１２案,新竹市,香山區,海山里,288,1223,355,194,549,49,598
公投第１２案,新竹市,香山區,海山里,289,1119,384,218,602,27,629
公投第１２案,新竹市,香山區,鹽水里,290,1400,402,289,691,36,727
公投第１２案,新竹市,香山區,內湖里,291,1627,449,290,739,38,777
公投第１２案,新竹市,香山區,內湖里,292,1289,396,219,615,36,651
公投第１２案,新竹市,香山區,內湖里,293,1409,406,281,687,28,715
公投第１２案,新竹市,香山區,南港里,294,814,244,153,397,28,425
公投第１２案,新竹市,香山區,中隘里,295,719,221,154,375,31,406
公投第１２案,新竹市,香山區,中隘里,296,1065,303,201,504,16,520
公投第１２案,新竹市,香山區,南隘里,297,776,247,159,406,32,438
公投第１２案,新竹市,香山區,大湖里,298,890,292,192,484,28,512
公投第１２案,新竹市,香山區,茄苳里,299,896,247,198,445,23,468
公投第１２案,嘉義市,東區,短竹里,1,1025,359,214,573,20,593
公投第１２案,嘉義市,東區,短竹里,2,1276,419,245,664,21,685
公投第１２案,嘉義市,東區,蘭潭里,3,974,301,179,480,22,502
公投第１２案,嘉義市,東區,蘭潭里,4,1175,423,280,703,20,723
公投第１２案,嘉義市,東區,東川里,5,702,283,148,431,9,440
公投第１２案,嘉義市,東區,東川里,6,1092,368,218,586,22,608
公投第１２案,嘉義市,東區,鹿寮里,7,1023,294,182,476,22,498
公投第１２案,嘉義市,東區,盧厝里,8,1816,612,296,908,30,938
公投第１２案,嘉義市,東區,文雅里,9,1936,626,401,1027,42,1069
公投第１２案,嘉義市,東區,文雅里,10,1698,554,385,939,20,959
公投第１２案,嘉義市,東區,王田里,11,1221,449,277,726,13,739
公投第１２案,嘉義市,東區,王田里,12,1113,390,246,636,11,647
公投第１２案,嘉義市,東區,長竹里,13,1452,486,319,805,27,832
公投第１２案,嘉義市,東區,長竹里,14,1395,506,325,831,27,858
公投第１２案,嘉義市,東區,後庄里,15,1453,458,288,746,24,770
公投第１２案,嘉義市,東區,後庄里,16,1094,383,193,576,17,593
公投第１２案,嘉義市,東區,後庄里,17,1420,515,278,793,23,816
公投第１２案,嘉義市,東區,新店里,18,1552,553,328,881,34,915
公投第１２案,嘉義市,東區,新店里,19,1558,516,342,858,33,891
公投第１２案,嘉義市,東區,新店里,20,1062,386,229,615,18,633
公投第１２案,嘉義市,東區,圳頭里,21,1199,404,223,627,24,651
公投第１２案,嘉義市,東區,圳頭里,22,1236,463,210,673,24,697
公投第１２案,嘉義市,東區,圳頭里,23,890,286,194,480,22,502
公投第１２案,嘉義市,東區,圳頭里,24,880,315,186,501,35,536
公投第１２案,嘉義市,東區,中山里,25,1189,409,250,659,18,677
公投第１２案,嘉義市,東區,中山里,26,669,221,158,379,17,396
公投第１２案,嘉義市,東區,太平里,27,1435,473,292,765,26,791
公投第１２案,嘉義市,東區,太平里,28,1349,491,307,798,20,818
公投第１２案,嘉義市,東區,太平里,29,1455,454,301,755,18,773
公投第１２案,嘉義市,東區,東興里,30,915,296,215,511,23,534
公投第１２案,嘉義市,東區,東興里,31,952,339,199,538,17,555
公投第１２案,嘉義市,東區,華南里,32,941,314,194,508,24,532
公投第１２案,嘉義市,東區,華南里,33,1080,370,210,580,17,597
公投第１２案,嘉義市,東區,中央里,34,1157,372,217,589,26,615
公投第１２案,嘉義市,東區,中央里,35,1053,389,220,609,24,633
公投第１２案,嘉義市,東區,朝陽里,36,967,270,208,478,22,500
公投第１２案,嘉義市,東區,朝陽里,37,1091,328,240,568,22,590
公投第１２案,嘉義市,東區,民族里,38,961,329,227,556,26,582
公投第１２案,嘉義市,東區,民族里,39,863,205,138,343,17,360
公投第１２案,嘉義市,東區,過溝里,40,1023,339,244,583,31,614
公投第１２案,嘉義市,東區,過溝里,41,1078,382,226,608,40,648
公投第１２案,嘉義市,東區,新開里,42,938,306,197,503,20,523
公投第１２案,嘉義市,東區,新開里,43,1049,331,245,576,17,593
公投第１２案,嘉義市,東區,宣信里,44,1360,437,242,679,38,717
公投第１２案,嘉義市,東區,興南里,45,1615,498,274,772,48,820
公投第１２案,嘉義市,東區,豐年里,46,1267,400,251,651,30,681
公投第１２案,嘉義市,東區,芳草里,47,1579,467,267,734,38,772
公投第１２案,嘉義市,東區,芳草里,48,1831,538,359,897,46,943
公投第１２案,嘉義市,東區,芳安里,49,977,359,183,542,24,566
公投第１２案,嘉義市,東區,芳安里,50,1169,378,239,617,22,639
公投第１２案,嘉義市,東區,頂寮里,51,1238,495,201,696,48,744
公投第１２案,嘉義市,東區,頂寮里,52,1266,439,267,706,24,730
公投第１２案,嘉義市,東區,安寮里,53,1429,460,205,665,28,693
公投第１２案,嘉義市,東區,安寮里,54,1288,432,273,705,22,727
公投第１２案,嘉義市,東區,安業里,55,980,302,212,514,29,543
公投第１２案,嘉義市,東區,安業里,56,922,303,161,464,21,485
公投第１２案,嘉義市,東區,興村里,57,1133,388,237,625,33,658
公投第１２案,嘉義市,東區,興村里,58,1235,408,257,665,32,697
公投第１２案,嘉義市,東區,興村里,59,1525,506,309,815,16,831
公投第１２案,嘉義市,東區,興安里,60,1170,345,246,591,22,613
公投第１２案,嘉義市,東區,興安里,61,1177,412,296,708,33,741
公投第１２案,嘉義市,東區,興仁里,62,1207,408,246,654,34,688
公投第１２案,嘉義市,東區,興仁里,63,1272,434,264,698,26,724
公投第１２案,嘉義市,東區,興仁里,64,1188,380,236,616,59,675
公投第１２案,嘉義市,東區,北門里,65,1172,344,236,580,18,598
公投第１２案,嘉義市,東區,北門里,66,1020,327,256,583,20,603
公投第１２案,嘉義市,東區,林森里,67,1332,452,284,736,30,766
公投第１２案,嘉義市,東區,林森里,68,1011,370,231,601,24,625
公投第１２案,嘉義市,東區,中庄里,69,1682,553,299,852,33,885
公投第１２案,嘉義市,東區,中庄里,70,1567,527,295,822,45,867
公投第１２案,嘉義市,東區,頂庄里,71,1207,439,239,678,13,691
公投第１２案,嘉義市,東區,頂庄里,72,981,406,196,602,12,614
公投第１２案,嘉義市,東區,義教里,73,1395,464,263,727,28,755
公投第１２案,嘉義市,東區,義教里,74,1434,413,266,679,25,704
公投第１２案,嘉義市,東區,仁義里,75,1404,409,223,632,16,648
公投第１２案,嘉義市,東區,仁義里,76,1428,520,283,803,21,824
公投第１２案,嘉義市,東區,後湖里,77,1823,505,278,783,17,800
公投第１２案,嘉義市,東區,後湖里,78,1570,452,304,756,29,785
公投第１２案,嘉義市,東區,荖藤里,79,1282,421,247,668,27,695
公投第１２案,嘉義市,東區,荖藤里,80,1571,566,330,896,33,929
公投第１２案,嘉義市,東區,荖藤里,81,1533,482,299,781,24,805
公投第１２案,嘉義市,西區,書院里,82,885,292,192,484,12,496
公投第１２案,嘉義市,西區,書院里,83,1109,358,213,571,34,605
公投第１２案,嘉義市,西區,永和里,84,1020,340,187,527,28,555
公投第１２案,嘉義市,西區,永和里,85,925,360,188,548,34,582
公投第１２案,嘉義市,西區,新富里,86,1671,479,310,789,22,811
公投第１２案,嘉義市,西區,文化里,87,1215,439,241,680,17,697
公投第１２案,嘉義市,西區,文化里,88,1036,362,211,573,18,591
公投第１２案,嘉義市,西區,西榮里,89,1129,340,244,584,18,602
公投第１２案,嘉義市,西區,西榮里,90,1127,370,221,591,28,619
公投第１２案,嘉義市,西區,番社里,91,1415,506,292,798,26,824
公投第１２案,嘉義市,西區,國華里,92,1366,458,239,697,26,723
公投第１２案,嘉義市,西區,大溪里,93,1053,403,212,615,32,647
公投第１２案,嘉義市,西區,大溪里,94,1067,417,185,602,16,618
公投第１２案,嘉義市,西區,磚磘里,95,1575,480,270,750,23,773
公投第１２案,嘉義市,西區,磚磘里,96,1865,603,353,956,28,984
公投第１２案,嘉義市,西區,福全里,97,1196,357,246,603,30,633
公投第１２案,嘉義市,西區,福全里,98,1280,374,260,634,25,659
公投第１２案,嘉義市,西區,福全里,99,1629,522,322,844,38,882
公投第１２案,嘉義市,西區,福安里,100,1393,410,309,719,52,771
公投第１２案,嘉義市,西區,福安里,101,1077,386,243,629,31,660
公投第１２案,嘉義市,西區,福安里,102,1694,461,329,790,12,802
公投第１２案,嘉義市,西區,新西里,103,841,282,197,479,47,526
公投第１２案,嘉義市,西區,新西里,104,1183,362,233,595,6,601
公投第１２案,嘉義市,西區,港坪里,105,1000,381,232,613,19,632
公投第１２案,嘉義市,西區,港坪里,106,1095,416,248,664,16,680
公投第１２案,嘉義市,西區,港坪里,107,1256,444,294,738,29,767
公投第１２案,嘉義市,西區,頭港里,108,962,318,212,530,33,563
公投第１２案,嘉義市,西區,頭港里,109,865,330,225,555,6,561
公投第１２案,嘉義市,西區,西平里,110,1396,403,321,724,28,752
公投第１２案,嘉義市,西區,西平里,111,1799,573,378,951,39,990
公投第１２案,嘉義市,西區,劉厝里,112,1505,469,284,753,18,771
公投第１２案,嘉義市,西區,劉厝里,113,1698,571,312,883,37,920
公投第１２案,嘉義市,西區,劉厝里,114,1854,619,383,1002,34,1036
公投第１２案,嘉義市,西區,劉厝里,115,1537,412,275,687,10,697
公投第１２案,嘉義市,西區,自強里,116,1604,503,290,793,35,828
公投第１２案,嘉義市,西區,美源里,117,944,348,214,562,42,604
公投第１２案,嘉義市,西區,美源里,118,1627,599,294,893,47,940
公投第１２案,嘉義市,西區,美源里,119,1144,403,255,658,26,684
公投第１２案,嘉義市,西區,湖內里,120,1362,457,255,712,40,752
公投第１２案,嘉義市,西區,湖內里,121,1279,445,293,738,23,761
公投第１２案,嘉義市,西區,湖內里,122,1702,554,357,911,39,950
公投第１２案,嘉義市,西區,獅子里,123,1358,451,319,770,33,803
公投第１２案,嘉義市,西區,獅子里,124,1360,474,310,784,48,832
公投第１２案,嘉義市,西區,紅瓦里,125,1589,547,318,865,39,904
公投第１２案,嘉義市,西區,光路里,126,1280,474,274,748,25,773
公投第１２案,嘉義市,西區,光路里,127,1220,364,240,604,21,625
公投第１２案,嘉義市,西區,光路里,128,1172,444,233,677,18,695
公投第１２案,嘉義市,西區,光路里,129,1320,453,279,732,24,756
公投第１２案,嘉義市,西區,福民里,130,1185,483,264,747,31,778
公投第１２案,嘉義市,西區,福民里,131,1278,475,291,766,26,792
公投第１２案,嘉義市,西區,福民里,132,1394,360,250,610,22,632
公投第１２案,嘉義市,西區,福民里,133,1540,511,333,844,44,888
公投第１２案,嘉義市,西區,車店里,134,1548,540,302,842,33,875
公投第１２案,嘉義市,西區,車店里,135,1295,510,167,677,27,704
公投第１２案,嘉義市,西區,車店里,136,1318,478,283,761,38,799
公投第１２案,嘉義市,西區,車店里,137,1545,513,321,834,29,863
公投第１２案,嘉義市,西區,垂楊里,138,736,249,134,383,13,396
公投第１２案,嘉義市,西區,垂楊里,139,1168,387,226,613,13,626
公投第１２案,嘉義市,西區,培元里,140,756,325,159,484,16,500
公投第１２案,嘉義市,西區,培元里,141,869,335,154,489,14,503
公投第１２案,嘉義市,西區,育英里,142,983,355,207,562,24,586
公投第１２案,嘉義市,西區,育英里,143,828,312,150,462,16,478
公投第１２案,嘉義市,西區,致遠里,144,1775,631,311,942,37,979
公投第１２案,嘉義市,西區,翠岱里,145,1419,504,234,738,28,766
公投第１２案,嘉義市,西區,導明里,146,779,275,157,432,11,443
公投第１２案,嘉義市,西區,導明里,147,855,289,158,447,13,460
公投第１２案,嘉義市,西區,北榮里,148,1146,401,231,632,41,673
公投第１２案,嘉義市,西區,北榮里,149,1111,395,225,620,32,652
公投第１２案,嘉義市,西區,慶安里,150,767,280,176,456,40,496
公投第１２案,嘉義市,西區,慶安里,151,817,242,161,403,17,420
公投第１２案,嘉義市,西區,香湖里,152,770,251,177,428,24,452
公投第１２案,嘉義市,西區,重興里,153,1135,306,216,522,14,536
公投第１２案,嘉義市,西區,重興里,154,835,245,166,411,44,455
公投第１２案,嘉義市,西區,後驛里,155,1182,373,212,585,25,610
公投第１２案,嘉義市,西區,後驛里,156,944,316,171,487,15,502
公投第１２案,嘉義市,西區,湖邊里,157,997,313,200,513,23,536
公投第１２案,嘉義市,西區,湖邊里,158,1074,359,229,588,25,613
公投第１２案,嘉義市,西區,竹圍里,159,1460,368,281,649,17,666
公投第１２案,嘉義市,西區,竹圍里,160,1352,441,260,701,25,726
公投第１２案,嘉義市,西區,竹圍里,161,1499,471,313,784,31,815
公投第１２案,嘉義市,西區,保生里,162,1262,434,239,673,48,721
公投第１２案,嘉義市,西區,保生里,163,1299,429,262,691,22,713
公投第１２案,嘉義市,西區,保生里,164,1734,591,307,898,28,926
公投第１２案,嘉義市,西區,保安里,165,1674,531,286,817,21,838
公投第１２案,嘉義市,西區,保安里,166,1540,490,313,803,22,825
公投第１２案,嘉義市,西區,北新里,167,1056,389,240,629,13,642
公投第１２案,嘉義市,西區,新厝里,168,1467,515,304,819,46,865
公投第１２案,嘉義市,西區,新厝里,169,1431,450,263,713,36,749
公投第１２案,嘉義市,西區,新厝里,170,1234,455,271,726,44,770
公投第１２案,嘉義市,西區,保福里,171,1266,386,286,672,19,691
公投第１２案,嘉義市,西區,保福里,172,1211,421,272,693,18,711
公投第１２案,嘉義市,西區,保福里,173,1121,381,250,631,15,646
公投第１２案,嘉義市,西區,竹村里,174,1155,361,223,584,11,595
公投第１２案,嘉義市,西區,北湖里,175,1546,511,337,848,75,923
公投第１２案,嘉義市,西區,北湖里,176,1322,441,262,703,35,738
公投第１２案,嘉義市,西區,下埤里,177,1549,524,309,833,55,888
公投第１２案,臺北市,北投區,建民里,1,1313,463,282,745,55,800
公投第１２案,臺北市,北投區,建民里,2,1403,480,360,840,33,873
公投第１２案,臺北市,北投區,建民里,3,1081,337,294,631,35,666
公投第１２案,臺北市,北投區,文林里,4,1209,393,297,690,39,729
公投第１２案,臺北市,北投區,文林里,5,1326,433,320,753,35,788
公投第１２案,臺北市,北投區,文林里,6,1263,431,297,728,41,769
公投第１２案,臺北市,北投區,石牌里,7,1580,521,379,900,49,949
公投第１２案,臺北市,北投區,石牌里,8,1577,546,356,902,33,935
公投第１２案,臺北市,北投區,石牌里,9,1483,477,379,856,42,898
公投第１２案,臺北市,北投區,福興里,10,1461,469,327,796,34,830
公投第１２案,臺北市,北投區,福興里,11,1466,465,335,800,39,839
公投第１２案,臺北市,北投區,福興里,12,1620,575,356,931,43,974
公投第１２案,臺北市,北投區,福興里,13,1543,494,310,804,32,836
公投第１２案,臺北市,北投區,榮光里,14,1513,508,289,797,36,833
公投第１２案,臺北市,北投區,榮光里,15,1534,532,339,871,28,899
公投第１２案,臺北市,北投區,榮光里,16,1650,594,337,931,53,984
公投第１２案,臺北市,北投區,榮光里,17,1533,528,341,869,32,901
公投第１２案,臺北市,北投區,榮華里,18,1702,554,365,919,35,954
公投第１２案,臺北市,北投區,榮華里,19,1721,522,415,937,38,975
公投第１２案,臺北市,北投區,榮華里,20,1575,495,428,923,44,967
公投第１２案,臺北市,北投區,榮華里,21,1530,470,372,842,60,902
公投第１２案,臺北市,北投區,裕民里,22,1728,568,389,957,49,1006
公投第１２案,臺北市,北投區,裕民里,23,1702,573,360,933,47,980
公投第１２案,臺北市,北投區,裕民里,24,1696,526,385,911,51,962
公投第１２案,臺北市,北投區,裕民里,25,1684,471,304,775,28,803
公投第１２案,臺北市,北投區,振華里,26,1717,590,392,982,54,1036
公投第１２案,臺北市,北投區,振華里,27,1605,574,346,920,28,948
公投第１２案,臺北市,北投區,振華里,28,1723,589,357,946,47,993
公投第１２案,臺北市,北投區,振華里,29,1597,572,381,953,32,985
公投第１２案,臺北市,北投區,永和里,30,1700,556,388,944,31,975
公投第１２案,臺北市,北投區,永和里,31,1544,427,360,787,30,817
公投第１２案,臺北市,北投區,永和里,32,1635,500,347,847,31,878
公投第１２案,臺北市,北投區,永和里,33,1495,498,349,847,28,875
公投第１２案,臺北市,北投區,永和里,34,1619,541,371,912,44,956
公投第１２案,臺北市,北投區,永欣里,35,1683,522,394,916,43,959
公投第１２案,臺北市,北投區,永欣里,36,1662,499,354,853,46,899
公投第１２案,臺北市,北投區,永欣里,37,1850,541,360,901,26,927
公投第１２案,臺北市,北投區,永欣里,38,1674,464,391,855,23,878
公投第１２案,臺北市,北投區,永明里,39,1511,544,336,880,40,920
公投第１２案,臺北市,北投區,永明里,40,1393,471,313,784,14,798
公投第１２案,臺北市,北投區,永明里,41,1279,472,301,773,39,812
公投第１２案,臺北市,北投區,東華里,42,1122,372,243,615,26,641
公投第１２案,臺北市,北投區,東華里,43,1238,492,315,807,44,851
公投第１２案,臺北市,北投區,東華里,44,1477,511,347,858,64,922
公投第１２案,臺北市,北投區,吉利里,45,1495,530,343,873,44,917
公投第１２案,臺北市,北投區,吉利里,46,1469,552,345,897,34,931
公投第１２案,臺北市,北投區,吉利里,47,1462,518,306,824,34,858
公投第１２案,臺北市,北投區,吉利里,48,1431,498,323,821,37,858
公投第１２案,臺北市,北投區,吉慶里,49,1486,501,346,847,28,875
公投第１２案,臺北市,北投區,吉慶里,50,1449,514,333,847,39,886
公投第１２案,臺北市,北投區,吉慶里,51,1456,480,346,826,33,859
公投第１２案,臺北市,北投區,尊賢里,52,1311,411,307,718,25,743
公投第１２案,臺北市,北投區,尊賢里,53,1356,481,208,689,38,727
公投第１２案,臺北市,北投區,尊賢里,54,1338,466,298,764,27,791
公投第１２案,臺北市,北投區,立賢里,55,1525,527,332,859,30,889
公投第１２案,臺北市,北投區,立賢里,56,1620,486,378,864,31,895
公投第１２案,臺北市,北投區,立賢里,57,1499,488,305,793,19,812
公投第１２案,臺北市,北投區,立農里,58,1497,546,337,883,31,914
公投第１２案,臺北市,北投區,立農里,59,1624,544,352,896,34,930
公投第１２案,臺北市,北投區,立農里,60,1536,475,316,791,52,843
公投第１２案,臺北市,北投區,立農里,61,1469,526,327,853,53,906
公投第１２案,臺北市,北投區,立農里,62,1598,496,358,854,37,891
公投第１２案,臺北市,北投區,八仙里,63,1690,487,417,904,31,935
公投第１２案,臺北市,北投區,八仙里,64,1599,472,373,845,67,912
公投第１２案,臺北市,北投區,八仙里,65,1634,510,379,889,40,929
公投第１２案,臺北市,北投區,洲美里,66,1660,453,386,839,50,889
公投第１２案,臺北市,北投區,奇岩里,67,1900,528,422,950,49,999
公投第１２案,臺北市,北投區,奇岩里,68,1797,580,405,985,42,1027
公投第１２案,臺北市,北投區,奇岩里,69,1832,554,462,1016,50,1066
公投第１２案,臺北市,北投區,奇岩里,70,1784,579,411,990,57,1047
公投第１２案,臺北市,北投區,奇岩里,71,1732,584,391,975,38,1013
公投第１２案,臺北市,北投區,清江里,72,2035,312,210,522,38,560
公投第１２案,臺北市,北投區,清江里,73,1504,479,329,808,44,852
公投第１２案,臺北市,北投區,清江里,74,1683,596,349,945,52,997
公投第１２案,臺北市,北投區,清江里,75,1635,488,367,855,54,909
公投第１２案,臺北市,北投區,清江里,76,1613,520,331,851,56,907
公投第１２案,臺北市,北投區,中央里,77,1483,406,396,802,26,828
公投第１２案,臺北市,北投區,中央里,78,1500,501,311,812,36,848
公投第１２案,臺北市,北投區,中央里,79,1483,479,354,833,42,875
公投第１２案,臺北市,北投區,中央里,80,1544,490,333,823,51,874
公投第１２案,臺北市,北投區,中央里,81,1532,426,319,745,33,778
公投第１２案,臺北市,北投區,長安里,82,1819,657,322,979,47,1026
公投第１２案,臺北市,北投區,長安里,83,1863,515,410,925,51,976
公投第１２案,臺北市,北投區,長安里,84,1872,493,423,916,18,934
公投第１２案,臺北市,北投區,大同里,85,1627,518,339,857,50,907
公投第１２案,臺北市,北投區,大同里,86,1696,523,371,894,12,906
公投第１２案,臺北市,北投區,大同里,87,1841,585,396,981,50,1031
公投第１２案,臺北市,北投區,溫泉里,88,1324,445,279,724,35,759
公投第１２案,臺北市,北投區,溫泉里,89,1504,466,334,800,28,828
公投第１２案,臺北市,北投區,溫泉里,90,1511,482,339,821,43,864
公投第１２案,臺北市,北投區,溫泉里,91,1615,536,389,925,31,956
公投第１２案,臺北市,北投區,林泉里,92,1270,367,276,643,32,675
公投第１２案,臺北市,北投區,林泉里,93,1492,393,329,722,29,751
公投第１２案,臺北市,北投區,中心里,94,1429,465,332,797,20,817
公投第１２案,臺北市,北投區,中心里,95,1567,471,336,807,26,833
公投第１２案,臺北市,北投區,中心里,96,1388,449,314,763,25,788
公投第１２案,臺北市,北投區,中心里,97,1448,431,311,742,21,763
公投第１２案,臺北市,北投區,中庸里,98,1356,427,272,699,37,736
公投第１２案,臺北市,北投區,中庸里,99,1308,439,274,713,22,735
公投第１２案,臺北市,北投區,中庸里,100,1165,392,279,671,35,706
公投第１２案,臺北市,北投區,開明里,101,1429,483,311,794,44,838
公投第１２案,臺北市,北投區,開明里,102,1472,497,298,795,26,821
公投第１２案,臺北市,北投區,開明里,103,1508,521,378,899,46,945
公投第１２案,臺北市,北投區,開明里,104,1480,484,321,805,45,850
公投第１２案,臺北市,北投區,中和里,105,1142,344,260,604,30,634
公投第１２案,臺北市,北投區,中和里,106,1554,498,313,811,23,834
公投第１２案,臺北市,北投區,中和里,107,1669,561,370,931,59,990
公投第１２案,臺北市,北投區,智仁里,108,1823,606,374,980,43,1023
公投第１２案,臺北市,北投區,智仁里,109,1739,520,385,905,54,959
公投第１２案,臺北市,北投區,智仁里,110,1771,551,360,911,39,950
公投第１２案,臺北市,北投區,秀山里,111,1468,455,280,735,44,779
公投第１２案,臺北市,北投區,秀山里,112,1469,488,320,808,22,830
公投第１２案,臺北市,北投區,文化里,113,1094,445,238,683,38,721
公投第１２案,臺北市,北投區,文化里,114,1101,429,250,679,30,709
公投第１２案,臺北市,北投區,文化里,115,1422,500,324,824,41,865
公投第１２案,臺北市,北投區,豐年里,116,1390,502,248,750,32,782
公投第１２案,臺北市,北投區,豐年里,117,1307,476,269,745,36,781
公投第１２案,臺北市,北投區,豐年里,118,1215,404,324,728,45,773
公投第１２案,臺北市,北投區,稻香里,119,1642,505,355,860,35,895
公投第１２案,臺北市,北投區,稻香里,120,1623,502,333,835,30,865
公投第１２案,臺北市,北投區,稻香里,121,1621,537,322,859,40,899
公投第１２案,臺北市,北投區,桃源里,122,1367,415,333,748,19,767
公投第１２案,臺北市,北投區,桃源里,123,1309,378,304,682,39,721
公投第１２案,臺北市,北投區,桃源里,124,1356,418,346,764,33,797
公投第１２案,臺北市,北投區,桃源里,125,1365,427,314,741,35,776
公投第１２案,臺北市,北投區,一德里,126,1613,459,387,846,36,882
公投第１２案,臺北市,北投區,一德里,127,1590,435,356,791,19,810
公投第１２案,臺北市,北投區,一德里,128,1662,553,369,922,47,969
公投第１２案,臺北市,北投區,一德里,129,1622,518,379,897,39,936
公投第１２案,臺北市,北投區,關渡里,130,1820,539,439,978,31,1009
公投第１２案,臺北市,北投區,關渡里,131,1615,537,364,901,48,949
公投第１２案,臺北市,北投區,關渡里,132,1612,450,265,715,43,758
公投第１２案,臺北市,北投區,關渡里,133,1652,511,368,879,48,927
公投第１２案,臺北市,北投區,關渡里,134,1666,545,380,925,22,947
公投第１２案,臺北市,北投區,關渡里,135,1641,502,365,867,39,906
公投第１２案,臺北市,北投區,泉源里,136,528,161,142,303,21,324
公投第１２案,臺北市,北投區,泉源里,137,1642,388,340,728,59,787
公投第１２案,臺北市,北投區,湖山里,138,829,258,180,438,33,471
公投第１２案,臺北市,北投區,湖山里,139,690,210,144,354,28,382
公投第１２案,臺北市,北投區,大屯里,140,1067,325,226,551,37,588
公投第１２案,臺北市,北投區,湖田里,141,892,233,211,444,63,507
公投第１２案,臺北市,士林區,仁勇里,142,1695,533,377,910,52,962
公投第１２案,臺北市,士林區,仁勇里,143,1720,597,365,962,67,1029
公投第１２案,臺北市,士林區,義信里,144,1288,420,278,698,47,745
公投第１２案,臺北市,士林區,義信里,145,1546,531,312,843,34,877
公投第１２案,臺北市,士林區,福林里,146,652,238,158,396,19,415
公投第１２案,臺北市,士林區,福林里,147,870,265,194,459,22,481
公投第１２案,臺北市,士林區,福林里,148,1137,399,269,668,36,704
公投第１２案,臺北市,士林區,福德里,149,1050,392,238,630,35,665
公投第１２案,臺北市,士林區,福德里,150,1031,357,244,601,43,644
公投第１２案,臺北市,士林區,福德里,151,1075,380,244,624,20,644
公投第１２案,臺北市,士林區,福德里,152,2175,284,211,495,30,525
公投第１２案,臺北市,士林區,福志里,153,1775,528,375,903,47,950
公投第１２案,臺北市,士林區,福志里,154,1669,591,358,949,33,982
公投第１２案,臺北市,士林區,福志里,155,1665,549,420,969,44,1013
公投第１２案,臺北市,士林區,福志里,156,1648,579,397,976,49,1025
公投第１２案,臺北市,士林區,舊佳里,157,1246,470,246,716,22,738
公投第１２案,臺北市,士林區,舊佳里,158,1419,487,298,785,51,836
公投第１２案,臺北市,士林區,舊佳里,159,1327,432,287,719,56,775
公投第１２案,臺北市,士林區,舊佳里,160,1573,542,389,931,47,978
公投第１２案,臺北市,士林區,福佳里,161,1470,507,312,819,55,874
公投第１２案,臺北市,士林區,福佳里,162,1775,615,391,1006,39,1045
公投第１２案,臺北市,士林區,福佳里,163,1692,579,378,957,31,988
公投第１２案,臺北市,士林區,福佳里,164,1842,621,431,1052,51,1103
公投第１２案,臺北市,士林區,後港里,165,1166,429,259,688,30,718
公投第１２案,臺北市,士林區,後港里,166,1687,660,247,907,0,907
公投第１２案,臺北市,士林區,後港里,167,1624,530,365,895,43,938
公投第１２案,臺北市,士林區,後港里,168,1477,510,352,862,70,932
公投第１２案,臺北市,士林區,後港里,169,1250,435,301,736,39,775
公投第１２案,臺北市,士林區,福中里,170,1434,463,350,813,49,862
公投第１２案,臺北市,士林區,福中里,171,1452,507,337,844,46,890
公投第１２案,臺北市,士林區,福中里,172,1533,549,371,920,45,965
公投第１２案,臺北市,士林區,福中里,173,1515,535,354,889,45,934
公投第１２案,臺北市,士林區,前港里,174,1203,403,302,705,27,732
公投第１２案,臺北市,士林區,前港里,175,1487,518,361,879,49,928
公投第１２案,臺北市,士林區,前港里,176,1252,461,273,734,18,752
公投第１２案,臺北市,士林區,百齡里,177,1536,514,336,850,47,897
公投第１２案,臺北市,士林區,百齡里,178,1556,543,370,913,37,950
公投第１２案,臺北市,士林區,百齡里,179,1511,508,367,875,27,902
公投第１２案,臺北市,士林區,百齡里,180,1572,556,374,930,36,966
公投第１２案,臺北市,士林區,承德里,181,1668,537,381,918,50,968
公投第１２案,臺北市,士林區,承德里,182,1685,549,352,901,67,968
公投第１２案,臺北市,士林區,承德里,183,1568,507,359,866,45,911
公投第１２案,臺北市,士林區,福華里,184,1327,446,260,706,28,734
公投第１２案,臺北市,士林區,福華里,185,1338,421,301,722,35,757
公投第１２案,臺北市,士林區,福華里,186,1515,417,333,750,49,799
公投第１２案,臺北市,士林區,福華里,187,1452,490,331,821,52,873
公投第１２案,臺北市,士林區,明勝里,188,1448,494,322,816,30,846
公投第１２案,臺北市,士林區,明勝里,189,1521,519,358,877,41,918
公投第１２案,臺北市,士林區,明勝里,190,1461,504,330,834,21,855
公投第１２案,臺北市,士林區,福順里,191,1541,434,335,769,69,838
公投第１２案,臺北市,士林區,福順里,192,1611,394,332,726,38,764
公投第１２案,臺北市,士林區,福順里,193,1595,515,308,823,53,876
公投第１２案,臺北市,士林區,富光里,194,1685,508,347,855,33,888
公投第１２案,臺北市,士林區,富光里,195,1816,541,391,932,52,984
公投第１２案,臺北市,士林區,富光里,196,1687,539,359,898,65,963
公投第１２案,臺北市,士林區,葫蘆里,197,1646,520,368,888,49,937
公投第１２案,臺北市,士林區,葫蘆里,198,1643,485,367,852,35,887
公投第１２案,臺北市,士林區,葫蘆里,199,1687,578,349,927,33,960
公投第１２案,臺北市,士林區,葫蘆里,200,1655,540,399,939,38,977
公投第１２案,臺北市,士林區,葫東里,201,1779,511,419,930,29,959
公投第１２案,臺北市,士林區,葫東里,202,1855,596,445,1041,48,1089
公投第１２案,臺北市,士林區,社子里,203,1350,404,340,744,46,790
公投第１２案,臺北市,士林區,社子里,204,1455,462,263,725,27,752
公投第１２案,臺北市,士林區,社子里,205,1497,382,303,685,46,731
公投第１２案,臺北市,士林區,社子里,206,1398,378,272,650,21,671
公投第１２案,臺北市,士林區,社新里,207,1747,547,418,965,61,1026
公投第１２案,臺北市,士林區,社新里,208,1465,554,235,789,46,835
公投第１２案,臺北市,士林區,社新里,209,1530,478,346,824,44,868
公投第１２案,臺北市,士林區,社新里,210,1855,529,401,930,48,978
公投第１２案,臺北市,士林區,社新里,211,1444,442,356,798,41,839
公投第１２案,臺北市,士林區,社園里,212,1563,473,320,793,45,838
公投第１２案,臺北市,士林區,社園里,213,1482,486,321,807,49,856
公投第１２案,臺北市,士林區,社園里,214,1552,445,365,810,63,873
公投第１２案,臺北市,士林區,社園里,215,1790,579,387,966,50,1016
公投第１２案,臺北市,士林區,永倫里,216,1628,480,321,801,59,860
公投第１２案,臺北市,士林區,永倫里,217,1337,469,276,745,53,798
公投第１２案,臺北市,士林區,永倫里,218,1750,555,418,973,39,1012
公投第１２案,臺北市,士林區,永倫里,219,1668,492,335,827,71,898
公投第１２案,臺北市,士林區,福安里,220,1403,388,237,625,50,675
公投第１２案,臺北市,士林區,福安里,221,1468,351,308,659,41,700
公投第１２案,臺北市,士林區,福安里,222,1471,394,307,701,31,732
公投第１２案,臺北市,士林區,富洲里,223,1666,506,312,818,55,873
公投第１２案,臺北市,士林區,富洲里,224,1587,445,339,784,51,835
公投第１２案,臺北市,士林區,富洲里,225,1987,517,373,890,58,948
公投第１２案,臺北市,士林區,岩山里,226,1271,408,234,642,23,665
公投第１２案,臺北市,士林區,岩山里,227,1728,549,447,996,43,1039
公投第１２案,臺北市,士林區,名山里,228,1630,577,355,932,49,981
公投第１２案,臺北市,士林區,名山里,229,1619,537,395,932,35,967
公投第１２案,臺北市,士林區,名山里,230,1425,503,294,797,45,842
公投第１２案,臺北市,士林區,名山里,231,1623,565,402,967,41,1008
公投第１２案,臺北市,士林區,聖山里,232,1564,544,357,901,37,938
公投第１２案,臺北市,士林區,聖山里,233,1376,521,347,868,34,902
公投第１２案,臺北市,士林區,聖山里,234,1517,560,351,911,29,940
公投第１２案,臺北市,士林區,芝山里,235,1729,523,372,895,32,927
公投第１２案,臺北市,士林區,芝山里,236,1511,589,300,889,41,930
公投第１２案,臺北市,士林區,芝山里,237,1811,643,402,1045,35,1080
公投第１２案,臺北市,士林區,芝山里,238,1533,501,382,883,27,910
公投第１２案,臺北市,士林區,東山里,239,1657,630,407,1037,37,1074
公投第１２案,臺北市,士林區,東山里,240,1499,491,333,824,31,855
公投第１２案,臺北市,士林區,東山里,241,1402,474,276,750,61,811
公投第１２案,臺北市,士林區,德行里,242,1273,440,342,782,48,830
公投第１２案,臺北市,士林區,德行里,243,1273,414,320,734,33,767
公投第１２案,臺北市,士林區,德行里,244,1316,437,306,743,38,781
公投第１２案,臺北市,士林區,德華里,245,1659,542,374,916,50,966
公投第１２案,臺北市,士林區,德華里,246,1749,509,443,952,40,992
公投第１２案,臺北市,士林區,德華里,247,1552,514,330,844,43,887
公投第１２案,臺北市,士林區,忠誠里,248,1529,539,321,860,49,909
公投第１２案,臺北市,士林區,忠誠里,249,1644,560,327,887,32,919
公投第１２案,臺北市,士林區,忠誠里,250,1779,600,368,968,46,1014
公投第１２案,臺北市,士林區,蘭雅里,251,1597,503,381,884,35,919
公投第１２案,臺北市,士林區,蘭雅里,252,1454,453,350,803,37,840
公投第１２案,臺北市,士林區,蘭雅里,253,1582,489,429,918,53,971
公投第１２案,臺北市,士林區,蘭雅里,254,1518,519,349,868,40,908
公投第１２案,臺北市,士林區,蘭雅里,255,1501,428,357,785,29,814
公投第１２案,臺北市,士林區,蘭興里,256,1420,447,366,813,47,860
公投第１２案,臺北市,士林區,蘭興里,257,1494,474,361,835,50,885
公投第１２案,臺北市,士林區,蘭興里,258,1568,560,424,984,31,1015
公投第１２案,臺北市,士林區,蘭興里,259,1208,378,346,724,42,766
公投第１２案,臺北市,士林區,三玉里,260,1826,585,411,996,41,1037
公投第１２案,臺北市,士林區,三玉里,261,1647,503,399,902,36,938
公投第１２案,臺北市,士林區,三玉里,262,1654,537,356,893,49,942
公投第１２案,臺北市,士林區,天福里,263,1550,509,383,892,40,932
公投第１２案,臺北市,士林區,天福里,264,1298,435,362,797,28,825
公投第１２案,臺北市,士林區,天福里,265,1297,468,320,788,34,822
公投第１２案,臺北市,士林區,天福里,266,1352,414,319,733,47,780
公投第１２案,臺北市,士林區,天祿里,267,1522,491,346,837,44,881
公投第１２案,臺北市,士林區,天祿里,268,1602,475,387,862,54,916
公投第１２案,臺北市,士林區,天祿里,269,1441,461,339,800,44,844
公投第１２案,臺北市,士林區,天壽里,270,1325,395,308,703,21,724
公投第１２案,臺北市,士林區,天壽里,271,1567,500,363,863,39,902
公投第１２案,臺北市,士林區,天壽里,272,1518,483,344,827,25,852
公投第１２案,臺北市,士林區,天和里,273,1549,517,393,910,39,949
公投第１２案,臺北市,士林區,天和里,274,1652,534,401,935,33,968
公投第１２案,臺北市,士林區,天和里,275,1766,582,429,1011,49,1060
公投第１２案,臺北市,士林區,天和里,276,1638,527,363,890,30,920
公投第１２案,臺北市,士林區,天山里,277,1491,535,332,867,39,906
公投第１２案,臺北市,士林區,天山里,278,1521,500,369,869,29,898
公投第１２案,臺北市,士林區,天山里,279,1351,481,316,797,47,844
公投第１２案,臺北市,士林區,天山里,280,1742,536,382,918,25,943
公投第１２案,臺北市,士林區,天玉里,281,1585,379,512,891,35,926
公投第１２案,臺北市,士林區,天玉里,282,1521,534,326,860,31,891
公投第１２案,臺北市,士林區,天玉里,283,1543,389,352,741,24,765
公投第１２案,臺北市,士林區,天玉里,284,1404,499,316,815,21,836
公投第１２案,臺北市,士林區,天玉里,285,1541,474,384,858,35,893
公投第１２案,臺北市,士林區,天母里,286,1584,521,324,845,35,880
公投第１２案,臺北市,士林區,天母里,287,1519,518,351,869,42,911
公投第１２案,臺北市,士林區,天母里,288,1482,458,305,763,21,784
公投第１２案,臺北市,士林區,天母里,289,1243,389,283,672,40,712
公投第１２案,臺北市,士林區,永福里,290,1156,366,261,627,39,666
公投第１２案,臺北市,士林區,公館里,291,1262,358,275,633,51,684
公投第１２案,臺北市,士林區,新安里,292,889,284,217,501,32,533
公投第１２案,臺北市,士林區,新安里,293,858,253,240,493,36,529
公投第１２案,臺北市,士林區,陽明里,294,945,256,233,489,50,539
公投第１２案,臺北市,士林區,陽明里,295,960,268,216,484,50,534
公投第１２案,臺北市,士林區,陽明里,296,876,279,180,459,38,497
公投第１２案,臺北市,士林區,菁山里,297,556,187,157,344,23,367
公投第１２案,臺北市,士林區,菁山里,298,919,319,245,564,33,597
公投第１２案,臺北市,士林區,平等里,299,1360,499,347,846,58,904
公投第１２案,臺北市,士林區,溪山里,300,1355,464,325,789,51,840
公投第１２案,臺北市,士林區,翠山里,301,1252,530,187,717,26,743
公投第１２案,臺北市,士林區,翠山里,302,1182,438,276,714,29,743
公投第１２案,臺北市,士林區,臨溪里,303,1431,408,275,683,26,709
公投第１２案,臺北市,士林區,臨溪里,304,1240,395,253,648,35,683
公投第１２案,臺北市,內湖區,西湖里,305,1661,498,361,859,22,881
公投第１２案,臺北市,內湖區,西湖里,306,1602,491,355,846,46,892
公投第１２案,臺北市,內湖區,西湖里,307,1655,583,372,955,58,1013
公投第１２案,臺北市,內湖區,西湖里,308,1582,526,408,934,30,964
公投第１２案,臺北市,內湖區,西康里,309,1688,535,371,906,28,934
公投第１２案,臺北市,內湖區,西康里,310,1737,548,403,951,48,999
公投第１２案,臺北市,內湖區,西康里,311,1809,598,400,998,41,1039
公投第１２案,臺北市,內湖區,西康里,312,1376,452,313,765,21,786
公投第１２案,臺北市,內湖區,西康里,313,1747,615,380,995,72,1067
公投第１２案,臺北市,內湖區,西安里,314,1389,483,346,829,24,853
公投第１２案,臺北市,內湖區,西安里,315,1454,514,368,882,31,913
公投第１２案,臺北市,內湖區,西安里,316,1468,521,382,903,32,935
公投第１２案,臺北市,內湖區,西安里,317,1603,598,383,981,31,1012
公投第１２案,臺北市,內湖區,港墘里,318,1795,584,397,981,33,1014
公投第１２案,臺北市,內湖區,港墘里,319,1737,612,441,1053,38,1091
公投第１２案,臺北市,內湖區,港墘里,320,1744,613,404,1017,36,1053
公投第１２案,臺北市,內湖區,港都里,321,1661,556,385,941,38,979
公投第１２案,臺北市,內湖區,港都里,322,1577,468,410,878,40,918
公投第１２案,臺北市,內湖區,港都里,323,1494,526,371,897,27,924
公投第１２案,臺北市,內湖區,港富里,324,1626,573,360,933,30,963
公投第１２案,臺北市,內湖區,港富里,325,1641,578,364,942,35,977
公投第１２案,臺北市,內湖區,港富里,326,1554,525,369,894,27,921
公投第１２案,臺北市,內湖區,港富里,327,1728,576,425,1001,48,1049
公投第１２案,臺北市,內湖區,港富里,328,1736,587,367,954,40,994
公投第１２案,臺北市,內湖區,港華里,329,1461,539,370,909,33,942
公投第１２案,臺北市,內湖區,港華里,330,1509,541,340,881,30,911
公投第１２案,臺北市,內湖區,港華里,331,1358,446,320,766,26,792
公投第１２案,臺北市,內湖區,港華里,332,1761,620,346,966,36,1002
公投第１２案,臺北市,內湖區,港華里,333,1651,554,379,933,26,959
公投第１２案,臺北市,內湖區,內湖里,334,1809,591,424,1015,77,1092
公投第１２案,臺北市,內湖區,內湖里,335,1773,617,384,1001,43,1044
公投第１２案,臺北市,內湖區,內湖里,336,1890,629,393,1022,40,1062
公投第１２案,臺北市,內湖區,湖濱里,337,1760,627,446,1073,46,1119
公投第１２案,臺北市,內湖區,湖濱里,338,1645,581,369,950,25,975
公投第１２案,臺北市,內湖區,湖濱里,339,1324,456,359,815,20,835
公投第１２案,臺北市,內湖區,湖濱里,340,1072,407,230,637,26,663
公投第１２案,臺北市,內湖區,湖濱里,341,1509,517,314,831,34,865
公投第１２案,臺北市,內湖區,紫星里,342,1715,584,391,975,35,1010
公投第１２案,臺北市,內湖區,紫星里,343,1774,607,410,1017,31,1048
公投第１２案,臺北市,內湖區,紫星里,344,1796,713,396,1109,32,1141
公投第１２案,臺北市,內湖區,紫星里,345,1784,626,375,1001,34,1035
公投第１２案,臺北市,內湖區,大湖里,346,1417,468,367,835,50,885
公投第１２案,臺北市,內湖區,大湖里,347,1699,511,441,952,26,978
公投第１２案,臺北市,內湖區,大湖里,348,1719,617,440,1057,26,1083
公投第１２案,臺北市,內湖區,金龍里,349,1715,551,431,982,29,1011
公投第１２案,臺北市,內湖區,金龍里,350,1634,475,369,844,28,872
公投第１２案,臺北市,內湖區,金龍里,351,1435,456,321,777,44,821
公投第１２案,臺北市,內湖區,金瑞里,352,1440,513,310,823,21,844
公投第１２案,臺北市,內湖區,金瑞里,353,1446,500,374,874,28,902
公投第１２案,臺北市,內湖區,金瑞里,354,1657,521,341,862,39,901
公投第１２案,臺北市,內湖區,金瑞里,355,1261,428,306,734,47,781
公投第１２案,臺北市,內湖區,碧山里,356,456,124,89,213,26,239
公投第１２案,臺北市,內湖區,碧山里,357,1433,529,379,908,31,939
公投第１２案,臺北市,內湖區,碧山里,358,1485,520,357,877,22,899
公投第１２案,臺北市,內湖區,碧山里,359,1590,529,371,900,22,922
公投第１２案,臺北市,內湖區,碧山里,360,1219,462,302,764,40,804
公投第１２案,臺北市,內湖區,紫雲里,361,1732,700,252,952,30,982
公投第１２案,臺北市,內湖區,紫雲里,362,1727,643,383,1026,31,1057
公投第１２案,臺北市,內湖區,紫雲里,363,1637,566,362,928,43,971
公投第１２案,臺北市,內湖區,清白里,364,1453,484,324,808,31,839
公投第１２案,臺北市,內湖區,清白里,365,1617,551,348,899,25,924
公投第１２案,臺北市,內湖區,清白里,366,1604,541,340,881,28,909
公投第１２案,臺北市,內湖區,清白里,367,1406,526,353,879,21,900
公投第１２案,臺北市,內湖區,清白里,368,1353,468,332,800,26,826
公投第１２案,臺北市,內湖區,葫洲里,369,1724,615,400,1015,30,1045
公投第１２案,臺北市,內湖區,葫洲里,370,1378,486,334,820,24,844
公投第１２案,臺北市,內湖區,葫洲里,371,1403,509,335,844,21,865
公投第１２案,臺北市,內湖區,葫洲里,372,1547,499,366,865,20,885
公投第１２案,臺北市,內湖區,紫陽里,373,1718,600,417,1017,30,1047
公投第１２案,臺北市,內湖區,紫陽里,374,1813,576,430,1006,37,1043
公投第１２案,臺北市,內湖區,紫陽里,375,1791,639,438,1077,37,1114
公投第１２案,臺北市,內湖區,紫陽里,376,1855,662,435,1097,35,1132
公投第１２案,臺北市,內湖區,瑞陽里,377,1731,610,373,983,31,1014
公投第１２案,臺北市,內湖區,瑞陽里,378,1593,561,420,981,42,1023
公投第１２案,臺北市,內湖區,瑞陽里,379,1869,587,351,938,46,984
公投第１２案,臺北市,內湖區,瑞陽里,380,1687,593,395,988,36,1024
公投第１２案,臺北市,內湖區,瑞光里,381,1530,538,378,916,12,928
公投第１２案,臺北市,內湖區,瑞光里,382,1300,463,299,762,39,801
公投第１２案,臺北市,內湖區,瑞光里,383,1314,514,307,821,25,846
公投第１２案,臺北市,內湖區,五分里,384,1433,439,314,753,18,771
公投第１２案,臺北市,內湖區,五分里,385,1450,431,333,764,35,799
公投第１２案,臺北市,內湖區,五分里,386,1608,495,390,885,39,924
公投第１２案,臺北市,內湖區,五分里,387,1414,450,352,802,38,840
公投第１２案,臺北市,內湖區,五分里,388,1492,498,359,857,33,890
公投第１２案,臺北市,內湖區,五分里,389,1528,501,318,819,15,834
公投第１２案,臺北市,內湖區,東湖里,390,1692,575,376,951,33,984
公投第１２案,臺北市,內湖區,東湖里,391,1556,511,369,880,41,921
公投第１２案,臺北市,內湖區,東湖里,392,1637,550,352,902,22,924
公投第１２案,臺北市,內湖區,東湖里,393,1749,521,416,937,35,972
公投第１２案,臺北市,內湖區,樂康里,394,1220,397,263,660,24,684
公投第１２案,臺北市,內湖區,樂康里,395,1600,500,391,891,37,928
公投第１２案,臺北市,內湖區,樂康里,396,1473,469,353,822,33,855
公投第１２案,臺北市,內湖區,樂康里,397,1498,462,352,814,44,858
公投第１２案,臺北市,內湖區,樂康里,398,1557,486,381,867,32,899
公投第１２案,臺北市,內湖區,內溝里,399,1674,518,334,852,35,887
公投第１２案,臺北市,內湖區,內溝里,400,1728,596,410,1006,36,1042
公投第１２案,臺北市,內湖區,內溝里,401,788,313,64,377,26,403
公投第１２案,臺北市,內湖區,週美里,402,1542,473,362,835,34,869
公投第１２案,臺北市,內湖區,週美里,403,1676,549,266,815,40,855
公投第１２案,臺北市,內湖區,週美里,404,1360,407,304,711,18,729
公投第１２案,臺北市,內湖區,週美里,405,1259,480,300,780,20,800
公投第１２案,臺北市,內湖區,週美里,406,1301,460,261,721,9,730
公投第１２案,臺北市,內湖區,行善里,407,1251,340,277,617,30,647
公投第１２案,臺北市,內湖區,行善里,408,1502,489,323,812,50,862
公投第１２案,臺北市,內湖區,行善里,409,1596,506,362,868,32,900
公投第１２案,臺北市,內湖區,行善里,410,1649,504,424,928,18,946
公投第１２案,臺北市,內湖區,石潭里,411,1774,588,350,938,41,979
公投第１２案,臺北市,內湖區,石潭里,412,1746,563,382,945,19,964
公投第１２案,臺北市,內湖區,湖興里,413,1473,487,316,803,30,833
公投第１２案,臺北市,內湖區,湖興里,414,2824,545,385,930,40,970
公投第１２案,臺北市,內湖區,湖興里,415,1849,514,428,942,34,976
公投第１２案,臺北市,內湖區,湖興里,416,1530,486,336,822,40,862
公投第１２案,臺北市,內湖區,湖元里,417,1656,515,397,912,43,955
公投第１２案,臺北市,內湖區,湖元里,418,1457,472,363,835,31,866
公投第１２案,臺北市,內湖區,湖元里,419,1695,576,403,979,40,1019
公投第１２案,臺北市,內湖區,安湖里,420,1663,569,391,960,25,985
公投第１２案,臺北市,內湖區,安湖里,421,1654,544,374,918,35,953
公投第１２案,臺北市,內湖區,安湖里,422,1642,560,398,958,30,988
公投第１２案,臺北市,內湖區,安湖里,423,1685,553,415,968,19,987
公投第１２案,臺北市,內湖區,秀湖里,424,1862,610,404,1014,41,1055
公投第１２案,臺北市,內湖區,秀湖里,425,1900,643,448,1091,54,1145
公投第１２案,臺北市,內湖區,秀湖里,426,1790,784,307,1091,48,1139
公投第１２案,臺北市,內湖區,安泰里,427,1417,450,335,785,33,818
公投第１２案,臺北市,內湖區,安泰里,428,1694,553,384,937,34,971
公投第１２案,臺北市,內湖區,安泰里,429,1676,517,350,867,55,922
公投第１２案,臺北市,內湖區,金湖里,430,1643,537,367,904,28,932
公投第１２案,臺北市,內湖區,金湖里,431,1588,542,359,901,35,936
公投第１２案,臺北市,內湖區,金湖里,432,1603,563,343,906,58,964
公投第１２案,臺北市,內湖區,金湖里,433,1629,531,399,930,27,957
公投第１２案,臺北市,內湖區,金湖里,434,1646,587,393,980,38,1018
公投第１２案,臺北市,內湖區,康寧里,435,1883,611,408,1019,28,1047
公投第１２案,臺北市,內湖區,康寧里,436,1434,488,327,815,26,841
公投第１２案,臺北市,內湖區,康寧里,437,1418,471,330,801,26,827
公投第１２案,臺北市,內湖區,康寧里,438,1373,492,292,784,36,820
公投第１２案,臺北市,內湖區,康寧里,439,1349,461,322,783,36,819
公投第１２案,臺北市,內湖區,明湖里,440,1511,515,382,897,34,931
公投第１２案,臺北市,內湖區,明湖里,441,1563,555,392,947,27,974
公投第１２案,臺北市,內湖區,明湖里,442,1550,504,378,882,26,908
公投第１２案,臺北市,內湖區,蘆洲里,443,1157,356,256,612,43,655
公投第１２案,臺北市,內湖區,麗山里,444,1768,560,454,1014,35,1049
公投第１２案,臺北市,內湖區,麗山里,445,1664,559,379,938,35,973
公投第１２案,臺北市,內湖區,麗山里,446,1743,570,418,988,41,1029
公投第１２案,臺北市,內湖區,寶湖里,447,1480,517,345,862,20,882
公投第１２案,臺北市,內湖區,寶湖里,448,1589,515,421,936,49,985
公投第１２案,臺北市,內湖區,寶湖里,449,1371,443,314,757,29,786
公投第１２案,臺北市,內湖區,寶湖里,450,1575,545,408,953,30,983
公投第１２案,臺北市,內湖區,寶湖里,451,1377,475,311,786,23,809
公投第１２案,臺北市,內湖區,南湖里,452,1469,542,395,937,36,973
公投第１２案,臺北市,內湖區,南湖里,453,1529,555,393,948,20,968
公投第１２案,臺北市,內湖區,南湖里,454,1649,566,403,969,36,1005
公投第１２案,臺北市,南港區,南港里,455,1280,404,281,685,24,709
公投第１２案,臺北市,南港區,南港里,456,1351,450,305,755,24,779
公投第１２案,臺北市,南港區,南港里,457,1345,435,339,774,26,800
公投第１２案,臺北市,南港區,南港里,458,1679,446,296,742,32,774
公投第１２案,臺北市,南港區,中南里,459,1680,427,389,816,42,858
公投第１２案,臺北市,南港區,中南里,460,1635,475,338,813,44,857
公投第１２案,臺北市,南港區,三重里,461,1459,480,299,779,25,804
公投第１２案,臺北市,南港區,三重里,462,1706,573,370,943,29,972
公投第１２案,臺北市,南港區,三重里,463,1674,504,358,862,39,901
公投第１２案,臺北市,南港區,三重里,464,1491,509,315,824,18,842
公投第１２案,臺北市,南港區,新富里,465,1086,378,299,677,25,702
公投第１２案,臺北市,南港區,新富里,466,1202,407,323,730,49,779
公投第１２案,臺北市,南港區,新富里,467,1198,403,291,694,37,731
公投第１２案,臺北市,南港區,中研里,468,1430,428,333,761,31,792
公投第１２案,臺北市,南港區,中研里,469,1275,428,327,755,30,785
公投第１２案,臺北市,南港區,中研里,470,1344,426,407,833,38,871
公投第１２案,臺北市,南港區,中研里,471,1391,437,338,775,24,799
公投第１２案,臺北市,南港區,中研里,472,1342,446,355,801,20,821
公投第１２案,臺北市,南港區,中研里,473,1389,400,335,735,27,762
公投第１２案,臺北市,南港區,九如里,474,1426,480,369,849,25,874
公投第１２案,臺北市,南港區,九如里,475,1359,488,305,793,22,815
公投第１２案,臺北市,南港區,九如里,476,1366,441,314,755,28,783
公投第１２案,臺北市,南港區,九如里,477,1441,485,343,828,25,853
公投第１２案,臺北市,南港區,舊莊里,478,1529,477,317,794,44,838
公投第１２案,臺北市,南港區,舊莊里,479,1618,436,398,834,37,871
公投第１２案,臺北市,南港區,舊莊里,480,1545,419,303,722,42,764
公投第１２案,臺北市,南港區,舊莊里,481,1569,518,352,870,34,904
公投第１２案,臺北市,南港區,舊莊里,482,1661,476,339,815,36,851
公投第１２案,臺北市,南港區,東新里,483,1518,427,329,756,39,795
公投第１２案,臺北市,南港區,東新里,484,1552,547,375,922,39,961
公投第１２案,臺北市,南港區,東新里,485,1658,507,358,865,24,889
公投第１２案,臺北市,南港區,東新里,486,1608,523,368,891,54,945
公投第１２案,臺北市,南港區,重陽里,487,1475,443,338,781,31,812
公投第１２案,臺北市,南港區,重陽里,488,1722,613,426,1039,33,1072
公投第１２案,臺北市,南港區,重陽里,489,1383,533,343,876,31,907
公投第１２案,臺北市,南港區,東明里,490,1397,465,327,792,37,829
公投第１２案,臺北市,南港區,東明里,491,1352,468,325,793,32,825
公投第１２案,臺北市,南港區,東明里,492,1344,573,211,784,26,810
公投第１２案,臺北市,南港區,西新里,493,1385,422,321,743,25,768
公投第１２案,臺北市,南港區,西新里,494,1399,466,314,780,32,812
公投第１２案,臺北市,南港區,西新里,495,1381,409,330,739,29,768
公投第１２案,臺北市,南港區,玉成里,496,1548,489,345,834,36,870
公投第１２案,臺北市,南港區,玉成里,497,1190,376,283,659,24,683
公投第１２案,臺北市,南港區,玉成里,498,1490,462,396,858,34,892
公投第１２案,臺北市,南港區,合成里,499,1096,389,276,665,17,682
公投第１２案,臺北市,南港區,合成里,500,1238,425,334,759,22,781
公投第１２案,臺北市,南港區,合成里,501,1271,465,310,775,21,796
公投第１２案,臺北市,南港區,合成里,502,1146,373,263,636,37,673
公投第１２案,臺北市,南港區,合成里,503,1232,400,289,689,30,719
公投第１２案,臺北市,南港區,新光里,504,1649,470,337,807,30,837
公投第１２案,臺北市,南港區,新光里,505,1688,573,383,956,38,994
公投第１２案,臺北市,南港區,聯成里,506,1503,506,370,876,32,908
公投第１２案,臺北市,南港區,聯成里,507,1542,516,360,876,19,895
公投第１２案,臺北市,南港區,聯成里,508,1463,500,332,832,38,870
公投第１２案,臺北市,南港區,萬福里,509,1195,501,220,721,43,764
公投第１２案,臺北市,南港區,萬福里,510,1254,392,345,737,13,750
公投第１２案,臺北市,南港區,萬福里,511,1356,447,328,775,36,811
公投第１２案,臺北市,南港區,鴻福里,512,1363,448,324,772,61,833
公投第１２案,臺北市,南港區,鴻福里,513,1317,472,330,802,30,832
公投第１２案,臺北市,南港區,鴻福里,514,1331,440,342,782,22,804
公投第１２案,臺北市,南港區,百福里,515,1610,513,398,911,34,945
公投第１２案,臺北市,南港區,百福里,516,1542,499,337,836,32,868
公投第１２案,臺北市,南港區,百福里,517,1581,535,361,896,48,944
公投第１２案,臺北市,南港區,成福里,518,1225,432,312,744,35,779
公投第１２案,臺北市,南港區,成福里,519,1264,324,442,766,37,803
公投第１２案,臺北市,南港區,成福里,520,1649,564,383,947,54,1001
公投第１２案,臺北市,南港區,成福里,521,1267,413,322,735,30,765
公投第１２案,臺北市,南港區,成福里,522,1336,460,316,776,23,799
公投第１２案,臺北市,南港區,仁福里,523,1162,409,279,688,26,714
公投第１２案,臺北市,南港區,仁福里,524,1045,338,265,603,26,629
公投第１２案,臺北市,南港區,仁福里,525,1351,518,343,861,39,900
公投第１２案,臺北市,南港區,仁福里,526,1358,482,303,785,24,809
公投第１２案,臺北市,松山區,莊敬里,527,1583,552,368,920,28,948
公投第１２案,臺北市,松山區,莊敬里,528,1691,561,375,936,45,981
公投第１２案,臺北市,松山區,莊敬里,529,1386,448,313,761,32,793
公投第１２案,臺北市,松山區,東榮里,530,1362,460,314,774,51,825
公投第１２案,臺北市,松山區,東榮里,531,1399,485,320,805,41,846
公投第１２案,臺北市,松山區,東榮里,532,1324,455,304,759,56,815
公投第１２案,臺北市,松山區,東榮里,533,1296,482,320,802,28,830
公投第１２案,臺北市,松山區,東榮里,534,1386,518,304,822,31,853
公投第１２案,臺北市,松山區,三民里,535,1529,527,383,910,57,967
公投第１２案,臺北市,松山區,三民里,536,1416,487,306,793,35,828
公投第１２案,臺北市,松山區,三民里,537,1619,521,335,856,51,907
公投第１２案,臺北市,松山區,三民里,538,1386,501,332,833,31,864
公投第１２案,臺北市,松山區,新益里,539,1380,469,387,856,29,885
公投第１２案,臺北市,松山區,新益里,540,1357,477,329,806,28,834
公投第１２案,臺北市,松山區,新益里,541,1296,442,350,792,21,813
公投第１２案,臺北市,松山區,富錦里,542,1632,550,367,917,68,985
公投第１２案,臺北市,松山區,富錦里,543,1414,490,307,797,31,828
公投第１２案,臺北市,松山區,富錦里,544,1404,484,340,824,32,856
公投第１２案,臺北市,松山區,新東里,545,1365,501,301,802,51,853
公投第１２案,臺北市,松山區,新東里,546,1431,467,360,827,38,865
公投第１２案,臺北市,松山區,新東里,547,1483,494,374,868,44,912
公投第１２案,臺北市,松山區,富泰里,548,1293,468,314,782,36,818
公投第１２案,臺北市,松山區,富泰里,549,1410,536,233,769,37,806
公投第１２案,臺北市,松山區,富泰里,550,1307,452,298,750,42,792
公投第１２案,臺北市,松山區,介壽里,551,1242,457,301,758,36,794
公投第１２案,臺北市,松山區,介壽里,552,1192,438,271,709,31,740
公投第１２案,臺北市,松山區,介壽里,553,1276,467,297,764,39,803
公投第１２案,臺北市,松山區,精忠里,554,1201,411,285,696,18,714
公投第１２案,臺北市,松山區,精忠里,555,1318,451,315,766,30,796
公投第１２案,臺北市,松山區,精忠里,556,1157,436,258,694,24,718
公投第１２案,臺北市,松山區,東光里,557,1157,389,281,670,15,685
公投第１２案,臺北市,松山區,東光里,558,1357,484,323,807,36,843
公投第１２案,臺北市,松山區,東光里,559,1215,401,251,652,22,674
公投第１２案,臺北市,松山區,東光里,560,1345,452,303,755,31,786
公投第１２案,臺北市,松山區,東光里,561,1237,414,294,708,41,749
公投第１２案,臺北市,松山區,龍田里,562,1393,537,296,833,41,874
公投第１２案,臺北市,松山區,龍田里,563,1331,507,335,842,26,868
公投第１２案,臺北市,松山區,龍田里,564,1550,537,400,937,43,980
公投第１２案,臺北市,松山區,龍田里,565,1308,480,244,724,18,742
公投第１２案,臺北市,松山區,龍田里,566,1490,509,331,840,38,878
公投第１２案,臺北市,松山區,龍田里,567,1406,552,308,860,38,898
公投第１２案,臺北市,松山區,東昌里,568,1191,408,336,744,30,774
公投第１２案,臺北市,松山區,東昌里,569,1095,373,263,636,42,678
公投第１２案,臺北市,松山區,東勢里,570,1198,405,262,667,46,713
公投第１２案,臺北市,松山區,東勢里,571,1265,461,253,714,35,749
公投第１２案,臺北市,松山區,東勢里,572,1225,412,285,697,27,724
公投第１２案,臺北市,松山區,中華里,573,1698,618,383,1001,51,1052
公投第１２案,臺北市,松山區,中華里,574,1819,646,365,1011,39,1050
公投第１２案,臺北市,松山區,中華里,575,1754,588,420,1008,48,1056
公投第１２案,臺北市,松山區,民有里,576,1361,436,381,817,40,857
公投第１２案,臺北市,松山區,民有里,577,1189,456,266,722,22,744
公投第１２案,臺北市,松山區,民有里,578,1214,432,283,715,32,747
公投第１２案,臺北市,松山區,民有里,579,1284,451,293,744,26,770
公投第１２案,臺北市,松山區,民有里,580,1297,452,314,766,41,807
公投第１２案,臺北市,松山區,民有里,581,1330,411,339,750,31,781
公投第１２案,臺北市,松山區,民福里,582,1396,534,301,835,36,871
公投第１２案,臺北市,松山區,民福里,583,1480,534,300,834,20,854
公投第１２案,臺北市,松山區,民福里,584,1419,528,310,838,26,864
公投第１２案,臺北市,松山區,民福里,585,1390,498,322,820,30,850
公投第１２案,臺北市,松山區,松基里,586,1525,502,379,881,39,920
公投第１２案,臺北市,松山區,松基里,587,1633,532,350,882,35,917
公投第１２案,臺北市,松山區,慈祐里,588,2677,484,396,880,24,904
公投第１２案,臺北市,松山區,慈祐里,589,1281,406,323,729,42,771
公投第１２案,臺北市,松山區,慈祐里,590,1469,393,298,691,32,723
公投第１２案,臺北市,松山區,慈祐里,591,1700,516,386,902,67,969
公投第１２案,臺北市,松山區,安平里,592,1503,447,344,791,39,830
公投第１２案,臺北市,松山區,安平里,593,1309,421,330,751,28,779
公投第１２案,臺北市,松山區,安平里,594,1376,458,324,782,56,838
公投第１２案,臺北市,松山區,安平里,595,1654,588,361,949,33,982
公投第１２案,臺北市,松山區,安平里,596,1601,470,390,860,52,912
公投第１２案,臺北市,松山區,鵬程里,597,1496,497,353,850,34,884
公投第１２案,臺北市,松山區,鵬程里,598,1598,546,408,954,62,1016
公投第１２案,臺北市,松山區,鵬程里,599,1751,635,386,1021,41,1062
公投第１２案,臺北市,松山區,自強里,600,1557,588,350,938,36,974
公投第１２案,臺北市,松山區,自強里,601,1686,705,351,1056,40,1096
公投第１２案,臺北市,松山區,自強里,602,1707,664,334,998,49,1047
公投第１２案,臺北市,松山區,自強里,603,1854,737,413,1150,45,1195
公投第１２案,臺北市,松山區,自強里,604,1740,546,399,945,35,980
公投第１２案,臺北市,松山區,吉祥里,605,1494,477,362,839,51,890
公投第１２案,臺北市,松山區,吉祥里,606,1453,506,332,838,42,880
公投第１２案,臺北市,松山區,吉祥里,607,1458,499,341,840,39,879
公投第１２案,臺北市,松山區,吉祥里,608,1536,474,398,872,29,901
公投第１２案,臺北市,松山區,吉祥里,609,1463,520,337,857,26,883
公投第１２案,臺北市,松山區,新聚里,610,1790,477,441,918,31,949
公投第１２案,臺北市,松山區,新聚里,611,1679,552,426,978,42,1020
公投第１２案,臺北市,松山區,新聚里,612,1785,508,387,895,44,939
公投第１２案,臺北市,松山區,新聚里,613,1793,537,427,964,41,1005
公投第１２案,臺北市,松山區,復盛里,614,1381,560,212,772,46,818
公投第１２案,臺北市,松山區,復盛里,615,1279,424,319,743,34,777
公投第１２案,臺北市,松山區,復盛里,616,1681,558,406,964,46,1010
公投第１２案,臺北市,松山區,復盛里,617,1232,431,309,740,39,779
公投第１２案,臺北市,松山區,中正里,618,1533,510,349,859,30,889
公投第１２案,臺北市,松山區,中正里,619,1540,536,385,921,32,953
公投第１２案,臺北市,松山區,中正里,620,1716,564,403,967,26,993
公投第１２案,臺北市,松山區,中正里,621,1664,504,387,891,40,931
公投第１２案,臺北市,松山區,中正里,622,1350,434,313,747,28,775
公投第１２案,臺北市,松山區,中崙里,623,1837,610,403,1013,36,1049
公投第１２案,臺北市,松山區,中崙里,624,1558,464,343,807,49,856
公投第１２案,臺北市,松山區,美仁里,625,1420,509,326,835,42,877
公投第１２案,臺北市,松山區,美仁里,626,1474,493,320,813,34,847
公投第１２案,臺北市,松山區,吉仁里,627,1591,541,334,875,42,917
公投第１２案,臺北市,松山區,吉仁里,628,1726,479,476,955,48,1003
公投第１２案,臺北市,松山區,敦化里,629,1452,761,59,820,28,848
公投第１２案,臺北市,松山區,敦化里,630,1482,493,323,816,25,841
公投第１２案,臺北市,松山區,敦化里,631,1460,496,345,841,39,880
公投第１２案,臺北市,松山區,敦化里,632,1398,452,328,780,28,808
公投第１２案,臺北市,松山區,復源里,633,1423,509,329,838,40,878
公投第１２案,臺北市,松山區,復源里,634,1226,436,285,721,22,743
公投第１２案,臺北市,松山區,復建里,635,1158,415,249,664,39,703
公投第１２案,臺北市,松山區,復建里,636,1426,439,359,798,26,824
公投第１２案,臺北市,松山區,復建里,637,1177,420,277,697,16,713
公投第１２案,臺北市,松山區,復勢里,638,1363,449,321,770,29,799
公投第１２案,臺北市,松山區,復勢里,639,1240,464,273,737,35,772
公投第１２案,臺北市,松山區,復勢里,640,1375,475,347,822,38,860
公投第１２案,臺北市,松山區,復勢里,641,1377,432,359,791,35,826
公投第１２案,臺北市,松山區,福成里,642,1225,379,277,656,24,680
公投第１２案,臺北市,松山區,福成里,643,1017,342,288,630,25,655
公投第１２案,臺北市,信義區,西村里,644,2476,483,306,789,26,815
公投第１２案,臺北市,信義區,西村里,645,1381,542,314,856,27,883
公投第１２案,臺北市,信義區,西村里,646,1294,500,270,770,47,817
公投第１２案,臺北市,信義區,正和里,647,1351,452,322,774,33,807
公投第１２案,臺北市,信義區,正和里,648,1296,462,295,757,24,781
公投第１２案,臺北市,信義區,正和里,649,1302,479,313,792,31,823
公投第１２案,臺北市,信義區,興隆里,650,1025,343,201,544,44,588
公投第１２案,臺北市,信義區,興隆里,651,1421,461,292,753,33,786
公投第１２案,臺北市,信義區,中興里,652,1501,507,323,830,28,858
公投第１２案,臺北市,信義區,中興里,653,1575,450,352,802,23,825
公投第１２案,臺北市,信義區,新仁里,654,1516,534,313,847,28,875
公投第１２案,臺北市,信義區,新仁里,655,1382,506,314,820,21,841
公投第１２案,臺北市,信義區,興雅里,656,1128,396,231,627,35,662
公投第１２案,臺北市,信義區,興雅里,657,1397,492,271,763,34,797
公投第１２案,臺北市,信義區,興雅里,658,1161,386,302,688,43,731
公投第１２案,臺北市,信義區,興雅里,659,1368,436,328,764,40,804
公投第１２案,臺北市,信義區,敦厚里,660,1049,391,225,616,20,636
公投第１２案,臺北市,信義區,敦厚里,661,1308,454,304,758,35,793
公投第１２案,臺北市,信義區,敦厚里,662,1154,387,309,696,36,732
公投第１２案,臺北市,信義區,敦厚里,663,1078,331,311,642,21,663
公投第１２案,臺北市,信義區,廣居里,664,1375,478,297,775,38,813
公投第１２案,臺北市,信義區,廣居里,665,1448,513,314,827,41,868
公投第１２案,臺北市,信義區,廣居里,666,1250,431,303,734,28,762
公投第１２案,臺北市,信義區,廣居里,667,1381,439,366,805,24,829
公投第１２案,臺北市,信義區,廣居里,668,1213,423,290,713,37,750
公投第１２案,臺北市,信義區,安康里,669,1373,475,349,824,35,859
公投第１２案,臺北市,信義區,安康里,670,1226,435,295,730,27,757
公投第１２案,臺北市,信義區,安康里,671,1117,388,281,669,17,686
公投第１２案,臺北市,信義區,安康里,672,1123,401,275,676,28,704
公投第１２案,臺北市,信義區,安康里,673,1200,412,277,689,43,732
公投第１２案,臺北市,信義區,安康里,674,1335,418,269,687,25,712
公投第１２案,臺北市,信義區,安康里,675,1332,446,259,705,31,736
公投第１２案,臺北市,信義區,六藝里,676,1648,551,380,931,57,988
公投第１２案,臺北市,信義區,六藝里,677,1542,489,347,836,54,890
公投第１２案,臺北市,信義區,雅祥里,678,1228,353,335,688,46,734
公投第１２案,臺北市,信義區,雅祥里,679,1731,556,407,963,43,1006
公投第１２案,臺北市,信義區,雅祥里,680,1403,483,337,820,23,843
公投第１２案,臺北市,信義區,五常里,681,1929,629,365,994,74,1068
公投第１２案,臺北市,信義區,五常里,682,1300,436,328,764,38,802
公投第１２案,臺北市,信義區,五全里,683,1486,454,318,772,26,798
公投第１２案,臺北市,信義區,五全里,684,1532,434,321,755,33,788
公投第１２案,臺北市,信義區,五全里,685,1387,516,321,837,33,870
公投第１２案,臺北市,信義區,永吉里,686,1195,368,246,614,42,656
公投第１２案,臺北市,信義區,永吉里,687,1068,335,250,585,29,614
公投第１２案,臺北市,信義區,永吉里,688,1273,399,274,673,32,705
公投第１２案,臺北市,信義區,長春里,689,1329,466,332,798,44,842
公投第１２案,臺北市,信義區,長春里,690,1311,415,301,716,30,746
公投第１２案,臺北市,信義區,長春里,691,1258,397,273,670,37,707
公投第１２案,臺北市,信義區,四育里,692,1277,432,294,726,48,774
公投第１２案,臺北市,信義區,四育里,693,1285,442,332,774,44,818
公投第１２案,臺北市,信義區,四育里,694,1161,410,290,700,43,743
公投第１２案,臺北市,信義區,四育里,695,1299,403,330,733,34,767
公投第１２案,臺北市,信義區,四維里,696,1243,409,281,690,33,723
公投第１２案,臺北市,信義區,四維里,697,1197,378,275,653,43,696
公投第１２案,臺北市,信義區,四維里,698,1224,462,289,751,23,774
公投第１２案,臺北市,信義區,四維里,699,1147,368,255,623,35,658
公投第１２案,臺北市,信義區,永春里,700,1045,448,270,718,21,739
公投第１２案,臺北市,信義區,永春里,701,1096,418,271,689,26,715
公投第１２案,臺北市,信義區,永春里,702,1115,363,257,620,20,640
公投第１２案,臺北市,信義區,永春里,703,1117,371,234,605,42,647
公投第１２案,臺北市,信義區,富台里,704,1019,294,220,514,25,539
公投第１２案,臺北市,信義區,富台里,705,1346,457,303,760,37,797
公投第１２案,臺北市,信義區,富台里,706,1405,476,295,771,31,802
公投第１２案,臺北市,信義區,國業里,707,1356,440,306,746,42,788
公投第１２案,臺北市,信義區,國業里,708,1250,451,324,775,32,807
公投第１２案,臺北市,信義區,國業里,709,1254,448,299,747,32,779
公投第１２案,臺北市,信義區,國業里,710,1317,434,317,751,30,781
公投第１２案,臺北市,信義區,國業里,711,1271,468,295,763,41,804
公投第１２案,臺北市,信義區,松隆里,712,979,301,229,530,33,563
公投第１２案,臺北市,信義區,松隆里,713,1025,320,225,545,30,575
公投第１２案,臺北市,信義區,松友里,714,1512,445,290,735,37,772
公投第１２案,臺北市,信義區,松友里,715,1483,404,457,861,33,894
公投第１２案,臺北市,信義區,松友里,716,1359,457,347,804,28,832
公投第１２案,臺北市,信義區,松友里,717,1387,507,317,824,19,843
公投第１２案,臺北市,信義區,松光里,718,1455,439,331,770,36,806
公投第１２案,臺北市,信義區,松光里,719,1461,472,358,830,30,860
公投第１２案,臺北市,信義區,松光里,720,1532,494,381,875,43,918
公投第１２案,臺北市,信義區,中坡里,721,1043,356,283,639,32,671
公投第１２案,臺北市,信義區,中坡里,722,875,325,203,528,30,558
公投第１２案,臺北市,信義區,中坡里,723,927,305,217,522,23,545
公投第１２案,臺北市,信義區,中坡里,724,1119,388,247,635,52,687
公投第１２案,臺北市,信義區,中行里,725,1463,483,240,723,42,765
公投第１２案,臺北市,信義區,中行里,726,1293,449,350,799,30,829
公投第１２案,臺北市,信義區,中行里,727,1553,493,353,846,35,881
公投第１２案,臺北市,信義區,中行里,728,1360,422,351,773,20,793
公投第１２案,臺北市,信義區,中行里,729,1392,456,340,796,33,829
公投第１２案,臺北市,信義區,大道里,730,1377,454,339,793,18,811
公投第１２案,臺北市,信義區,大道里,731,1377,464,332,796,19,815
公投第１２案,臺北市,信義區,大道里,732,1269,399,258,657,32,689
公投第１２案,臺北市,信義區,大道里,733,1407,464,319,783,64,847
公投第１２案,臺北市,信義區,大仁里,734,1172,389,274,663,27,690
公投第１２案,臺北市,信義區,大仁里,735,1182,372,291,663,32,695
公投第１２案,臺北市,信義區,大仁里,736,1255,433,282,715,46,761
公投第１２案,臺北市,信義區,景新里,737,1689,552,331,883,20,903
公投第１２案,臺北市,信義區,景新里,738,1605,510,336,846,40,886
公投第１２案,臺北市,信義區,景新里,739,1143,379,244,623,31,654
公投第１２案,臺北市,信義區,惠安里,740,1440,453,303,756,36,792
公投第１２案,臺北市,信義區,惠安里,741,1495,501,327,828,31,859
公投第１２案,臺北市,信義區,惠安里,742,1514,491,385,876,46,922
公投第１２案,臺北市,信義區,惠安里,743,1449,490,300,790,34,824
公投第１２案,臺北市,信義區,三張里,744,1401,469,357,826,35,861
公投第１２案,臺北市,信義區,三張里,745,1181,366,270,636,20,656
公投第１２案,臺北市,信義區,三張里,746,1376,528,334,862,23,885
公投第１２案,臺北市,信義區,三張里,747,1422,514,318,832,44,876
公投第１２案,臺北市,信義區,三張里,748,1267,453,274,727,25,752
公投第１２案,臺北市,信義區,三張里,749,1220,375,278,653,29,682
公投第１２案,臺北市,信義區,三犁里,750,1562,496,295,791,33,824
公投第１２案,臺北市,信義區,三犁里,751,1455,472,340,812,18,830
公投第１２案,臺北市,信義區,三犁里,752,1605,521,338,859,35,894
公投第１２案,臺北市,信義區,六合里,753,1626,515,362,877,24,901
公投第１２案,臺北市,信義區,六合里,754,1561,531,374,905,36,941
公投第１２案,臺北市,信義區,六合里,755,1547,412,350,762,23,785
公投第１２案,臺北市,信義區,六合里,756,1336,434,310,744,22,766
公投第１２案,臺北市,信義區,泰和里,757,1314,411,268,679,24,703
公投第１２案,臺北市,信義區,泰和里,758,1297,432,269,701,29,730
公投第１２案,臺北市,信義區,泰和里,759,1366,432,290,722,40,762
公投第１２案,臺北市,信義區,泰和里,760,1472,468,331,799,45,844
公投第１２案,臺北市,信義區,泰和里,761,1450,477,323,800,39,839
公投第１２案,臺北市,信義區,景聯里,762,1328,441,300,741,33,774
公投第１２案,臺北市,信義區,景聯里,763,1399,469,346,815,38,853
公投第１２案,臺北市,信義區,景聯里,764,1373,480,317,797,49,846
公投第１２案,臺北市,信義區,景勤里,765,1099,388,219,607,17,624
公投第１２案,臺北市,信義區,景勤里,766,1226,379,303,682,56,738
公投第１２案,臺北市,信義區,景勤里,767,1267,404,279,683,12,695
公投第１２案,臺北市,信義區,雙和里,768,1531,548,319,867,44,911
公投第１２案,臺北市,信義區,雙和里,769,1438,496,344,840,33,873
公投第１２案,臺北市,信義區,雙和里,770,1657,494,388,882,30,912
公投第１２案,臺北市,信義區,雙和里,771,1621,544,379,923,44,967
公投第１２案,臺北市,信義區,嘉興里,772,1508,523,360,883,30,913
公投第１２案,臺北市,信義區,嘉興里,773,1334,469,308,777,38,815
公投第１２案,臺北市,信義區,黎順里,774,1246,321,246,567,32,599
公投第１２案,臺北市,信義區,黎順里,775,1196,401,324,725,33,758
公投第１２案,臺北市,信義區,黎順里,776,1220,419,292,711,30,741
公投第１２案,臺北市,信義區,黎平里,777,1538,480,357,837,32,869
公投第１２案,臺北市,信義區,黎平里,778,1565,537,352,889,54,943
公投第１２案,臺北市,信義區,黎平里,779,1621,473,334,807,67,874
公投第１２案,臺北市,信義區,黎平里,780,1486,484,313,797,46,843
公投第１２案,臺北市,信義區,黎忠里,781,1507,471,325,796,31,827
公投第１２案,臺北市,信義區,黎忠里,782,1516,503,363,866,37,903
公投第１２案,臺北市,信義區,黎忠里,783,1287,436,309,745,53,798
公投第１２案,臺北市,信義區,黎安里,784,1050,325,208,533,35,568
公投第１２案,臺北市,信義區,黎安里,785,801,291,175,466,30,496
公投第１２案,臺北市,中山區,正守里,786,1522,461,384,845,35,880
公投第１２案,臺北市,中山區,正守里,787,1332,426,306,732,31,763
公投第１２案,臺北市,中山區,正義里,788,1656,442,357,799,38,837
公投第１２案,臺北市,中山區,正義里,789,1367,383,297,680,27,707
公投第１２案,臺北市,中山區,正義里,790,1732,473,382,855,39,894
公投第１２案,臺北市,中山區,正得里,791,1634,523,373,896,44,940
公投第１２案,臺北市,中山區,正得里,792,1650,505,370,875,26,901
公投第１２案,臺北市,中山區,民安里,793,1392,463,327,790,36,826
公投第１２案,臺北市,中山區,民安里,794,1177,384,315,699,27,726
公投第１２案,臺北市,中山區,民安里,795,1477,474,378,852,39,891
公投第１２案,臺北市,中山區,康樂里,796,1063,315,225,540,41,581
公投第１２案,臺北市,中山區,康樂里,797,1296,412,278,690,32,722
公投第１２案,臺北市,中山區,中山里,798,1330,380,301,681,30,711
公投第１２案,臺北市,中山區,中山里,799,1483,424,342,766,37,803
公投第１２案,臺北市,中山區,中山里,800,1542,456,351,807,22,829
公投第１２案,臺北市,中山區,中山里,801,1710,567,282,849,41,890
公投第１２案,臺北市,中山區,聚盛里,802,1315,385,273,658,22,680
公投第１２案,臺北市,中山區,聚盛里,803,1245,398,269,667,40,707
公投第１２案,臺北市,中山區,聚盛里,804,1262,386,267,653,35,688
公投第１２案,臺北市,中山區,集英里,805,1518,438,383,821,45,866
公投第１２案,臺北市,中山區,集英里,806,1522,479,367,846,38,884
公投第１２案,臺北市,中山區,集英里,807,1580,452,348,800,33,833
公投第１２案,臺北市,中山區,集英里,808,1529,474,359,833,25,858
公投第１２案,臺北市,中山區,聚葉里,809,1221,380,276,656,33,689
公投第１２案,臺北市,中山區,聚葉里,810,1221,384,316,700,31,731
公投第１２案,臺北市,中山區,聚葉里,811,1139,319,231,550,31,581
公投第１２案,臺北市,中山區,恆安里,812,1407,423,326,749,59,808
公投第１２案,臺北市,中山區,恆安里,813,1321,401,328,729,29,758
公投第１２案,臺北市,中山區,恆安里,814,1578,453,313,766,28,794
公投第１２案,臺北市,中山區,晴光里,815,1739,523,331,854,42,896
公投第１２案,臺北市,中山區,晴光里,816,1637,478,347,825,33,858
公投第１２案,臺北市,中山區,晴光里,817,1541,461,339,800,41,841
公投第１２案,臺北市,中山區,圓山里,818,1210,394,301,695,25,720
公投第１２案,臺北市,中山區,圓山里,819,1331,400,321,721,36,757
公投第１２案,臺北市,中山區,圓山里,820,1224,335,283,618,37,655
公投第１２案,臺北市,中山區,新庄里,821,1585,512,367,879,34,913
公投第１２案,臺北市,中山區,新庄里,822,1523,518,376,894,51,945
公投第１２案,臺北市,中山區,新庄里,823,1368,493,317,810,37,847
公投第１２案,臺北市,中山區,劍潭里,824,1805,685,307,992,41,1033
公投第１２案,臺北市,中山區,劍潭里,825,1404,565,247,812,21,833
公投第１２案,臺北市,中山區,大直里,826,1708,594,439,1033,35,1068
公投第１２案,臺北市,中山區,大直里,827,1451,501,386,887,37,924
公投第１２案,臺北市,中山區,大直里,828,1684,572,426,998,44,1042
公投第１２案,臺北市,中山區,大直里,829,1585,564,332,896,21,917
公投第１２案,臺北市,中山區,大直里,830,1391,466,320,786,60,846
公投第１２案,臺北市,中山區,成功里,831,1375,505,346,851,60,911
公投第１２案,臺北市,中山區,成功里,832,1472,553,326,879,18,897
公投第１２案,臺北市,中山區,成功里,833,1327,402,312,714,27,741
公投第１２案,臺北市,中山區,成功里,834,1401,490,318,808,19,827
公投第１２案,臺北市,中山區,永安里,835,1423,476,339,815,34,849
公投第１２案,臺北市,中山區,永安里,836,1569,513,399,912,25,937
公投第１２案,臺北市,中山區,永安里,837,1651,535,401,936,29,965
公投第１２案,臺北市,中山區,永安里,838,1624,518,369,887,28,915
公投第１２案,臺北市,中山區,永安里,839,1713,584,433,1017,36,1053
公投第１２案,臺北市,中山區,金泰里,840,1647,588,366,954,41,995
公投第１２案,臺北市,中山區,金泰里,841,1762,543,377,920,42,962
公投第１２案,臺北市,中山區,金泰里,842,1399,519,308,827,34,861
公投第１２案,臺北市,中山區,金泰里,843,1489,535,356,891,32,923
公投第１２案,臺北市,中山區,北安里,844,1269,456,310,766,27,793
公投第１２案,臺北市,中山區,北安里,845,998,376,231,607,26,633
公投第１２案,臺北市,中山區,新喜里,846,1472,445,360,805,30,835
公投第１２案,臺北市,中山區,新喜里,847,1517,427,360,787,47,834
公投第１２案,臺北市,中山區,新喜里,848,1704,562,420,982,47,1029
公投第１２案,臺北市,中山區,新福里,849,1603,528,370,898,42,940
公投第１２案,臺北市,中山區,新福里,850,1432,460,291,751,48,799
公投第１２案,臺北市,中山區,新福里,851,1500,462,370,832,59,891
公投第１２案,臺北市,中山區,松江里,852,1332,469,317,786,34,820
公投第１２案,臺北市,中山區,松江里,853,1450,485,356,841,46,887
公投第１２案,臺北市,中山區,松江里,854,1434,474,373,847,34,881
公投第１２案,臺北市,中山區,松江里,855,1419,455,309,764,36,800
公投第１２案,臺北市,中山區,新生里,856,1292,393,313,706,30,736
公投第１２案,臺北市,中山區,新生里,857,1526,434,389,823,31,854
公投第１２案,臺北市,中山區,新生里,858,1582,435,326,761,36,797
公投第１２案,臺北市,中山區,中庄里,859,1588,436,352,788,45,833
公投第１２案,臺北市,中山區,中庄里,860,1463,465,339,804,44,848
公投第１２案,臺北市,中山區,中庄里,861,1533,433,388,821,48,869
公投第１２案,臺北市,中山區,大佳里,862,944,317,228,545,26,571
公投第１２案,臺北市,中山區,行政里,863,1745,604,445,1049,37,1086
公投第１２案,臺北市,中山區,行政里,864,1679,469,346,815,30,845
公投第１２案,臺北市,中山區,行政里,865,3419,449,334,783,37,820
公投第１２案,臺北市,中山區,行仁里,866,1387,463,329,792,43,835
公投第１２案,臺北市,中山區,行仁里,867,1672,584,387,971,41,1012
公投第１２案,臺北市,中山區,行仁里,868,1319,442,302,744,36,780
公投第１２案,臺北市,中山區,行仁里,869,1364,414,319,733,33,766
公投第１２案,臺北市,中山區,行仁里,870,1461,441,335,776,44,820
公投第１２案,臺北市,中山區,行孝里,871,1173,388,285,673,39,712
公投第１２案,臺北市,中山區,行孝里,872,1171,366,255,621,36,657
公投第１２案,臺北市,中山區,行孝里,873,1310,418,319,737,21,758
公投第１２案,臺北市,中山區,下埤里,874,1373,483,321,804,36,840
公投第１２案,臺北市,中山區,下埤里,875,1290,468,303,771,34,805
公投第１２案,臺北市,中山區,下埤里,876,1346,452,334,786,36,822
公投第１２案,臺北市,中山區,下埤里,877,1468,471,386,857,35,892
公投第１２案,臺北市,中山區,下埤里,878,1178,409,279,688,23,711
公投第１２案,臺北市,中山區,江寧里,879,1654,575,376,951,40,991
公投第１２案,臺北市,中山區,江寧里,880,1464,483,336,819,42,861
公投第１２案,臺北市,中山區,江寧里,881,1450,487,335,822,31,853
公投第１２案,臺北市,中山區,江寧里,882,1534,463,367,830,50,880
公投第１２案,臺北市,中山區,江山里,883,1703,530,402,932,43,975
公投第１２案,臺北市,中山區,江山里,884,1610,494,466,960,50,1010
公投第１２案,臺北市,中山區,江山里,885,1653,470,396,866,62,928
公投第１２案,臺北市,中山區,江山里,886,1694,575,413,988,48,1036
公投第１２案,臺北市,中山區,中吉里,887,1623,500,371,871,41,912
公投第１２案,臺北市,中山區,中吉里,888,1618,504,391,895,51,946
公投第１２案,臺北市,中山區,中吉里,889,1583,491,374,865,42,907
公投第１２案,臺北市,中山區,中原里,890,1605,486,435,921,62,983
公投第１２案,臺北市,中山區,中原里,891,1398,478,365,843,51,894
公投第１２案,臺北市,中山區,中原里,892,1526,523,414,937,52,989
公投第１２案,臺北市,中山區,興亞里,893,1555,463,419,882,46,928
公投第１２案,臺北市,中山區,興亞里,894,1597,508,356,864,29,893
公投第１２案,臺北市,中山區,興亞里,895,1587,493,392,885,54,939
公投第１２案,臺北市,中山區,中央里,896,1587,507,412,919,34,953
公投第１２案,臺北市,中山區,中央里,897,1546,515,388,903,61,964
公投第１２案,臺北市,中山區,朱馥里,898,1322,435,275,710,43,753
公投第１２案,臺北市,中山區,朱馥里,899,1267,416,294,710,34,744
公投第１２案,臺北市,中山區,朱馥里,900,1210,384,238,622,19,641
公投第１２案,臺北市,中山區,朱馥里,901,1295,442,260,702,47,749
公投第１２案,臺北市,中山區,龍洲里,902,1467,497,350,847,43,890
公投第１２案,臺北市,中山區,龍洲里,903,1491,600,306,906,26,932
公投第１２案,臺北市,中山區,龍洲里,904,1516,593,351,944,42,986
公投第１２案,臺北市,中山區,朱園里,905,1384,404,315,719,32,751
公投第１２案,臺北市,中山區,朱園里,906,1138,388,301,689,39,728
公投第１２案,臺北市,中山區,朱園里,907,1513,452,335,787,28,815
公投第１２案,臺北市,中山區,埤頭里,908,1559,535,343,878,50,928
公投第１２案,臺北市,中山區,埤頭里,909,1429,498,354,852,47,899
公投第１２案,臺北市,中山區,朱崙里,910,1245,459,309,768,21,789
公投第１２案,臺北市,中山區,朱崙里,911,1214,414,312,726,40,766
公投第１２案,臺北市,中山區,力行里,912,1394,441,358,799,33,832
公投第１２案,臺北市,中山區,力行里,913,1336,401,252,653,17,670
公投第１２案,臺北市,中山區,力行里,914,1227,393,272,665,35,700
公投第１２案,臺北市,中山區,力行里,915,1382,471,316,787,33,820
公投第１２案,臺北市,中山區,復華里,916,1436,456,326,782,43,825
公投第１２案,臺北市,中山區,復華里,917,1405,377,325,702,39,741
公投第１２案,臺北市,中山區,復華里,918,1259,414,287,701,28,729
公投第１２案,臺北市,大同區,玉泉里,919,1261,405,304,709,48,757
公投第１２案,臺北市,大同區,玉泉里,920,1352,460,336,796,40,836
公投第１２案,臺北市,大同區,建明里,921,1462,473,328,801,43,844
公投第１２案,臺北市,大同區,建明里,922,1510,461,341,802,66,868
公投第１２案,臺北市,大同區,建功里,923,1496,438,343,781,24,805
公投第１２案,臺北市,大同區,建功里,924,1329,384,326,710,45,755
公投第１２案,臺北市,大同區,建功里,925,1307,399,314,713,56,769
公投第１２案,臺北市,大同區,建泰里,926,1065,322,276,598,36,634
公投第１２案,臺北市,大同區,建泰里,927,1085,345,276,621,19,640
公投第１２案,臺北市,大同區,建泰里,928,1047,332,292,624,51,675
公投第１２案,臺北市,大同區,永樂里,929,1215,319,313,632,29,661
公投第１２案,臺北市,大同區,永樂里,930,1117,379,295,674,24,698
公投第１２案,臺北市,大同區,永樂里,931,1186,383,322,705,31,736
公投第１２案,臺北市,大同區,永樂里,932,1185,399,287,686,41,727
公投第１２案,臺北市,大同區,朝陽里,933,1359,438,314,752,35,787
公投第１２案,臺北市,大同區,朝陽里,934,1273,423,298,721,24,745
公投第１２案,臺北市,大同區,朝陽里,935,1291,403,349,752,46,798
公投第１２案,臺北市,大同區,星明里,936,1288,387,296,683,36,719
公投第１２案,臺北市,大同區,星明里,937,1245,421,337,758,28,786
公投第１２案,臺北市,大同區,星明里,938,1261,423,329,752,38,790
公投第１２案,臺北市,大同區,星明里,939,1348,413,314,727,29,756
公投第１２案,臺北市,大同區,光能里,940,1676,509,406,915,73,988
公投第１２案,臺北市,大同區,光能里,941,1311,493,283,776,39,815
公投第１２案,臺北市,大同區,光能里,942,1316,440,320,760,41,801
公投第１２案,臺北市,大同區,大有里,943,1409,449,316,765,57,822
公投第１２案,臺北市,大同區,大有里,944,1436,462,364,826,43,869
公投第１２案,臺北市,大同區,大有里,945,1408,420,375,795,45,840
公投第１２案,臺北市,大同區,延平里,946,1276,397,305,702,33,735
公投第１２案,臺北市,大同區,延平里,947,1110,349,261,610,22,632
公投第１２案,臺北市,大同區,延平里,948,1324,402,350,752,23,775
公投第１２案,臺北市,大同區,雙連里,949,1016,350,226,576,22,598
公投第１２案,臺北市,大同區,雙連里,950,1028,376,239,615,31,646
公投第１２案,臺北市,大同區,雙連里,951,1158,416,251,667,40,707
公投第１２案,臺北市,大同區,雙連里,952,1138,399,272,671,31,702
公投第１２案,臺北市,大同區,雙連里,953,1214,408,287,695,41,736
公投第１２案,臺北市,大同區,雙連里,954,1090,351,261,612,28,640
公投第１２案,臺北市,大同區,雙連里,955,1305,484,310,794,37,831
公投第１２案,臺北市,大同區,南芳里,956,1167,377,259,636,26,662
公投第１２案,臺北市,大同區,南芳里,957,1148,359,287,646,28,674
公投第１２案,臺北市,大同區,南芳里,958,1203,422,299,721,31,752
公投第１２案,臺北市,大同區,民權里,959,1441,452,329,781,31,812
公投第１２案,臺北市,大同區,民權里,960,1315,446,323,769,51,820
公投第１２案,臺北市,大同區,民權里,961,1393,438,321,759,44,803
公投第１２案,臺北市,大同區,民權里,962,1278,434,304,738,32,770
公投第１２案,臺北市,大同區,景星里,963,1246,347,288,635,44,679
公投第１２案,臺北市,大同區,景星里,964,1142,375,247,622,47,669
公投第１２案,臺北市,大同區,隆和里,965,1336,479,323,802,39,841
公投第１２案,臺北市,大同區,隆和里,966,1363,411,376,787,48,835
公投第１２案,臺北市,大同區,蓬萊里,967,1476,528,329,857,21,878
公投第１２案,臺北市,大同區,蓬萊里,968,1418,444,356,800,41,841
公投第１２案,臺北市,大同區,蓬萊里,969,1460,469,313,782,37,819
公投第１２案,臺北市,大同區,國順里,970,1222,340,267,607,41,648
公投第１２案,臺北市,大同區,國順里,971,1246,344,247,591,66,657
公投第１２案,臺北市,大同區,國慶里,972,1256,430,315,745,39,784
公投第１２案,臺北市,大同區,國慶里,973,1289,435,305,740,22,762
公投第１２案,臺北市,大同區,國慶里,974,1340,397,322,719,28,747
公投第１２案,臺北市,大同區,揚雅里,975,1555,462,334,796,44,840
公投第１２案,臺北市,大同區,揚雅里,976,2459,485,300,785,53,838
公投第１２案,臺北市,大同區,斯文里,977,1108,286,213,499,38,537
公投第１２案,臺北市,大同區,斯文里,978,867,276,175,451,35,486
公投第１２案,臺北市,大同區,斯文里,979,1329,424,377,801,39,840
公投第１２案,臺北市,大同區,斯文里,980,1162,368,292,660,21,681
公投第１２案,臺北市,大同區,鄰江里,981,1434,439,294,733,62,795
公投第１２案,臺北市,大同區,鄰江里,982,1351,402,340,742,53,795
公投第１２案,臺北市,大同區,鄰江里,983,1531,439,318,757,76,833
公投第１２案,臺北市,大同區,鄰江里,984,1507,431,309,740,25,765
公投第１２案,臺北市,大同區,至聖里,985,1488,458,342,800,39,839
公投第１２案,臺北市,大同區,至聖里,986,1384,481,330,811,44,855
公投第１２案,臺北市,大同區,至聖里,987,1460,525,287,812,42,854
公投第１２案,臺北市,大同區,至聖里,988,1371,487,332,819,30,849
公投第１２案,臺北市,大同區,至聖里,989,1439,443,344,787,17,804
公投第１２案,臺北市,大同區,老師里,990,1376,419,372,791,45,836
公投第１２案,臺北市,大同區,老師里,991,1366,410,317,727,49,776
公投第１２案,臺北市,大同區,老師里,992,1218,436,314,750,38,788
公投第１２案,臺北市,大同區,老師里,993,1235,417,283,700,36,736
公投第１２案,臺北市,大同區,重慶里,994,1364,461,271,732,18,750
公投第１２案,臺北市,大同區,重慶里,995,1408,463,378,841,48,889
公投第１２案,臺北市,大同區,重慶里,996,1450,467,352,819,37,856
公投第１２案,臺北市,大同區,重慶里,997,1429,470,364,834,54,888
公投第１２案,臺北市,大同區,保安里,998,1170,372,296,668,52,720
公投第１２案,臺北市,大同區,保安里,999,1245,355,339,694,44,738
公投第１２案,臺北市,大同區,保安里,1000,1215,423,308,731,58,789
公投第１２案,臺北市,中正區,水源里,1001,1308,459,300,759,28,787
公投第１２案,臺北市,中正區,水源里,1002,1317,400,300,700,39,739
公投第１２案,臺北市,中正區,富水里,1003,1069,392,247,639,23,662
公投第１２案,臺北市,中正區,富水里,1004,1128,366,239,605,33,638
公投第１２案,臺北市,中正區,文盛里,1005,1053,368,255,623,26,649
公投第１２案,臺北市,中正區,文盛里,1006,1048,368,249,617,17,634
公投第１２案,臺北市,中正區,林興里,1007,1297,449,260,709,35,744
公投第１２案,臺北市,中正區,林興里,1008,1193,445,251,696,21,717
公投第１２案,臺北市,中正區,林興里,1009,1500,558,384,942,34,976
公投第１２案,臺北市,中正區,河堤里,1010,1346,424,311,735,27,762
公投第１２案,臺北市,中正區,河堤里,1011,1283,408,303,711,21,732
公投第１２案,臺北市,中正區,河堤里,1012,1450,455,333,788,42,830
公投第１２案,臺北市,中正區,頂東里,1013,1433,481,324,805,47,852
公投第１２案,臺北市,中正區,頂東里,1014,1309,460,362,822,39,861
公投第１２案,臺北市,中正區,頂東里,1015,1386,494,323,817,12,829
公投第１２案,臺北市,中正區,頂東里,1016,1201,415,283,698,31,729
公投第１２案,臺北市,中正區,網溪里,1017,1336,467,324,791,33,824
公投第１２案,臺北市,中正區,網溪里,1018,1358,446,357,803,34,837
公投第１２案,臺北市,中正區,網溪里,1019,1177,403,286,689,30,719
公投第１２案,臺北市,中正區,網溪里,1020,1236,464,290,754,25,779
公投第１２案,臺北市,中正區,板溪里,1021,1478,499,337,836,34,870
公投第１２案,臺北市,中正區,板溪里,1022,1474,488,364,852,29,881
公投第１２案,臺北市,中正區,螢圃里,1023,1172,369,288,657,35,692
公投第１２案,臺北市,中正區,螢圃里,1024,1310,413,321,734,40,774
公投第１２案,臺北市,中正區,螢圃里,1025,1263,434,287,721,36,757
公投第１２案,臺北市,中正區,螢圃里,1026,1169,402,269,671,30,701
公投第１２案,臺北市,中正區,螢雪里,1027,1391,470,325,795,21,816
公投第１２案,臺北市,中正區,螢雪里,1028,1201,409,254,663,22,685
公投第１２案,臺北市,中正區,螢雪里,1029,1324,426,330,756,36,792
公投第１２案,臺北市,中正區,永功里,1030,1216,379,269,648,44,692
公投第１２案,臺北市,中正區,永功里,1031,1183,278,372,650,40,690
公投第１２案,臺北市,中正區,永功里,1032,1469,524,342,866,60,926
公投第１２案,臺北市,中正區,永功里,1033,1411,440,348,788,34,822
公投第１２案,臺北市,中正區,永昌里,1034,1398,456,334,790,58,848
公投第１２案,臺北市,中正區,永昌里,1035,1479,455,343,798,49,847
公投第１２案,臺北市,中正區,永昌里,1036,1620,542,341,883,33,916
公投第１２案,臺北市,中正區,龍興里,1037,1041,359,248,607,17,624
公投第１２案,臺北市,中正區,龍興里,1038,1056,348,257,605,20,625
公投第１２案,臺北市,中正區,龍興里,1039,1063,400,265,665,29,694
公投第１２案,臺北市,中正區,忠勤里,1040,1591,422,292,714,33,747
公投第１２案,臺北市,中正區,忠勤里,1041,1502,411,256,667,49,716
公投第１２案,臺北市,中正區,忠勤里,1042,1331,405,276,681,33,714
公投第１２案,臺北市,中正區,忠勤里,1043,1441,482,283,765,50,815
公投第１２案,臺北市,中正區,廈安里,1044,1273,447,314,761,35,796
公投第１２案,臺北市,中正區,廈安里,1045,1133,405,262,667,29,696
公投第１２案,臺北市,中正區,廈安里,1046,1156,388,284,672,27,699
公投第１２案,臺北市,中正區,愛國里,1047,1377,431,327,758,44,802
公投第１２案,臺北市,中正區,愛國里,1048,1266,451,286,737,44,781
公投第１２案,臺北市,中正區,南門里,1049,1111,415,269,684,29,713
公投第１２案,臺北市,中正區,南門里,1050,1124,376,276,652,26,678
公投第１２案,臺北市,中正區,龍光里,1051,1373,469,336,805,37,842
公投第１２案,臺北市,中正區,龍光里,1052,1351,494,318,812,27,839
公投第１２案,臺北市,中正區,南福里,1053,1495,515,361,876,23,899
公投第１２案,臺北市,中正區,南福里,1054,1436,541,358,899,24,923
公投第１２案,臺北市,中正區,南福里,1055,1516,508,347,855,23,878
公投第１２案,臺北市,中正區,南福里,1056,1374,450,329,779,29,808
公投第１２案,臺北市,中正區,南福里,1057,1522,497,316,813,30,843
公投第１２案,臺北市,中正區,南福里,1058,1336,496,282,778,30,808
公投第１２案,臺北市,中正區,龍福里,1059,1551,507,380,887,30,917
公投第１２案,臺北市,中正區,龍福里,1060,1594,539,364,903,52,955
公投第１２案,臺北市,中正區,龍福里,1061,1503,492,345,837,37,874
公投第１２案,臺北市,中正區,新營里,1062,1455,563,283,846,19,865
公投第１２案,臺北市,中正區,新營里,1063,1439,525,312,837,19,856
公投第１２案,臺北市,中正區,新營里,1064,1469,511,327,838,37,875
公投第１２案,臺北市,中正區,新營里,1065,1430,564,273,837,35,872
公投第１２案,臺北市,中正區,新營里,1066,1444,524,331,855,38,893
公投第１２案,臺北市,中正區,建國里,1067,1254,433,275,708,24,732
公投第１２案,臺北市,中正區,光復里,1068,932,323,220,543,33,576
公投第１２案,臺北市,中正區,光復里,1069,1055,334,273,607,36,643
公投第１２案,臺北市,中正區,光復里,1070,1226,411,287,698,26,724
公投第１２案,臺北市,中正區,黎明里,1071,1390,425,296,721,29,750
公投第１２案,臺北市,中正區,黎明里,1072,1336,457,295,752,30,782
公投第１２案,臺北市,中正區,梅花里,1073,1419,440,286,726,34,760
公投第１２案,臺北市,中正區,梅花里,1074,1361,456,351,807,43,850
公投第１２案,臺北市,中正區,幸福里,1075,2520,508,359,867,42,909
公投第１２案,臺北市,中正區,幸福里,1076,1224,454,257,711,16,727
公投第１２案,臺北市,中正區,幸福里,1077,1272,377,288,665,4,669
公投第１２案,臺北市,中正區,幸市里,1078,1400,446,353,799,23,822
公投第１２案,臺北市,中正區,幸市里,1079,1319,423,294,717,27,744
公投第１２案,臺北市,中正區,幸市里,1080,1232,465,275,740,25,765
公投第１２案,臺北市,中正區,東門里,1081,1265,456,319,775,32,807
公投第１２案,臺北市,中正區,東門里,1082,1055,385,262,647,19,666
公投第１２案,臺北市,中正區,東門里,1083,954,330,208,538,30,568
公投第１２案,臺北市,中正區,文北里,1084,1018,377,206,583,34,617
公投第１２案,臺北市,中正區,文北里,1085,1431,475,312,787,27,814
公投第１２案,臺北市,中正區,文北里,1086,1271,351,291,642,36,678
公投第１２案,臺北市,中正區,文北里,1087,983,326,263,589,26,615
公投第１２案,臺北市,中正區,文祥里,1088,1594,531,356,887,32,919
公投第１２案,臺北市,中正區,文祥里,1089,1565,552,359,911,40,951
公投第１２案,臺北市,中正區,文祥里,1090,1650,560,361,921,36,957
公投第１２案,臺北市,中正區,文祥里,1091,1600,484,368,852,34,886
公投第１２案,臺北市,中正區,三愛里,1092,1391,451,320,771,26,797
公投第１２案,臺北市,中正區,三愛里,1093,1769,581,391,972,35,1007
公投第１２案,臺北市,中正區,三愛里,1094,1487,476,379,855,26,881
公投第１２案,臺北市,中正區,三愛里,1095,1291,475,280,755,29,784
公投第１２案,臺北市,中正區,三愛里,1096,1289,465,288,753,25,778
公投第１２案,臺北市,萬華區,福星里,1097,1305,397,339,736,40,776
公投第１２案,臺北市,萬華區,福星里,1098,1183,320,230,550,53,603
公投第１２案,臺北市,萬華區,福星里,1099,1176,367,280,647,24,671
公投第１２案,臺北市,萬華區,福星里,1100,1169,329,263,592,23,615
公投第１２案,臺北市,萬華區,萬壽里,1101,1457,463,252,715,28,743
公投第１２案,臺北市,萬華區,萬壽里,1102,1563,388,330,718,41,759
公投第１２案,臺北市,萬華區,西門里,1103,1771,450,395,845,24,869
公投第１２案,臺北市,萬華區,西門里,1104,1615,450,355,805,36,841
公投第１２案,臺北市,萬華區,新起里,1105,1478,449,320,769,60,829
公投第１２案,臺北市,萬華區,新起里,1106,1462,444,342,786,28,814
公投第１２案,臺北市,萬華區,新起里,1107,1507,429,266,695,43,738
公投第１２案,臺北市,萬華區,新起里,1108,1347,437,313,750,43,793
公投第１２案,臺北市,萬華區,菜園里,1109,1367,390,308,698,34,732
公投第１２案,臺北市,萬華區,菜園里,1110,1277,423,323,746,40,786
公投第１２案,臺北市,萬華區,菜園里,1111,1395,439,366,805,49,854
公投第１２案,臺北市,萬華區,菜園里,1112,1450,416,333,749,44,793
公投第１２案,臺北市,萬華區,青山里,1113,1340,376,290,666,32,698
公投第１２案,臺北市,萬華區,青山里,1114,1242,359,275,634,36,670
公投第１２案,臺北市,萬華區,青山里,1115,1286,372,293,665,54,719
公投第１２案,臺北市,萬華區,青山里,1116,1324,378,300,678,41,719
公投第１２案,臺北市,萬華區,富民里,1117,1619,507,307,814,48,862
公投第１２案,臺北市,萬華區,富民里,1118,1352,382,257,639,38,677
公投第１２案,臺北市,萬華區,富民里,1119,1440,439,315,754,37,791
公投第１２案,臺北市,萬華區,福音里,1120,1194,368,310,678,45,723
公投第１２案,臺北市,萬華區,福音里,1121,1083,391,251,642,50,692
公投第１２案,臺北市,萬華區,福音里,1122,1237,384,252,636,50,686
公投第１２案,臺北市,萬華區,仁德里,1123,1625,454,396,850,33,883
公投第１２案,臺北市,萬華區,仁德里,1124,1324,425,324,749,44,793
公投第１２案,臺北市,萬華區,仁德里,1125,1352,424,344,768,38,806
公投第１２案,臺北市,萬華區,富福里,1126,2630,411,309,720,38,758
公投第１２案,臺北市,萬華區,富福里,1127,1504,507,361,868,44,912
公投第１２案,臺北市,萬華區,富福里,1128,1425,429,333,762,32,794
公投第１２案,臺北市,萬華區,柳鄉里,1129,1591,410,353,763,55,818
公投第１２案,臺北市,萬華區,柳鄉里,1130,1474,434,334,768,42,810
公投第１２案,臺北市,萬華區,柳鄉里,1131,1612,449,352,801,56,857
公投第１２案,臺北市,萬華區,華江里,1132,1447,429,327,756,52,808
公投第１２案,臺北市,萬華區,華江里,1133,1491,473,348,821,48,869
公投第１２案,臺北市,萬華區,華江里,1134,1500,501,364,865,35,900
公投第１２案,臺北市,萬華區,華江里,1135,1582,453,405,858,48,906
公投第１２案,臺北市,萬華區,華江里,1136,1623,453,355,808,39,847
公投第１２案,臺北市,萬華區,糖廍里,1137,1228,358,307,665,24,689
公投第１２案,臺北市,萬華區,糖廍里,1138,1268,390,291,681,42,723
公投第１２案,臺北市,萬華區,糖廍里,1139,1207,409,279,688,47,735
公投第１２案,臺北市,萬華區,糖廍里,1140,1188,368,309,677,40,717
公投第１２案,臺北市,萬華區,綠堤里,1141,1474,436,331,767,34,801
公投第１２案,臺北市,萬華區,綠堤里,1142,1304,346,268,614,24,638
公投第１２案,臺北市,萬華區,綠堤里,1143,1082,267,173,440,39,479
公投第１２案,臺北市,萬華區,頂碩里,1144,1052,314,238,552,28,580
公投第１２案,臺北市,萬華區,頂碩里,1145,1135,355,258,613,30,643
公投第１２案,臺北市,萬華區,頂碩里,1146,1225,348,294,642,51,693
公投第１２案,臺北市,萬華區,頂碩里,1147,1583,478,336,814,21,835
公投第１２案,臺北市,萬華區,頂碩里,1148,1403,391,346,737,49,786
公投第１２案,臺北市,萬華區,雙園里,1149,1406,465,299,764,53,817
公投第１２案,臺北市,萬華區,雙園里,1150,1401,472,327,799,39,838
公投第１２案,臺北市,萬華區,雙園里,1151,1188,386,289,675,49,724
公投第１２案,臺北市,萬華區,和平里,1152,1597,453,347,800,69,869
公投第１２案,臺北市,萬華區,和平里,1153,1290,456,297,753,48,801
公投第１２案,臺北市,萬華區,和平里,1154,1746,487,374,861,22,883
公投第１２案,臺北市,萬華區,和平里,1155,1595,412,323,735,37,772
公投第１２案,臺北市,萬華區,和德里,1156,1701,490,374,864,75,939
公投第１２案,臺北市,萬華區,和德里,1157,1339,331,277,608,59,667
公投第１２案,臺北市,萬華區,和德里,1158,1484,389,293,682,55,737
公投第１２案,臺北市,萬華區,和德里,1159,1604,488,373,861,54,915
公投第１２案,臺北市,萬華區,全德里,1160,1197,394,279,673,35,708
公投第１２案,臺北市,萬華區,全德里,1161,1347,376,304,680,59,739
公投第１２案,臺北市,萬華區,全德里,1162,1223,433,323,756,28,784
公投第１２案,臺北市,萬華區,日善里,1163,1036,319,273,592,38,630
公投第１２案,臺北市,萬華區,日善里,1164,1035,347,293,640,31,671
公投第１２案,臺北市,萬華區,日善里,1165,1141,404,279,683,28,711
公投第１２案,臺北市,萬華區,忠德里,1166,1271,408,328,736,23,759
公投第１２案,臺北市,萬華區,忠德里,1167,1328,402,333,735,58,793
公投第１２案,臺北市,萬華區,忠德里,1168,1286,419,315,734,31,765
公投第１２案,臺北市,萬華區,錦德里,1169,1679,526,398,924,54,978
公投第１２案,臺北市,萬華區,錦德里,1170,1619,487,375,862,51,913
公投第１２案,臺北市,萬華區,錦德里,1171,1625,463,330,793,33,826
公投第１２案,臺北市,萬華區,孝德里,1172,1623,545,375,920,41,961
公投第１２案,臺北市,萬華區,孝德里,1173,1280,397,277,674,48,722
公投第１２案,臺北市,萬華區,壽德里,1174,1608,490,357,847,49,896
公投第１２案,臺北市,萬華區,壽德里,1175,1453,482,312,794,57,851
公投第１２案,臺北市,萬華區,壽德里,1176,1472,528,349,877,37,914
公投第１２案,臺北市,萬華區,銘德里,1177,1373,429,339,768,31,799
公投第１２案,臺北市,萬華區,銘德里,1178,1394,432,303,735,43,778
公投第１２案,臺北市,萬華區,銘德里,1179,1427,444,312,756,25,781
公投第１２案,臺北市,萬華區,保德里,1180,1342,443,352,795,36,831
公投第１２案,臺北市,萬華區,保德里,1181,1569,527,355,882,61,943
公投第１２案,臺北市,萬華區,榮德里,1182,1514,442,286,728,40,768
公投第１２案,臺北市,萬華區,榮德里,1183,1720,462,356,818,39,857
公投第１２案,臺北市,萬華區,華中里,1184,1461,508,350,858,58,916
公投第１２案,臺北市,萬華區,華中里,1185,1264,379,304,683,29,712
公投第１２案,臺北市,萬華區,華中里,1186,1334,446,334,780,49,829
公投第１２案,臺北市,萬華區,華中里,1187,1446,462,364,826,39,865
公投第１２案,臺北市,萬華區,興德里,1188,1307,399,257,656,36,692
公投第１２案,臺北市,萬華區,興德里,1189,1420,489,306,795,41,836
公投第１２案,臺北市,萬華區,興德里,1190,1427,415,323,738,28,766
公投第１２案,臺北市,萬華區,日祥里,1191,956,323,197,520,27,547
公投第１２案,臺北市,萬華區,日祥里,1192,1352,468,275,743,51,794
公投第１２案,臺北市,萬華區,日祥里,1193,1370,486,252,738,42,780
公投第１２案,臺北市,萬華區,日祥里,1194,1222,444,248,692,44,736
公投第１２案,臺北市,萬華區,忠貞里,1195,1375,541,251,792,44,836
公投第１２案,臺北市,萬華區,忠貞里,1196,1463,499,326,825,41,866
公投第１２案,臺北市,萬華區,忠貞里,1197,1527,466,322,788,41,829
公投第１２案,臺北市,萬華區,新忠里,1198,1485,512,262,774,38,812
公投第１２案,臺北市,萬華區,新忠里,1199,1591,664,279,943,40,983
公投第１２案,臺北市,萬華區,新和里,1200,1394,561,310,871,38,909
公投第１２案,臺北市,萬華區,新和里,1201,1522,525,334,859,25,884
公投第１２案,臺北市,萬華區,新和里,1202,1661,645,328,973,29,1002
公投第１２案,臺北市,萬華區,新和里,1203,1561,575,358,933,33,966
公投第１２案,臺北市,萬華區,新和里,1204,1406,570,299,869,37,906
公投第１２案,臺北市,萬華區,新安里,1205,1498,420,267,687,35,722
公投第１２案,臺北市,萬華區,新安里,1206,1478,400,270,670,44,714
公投第１２案,臺北市,萬華區,新安里,1207,1170,378,244,622,46,668
公投第１２案,臺北市,萬華區,新安里,1208,1376,480,302,782,31,813
公投第１２案,臺北市,萬華區,凌霄里,1209,1093,290,224,514,21,535
公投第１２案,臺北市,萬華區,凌霄里,1210,1084,415,237,652,34,686
公投第１２案,臺北市,萬華區,凌霄里,1211,1119,409,248,657,33,690
公投第１２案,臺北市,萬華區,騰雲里,1212,1381,539,294,833,27,860
公投第１２案,臺北市,萬華區,騰雲里,1213,1396,503,316,819,30,849
公投第１２案,臺北市,大安區,德安里,1214,1184,380,250,630,25,655
公投第１２案,臺北市,大安區,德安里,1215,1197,385,244,629,32,661
公投第１２案,臺北市,大安區,德安里,1216,1221,386,308,694,18,712
公投第１２案,臺北市,大安區,德安里,1217,1246,467,248,715,29,744
公投第１２案,臺北市,大安區,仁慈里,1218,1478,547,330,877,25,902
公投第１２案,臺北市,大安區,仁慈里,1219,1314,403,312,715,40,755
公投第１２案,臺北市,大安區,仁慈里,1220,1594,546,379,925,41,966
公投第１２案,臺北市,大安區,和安里,1221,1429,475,345,820,37,857
公投第１２案,臺北市,大安區,和安里,1222,1452,533,331,864,28,892
公投第１２案,臺北市,大安區,和安里,1223,1551,496,389,885,23,908
公投第１２案,臺北市,大安區,和安里,1224,1335,456,311,767,43,810
公投第１２案,臺北市,大安區,民炤里,1225,1196,366,278,644,23,667
公投第１２案,臺北市,大安區,民炤里,1226,1339,410,309,719,22,741
公投第１２案,臺北市,大安區,民炤里,1227,1448,458,355,813,24,837
公投第１２案,臺北市,大安區,民炤里,1228,1373,461,299,760,38,798
公投第１２案,臺北市,大安區,民炤里,1229,1439,476,318,794,47,841
公投第１２案,臺北市,大安區,仁愛里,1230,1174,346,283,629,9,638
公投第１２案,臺北市,大安區,仁愛里,1231,1144,360,242,602,17,619
公投第１２案,臺北市,大安區,仁愛里,1232,1119,384,194,578,23,601
公投第１２案,臺北市,大安區,仁愛里,1233,1024,304,181,485,16,501
公投第１２案,臺北市,大安區,義村里,1234,1032,393,219,612,17,629
公投第１２案,臺北市,大安區,義村里,1235,1319,503,255,758,29,787
公投第１２案,臺北市,大安區,義村里,1236,1369,472,342,814,32,846
公投第１２案,臺北市,大安區,義村里,1237,1347,438,322,760,34,794
公投第１２案,臺北市,大安區,民輝里,1238,1655,502,342,844,22,866
公投第１２案,臺北市,大安區,民輝里,1239,1595,484,308,792,25,817
公投第１２案,臺北市,大安區,民輝里,1240,1429,442,316,758,30,788
公投第１２案,臺北市,大安區,民輝里,1241,1309,398,296,694,15,709
公投第１２案,臺北市,大安區,昌隆里,1242,1508,482,317,799,25,824
公投第１２案,臺北市,大安區,昌隆里,1243,1310,370,320,690,44,734
公投第１２案,臺北市,大安區,誠安里,1244,1233,392,247,639,30,669
公投第１２案,臺北市,大安區,誠安里,1245,1287,370,291,661,34,695
公投第１２案,臺北市,大安區,誠安里,1246,1147,348,240,588,26,614
公投第１２案,臺北市,大安區,光武里,1247,1260,370,277,647,30,677
公投第１２案,臺北市,大安區,光武里,1248,1377,432,301,733,31,764
公投第１２案,臺北市,大安區,光武里,1249,1284,385,287,672,48,720
公投第１２案,臺北市,大安區,光武里,1250,1314,393,279,672,18,690
公投第１２案,臺北市,大安區,光武里,1251,1273,390,264,654,29,683
公投第１２案,臺北市,大安區,龍坡里,1252,1146,358,294,652,25,677
公投第１２案,臺北市,大安區,龍坡里,1253,1285,454,287,741,25,766
公投第１２案,臺北市,大安區,龍坡里,1254,1297,459,315,774,17,791
公投第１２案,臺北市,大安區,龍坡里,1255,1101,404,253,657,30,687
公投第１２案,臺北市,大安區,龍泉里,1256,1310,398,321,719,44,763
公投第１２案,臺北市,大安區,龍泉里,1257,1365,460,340,800,44,844
公投第１２案,臺北市,大安區,龍泉里,1258,1372,467,306,773,25,798
公投第１２案,臺北市,大安區,古風里,1259,1189,429,284,713,19,732
公投第１２案,臺北市,大安區,古風里,1260,1256,430,312,742,30,772
公投第１２案,臺北市,大安區,古風里,1261,1151,402,262,664,28,692
公投第１２案,臺北市,大安區,古莊里,1262,1501,510,380,890,36,926
公投第１２案,臺北市,大安區,古莊里,1263,1520,558,347,905,22,927
公投第１２案,臺北市,大安區,古莊里,1264,1529,538,375,913,45,958
公投第１２案,臺北市,大安區,古莊里,1265,1579,545,385,930,31,961
公投第１２案,臺北市,大安區,龍安里,1266,2619,373,282,655,24,679
公投第１２案,臺北市,大安區,龍安里,1267,1290,445,290,735,23,758
公投第１２案,臺北市,大安區,龍安里,1268,1307,465,318,783,37,820
公投第１２案,臺北市,大安區,龍安里,1269,1489,491,389,880,31,911
公投第１２案,臺北市,大安區,錦安里,1270,1097,385,272,657,30,687
公投第１２案,臺北市,大安區,錦安里,1271,1328,433,320,753,28,781
公投第１２案,臺北市,大安區,錦安里,1272,1189,377,284,661,20,681
公投第１２案,臺北市,大安區,錦安里,1273,1270,445,278,723,26,749
公投第１２案,臺北市,大安區,福住里,1274,1349,417,344,761,13,774
公投第１２案,臺北市,大安區,福住里,1275,1292,409,302,711,19,730
公投第１２案,臺北市,大安區,福住里,1276,1314,480,295,775,30,805
公投第１２案,臺北市,大安區,福住里,1277,1200,411,293,704,27,731
公投第１２案,臺北市,大安區,永康里,1278,1558,505,370,875,12,887
公投第１２案,臺北市,大安區,永康里,1279,1561,525,350,875,28,903
公投第１２案,臺北市,大安區,光明里,1280,1446,494,341,835,25,860
公投第１２案,臺北市,大安區,光明里,1281,1499,502,362,864,23,887
公投第１２案,臺北市,大安區,錦泰里,1282,1467,528,329,857,19,876
公投第１２案,臺北市,大安區,錦泰里,1283,1511,501,316,817,29,846
公投第１２案,臺北市,大安區,錦華里,1284,1600,550,364,914,55,969
公投第１２案,臺北市,大安區,錦華里,1285,1573,534,366,900,38,938
公投第１２案,臺北市,大安區,錦華里,1286,1467,543,340,883,35,918
公投第１２案,臺北市,大安區,龍圖里,1287,1358,455,312,767,36,803
公投第１２案,臺北市,大安區,龍圖里,1288,1568,527,343,870,36,906
公投第１２案,臺北市,大安區,龍圖里,1289,1411,456,355,811,32,843
公投第１２案,臺北市,大安區,龍圖里,1290,1554,539,314,853,21,874
公投第１２案,臺北市,大安區,新龍里,1291,1345,484,312,796,29,825
公投第１２案,臺北市,大安區,新龍里,1292,1435,512,324,836,13,849
公投第１２案,臺北市,大安區,新龍里,1293,1481,577,334,911,20,931
公投第１２案,臺北市,大安區,新龍里,1294,1451,413,503,916,28,944
公投第１２案,臺北市,大安區,龍陣里,1295,1566,517,364,881,50,931
公投第１２案,臺北市,大安區,龍陣里,1296,1525,501,367,868,29,897
公投第１２案,臺北市,大安區,龍雲里,1297,1336,447,291,738,31,769
公投第１２案,臺北市,大安區,龍雲里,1298,1483,516,346,862,38,900
公投第１２案,臺北市,大安區,龍雲里,1299,1396,437,284,721,21,742
公投第１２案,臺北市,大安區,龍生里,1300,1406,481,348,829,40,869
公投第１２案,臺北市,大安區,龍生里,1301,1434,505,330,835,31,866
公投第１２案,臺北市,大安區,龍生里,1302,1288,432,291,723,33,756
公投第１２案,臺北市,大安區,龍生里,1303,1407,488,310,798,36,834
公投第１２案,臺北市,大安區,住安里,1304,1514,477,340,817,28,845
公投第１２案,臺北市,大安區,住安里,1305,1550,476,271,747,35,782
公投第１２案,臺北市,大安區,住安里,1306,1490,485,349,834,34,868
公投第１２案,臺北市,大安區,義安里,1307,1284,382,321,703,25,728
公投第１２案,臺北市,大安區,義安里,1308,1129,389,272,661,25,686
公投第１２案,臺北市,大安區,義安里,1309,1193,400,288,688,17,705
公投第１２案,臺北市,大安區,義安里,1310,1057,344,231,575,25,600
公投第１２案,臺北市,大安區,通化里,1311,1361,432,334,766,30,796
公投第１２案,臺北市,大安區,通化里,1312,1412,459,303,762,39,801
公投第１２案,臺北市,大安區,通化里,1313,1423,370,296,666,28,694
公投第１２案,臺北市,大安區,通化里,1314,1257,387,270,657,80,737
公投第１２案,臺北市,大安區,通安里,1315,1133,398,273,671,33,704
公投第１２案,臺北市,大安區,通安里,1316,1077,350,256,606,23,629
公投第１２案,臺北市,大安區,通安里,1317,1300,468,287,755,33,788
公投第１２案,臺北市,大安區,通安里,1318,1319,449,349,798,52,850
公投第１２案,臺北市,大安區,臨江里,1319,1265,420,284,704,52,756
公投第１２案,臺北市,大安區,臨江里,1320,1265,408,264,672,30,702
公投第１２案,臺北市,大安區,臨江里,1321,1103,385,258,643,26,669
公投第１２案,臺北市,大安區,法治里,1322,1341,581,191,772,32,804
公投第１２案,臺北市,大安區,法治里,1323,1357,480,310,790,35,825
公投第１２案,臺北市,大安區,法治里,1324,1260,432,294,726,25,751
公投第１２案,臺北市,大安區,全安里,1325,1295,421,304,725,37,762
公投第１２案,臺北市,大安區,全安里,1326,1399,437,302,739,25,764
公投第１２案,臺北市,大安區,全安里,1327,1150,375,249,624,33,657
公投第１２案,臺北市,大安區,群賢里,1328,1351,400,286,686,20,706
公投第１２案,臺北市,大安區,群賢里,1329,1341,425,329,754,39,793
公投第１２案,臺北市,大安區,群賢里,1330,1129,375,234,609,21,630
公投第１２案,臺北市,大安區,群賢里,1331,1328,457,280,737,25,762
公投第１２案,臺北市,大安區,群英里,1332,1557,644,311,955,34,989
公投第１２案,臺北市,大安區,群英里,1333,1461,555,326,881,44,925
公投第１２案,臺北市,大安區,群英里,1334,1589,493,296,789,31,820
公投第１２案,臺北市,大安區,群英里,1335,1473,530,267,797,36,833
公投第１２案,臺北市,大安區,虎嘯里,1336,1479,446,355,801,37,838
公投第１２案,臺北市,大安區,虎嘯里,1337,833,311,181,492,28,520
公投第１２案,臺北市,大安區,虎嘯里,1338,999,333,218,551,25,576
公投第１２案,臺北市,大安區,臥龍里,1339,1757,597,419,1016,33,1049
公投第１２案,臺北市,大安區,龍淵里,1340,1573,552,353,905,34,939
公投第１２案,臺北市,大安區,龍淵里,1341,1587,560,391,951,29,980
公投第１２案,臺北市,大安區,龍淵里,1342,1496,497,379,876,38,914
公投第１２案,臺北市,大安區,龍淵里,1343,1440,480,357,837,33,870
公投第１２案,臺北市,大安區,龍淵里,1344,1578,556,368,924,39,963
公投第１２案,臺北市,大安區,龍門里,1345,1223,411,307,718,18,736
公投第１２案,臺北市,大安區,龍門里,1346,1119,376,273,649,21,670
公投第１２案,臺北市,大安區,龍門里,1347,1252,437,314,751,18,769
公投第１２案,臺北市,大安區,大學里,1348,1576,543,382,925,33,958
公投第１２案,臺北市,大安區,大學里,1349,1425,484,314,798,35,833
公投第１２案,臺北市,大安區,大學里,1350,1450,478,298,776,24,800
公投第１２案,臺北市,大安區,大學里,1351,1444,591,200,791,31,822
公投第１２案,臺北市,大安區,大學里,1352,1337,492,328,820,33,853
公投第１２案,臺北市,大安區,芳和里,1353,1417,462,302,764,31,795
公投第１２案,臺北市,大安區,芳和里,1354,1250,425,278,703,31,734
公投第１２案,臺北市,大安區,芳和里,1355,1176,388,260,648,37,685
公投第１２案,臺北市,大安區,芳和里,1356,1257,455,296,751,35,786
公投第１２案,臺北市,大安區,黎元里,1357,1257,426,297,723,34,757
公投第１２案,臺北市,大安區,黎元里,1358,1148,387,281,668,26,694
公投第１２案,臺北市,大安區,黎元里,1359,1418,456,345,801,26,827
公投第１２案,臺北市,大安區,黎元里,1360,1028,325,253,578,20,598
公投第１２案,臺北市,大安區,黎孝里,1361,1445,479,367,846,25,871
公投第１２案,臺北市,大安區,黎孝里,1362,1361,497,281,778,39,817
公投第１２案,臺北市,大安區,黎孝里,1363,1343,506,282,788,38,826
公投第１２案,臺北市,大安區,黎孝里,1364,1267,424,301,725,35,760
公投第１２案,臺北市,大安區,黎孝里,1365,1380,421,312,733,25,758
公投第１２案,臺北市,大安區,黎和里,1366,1524,476,342,818,41,859
公投第１２案,臺北市,大安區,黎和里,1367,1470,521,334,855,23,878
公投第１２案,臺北市,大安區,黎和里,1368,1318,417,246,663,39,702
公投第１２案,臺北市,大安區,建安里,1369,1430,445,315,760,26,786
公投第１２案,臺北市,大安區,建安里,1370,1386,463,309,772,28,800
公投第１２案,臺北市,大安區,建安里,1371,1438,482,264,746,32,778
公投第１２案,臺北市,大安區,建倫里,1372,1270,387,262,649,18,667
公投第１２案,臺北市,大安區,建倫里,1373,1395,425,311,736,44,780
公投第１２案,臺北市,大安區,建倫里,1374,1292,452,264,716,29,745
公投第１２案,臺北市,大安區,建倫里,1375,1310,398,305,703,32,735
公投第１２案,臺北市,大安區,敦安里,1376,1319,424,302,726,32,758
公投第１２案,臺北市,大安區,敦安里,1377,1355,467,310,777,24,801
公投第１２案,臺北市,大安區,敦安里,1378,1312,381,301,682,24,706
公投第１２案,臺北市,大安區,敦安里,1379,1335,445,290,735,28,763
公投第１２案,臺北市,大安區,正聲里,1380,1489,492,309,801,21,822
公投第１２案,臺北市,大安區,正聲里,1381,1307,450,299,749,27,776
公投第１２案,臺北市,大安區,正聲里,1382,1328,388,296,684,21,705
公投第１２案,臺北市,大安區,敦煌里,1383,1277,409,286,695,10,705
公投第１２案,臺北市,大安區,敦煌里,1384,1314,424,308,732,31,763
公投第１２案,臺北市,大安區,敦煌里,1385,1270,434,308,742,31,773
公投第１２案,臺北市,大安區,敦煌里,1386,1308,406,313,719,42,761
公投第１２案,臺北市,大安區,華聲里,1387,1138,393,264,657,25,682
公投第１２案,臺北市,大安區,華聲里,1388,1333,432,289,721,23,744
公投第１２案,臺北市,大安區,華聲里,1389,1176,391,263,654,40,694
公投第１２案,臺北市,大安區,車層里,1390,1311,401,308,709,43,752
公投第１２案,臺北市,大安區,車層里,1391,1295,425,276,701,22,723
公投第１２案,臺北市,大安區,車層里,1392,1421,506,291,797,41,838
公投第１２案,臺北市,大安區,車層里,1393,1409,431,319,750,30,780
公投第１２案,臺北市,大安區,光信里,1394,1434,481,334,815,26,841
公投第１２案,臺北市,大安區,光信里,1395,1449,416,330,746,39,785
公投第１２案,臺北市,大安區,光信里,1396,1284,422,311,733,27,760
公投第１２案,臺北市,大安區,光信里,1397,1248,430,275,705,15,720
公投第１２案,臺北市,大安區,光信里,1398,1119,439,279,718,20,738
公投第１２案,臺北市,大安區,學府里,1399,883,320,193,513,25,538
公投第１２案,臺北市,大安區,學府里,1400,630,189,135,324,37,361
公投第１２案,臺北市,大安區,學府里,1401,814,274,183,457,29,486
公投第１２案,臺北市,文山區,景行里,1402,1539,500,340,840,40,880
公投第１２案,臺北市,文山區,景行里,1403,1548,503,316,819,30,849
公投第１２案,臺北市,文山區,景行里,1404,1493,509,354,863,43,906
公投第１２案,臺北市,文山區,景行里,1405,1648,577,384,961,38,999
公投第１２案,臺北市,文山區,景東里,1406,1544,524,347,871,29,900
公投第１２案,臺北市,文山區,景東里,1407,1557,562,307,869,40,909
公投第１２案,臺北市,文山區,景東里,1408,1514,490,327,817,40,857
公投第１２案,臺北市,文山區,景東里,1409,1540,573,378,951,35,986
公投第１２案,臺北市,文山區,景美里,1410,1466,517,360,877,29,906
公投第１２案,臺北市,文山區,景美里,1411,1444,546,296,842,53,895
公投第１２案,臺北市,文山區,景美里,1412,1455,520,317,837,47,884
公投第１２案,臺北市,文山區,景慶里,1413,1440,495,294,789,27,816
公投第１２案,臺北市,文山區,景慶里,1414,1398,505,343,848,35,883
公投第１２案,臺北市,文山區,景慶里,1415,1412,461,329,790,18,808
公投第１２案,臺北市,文山區,景慶里,1416,1426,487,318,805,30,835
公投第１２案,臺北市,文山區,景仁里,1417,1437,492,330,822,34,856
公投第１２案,臺北市,文山區,景仁里,1418,1340,462,309,771,39,810
公投第１２案,臺北市,文山區,景仁里,1419,1568,542,347,889,26,915
公投第１２案,臺北市,文山區,景華里,1420,1372,516,281,797,23,820
公投第１２案,臺北市,文山區,景華里,1421,1046,354,234,588,29,617
公投第１２案,臺北市,文山區,景華里,1422,1274,433,296,729,43,772
公投第１２案,臺北市,文山區,景華里,1423,1324,470,290,760,26,786
公投第１２案,臺北市,文山區,萬有里,1424,1722,574,382,956,35,991
公投第１２案,臺北市,文山區,萬有里,1425,1737,606,373,979,47,1026
公投第１２案,臺北市,文山區,萬有里,1426,1370,505,342,847,18,865
公投第１２案,臺北市,文山區,萬祥里,1427,1495,509,241,750,37,787
公投第１２案,臺北市,文山區,萬祥里,1428,1328,453,309,762,45,807
公投第１２案,臺北市,文山區,萬祥里,1429,1138,418,257,675,29,704
公投第１２案,臺北市,文山區,萬隆里,1430,1471,533,343,876,30,906
公投第１２案,臺北市,文山區,萬隆里,1431,1144,426,272,698,22,720
公投第１２案,臺北市,文山區,萬隆里,1432,1176,449,277,726,32,758
公投第１２案,臺北市,文山區,萬隆里,1433,1212,473,275,748,31,779
公投第１２案,臺北市,文山區,萬隆里,1434,1214,501,273,774,22,796
公投第１２案,臺北市,文山區,萬年里,1435,1170,372,269,641,33,674
公投第１２案,臺北市,文山區,萬年里,1436,1308,458,306,764,41,805
公投第１２案,臺北市,文山區,萬年里,1437,1190,434,274,708,34,742
公投第１２案,臺北市,文山區,萬年里,1438,1110,413,233,646,32,678
公投第１２案,臺北市,文山區,萬和里,1439,1512,508,345,853,45,898
公投第１２案,臺北市,文山區,萬和里,1440,1387,518,305,823,42,865
公投第１２案,臺北市,文山區,萬盛里,1441,1355,462,312,774,37,811
公投第１２案,臺北市,文山區,萬盛里,1442,1370,452,323,775,55,830
公投第１２案,臺北市,文山區,萬盛里,1443,1484,492,350,842,46,888
公投第１２案,臺北市,文山區,興豐里,1444,1786,584,404,988,55,1043
公投第１２案,臺北市,文山區,興豐里,1445,1260,473,259,732,38,770
公投第１２案,臺北市,文山區,興豐里,1446,1194,462,293,755,28,783
公投第１２案,臺北市,文山區,興邦里,1447,1444,543,299,842,28,870
公投第１２案,臺北市,文山區,興邦里,1448,1495,548,316,864,40,904
公投第１２案,臺北市,文山區,興邦里,1449,1446,544,320,864,29,893
公投第１２案,臺北市,文山區,興光里,1450,1450,491,314,805,52,857
公投第１２案,臺北市,文山區,興光里,1451,1486,518,359,877,39,916
公投第１２案,臺北市,文山區,興家里,1452,1259,449,298,747,26,773
公投第１２案,臺北市,文山區,興家里,1453,1317,508,291,799,18,817
公投第１２案,臺北市,文山區,興家里,1454,1321,461,340,801,27,828
公投第１２案,臺北市,文山區,興家里,1455,1475,511,318,829,37,866
公投第１２案,臺北市,文山區,興家里,1456,1271,429,279,708,28,736
公投第１２案,臺北市,文山區,興得里,1457,1609,556,381,937,35,972
公投第１２案,臺北市,文山區,興得里,1458,1501,516,304,820,27,847
公投第１２案,臺北市,文山區,興得里,1459,997,294,237,531,23,554
公投第１２案,臺北市,文山區,興得里,1460,1052,380,275,655,31,686
公投第１２案,臺北市,文山區,興業里,1461,1247,452,283,735,28,763
公投第１２案,臺北市,文山區,興業里,1462,1167,392,295,687,36,723
公投第１２案,臺北市,文山區,興業里,1463,1280,468,299,767,22,789
公投第１２案,臺北市,文山區,興業里,1464,1153,435,247,682,27,709
公投第１２案,臺北市,文山區,興安里,1465,1557,576,345,921,39,960
公投第１２案,臺北市,文山區,興安里,1466,1444,529,286,815,46,861
公投第１２案,臺北市,文山區,興安里,1467,1459,566,348,914,28,942
公投第１２案,臺北市,文山區,興安里,1468,1357,555,290,845,28,873
公投第１２案,臺北市,文山區,興福里,1469,1194,400,274,674,24,698
公投第１２案,臺北市,文山區,興福里,1470,1184,413,302,715,50,765
公投第１２案,臺北市,文山區,興福里,1471,1119,412,278,690,28,718
公投第１２案,臺北市,文山區,興福里,1472,1350,501,321,822,40,862
公投第１２案,臺北市,文山區,興旺里,1473,1502,536,285,821,27,848
公投第１２案,臺北市,文山區,興旺里,1474,1511,569,319,888,34,922
公投第１２案,臺北市,文山區,興旺里,1475,1481,541,371,912,20,932
公投第１２案,臺北市,文山區,興旺里,1476,1477,580,324,904,26,930
公投第１２案,臺北市,文山區,興旺里,1477,1294,494,282,776,29,805
公投第１２案,臺北市,文山區,興泰里,1478,1040,422,262,684,27,711
公投第１２案,臺北市,文山區,興泰里,1479,1323,515,292,807,28,835
公投第１２案,臺北市,文山區,興泰里,1480,1153,404,275,679,35,714
公投第１２案,臺北市,文山區,興昌里,1481,1525,516,342,858,30,888
公投第１２案,臺北市,文山區,興昌里,1482,1412,493,265,758,31,789
公投第１２案,臺北市,文山區,興昌里,1483,1473,487,388,875,39,914
公投第１２案,臺北市,文山區,興昌里,1484,1486,492,379,871,35,906
公投第１２案,臺北市,文山區,試院里,1485,1616,624,354,978,40,1018
公投第１２案,臺北市,文山區,試院里,1486,1489,562,332,894,50,944
公投第１２案,臺北市,文山區,試院里,1487,1414,489,314,803,40,843
公投第１２案,臺北市,文山區,試院里,1488,1494,557,376,933,33,966
公投第１２案,臺北市,文山區,華興里,1489,1547,557,369,926,36,962
公投第１２案,臺北市,文山區,華興里,1490,1587,549,380,929,39,968
公投第１２案,臺北市,文山區,華興里,1491,1515,566,364,930,27,957
公投第１２案,臺北市,文山區,華興里,1492,1573,578,378,956,36,992
公投第１２案,臺北市,文山區,華興里,1493,1542,562,370,932,37,969
公投第１２案,臺北市,文山區,明義里,1494,1465,455,304,759,49,808
公投第１２案,臺北市,文山區,明義里,1495,699,186,134,320,26,346
公投第１２案,臺北市,文山區,明義里,1496,1372,398,279,677,37,714
公投第１２案,臺北市,文山區,明興里,1497,1448,457,279,736,39,775
公投第１２案,臺北市,文山區,明興里,1498,1548,525,336,861,47,908
公投第１２案,臺北市,文山區,明興里,1499,1501,498,370,868,34,902
公投第１２案,臺北市,文山區,明興里,1500,1560,549,373,922,42,964
公投第１２案,臺北市,文山區,木柵里,1501,1567,540,339,879,33,912
公投第１２案,臺北市,文山區,木柵里,1502,1554,532,364,896,27,923
公投第１２案,臺北市,文山區,木柵里,1503,1544,549,332,881,37,918
公投第１２案,臺北市,文山區,木柵里,1504,1528,540,370,910,40,950
公投第１２案,臺北市,文山區,木柵里,1505,1543,593,345,938,28,966
公投第１２案,臺北市,文山區,木新里,1506,2754,501,411,912,51,963
公投第１２案,臺北市,文山區,木新里,1507,1709,488,361,849,42,891
公投第１２案,臺北市,文山區,木新里,1508,1515,489,326,815,56,871
公投第１２案,臺北市,文山區,木新里,1509,1571,500,326,826,37,863
公投第１２案,臺北市,文山區,木新里,1510,1578,483,387,870,42,912
公投第１２案,臺北市,文山區,順興里,1511,1454,478,314,792,32,824
公投第１２案,臺北市,文山區,順興里,1512,1436,505,317,822,42,864
公投第１２案,臺北市,文山區,順興里,1513,1402,632,211,843,40,883
公投第１２案,臺北市,文山區,順興里,1514,1117,405,267,672,0,672
公投第１２案,臺北市,文山區,順興里,1515,1094,356,258,614,43,657
公投第１２案,臺北市,文山區,忠順里,1516,1070,405,245,650,38,688
公投第１２案,臺北市,文山區,忠順里,1517,1319,540,279,819,31,850
公投第１２案,臺北市,文山區,忠順里,1518,1226,458,298,756,31,787
公投第１２案,臺北市,文山區,樟林里,1519,1385,473,279,752,37,789
公投第１２案,臺北市,文山區,樟林里,1520,1416,464,356,820,37,857
公投第１２案,臺北市,文山區,樟林里,1521,1412,534,346,880,27,907
公投第１２案,臺北市,文山區,樟林里,1522,1535,506,332,838,47,885
公投第１２案,臺北市,文山區,樟林里,1523,1654,615,373,988,56,1044
公投第１２案,臺北市,文山區,樟新里,1524,1156,434,267,701,29,730
公投第１２案,臺北市,文山區,樟新里,1525,1231,449,306,755,28,783
公投第１２案,臺北市,文山區,樟新里,1526,1218,444,253,697,35,732
公投第１２案,臺北市,文山區,樟新里,1527,1176,435,298,733,28,761
公投第１２案,臺北市,文山區,樟文里,1528,1392,518,326,844,8,852
公投第１２案,臺北市,文山區,樟文里,1529,1323,443,292,735,59,794
公投第１２案,臺北市,文山區,樟文里,1530,1297,422,312,734,35,769
公投第１２案,臺北市,文山區,樟文里,1531,1296,462,321,783,34,817
公投第１２案,臺北市,文山區,樟腳里,1532,1613,516,379,895,47,942
公投第１２案,臺北市,文山區,樟腳里,1533,1697,567,419,986,47,1033
公投第１２案,臺北市,文山區,樟腳里,1534,1579,539,361,900,46,946
公投第１２案,臺北市,文山區,樟樹里,1535,1320,481,321,802,45,847
公投第１２案,臺北市,文山區,樟樹里,1536,1438,523,329,852,25,877
公投第１２案,臺北市,文山區,樟樹里,1537,1465,458,338,796,14,810
公投第１２案,臺北市,文山區,萬芳里,1538,1646,524,408,932,55,987
公投第１２案,臺北市,文山區,萬芳里,1539,1286,452,303,755,39,794
公投第１２案,臺北市,文山區,萬芳里,1540,1219,428,292,720,26,746
公投第１２案,臺北市,文山區,萬芳里,1541,1292,354,317,671,30,701
公投第１２案,臺北市,文山區,萬芳里,1542,1489,484,333,817,40,857
公投第１２案,臺北市,文山區,萬美里,1543,1611,537,409,946,40,986
公投第１２案,臺北市,文山區,萬美里,1544,1549,477,294,771,43,814
公投第１２案,臺北市,文山區,萬美里,1545,1678,555,359,914,52,966
公投第１２案,臺北市,文山區,萬美里,1546,1660,545,358,903,44,947
公投第１２案,臺北市,文山區,博嘉里,1547,1816,543,355,898,22,920
公投第１２案,臺北市,文山區,博嘉里,1548,985,315,227,542,24,566
公投第１２案,臺北市,文山區,博嘉里,1549,1314,484,306,790,23,813
公投第１２案,臺北市,文山區,博嘉里,1550,1018,397,241,638,30,668
公投第１２案,臺北市,文山區,萬興里,1551,1578,546,368,914,29,943
公投第１２案,臺北市,文山區,萬興里,1552,1457,483,336,819,27,846
公投第１２案,臺北市,文山區,萬興里,1553,1326,453,341,794,29,823
公投第１２案,臺北市,文山區,萬興里,1554,1393,501,329,830,29,859
公投第１２案,臺北市,文山區,萬興里,1555,1377,430,325,755,39,794
公投第１２案,臺北市,文山區,政大里,1556,1448,470,372,842,31,873
公投第１２案,臺北市,文山區,政大里,1557,1447,532,351,883,46,929
公投第１２案,臺北市,文山區,政大里,1558,1739,626,461,1087,48,1135
公投第１２案,臺北市,文山區,政大里,1559,1457,463,388,851,28,879
公投第１２案,臺北市,文山區,指南里,1560,1288,427,329,756,41,797
公投第１２案,臺北市,文山區,指南里,1561,1301,390,288,678,38,716
公投第１２案,臺北市,文山區,指南里,1562,865,230,208,438,41,479
公投第１２案,臺北市,文山區,老泉里,1563,789,221,189,410,32,442
公投第１２案,高雄市,桃源區,梅山里,1,264,67,54,121,1,122
公投第１２案,高雄市,桃源區,拉芙蘭里,2,233,110,59,169,3,172
公投第１２案,高雄市,桃源區,復興里,3,279,114,67,181,5,186
公投第１２案,高雄市,桃源區,勤和里,4,223,118,45,163,2,165
公投第１２案,高雄市,桃源區,桃源里,5,783,330,150,480,10,490
公投第１２案,高雄市,桃源區,高中里,6,632,284,111,395,7,402
公投第１２案,高雄市,桃源區,建山里,7,612,254,149,403,17,420
公投第１２案,高雄市,桃源區,寶山里,8,472,171,80,251,17,268
公投第１２案,高雄市,那瑪夏區,達卡努瓦里,9,741,319,153,472,21,493
公投第１２案,高雄市,那瑪夏區,達卡努瓦里,10,585,238,159,397,31,428
公投第１２案,高雄市,那瑪夏區,瑪雅里,11,609,327,129,456,18,474
公投第１２案,高雄市,那瑪夏區,南沙魯里,12,489,207,65,272,12,284
公投第１２案,高雄市,甲仙區,東安里,13,472,121,57,178,9,187
公投第１２案,高雄市,甲仙區,西安里,14,882,348,174,522,40,562
公投第１２案,高雄市,甲仙區,和安里,15,668,204,133,337,19,356
公投第１２案,高雄市,甲仙區,大田里,16,1581,438,275,713,81,794
公投第１２案,高雄市,甲仙區,寶隆里,17,673,144,103,247,11,258
公投第１２案,高雄市,甲仙區,關山里,18,607,164,104,268,28,296
公投第１２案,高雄市,甲仙區,小林里,19,534,144,111,255,19,274
公投第１２案,高雄市,六龜區,新威里,20,760,222,136,358,28,386
公投第１２案,高雄市,六龜區,新興里,21,666,169,111,280,27,307
公投第１２案,高雄市,六龜區,新寮里,22,704,230,142,372,40,412
公投第１２案,高雄市,六龜區,新發里,23,1003,302,172,474,40,514
公投第１２案,高雄市,六龜區,荖濃里,24,1382,326,246,572,94,666
公投第１２案,高雄市,六龜區,六龜里,25,986,218,153,371,45,416
公投第１２案,高雄市,六龜區,義寶里,26,1046,293,208,501,37,538
公投第１２案,高雄市,六龜區,興龍里,27,812,211,142,353,29,382
公投第１２案,高雄市,六龜區,中興里,28,1431,371,208,579,65,644
公投第１２案,高雄市,六龜區,寶來里,29,912,289,142,431,51,482
公投第１２案,高雄市,六龜區,文武里,30,1472,328,238,566,43,609
公投第１２案,高雄市,六龜區,大津里,31,327,78,55,133,12,145
公投第１２案,高雄市,杉林區,杉林里,32,640,174,113,287,32,319
公投第１２案,高雄市,杉林區,木梓里,33,696,184,127,311,26,337
公投第１２案,高雄市,杉林區,集來里,34,1284,275,182,457,35,492
公投第１２案,高雄市,杉林區,新庄里,35,1027,246,172,418,41,459
公投第１２案,高雄市,杉林區,新庄里,36,482,148,83,231,16,247
公投第１２案,高雄市,杉林區,上平里,37,1627,514,320,834,80,914
公投第１２案,高雄市,杉林區,月眉里,38,1630,484,261,745,27,772
公投第１２案,高雄市,杉林區,大愛里,39,973,227,155,382,22,404
公投第１２案,高雄市,杉林區,大愛里,40,987,266,156,422,18,440
公投第１２案,高雄市,杉林區,月美里,41,1261,381,220,601,67,668
公投第１２案,高雄市,內門區,溝坪里,42,969,286,162,448,36,484
公投第１２案,高雄市,內門區,金竹里,43,652,190,101,291,15,306
公投第１２案,高雄市,內門區,永富里,44,961,318,148,466,48,514
公投第１２案,高雄市,內門區,永吉里,45,426,145,60,205,10,215
公投第１２案,高雄市,內門區,永興里,46,398,120,58,178,9,187
公投第１２案,高雄市,內門區,石坑里,47,508,133,96,229,12,241
公投第１２案,高雄市,內門區,內門里,48,980,354,185,539,42,581
公投第１２案,高雄市,內門區,內豊里,49,1225,315,192,507,32,539
公投第１２案,高雄市,內門區,觀亭里,50,1722,518,354,872,100,972
公投第１２案,高雄市,內門區,中埔里,51,560,156,93,249,26,275
公投第１２案,高雄市,內門區,內東里,52,801,203,145,348,14,362
公投第１２案,高雄市,內門區,內南里,53,423,117,92,209,11,220
公投第１２案,高雄市,內門區,東埔里,54,497,140,78,218,19,237
公投第１２案,高雄市,內門區,三平里,55,677,215,112,327,18,345
公投第１２案,高雄市,內門區,木柵里,56,593,178,68,246,7,253
公投第１２案,高雄市,內門區,內興里,57,597,184,85,269,22,291
公投第１２案,高雄市,內門區,瑞山里,58,343,101,51,152,0,152
公投第１２案,高雄市,內門區,光興里,59,670,211,129,340,31,371
公投第１２案,高雄市,旗山區,太平里,60,1060,368,246,614,25,639
公投第１２案,高雄市,旗山區,太平里,61,1125,374,187,561,34,595
公投第１２案,高雄市,旗山區,大德里,62,1100,391,258,649,32,681
公投第１２案,高雄市,旗山區,大德里,63,1238,459,289,748,21,769
公投第１２案,高雄市,旗山區,湄洲里,64,933,309,216,525,18,543
公投第１２案,高雄市,旗山區,湄洲里,65,727,222,200,422,17,439
公投第１２案,高雄市,旗山區,圓富里,66,1071,367,209,576,34,610
公投第１２案,高雄市,旗山區,圓富里,67,744,222,158,380,22,402
公投第１２案,高雄市,旗山區,中正里,68,1100,322,220,542,38,580
公投第１２案,高雄市,旗山區,中正里,69,369,124,61,185,12,197
公投第１２案,高雄市,旗山區,大林里,70,888,273,141,414,13,427
公投第１２案,高雄市,旗山區,大林里,71,510,163,75,238,9,247
公投第１２案,高雄市,旗山區,上洲里,72,1042,353,231,584,66,650
公投第１２案,高雄市,旗山區,新光里,73,791,245,157,402,36,438
公投第１２案,高雄市,旗山區,南勝里,74,939,321,191,512,56,568
公投第１２案,高雄市,旗山區,南勝里,75,1218,302,232,534,31,565
公投第１２案,高雄市,旗山區,中寮里,76,178,49,34,83,16,99
公投第１２案,高雄市,旗山區,東平里,77,946,350,204,554,36,590
公投第１２案,高雄市,旗山區,東平里,78,1025,333,226,559,27,586
公投第１２案,高雄市,旗山區,東昌里,79,1040,381,205,586,114,700
公投第１２案,高雄市,旗山區,竹峰里,80,900,339,199,538,49,587
公投第１２案,高雄市,旗山區,竹峰里,81,663,226,113,339,20,359
公投第１２案,高雄市,旗山區,瑞吉里,82,954,303,209,512,34,546
公投第１２案,高雄市,旗山區,瑞吉里,83,1060,370,199,569,27,596
公投第１２案,高雄市,旗山區,永和里,84,1110,387,242,629,48,677
公投第１２案,高雄市,旗山區,永和里,85,1062,337,253,590,41,631
公投第１２案,高雄市,旗山區,永和里,86,1151,412,228,640,28,668
公投第１２案,高雄市,旗山區,三協里,87,266,80,71,151,16,167
公投第１２案,高雄市,旗山區,三協里,88,633,252,122,374,19,393
公投第１２案,高雄市,旗山區,三協里,89,1307,398,237,635,36,671
公投第１２案,高雄市,旗山區,鯤洲里,90,754,227,160,387,46,433
公投第１２案,高雄市,旗山區,大山里,91,1296,390,259,649,98,747
公投第１２案,高雄市,旗山區,中洲里,92,839,211,159,370,21,391
公投第１２案,高雄市,旗山區,南洲里,93,1329,424,294,718,50,768
公投第１２案,高雄市,旗山區,廣福里,94,628,229,125,354,19,373
公投第１２案,高雄市,美濃區,福安里,95,1175,434,195,629,60,689
公投第１２案,高雄市,美濃區,福安里,96,1438,433,282,715,20,735
公投第１２案,高雄市,美濃區,合和里,97,989,330,146,476,31,507
公投第１２案,高雄市,美濃區,合和里,98,1427,527,221,748,53,801
公投第１２案,高雄市,美濃區,祿興里,99,1309,414,271,685,58,743
公投第１２案,高雄市,美濃區,祿興里,100,1263,448,262,710,64,774
公投第１２案,高雄市,美濃區,中壇里,101,997,369,193,562,48,610
公投第１２案,高雄市,美濃區,中壇里,102,1064,341,220,561,54,615
公投第１２案,高雄市,美濃區,德興里,103,1498,502,279,781,55,836
公投第１２案,高雄市,美濃區,龍山里,104,1119,381,214,595,63,658
公投第１２案,高雄市,美濃區,龍山里,105,1031,358,196,554,52,606
公投第１２案,高雄市,美濃區,獅山里,106,1437,412,291,703,64,767
公投第１２案,高雄市,美濃區,獅山里,107,1071,354,212,566,42,608
公投第１２案,高雄市,美濃區,龍肚里,108,687,254,113,367,25,392
公投第１２案,高雄市,美濃區,龍肚里,109,775,220,121,341,25,366
公投第１２案,高雄市,美濃區,廣德里,110,1353,427,224,651,48,699
公投第１２案,高雄市,美濃區,興隆里,111,1191,368,209,577,36,613
公投第１２案,高雄市,美濃區,中圳里,112,906,288,140,428,33,461
公投第１２案,高雄市,美濃區,中圳里,113,1178,421,245,666,28,694
公投第１２案,高雄市,美濃區,東門里,114,1252,369,228,597,42,639
公投第１２案,高雄市,美濃區,泰安里,115,1549,547,312,859,36,895
公投第１２案,高雄市,美濃區,瀰濃里,116,1088,375,174,549,26,575
公投第１２案,高雄市,美濃區,瀰濃里,117,1116,371,228,599,38,637
公投第１２案,高雄市,美濃區,清水里,118,977,317,192,509,18,527
公投第１２案,高雄市,美濃區,清水里,119,816,280,191,471,41,512
公投第１２案,高雄市,美濃區,吉洋里,120,955,275,148,423,26,449
公投第１２案,高雄市,美濃區,吉洋里,121,943,322,170,492,54,546
公投第１２案,高雄市,美濃區,吉和里,122,1371,440,259,699,40,739
公投第１２案,高雄市,美濃區,吉東里,123,919,272,189,461,53,514
公投第１２案,高雄市,美濃區,吉東里,124,915,326,193,519,48,567
公投第１２案,高雄市,美濃區,廣林里,125,828,236,156,392,63,455
公投第１２案,高雄市,美濃區,廣林里,126,674,168,109,277,44,321
公投第１２案,高雄市,茂林區,多納里,127,507,194,142,336,20,356
公投第１２案,高雄市,茂林區,萬山里,128,382,192,81,273,9,282
公投第１２案,高雄市,茂林區,茂林里,129,726,315,153,468,17,485
公投第１２案,高雄市,茄萣區,福德里,130,976,302,187,489,14,503
公投第１２案,高雄市,茄萣區,萬福里,131,887,283,166,449,38,487
公投第１２案,高雄市,茄萣區,白雲里,132,1710,533,351,884,35,919
公投第１２案,高雄市,茄萣區,嘉賜里,133,1280,382,203,585,29,614
公投第１２案,高雄市,茄萣區,嘉賜里,134,1314,489,282,771,24,795
公投第１２案,高雄市,茄萣區,嘉賜里,135,1157,453,254,707,30,737
公投第１２案,高雄市,茄萣區,嘉安里,136,1785,600,326,926,65,991
公投第１２案,高雄市,茄萣區,嘉樂里,137,838,295,158,453,37,490
公投第１２案,高雄市,茄萣區,嘉樂里,138,1249,530,245,775,50,825
公投第１２案,高雄市,茄萣區,嘉泰里,139,1116,366,201,567,47,614
公投第１２案,高雄市,茄萣區,嘉福里,140,978,303,190,493,34,527
公投第１２案,高雄市,茄萣區,和協里,141,1125,342,179,521,26,547
公投第１２案,高雄市,茄萣區,嘉定里,142,1139,330,242,572,53,625
公投第１２案,高雄市,茄萣區,保定里,143,1363,457,241,698,75,773
公投第１２案,高雄市,茄萣區,保定里,144,1598,562,334,896,68,964
公投第１２案,高雄市,茄萣區,大定里,145,1111,341,212,553,44,597
公投第１２案,高雄市,茄萣區,光定里,146,925,282,145,427,19,446
公投第１２案,高雄市,茄萣區,吉定里,147,1148,368,224,592,37,629
公投第１２案,高雄市,茄萣區,崎漏里,148,1353,403,280,683,21,704
公投第１２案,高雄市,茄萣區,崎漏里,149,1331,440,257,697,43,740
公投第１２案,高雄市,茄萣區,崎漏里,150,1829,535,322,857,43,900
公投第１２案,高雄市,湖內區,海山里,151,1112,377,200,577,39,616
公投第１２案,高雄市,湖內區,劉家里,152,1017,344,194,538,55,593
公投第１２案,高雄市,湖內區,太爺里,153,796,265,157,422,12,434
公投第１２案,高雄市,湖內區,公舘里,154,1079,396,250,646,29,675
公投第１２案,高雄市,湖內區,公舘里,155,1115,405,241,646,18,664
公投第１２案,高雄市,湖內區,葉厝里,156,1311,409,281,690,35,725
公投第１２案,高雄市,湖內區,葉厝里,157,1319,456,228,684,22,706
公投第１２案,高雄市,湖內區,大湖里,158,1244,452,297,749,41,790
公投第１２案,高雄市,湖內區,大湖里,159,1227,486,257,743,37,780
公投第１２案,高雄市,湖內區,大湖里,160,1163,423,240,663,51,714
公投第１２案,高雄市,湖內區,田尾里,161,981,346,221,567,29,596
公投第１２案,高雄市,湖內區,湖內里,162,780,240,185,425,17,442
公投第１２案,高雄市,湖內區,湖內里,163,832,300,149,449,39,488
公投第１２案,高雄市,湖內區,湖內里,164,1017,374,237,611,31,642
公投第１２案,高雄市,湖內區,湖內里,165,1051,346,252,598,27,625
公投第１２案,高雄市,湖內區,海埔里,166,941,332,187,519,22,541
公投第１２案,高雄市,湖內區,海埔里,167,863,312,144,456,33,489
公投第１２案,高雄市,湖內區,文賢里,168,1160,349,251,600,32,632
公投第１２案,高雄市,湖內區,中賢里,169,1090,290,182,472,22,494
公投第１２案,高雄市,湖內區,中賢里,170,1122,376,241,617,38,655
公投第１２案,高雄市,湖內區,逸賢里,171,1123,328,212,540,25,565
公投第１２案,高雄市,湖內區,忠興里,172,684,238,129,367,24,391
公投第１２案,高雄市,湖內區,湖東里,173,1249,379,236,615,22,637
公投第１２案,高雄市,湖內區,湖東里,174,1453,455,236,691,32,723
公投第１２案,高雄市,路竹區,竹滬里,175,1026,343,201,544,17,561
公投第１２案,高雄市,路竹區,竹滬里,176,1069,364,215,579,54,633
公投第１２案,高雄市,路竹區,竹滬里,177,1127,389,251,640,51,691
公投第１２案,高雄市,路竹區,頂寮里,178,1179,438,214,652,30,682
公投第１２案,高雄市,路竹區,新達里,179,1237,410,220,630,72,702
公投第１２案,高雄市,路竹區,後鄉里,180,1096,356,264,620,38,658
公投第１２案,高雄市,路竹區,北嶺里,181,1272,522,244,766,43,809
公投第１２案,高雄市,路竹區,社西里,182,1182,410,258,668,38,706
公投第１２案,高雄市,路竹區,社西里,183,1127,397,220,617,39,656
公投第１２案,高雄市,路竹區,甲北里,184,956,343,198,541,36,577
公投第１２案,高雄市,路竹區,甲北里,185,1132,361,254,615,53,668
公投第１２案,高雄市,路竹區,甲南里,186,1025,360,237,597,61,658
公投第１２案,高雄市,路竹區,甲南里,187,1007,318,229,547,25,572
公投第１２案,高雄市,路竹區,甲南里,188,1301,411,249,660,42,702
公投第１２案,高雄市,路竹區,下坑里,189,885,303,196,499,31,530
公投第１２案,高雄市,路竹區,下坑里,190,837,237,177,414,15,429
公投第１２案,高雄市,路竹區,下坑里,191,930,310,222,532,35,567
公投第１２案,高雄市,路竹區,竹園里,192,781,259,131,390,32,422
公投第１２案,高雄市,路竹區,竹園里,193,1023,342,231,573,40,613
公投第１２案,高雄市,路竹區,竹東里,194,1763,615,398,1013,53,1066
公投第１２案,高雄市,路竹區,竹東里,195,1637,547,352,899,47,946
公投第１２案,高雄市,路竹區,竹西里,196,1070,378,214,592,42,634
公投第１２案,高雄市,路竹區,竹西里,197,1177,424,268,692,37,729
公投第１２案,高雄市,路竹區,文北里,198,1007,341,229,570,30,600
公投第１２案,高雄市,路竹區,文北里,199,1026,340,224,564,38,602
公投第１２案,高雄市,路竹區,文北里,200,1017,349,224,573,31,604
公投第１２案,高雄市,路竹區,文南里,201,1264,414,298,712,30,742
公投第１２案,高雄市,路竹區,文南里,202,1089,400,233,633,40,673
公投第１２案,高雄市,路竹區,三爺里,203,851,283,186,469,32,501
公投第１２案,高雄市,路竹區,鴨寮里,204,1011,362,211,573,65,638
公投第１２案,高雄市,路竹區,鴨寮里,205,937,358,240,598,18,616
公投第１２案,高雄市,路竹區,社東里,206,820,249,171,420,12,432
公投第１２案,高雄市,路竹區,社東里,207,910,354,214,568,23,591
公投第１２案,高雄市,路竹區,社中里,208,867,255,200,455,39,494
公投第１２案,高雄市,路竹區,竹南里,209,937,359,183,542,25,567
公投第１２案,高雄市,路竹區,竹南里,210,900,314,200,514,20,534
公投第１２案,高雄市,路竹區,竹南里,211,900,328,193,521,39,560
公投第１２案,高雄市,路竹區,社南里,212,918,328,215,543,25,568
公投第１２案,高雄市,路竹區,社南里,213,870,316,219,535,33,568
公投第１２案,高雄市,路竹區,社南里,214,1150,438,264,702,24,726
公投第１２案,高雄市,路竹區,社南里,215,1537,616,321,937,48,985
公投第１２案,高雄市,阿蓮區,石安里,216,1299,360,253,613,30,643
公投第１２案,高雄市,阿蓮區,中路里,217,1107,395,216,611,26,637
公投第１２案,高雄市,阿蓮區,中路里,218,898,326,142,468,17,485
公投第１２案,高雄市,阿蓮區,峯山里,219,1259,407,231,638,57,695
公投第１２案,高雄市,阿蓮區,港後里,220,1579,469,331,800,42,842
公投第１２案,高雄市,阿蓮區,港後里,221,564,199,121,320,8,328
公投第１２案,高雄市,阿蓮區,崗山里,222,768,257,203,460,38,498
公投第１２案,高雄市,阿蓮區,阿蓮里,223,1092,348,261,609,34,643
公投第１２案,高雄市,阿蓮區,阿蓮里,224,1099,354,239,593,36,629
公投第１２案,高雄市,阿蓮區,阿蓮里,225,1134,375,249,624,16,640
公投第１２案,高雄市,阿蓮區,阿蓮里,226,1561,470,323,793,26,819
公投第１２案,高雄市,阿蓮區,清蓮里,227,1533,481,369,850,53,903
公投第１２案,高雄市,阿蓮區,清蓮里,228,1116,339,216,555,23,578
公投第１２案,高雄市,阿蓮區,和蓮里,229,1054,357,208,565,34,599
公投第１２案,高雄市,阿蓮區,和蓮里,230,1260,422,245,667,26,693
公投第１２案,高雄市,阿蓮區,青旗里,231,1504,432,306,738,59,797
公投第１２案,高雄市,阿蓮區,復安里,232,848,256,155,411,17,428
公投第１２案,高雄市,阿蓮區,復安里,233,823,278,160,438,19,457
公投第１２案,高雄市,阿蓮區,玉庫里,234,1021,371,205,576,28,604
公投第１２案,高雄市,阿蓮區,南蓮里,235,1715,492,358,850,28,878
公投第１２案,高雄市,阿蓮區,南蓮里,236,1300,435,227,662,39,701
公投第１２案,高雄市,田寮區,鹿埔里,237,369,99,67,166,6,172
公投第１２案,高雄市,田寮區,南安里,238,656,152,113,265,19,284
公投第１２案,高雄市,田寮區,南安里,239,406,67,55,122,8,130
公投第１２案,高雄市,田寮區,大同里,240,380,114,70,184,14,198
公投第１２案,高雄市,田寮區,田寮里,241,379,116,85,201,18,219
公投第１２案,高雄市,田寮區,七星里,242,625,208,111,319,41,360
公投第１２案,高雄市,田寮區,崇德里,243,946,279,180,459,25,484
公投第１２案,高雄市,田寮區,西德里,244,794,228,119,347,38,385
公投第１２案,高雄市,田寮區,三和里,245,382,103,47,150,19,169
公投第１２案,高雄市,田寮區,古亭里,246,513,107,71,178,27,205
公投第１２案,高雄市,田寮區,新興里,247,601,195,114,309,17,326
公投第１２案,高雄市,田寮區,新興里,248,620,213,131,344,33,377
公投第１２案,高雄市,永安區,永安里,249,756,331,150,481,23,504
公投第１２案,高雄市,永安區,永安里,250,818,303,187,490,35,525
公投第１２案,高雄市,永安區,永華里,251,866,363,214,577,24,601
公投第１２案,高雄市,永安區,永華里,252,951,364,204,568,48,616
公投第１２案,高雄市,永安區,新港里,253,992,165,425,590,48,638
公投第１２案,高雄市,永安區,新港里,254,682,184,140,324,15,339
公投第１２案,高雄市,永安區,新港里,255,665,247,139,386,21,407
公投第１２案,高雄市,永安區,鹽田里,256,371,122,82,204,8,212
公投第１２案,高雄市,永安區,保寧里,257,1114,414,277,691,47,738
公投第１２案,高雄市,永安區,保寧里,258,1418,577,286,863,25,888
公投第１２案,高雄市,永安區,維新里,259,1477,598,323,921,58,979
公投第１２案,高雄市,永安區,維新里,260,1891,716,421,1137,56,1193
公投第１２案,高雄市,岡山區,岡山里,261,1345,569,300,869,23,892
公投第１２案,高雄市,岡山區,岡山里,262,1045,315,184,499,17,516
公投第１２案,高雄市,岡山區,岡山里,263,1051,388,233,621,24,645
公投第１２案,高雄市,岡山區,岡山里,264,917,322,237,559,19,578
公投第１２案,高雄市,岡山區,壽天里,265,934,375,211,586,25,611
公投第１２案,高雄市,岡山區,壽天里,266,1097,467,194,661,32,693
公投第１２案,高雄市,岡山區,壽天里,267,1208,534,249,783,25,808
公投第１２案,高雄市,岡山區,平安里,268,1159,474,264,738,42,780
公投第１２案,高雄市,岡山區,維仁里,269,1018,375,224,599,29,628
公投第１２案,高雄市,岡山區,大遼里,270,1316,455,253,708,22,730
公投第１２案,高雄市,岡山區,程香里,271,1345,497,279,776,34,810
公投第１２案,高雄市,岡山區,程香里,272,1295,523,250,773,36,809
公投第１２案,高雄市,岡山區,程香里,273,1425,509,303,812,36,848
公投第１２案,高雄市,岡山區,後紅里,274,1328,497,269,766,28,794
公投第１２案,高雄市,岡山區,後紅里,275,1382,581,257,838,16,854
公投第１２案,高雄市,岡山區,後紅里,276,1381,543,295,838,13,851
公投第１２案,高雄市,岡山區,碧紅里,277,1282,465,267,732,45,777
公投第１２案,高雄市,岡山區,碧紅里,278,1240,479,233,712,17,729
公投第１２案,高雄市,岡山區,碧紅里,279,1327,504,273,777,30,807
公投第１２案,高雄市,岡山區,竹圍里,280,1736,561,372,933,37,970
公投第１２案,高雄市,岡山區,竹圍里,281,1566,585,325,910,31,941
公投第１２案,高雄市,岡山區,竹圍里,282,1779,600,342,942,30,972
公投第１２案,高雄市,岡山區,竹圍里,283,1593,573,317,890,55,945
公投第１２案,高雄市,岡山區,台上里,284,1480,577,302,879,50,929
公投第１２案,高雄市,岡山區,台上里,285,1364,548,252,800,35,835
公投第１２案,高雄市,岡山區,台上里,286,1410,537,293,830,40,870
公投第１２案,高雄市,岡山區,台上里,287,1148,499,267,766,25,791
公投第１２案,高雄市,岡山區,為隨里,288,625,232,157,389,29,418
公投第１２案,高雄市,岡山區,灣裡里,289,969,323,256,579,24,603
公投第１２案,高雄市,岡山區,灣裡里,290,861,356,185,541,16,557
公投第１２案,高雄市,岡山區,本洲里,291,823,273,178,451,16,467
公投第１２案,高雄市,岡山區,本洲里,292,889,353,211,564,38,602
公投第１２案,高雄市,岡山區,前峰里,293,1283,469,277,746,33,779
公投第１２案,高雄市,岡山區,前峰里,294,1512,565,284,849,23,872
公投第１２案,高雄市,岡山區,壽峰里,295,983,389,249,638,34,672
公投第１２案,高雄市,岡山區,壽峰里,296,1262,460,279,739,22,761
公投第１２案,高雄市,岡山區,仁壽里,297,1096,432,224,656,33,689
公投第１２案,高雄市,岡山區,仁壽里,298,1066,391,230,621,28,649
公投第１２案,高雄市,岡山區,仁壽里,299,1188,409,236,645,22,667
公投第１２案,高雄市,岡山區,後協里,300,1360,551,280,831,30,861
公投第１２案,高雄市,岡山區,後協里,301,1363,567,287,854,29,883
公投第１２案,高雄市,岡山區,後協里,302,1352,541,292,833,41,874
公投第１２案,高雄市,岡山區,後協里,303,1460,571,270,841,28,869
公投第１２案,高雄市,岡山區,協和里,304,1272,451,304,755,32,787
公投第１２案,高雄市,岡山區,協和里,305,1080,425,239,664,34,698
公投第１２案,高雄市,岡山區,協和里,306,1255,445,285,730,52,782
公投第１２案,高雄市,岡山區,協榮里,307,938,407,197,604,25,629
公投第１２案,高雄市,岡山區,協榮里,308,1237,534,239,773,25,798
公投第１２案,高雄市,岡山區,劉厝里,309,1413,536,258,794,19,813
公投第１２案,高雄市,岡山區,白米里,310,765,295,171,466,12,478
公投第１２案,高雄市,岡山區,白米里,311,1043,417,254,671,24,695
公投第１２案,高雄市,岡山區,石潭里,312,844,326,157,483,25,508
公投第１２案,高雄市,岡山區,石潭里,313,993,427,272,699,32,731
公投第１２案,高雄市,岡山區,福興里,314,1038,387,234,621,52,673
公投第１２案,高雄市,岡山區,嘉興里,315,1070,381,246,627,44,671
公投第１２案,高雄市,岡山區,嘉興里,316,1023,393,254,647,50,697
公投第１２案,高雄市,岡山區,嘉興里,317,1349,497,298,795,25,820
公投第１２案,高雄市,岡山區,嘉峰里,318,1452,488,287,775,35,810
公投第１２案,高雄市,岡山區,嘉峰里,319,301,107,84,191,15,206
公投第１２案,高雄市,岡山區,潭底里,320,756,258,196,454,63,517
公投第１２案,高雄市,岡山區,華崗里,321,733,247,146,393,10,403
公投第１２案,高雄市,岡山區,華崗里,322,854,335,213,548,54,602
公投第１２案,高雄市,岡山區,三和里,323,866,267,165,432,19,451
公投第１２案,高雄市,岡山區,大莊里,324,978,349,190,539,32,571
公投第１２案,高雄市,岡山區,忠孝里,325,1336,559,229,788,31,819
公投第１２案,高雄市,岡山區,忠孝里,326,1218,575,197,772,11,783
公投第１２案,高雄市,岡山區,忠孝里,327,341,155,98,253,5,258
公投第１２案,高雄市,岡山區,仁義里,328,955,532,154,686,29,715
公投第１２案,高雄市,岡山區,仁義里,329,940,472,161,633,22,655
公投第１２案,高雄市,岡山區,信義里,330,851,381,177,558,18,576
公投第１２案,高雄市,岡山區,信義里,331,762,376,149,525,17,542
公投第１２案,高雄市,岡山區,和平里,332,318,140,94,234,7,241
公投第１２案,高雄市,燕巢區,尖山里,333,1152,369,237,606,59,665
公投第１２案,高雄市,燕巢區,瓊林里,334,1120,412,237,649,24,673
公投第１２案,高雄市,燕巢區,瓊林里,335,974,385,236,621,32,653
公投第１２案,高雄市,燕巢區,安招里,336,1019,377,206,583,10,593
公投第１２案,高雄市,燕巢區,安招里,337,1058,362,210,572,41,613
公投第１２案,高雄市,燕巢區,安招里,338,1017,328,165,493,31,524
公投第１２案,高雄市,燕巢區,安招里,339,259,33,11,44,3,47
公投第１２案,高雄市,燕巢區,角宿里,340,926,387,196,583,40,623
公投第１２案,高雄市,燕巢區,角宿里,341,624,209,119,328,15,343
公投第１２案,高雄市,燕巢區,角宿里,342,1102,453,225,678,46,724
公投第１２案,高雄市,燕巢區,鳳雄里,343,1072,358,188,546,36,582
公投第１２案,高雄市,燕巢區,鳳雄里,344,1361,406,324,730,67,797
公投第１２案,高雄市,燕巢區,金山里,345,472,163,100,263,26,289
公投第１２案,高雄市,燕巢區,東燕里,346,1197,365,235,600,45,645
公投第１２案,高雄市,燕巢區,東燕里,347,1134,426,257,683,53,736
公投第１２案,高雄市,燕巢區,南燕里,348,1148,408,219,627,35,662
公投第１２案,高雄市,燕巢區,南燕里,349,1207,395,209,604,52,656
公投第１２案,高雄市,燕巢區,南燕里,350,1402,525,337,862,36,898
公投第１２案,高雄市,燕巢區,西燕里,351,1000,352,220,572,38,610
公投第１２案,高雄市,燕巢區,西燕里,352,1110,386,253,639,40,679
公投第１２案,高雄市,燕巢區,西燕里,353,1291,431,276,707,42,749
公投第１２案,高雄市,燕巢區,橫山里,354,797,269,169,438,49,487
公投第１２案,高雄市,燕巢區,橫山里,355,1098,346,194,540,37,577
公投第１２案,高雄市,燕巢區,深水里,356,1393,425,281,706,43,749
公投第１２案,高雄市,燕巢區,深水里,357,1079,325,164,489,24,513
公投第１２案,高雄市,彌陀區,光和里,358,1246,445,274,719,38,757
公投第１２案,高雄市,彌陀區,彌靖里,359,885,341,187,528,28,556
公投第１２案,高雄市,彌陀區,彌靖里,360,955,399,233,632,26,658
公投第１２案,高雄市,彌陀區,彌仁里,361,534,173,128,301,21,322
公投第１２案,高雄市,彌陀區,彌壽里,362,738,281,144,425,28,453
公投第１２案,高雄市,彌陀區,彌陀里,363,855,355,204,559,28,587
公投第１２案,高雄市,彌陀區,彌陀里,364,877,363,177,540,29,569
公投第１２案,高雄市,彌陀區,舊港里,365,781,346,131,477,33,510
公投第１２案,高雄市,彌陀區,舊港里,366,808,303,166,469,25,494
公投第１２案,高雄市,彌陀區,文安里,367,904,281,173,454,18,472
公投第１２案,高雄市,彌陀區,文安里,368,825,284,178,462,42,504
公投第１２案,高雄市,彌陀區,過港里,369,941,310,176,486,49,535
公投第１２案,高雄市,彌陀區,鹽埕里,370,1013,358,221,579,24,603
公投第１２案,高雄市,彌陀區,鹽埕里,371,1024,413,226,639,36,675
公投第１２案,高雄市,彌陀區,海尾里,372,861,310,153,463,13,476
公投第１２案,高雄市,彌陀區,漯底里,373,1163,440,249,689,46,735
公投第１２案,高雄市,彌陀區,南寮里,374,1216,526,245,771,35,806
公投第１２案,高雄市,彌陀區,南寮里,375,861,413,179,592,37,629
公投第１２案,高雄市,梓官區,梓信里,376,1061,412,215,627,41,668
公投第１２案,高雄市,梓官區,梓信里,377,1063,389,213,602,36,638
公投第１２案,高雄市,梓官區,梓義里,378,969,377,210,587,19,606
公投第１２案,高雄市,梓官區,梓義里,379,1078,347,219,566,20,586
公投第１２案,高雄市,梓官區,梓和里,380,838,310,186,496,32,528
公投第１２案,高雄市,梓官區,梓和里,381,611,258,130,388,24,412
公投第１２案,高雄市,梓官區,梓和里,382,782,310,173,483,18,501
公投第１２案,高雄市,梓官區,梓平里,383,1451,564,346,910,42,952
公投第１２案,高雄市,梓官區,中崙里,384,1144,436,219,655,21,676
公投第１２案,高雄市,梓官區,同安里,385,975,354,180,534,12,546
公投第１２案,高雄市,梓官區,大舍里,386,1317,505,270,775,30,805
公投第１２案,高雄市,梓官區,大舍里,387,1218,489,227,716,50,766
公投第１２案,高雄市,梓官區,大舍里,388,1073,404,224,628,33,661
公投第１２案,高雄市,梓官區,赤崁里,389,1112,404,189,593,27,620
公投第１２案,高雄市,梓官區,赤崁里,390,715,231,156,387,26,413
公投第１２案,高雄市,梓官區,赤東里,391,1311,474,255,729,30,759
公投第１２案,高雄市,梓官區,赤東里,392,939,344,212,556,22,578
公投第１２案,高雄市,梓官區,赤西里,393,824,335,170,505,15,520
公投第１２案,高雄市,梓官區,禮蚵里,394,1052,439,228,667,44,711
公投第１２案,高雄市,梓官區,禮蚵里,395,1020,428,185,613,43,656
公投第１２案,高雄市,梓官區,智蚵里,396,1260,455,246,701,32,733
公投第１２案,高雄市,梓官區,智蚵里,397,1595,596,269,865,25,890
公投第１２案,高雄市,梓官區,信蚵里,398,829,312,179,491,22,513
公投第１２案,高雄市,梓官區,信蚵里,399,1532,577,282,859,28,887
公投第１２案,高雄市,梓官區,茄苳里,400,1195,517,239,756,36,792
公投第１２案,高雄市,梓官區,茄苳里,401,1143,449,214,663,51,714
公投第１２案,高雄市,梓官區,典寶里,402,1186,447,263,710,38,748
公投第１２案,高雄市,梓官區,典寶里,403,1732,561,284,845,26,871
公投第１２案,高雄市,橋頭區,橋頭里,404,1005,398,228,626,54,680
公投第１２案,高雄市,橋頭區,橋頭里,405,1073,392,250,642,42,684
公投第１２案,高雄市,橋頭區,橋南里,406,1129,474,241,715,24,739
公投第１２案,高雄市,橋頭區,仕隆里,407,1244,460,286,746,57,803
公投第１２案,高雄市,橋頭區,仕隆里,408,1091,417,226,643,21,664
公投第１２案,高雄市,橋頭區,仕豐里,409,1329,556,286,842,42,884
公投第１２案,高雄市,橋頭區,仕豐里,410,1140,445,245,690,29,719
公投第１２案,高雄市,橋頭區,芋寮里,411,1220,443,261,704,64,768
公投第１２案,高雄市,橋頭區,東林里,412,1047,421,253,674,41,715
公投第１２案,高雄市,橋頭區,東林里,413,1315,453,284,737,61,798
公投第１２案,高雄市,橋頭區,西林里,414,691,266,145,411,25,436
公投第１２案,高雄市,橋頭區,西林里,415,720,297,152,449,37,486
公投第１２案,高雄市,橋頭區,白樹里,416,1192,433,259,692,59,751
公投第１２案,高雄市,橋頭區,白樹里,417,1318,488,299,787,62,849
公投第１２案,高雄市,橋頭區,白樹里,418,761,297,164,461,35,496
公投第１２案,高雄市,橋頭區,筆秀里,419,973,356,230,586,25,611
公投第１２案,高雄市,橋頭區,筆秀里,420,587,209,133,342,24,366
公投第１２案,高雄市,橋頭區,新莊里,421,812,311,194,505,27,532
公投第１２案,高雄市,橋頭區,新莊里,422,343,132,87,219,6,225
公投第１２案,高雄市,橋頭區,新莊里,423,1266,490,311,801,18,819
公投第１２案,高雄市,橋頭區,甲北里,424,1128,566,107,673,73,746
公投第１２案,高雄市,橋頭區,甲北里,425,884,375,166,541,28,569
公投第１２案,高雄市,橋頭區,甲南里,426,1187,419,240,659,38,697
公投第１２案,高雄市,橋頭區,甲南里,427,1259,526,224,750,31,781
公投第１２案,高雄市,橋頭區,頂鹽里,428,1361,485,225,710,49,759
公投第１２案,高雄市,橋頭區,中崎里,429,671,244,133,377,16,393
公投第１２案,高雄市,橋頭區,仕和里,430,1215,452,279,731,50,781
公投第１２案,高雄市,橋頭區,仕和里,431,1255,487,277,764,51,815
公投第１２案,高雄市,橋頭區,仕和里,432,1219,472,275,747,40,787
公投第１２案,高雄市,橋頭區,德松里,433,1372,513,310,823,27,850
公投第１２案,高雄市,橋頭區,三德里,434,758,328,144,472,17,489
公投第１２案,高雄市,楠梓區,清豐里,435,1309,534,280,814,25,839
公投第１２案,高雄市,楠梓區,清豐里,436,1408,533,315,848,26,874
公投第１２案,高雄市,楠梓區,清豐里,437,1851,698,379,1077,47,1124
公投第１２案,高雄市,楠梓區,清豐里,438,1578,600,349,949,34,983
公投第１２案,高雄市,楠梓區,清豐里,439,1715,587,351,938,22,960
公投第１２案,高雄市,楠梓區,清豐里,440,1611,597,301,898,13,911
公投第１２案,高雄市,楠梓區,清豐里,441,2024,711,374,1085,29,1114
公投第１２案,高雄市,楠梓區,清豐里,442,1890,626,377,1003,21,1024
公投第１２案,高雄市,楠梓區,清豐里,443,1762,558,349,907,23,930
公投第１２案,高雄市,楠梓區,清豐里,444,1888,630,384,1014,34,1048
公投第１２案,高雄市,楠梓區,清豐里,445,1822,628,373,1001,39,1040
公投第１２案,高雄市,楠梓區,清豐里,446,1846,646,375,1021,24,1045
公投第１２案,高雄市,楠梓區,東寧里,447,1268,472,284,756,42,798
公投第１２案,高雄市,楠梓區,東寧里,448,1240,496,288,784,26,810
公投第１２案,高雄市,楠梓區,東寧里,449,1432,548,321,869,24,893
公投第１２案,高雄市,楠梓區,五常里,450,1490,512,364,876,30,906
公投第１２案,高雄市,楠梓區,五常里,451,1464,575,320,895,33,928
公投第１２案,高雄市,楠梓區,五常里,452,1435,486,294,780,41,821
公投第１２案,高雄市,楠梓區,五常里,453,1602,556,311,867,38,905
公投第１２案,高雄市,楠梓區,享平里,454,1500,539,301,840,30,870
公投第１２案,高雄市,楠梓區,享平里,455,1591,565,355,920,72,992
公投第１２案,高雄市,楠梓區,惠楠里,456,1669,361,280,641,25,666
公投第１２案,高雄市,楠梓區,惠楠里,457,1469,552,328,880,29,909
公投第１２案,高雄市,楠梓區,中陽里,458,1559,495,354,849,52,901
公投第１２案,高雄市,楠梓區,中陽里,459,1638,562,313,875,55,930
公投第１２案,高雄市,楠梓區,惠民里,460,1960,754,399,1153,51,1204
公投第１２案,高雄市,楠梓區,惠民里,461,1912,662,437,1099,58,1157
公投第１２案,高雄市,楠梓區,惠豐里,462,1559,565,325,890,23,913
公投第１２案,高雄市,楠梓區,惠豐里,463,1423,465,310,775,31,806
公投第１２案,高雄市,楠梓區,惠豐里,464,1696,550,370,920,22,942
公投第１２案,高雄市,楠梓區,錦屏里,465,1493,524,297,821,68,889
公投第１２案,高雄市,楠梓區,錦屏里,466,1527,552,325,877,52,929
公投第１２案,高雄市,楠梓區,玉屏里,467,1020,374,235,609,45,654
公投第１２案,高雄市,楠梓區,玉屏里,468,1197,412,276,688,43,731
公投第１２案,高雄市,楠梓區,金田里,469,1528,517,306,823,36,859
公投第１２案,高雄市,楠梓區,金田里,470,1918,573,369,942,57,999
公投第１２案,高雄市,楠梓區,稔田里,471,1458,524,297,821,96,917
公投第１２案,高雄市,楠梓區,瑞屏里,472,1790,692,370,1062,48,1110
公投第１２案,高雄市,楠梓區,瑞屏里,473,1845,676,416,1092,60,1152
公投第１２案,高雄市,楠梓區,翠屏里,474,2037,268,428,696,43,739
公投第１２案,高雄市,楠梓區,翠屏里,475,1964,684,402,1086,31,1117
公投第１２案,高雄市,楠梓區,翠屏里,476,2006,732,410,1142,26,1168
公投第１２案,高雄市,楠梓區,翠屏里,477,1951,688,390,1078,34,1112
公投第１２案,高雄市,楠梓區,翠屏里,478,1951,630,399,1029,54,1083
公投第１２案,高雄市,楠梓區,翠屏里,479,2008,787,391,1178,36,1214
公投第１２案,高雄市,楠梓區,翠屏里,480,1923,723,392,1115,52,1167
公投第１２案,高雄市,楠梓區,翠屏里,481,1921,696,421,1117,34,1151
公投第１２案,高雄市,楠梓區,宏南里,482,832,371,190,561,23,584
公投第１２案,高雄市,楠梓區,宏毅里,483,1156,439,219,658,35,693
公投第１２案,高雄市,楠梓區,宏毅里,484,1125,412,260,672,42,714
公投第１２案,高雄市,楠梓區,宏榮里,485,1060,419,237,656,31,687
公投第１２案,高雄市,楠梓區,宏榮里,486,1502,590,294,884,42,926
公投第１２案,高雄市,楠梓區,廣昌里,487,1404,520,280,800,58,858
公投第１２案,高雄市,楠梓區,廣昌里,488,1552,474,286,760,41,801
公投第１２案,高雄市,楠梓區,久昌里,489,1460,513,290,803,36,839
公投第１２案,高雄市,楠梓區,久昌里,490,1315,493,200,693,36,729
公投第１２案,高雄市,楠梓區,大昌里,491,1062,419,205,624,48,672
公投第１２案,高雄市,楠梓區,大昌里,492,1078,399,227,626,36,662
公投第１２案,高雄市,楠梓區,福昌里,493,914,393,175,568,47,615
公投第１２案,高雄市,楠梓區,福昌里,494,1064,466,201,667,39,706
公投第１２案,高雄市,楠梓區,盛昌里,495,1705,683,338,1021,32,1053
公投第１２案,高雄市,楠梓區,盛昌里,496,1728,675,354,1029,40,1069
公投第１２案,高雄市,楠梓區,盛昌里,497,1917,758,397,1155,26,1181
公投第１２案,高雄市,楠梓區,泰昌里,498,1439,572,222,794,44,838
公投第１２案,高雄市,楠梓區,興昌里,499,1287,485,273,758,48,806
公投第１２案,高雄市,楠梓區,興昌里,500,1504,602,331,933,38,971
公投第１２案,高雄市,楠梓區,興昌里,501,1405,597,242,839,47,886
公投第１２案,高雄市,楠梓區,建昌里,502,1287,472,266,738,56,794
公投第１２案,高雄市,楠梓區,建昌里,503,1295,505,287,792,25,817
公投第１２案,高雄市,楠梓區,宏昌里,504,1483,533,344,877,33,910
公投第１２案,高雄市,楠梓區,宏昌里,505,1649,702,367,1069,35,1104
公投第１２案,高雄市,楠梓區,和昌里,506,998,377,244,621,34,655
公投第１２案,高雄市,楠梓區,和昌里,507,1025,414,226,640,36,676
公投第１２案,高雄市,楠梓區,慶昌里,508,1671,690,377,1067,42,1109
公投第１２案,高雄市,楠梓區,慶昌里,509,1453,620,282,902,54,956
公投第１２案,高雄市,楠梓區,隆昌里,510,1673,651,322,973,49,1022
公投第１２案,高雄市,楠梓區,隆昌里,511,1653,621,328,949,36,985
公投第１２案,高雄市,楠梓區,秀昌里,512,1034,382,229,611,32,643
公投第１２案,高雄市,楠梓區,秀昌里,513,1127,481,254,735,42,777
公投第１２案,高雄市,楠梓區,裕昌里,514,1575,560,332,892,34,926
公投第１２案,高雄市,楠梓區,裕昌里,515,1559,581,332,913,44,957
公投第１２案,高雄市,楠梓區,裕昌里,516,1378,492,287,779,26,805
公投第１２案,高雄市,楠梓區,國昌里,517,1714,650,373,1023,32,1055
公投第１２案,高雄市,楠梓區,國昌里,518,1721,688,332,1020,45,1065
公投第１２案,高雄市,楠梓區,加昌里,519,1628,608,352,960,33,993
公投第１２案,高雄市,楠梓區,加昌里,520,1590,660,361,1021,51,1072
公投第１２案,高雄市,楠梓區,加昌里,521,1628,636,317,953,44,997
公投第１２案,高雄市,楠梓區,加昌里,522,1739,715,389,1104,26,1130
公投第１２案,高雄市,楠梓區,加昌里,523,1642,652,376,1028,35,1063
公投第１２案,高雄市,楠梓區,仁昌里,524,1766,608,333,941,47,988
公投第１２案,高雄市,楠梓區,仁昌里,525,1482,537,294,831,34,865
公投第１２案,高雄市,楠梓區,仁昌里,526,1749,573,327,900,23,923
公投第１２案,高雄市,楠梓區,藍田里,527,1591,579,358,937,29,966
公投第１２案,高雄市,楠梓區,藍田里,528,1545,598,381,979,19,998
公投第１２案,高雄市,楠梓區,藍田里,529,1651,678,373,1051,24,1075
公投第１２案,高雄市,楠梓區,藍田里,530,1646,651,350,1001,37,1038
公投第１２案,高雄市,楠梓區,中興里,531,1496,584,336,920,50,970
公投第１２案,高雄市,楠梓區,中和里,532,1403,548,246,794,49,843
公投第１２案,高雄市,楠梓區,中和里,533,1624,442,364,806,30,836
公投第１２案,高雄市,左營區,進學里,534,2604,570,310,880,35,915
公投第１２案,高雄市,左營區,尾西里,535,1037,397,206,603,45,648
公投第１２案,高雄市,左營區,頂北里,536,542,221,111,332,29,361
公投第１２案,高雄市,左營區,中北里,537,635,227,139,366,33,399
公投第１２案,高雄市,左營區,中南里,538,518,184,88,272,8,280
公投第１２案,高雄市,左營區,廟東里,539,813,312,155,467,37,504
公投第１２案,高雄市,左營區,廟北里,540,889,315,177,492,59,551
公投第１２案,高雄市,左營區,尾南里,541,731,256,169,425,46,471
公投第１２案,高雄市,左營區,尾北里,542,1592,545,286,831,38,869
公投第１２案,高雄市,左營區,尾北里,543,1709,647,369,1016,32,1048
公投第１２案,高雄市,左營區,屏山里,544,1588,591,275,866,46,912
公投第１２案,高雄市,左營區,祥和里,545,358,156,44,200,10,210
公投第１２案,高雄市,左營區,永清里,546,666,311,133,444,13,457
公投第１２案,高雄市,左營區,莒光里,547,1748,686,319,1005,33,1038
公投第１２案,高雄市,左營區,光輝里,548,1196,500,230,730,37,767
公投第１２案,高雄市,左營區,光輝里,549,1240,491,276,767,37,804
公投第１２案,高雄市,左營區,合群里,550,1402,658,193,851,28,879
公投第１２案,高雄市,左營區,合群里,551,1173,554,157,711,21,732
公投第１２案,高雄市,左營區,明建里,552,641,330,119,449,13,462
公投第１２案,高雄市,左營區,頂西里,553,951,326,232,558,33,591
公投第１２案,高雄市,左營區,聖后里,554,732,249,167,416,27,443
公投第１２案,高雄市,左營區,聖西里,555,339,124,61,185,12,197
公投第１２案,高雄市,左營區,聖南里,556,519,212,106,318,10,328
公投第１２案,高雄市,左營區,城南里,557,514,188,124,312,30,342
公投第１２案,高雄市,左營區,路東里,558,720,282,144,426,41,467
公投第１２案,高雄市,左營區,廍北里,559,411,171,80,251,18,269
公投第１２案,高雄市,左營區,廍南里,560,603,244,132,376,26,402
公投第１２案,高雄市,左營區,埤西里,561,904,300,193,493,42,535
公投第１２案,高雄市,左營區,埤北里,562,1318,485,224,709,23,732
公投第１２案,高雄市,左營區,埤東里,563,966,347,178,525,22,547
公投第１２案,高雄市,左營區,海勝里,564,1440,576,258,834,21,855
公投第１２案,高雄市,左營區,海勝里,565,1990,751,328,1079,31,1110
公投第１２案,高雄市,左營區,海勝里,566,1090,508,178,686,24,710
公投第１２案,高雄市,左營區,海勝里,567,1272,594,174,768,33,801
公投第１２案,高雄市,左營區,崇實里,568,1558,631,358,989,17,1006
公投第１２案,高雄市,左營區,崇實里,569,1501,599,346,945,24,969
公投第１２案,高雄市,左營區,自助里,570,360,152,91,243,7,250
公投第１２案,高雄市,左營區,果貿里,571,1335,588,170,758,38,796
公投第１２案,高雄市,左營區,果貿里,572,1359,559,232,791,27,818
公投第１２案,高雄市,左營區,果惠里,573,1487,622,292,914,34,948
公投第１２案,高雄市,左營區,果峰里,574,1637,756,144,900,39,939
公投第１２案,高雄市,左營區,新下里,575,1553,612,350,962,29,991
公投第１２案,高雄市,左營區,新下里,576,1564,603,375,978,39,1017
公投第１２案,高雄市,左營區,新下里,577,1788,738,393,1131,39,1170
公投第１２案,高雄市,左營區,新下里,578,2028,761,434,1195,56,1251
公投第１２案,高雄市,左營區,新下里,579,2037,729,476,1205,50,1255
公投第１２案,高雄市,左營區,新下里,580,2101,821,449,1270,36,1306
公投第１２案,高雄市,左營區,新下里,581,2018,809,418,1227,44,1271
公投第１２案,高雄市,左營區,新上里,582,1925,782,447,1229,41,1270
公投第１２案,高雄市,左營區,新上里,583,1989,712,426,1138,38,1176
公投第１２案,高雄市,左營區,新上里,584,1780,601,354,955,29,984
公投第１２案,高雄市,左營區,新上里,585,1778,680,408,1088,23,1111
公投第１２案,高雄市,左營區,新上里,586,1496,580,316,896,29,925
公投第１２案,高雄市,左營區,新上里,587,1538,588,359,947,25,972
公投第１２案,高雄市,左營區,新上里,588,2058,788,452,1240,33,1273
公投第１２案,高雄市,左營區,新上里,589,1992,749,451,1200,33,1233
公投第１２案,高雄市,左營區,新上里,590,2058,755,487,1242,42,1284
公投第１２案,高雄市,左營區,新上里,591,2090,774,472,1246,34,1280
公投第１２案,高雄市,左營區,新上里,592,2157,817,468,1285,34,1319
公投第１２案,高雄市,左營區,新上里,593,2096,794,490,1284,33,1317
公投第１２案,高雄市,左營區,新上里,594,2101,807,475,1282,43,1325
公投第１２案,高雄市,左營區,新中里,595,1649,602,359,961,45,1006
公投第１２案,高雄市,左營區,新中里,596,1516,583,295,878,41,919
公投第１２案,高雄市,左營區,新中里,597,1678,585,449,1034,42,1076
公投第１２案,高雄市,左營區,新光里,598,1898,742,402,1144,30,1174
公投第１２案,高雄市,左營區,新光里,599,1837,804,317,1121,30,1151
公投第１２案,高雄市,左營區,新光里,600,1922,724,352,1076,30,1106
公投第１２案,高雄市,左營區,新光里,601,1785,727,370,1097,38,1135
公投第１２案,高雄市,左營區,新光里,602,1886,719,395,1114,22,1136
公投第１２案,高雄市,左營區,新光里,603,1895,742,413,1155,32,1187
公投第１２案,高雄市,左營區,新光里,604,1831,753,385,1138,31,1169
公投第１２案,高雄市,左營區,菜公里,605,2050,805,400,1205,34,1239
公投第１２案,高雄市,左營區,菜公里,606,2251,899,562,1461,31,1492
公投第１２案,高雄市,左營區,菜公里,607,2126,825,532,1357,39,1396
公投第１２案,高雄市,左營區,菜公里,608,1928,704,414,1118,19,1137
公投第１２案,高雄市,左營區,菜公里,609,2166,787,474,1261,27,1288
公投第１２案,高雄市,左營區,菜公里,610,2031,780,396,1176,34,1210
公投第１２案,高雄市,左營區,菜公里,611,1987,783,428,1211,24,1235
公投第１２案,高雄市,左營區,菜公里,612,2166,895,457,1352,37,1389
公投第１２案,高雄市,左營區,菜公里,613,1856,709,413,1122,40,1162
公投第１２案,高雄市,左營區,菜公里,614,2289,871,541,1412,28,1440
公投第１２案,高雄市,左營區,菜公里,615,1973,788,391,1179,36,1215
公投第１２案,高雄市,左營區,菜公里,616,1818,696,388,1084,44,1128
公投第１２案,高雄市,左營區,菜公里,617,1565,565,358,923,20,943
公投第１２案,高雄市,左營區,菜公里,618,1608,682,358,1040,24,1064
公投第１２案,高雄市,左營區,福山里,619,1812,719,428,1147,36,1183
公投第１２案,高雄市,左營區,福山里,620,1821,692,364,1056,16,1072
公投第１２案,高雄市,左營區,福山里,621,1907,729,406,1135,41,1176
公投第１２案,高雄市,左營區,福山里,622,1812,891,274,1165,30,1195
公投第１２案,高雄市,左營區,福山里,623,1833,940,211,1151,26,1177
公投第１２案,高雄市,左營區,福山里,624,1850,678,440,1118,35,1153
公投第１２案,高雄市,左營區,福山里,625,1738,658,351,1009,29,1038
公投第１２案,高雄市,左營區,福山里,626,1864,771,422,1193,33,1226
公投第１２案,高雄市,左營區,福山里,627,1887,744,426,1170,27,1197
公投第１２案,高雄市,左營區,福山里,628,1870,694,357,1051,25,1076
公投第１２案,高雄市,左營區,福山里,629,1866,738,378,1116,20,1136
公投第１２案,高雄市,左營區,福山里,630,1862,707,397,1104,16,1120
公投第１２案,高雄市,左營區,福山里,631,1816,730,387,1117,24,1141
公投第１２案,高雄市,左營區,福山里,632,1833,766,370,1136,30,1166
公投第１２案,高雄市,左營區,福山里,633,1676,665,368,1033,31,1064
公投第１２案,高雄市,左營區,福山里,634,1843,722,385,1107,34,1141
公投第１２案,高雄市,左營區,福山里,635,1872,761,401,1162,21,1183
公投第１２案,高雄市,左營區,福山里,636,2259,892,432,1324,31,1355
公投第１２案,高雄市,大社區,嘉誠里,637,950,270,217,487,53,540
公投第１２案,高雄市,大社區,保社里,638,1306,438,264,702,20,722
公投第１２案,高雄市,大社區,保社里,639,1856,534,295,829,24,853
公投第１２案,高雄市,大社區,大社里,640,986,361,262,623,27,650
公投第１２案,高雄市,大社區,大社里,641,1116,313,225,538,35,573
公投第１２案,高雄市,大社區,大社里,642,1253,485,280,765,50,815
公投第１２案,高雄市,大社區,大社里,643,1613,609,333,942,36,978
公投第１２案,高雄市,大社區,保安里,644,1455,461,295,756,28,784
公投第１２案,高雄市,大社區,保安里,645,1674,606,388,994,41,1035
公投第１２案,高雄市,大社區,三奶里,646,1004,370,208,578,42,620
公投第１２案,高雄市,大社區,三奶里,647,879,319,199,518,24,542
公投第１２案,高雄市,大社區,三奶里,648,778,234,196,430,19,449
公投第１２案,高雄市,大社區,觀音里,649,1110,408,234,642,37,679
公投第１２案,高雄市,大社區,觀音里,650,1432,461,321,782,36,818
公投第１２案,高雄市,大社區,觀音里,651,1466,527,348,875,36,911
公投第１２案,高雄市,大社區,觀音里,652,1383,525,339,864,51,915
公投第１２案,高雄市,大社區,神農里,653,1645,571,381,952,24,976
公投第１２案,高雄市,大社區,神農里,654,1555,462,319,781,33,814
公投第１２案,高雄市,大社區,神農里,655,1750,567,433,1000,43,1043
公投第１２案,高雄市,大社區,中里里,656,1111,377,242,619,49,668
公投第１２案,高雄市,大社區,中里里,657,1133,390,265,655,43,698
公投第１２案,高雄市,大社區,中里里,658,912,326,199,525,30,555
公投第１２案,高雄市,大社區,翠屏里,659,745,222,139,361,13,374
公投第１２案,高雄市,大社區,翠屏里,660,934,321,235,556,17,573
公投第１２案,高雄市,仁武區,大灣里,661,1777,781,385,1166,27,1193
公投第１２案,高雄市,仁武區,大灣里,662,2273,845,514,1359,47,1406
公投第１２案,高雄市,仁武區,灣內里,663,1384,556,320,876,49,925
公投第１２案,高雄市,仁武區,灣內里,664,1170,418,242,660,36,696
公投第１２案,高雄市,仁武區,灣內里,665,1216,515,269,784,37,821
公投第１２案,高雄市,仁武區,灣內里,666,1598,570,330,900,15,915
公投第１２案,高雄市,仁武區,灣內里,667,2143,854,480,1334,34,1368
公投第１２案,高雄市,仁武區,考潭里,668,1300,449,272,721,36,757
公投第１２案,高雄市,仁武區,考潭里,669,1338,474,294,768,58,826
公投第１２案,高雄市,仁武區,烏林里,670,1217,417,255,672,17,689
公投第１２案,高雄市,仁武區,烏林里,671,1202,380,200,580,43,623
公投第１２案,高雄市,仁武區,烏林里,672,1404,451,303,754,37,791
公投第１２案,高雄市,仁武區,仁福里,673,830,284,174,458,24,482
公投第１２案,高雄市,仁武區,仁武里,674,1802,526,277,803,27,830
公投第１２案,高雄市,仁武區,仁武里,675,1877,595,373,968,52,1020
公投第１２案,高雄市,仁武區,仁武里,676,1738,538,295,833,23,856
公投第１２案,高雄市,仁武區,文武里,677,1549,523,347,870,41,911
公投第１２案,高雄市,仁武區,文武里,678,1579,568,341,909,42,951
公投第１２案,高雄市,仁武區,文武里,679,1406,500,278,778,31,809
公投第１２案,高雄市,仁武區,文武里,680,1461,552,304,856,28,884
公投第１２案,高雄市,仁武區,文武里,681,1311,511,285,796,27,823
公投第１２案,高雄市,仁武區,文武里,682,1373,500,284,784,19,803
公投第１２案,高雄市,仁武區,竹後里,683,1035,349,225,574,21,595
公投第１２案,高雄市,仁武區,竹後里,684,1181,425,251,676,17,693
公投第１２案,高雄市,仁武區,八卦里,685,1670,574,341,915,34,949
公投第１２案,高雄市,仁武區,八卦里,686,1576,584,303,887,28,915
公投第１２案,高雄市,仁武區,八卦里,687,1576,580,356,936,45,981
公投第１２案,高雄市,仁武區,八卦里,688,1915,741,417,1158,24,1182
公投第１２案,高雄市,仁武區,八卦里,689,1758,624,366,990,30,1020
公投第１２案,高雄市,仁武區,八卦里,690,1892,760,404,1164,33,1197
公投第１２案,高雄市,仁武區,八卦里,691,2025,735,455,1190,41,1231
公投第１２案,高雄市,仁武區,八卦里,692,2014,796,425,1221,35,1256
公投第１２案,高雄市,仁武區,八卦里,693,1473,608,363,971,25,996
公投第１２案,高雄市,仁武區,高楠里,694,979,363,201,564,22,586
公投第１２案,高雄市,仁武區,高楠里,695,944,399,169,568,17,585
公投第１２案,高雄市,仁武區,後安里,696,1153,410,248,658,45,703
公投第１２案,高雄市,仁武區,後安里,697,1328,467,251,718,43,761
公投第１２案,高雄市,仁武區,中華里,698,1657,591,363,954,47,1001
公投第１２案,高雄市,仁武區,五和里,699,1545,491,309,800,33,833
公投第１２案,高雄市,仁武區,五和里,700,1417,572,299,871,30,901
公投第１２案,高雄市,仁武區,五和里,701,1602,624,377,1001,33,1034
公投第１２案,高雄市,仁武區,仁和里,702,1823,749,392,1141,63,1204
公投第１２案,高雄市,仁武區,仁和里,703,1914,697,410,1107,27,1134
公投第１２案,高雄市,仁武區,赤山里,704,1992,736,425,1161,33,1194
公投第１２案,高雄市,仁武區,赤山里,705,2045,691,357,1048,26,1074
公投第１２案,高雄市,仁武區,赤山里,706,1982,744,457,1201,29,1230
公投第１２案,高雄市,仁武區,仁慈里,707,2167,738,416,1154,35,1189
公投第１２案,高雄市,鳥松區,鳥松里,708,1678,612,338,950,50,1000
公投第１２案,高雄市,鳥松區,鳥松里,709,1682,578,314,892,39,931
公投第１２案,高雄市,鳥松區,鳥松里,710,1225,474,281,755,37,792
公投第１２案,高雄市,鳥松區,鳥松里,711,1322,442,255,697,39,736
公投第１２案,高雄市,鳥松區,鳥松里,712,1215,458,257,715,24,739
公投第１２案,高雄市,鳥松區,鳥松里,713,1779,568,401,969,33,1002
公投第１２案,高雄市,鳥松區,鳥松里,714,1129,384,341,725,20,745
公投第１２案,高雄市,鳥松區,夢裡里,715,1374,543,284,827,41,868
公投第１２案,高雄市,鳥松區,夢裡里,716,1089,384,262,646,25,671
公投第１２案,高雄市,鳥松區,夢裡里,717,2219,803,518,1321,48,1369
公投第１２案,高雄市,鳥松區,大華里,718,1634,598,353,951,33,984
公投第１２案,高雄市,鳥松區,大華里,719,1553,592,349,941,53,994
公投第１２案,高雄市,鳥松區,大華里,720,1572,596,363,959,52,1011
公投第１２案,高雄市,鳥松區,大華里,721,1688,613,429,1042,32,1074
公投第１２案,高雄市,鳥松區,大華里,722,1626,607,394,1001,33,1034
公投第１２案,高雄市,鳥松區,大華里,723,1744,662,423,1085,44,1129
公投第１２案,高雄市,鳥松區,坔埔里,724,1230,436,226,662,37,699
公投第１２案,高雄市,鳥松區,坔埔里,725,1201,427,298,725,52,777
公投第１２案,高雄市,鳥松區,坔埔里,726,1117,457,252,709,31,740
公投第１２案,高雄市,鳥松區,仁美里,727,1255,501,219,720,32,752
公投第１２案,高雄市,鳥松區,仁美里,728,1432,489,253,742,34,776
公投第１２案,高雄市,鳥松區,仁美里,729,1370,486,237,723,25,748
公投第１２案,高雄市,鳥松區,仁美里,730,1364,519,293,812,44,856
公投第１２案,高雄市,鳥松區,仁美里,731,1041,435,201,636,44,680
公投第１２案,高雄市,鳥松區,大竹里,732,702,322,157,479,32,511
公投第１２案,高雄市,鳥松區,華美里,733,1212,423,286,709,36,745
公投第１２案,高雄市,鳥松區,華美里,734,1289,465,257,722,41,763
公投第１２案,高雄市,鳥松區,華美里,735,1449,563,364,927,16,943
公投第１２案,高雄市,大樹區,竹寮里,736,1386,447,326,773,19,792
公投第１２案,高雄市,大樹區,竹寮里,737,1315,553,279,832,30,862
公投第１２案,高雄市,大樹區,九曲里,738,2461,818,507,1325,40,1365
公投第１２案,高雄市,大樹區,九曲里,739,1274,427,281,708,31,739
公投第１２案,高雄市,大樹區,九曲里,740,1265,434,234,668,47,715
公投第１２案,高雄市,大樹區,久堂里,741,1504,512,298,810,45,855
公投第１２案,高雄市,大樹區,久堂里,742,1049,330,221,551,20,571
公投第１２案,高雄市,大樹區,久堂里,743,1573,542,296,838,42,880
公投第１２案,高雄市,大樹區,水安里,744,1121,363,191,554,27,581
公投第１２案,高雄市,大樹區,水安里,745,1207,476,233,709,34,743
公投第１２案,高雄市,大樹區,水寮里,746,1134,397,234,631,19,650
公投第１２案,高雄市,大樹區,水寮里,747,1124,424,255,679,22,701
公投第１２案,高雄市,大樹區,檨腳里,748,1259,407,244,651,73,724
公投第１２案,高雄市,大樹區,檨腳里,749,1105,381,255,636,58,694
公投第１２案,高雄市,大樹區,檨腳里,750,1128,364,241,605,47,652
公投第１２案,高雄市,大樹區,興山里,751,1079,317,216,533,74,607
公投第１２案,高雄市,大樹區,和山里,752,1025,307,191,498,46,544
公投第１２案,高雄市,大樹區,姑山里,753,950,302,185,487,46,533
公投第１２案,高雄市,大樹區,大坑里,754,1433,455,274,729,79,808
公投第１２案,高雄市,大樹區,井腳里,755,794,238,165,403,28,431
公投第１２案,高雄市,大樹區,井腳里,756,781,226,137,363,11,374
公投第１２案,高雄市,大樹區,小坪里,757,1318,413,225,638,24,662
公投第１２案,高雄市,大樹區,龍目里,758,736,263,134,397,21,418
公投第１２案,高雄市,大樹區,龍目里,759,1047,289,208,497,21,518
公投第１２案,高雄市,大樹區,大樹里,760,1271,391,294,685,69,754
公投第１２案,高雄市,大樹區,大樹里,761,1186,355,239,594,26,620
公投第１２案,高雄市,大樹區,三和里,762,1007,347,197,544,44,588
公投第１２案,高雄市,大樹區,溪埔里,763,859,257,229,486,35,521
公投第１２案,高雄市,大樹區,溪埔里,764,735,214,153,367,14,381
公投第１２案,高雄市,大樹區,興田里,765,1046,387,213,600,51,651
公投第１２案,高雄市,大樹區,興田里,766,880,476,142,618,34,652
公投第１２案,高雄市,大樹區,統嶺里,767,720,248,119,367,17,384
公投第１２案,高雄市,鼓山區,鼓峰里,768,959,344,182,526,15,541
公投第１２案,高雄市,鼓山區,鼓峰里,769,1000,422,213,635,35,670
公投第１２案,高雄市,鼓山區,雄峰里,770,910,373,174,547,16,563
公投第１２案,高雄市,鼓山區,雄峰里,771,1085,468,207,675,38,713
公投第１２案,高雄市,鼓山區,前峰里,772,1484,480,251,731,27,758
公投第１２案,高雄市,鼓山區,前峰里,773,1393,561,277,838,20,858
公投第１２案,高雄市,鼓山區,前峰里,774,1270,532,288,820,36,856
公投第１２案,高雄市,鼓山區,光榮里,775,1055,393,220,613,31,644
公投第１２案,高雄市,鼓山區,光榮里,776,1172,433,246,679,27,706
公投第１２案,高雄市,鼓山區,光榮里,777,1175,487,252,739,34,773
公投第１２案,高雄市,鼓山區,民族里,778,1274,518,252,770,34,804
公投第１２案,高雄市,鼓山區,內惟里,779,1085,372,198,570,18,588
公投第１２案,高雄市,鼓山區,建國里,780,1470,512,311,823,38,861
公投第１２案,高雄市,鼓山區,建國里,781,974,381,253,634,20,654
公投第１２案,高雄市,鼓山區,忠正里,782,1275,458,296,754,46,800
公投第１２案,高雄市,鼓山區,忠正里,783,1206,428,274,702,38,740
公投第１２案,高雄市,鼓山區,忠正里,784,1238,503,243,746,26,772
公投第１２案,高雄市,鼓山區,自強里,785,721,351,140,491,10,501
公投第１２案,高雄市,鼓山區,龍井里,786,1220,432,252,684,25,709
公投第１２案,高雄市,鼓山區,正德里,787,1966,623,382,1005,37,1042
公投第１２案,高雄市,鼓山區,平和里,788,1722,625,319,944,51,995
公投第１２案,高雄市,鼓山區,平和里,789,1720,590,353,943,34,977
公投第１２案,高雄市,鼓山區,民強里,790,1287,507,275,782,54,836
公投第１２案,高雄市,鼓山區,民強里,791,1369,400,223,623,13,636
公投第１２案,高雄市,鼓山區,厚生里,792,1222,512,258,770,21,791
公投第１２案,高雄市,鼓山區,厚生里,793,1770,629,382,1011,37,1048
公投第１２案,高雄市,鼓山區,龍子里,794,1860,695,393,1088,21,1109
公投第１２案,高雄市,鼓山區,龍子里,795,1857,657,395,1052,33,1085
公投第１２案,高雄市,鼓山區,龍子里,796,1841,684,393,1077,30,1107
公投第１２案,高雄市,鼓山區,龍子里,797,1830,679,409,1088,32,1120
公投第１２案,高雄市,鼓山區,龍子里,798,1809,678,370,1048,42,1090
公投第１２案,高雄市,鼓山區,龍子里,799,1894,725,410,1135,39,1174
公投第１２案,高雄市,鼓山區,龍子里,800,1882,702,424,1126,24,1150
公投第１２案,高雄市,鼓山區,龍子里,801,1894,730,440,1170,38,1208
公投第１２案,高雄市,鼓山區,龍水里,802,1745,648,328,976,37,1013
公投第１２案,高雄市,鼓山區,龍水里,803,1887,642,419,1061,15,1076
公投第１２案,高雄市,鼓山區,龍水里,804,1891,764,445,1209,29,1238
公投第１２案,高雄市,鼓山區,龍水里,805,1903,740,398,1138,27,1165
公投第１２案,高雄市,鼓山區,龍水里,806,1998,738,453,1191,33,1224
公投第１２案,高雄市,鼓山區,龍水里,807,1912,706,437,1143,33,1176
公投第１２案,高雄市,鼓山區,龍水里,808,1923,737,424,1161,46,1207
公投第１２案,高雄市,鼓山區,龍水里,809,1888,705,462,1167,20,1187
公投第１２案,高雄市,鼓山區,龍水里,810,1873,717,436,1153,17,1170
公投第１２案,高雄市,鼓山區,龍水里,811,1959,772,517,1289,22,1311
公投第１２案,高雄市,鼓山區,龍水里,812,1897,754,445,1199,40,1239
公投第１２案,高雄市,鼓山區,明誠里,813,2362,920,507,1427,26,1453
公投第１２案,高雄市,鼓山區,明誠里,814,1850,729,405,1134,26,1160
公投第１２案,高雄市,鼓山區,明誠里,815,1928,741,439,1180,29,1209
公投第１２案,高雄市,鼓山區,明誠里,816,1937,674,410,1084,23,1107
公投第１２案,高雄市,鼓山區,明誠里,817,2123,812,417,1229,43,1272
公投第１２案,高雄市,鼓山區,明誠里,818,1861,717,424,1141,30,1171
公投第１２案,高雄市,鼓山區,明誠里,819,1892,703,413,1116,23,1139
公投第１２案,高雄市,鼓山區,明誠里,820,2147,781,495,1276,35,1311
公投第１２案,高雄市,鼓山區,華豐里,821,1897,747,413,1160,29,1189
公投第１２案,高雄市,鼓山區,華豐里,822,2041,737,461,1198,35,1233
公投第１２案,高雄市,鼓山區,裕興里,823,1309,473,275,748,46,794
公投第１２案,高雄市,鼓山區,裕興里,824,1867,701,403,1104,38,1142
公投第１２案,高雄市,鼓山區,裕豐里,825,1152,485,276,761,23,784
公投第１２案,高雄市,鼓山區,裕豐里,826,1404,581,300,881,31,912
公投第１２案,高雄市,鼓山區,鼓岩里,827,1210,345,227,572,17,589
公投第１２案,高雄市,鼓山區,樹德里,828,1135,425,250,675,35,710
公投第１２案,高雄市,鼓山區,寶樹里,829,1831,419,220,639,44,683
公投第１２案,高雄市,鼓山區,興宗里,830,1288,486,251,737,41,778
公投第１２案,高雄市,鼓山區,光化里,831,1241,452,232,684,31,715
公投第１２案,高雄市,鼓山區,山下里,832,1342,502,296,798,28,826
公投第１２案,高雄市,鼓山區,河邊里,833,1422,524,303,827,74,901
公投第１２案,高雄市,鼓山區,綠川里,834,1453,544,322,866,62,928
公投第１２案,高雄市,鼓山區,登山里,835,616,266,119,385,20,405
公投第１２案,高雄市,鼓山區,峰南里,836,834,311,169,480,36,516
公投第１２案,高雄市,鼓山區,麗興里,837,969,352,203,555,25,580
公投第１２案,高雄市,鼓山區,新民里,838,978,384,192,576,28,604
公投第１２案,高雄市,鼓山區,延平里,839,760,295,176,471,36,507
公投第１２案,高雄市,鼓山區,維生里,840,1248,462,253,715,41,756
公投第１２案,高雄市,鼓山區,惠安里,841,1143,403,229,632,23,655
公投第１２案,高雄市,鼓山區,壽山里,842,1358,461,242,703,37,740
公投第１２案,高雄市,鼓山區,哨船頭里,843,1036,339,203,542,20,562
公投第１２案,高雄市,鼓山區,桃源里,844,580,211,127,338,10,348
公投第１２案,高雄市,鹽埕區,藍橋里,845,1304,497,296,793,48,841
公投第１２案,高雄市,鹽埕區,慈愛里,846,357,150,70,220,10,230
公投第１２案,高雄市,鹽埕區,博愛里,847,651,250,148,398,13,411
公投第１２案,高雄市,鹽埕區,壽星里,848,1322,461,227,688,23,711
公投第１２案,高雄市,鹽埕區,中山里,849,1056,596,36,632,23,655
公投第１２案,高雄市,鹽埕區,教仁里,850,904,353,219,572,11,583
公投第１２案,高雄市,鹽埕區,教仁里,851,1130,423,233,656,22,678
公投第１２案,高雄市,鹽埕區,新樂里,852,840,354,168,522,16,538
公投第１２案,高雄市,鹽埕區,中原里,853,616,259,163,422,18,440
公投第１２案,高雄市,鹽埕區,光明里,854,1397,454,274,728,29,757
公投第１２案,高雄市,鹽埕區,育仁里,855,766,279,181,460,7,467
公投第１２案,高雄市,鹽埕區,河濱里,856,839,291,194,485,32,517
公投第１２案,高雄市,鹽埕區,河濱里,857,805,308,198,506,13,519
公投第１２案,高雄市,鹽埕區,沙地里,858,750,258,161,419,11,430
公投第１２案,高雄市,鹽埕區,南端里,859,986,335,234,569,19,588
公投第１２案,高雄市,鹽埕區,港都里,860,1068,373,224,597,10,607
公投第１２案,高雄市,鹽埕區,江西里,861,1060,369,245,614,23,637
公投第１２案,高雄市,鹽埕區,新豐里,862,805,292,150,442,22,464
公投第１２案,高雄市,鹽埕區,府北里,863,1073,357,218,575,14,589
公投第１２案,高雄市,鹽埕區,府北里,864,921,287,193,480,19,499
公投第１２案,高雄市,鹽埕區,陸橋里,865,1171,436,226,662,15,677
公投第１２案,高雄市,鹽埕區,瀨南里,866,594,201,153,354,5,359
公投第１２案,高雄市,鹽埕區,新化里,867,592,231,132,363,17,380
公投第１２案,高雄市,鹽埕區,江南里,868,610,193,138,331,10,341
公投第１２案,高雄市,旗津區,旗下里,869,1177,447,260,707,43,750
公投第１２案,高雄市,旗津區,永安里,870,1109,390,185,575,33,608
公投第１２案,高雄市,旗津區,振興里,871,1642,502,314,816,22,838
公投第１２案,高雄市,旗津區,慈愛里,872,1209,409,205,614,59,673
公投第１２案,高雄市,旗津區,慈愛里,873,1112,359,200,559,35,594
公投第１２案,高雄市,旗津區,復興里,874,1483,571,272,843,44,887
公投第１２案,高雄市,旗津區,復興里,875,1460,463,239,702,32,734
公投第１２案,高雄市,旗津區,中華里,876,1572,574,331,905,96,1001
公投第１２案,高雄市,旗津區,實踐里,877,1384,443,231,674,25,699
公投第１２案,高雄市,旗津區,北汕里,878,1390,447,254,701,22,723
公投第１２案,高雄市,旗津區,北汕里,879,1239,368,227,595,33,628
公投第１２案,高雄市,旗津區,南汕里,880,2045,664,409,1073,51,1124
公投第１２案,高雄市,旗津區,上竹里,881,893,307,151,458,24,482
公投第１２案,高雄市,旗津區,上竹里,882,1866,585,344,929,58,987
公投第１２案,高雄市,旗津區,中洲里,883,1874,548,304,852,29,881
公投第１２案,高雄市,旗津區,安順里,884,893,257,168,425,37,462
公投第１２案,高雄市,旗津區,中興里,885,1215,456,248,704,30,734
公投第１２案,高雄市,旗津區,中興里,886,1297,445,222,667,25,692
公投第１２案,高雄市,三民區,鼎金里,887,1893,660,396,1056,59,1115
公投第１２案,高雄市,三民區,鼎金里,888,1982,637,387,1024,68,1092
公投第１２案,高雄市,三民區,鼎盛里,889,1661,593,330,923,54,977
公投第１２案,高雄市,三民區,鼎盛里,890,1894,636,434,1070,19,1089
公投第１２案,高雄市,三民區,鼎盛里,891,1839,655,371,1026,29,1055
公投第１２案,高雄市,三民區,鼎盛里,892,2014,718,387,1105,46,1151
公投第１２案,高雄市,三民區,鼎強里,893,1897,701,374,1075,68,1143
公投第１２案,高雄市,三民區,鼎強里,894,2016,670,393,1063,29,1092
公投第１２案,高雄市,三民區,鼎力里,895,1924,693,383,1076,28,1104
公投第１２案,高雄市,三民區,鼎力里,896,1749,538,463,1001,39,1040
公投第１２案,高雄市,三民區,鼎西里,897,1845,705,429,1134,47,1181
公投第１２案,高雄市,三民區,鼎西里,898,1724,587,384,971,33,1004
公投第１２案,高雄市,三民區,鼎西里,899,1889,679,399,1078,34,1112
公投第１２案,高雄市,三民區,鼎西里,900,1622,598,336,934,31,965
公投第１２案,高雄市,三民區,鼎中里,901,1870,577,567,1144,12,1156
公投第１２案,高雄市,三民區,鼎中里,902,1523,574,358,932,42,974
公投第１２案,高雄市,三民區,鼎泰里,903,2006,691,378,1069,46,1115
公投第１２案,高雄市,三民區,鼎泰里,904,2076,759,511,1270,45,1315
公投第１２案,高雄市,三民區,鼎泰里,905,2073,723,462,1185,16,1201
公投第１２案,高雄市,三民區,鼎泰里,906,2045,897,294,1191,30,1221
公投第１２案,高雄市,三民區,鼎泰里,907,2070,617,395,1012,45,1057
公投第１２案,高雄市,三民區,鼎泰里,908,2035,682,447,1129,29,1158
公投第１２案,高雄市,三民區,鼎泰里,909,2075,767,506,1273,29,1302
公投第１２案,高雄市,三民區,鼎泰里,910,2053,774,419,1193,26,1219
公投第１２案,高雄市,三民區,鼎泰里,911,2063,846,437,1283,24,1307
公投第１２案,高雄市,三民區,鼎泰里,912,2143,825,485,1310,37,1347
公投第１２案,高雄市,三民區,本館里,913,1746,649,412,1061,45,1106
公投第１２案,高雄市,三民區,本館里,914,1735,609,331,940,14,954
公投第１２案,高雄市,三民區,本館里,915,1655,564,331,895,36,931
公投第１２案,高雄市,三民區,本館里,916,1583,534,364,898,47,945
公投第１２案,高雄市,三民區,本館里,917,1800,600,396,996,31,1027
公投第１２案,高雄市,三民區,本和里,918,1730,682,361,1043,20,1063
公投第１２案,高雄市,三民區,本和里,919,1715,535,463,998,22,1020
公投第１２案,高雄市,三民區,本和里,920,1691,626,371,997,34,1031
公投第１２案,高雄市,三民區,本和里,921,1865,667,416,1083,31,1114
公投第１２案,高雄市,三民區,本文里,922,1073,423,253,676,29,705
公投第１２案,高雄市,三民區,本文里,923,917,370,236,606,41,647
公投第１２案,高雄市,三民區,本武里,924,1647,613,345,958,31,989
公投第１２案,高雄市,三民區,本元里,925,1654,634,340,974,43,1017
公投第１２案,高雄市,三民區,本元里,926,1639,645,352,997,35,1032
公投第１２案,高雄市,三民區,本元里,927,1833,696,377,1073,32,1105
公投第１２案,高雄市,三民區,本安里,928,1362,523,357,880,34,914
公投第１２案,高雄市,三民區,本安里,929,1557,600,352,952,39,991
公投第１２案,高雄市,三民區,本安里,930,1482,591,273,864,27,891
公投第１２案,高雄市,三民區,本上里,931,1563,630,336,966,29,995
公投第１２案,高雄市,三民區,本上里,932,1497,545,376,921,27,948
公投第１２案,高雄市,三民區,本上里,933,1523,576,399,975,22,997
公投第１２案,高雄市,三民區,本揚里,934,1293,531,314,845,23,868
公投第１２案,高雄市,三民區,本揚里,935,1662,612,418,1030,29,1059
公投第１２案,高雄市,三民區,本揚里,936,1441,553,292,845,29,874
公投第１２案,高雄市,三民區,本揚里,937,1326,575,310,885,27,912
公投第１２案,高雄市,三民區,本揚里,938,1476,596,353,949,33,982
公投第１２案,高雄市,三民區,寶獅里,939,1968,664,404,1068,29,1097
公投第１２案,高雄市,三民區,寶獅里,940,1618,541,342,883,25,908
公投第１２案,高雄市,三民區,寶德里,941,1873,616,438,1054,35,1089
公投第１２案,高雄市,三民區,寶德里,942,1487,541,321,862,44,906
公投第１２案,高雄市,三民區,寶德里,943,1640,626,345,971,19,990
公投第１２案,高雄市,三民區,寶泰里,944,1889,685,390,1075,21,1096
公投第１２案,高雄市,三民區,寶泰里,945,1969,690,398,1088,37,1125
公投第１２案,高雄市,三民區,寶興里,946,1466,541,304,845,41,886
公投第１２案,高雄市,三民區,寶興里,947,1697,656,365,1021,39,1060
公投第１２案,高雄市,三民區,寶興里,948,1663,628,371,999,31,1030
公投第１２案,高雄市,三民區,寶興里,949,1649,566,387,953,32,985
公投第１２案,高雄市,三民區,寶中里,950,1486,548,312,860,33,893
公投第１２案,高雄市,三民區,寶中里,951,1495,598,302,900,18,918
公投第１２案,高雄市,三民區,寶華里,952,1548,595,386,981,28,1009
公投第１２案,高雄市,三民區,寶華里,953,1493,535,351,886,25,911
公投第１２案,高雄市,三民區,寶國里,954,1445,568,342,910,15,925
公投第１２案,高雄市,三民區,寶國里,955,1529,568,318,886,24,910
公投第１２案,高雄市,三民區,寶國里,956,1506,566,331,897,19,916
公投第１２案,高雄市,三民區,寶國里,957,1549,605,355,960,26,986
公投第１２案,高雄市,三民區,寶國里,958,1620,642,375,1017,48,1065
公投第１２案,高雄市,三民區,寶民里,959,1550,570,382,952,39,991
公投第１２案,高雄市,三民區,寶民里,960,1488,589,330,919,28,947
公投第１２案,高雄市,三民區,寶慶里,961,1335,481,327,808,36,844
公投第１２案,高雄市,三民區,寶慶里,962,1332,512,281,793,29,822
公投第１２案,高雄市,三民區,寶業里,963,1764,641,391,1032,55,1087
公投第１２案,高雄市,三民區,寶業里,964,1811,694,372,1066,30,1096
公投第１２案,高雄市,三民區,寶業里,965,1693,630,408,1038,48,1086
公投第１２案,高雄市,三民區,寶盛里,966,1684,683,372,1055,50,1105
公投第１２案,高雄市,三民區,寶盛里,967,1464,518,319,837,40,877
公投第１２案,高雄市,三民區,寶盛里,968,1719,674,426,1100,26,1126
公投第１２案,高雄市,三民區,寶安里,969,1749,641,392,1033,22,1055
公投第１２案,高雄市,三民區,寶安里,970,1908,381,697,1078,25,1103
公投第１２案,高雄市,三民區,寶安里,971,1573,596,347,943,35,978
公投第１２案,高雄市,三民區,寶安里,972,1628,585,340,925,26,951
公投第１２案,高雄市,三民區,寶龍里,973,1377,478,266,744,31,775
公投第１２案,高雄市,三民區,寶龍里,974,1530,607,350,957,25,982
公投第１２案,高雄市,三民區,寶龍里,975,1188,452,247,699,32,731
公投第１２案,高雄市,三民區,寶珠里,976,2791,521,322,843,30,873
公投第１２案,高雄市,三民區,寶珠里,977,1840,685,381,1066,41,1107
公投第１２案,高雄市,三民區,寶珠里,978,1671,624,377,1001,52,1053
公投第１２案,高雄市,三民區,寶玉里,979,1624,584,368,952,33,985
公投第１２案,高雄市,三民區,寶玉里,980,1555,647,387,1034,29,1063
公投第１２案,高雄市,三民區,寶玉里,981,1489,585,373,958,30,988
公投第１２案,高雄市,三民區,寶玉里,982,1662,610,396,1006,36,1042
公投第１２案,高雄市,三民區,寶玉里,983,1639,607,333,940,22,962
公投第１２案,高雄市,三民區,灣子里,984,1872,711,354,1065,36,1101
公投第１２案,高雄市,三民區,灣子里,985,1968,702,402,1104,41,1145
公投第１２案,高雄市,三民區,灣愛里,986,1471,497,232,729,57,786
公投第１２案,高雄市,三民區,灣愛里,987,1534,600,262,862,35,897
公投第１２案,高雄市,三民區,灣中里,988,1659,556,306,862,56,918
公投第１２案,高雄市,三民區,灣中里,989,1815,518,417,935,27,962
公投第１２案,高雄市,三民區,灣中里,990,1808,604,368,972,38,1010
公投第１２案,高雄市,三民區,灣華里,991,1224,412,256,668,28,696
公投第１２案,高雄市,三民區,灣華里,992,1406,520,283,803,23,826
公投第１２案,高雄市,三民區,灣勝里,993,945,357,196,553,25,578
公投第１２案,高雄市,三民區,灣勝里,994,944,362,239,601,22,623
公投第１２案,高雄市,三民區,灣利里,995,1669,581,390,971,47,1018
公投第１２案,高雄市,三民區,灣利里,996,1473,590,320,910,35,945
公投第１２案,高雄市,三民區,灣復里,997,1876,525,393,918,39,957
公投第１２案,高雄市,三民區,灣復里,998,1682,420,226,646,31,677
公投第１２案,高雄市,三民區,正興里,999,1791,589,360,949,25,974
公投第１２案,高雄市,三民區,正興里,1000,1808,670,394,1064,39,1103
公投第１２案,高雄市,三民區,正興里,1001,1798,613,373,986,29,1015
公投第１２案,高雄市,三民區,正興里,1002,2030,713,455,1168,21,1189
公投第１２案,高雄市,三民區,正興里,1003,2034,751,428,1179,25,1204
公投第１２案,高雄市,三民區,正興里,1004,1998,722,436,1158,26,1184
公投第１２案,高雄市,三民區,正順里,1005,1914,670,379,1049,35,1084
公投第１２案,高雄市,三民區,正順里,1006,1965,706,414,1120,28,1148
公投第１２案,高雄市,三民區,灣興里,1007,1885,643,386,1029,60,1089
公投第１２案,高雄市,三民區,灣成里,1008,1220,489,278,767,20,787
公投第１２案,高雄市,三民區,灣成里,1009,1057,408,201,609,42,651
公投第１２案,高雄市,三民區,安康里,1010,1434,432,289,721,25,746
公投第１２案,高雄市,三民區,安康里,1011,1350,440,251,691,26,717
公投第１２案,高雄市,三民區,安寧里,1012,872,325,153,478,10,488
公投第１２案,高雄市,三民區,安寧里,1013,954,335,178,513,20,533
公投第１２案,高雄市,三民區,安吉里,1014,1689,632,388,1020,24,1044
公投第１２案,高雄市,三民區,安吉里,1015,1390,490,321,811,25,836
公投第１２案,高雄市,三民區,安吉里,1016,1336,504,294,798,41,839
公投第１２案,高雄市,三民區,安發里,1017,1437,570,362,932,34,966
公投第１２案,高雄市,三民區,安發里,1018,1452,540,335,875,22,897
公投第１２案,高雄市,三民區,安發里,1019,1513,558,342,900,43,943
公投第１２案,高雄市,三民區,安東里,1020,1467,583,345,928,42,970
公投第１２案,高雄市,三民區,安東里,1021,1381,583,324,907,51,958
公投第１２案,高雄市,三民區,安和里,1022,1117,428,225,653,32,685
公投第１２案,高雄市,三民區,安和里,1023,1327,509,339,848,21,869
公投第１２案,高雄市,三民區,達德里,1024,1304,527,292,819,24,843
公投第１２案,高雄市,三民區,達明里,1025,1483,551,299,850,24,874
公投第１２案,高雄市,三民區,達仁里,1026,1473,595,339,934,31,965
公投第１２案,高雄市,三民區,達勇里,1027,980,347,228,575,28,603
公投第１２案,高雄市,三民區,同德里,1028,1409,587,268,855,25,880
公投第１２案,高雄市,三民區,同德里,1029,1230,480,268,748,28,776
公投第１２案,高雄市,三民區,德智里,1030,1024,413,244,657,24,681
公投第１２案,高雄市,三民區,德智里,1031,1130,442,234,676,37,713
公投第１２案,高雄市,三民區,德仁里,1032,1889,637,371,1008,31,1039
公投第１２案,高雄市,三民區,安生里,1033,1427,589,268,857,25,882
公投第１２案,高雄市,三民區,德東里,1034,791,362,156,518,15,533
公投第１２案,高雄市,三民區,德行里,1035,1079,502,238,740,35,775
公投第１２案,高雄市,三民區,精華里,1036,1492,555,310,865,43,908
公投第１２案,高雄市,三民區,民享里,1037,1020,409,230,639,30,669
公投第１２案,高雄市,三民區,民享里,1038,1001,402,247,649,9,658
公投第１２案,高雄市,三民區,安宜里,1039,1581,644,335,979,27,1006
公投第１２案,高雄市,三民區,安宜里,1040,1471,539,331,870,29,899
公投第１２案,高雄市,三民區,安泰里,1041,1151,497,244,741,18,759
公投第１２案,高雄市,三民區,安泰里,1042,1334,549,288,837,36,873
公投第１２案,高雄市,三民區,安泰里,1043,1275,479,282,761,23,784
公投第１２案,高雄市,三民區,安邦里,1044,1688,476,284,760,27,787
公投第１２案,高雄市,三民區,安邦里,1045,1214,451,281,732,28,760
公投第１２案,高雄市,三民區,安邦里,1046,1149,463,283,746,26,772
公投第１２案,高雄市,三民區,十全里,1047,1667,594,362,956,57,1013
公投第１２案,高雄市,三民區,十美里,1048,1786,606,369,975,31,1006
公投第１２案,高雄市,三民區,德北里,1049,896,353,191,544,16,560
公投第１２案,高雄市,三民區,德北里,1050,925,367,195,562,22,584
公投第１２案,高雄市,三民區,立誠里,1051,684,292,156,448,29,477
公投第１２案,高雄市,三民區,立業里,1052,981,371,253,624,36,660
公投第１２案,高雄市,三民區,港東里,1053,1383,484,252,736,40,776
公投第１２案,高雄市,三民區,港新里,1054,1382,501,321,822,34,856
公投第１２案,高雄市,三民區,港西里,1055,808,280,176,456,23,479
公投第１２案,高雄市,三民區,博愛里,1056,1197,455,273,728,22,750
公投第１２案,高雄市,三民區,博惠里,1057,1344,520,257,777,33,810
公投第１２案,高雄市,三民區,博惠里,1058,1344,531,287,818,34,852
公投第１２案,高雄市,三民區,博惠里,1059,1359,495,334,829,21,850
公投第１２案,高雄市,三民區,長明里,1060,1073,403,252,655,34,689
公投第１２案,高雄市,三民區,建東里,1061,1186,415,240,655,28,683
公投第１２案,高雄市,三民區,興德里,1062,1749,636,372,1008,51,1059
公投第１２案,高雄市,三民區,鳳南里,1063,877,361,183,544,13,557
公投第１２案,高雄市,三民區,鳳北里,1064,1402,598,296,894,36,930
公投第１２案,高雄市,三民區,德西里,1065,769,298,201,499,21,520
公投第１２案,高雄市,三民區,豐裕里,1066,1207,466,279,745,32,777
公投第１２案,高雄市,三民區,豐裕里,1067,1270,440,230,670,35,705
公投第１２案,高雄市,三民區,川東里,1068,1248,445,277,722,33,755
公投第１２案,高雄市,三民區,裕民里,1069,1263,481,267,748,44,792
公投第１２案,高雄市,三民區,力行里,1070,1101,422,253,675,32,707
公投第１２案,高雄市,三民區,千歲里,1071,1116,458,262,720,21,741
公投第１２案,高雄市,三民區,立德里,1072,1152,483,233,716,22,738
公投第１２案,高雄市,三民區,千北里,1073,1057,427,220,647,29,676
公投第１２案,高雄市,三民區,千秋里,1074,971,351,200,551,21,572
公投第１２案,高雄市,三民區,千秋里,1075,1062,383,242,625,17,642
公投第１２案,高雄市,前金區,三川里,1076,673,257,152,409,13,422
公投第１２案,高雄市,前金區,草江里,1077,1022,372,247,619,24,643
公投第１２案,高雄市,前金區,長城里,1078,1324,526,250,776,19,795
公投第１２案,高雄市,前金區,北金里,1079,839,221,175,396,28,424
公投第１２案,高雄市,前金區,東金里,1080,975,343,125,468,33,501
公投第１２案,高雄市,前金區,新生里,1081,1806,669,363,1032,46,1078
公投第１２案,高雄市,前金區,新生里,1082,1781,686,364,1050,30,1080
公投第１２案,高雄市,前金區,後金里,1083,717,274,163,437,24,461
公投第１２案,高雄市,前金區,長興里,1084,1097,409,239,648,13,661
公投第１２案,高雄市,前金區,青山里,1085,1633,601,364,965,20,985
公投第１２案,高雄市,前金區,民生里,1086,759,312,189,501,18,519
公投第１２案,高雄市,前金區,復元里,1087,948,365,227,592,34,626
公投第１２案,高雄市,前金區,林投里,1088,1009,327,210,537,31,568
公投第１２案,高雄市,前金區,國民里,1089,945,343,225,568,29,597
公投第１２案,高雄市,前金區,社東里,1090,772,295,185,480,12,492
公投第１２案,高雄市,前金區,社東里,1091,757,271,199,470,24,494
公投第１２案,高雄市,前金區,社西里,1092,1047,413,242,655,29,684
公投第１２案,高雄市,前金區,博孝里,1093,985,379,227,606,27,633
公投第１２案,高雄市,前金區,長生里,1094,1674,600,343,943,21,964
公投第１２案,高雄市,前金區,榮復里,1095,1088,402,226,628,32,660
公投第１２案,高雄市,前金區,文西里,1096,893,352,213,565,44,609
公投第１２案,高雄市,前金區,文東里,1097,1184,462,259,721,17,738
公投第１２案,高雄市,新興區,浩然里,1098,828,291,186,477,24,501
公投第１２案,高雄市,新興區,浩然里,1099,963,402,203,605,34,639
公投第１２案,高雄市,新興區,振成里,1100,1075,366,238,604,19,623
公投第１２案,高雄市,新興區,德生里,1101,1488,540,346,886,16,902
公投第１２案,高雄市,新興區,德生里,1102,1438,490,363,853,29,882
公投第１２案,高雄市,新興區,振華里,1103,1049,358,262,620,27,647
公投第１２案,高雄市,新興區,正氣里,1104,1378,539,333,872,55,927
公投第１２案,高雄市,新興區,德政里,1105,666,263,157,420,27,447
公投第１２案,高雄市,新興區,仁聲里,1106,981,348,243,591,12,603
公投第１２案,高雄市,新興區,德望里,1107,933,364,234,598,22,620
公投第１２案,高雄市,新興區,德望里,1108,987,380,198,578,19,597
公投第１２案,高雄市,新興區,華聲里,1109,988,399,214,613,21,634
公投第１２案,高雄市,新興區,蕉園里,1110,735,302,169,471,25,496
公投第１２案,高雄市,新興區,永寧里,1111,1317,489,298,787,21,808
公投第１２案,高雄市,新興區,玉衡里,1112,800,293,169,462,21,483
公投第１２案,高雄市,新興區,順昌里,1113,968,411,196,607,26,633
公投第１２案,高雄市,新興區,順昌里,1114,913,395,178,573,11,584
公投第１２案,高雄市,新興區,文昌里,1115,1389,547,350,897,20,917
公投第１２案,高雄市,新興區,文昌里,1116,1228,483,330,813,25,838
公投第１２案,高雄市,新興區,光耀里,1117,1211,492,256,748,29,777
公投第１２案,高雄市,新興區,光耀里,1118,1101,458,236,694,16,710
公投第１２案,高雄市,新興區,興昌里,1119,752,308,172,480,11,491
公投第１２案,高雄市,新興區,興昌里,1120,873,386,208,594,27,621
公投第１２案,高雄市,新興區,開平里,1121,1609,602,400,1002,22,1024
公投第１２案,高雄市,新興區,開平里,1122,1736,669,412,1081,29,1110
公投第１２案,高雄市,新興區,成功里,1123,1258,467,271,738,18,756
公投第１２案,高雄市,新興區,新江里,1124,1105,421,255,676,25,701
公投第１２案,高雄市,新興區,黎明里,1125,851,331,186,517,33,550
公投第１２案,高雄市,新興區,愛平里,1126,1011,379,236,615,34,649
公投第１２案,高雄市,新興區,南港里,1127,888,373,224,597,42,639
公投第１２案,高雄市,新興區,南港里,1128,1005,377,229,606,23,629
公投第１２案,高雄市,新興區,中東里,1129,1375,410,215,625,21,646
公投第１２案,高雄市,新興區,中東里,1130,1388,518,316,834,30,864
公投第１２案,高雄市,新興區,明莊里,1131,719,262,158,420,24,444
公投第１２案,高雄市,新興區,大明里,1132,1077,392,227,619,42,661
公投第１２案,高雄市,新興區,秋山里,1133,875,306,155,461,11,472
公投第１２案,高雄市,新興區,長驛里,1134,936,347,187,534,19,553
公投第１２案,高雄市,新興區,建興里,1135,944,371,174,545,27,572
公投第１２案,高雄市,新興區,建華里,1136,833,314,161,475,19,494
公投第１２案,高雄市,新興區,漢民里,1137,708,298,145,443,14,457
公投第１２案,高雄市,新興區,榮治里,1138,741,262,164,426,15,441
公投第１２案,高雄市,新興區,東坡里,1139,1235,443,252,695,23,718
公投第１２案,高雄市,苓雅區,博仁里,1140,718,300,145,445,14,459
公投第１２案,高雄市,苓雅區,苓洲里,1141,1492,565,280,845,40,885
公投第１２案,高雄市,苓雅區,苓昇里,1142,1210,462,269,731,33,764
公投第１２案,高雄市,苓雅區,苓中里,1143,1617,602,291,893,26,919
公投第１２案,高雄市,苓雅區,苓雅里,1144,1428,552,295,847,53,900
公投第１２案,高雄市,苓雅區,苓東里,1145,1444,497,285,782,35,817
公投第１２案,高雄市,苓雅區,城北里,1146,1452,537,281,818,51,869
公投第１２案,高雄市,苓雅區,城西里,1147,554,239,107,346,14,360
公投第１２案,高雄市,苓雅區,城東里,1148,950,334,214,548,21,569
公投第１２案,高雄市,苓雅區,城東里,1149,978,364,184,548,18,566
公投第１２案,高雄市,苓雅區,意誠里,1150,1673,593,313,906,25,931
公投第１２案,高雄市,苓雅區,意誠里,1151,2045,681,417,1098,36,1134
公投第１２案,高雄市,苓雅區,鼓中里,1152,939,383,189,572,35,607
公投第１２案,高雄市,苓雅區,田西里,1153,1284,434,267,701,23,724
公投第１２案,高雄市,苓雅區,人和里,1154,908,377,182,559,15,574
公投第１２案,高雄市,苓雅區,人和里,1155,838,278,197,475,16,491
公投第１２案,高雄市,苓雅區,仁政里,1156,1267,469,293,762,30,792
公投第１２案,高雄市,苓雅區,廣澤里,1157,994,427,203,630,36,666
公投第１２案,高雄市,苓雅區,廣澤里,1158,774,301,161,462,20,482
公投第１２案,高雄市,苓雅區,美田里,1159,1121,423,250,673,23,696
公投第１２案,高雄市,苓雅區,華堂里,1160,1474,526,343,869,32,901
公投第１２案,高雄市,苓雅區,華堂里,1161,1525,564,345,909,35,944
公投第１２案,高雄市,苓雅區,日中里,1162,1147,438,264,702,23,725
公投第１２案,高雄市,苓雅區,日中里,1163,1014,402,232,634,32,666
公投第１２案,高雄市,苓雅區,普照里,1164,1496,537,350,887,36,923
公投第１２案,高雄市,苓雅區,普照里,1165,1499,592,317,909,52,961
公投第１２案,高雄市,苓雅區,和煦里,1166,1138,460,245,705,32,737
公投第１２案,高雄市,苓雅區,和煦里,1167,839,380,179,559,28,587
公投第１２案,高雄市,苓雅區,晴朗里,1168,2088,428,299,727,29,756
公投第１２案,高雄市,苓雅區,普天里,1169,1648,622,380,1002,24,1026
公投第１２案,高雄市,苓雅區,普天里,1170,1623,585,349,934,28,962
公投第１２案,高雄市,苓雅區,林富里,1171,1932,777,436,1213,47,1260
公投第１２案,高雄市,苓雅區,林圍里,1172,1127,442,285,727,21,748
公投第１２案,高雄市,苓雅區,林圍里,1173,1156,533,276,809,17,826
公投第１２案,高雄市,苓雅區,林安里,1174,1465,613,328,941,26,967
公投第１２案,高雄市,苓雅區,光華里,1175,690,265,124,389,16,405
公投第１２案,高雄市,苓雅區,林興里,1176,1283,504,245,749,49,798
公投第１２案,高雄市,苓雅區,林華里,1177,1432,534,310,844,40,884
公投第１２案,高雄市,苓雅區,林華里,1178,1313,539,274,813,15,828
公投第１２案,高雄市,苓雅區,林西里,1179,1579,568,323,891,34,925
公投第１２案,高雄市,苓雅區,林中里,1180,1385,542,295,837,43,880
公投第１２案,高雄市,苓雅區,林中里,1181,1449,606,294,900,30,930
公投第１２案,高雄市,苓雅區,林泉里,1182,1834,700,428,1128,35,1163
公投第１２案,高雄市,苓雅區,林南里,1183,1436,573,320,893,33,926
公投第１２案,高雄市,苓雅區,林南里,1184,1431,579,312,891,42,933
公投第１２案,高雄市,苓雅區,中正里,1185,1248,523,286,809,23,832
公投第１２案,高雄市,苓雅區,中正里,1186,1470,570,340,910,34,944
公投第１２案,高雄市,苓雅區,尚義里,1187,1540,642,345,987,36,1023
公投第１２案,高雄市,苓雅區,同慶里,1188,1374,576,305,881,23,904
公投第１２案,高雄市,苓雅區,同慶里,1189,839,349,203,552,16,568
公投第１２案,高雄市,苓雅區,凱旋里,1190,1022,405,268,673,20,693
公投第１２案,高雄市,苓雅區,凱旋里,1191,1062,442,253,695,6,701
公投第１２案,高雄市,苓雅區,安祥里,1192,1078,400,275,675,13,688
公投第１２案,高雄市,苓雅區,安祥里,1193,1117,492,241,733,16,749
公投第１２案,高雄市,苓雅區,奏捷里,1194,1516,630,310,940,40,980
公投第１２案,高雄市,苓雅區,福壽里,1195,1440,514,308,822,75,897
公投第１２案,高雄市,苓雅區,福南里,1196,839,311,195,506,24,530
公投第１２案,高雄市,苓雅區,福南里,1197,888,319,204,523,17,540
公投第１２案,高雄市,苓雅區,五權里,1198,1101,448,268,716,16,732
公投第１２案,高雄市,苓雅區,五權里,1199,1004,450,243,693,29,722
公投第１２案,高雄市,苓雅區,民主里,1200,1427,551,323,874,28,902
公投第１２案,高雄市,苓雅區,民主里,1201,1168,470,251,721,19,740
公投第１２案,高雄市,苓雅區,民主里,1202,1184,481,286,767,30,797
公投第１２案,高雄市,苓雅區,林德里,1203,974,421,214,635,14,649
公投第１２案,高雄市,苓雅區,林德里,1204,849,288,186,474,10,484
公投第１２案,高雄市,苓雅區,林貴里,1205,1821,708,381,1089,31,1120
公投第１２案,高雄市,苓雅區,林榮里,1206,1306,494,304,798,32,830
公投第１２案,高雄市,苓雅區,林榮里,1207,1185,471,292,763,12,775
公投第１２案,高雄市,苓雅區,林榮里,1208,1415,539,303,842,29,871
公投第１２案,高雄市,苓雅區,英明里,1209,962,369,256,625,26,651
公投第１２案,高雄市,苓雅區,英明里,1210,964,357,218,575,26,601
公投第１２案,高雄市,苓雅區,林靖里,1211,1524,589,337,926,28,954
公投第１２案,高雄市,苓雅區,朝陽里,1212,1455,550,347,897,26,923
公投第１２案,高雄市,苓雅區,福隆里,1213,1272,476,235,711,26,737
公投第１２案,高雄市,苓雅區,福隆里,1214,1256,481,266,747,18,765
公投第１２案,高雄市,苓雅區,福祥里,1215,1203,484,223,707,25,732
公投第１２案,高雄市,苓雅區,福海里,1216,1062,436,232,668,27,695
公投第１２案,高雄市,苓雅區,福康里,1217,850,336,199,535,44,579
公投第１２案,高雄市,苓雅區,福康里,1218,1010,406,235,641,57,698
公投第１２案,高雄市,苓雅區,福人里,1219,1118,402,244,646,22,668
公投第１２案,高雄市,苓雅區,福人里,1220,937,375,199,574,32,606
公投第１２案,高雄市,苓雅區,福地里,1221,1493,538,296,834,15,849
公投第１２案,高雄市,苓雅區,福地里,1222,1183,435,298,733,30,763
公投第１２案,高雄市,苓雅區,福居里,1223,1318,458,282,740,28,768
公投第１２案,高雄市,苓雅區,福居里,1224,1362,495,308,803,34,837
公投第１２案,高雄市,苓雅區,福東里,1225,1102,408,237,645,45,690
公投第１２案,高雄市,苓雅區,福東里,1226,1481,533,335,868,33,901
公投第１２案,高雄市,苓雅區,福西里,1227,878,347,214,561,28,589
公投第１２案,高雄市,苓雅區,福西里,1228,908,359,158,517,16,533
公投第１２案,高雄市,苓雅區,永康里,1229,1056,417,260,677,26,703
公投第１２案,高雄市,苓雅區,永康里,1230,1091,427,210,637,20,657
公投第１２案,高雄市,苓雅區,正文里,1231,976,387,224,611,23,634
公投第１２案,高雄市,苓雅區,正文里,1232,1063,429,264,693,25,718
公投第１２案,高雄市,苓雅區,正言里,1233,1484,579,333,912,34,946
公投第１２案,高雄市,苓雅區,正言里,1234,1290,512,278,790,24,814
公投第１２案,高雄市,苓雅區,正大里,1235,1740,664,381,1045,35,1080
公投第１２案,高雄市,苓雅區,正大里,1236,1594,617,331,948,31,979
公投第１２案,高雄市,苓雅區,正大里,1237,1648,567,386,953,18,971
公投第１２案,高雄市,苓雅區,五福里,1238,1236,523,256,779,33,812
公投第１２案,高雄市,苓雅區,五福里,1239,1211,473,274,747,19,766
公投第１２案,高雄市,苓雅區,五福里,1240,1283,506,272,778,21,799
公投第１２案,高雄市,苓雅區,正心里,1241,1804,730,384,1114,41,1155
公投第１２案,高雄市,苓雅區,正心里,1242,1718,654,385,1039,36,1075
公投第１２案,高雄市,苓雅區,正道里,1243,1297,505,284,789,35,824
公投第１２案,高雄市,苓雅區,正道里,1244,1449,541,302,843,57,900
公投第１２案,高雄市,苓雅區,正道里,1245,1307,511,273,784,16,800
公投第１２案,高雄市,苓雅區,正義里,1246,1184,472,259,731,26,757
公投第１２案,高雄市,苓雅區,正義里,1247,1250,486,316,802,38,840
公投第１２案,高雄市,苓雅區,正仁里,1248,1248,440,282,722,20,742
公投第１２案,高雄市,苓雅區,正仁里,1249,1283,520,273,793,19,812
公投第１２案,高雄市,苓雅區,文昌里,1250,1121,481,248,729,17,746
公投第１２案,高雄市,苓雅區,文昌里,1251,1258,512,261,773,24,797
公投第１２案,高雄市,苓雅區,文昌里,1252,1339,533,286,819,20,839
公投第１２案,高雄市,苓雅區,建軍里,1253,1986,720,410,1130,46,1176
公投第１２案,高雄市,苓雅區,衛武里,1254,1028,427,196,623,22,645
公投第１２案,高雄市,苓雅區,衛武里,1255,948,438,160,598,12,610
公投第１２案,高雄市,鳳山區,鳳崗里,1256,1080,421,262,683,40,723
公投第１２案,高雄市,鳳山區,縣衙里,1257,819,331,166,497,25,522
公投第１２案,高雄市,鳳山區,曹公里,1258,851,341,167,508,32,540
公投第１２案,高雄市,鳳山區,曹公里,1259,1075,390,271,661,23,684
公投第１２案,高雄市,鳳山區,鎮西里,1260,1223,483,270,753,24,777
公投第１２案,高雄市,鳳山區,鎮西里,1261,1207,486,239,725,30,755
公投第１２案,高雄市,鳳山區,鎮西里,1262,1339,472,246,718,31,749
公投第１２案,高雄市,鳳山區,鎮西里,1263,1188,373,250,623,26,649
公投第１２案,高雄市,鳳山區,北門里,1264,1055,391,225,616,29,645
公投第１２案,高雄市,鳳山區,北門里,1265,1109,414,202,616,38,654
公投第１２案,高雄市,鳳山區,北門里,1266,756,334,160,494,34,528
公投第１２案,高雄市,鳳山區,北門里,1267,1182,425,231,656,33,689
公投第１２案,高雄市,鳳山區,鎮北里,1268,1496,532,332,864,39,903
公投第１２案,高雄市,鳳山區,鎮北里,1269,2094,617,399,1016,39,1055
公投第１２案,高雄市,鳳山區,鎮北里,1270,1672,577,338,915,28,943
公投第１２案,高雄市,鳳山區,鎮北里,1271,1761,622,340,962,18,980
公投第１２案,高雄市,鳳山區,鎮北里,1272,1450,541,282,823,51,874
公投第１２案,高雄市,鳳山區,武松里,1273,1455,461,292,753,28,781
公投第１２案,高雄市,鳳山區,武松里,1274,1234,450,260,710,32,742
公投第１２案,高雄市,鳳山區,忠誠里,1275,1713,668,364,1032,44,1076
公投第１２案,高雄市,鳳山區,忠誠里,1276,1698,606,325,931,35,966
公投第１２案,高雄市,鳳山區,文英里,1277,1247,478,266,744,32,776
公投第１２案,高雄市,鳳山區,文英里,1278,1087,387,273,660,20,680
公投第１２案,高雄市,鳳山區,文英里,1279,1199,465,258,723,23,746
公投第１２案,高雄市,鳳山區,文華里,1280,1559,616,243,859,44,903
公投第１２案,高雄市,鳳山區,文華里,1281,1233,470,265,735,33,768
公投第１２案,高雄市,鳳山區,文華里,1282,1277,470,230,700,29,729
公投第１２案,高雄市,鳳山區,文華里,1283,1481,303,564,867,11,878
公投第１２案,高雄市,鳳山區,文華里,1284,1154,452,291,743,16,759
公投第１２案,高雄市,鳳山區,文華里,1285,1475,558,352,910,27,937
公投第１２案,高雄市,鳳山區,文山里,1286,1247,426,238,664,26,690
公投第１２案,高雄市,鳳山區,文山里,1287,1538,523,312,835,28,863
公投第１２案,高雄市,鳳山區,文山里,1288,1097,409,232,641,19,660
公投第１２案,高雄市,鳳山區,文山里,1289,1221,419,234,653,22,675
公投第１２案,高雄市,鳳山區,文山里,1290,1075,432,260,692,41,733
公投第１２案,高雄市,鳳山區,文德里,1291,1751,679,370,1049,29,1078
公投第１２案,高雄市,鳳山區,文德里,1292,1758,652,411,1063,22,1085
公投第１２案,高雄市,鳳山區,文德里,1293,1749,678,328,1006,39,1045
公投第１２案,高雄市,鳳山區,文德里,1294,1746,630,342,972,16,988
公投第１２案,高雄市,鳳山區,文德里,1295,1712,762,230,992,28,1020
公投第１２案,高雄市,鳳山區,文衡里,1296,1247,478,262,740,23,763
公投第１２案,高雄市,鳳山區,文衡里,1297,1409,536,398,934,36,970
公投第１２案,高雄市,鳳山區,文衡里,1298,1347,470,322,792,26,818
公投第１２案,高雄市,鳳山區,文福里,1299,1771,636,373,1009,22,1031
公投第１２案,高雄市,鳳山區,文福里,1300,1537,550,365,915,15,930
公投第１２案,高雄市,鳳山區,文福里,1301,1605,621,341,962,23,985
公投第１２案,高雄市,鳳山區,文福里,1302,1375,522,295,817,24,841
公投第１２案,高雄市,鳳山區,文福里,1303,1393,556,293,849,35,884
公投第１２案,高雄市,鳳山區,文福里,1304,1584,531,326,857,30,887
公投第１２案,高雄市,鳳山區,成功里,1305,618,231,137,368,19,387
公投第１２案,高雄市,鳳山區,縣口里,1306,423,180,89,269,7,276
公投第１２案,高雄市,鳳山區,光明里,1307,1312,478,275,753,48,801
公投第１２案,高雄市,鳳山區,和德里,1308,769,275,178,453,24,477
公投第１２案,高雄市,鳳山區,和德里,1309,1213,490,293,783,19,802
公投第１２案,高雄市,鳳山區,和興里,1310,1107,501,226,727,24,751
公投第１２案,高雄市,鳳山區,和興里,1311,1188,460,256,716,27,743
公投第１２案,高雄市,鳳山區,和興里,1312,1183,443,288,731,24,755
公投第１２案,高雄市,鳳山區,和興里,1313,1264,498,255,753,33,786
公投第１２案,高雄市,鳳山區,南興里,1314,882,366,175,541,17,558
公投第１２案,高雄市,鳳山區,三民里,1315,1007,425,246,671,37,708
公投第１２案,高雄市,鳳山區,新興里,1316,853,322,176,498,43,541
公投第１２案,高雄市,鳳山區,新興里,1317,1660,296,167,463,26,489
公投第１２案,高雄市,鳳山區,興仁里,1318,1124,435,231,666,37,703
公投第１２案,高雄市,鳳山區,興仁里,1319,1112,422,233,655,44,699
公投第１２案,高雄市,鳳山區,興仁里,1320,1182,414,243,657,28,685
公投第１２案,高雄市,鳳山區,興中里,1321,875,368,224,592,35,627
公投第１２案,高雄市,鳳山區,協和里,1322,1040,372,251,623,32,655
公投第１２案,高雄市,鳳山區,協和里,1323,1094,436,271,707,15,722
公投第１２案,高雄市,鳳山區,協和里,1324,1217,440,290,730,36,766
公投第１２案,高雄市,鳳山區,忠義里,1325,974,410,230,640,25,665
公投第１２案,高雄市,鳳山區,忠義里,1326,987,364,218,582,29,611
公投第１２案,高雄市,鳳山區,忠義里,1327,1210,528,261,789,13,802
公投第１２案,高雄市,鳳山區,忠義里,1328,1391,502,311,813,32,845
公投第１２案,高雄市,鳳山區,忠孝里,1329,1241,394,242,636,17,653
公投第１２案,高雄市,鳳山區,忠孝里,1330,1000,390,236,626,28,654
公投第１２案,高雄市,鳳山區,忠孝里,1331,1092,446,218,664,20,684
公投第１２案,高雄市,鳳山區,忠孝里,1332,1308,537,267,804,28,832
公投第１２案,高雄市,鳳山區,忠孝里,1333,1031,412,200,612,38,650
公投第１２案,高雄市,鳳山區,中和里,1334,1159,453,277,730,41,771
公投第１２案,高雄市,鳳山區,中和里,1335,1127,429,214,643,30,673
公投第１２案,高雄市,鳳山區,中和里,1336,1109,491,281,772,28,800
公投第１２案,高雄市,鳳山區,誠義里,1337,1879,751,405,1156,34,1190
公投第１２案,高雄市,鳳山區,誠義里,1338,1803,770,390,1160,37,1197
公投第１２案,高雄市,鳳山區,生明里,1339,2045,730,344,1074,48,1122
公投第１２案,高雄市,鳳山區,鎮東里,1340,1432,510,270,780,38,818
公投第１２案,高雄市,鳳山區,鎮東里,1341,1033,403,215,618,12,630
公投第１２案,高雄市,鳳山區,瑞竹里,1342,1253,511,253,764,39,803
公投第１２案,高雄市,鳳山區,瑞竹里,1343,1217,473,258,731,19,750
公投第１２案,高雄市,鳳山區,瑞竹里,1344,1267,541,258,799,28,827
公投第１２案,高雄市,鳳山區,瑞竹里,1345,1251,474,249,723,35,758
公投第１２案,高雄市,鳳山區,瑞興里,1346,1563,593,325,918,45,963
公投第１２案,高雄市,鳳山區,瑞興里,1347,1888,711,415,1126,34,1160
公投第１２案,高雄市,鳳山區,瑞興里,1348,1368,490,312,802,34,836
公投第１２案,高雄市,鳳山區,東門里,1349,1588,557,307,864,31,895
公投第１２案,高雄市,鳳山區,東門里,1350,1255,549,210,759,37,796
公投第１２案,高雄市,鳳山區,東門里,1351,1264,477,247,724,45,769
公投第１２案,高雄市,鳳山區,東門里,1352,1291,476,267,743,54,797
公投第１２案,高雄市,鳳山區,誠德里,1353,1224,501,237,738,14,752
公投第１２案,高雄市,鳳山區,誠德里,1354,1296,466,283,749,19,768
公投第１２案,高雄市,鳳山區,誠信里,1355,826,351,178,529,30,559
公投第１２案,高雄市,鳳山區,誠信里,1356,1229,516,213,729,26,755
公投第１２案,高雄市,鳳山區,誠智里,1357,1467,544,325,869,31,900
公投第１２案,高雄市,鳳山區,誠智里,1358,1218,480,242,722,29,751
公投第１２案,高雄市,鳳山區,鳳東里,1359,2173,794,413,1207,46,1253
公投第１２案,高雄市,鳳山區,鳳東里,1360,2255,876,410,1286,46,1332
公投第１２案,高雄市,鳳山區,鳳東里,1361,1556,622,332,954,30,984
公投第１２案,高雄市,鳳山區,埤頂里,1362,1521,552,282,834,31,865
公投第１２案,高雄市,鳳山區,埤頂里,1363,1407,473,260,733,24,757
公投第１２案,高雄市,鳳山區,埤頂里,1364,1542,623,279,902,39,941
公投第１２案,高雄市,鳳山區,埤頂里,1365,1502,538,270,808,14,822
公投第１２案,高雄市,鳳山區,中正里,1366,1320,525,267,792,34,826
公投第１２案,高雄市,鳳山區,中正里,1367,1507,612,200,812,28,840
公投第１２案,高雄市,鳳山區,中正里,1368,1284,590,210,800,31,831
公投第１２案,高雄市,鳳山區,海光里,1369,1441,515,288,803,18,821
公投第１２案,高雄市,鳳山區,海光里,1370,1485,642,247,889,43,932
公投第１２案,高雄市,鳳山區,國泰里,1371,1205,486,207,693,38,731
公投第１２案,高雄市,鳳山區,國泰里,1372,1284,485,239,724,20,744
公投第１２案,高雄市,鳳山區,國泰里,1373,1326,504,297,801,37,838
公投第１２案,高雄市,鳳山區,國光里,1374,1096,418,234,652,31,683
公投第１２案,高雄市,鳳山區,國光里,1375,1182,471,256,727,42,769
公投第１２案,高雄市,鳳山區,國光里,1376,1017,239,426,665,38,703
公投第１２案,高雄市,鳳山區,國隆里,1377,1198,415,265,680,42,722
公投第１２案,高雄市,鳳山區,國隆里,1378,1281,444,262,706,32,738
公投第１２案,高雄市,鳳山區,國富里,1379,1358,512,346,858,24,882
公投第１２案,高雄市,鳳山區,國富里,1380,1226,517,286,803,30,833
公投第１２案,高雄市,鳳山區,武慶里,1381,1098,459,229,688,30,718
公投第１２案,高雄市,鳳山區,武慶里,1382,1200,456,272,728,27,755
公投第１２案,高雄市,鳳山區,武漢里,1383,942,336,225,561,27,588
公投第１２案,高雄市,鳳山區,武漢里,1384,1206,482,234,716,22,738
公投第１２案,高雄市,鳳山區,武漢里,1385,1159,465,276,741,22,763
公投第１２案,高雄市,鳳山區,武漢里,1386,1401,515,339,854,31,885
公投第１２案,高雄市,鳳山區,新甲里,1387,1525,532,325,857,20,877
公投第１２案,高雄市,鳳山區,新甲里,1388,1345,496,282,778,24,802
公投第１２案,高雄市,鳳山區,新武里,1389,1180,469,276,745,26,771
公投第１２案,高雄市,鳳山區,新武里,1390,1106,427,202,629,18,647
公投第１２案,高雄市,鳳山區,新泰里,1391,1442,572,309,881,44,925
公投第１２案,高雄市,鳳山區,新泰里,1392,1376,523,309,832,27,859
公投第１２案,高雄市,鳳山區,新泰里,1393,1243,484,265,749,24,773
公投第１２案,高雄市,鳳山區,新樂里,1394,1361,516,302,818,20,838
公投第１２案,高雄市,鳳山區,新樂里,1395,1416,553,310,863,27,890
公投第１２案,高雄市,鳳山區,新樂里,1396,1536,604,386,990,30,1020
公投第１２案,高雄市,鳳山區,新強里,1397,1388,494,268,762,23,785
公投第１２案,高雄市,鳳山區,新強里,1398,1241,510,239,749,47,796
公投第１２案,高雄市,鳳山區,新強里,1399,1394,560,293,853,33,886
公投第１２案,高雄市,鳳山區,新強里,1400,1188,496,286,782,12,794
公投第１２案,高雄市,鳳山區,海洋里,1401,1112,469,241,710,21,731
公投第１２案,高雄市,鳳山區,海洋里,1402,1198,461,297,758,28,786
公投第１２案,高雄市,鳳山區,海洋里,1403,1475,532,312,844,23,867
公投第１２案,高雄市,鳳山區,新富里,1404,1216,442,246,688,31,719
公投第１２案,高雄市,鳳山區,新富里,1405,1318,473,257,730,22,752
公投第１２案,高雄市,鳳山區,新富里,1406,1465,549,304,853,27,880
公投第１２案,高雄市,鳳山區,老爺里,1407,1314,474,212,686,30,716
公投第１２案,高雄市,鳳山區,老爺里,1408,1649,525,336,861,25,886
公投第１２案,高雄市,鳳山區,老爺里,1409,1601,515,323,838,81,919
公投第１２案,高雄市,鳳山區,老爺里,1410,1155,446,233,679,22,701
公投第１２案,高雄市,鳳山區,老爺里,1411,1050,420,196,616,38,654
公投第１２案,高雄市,鳳山區,中民里,1412,1417,504,262,766,23,789
公投第１２案,高雄市,鳳山區,中民里,1413,1525,574,285,859,40,899
公投第１２案,高雄市,鳳山區,中民里,1414,1514,599,305,904,33,937
公投第１２案,高雄市,鳳山區,中崙里,1415,1190,437,251,688,24,712
公投第１２案,高雄市,鳳山區,中崙里,1416,1325,475,264,739,20,759
公投第１２案,高雄市,鳳山區,中榮里,1417,1049,404,232,636,30,666
公投第１２案,高雄市,鳳山區,中榮里,1418,1026,407,219,626,23,649
公投第１２案,高雄市,鳳山區,中榮里,1419,1152,441,242,683,46,729
公投第１２案,高雄市,鳳山區,中榮里,1420,1254,449,232,681,15,696
公投第１２案,高雄市,鳳山區,過埤里,1421,1688,591,310,901,30,931
公投第１２案,高雄市,鳳山區,過埤里,1422,1657,667,297,964,34,998
公投第１２案,高雄市,鳳山區,過埤里,1423,1729,565,331,896,31,927
公投第１２案,高雄市,鳳山區,過埤里,1424,1628,600,369,969,27,996
公投第１２案,高雄市,鳳山區,過埤里,1425,1891,621,351,972,15,987
公投第１２案,高雄市,鳳山區,過埤里,1426,1594,606,354,960,31,991
公投第１２案,高雄市,鳳山區,過埤里,1427,1342,554,304,858,19,877
公投第１２案,高雄市,鳳山區,過埤里,1428,1448,552,368,920,26,946
公投第１２案,高雄市,鳳山區,正義里,1429,1405,518,324,842,40,882
公投第１２案,高雄市,鳳山區,正義里,1430,1097,469,224,693,32,725
公投第１２案,高雄市,鳳山區,正義里,1431,1248,487,291,778,46,824
公投第１２案,高雄市,鳳山區,正義里,1432,1225,483,251,734,30,764
公投第１２案,高雄市,鳳山區,正義里,1433,1214,497,240,737,21,758
公投第１２案,高雄市,鳳山區,保安里,1434,2032,785,450,1235,50,1285
公投第１２案,高雄市,鳳山區,保安里,1435,1927,758,366,1124,39,1163
公投第１２案,高雄市,鳳山區,保安里,1436,2097,837,429,1266,41,1307
公投第１２案,高雄市,鳳山區,一甲里,1437,968,352,188,540,38,578
公投第１２案,高雄市,鳳山區,一甲里,1438,1200,424,235,659,35,694
公投第１２案,高雄市,鳳山區,一甲里,1439,1101,401,241,642,34,676
公投第１２案,高雄市,鳳山區,二甲里,1440,1369,474,271,745,25,770
公投第１２案,高雄市,鳳山區,二甲里,1441,1542,572,325,897,42,939
公投第１２案,高雄市,鳳山區,二甲里,1442,1536,599,315,914,54,968
公投第１２案,高雄市,鳳山區,龍成里,1443,1382,495,288,783,22,805
公投第１２案,高雄市,鳳山區,龍成里,1444,1452,510,325,835,53,888
公投第１２案,高雄市,鳳山區,鎮南里,1445,1058,380,236,616,29,645
公投第１２案,高雄市,鳳山區,鎮南里,1446,976,409,191,600,33,633
公投第１２案,高雄市,鳳山區,鎮南里,1447,1545,523,288,811,22,833
公投第１２案,高雄市,鳳山區,鎮南里,1448,1143,419,235,654,28,682
公投第１２案,高雄市,鳳山區,富甲里,1449,1301,233,133,366,7,373
公投第１２案,高雄市,鳳山區,富甲里,1450,1250,420,251,671,28,699
公投第１２案,高雄市,鳳山區,善美里,1451,1208,432,262,694,24,718
公投第１２案,高雄市,鳳山區,善美里,1452,1202,455,252,707,36,743
公投第１２案,高雄市,鳳山區,善美里,1453,1499,485,335,820,54,874
公投第１２案,高雄市,鳳山區,善美里,1454,1522,548,291,839,22,861
公投第１２案,高雄市,鳳山區,富榮里,1455,1125,446,269,715,32,747
公投第１２案,高雄市,鳳山區,富榮里,1456,1307,396,390,786,16,802
公投第１２案,高雄市,鳳山區,南和里,1457,1405,528,282,810,40,850
公投第１２案,高雄市,鳳山區,南和里,1458,1252,485,257,742,41,783
公投第１２案,高雄市,鳳山區,南成里,1459,1291,505,299,804,24,828
公投第１２案,高雄市,鳳山區,南成里,1460,938,376,198,574,34,608
公投第１２案,高雄市,鳳山區,南成里,1461,1783,654,394,1048,29,1077
公投第１２案,高雄市,鳳山區,南成里,1462,1105,404,274,678,30,708
公投第１２案,高雄市,鳳山區,南成里,1463,1392,519,266,785,49,834
公投第１２案,高雄市,鳳山區,南成里,1464,1244,508,290,798,34,832
公投第１２案,高雄市,鳳山區,天興里,1465,1154,434,230,664,24,688
公投第１２案,高雄市,鳳山區,天興里,1466,1153,437,230,667,41,708
公投第１２案,高雄市,鳳山區,天興里,1467,1148,404,214,618,19,637
公投第１２案,高雄市,鳳山區,大德里,1468,1432,533,234,767,60,827
公投第１２案,高雄市,鳳山區,大德里,1469,1429,407,232,639,19,658
公投第１２案,高雄市,鳳山區,大德里,1470,1479,522,309,831,19,850
公投第１２案,高雄市,鳳山區,五福里,1471,1026,431,219,650,20,670
公投第１２案,高雄市,鳳山區,五福里,1472,993,403,227,630,49,679
公投第１２案,高雄市,鳳山區,五福里,1473,947,377,203,580,37,617
公投第１２案,高雄市,鳳山區,福興里,1474,1042,383,231,614,36,650
公投第１２案,高雄市,鳳山區,福興里,1475,1098,411,225,636,33,669
公投第１２案,高雄市,鳳山區,福興里,1476,1284,457,226,683,23,706
公投第１２案,高雄市,鳳山區,福興里,1477,1242,421,251,672,39,711
公投第１２案,高雄市,鳳山區,福興里,1478,1093,418,229,647,45,692
公投第１２案,高雄市,鳳山區,福祥里,1479,1353,452,294,746,37,783
公投第１２案,高雄市,鳳山區,福祥里,1480,1353,487,269,756,16,772
公投第１２案,高雄市,鳳山區,福誠里,1481,1309,499,273,772,31,803
公投第１２案,高雄市,鳳山區,福誠里,1482,1627,568,365,933,46,979
公投第１２案,高雄市,鳳山區,福誠里,1483,1372,522,282,804,49,853
公投第１２案,高雄市,前鎮區,草衙里,1484,1809,655,339,994,68,1062
公投第１２案,高雄市,前鎮區,草衙里,1485,1835,616,327,943,48,991
公投第１２案,高雄市,前鎮區,草衙里,1486,1890,501,294,795,46,841
公投第１２案,高雄市,前鎮區,草衙里,1487,2013,583,408,991,46,1037
公投第１２案,高雄市,前鎮區,草衙里,1488,1776,560,354,914,38,952
公投第１２案,高雄市,前鎮區,明孝里,1489,1705,464,329,793,50,843
公投第１２案,高雄市,前鎮區,明孝里,1490,672,241,135,376,45,421
公投第１２案,高雄市,前鎮區,明正里,1491,1726,521,306,827,45,872
公投第１２案,高雄市,前鎮區,明正里,1492,1597,532,388,920,20,940
公投第１２案,高雄市,前鎮區,明正里,1493,1690,618,337,955,50,1005
公投第１２案,高雄市,前鎮區,明義里,1494,1080,413,221,634,51,685
公投第１２案,高雄市,前鎮區,明義里,1495,1159,468,274,742,36,778
公投第１２案,高雄市,前鎮區,仁愛里,1496,1314,472,254,726,41,767
公投第１２案,高雄市,前鎮區,德昌里,1497,896,350,192,542,33,575
公投第１２案,高雄市,前鎮區,德昌里,1498,1002,339,240,579,27,606
公投第１２案,高雄市,前鎮區,平等里,1499,2765,679,361,1040,62,1102
公投第１２案,高雄市,前鎮區,平昌里,1500,600,225,129,354,32,386
公投第１２案,高雄市,前鎮區,明禮里,1501,1466,388,182,570,29,599
公投第１２案,高雄市,前鎮區,信義里,1502,1449,537,295,832,39,871
公投第１２案,高雄市,前鎮區,信德里,1503,991,366,180,546,25,571
公投第１２案,高雄市,前鎮區,信德里,1504,1248,475,244,719,50,769
公投第１２案,高雄市,前鎮區,明道里,1505,1066,414,232,646,54,700
公投第１２案,高雄市,前鎮區,興化里,1506,706,266,145,411,18,429
公投第１２案,高雄市,前鎮區,興仁里,1507,713,234,162,396,20,416
公投第１２案,高雄市,前鎮區,前鎮里,1508,1344,479,264,743,32,775
公投第１２案,高雄市,前鎮區,鎮東里,1509,856,328,179,507,36,543
公投第１２案,高雄市,前鎮區,鎮東里,1510,873,299,189,488,23,511
公投第１２案,高雄市,前鎮區,鎮榮里,1511,1114,409,212,621,33,654
公投第１２案,高雄市,前鎮區,鎮榮里,1512,1112,404,211,615,17,632
公投第１２案,高雄市,前鎮區,鎮昌里,1513,1044,363,225,588,31,619
公投第１２案,高雄市,前鎮區,鎮昌里,1514,940,310,194,504,24,528
公投第１２案,高雄市,前鎮區,鎮海里,1515,1342,407,275,682,43,725
公投第１２案,高雄市,前鎮區,鎮海里,1516,1402,547,348,895,39,934
公投第１２案,高雄市,前鎮區,鎮海里,1517,1320,473,320,793,28,821
公投第１２案,高雄市,前鎮區,鎮陽里,1518,958,333,208,541,39,580
公投第１２案,高雄市,前鎮區,興邦里,1519,1276,558,303,861,20,881
公投第１２案,高雄市,前鎮區,興邦里,1520,1459,582,304,886,39,925
公投第１２案,高雄市,前鎮區,鎮中里,1521,761,250,143,393,18,411
公投第１２案,高雄市,前鎮區,鎮北里,1522,1093,374,248,622,19,641
公投第１２案,高雄市,前鎮區,忠純里,1523,1521,679,252,931,38,969
公投第１２案,高雄市,前鎮區,忠純里,1524,1557,661,286,947,26,973
公投第１２案,高雄市,前鎮區,忠純里,1525,1821,629,330,959,31,990
公投第１２案,高雄市,前鎮區,忠誠里,1526,1066,504,197,701,36,737
公投第１２案,高雄市,前鎮區,忠誠里,1527,1046,493,176,669,11,680
公投第１２案,高雄市,前鎮區,西山里,1528,1709,597,376,973,38,1011
公投第１２案,高雄市,前鎮區,西山里,1529,1723,654,361,1015,49,1064
公投第１２案,高雄市,前鎮區,民權里,1530,1202,463,302,765,26,791
公投第１２案,高雄市,前鎮區,民權里,1531,1279,524,327,851,28,879
公投第１２案,高雄市,前鎮區,民權里,1532,1513,615,341,956,24,980
公投第１２案,高雄市,前鎮區,建隆里,1533,1260,473,275,748,21,769
公投第１２案,高雄市,前鎮區,振興里,1534,1139,450,263,713,51,764
公投第１２案,高雄市,前鎮區,振興里,1535,1140,469,267,736,32,768
公投第１２案,高雄市,前鎮區,良和里,1536,1462,501,392,893,46,939
公投第１２案,高雄市,前鎮區,良和里,1537,1359,531,288,819,34,853
公投第１２案,高雄市,前鎮區,西甲里,1538,2037,670,370,1040,51,1091
公投第１２案,高雄市,前鎮區,盛興里,1539,1410,504,299,803,19,822
公投第１２案,高雄市,前鎮區,盛興里,1540,1307,479,283,762,15,777
公投第１２案,高雄市,前鎮區,盛豐里,1541,1512,514,315,829,59,888
公投第１２案,高雄市,前鎮區,盛豐里,1542,1491,538,342,880,36,916
公投第１２案,高雄市,前鎮區,興中里,1543,1621,601,311,912,43,955
公投第１２案,高雄市,前鎮區,興中里,1544,1522,509,287,796,25,821
公投第１２案,高雄市,前鎮區,興東里,1545,1593,553,363,916,52,968
公投第１２案,高雄市,前鎮區,興東里,1546,1885,729,393,1122,50,1172
公投第１２案,高雄市,前鎮區,興東里,1547,1870,702,402,1104,47,1151
公投第１２案,高雄市,前鎮區,忠孝里,1548,1388,535,300,835,30,865
公投第１２案,高雄市,前鎮區,忠孝里,1549,1348,518,291,809,35,844
公投第１２案,高雄市,前鎮區,復國里,1550,1341,495,232,727,59,786
公投第１２案,高雄市,前鎮區,復國里,1551,1364,544,315,859,31,890
公投第１２案,高雄市,前鎮區,竹內里,1552,1367,505,289,794,46,840
公投第１２案,高雄市,前鎮區,竹內里,1553,1326,489,279,768,40,808
公投第１２案,高雄市,前鎮區,竹東里,1554,1059,478,137,615,31,646
公投第１２案,高雄市,前鎮區,竹東里,1555,1119,522,167,689,14,703
公投第１２案,高雄市,前鎮區,竹南里,1556,1565,512,364,876,26,902
公投第１２案,高雄市,前鎮區,竹南里,1557,1549,564,320,884,44,928
公投第１２案,高雄市,前鎮區,竹南里,1558,1691,683,397,1080,21,1101
公投第１２案,高雄市,前鎮區,竹南里,1559,1837,700,381,1081,23,1104
公投第１２案,高雄市,前鎮區,竹北里,1560,1092,451,238,689,18,707
公投第１２案,高雄市,前鎮區,竹北里,1561,1126,423,254,677,38,715
公投第１２案,高雄市,前鎮區,竹西里,1562,1215,419,250,669,48,717
公投第１２案,高雄市,前鎮區,竹西里,1563,1443,537,335,872,24,896
公投第１２案,高雄市,前鎮區,竹西里,1564,1448,616,371,987,15,1002
公投第１２案,高雄市,前鎮區,竹中里,1565,1648,634,340,974,43,1017
公投第１２案,高雄市,前鎮區,竹中里,1566,1603,366,216,582,41,623
公投第１２案,高雄市,前鎮區,瑞竹里,1567,1596,523,281,804,32,836
公投第１２案,高雄市,前鎮區,瑞南里,1568,1450,516,262,778,34,812
公投第１２案,高雄市,前鎮區,瑞南里,1569,1510,530,266,796,61,857
公投第１２案,高雄市,前鎮區,瑞南里,1570,1647,643,349,992,52,1044
公投第１２案,高雄市,前鎮區,瑞豐里,1571,1342,493,262,755,35,790
公投第１２案,高雄市,前鎮區,瑞豐里,1572,1384,494,263,757,30,787
公投第１２案,高雄市,前鎮區,瑞祥里,1573,1479,558,260,818,44,862
公投第１２案,高雄市,前鎮區,瑞祥里,1574,1546,604,315,919,22,941
公投第１２案,高雄市,前鎮區,瑞祥里,1575,1595,557,381,938,44,982
公投第１２案,高雄市,前鎮區,瑞東里,1576,1201,467,252,719,35,754
公投第１２案,高雄市,前鎮區,瑞東里,1577,1082,413,197,610,23,633
公投第１２案,高雄市,前鎮區,瑞和里,1578,996,342,202,544,26,570
公投第１２案,高雄市,前鎮區,瑞和里,1579,932,284,281,565,29,594
公投第１２案,高雄市,前鎮區,瑞平里,1580,1146,408,264,672,33,705
公投第１２案,高雄市,前鎮區,瑞平里,1581,1096,414,240,654,26,680
公投第１２案,高雄市,前鎮區,瑞平里,1582,1332,535,334,869,12,881
公投第１２案,高雄市,前鎮區,瑞隆里,1583,1175,421,279,700,24,724
公投第１２案,高雄市,前鎮區,瑞隆里,1584,986,363,204,567,39,606
公投第１２案,高雄市,前鎮區,瑞隆里,1585,1316,487,287,774,52,826
公投第１２案,高雄市,前鎮區,瑞北里,1586,1559,482,337,819,40,859
公投第１２案,高雄市,前鎮區,瑞北里,1587,1622,626,330,956,47,1003
公投第１２案,高雄市,前鎮區,瑞西里,1588,1310,557,225,782,25,807
公投第１２案,高雄市,前鎮區,瑞西里,1589,1299,536,270,806,49,855
公投第１２案,高雄市,前鎮區,瑞崗里,1590,1191,522,247,769,32,801
公投第１２案,高雄市,前鎮區,瑞崗里,1591,1375,515,268,783,26,809
公投第１２案,高雄市,前鎮區,瑞興里,1592,1338,494,291,785,33,818
公投第１２案,高雄市,前鎮區,瑞興里,1593,1175,412,264,676,23,699
公投第１２案,高雄市,前鎮區,瑞誠里,1594,1357,473,296,769,18,787
公投第１２案,高雄市,前鎮區,瑞誠里,1595,1187,478,283,761,39,800
公投第１２案,高雄市,前鎮區,瑞文里,1596,1164,457,229,686,27,713
公投第１２案,高雄市,前鎮區,瑞文里,1597,1219,450,287,737,47,784
公投第１２案,高雄市,前鎮區,瑞華里,1598,1428,524,281,805,19,824
公投第１２案,高雄市,前鎮區,瑞華里,1599,1495,540,307,847,45,892
公投第１２案,高雄市,前鎮區,瑞華里,1600,1531,574,371,945,30,975
公投第１２案,高雄市,前鎮區,瑞昌里,1601,1509,556,308,864,44,908
公投第１２案,高雄市,前鎮區,瑞昌里,1602,1591,588,301,889,46,935
公投第１２案,高雄市,小港區,小港里,1603,1108,465,235,700,21,721
公投第１２案,高雄市,小港區,小港里,1604,1171,445,260,705,42,747
公投第１２案,高雄市,小港區,港口里,1605,1557,546,406,952,20,972
公投第１２案,高雄市,小港區,港口里,1606,1668,558,344,902,18,920
公投第１２案,高雄市,小港區,港正里,1607,1183,515,242,757,20,777
公投第１２案,高雄市,小港區,港正里,1608,1372,503,311,814,28,842
公投第１２案,高雄市,小港區,港墘里,1609,1737,644,379,1023,51,1074
公投第１２案,高雄市,小港區,港明里,1610,1586,455,408,863,46,909
公投第１２案,高雄市,小港區,港明里,1611,1558,530,300,830,35,865
公投第１２案,高雄市,小港區,港后里,1612,1284,534,292,826,38,864
公投第１２案,高雄市,小港區,港后里,1613,1249,454,288,742,36,778
公投第１２案,高雄市,小港區,港南里,1614,2400,667,420,1087,54,1141
公投第１２案,高雄市,小港區,港興里,1615,1181,497,251,748,24,772
公投第１２案,高雄市,小港區,港興里,1616,1079,428,212,640,38,678
公投第１２案,高雄市,小港區,鳳宮里,1617,1335,438,320,758,34,792
公投第１２案,高雄市,小港區,鳳宮里,1618,1241,455,276,731,37,768
公投第１２案,高雄市,小港區,店鎮里,1619,1513,540,309,849,35,884
公投第１２案,高雄市,小港區,店鎮里,1620,1349,509,299,808,50,858
公投第１２案,高雄市,小港區,店鎮里,1621,1483,528,306,834,38,872
公投第１２案,高雄市,小港區,店鎮里,1622,1451,539,330,869,10,879
公投第１２案,高雄市,小港區,大苓里,1623,1241,416,259,675,22,697
公投第１２案,高雄市,小港區,大苓里,1624,1262,498,310,808,44,852
公投第１２案,高雄市,小港區,二苓里,1625,1813,669,402,1071,42,1113
公投第１２案,高雄市,小港區,二苓里,1626,1877,635,360,995,30,1025
公投第１２案,高雄市,小港區,三苓里,1627,1391,477,332,809,21,830
公投第１２案,高雄市,小港區,三苓里,1628,1453,566,330,896,25,921
公投第１２案,高雄市,小港區,正苓里,1629,1374,508,281,789,34,823
公投第１２案,高雄市,小港區,正苓里,1630,1348,511,275,786,21,807
公投第１２案,高雄市,小港區,正苓里,1631,1334,516,295,811,37,848
公投第１２案,高雄市,小港區,順苓里,1632,1433,488,343,831,23,854
公投第１２案,高雄市,小港區,順苓里,1633,1448,473,317,790,17,807
公投第１２案,高雄市,小港區,順苓里,1634,1488,571,342,913,50,963
公投第１２案,高雄市,小港區,六苓里,1635,1278,491,269,760,43,803
公投第１２案,高雄市,小港區,六苓里,1636,1306,555,329,884,28,912
公投第１２案,高雄市,小港區,宏亮里,1637,1625,605,337,942,49,991
公投第１２案,高雄市,小港區,宏亮里,1638,1640,600,400,1000,55,1055
公投第１２案,高雄市,小港區,山東里,1639,1506,552,300,852,40,892
公投第１２案,高雄市,小港區,山東里,1640,1438,508,259,767,43,810
公投第１２案,高雄市,小港區,青島里,1641,1105,485,237,722,28,750
公投第１２案,高雄市,小港區,青島里,1642,1167,430,221,651,18,669
公投第１２案,高雄市,小港區,濟南里,1643,1420,539,327,866,28,894
公投第１２案,高雄市,小港區,濟南里,1644,1380,507,350,857,55,912
公投第１２案,高雄市,小港區,濟南里,1645,1239,460,257,717,24,741
公投第１２案,高雄市,小港區,泰山里,1646,1563,644,291,935,41,976
公投第１２案,高雄市,小港區,泰山里,1647,1644,590,364,954,43,997
公投第１２案,高雄市,小港區,山明里,1648,1895,705,359,1064,44,1108
公投第１２案,高雄市,小港區,山明里,1649,1748,608,354,962,55,1017
公投第１２案,高雄市,小港區,山明里,1650,1579,573,349,922,48,970
公投第１２案,高雄市,小港區,山明里,1651,2135,739,432,1171,32,1203
公投第１２案,高雄市,小港區,山明里,1652,1728,621,365,986,39,1025
公投第１２案,高雄市,小港區,山明里,1653,2022,646,421,1067,41,1108
公投第１２案,高雄市,小港區,高松里,1654,1329,460,211,671,24,695
公投第１２案,高雄市,小港區,高松里,1655,1320,481,284,765,23,788
公投第１２案,高雄市,小港區,高松里,1656,1267,452,296,748,39,787
公投第１２案,高雄市,小港區,松金里,1657,1298,488,306,794,40,834
公投第１２案,高雄市,小港區,松金里,1658,1289,506,307,813,20,833
公投第１２案,高雄市,小港區,松山里,1659,1534,589,347,936,36,972
公投第１２案,高雄市,小港區,松山里,1660,1494,574,307,881,35,916
公投第１２案,高雄市,小港區,大坪里,1661,1377,522,296,818,39,857
公投第１２案,高雄市,小港區,大坪里,1662,1344,523,311,834,28,862
公投第１２案,高雄市,小港區,坪頂里,1663,1508,515,345,860,33,893
公投第１２案,高雄市,小港區,坪頂里,1664,1400,501,286,787,25,812
公投第１２案,高雄市,小港區,坪頂里,1665,1457,532,339,871,31,902
公投第１２案,高雄市,小港區,坪頂里,1666,1392,482,288,770,20,790
公投第１２案,高雄市,小港區,孔宅里,1667,1983,662,378,1040,73,1113
公投第１２案,高雄市,小港區,孔宅里,1668,1204,432,269,701,19,720
公投第１２案,高雄市,小港區,孔宅里,1669,1300,443,307,750,24,774
公投第１２案,高雄市,小港區,廈莊里,1670,1857,677,423,1100,61,1161
公投第１２案,高雄市,小港區,廈莊里,1671,1566,580,312,892,21,913
公投第１２案,高雄市,小港區,合作里,1672,1343,500,336,836,46,882
公投第１２案,高雄市,小港區,合作里,1673,1236,481,293,774,53,827
公投第１２案,高雄市,小港區,桂林里,1674,1564,593,344,937,59,996
公投第１２案,高雄市,小港區,桂林里,1675,1484,560,311,871,25,896
公投第１２案,高雄市,小港區,桂林里,1676,1477,540,338,878,19,897
公投第１２案,高雄市,小港區,桂林里,1677,1482,525,381,906,24,930
公投第１２案,高雄市,小港區,桂林里,1678,1708,589,350,939,29,968
公投第１２案,高雄市,小港區,中厝里,1679,1867,597,432,1029,49,1078
公投第１２案,高雄市,小港區,中厝里,1680,1709,548,381,929,26,955
公投第１２案,高雄市,小港區,鳳鳴里,1681,1425,460,308,768,45,813
公投第１２案,高雄市,小港區,鳳鳴里,1682,1696,518,292,810,32,842
公投第１２案,高雄市,小港區,龍鳳里,1683,1522,452,313,765,28,793
公投第１２案,高雄市,小港區,龍鳳里,1684,1531,508,332,840,64,904
公投第１２案,高雄市,小港區,鳳森里,1685,2215,740,419,1159,75,1234
公投第１２案,高雄市,小港區,鳳林里,1686,1515,555,324,879,32,911
公投第１２案,高雄市,小港區,鳳林里,1687,1535,497,336,833,28,861
公投第１２案,高雄市,小港區,鳳興里,1688,1276,423,290,713,18,731
公投第１２案,高雄市,小港區,鳳興里,1689,1217,371,253,624,31,655
公投第１２案,高雄市,小港區,鳳源里,1690,1707,526,295,821,48,869
公投第１２案,高雄市,小港區,鳳源里,1691,1920,586,382,968,71,1039
公投第１２案,高雄市,大寮區,拷潭里,1692,727,226,145,371,23,394
公投第１２案,高雄市,大寮區,拷潭里,1693,718,212,145,357,15,372
公投第１２案,高雄市,大寮區,內坑里,1694,1340,462,241,703,30,733
公投第１２案,高雄市,大寮區,內坑里,1695,1575,446,282,728,28,756
公投第１２案,高雄市,大寮區,內坑里,1696,444,143,102,245,18,263
公投第１２案,高雄市,大寮區,內坑里,1697,2374,635,392,1027,38,1065
公投第１２案,高雄市,大寮區,大寮里,1698,1291,433,252,685,43,728
公投第１２案,高雄市,大寮區,大寮里,1699,1400,494,262,756,65,821
公投第１２案,高雄市,大寮區,大寮里,1700,1390,468,300,768,22,790
公投第１２案,高雄市,大寮區,大寮里,1701,1401,430,300,730,55,785
公投第１２案,高雄市,大寮區,大寮里,1702,1199,389,225,614,28,642
公投第１２案,高雄市,大寮區,上寮里,1703,1210,371,237,608,28,636
公投第１２案,高雄市,大寮區,上寮里,1704,1195,424,229,653,30,683
公投第１２案,高雄市,大寮區,三隆里,1705,1166,427,237,664,29,693
公投第１２案,高雄市,大寮區,三隆里,1706,1353,489,278,767,17,784
公投第１２案,高雄市,大寮區,三隆里,1707,1052,372,228,600,45,645
公投第１２案,高雄市,大寮區,三隆里,1708,1024,327,175,502,23,525
公投第１２案,高雄市,大寮區,琉球里,1709,1189,468,225,693,21,714
公投第１２案,高雄市,大寮區,琉球里,1710,1512,715,155,870,47,917
公投第１２案,高雄市,大寮區,琉球里,1711,1633,526,315,841,46,887
公投第１２案,高雄市,大寮區,翁園里,1712,1214,470,265,735,37,772
公投第１２案,高雄市,大寮區,翁園里,1713,1258,544,253,797,44,841
公投第１２案,高雄市,大寮區,翁園里,1714,1323,599,242,841,21,862
公投第１２案,高雄市,大寮區,前庄里,1715,1253,490,261,751,30,781
公投第１２案,高雄市,大寮區,前庄里,1716,1035,407,221,628,32,660
公投第１２案,高雄市,大寮區,中庄里,1717,1106,405,218,623,32,655
公投第１２案,高雄市,大寮區,中庄里,1718,1195,415,249,664,25,689
公投第１２案,高雄市,大寮區,中庄里,1719,1051,416,219,635,27,662
公投第１２案,高雄市,大寮區,中庄里,1720,1425,498,311,809,50,859
公投第１２案,高雄市,大寮區,中庄里,1721,1635,550,324,874,44,918
公投第１２案,高雄市,大寮區,中庄里,1722,1359,523,264,787,27,814
公投第１２案,高雄市,大寮區,中庄里,1723,1361,482,286,768,49,817
公投第１２案,高雄市,大寮區,中庄里,1724,1629,577,336,913,29,942
公投第１２案,高雄市,大寮區,後庄里,1725,1518,561,301,862,24,886
公投第１２案,高雄市,大寮區,後庄里,1726,1620,572,310,882,30,912
公投第１２案,高雄市,大寮區,後庄里,1727,1648,586,298,884,22,906
公投第１２案,高雄市,大寮區,後庄里,1728,1385,492,307,799,33,832
公投第１２案,高雄市,大寮區,後庄里,1729,1435,481,299,780,22,802
公投第１２案,高雄市,大寮區,義仁里,1730,1046,391,205,596,24,620
公投第１２案,高雄市,大寮區,義仁里,1731,789,259,145,404,24,428
公投第１２案,高雄市,大寮區,新厝里,1732,909,297,172,469,23,492
公投第１２案,高雄市,大寮區,新厝里,1733,733,256,164,420,24,444
公投第１２案,高雄市,大寮區,過溪里,1734,1553,518,307,825,32,857
公投第１２案,高雄市,大寮區,過溪里,1735,922,311,195,506,21,527
公投第１２案,高雄市,大寮區,潮寮里,1736,1012,364,179,543,51,594
公投第１２案,高雄市,大寮區,潮寮里,1737,968,318,188,506,44,550
公投第１２案,高雄市,大寮區,潮寮里,1738,1021,407,207,614,20,634
公投第１２案,高雄市,大寮區,會結里,1739,1554,480,252,732,44,776
公投第１２案,高雄市,大寮區,會社里,1740,1120,425,226,651,39,690
公投第１２案,高雄市,大寮區,會社里,1741,1225,454,281,735,31,766
公投第１２案,高雄市,大寮區,會社里,1742,1320,322,176,498,17,515
公投第１２案,高雄市,大寮區,會社里,1743,1317,476,248,724,40,764
公投第１２案,高雄市,大寮區,會社里,1744,1119,396,219,615,25,640
公投第１２案,高雄市,大寮區,山頂里,1745,1190,454,250,704,25,729
公投第１２案,高雄市,大寮區,山頂里,1746,1229,446,276,722,36,758
公投第１２案,高雄市,大寮區,山頂里,1747,1178,479,246,725,31,756
公投第１２案,高雄市,大寮區,山頂里,1748,1272,478,280,758,39,797
公投第１２案,高雄市,大寮區,山頂里,1749,1413,526,268,794,17,811
公投第１２案,高雄市,大寮區,山頂里,1750,1185,451,260,711,30,741
公投第１２案,高雄市,大寮區,忠義里,1751,553,225,96,321,12,333
公投第１２案,高雄市,大寮區,永芳里,1752,1121,387,205,592,46,638
公投第１２案,高雄市,大寮區,永芳里,1753,1227,419,277,696,29,725
公投第１２案,高雄市,大寮區,永芳里,1754,1058,449,237,686,33,719
公投第１２案,高雄市,大寮區,永芳里,1755,1209,426,251,677,19,696
公投第１２案,高雄市,大寮區,永芳里,1756,1100,413,256,669,15,684
公投第１２案,高雄市,大寮區,永芳里,1757,1122,366,240,606,23,629
公投第１２案,高雄市,大寮區,義和里,1758,983,374,229,603,45,648
公投第１２案,高雄市,大寮區,義和里,1759,1192,417,217,634,12,646
公投第１２案,高雄市,大寮區,溪寮里,1760,719,294,140,434,28,462
公投第１２案,高雄市,大寮區,溪寮里,1761,829,324,186,510,15,525
公投第１２案,高雄市,大寮區,江山里,1762,771,345,156,501,32,533
公投第１２案,高雄市,大寮區,江山里,1763,1075,419,243,662,27,689
公投第１２案,高雄市,大寮區,昭明里,1764,1280,475,268,743,57,800
公投第１２案,高雄市,大寮區,昭明里,1765,1179,408,223,631,70,701
公投第１２案,高雄市,大寮區,昭明里,1766,1210,416,245,661,22,683
公投第１２案,高雄市,大寮區,光武里,1767,189,74,41,115,5,120
公投第１２案,高雄市,大寮區,中興里,1768,1228,486,232,718,32,750
公投第１２案,高雄市,大寮區,中興里,1769,1170,460,189,649,27,676
公投第１２案,高雄市,大寮區,中興里,1770,1416,574,280,854,28,882
公投第１２案,高雄市,大寮區,中興里,1771,1482,554,319,873,29,902
公投第１２案,高雄市,大寮區,中興里,1772,1478,515,274,789,36,825
公投第１２案,高雄市,林園區,東林里,1773,1262,458,278,736,39,775
公投第１２案,高雄市,林園區,東林里,1774,1562,488,313,801,56,857
公投第１２案,高雄市,林園區,林園里,1775,1078,392,227,619,22,641
公投第１２案,高雄市,林園區,林園里,1776,979,355,238,593,35,628
公投第１２案,高雄市,林園區,林園里,1777,1195,387,257,644,39,683
公投第１２案,高雄市,林園區,溪州里,1778,1380,448,262,710,48,758
公投第１２案,高雄市,林園區,溪州里,1779,1280,428,256,684,48,732
公投第１２案,高雄市,林園區,溪州里,1780,1269,384,280,664,32,696
公投第１２案,高雄市,林園區,潭頭里,1781,1568,445,246,691,17,708
公投第１２案,高雄市,林園區,潭頭里,1782,1226,419,288,707,34,741
公投第１２案,高雄市,林園區,中厝里,1783,1480,515,265,780,45,825
公投第１２案,高雄市,林園區,中厝里,1784,1459,545,270,815,48,863
公投第１２案,高雄市,林園區,中門里,1785,1593,511,320,831,46,877
公投第１２案,高雄市,林園區,中門里,1786,895,292,184,476,72,548
公投第１２案,高雄市,林園區,頂厝里,1787,1110,360,205,565,14,579
公投第１２案,高雄市,林園區,頂厝里,1788,1348,410,277,687,44,731
公投第１２案,高雄市,林園區,頂厝里,1789,912,304,210,514,38,552
公投第１２案,高雄市,林園區,頂厝里,1790,1085,401,253,654,51,705
公投第１２案,高雄市,林園區,港埔里,1791,955,346,191,537,21,558
公投第１２案,高雄市,林園區,港埔里,1792,879,332,177,509,36,545
公投第１２案,高雄市,林園區,西溪里,1793,1103,357,241,598,49,647
公投第１２案,高雄市,林園區,西溪里,1794,1054,392,245,637,49,686
公投第１２案,高雄市,林園區,西溪里,1795,1292,399,255,654,20,674
公投第１２案,高雄市,林園區,港嘴里,1796,1683,502,305,807,25,832
公投第１２案,高雄市,林園區,北汕里,1797,607,208,121,329,24,353
公投第１２案,高雄市,林園區,北汕里,1798,1012,331,211,542,53,595
公投第１２案,高雄市,林園區,林內里,1799,1046,371,210,581,39,620
公投第１２案,高雄市,林園區,林內里,1800,914,263,167,430,18,448
公投第１２案,高雄市,林園區,王公里,1801,1405,483,309,792,44,836
公投第１２案,高雄市,林園區,王公里,1802,1299,405,343,748,12,760
公投第１２案,高雄市,林園區,王公里,1803,1170,423,236,659,32,691
公投第１２案,高雄市,林園區,林家里,1804,1299,358,254,612,24,636
公投第１２案,高雄市,林園區,龔厝里,1805,1031,369,205,574,22,596
公投第１２案,高雄市,林園區,龔厝里,1806,849,298,176,474,9,483
公投第１２案,高雄市,林園區,鳳芸里,1807,838,269,179,448,43,491
公投第１２案,高雄市,林園區,鳳芸里,1808,938,345,195,540,22,562
公投第１２案,高雄市,林園區,中芸里,1809,1051,371,184,555,20,575
公投第１２案,高雄市,林園區,中芸里,1810,786,271,190,461,25,486
公投第１２案,高雄市,林園區,東汕里,1811,894,332,187,519,43,562
公投第１２案,高雄市,林園區,西汕里,1812,749,197,119,316,22,338
公投第１２案,高雄市,林園區,仁愛里,1813,1485,535,337,872,29,901
公投第１２案,高雄市,林園區,仁愛里,1814,1478,515,339,854,58,912
公投第１２案,高雄市,林園區,文賢里,1815,1345,490,348,838,34,872
公投第１２案,高雄市,林園區,文賢里,1816,1038,337,212,549,26,575
公投第１２案,高雄市,林園區,廣應里,1817,1203,407,281,688,13,701
公投第１２案,高雄市,林園區,廣應里,1818,1138,391,249,640,21,661
公投第１２案,高雄市,林園區,廣應里,1819,1025,343,180,523,9,532
公投第１２案,高雄市,林園區,五福里,1820,1341,444,297,741,54,795
公投第１２案,高雄市,林園區,五福里,1821,1218,366,211,577,17,594
公投第１２案,高雄市,林園區,中汕里,1822,1147,331,212,543,12,555
公投第１２案,高雄市,林園區,中汕里,1823,1176,376,196,572,22,594
公投第１２案,新北市,石門區,德茂里,1,1121,290,266,556,32,588
公投第１２案,新北市,石門區,富基里,2,1389,374,263,637,37,674
公投第１２案,新北市,石門區,老梅里,3,933,282,149,431,57,488
公投第１２案,新北市,石門區,老梅里,4,1244,355,199,554,65,619
公投第１２案,新北市,石門區,山溪里,5,883,255,177,432,55,487
公投第１２案,新北市,石門區,石門里,6,1564,441,355,796,51,847
公投第１２案,新北市,石門區,尖鹿里,7,1500,446,310,756,43,799
公投第１２案,新北市,石門區,乾華里,8,328,73,67,140,11,151
公投第１２案,新北市,石門區,茂林里,9,651,232,138,370,33,403
公投第１２案,新北市,石門區,草里里,10,915,207,168,375,36,411
公投第１２案,新北市,三芝區,八賢里,11,312,88,48,136,15,151
公投第１２案,新北市,三芝區,埔頭里,12,1421,405,282,687,30,717
公投第１２案,新北市,三芝區,埔頭里,13,1557,445,316,761,41,802
公投第１２案,新北市,三芝區,埔頭里,14,1828,526,346,872,69,941
公投第１２案,新北市,三芝區,古庄里,15,1060,280,217,497,44,541
公投第１２案,新北市,三芝區,新庄里,16,819,189,135,324,33,357
公投第１２案,新北市,三芝區,埔坪里,17,1701,410,279,689,40,729
公投第１２案,新北市,三芝區,埔坪里,18,1740,442,345,787,53,840
公投第１２案,新北市,三芝區,埔坪里,19,1451,385,263,648,32,680
公投第１２案,新北市,三芝區,埔坪里,20,1248,328,196,524,52,576
公投第１２案,新北市,三芝區,茂長里,21,629,174,142,316,16,332
公投第１２案,新北市,三芝區,橫山里,22,504,139,77,216,18,234
公投第１２案,新北市,三芝區,錫板里,23,698,183,129,312,15,327
公投第１２案,新北市,三芝區,後厝里,24,2069,571,355,926,54,980
公投第１２案,新北市,三芝區,福德里,25,784,218,169,387,32,419
公投第１２案,新北市,三芝區,圓山里,26,522,120,123,243,23,266
公投第１２案,新北市,三芝區,店子里,27,587,162,99,261,47,308
公投第１２案,新北市,三芝區,興華里,28,1189,319,266,585,39,624
公投第１２案,新北市,淡水區,中和里,29,544,143,117,260,32,292
公投第１２案,新北市,淡水區,屯山里,30,1044,297,243,540,43,583
公投第１２案,新北市,淡水區,賢孝里,31,1462,395,316,711,43,754
公投第１２案,新北市,淡水區,興仁里,32,1525,419,317,736,62,798
公投第１２案,新北市,淡水區,蕃薯里,33,986,276,166,442,32,474
公投第１２案,新北市,淡水區,忠山里,34,806,250,190,440,21,461
公投第１２案,新北市,淡水區,義山里,35,1173,349,250,599,58,657
公投第１２案,新北市,淡水區,義山里,36,1343,380,240,620,27,647
公投第１２案,新北市,淡水區,水源里,37,1153,292,217,509,20,529
公投第１２案,新北市,淡水區,水源里,38,874,230,190,420,30,450
公投第１２案,新北市,淡水區,忠寮里,39,1063,304,222,526,64,590
公投第１２案,新北市,淡水區,樹興里,40,1309,404,222,626,36,662
公投第１２案,新北市,淡水區,坪頂里,41,1290,387,264,651,41,692
公投第１２案,新北市,淡水區,福德里,42,1675,552,376,928,27,955
公投第１２案,新北市,淡水區,福德里,43,1589,502,332,834,42,876
公投第１２案,新北市,淡水區,福德里,44,1624,519,394,913,32,945
公投第１２案,新北市,淡水區,福德里,45,1241,365,265,630,34,664
公投第１２案,新北市,淡水區,竹圍里,46,1317,427,263,690,36,726
公投第１２案,新北市,淡水區,竹圍里,47,1225,471,216,687,28,715
公投第１２案,新北市,淡水區,竹圍里,48,1426,467,294,761,30,791
公投第１２案,新北市,淡水區,竹圍里,49,1610,552,353,905,31,936
公投第１２案,新北市,淡水區,民權里,50,1982,702,364,1066,36,1102
公投第１２案,新北市,淡水區,民權里,51,1924,529,347,876,31,907
公投第１２案,新北市,淡水區,民生里,52,1822,512,380,892,28,920
公投第１２案,新北市,淡水區,民生里,53,1232,290,401,691,46,737
公投第１２案,新北市,淡水區,民生里,54,1588,518,341,859,51,910
公投第１２案,新北市,淡水區,民生里,55,1784,518,350,868,34,902
公投第１２案,新北市,淡水區,八勢里,56,1762,502,364,866,62,928
公投第１２案,新北市,淡水區,八勢里,57,1546,465,323,788,36,824
公投第１２案,新北市,淡水區,八勢里,58,1897,575,402,977,39,1016
公投第１２案,新北市,淡水區,竿蓁里,59,1489,465,302,767,33,800
公投第１２案,新北市,淡水區,竿蓁里,60,1679,527,312,839,26,865
公投第１２案,新北市,淡水區,竿蓁里,61,1693,478,335,813,34,847
公投第１２案,新北市,淡水區,竿蓁里,62,1674,521,306,827,17,844
公投第１２案,新北市,淡水區,竿蓁里,63,1330,432,277,709,19,728
公投第１２案,新北市,淡水區,竿蓁里,64,1467,455,292,747,22,769
公投第１２案,新北市,淡水區,崁頂里,65,1837,603,335,938,42,980
公投第１２案,新北市,淡水區,崁頂里,66,1924,400,234,634,17,651
公投第１２案,新北市,淡水區,崁頂里,67,2340,678,464,1142,36,1178
公投第１２案,新北市,淡水區,崁頂里,68,1704,485,283,768,35,803
公投第１２案,新北市,淡水區,崁頂里,69,1363,395,283,678,40,718
公投第１２案,新北市,淡水區,崁頂里,70,3068,784,600,1384,37,1421
公投第１２案,新北市,淡水區,埤島里,71,1528,447,289,736,33,769
公投第１２案,新北市,淡水區,水碓里,72,1600,448,336,784,45,829
公投第１２案,新北市,淡水區,水碓里,73,1874,616,391,1007,50,1057
公投第１２案,新北市,淡水區,水碓里,74,1567,466,319,785,50,835
公投第１２案,新北市,淡水區,北新里,75,1245,395,283,678,25,703
公投第１２案,新北市,淡水區,北新里,76,1211,348,267,615,18,633
公投第１２案,新北市,淡水區,正德里,77,1992,641,424,1065,45,1110
公投第１２案,新北市,淡水區,正德里,78,2028,679,415,1094,28,1122
公投第１２案,新北市,淡水區,新興里,79,1373,466,284,750,31,781
公投第１２案,新北市,淡水區,新興里,80,1732,534,371,905,34,939
公投第１２案,新北市,淡水區,新興里,81,1519,413,321,734,33,767
公投第１２案,新北市,淡水區,新興里,82,1727,507,320,827,21,848
公投第１２案,新北市,淡水區,新義里,83,1297,464,249,713,25,738
公投第１２案,新北市,淡水區,新義里,84,1066,298,235,533,41,574
公投第１２案,新北市,淡水區,新義里,85,1387,461,283,744,39,783
公投第１２案,新北市,淡水區,新春里,86,1909,620,381,1001,45,1046
公投第１２案,新北市,淡水區,新春里,87,1770,550,373,923,33,956
公投第１２案,新北市,淡水區,新春里,88,2049,628,388,1016,34,1050
公投第１２案,新北市,淡水區,新春里,89,1680,548,326,874,35,909
公投第１２案,新北市,淡水區,新民里,90,1433,469,337,806,42,848
公投第１２案,新北市,淡水區,新民里,91,1365,415,292,707,25,732
公投第１２案,新北市,淡水區,新民里,92,1452,457,317,774,40,814
公投第１２案,新北市,淡水區,北投里,93,1804,551,370,921,40,961
公投第１２案,新北市,淡水區,北投里,94,1322,422,270,692,40,732
公投第１２案,新北市,淡水區,北投里,95,2019,633,420,1053,26,1079
公投第１２案,新北市,淡水區,北投里,96,1696,594,365,959,42,1001
公投第１２案,新北市,淡水區,北投里,97,1576,519,335,854,29,883
公投第１２案,新北市,淡水區,鄧公里,98,1781,552,391,943,54,997
公投第１２案,新北市,淡水區,鄧公里,99,1665,531,382,913,54,967
公投第１２案,新北市,淡水區,鄧公里,100,2013,522,414,936,43,979
公投第１２案,新北市,淡水區,幸福里,101,1108,329,245,574,23,597
公投第１２案,新北市,淡水區,幸福里,102,1305,411,281,692,36,728
公投第１２案,新北市,淡水區,幸福里,103,1199,391,250,641,20,661
公投第１２案,新北市,淡水區,學府里,104,2017,619,414,1033,38,1071
公投第１２案,新北市,淡水區,學府里,105,2125,570,441,1011,34,1045
公投第１２案,新北市,淡水區,中興里,106,1289,358,231,589,26,615
公投第１２案,新北市,淡水區,中興里,107,1319,402,346,748,39,787
公投第１２案,新北市,淡水區,中興里,108,1051,369,223,592,26,618
公投第１２案,新北市,淡水區,長庚里,109,1348,435,276,711,31,742
公投第１２案,新北市,淡水區,清文里,110,1106,333,239,572,34,606
公投第１２案,新北市,淡水區,草東里,111,717,242,149,391,29,420
公投第１２案,新北市,淡水區,協元里,112,1385,412,316,728,23,751
公投第１２案,新北市,淡水區,永吉里,113,841,274,199,473,33,506
公投第１２案,新北市,淡水區,民安里,114,665,214,151,365,23,388
公投第１２案,新北市,淡水區,新生里,115,419,135,107,242,10,252
公投第１２案,新北市,淡水區,文化里,116,1599,542,331,873,27,900
公投第１２案,新北市,淡水區,油車里,117,1670,487,336,823,57,880
公投第１２案,新北市,淡水區,油車里,118,1683,595,319,914,44,958
公投第１２案,新北市,淡水區,油車里,119,1577,455,314,769,41,810
公投第１２案,新北市,淡水區,沙崙里,120,1618,454,329,783,35,818
公投第１２案,新北市,淡水區,沙崙里,121,2214,650,365,1015,36,1051
公投第１２案,新北市,淡水區,大庄里,122,1832,553,365,918,38,956
公投第１２案,新北市,淡水區,大庄里,123,2123,659,418,1077,46,1123
公投第１２案,新北市,淡水區,大庄里,124,2998,822,446,1268,27,1295
公投第１２案,新北市,八里區,龍源里,125,1498,408,302,710,43,753
公投第１２案,新北市,八里區,龍源里,126,1939,546,325,871,27,898
公投第１２案,新北市,八里區,龍源里,127,1516,490,288,778,29,807
公投第１２案,新北市,八里區,龍源里,128,1642,552,336,888,54,942
公投第１２案,新北市,八里區,米倉里,129,1927,502,384,886,58,944
公投第１２案,新北市,八里區,米倉里,130,1276,406,246,652,40,692
公投第１２案,新北市,八里區,大崁里,131,1349,442,310,752,41,793
公投第１２案,新北市,八里區,大崁里,132,1403,451,303,754,36,790
公投第１２案,新北市,八里區,埤頭里,133,1644,502,346,848,41,889
公投第１２案,新北市,八里區,埤頭里,134,1853,550,402,952,53,1005
公投第１２案,新北市,八里區,頂罟里,135,1793,587,409,996,53,1049
公投第１２案,新北市,八里區,舊城里,136,1644,487,358,845,40,885
公投第１２案,新北市,八里區,舊城里,137,1846,535,388,923,43,966
公投第１２案,新北市,八里區,舊城里,138,1346,383,295,678,44,722
公投第１２案,新北市,八里區,舊城里,139,1621,479,356,835,40,875
公投第１２案,新北市,八里區,訊塘里,140,2110,541,345,886,56,942
公投第１２案,新北市,八里區,訊塘里,141,1967,412,540,952,57,1009
公投第１２案,新北市,八里區,荖阡里,142,1626,477,365,842,55,897
公投第１２案,新北市,八里區,長坑里,143,1514,417,350,767,67,834
公投第１２案,新北市,八里區,下罟里,144,1456,432,330,762,75,837
公投第１２案,新北市,林口區,東林里,145,1268,383,289,672,13,685
公投第１２案,新北市,林口區,東林里,146,1171,314,254,568,39,607
公投第１２案,新北市,林口區,東林里,147,1218,373,273,646,45,691
公投第１２案,新北市,林口區,林口里,148,1788,494,382,876,44,920
公投第１２案,新北市,林口區,林口里,149,1625,449,366,815,47,862
公投第１２案,新北市,林口區,林口里,150,1448,383,309,692,67,759
公投第１２案,新北市,林口區,西林里,151,1328,384,248,632,54,686
公投第１２案,新北市,林口區,西林里,152,1523,392,270,662,45,707
公投第１２案,新北市,林口區,西林里,153,1245,395,256,651,34,685
公投第１２案,新北市,林口區,西林里,154,1329,499,301,800,28,828
公投第１２案,新北市,林口區,西林里,155,1465,496,322,818,39,857
公投第１２案,新北市,林口區,西林里,156,1369,450,334,784,23,807
公投第１２案,新北市,林口區,菁湖里,157,1346,432,311,743,47,790
公投第１２案,新北市,林口區,菁湖里,158,1181,356,241,597,53,650
公投第１２案,新北市,林口區,菁湖里,159,1291,449,323,772,30,802
公投第１２案,新北市,林口區,中湖里,160,1213,379,254,633,42,675
公投第１２案,新北市,林口區,中湖里,161,1256,430,279,709,27,736
公投第１２案,新北市,林口區,中湖里,162,1185,333,281,614,36,650
公投第１２案,新北市,林口區,湖北里,163,1361,421,298,719,43,762
公投第１２案,新北市,林口區,湖南里,164,1756,524,347,871,31,902
公投第１２案,新北市,林口區,湖南里,165,1676,488,349,837,30,867
公投第１２案,新北市,林口區,湖南里,166,1540,539,314,853,23,876
公投第１２案,新北市,林口區,湖南里,167,1569,482,331,813,38,851
公投第１２案,新北市,林口區,湖南里,168,1514,527,277,804,33,837
公投第１２案,新北市,林口區,湖南里,169,1193,381,289,670,22,692
公投第１２案,新北市,林口區,湖南里,170,1610,574,354,928,18,946
公投第１２案,新北市,林口區,湖南里,171,1338,463,285,748,29,777
公投第１２案,新北市,林口區,湖南里,172,1141,392,243,635,27,662
公投第１２案,新北市,林口區,湖南里,173,1307,419,287,706,34,740
公投第１２案,新北市,林口區,湖南里,174,1327,456,286,742,22,764
公投第１２案,新北市,林口區,湖南里,175,1285,417,300,717,25,742
公投第１２案,新北市,林口區,南勢里,176,1481,456,349,805,38,843
公投第１２案,新北市,林口區,南勢里,177,1510,483,359,842,24,866
公投第１２案,新北市,林口區,南勢里,178,1785,558,361,919,34,953
公投第１２案,新北市,林口區,南勢里,179,1792,593,358,951,25,976
公投第１２案,新北市,林口區,南勢里,180,1517,518,318,836,25,861
公投第１２案,新北市,林口區,南勢里,181,1564,544,332,876,20,896
公投第１２案,新北市,林口區,南勢里,182,1560,549,313,862,31,893
公投第１２案,新北市,林口區,南勢里,183,1544,482,325,807,32,839
公投第１２案,新北市,林口區,南勢里,184,1593,502,336,838,23,861
公投第１２案,新北市,林口區,南勢里,185,1431,491,287,778,26,804
公投第１２案,新北市,林口區,仁愛里,186,1571,490,320,810,33,843
公投第１２案,新北市,林口區,仁愛里,187,1439,459,349,808,23,831
公投第１２案,新北市,林口區,仁愛里,188,1451,478,329,807,34,841
公投第１２案,新北市,林口區,仁愛里,189,1391,457,355,812,29,841
公投第１２案,新北市,林口區,麗林里,190,1461,464,314,778,37,815
公投第１２案,新北市,林口區,麗林里,191,1691,515,382,897,22,919
公投第１２案,新北市,林口區,麗林里,192,1524,538,273,811,38,849
公投第１２案,新北市,林口區,麗林里,193,1343,497,316,813,27,840
公投第１２案,新北市,林口區,麗林里,194,1398,477,333,810,30,840
公投第１２案,新北市,林口區,東勢里,195,1380,488,298,786,29,815
公投第１２案,新北市,林口區,東勢里,196,1367,428,296,724,47,771
公投第１２案,新北市,林口區,東勢里,197,1350,428,313,741,37,778
公投第１２案,新北市,林口區,東勢里,198,1194,398,273,671,33,704
公投第１２案,新北市,林口區,麗園里,199,1344,398,290,688,49,737
公投第１２案,新北市,林口區,麗園里,200,1154,363,260,623,31,654
公投第１２案,新北市,林口區,麗園里,201,1119,389,283,672,25,697
公投第１２案,新北市,林口區,頂福里,202,1026,264,207,471,34,505
公投第１２案,新北市,林口區,下福里,203,1210,339,280,619,58,677
公投第１２案,新北市,林口區,嘉寶里,204,912,256,198,454,63,517
公投第１２案,新北市,林口區,瑞平里,205,824,230,221,451,32,483
公投第１２案,新北市,林口區,太平里,206,1411,440,324,764,69,833
公投第１２案,新北市,五股區,興珍里,207,1456,417,321,738,63,801
公投第１２案,新北市,五股區,興珍里,208,1482,438,302,740,46,786
公投第１２案,新北市,五股區,興珍里,209,1287,394,288,682,45,727
公投第１２案,新北市,五股區,更寮里,210,1106,311,251,562,25,587
公投第１２案,新北市,五股區,觀音里,211,1283,375,249,624,55,679
公投第１２案,新北市,五股區,集福里,212,1833,545,399,944,37,981
公投第１２案,新北市,五股區,集福里,213,1141,339,285,624,33,657
公投第１２案,新北市,五股區,集福里,214,463,140,109,249,36,285
公投第１２案,新北市,五股區,集賢里,215,1786,556,374,930,49,979
公投第１２案,新北市,五股區,集賢里,216,1660,438,382,820,41,861
公投第１２案,新北市,五股區,成德里,217,1534,462,327,789,57,846
公投第１２案,新北市,五股區,成德里,218,1285,437,263,700,44,744
公投第１２案,新北市,五股區,成州里,219,1832,551,343,894,79,973
公投第１２案,新北市,五股區,成州里,220,1542,460,327,787,42,829
公投第１２案,新北市,五股區,成州里,221,1897,503,354,857,40,897
公投第１２案,新北市,五股區,成功里,222,1964,537,352,889,74,963
公投第１２案,新北市,五股區,成功里,223,1779,472,358,830,55,885
公投第１２案,新北市,五股區,成功里,224,1735,503,341,844,70,914
公投第１２案,新北市,五股區,成泰里,225,2299,620,467,1087,40,1127
公投第１２案,新北市,五股區,成泰里,226,1755,534,291,825,44,869
公投第１２案,新北市,五股區,成泰里,227,1674,540,334,874,46,920
公投第１２案,新北市,五股區,成泰里,228,1661,536,335,871,50,921
公投第１２案,新北市,五股區,五龍里,229,1281,337,266,603,35,638
公投第１２案,新北市,五股區,五福里,230,1566,503,309,812,39,851
公投第１２案,新北市,五股區,五福里,231,1560,493,270,763,27,790
公投第１２案,新北市,五股區,六福里,232,1622,542,309,851,35,886
公投第１２案,新北市,五股區,六福里,233,1779,576,357,933,31,964
公投第１２案,新北市,五股區,民義里,234,1487,480,261,741,44,785
公投第１２案,新北市,五股區,民義里,235,1567,490,333,823,37,860
公投第１２案,新北市,五股區,五股里,236,1333,301,210,511,27,538
公投第１２案,新北市,五股區,五股里,237,1263,443,282,725,37,762
公投第１２案,新北市,五股區,五股里,238,1314,449,268,717,46,763
公投第１２案,新北市,五股區,德音里,239,1513,455,304,759,32,791
公投第１２案,新北市,五股區,德音里,240,1517,526,304,830,32,862
公投第１２案,新北市,五股區,德音里,241,1613,492,326,818,57,875
公投第１２案,新北市,五股區,水碓里,242,1616,488,337,825,49,874
公投第１２案,新北市,五股區,水碓里,243,1616,445,364,809,58,867
公投第１２案,新北市,五股區,水碓里,244,1689,532,333,865,54,919
公投第１２案,新北市,五股區,水碓里,245,1894,549,403,952,32,984
公投第１２案,新北市,五股區,福德里,246,1210,437,286,723,40,763
公投第１２案,新北市,五股區,福德里,247,1643,497,327,824,29,853
公投第１２案,新北市,五股區,德泰里,248,1441,439,304,743,28,771
公投第１２案,新北市,五股區,德泰里,249,1305,459,272,731,22,753
公投第１２案,新北市,五股區,德泰里,250,1170,404,281,685,38,723
公投第１２案,新北市,五股區,貿商里,251,1397,489,298,787,67,854
公投第１２案,新北市,五股區,貿商里,252,1312,505,251,756,55,811
公投第１２案,新北市,五股區,陸一里,253,1127,381,168,549,23,572
公投第１２案,新北市,五股區,陸一里,254,1154,390,190,580,22,602
公投第１２案,新北市,泰山區,大科里,255,643,179,123,302,23,325
公投第１２案,新北市,泰山區,大科里,256,186,70,41,111,4,115
公投第１２案,新北市,泰山區,黎明里,257,1457,425,288,713,28,741
公投第１２案,新北市,泰山區,黎明里,258,1594,529,312,841,50,891
公投第１２案,新北市,泰山區,山腳里,259,1598,482,293,775,33,808
公投第１２案,新北市,泰山區,山腳里,260,1503,429,324,753,21,774
公投第１２案,新北市,泰山區,山腳里,261,1436,422,263,685,63,748
公投第１２案,新北市,泰山區,山腳里,262,1384,427,297,724,44,768
公投第１２案,新北市,泰山區,福泰里,263,1231,425,240,665,37,702
公投第１２案,新北市,泰山區,福泰里,264,1295,410,242,652,32,684
公投第１２案,新北市,泰山區,福興里,265,1563,502,356,858,41,899
公投第１２案,新北市,泰山區,福興里,266,1610,533,352,885,48,933
公投第１２案,新北市,泰山區,楓樹里,267,1253,375,271,646,30,676
公投第１２案,新北市,泰山區,楓樹里,268,1294,388,250,638,29,667
公投第１２案,新北市,泰山區,楓樹里,269,1354,408,334,742,48,790
公投第１２案,新北市,泰山區,同榮里,270,1259,389,276,665,31,696
公投第１２案,新北市,泰山區,同榮里,271,1252,399,298,697,22,719
公投第１２案,新北市,泰山區,同榮里,272,1094,353,220,573,24,597
公投第１２案,新北市,泰山區,同興里,273,1590,527,337,864,30,894
公投第１２案,新北市,泰山區,同興里,274,1634,497,369,866,49,915
公投第１２案,新北市,泰山區,全興里,275,1536,418,284,702,27,729
公投第１２案,新北市,泰山區,全興里,276,1534,522,337,859,24,883
公投第１２案,新北市,泰山區,全興里,277,1545,576,333,909,43,952
公投第１２案,新北市,泰山區,全興里,278,1399,449,298,747,36,783
公投第１２案,新北市,泰山區,全興里,279,1315,434,258,692,22,714
公投第１２案,新北市,泰山區,義學里,280,1201,415,283,698,38,736
公投第１２案,新北市,泰山區,義學里,281,1182,358,263,621,43,664
公投第１２案,新北市,泰山區,義學里,282,1665,491,337,828,58,886
公投第１２案,新北市,泰山區,義仁里,283,1855,587,373,960,49,1009
公投第１２案,新北市,泰山區,義仁里,284,1866,605,367,972,59,1031
公投第１２案,新北市,泰山區,義仁里,285,1935,591,398,989,45,1034
公投第１２案,新北市,泰山區,義仁里,286,1589,490,304,794,26,820
公投第１２案,新北市,泰山區,明志里,287,1152,362,239,601,27,628
公投第１２案,新北市,泰山區,明志里,288,1114,341,257,598,29,627
公投第１２案,新北市,泰山區,明志里,289,1040,388,235,623,26,649
公投第１２案,新北市,泰山區,泰友里,290,1003,338,237,575,28,603
公投第１２案,新北市,泰山區,泰友里,291,975,301,271,572,23,595
公投第１２案,新北市,泰山區,新明里,292,1440,440,299,739,48,787
公投第１２案,新北市,泰山區,新明里,293,1480,490,300,790,7,797
公投第１２案,新北市,泰山區,貴子里,294,1211,409,252,661,28,689
公投第１２案,新北市,泰山區,貴子里,295,1237,439,246,685,24,709
公投第１２案,新北市,泰山區,貴子里,296,1069,359,221,580,27,607
公投第１２案,新北市,泰山區,貴賢里,297,1680,538,407,945,50,995
公投第１２案,新北市,泰山區,貴賢里,298,1651,533,377,910,31,941
公投第１２案,新北市,泰山區,貴和里,299,1420,432,282,714,28,742
公投第１２案,新北市,泰山區,貴和里,300,1337,427,324,751,36,787
公投第１２案,新北市,泰山區,貴和里,301,1591,521,345,866,33,899
公投第１２案,新北市,新莊區,海山里,302,1123,359,268,627,37,664
公投第１２案,新北市,新莊區,海山里,303,1278,416,329,745,42,787
公投第１２案,新北市,新莊區,海山里,304,1163,432,262,694,46,740
公投第１２案,新北市,新莊區,海山里,305,1228,422,302,724,33,757
公投第１２案,新北市,新莊區,全安里,306,1211,409,261,670,45,715
公投第１２案,新北市,新莊區,全安里,307,1176,406,264,670,39,709
公投第１２案,新北市,新莊區,全安里,308,1536,537,356,893,39,932
公投第１２案,新北市,新莊區,全泰里,309,1486,536,351,887,45,932
公投第１２案,新北市,新莊區,全泰里,310,1513,535,380,915,58,973
公投第１２案,新北市,新莊區,全泰里,311,1395,497,345,842,48,890
公投第１２案,新北市,新莊區,忠孝里,312,1353,423,303,726,42,768
公投第１２案,新北市,新莊區,忠孝里,313,1409,496,329,825,53,878
公投第１２案,新北市,新莊區,忠孝里,314,1478,484,316,800,25,825
公投第１２案,新北市,新莊區,文衡里,315,921,333,212,545,33,578
公投第１２案,新北市,新莊區,文衡里,316,971,330,245,575,33,608
公投第１２案,新北市,新莊區,文聖里,317,1534,546,374,920,44,964
公投第１２案,新北市,新莊區,文聖里,318,1516,504,303,807,38,845
公投第１２案,新北市,新莊區,興漢里,319,697,214,166,380,30,410
公投第１２案,新北市,新莊區,興漢里,320,1235,406,290,696,27,723
公投第１２案,新北市,新莊區,興漢里,321,1138,375,253,628,31,659
公投第１２案,新北市,新莊區,榮和里,322,1063,342,198,540,20,560
公投第１２案,新北市,新莊區,榮和里,323,3399,444,365,809,37,846
公投第１２案,新北市,新莊區,文德里,324,1575,531,347,878,58,936
公投第１２案,新北市,新莊區,文明里,325,1615,525,426,951,56,1007
公投第１２案,新北市,新莊區,化成里,326,1612,466,332,798,53,851
公投第１２案,新北市,新莊區,化成里,327,1514,496,305,801,48,849
公投第１２案,新北市,新莊區,頭前里,328,1382,400,283,683,40,723
公投第１２案,新北市,新莊區,頭前里,329,1475,445,346,791,36,827
公投第１２案,新北市,新莊區,頭前里,330,1462,465,356,821,25,846
公投第１２案,新北市,新莊區,頭前里,331,1426,429,337,766,28,794
公投第１２案,新北市,新莊區,頭前里,332,1421,432,322,754,37,791
公投第１２案,新北市,新莊區,福基里,333,1536,438,383,821,45,866
公投第１２案,新北市,新莊區,福基里,334,1587,500,384,884,36,920
公投第１２案,新北市,新莊區,福基里,335,749,225,171,396,12,408
公投第１２案,新北市,新莊區,福興里,336,1276,428,301,729,38,767
公投第１２案,新北市,新莊區,福興里,337,1303,431,275,706,29,735
公投第１２案,新北市,新莊區,福興里,338,1259,422,304,726,48,774
公投第１２案,新北市,新莊區,福興里,339,1291,437,308,745,37,782
公投第１２案,新北市,新莊區,昌平里,340,1493,494,350,844,20,864
公投第１２案,新北市,新莊區,昌平里,341,1507,478,358,836,42,878
公投第１２案,新北市,新莊區,昌平里,342,1456,474,351,825,12,837
公投第１２案,新北市,新莊區,昌平里,343,1396,468,314,782,21,803
公投第１２案,新北市,新莊區,和平里,344,1351,398,275,673,44,717
公投第１２案,新北市,新莊區,和平里,345,1403,451,296,747,53,800
公投第１２案,新北市,新莊區,和平里,346,1497,461,336,797,41,838
公投第１２案,新北市,新莊區,幸福里,347,1272,449,277,726,48,774
公投第１２案,新北市,新莊區,幸福里,348,1269,400,230,630,30,660
公投第１２案,新北市,新莊區,幸福里,349,1335,440,306,746,51,797
公投第１２案,新北市,新莊區,昌隆里,350,1300,426,345,771,24,795
公投第１２案,新北市,新莊區,昌隆里,351,1286,440,296,736,13,749
公投第１２案,新北市,新莊區,昌隆里,352,1255,470,320,790,38,828
公投第１２案,新北市,新莊區,信義里,353,1558,484,349,833,60,893
公投第１２案,新北市,新莊區,信義里,354,1567,512,311,823,44,867
公投第１２案,新北市,新莊區,信義里,355,1603,559,342,901,48,949
公投第１２案,新北市,新莊區,昌信里,356,1538,507,352,859,15,874
公投第１２案,新北市,新莊區,昌信里,357,1671,531,405,936,30,966
公投第１２案,新北市,新莊區,昌明里,358,1698,521,368,889,30,919
公投第１２案,新北市,新莊區,昌明里,359,1545,521,383,904,37,941
公投第１２案,新北市,新莊區,仁義里,360,1696,558,421,979,57,1036
公投第１２案,新北市,新莊區,仁義里,361,1626,519,305,824,66,890
公投第１２案,新北市,新莊區,仁愛里,362,1170,301,281,582,53,635
公投第１２案,新北市,新莊區,仁愛里,363,1236,399,263,662,59,721
公投第１２案,新北市,新莊區,自信里,364,1071,344,216,560,43,603
公投第１２案,新北市,新莊區,自信里,365,1129,350,269,619,29,648
公投第１２案,新北市,新莊區,自立里,366,1586,599,364,963,26,989
公投第１２案,新北市,新莊區,自立里,367,1597,497,303,800,33,833
公投第１２案,新北市,新莊區,自立里,368,1573,449,299,748,80,828
公投第１２案,新北市,新莊區,自強里,369,1225,443,237,680,29,709
公投第１２案,新北市,新莊區,自強里,370,1217,408,214,622,28,650
公投第１２案,新北市,新莊區,思源里,371,1571,501,334,835,48,883
公投第１２案,新北市,新莊區,思源里,372,1594,468,349,817,44,861
公投第１２案,新北市,新莊區,思源里,373,1583,471,348,819,54,873
公投第１２案,新北市,新莊區,思賢里,374,1245,348,292,640,43,683
公投第１２案,新北市,新莊區,思賢里,375,1203,432,269,701,29,730
公投第１２案,新北市,新莊區,思賢里,376,1265,462,302,764,35,799
公投第１２案,新北市,新莊區,中華里,377,1255,411,305,716,43,759
公投第１２案,新北市,新莊區,中華里,378,1287,454,269,723,33,756
公投第１２案,新北市,新莊區,中美里,379,1167,378,309,687,46,733
公投第１２案,新北市,新莊區,中美里,380,1299,420,287,707,44,751
公投第１２案,新北市,新莊區,中美里,381,1207,399,274,673,33,706
公投第１２案,新北市,新莊區,中美里,382,1415,722,76,798,33,831
公投第１２案,新北市,新莊區,恆安里,383,1342,441,292,733,53,786
公投第１２案,新北市,新莊區,恆安里,384,1341,822,311,1133,48,1181
公投第１２案,新北市,新莊區,恆安里,385,1247,377,287,664,51,715
公投第１２案,新北市,新莊區,立人里,386,984,433,206,639,16,655
公投第１２案,新北市,新莊區,立人里,387,1043,339,259,598,43,641
公投第１２案,新北市,新莊區,立德里,388,1135,451,274,725,31,756
公投第１２案,新北市,新莊區,立德里,389,1185,390,284,674,33,707
公投第１２案,新北市,新莊區,中和里,390,1346,455,302,757,35,792
公投第１２案,新北市,新莊區,中和里,391,1372,466,295,761,57,818
公投第１２案,新北市,新莊區,中和里,392,1350,481,302,783,52,835
公投第１２案,新北市,新莊區,中泰里,393,1307,400,286,686,46,732
公投第１２案,新北市,新莊區,中泰里,394,1353,487,254,741,45,786
公投第１２案,新北市,新莊區,中泰里,395,1287,427,296,723,44,767
公投第１２案,新北市,新莊區,中宏里,396,1567,476,266,742,25,767
公投第１２案,新北市,新莊區,中宏里,397,1709,578,396,974,48,1022
公投第１２案,新北市,新莊區,中全里,398,1616,487,344,831,30,861
公投第１２案,新北市,新莊區,中全里,399,1628,468,347,815,46,861
公投第１２案,新北市,新莊區,立志里,400,1148,406,259,665,44,709
公投第１２案,新北市,新莊區,立志里,401,1201,431,260,691,7,698
公投第１２案,新北市,新莊區,立志里,402,1135,418,280,698,36,734
公投第１２案,新北市,新莊區,立廷里,403,1495,512,375,887,39,926
公投第１２案,新北市,新莊區,立廷里,404,1486,484,374,858,51,909
公投第１２案,新北市,新莊區,立廷里,405,1483,519,352,871,31,902
公投第１２案,新北市,新莊區,立廷里,406,1553,493,327,820,37,857
公投第１２案,新北市,新莊區,立廷里,407,1625,573,409,982,21,1003
公投第１２案,新北市,新莊區,立廷里,408,1671,552,373,925,32,957
公投第１２案,新北市,新莊區,立基里,409,1389,487,340,827,45,872
公投第１２案,新北市,新莊區,立基里,410,1272,418,299,717,33,750
公投第１２案,新北市,新莊區,立基里,411,1409,449,369,818,32,850
公投第１２案,新北市,新莊區,立基里,412,1372,485,335,820,34,854
公投第１２案,新北市,新莊區,中誠里,413,955,334,204,538,23,561
公投第１２案,新北市,新莊區,中誠里,414,952,302,195,497,44,541
公投第１２案,新北市,新莊區,中港里,415,1412,478,320,798,21,819
公投第１２案,新北市,新莊區,中港里,416,1415,477,311,788,39,827
公投第１２案,新北市,新莊區,中港里,417,1421,508,300,808,47,855
公投第１２案,新北市,新莊區,中港里,418,1293,479,295,774,36,810
公投第１２案,新北市,新莊區,中信里,419,1475,444,328,772,33,805
公投第１２案,新北市,新莊區,中信里,420,1429,453,332,785,38,823
公投第１２案,新北市,新莊區,中信里,421,1481,465,336,801,45,846
公投第１２案,新北市,新莊區,中信里,422,1472,501,339,840,50,890
公投第１２案,新北市,新莊區,中信里,423,1474,471,372,843,28,871
公投第１２案,新北市,新莊區,中平里,424,1462,492,358,850,25,875
公投第１２案,新北市,新莊區,中平里,425,1484,513,353,866,21,887
公投第１２案,新北市,新莊區,中平里,426,1461,503,306,809,36,845
公投第１２案,新北市,新莊區,中平里,427,1444,488,339,827,31,858
公投第１２案,新北市,新莊區,中平里,428,1437,504,327,831,27,858
公投第１２案,新北市,新莊區,中原里,429,1641,467,324,791,38,829
公投第１２案,新北市,新莊區,中原里,430,1633,503,340,843,34,877
公投第１２案,新北市,新莊區,中原里,431,1531,513,352,865,18,883
公投第１２案,新北市,新莊區,中原里,432,1517,517,355,872,35,907
公投第１２案,新北市,新莊區,中原里,433,1487,470,319,789,40,829
公投第１２案,新北市,新莊區,中原里,434,1560,523,335,858,32,890
公投第１２案,新北市,新莊區,中隆里,435,1584,485,371,856,39,895
公投第１２案,新北市,新莊區,中隆里,436,1602,509,346,855,18,873
公投第１２案,新北市,新莊區,中隆里,437,818,269,186,455,30,485
公投第１２案,新北市,新莊區,立功里,438,1633,482,306,788,34,822
公投第１２案,新北市,新莊區,立功里,439,1652,506,358,864,37,901
公投第１２案,新北市,新莊區,立泰里,440,1498,480,311,791,35,826
公投第１２案,新北市,新莊區,立泰里,441,1379,411,320,731,41,772
公投第１２案,新北市,新莊區,立泰里,442,1381,464,317,781,42,823
公投第１２案,新北市,新莊區,立言里,443,1535,522,344,866,54,920
公投第１２案,新北市,新莊區,立言里,444,1492,528,367,895,48,943
公投第１２案,新北市,新莊區,立言里,445,1450,513,354,867,49,916
公投第１２案,新北市,新莊區,豐年里,446,1107,367,255,622,37,659
公投第１２案,新北市,新莊區,豐年里,447,1063,203,233,436,44,480
公投第１２案,新北市,新莊區,豐年里,448,1143,412,250,662,34,696
公投第１２案,新北市,新莊區,國泰里,449,1341,405,293,698,59,757
公投第１２案,新北市,新莊區,泰豐里,450,1063,368,227,595,29,624
公投第１２案,新北市,新莊區,泰豐里,451,1096,369,249,618,34,652
公投第１２案,新北市,新莊區,瓊林里,452,1309,417,301,718,33,751
公投第１２案,新北市,新莊區,瓊林里,453,1216,521,176,697,40,737
公投第１２案,新北市,新莊區,瓊林里,454,1278,379,287,666,26,692
公投第１２案,新北市,新莊區,瓊林里,455,1352,415,320,735,49,784
公投第１２案,新北市,新莊區,福營里,456,1298,377,256,633,46,679
公投第１２案,新北市,新莊區,福營里,457,1042,343,233,576,37,613
公投第１２案,新北市,新莊區,營盤里,458,881,249,193,442,27,469
公投第１２案,新北市,新莊區,營盤里,459,1109,363,312,675,43,718
公投第１２案,新北市,新莊區,丹鳳里,460,1291,375,295,670,51,721
公投第１２案,新北市,新莊區,丹鳳里,461,1293,413,269,682,23,705
公投第１２案,新北市,新莊區,丹鳳里,462,1336,429,319,748,40,788
公投第１２案,新北市,新莊區,丹鳳里,463,1384,425,287,712,34,746
公投第１２案,新北市,新莊區,丹鳳里,464,1231,358,255,613,25,638
公投第１２案,新北市,新莊區,丹鳳里,465,940,271,223,494,30,524
公投第１２案,新北市,新莊區,合鳳里,466,1369,407,292,699,69,768
公投第１２案,新北市,新莊區,合鳳里,467,1384,449,281,730,53,783
公投第１２案,新北市,新莊區,合鳳里,468,1272,414,293,707,49,756
公投第１２案,新北市,新莊區,祥鳳里,469,1073,370,237,607,32,639
公投第１２案,新北市,新莊區,祥鳳里,470,1058,335,238,573,30,603
公投第１２案,新北市,新莊區,雙鳳里,471,1528,477,355,832,18,850
公投第１２案,新北市,新莊區,雙鳳里,472,1244,389,250,639,42,681
公投第１２案,新北市,新莊區,雙鳳里,473,1356,452,238,690,35,725
公投第１２案,新北市,新莊區,雙鳳里,474,1164,370,219,589,19,608
公投第１２案,新北市,新莊區,雙鳳里,475,1423,475,324,799,40,839
公投第１２案,新北市,新莊區,雙鳳里,476,1250,440,306,746,31,777
公投第１２案,新北市,新莊區,雙鳳里,477,1252,385,280,665,26,691
公投第１２案,新北市,新莊區,龍福里,478,1022,320,222,542,17,559
公投第１２案,新北市,新莊區,龍福里,479,959,301,235,536,33,569
公投第１２案,新北市,新莊區,龍鳳里,480,1646,526,400,926,33,959
公投第１２案,新北市,新莊區,龍鳳里,481,1551,454,348,802,56,858
公投第１２案,新北市,新莊區,龍鳳里,482,1526,505,368,873,36,909
公投第１２案,新北市,新莊區,龍鳳里,483,1518,475,374,849,22,871
公投第１２案,新北市,新莊區,龍鳳里,484,1547,482,377,859,36,895
公投第１２案,新北市,新莊區,裕民里,485,1505,489,292,781,46,827
公投第１２案,新北市,新莊區,裕民里,486,1527,473,308,781,47,828
公投第１２案,新北市,新莊區,裕民里,487,1482,426,316,742,38,780
公投第１２案,新北市,新莊區,裕民里,488,1586,443,325,768,60,828
公投第１２案,新北市,新莊區,龍安里,489,1065,330,228,558,63,621
公投第１２案,新北市,新莊區,龍安里,490,1040,381,258,639,35,674
公投第１２案,新北市,新莊區,富國里,491,1090,323,246,569,41,610
公投第１２案,新北市,新莊區,富國里,492,1071,339,247,586,38,624
公投第１２案,新北市,新莊區,富民里,493,1704,489,357,846,37,883
公投第１２案,新北市,新莊區,富民里,494,1698,488,345,833,26,859
公投第１２案,新北市,新莊區,後德里,495,1362,455,348,803,48,851
公投第１２案,新北市,新莊區,後德里,496,1350,449,332,781,33,814
公投第１２案,新北市,新莊區,萬安里,497,1689,541,363,904,65,969
公投第１２案,新北市,新莊區,萬安里,498,1612,486,383,869,67,936
公投第１２案,新北市,新莊區,建福里,499,1130,401,248,649,38,687
公投第１２案,新北市,新莊區,建福里,500,1111,485,178,663,40,703
公投第１２案,新北市,新莊區,後港里,501,1539,456,346,802,35,837
公投第１２案,新北市,新莊區,後港里,502,1586,503,358,861,29,890
公投第１２案,新北市,新莊區,後港里,503,1631,519,376,895,38,933
公投第１２案,新北市,新莊區,後港里,504,1540,478,359,837,38,875
公投第１２案,新北市,新莊區,四維里,505,1388,377,296,673,40,713
公投第１２案,新北市,新莊區,四維里,506,1388,379,275,654,62,716
公投第１２案,新北市,新莊區,四維里,507,1387,385,271,656,47,703
公投第１２案,新北市,新莊區,南港里,508,1181,364,243,607,33,640
公投第１２案,新北市,新莊區,南港里,509,1135,341,281,622,42,664
公投第１２案,新北市,新莊區,南港里,510,1173,338,306,644,29,673
公投第１２案,新北市,新莊區,南港里,511,1215,362,309,671,33,704
公投第１２案,新北市,新莊區,建安里,512,1488,493,334,827,52,879
公投第１２案,新北市,新莊區,建安里,513,1444,437,345,782,43,825
公投第１２案,新北市,新莊區,建安里,514,1499,488,318,806,32,838
公投第１２案,新北市,新莊區,建安里,515,1449,419,346,765,26,791
公投第１２案,新北市,新莊區,民全里,516,1640,491,387,878,55,933
公投第１２案,新北市,新莊區,民全里,517,1648,490,371,861,49,910
公投第１２案,新北市,新莊區,八德里,518,1371,405,270,675,47,722
公投第１２案,新北市,新莊區,八德里,519,1400,406,325,731,42,773
公投第１２案,新北市,新莊區,成德里,520,1457,429,320,749,66,815
公投第１２案,新北市,新莊區,成德里,521,1502,433,340,773,52,825
公投第１２案,新北市,新莊區,成德里,522,1412,419,304,723,63,786
公投第１２案,新北市,新莊區,民安里,523,1318,393,301,694,45,739
公投第１２案,新北市,新莊區,民安里,524,1411,462,365,827,33,860
公投第１２案,新北市,新莊區,民安里,525,1262,424,292,716,20,736
公投第１２案,新北市,新莊區,民安里,526,1228,407,310,717,28,745
公投第１２案,新北市,新莊區,民有里,527,1748,548,434,982,42,1024
公投第１２案,新北市,新莊區,民有里,528,1761,581,386,967,60,1027
公投第１２案,新北市,新莊區,民本里,529,1326,397,269,666,37,703
公投第１２案,新北市,新莊區,民本里,530,1344,397,251,648,25,673
公投第１２案,新北市,新莊區,光明里,531,1355,437,291,728,38,766
公投第１２案,新北市,新莊區,光明里,532,1306,419,287,706,52,758
公投第１２案,新北市,新莊區,光明里,533,1349,470,305,775,26,801
公投第１２案,新北市,新莊區,光正里,534,1265,432,276,708,30,738
公投第１２案,新北市,新莊區,光正里,535,1282,437,300,737,43,780
公投第１２案,新北市,新莊區,光正里,536,1237,431,289,720,32,752
公投第１２案,新北市,新莊區,光榮里,537,1301,413,288,701,20,721
公投第１２案,新北市,新莊區,光榮里,538,1262,394,279,673,54,727
公投第１２案,新北市,新莊區,光榮里,539,1270,389,293,682,42,724
公投第１２案,新北市,新莊區,光和里,540,1245,389,302,691,42,733
公投第１２案,新北市,新莊區,光和里,541,1220,374,271,645,44,689
公投第１２案,新北市,新莊區,光華里,542,1245,337,279,616,45,661
公投第１２案,新北市,新莊區,光華里,543,1212,386,233,619,44,663
公投第１２案,新北市,新莊區,光華里,544,1253,368,284,652,36,688
公投第１２案,新北市,新莊區,光華里,545,1272,362,275,637,43,680
公投第１２案,新北市,新莊區,光華里,546,1227,439,271,710,22,732
公投第１２案,新北市,新莊區,西盛里,547,1126,377,275,652,25,677
公投第１２案,新北市,新莊區,西盛里,548,1240,398,287,685,36,721
公投第１２案,新北市,新莊區,西盛里,549,1460,465,333,798,33,831
公投第１２案,新北市,新莊區,西盛里,550,1072,313,257,570,27,597
公投第１２案,新北市,新莊區,西盛里,551,1127,316,250,566,29,595
公投第１２案,新北市,新莊區,西盛里,552,1332,448,305,753,28,781
公投第１２案,新北市,新莊區,西盛里,553,1341,388,306,694,17,711
公投第１２案,新北市,新莊區,西盛里,554,1140,291,196,487,20,507
公投第１２案,新北市,蘆洲區,光華里,555,1600,463,370,833,54,887
公投第１２案,新北市,蘆洲區,光華里,556,1549,481,339,820,46,866
公投第１２案,新北市,蘆洲區,光華里,557,1516,508,337,845,50,895
公投第１２案,新北市,蘆洲區,光明里,558,1404,458,276,734,42,776
公投第１２案,新北市,蘆洲區,光明里,559,1381,411,288,699,63,762
公投第１２案,新北市,蘆洲區,光明里,560,1485,497,310,807,35,842
公投第１２案,新北市,蘆洲區,中路里,561,1779,396,250,646,37,683
公投第１２案,新北市,蘆洲區,中路里,562,1797,555,367,922,37,959
公投第１２案,新北市,蘆洲區,永安里,563,1364,440,297,737,52,789
公投第１２案,新北市,蘆洲區,永安里,564,1635,529,345,874,44,918
公投第１２案,新北市,蘆洲區,永安里,565,1567,428,304,732,30,762
公投第１２案,新北市,蘆洲區,九芎里,566,1524,476,300,776,36,812
公投第１２案,新北市,蘆洲區,九芎里,567,1612,489,301,790,45,835
公投第１２案,新北市,蘆洲區,九芎里,568,1674,499,343,842,27,869
公投第１２案,新北市,蘆洲區,延平里,569,1838,471,396,867,41,908
公投第１２案,新北市,蘆洲區,延平里,570,1814,486,316,802,28,830
公投第１２案,新北市,蘆洲區,中華里,571,1473,435,362,797,41,838
公投第１２案,新北市,蘆洲區,中華里,572,1465,441,316,757,38,795
公投第１２案,新北市,蘆洲區,中原里,573,1652,505,402,907,42,949
公投第１２案,新北市,蘆洲區,中原里,574,1650,485,374,859,59,918
公投第１２案,新北市,蘆洲區,中原里,575,1656,514,363,877,40,917
公投第１２案,新北市,蘆洲區,長安里,576,1571,423,366,789,35,824
公投第１２案,新北市,蘆洲區,長安里,577,1523,435,348,783,39,822
公投第１２案,新北市,蘆洲區,長安里,578,1475,470,289,759,42,801
公投第１２案,新北市,蘆洲區,忠義里,579,1367,377,317,694,41,735
公投第１２案,新北市,蘆洲區,忠義里,580,1514,482,338,820,42,862
公投第１２案,新北市,蘆洲區,正義里,581,1791,592,428,1020,37,1057
公投第１２案,新北市,蘆洲區,正義里,582,1714,520,494,1014,27,1041
公投第１２案,新北市,蘆洲區,正義里,583,1780,604,378,982,32,1014
公投第１２案,新北市,蘆洲區,正義里,584,1713,546,397,943,27,970
公投第１２案,新北市,蘆洲區,正義里,585,1720,582,377,959,27,986
公投第１２案,新北市,蘆洲區,正義里,586,1766,576,367,943,32,975
公投第１２案,新北市,蘆洲區,南港里,587,1623,522,331,853,35,888
公投第１２案,新北市,蘆洲區,南港里,588,1740,503,407,910,48,958
公投第１２案,新北市,蘆洲區,南港里,589,1759,586,390,976,44,1020
公投第１２案,新北市,蘆洲區,永樂里,590,1775,564,410,974,57,1031
公投第１２案,新北市,蘆洲區,永樂里,591,1909,609,449,1058,35,1093
公投第１２案,新北市,蘆洲區,永樂里,592,1805,564,429,993,57,1050
公投第１２案,新北市,蘆洲區,成功里,593,1642,499,352,851,24,875
公投第１２案,新北市,蘆洲區,成功里,594,1713,492,377,869,48,917
公投第１２案,新北市,蘆洲區,成功里,595,1746,482,352,834,59,893
公投第１２案,新北市,蘆洲區,成功里,596,1596,497,335,832,45,877
公投第１２案,新北市,蘆洲區,永康里,597,1434,404,325,729,39,768
公投第１２案,新北市,蘆洲區,永康里,598,1450,438,336,774,37,811
公投第１２案,新北市,蘆洲區,永康里,599,1543,457,324,781,16,797
公投第１２案,新北市,蘆洲區,永康里,600,1525,441,358,799,29,828
公投第１２案,新北市,蘆洲區,永德里,601,1419,403,310,713,42,755
公投第１２案,新北市,蘆洲區,永德里,602,1298,390,316,706,34,740
公投第１２案,新北市,蘆洲區,永德里,603,1304,401,261,662,50,712
公投第１２案,新北市,蘆洲區,樓厝里,604,1806,539,381,920,45,965
公投第１２案,新北市,蘆洲區,樓厝里,605,1910,542,391,933,60,993
公投第１２案,新北市,蘆洲區,樓厝里,606,1873,475,339,814,34,848
公投第１２案,新北市,蘆洲區,信義里,607,1785,468,354,822,36,858
公投第１２案,新北市,蘆洲區,信義里,608,1760,501,341,842,49,891
公投第１２案,新北市,蘆洲區,玉清里,609,1841,569,399,968,54,1022
公投第１２案,新北市,蘆洲區,玉清里,610,1855,548,374,922,43,965
公投第１２案,新北市,蘆洲區,玉清里,611,1450,390,293,683,52,735
公投第１２案,新北市,蘆洲區,復興里,612,1585,448,336,784,53,837
公投第１２案,新北市,蘆洲區,復興里,613,1541,416,290,706,82,788
公投第１２案,新北市,蘆洲區,福安里,614,1626,487,329,816,47,863
公投第１２案,新北市,蘆洲區,福安里,615,1241,352,323,675,42,717
公投第１２案,新北市,蘆洲區,鷺江里,616,1634,492,360,852,40,892
公投第１２案,新北市,蘆洲區,鷺江里,617,1573,497,331,828,46,874
公投第１２案,新北市,蘆洲區,鷺江里,618,1619,479,385,864,44,908
公投第１２案,新北市,蘆洲區,恆德里,619,1878,559,395,954,68,1022
公投第１２案,新北市,蘆洲區,恆德里,620,1797,535,380,915,50,965
公投第１２案,新北市,蘆洲區,恆德里,621,1816,665,302,967,36,1003
公投第１２案,新北市,蘆洲區,溪墘里,622,1344,415,316,731,66,797
公投第１２案,新北市,蘆洲區,溪墘里,623,1492,508,337,845,42,887
公投第１２案,新北市,蘆洲區,仁復里,624,1959,605,373,978,73,1051
公投第１２案,新北市,蘆洲區,仁德里,625,1611,472,345,817,67,884
公投第１２案,新北市,蘆洲區,仁德里,626,1574,500,375,875,37,912
公投第１２案,新北市,蘆洲區,仁德里,627,1653,515,374,889,38,927
公投第１２案,新北市,蘆洲區,仁義里,628,3085,555,455,1010,52,1062
公投第１２案,新北市,蘆洲區,仁義里,629,1812,508,411,919,51,970
公投第１２案,新北市,蘆洲區,得勝里,630,1332,415,277,692,43,735
公投第１２案,新北市,蘆洲區,得勝里,631,1648,436,329,765,50,815
公投第１２案,新北市,蘆洲區,得仁里,632,1355,397,290,687,28,715
公投第１２案,新北市,蘆洲區,得仁里,633,1371,412,296,708,29,737
公投第１２案,新北市,蘆洲區,保和里,634,1111,350,247,597,43,640
公投第１２案,新北市,蘆洲區,保和里,635,1176,361,259,620,76,696
公投第１２案,新北市,蘆洲區,樹德里,636,1602,469,384,853,42,895
公投第１２案,新北市,蘆洲區,樹德里,637,1361,367,291,658,35,693
公投第１２案,新北市,蘆洲區,民和里,638,1530,460,320,780,52,832
公投第１２案,新北市,蘆洲區,民和里,639,925,286,180,466,62,528
公投第１２案,新北市,蘆洲區,水湳里,640,1851,580,372,952,48,1000
公投第１２案,新北市,蘆洲區,水湳里,641,1791,488,344,832,50,882
公投第１２案,新北市,蘆洲區,水湳里,642,1853,497,378,875,51,926
公投第１２案,新北市,蘆洲區,水湳里,643,1758,466,366,832,37,869
公投第１２案,新北市,蘆洲區,水湳里,644,1798,504,402,906,62,968
公投第１２案,新北市,蘆洲區,水河里,645,1645,506,356,862,45,907
公投第１２案,新北市,蘆洲區,水河里,646,1612,443,323,766,30,796
公投第１２案,新北市,蘆洲區,水河里,647,1784,456,374,830,44,874
公投第１２案,新北市,蘆洲區,水河里,648,1701,445,302,747,46,793
公投第１２案,新北市,蘆洲區,水河里,649,1581,476,309,785,34,819
公投第１２案,新北市,蘆洲區,仁愛里,650,1534,441,363,804,41,845
公投第１２案,新北市,蘆洲區,仁愛里,651,1620,506,377,883,52,935
公投第１２案,新北市,蘆洲區,仁愛里,652,1494,504,339,843,47,890
公投第１２案,新北市,蘆洲區,忠孝里,653,1183,353,281,634,26,660
公投第１２案,新北市,蘆洲區,忠孝里,654,985,318,219,537,36,573
公投第１２案,新北市,蘆洲區,保佑里,655,1673,509,310,819,57,876
公投第１２案,新北市,蘆洲區,保佑里,656,1688,513,372,885,65,950
公投第１２案,新北市,蘆洲區,保新里,657,1249,368,279,647,36,683
公投第１２案,新北市,蘆洲區,保新里,658,1476,410,312,722,54,776
公投第１２案,新北市,三重區,大有里,659,1509,420,350,770,40,810
公投第１２案,新北市,三重區,大有里,660,1591,509,367,876,46,922
公投第１２案,新北市,三重區,大有里,661,1653,512,389,901,61,962
公投第１２案,新北市,三重區,博愛里,662,1392,482,290,772,57,829
公投第１２案,新北市,三重區,博愛里,663,1451,508,317,825,57,882
公投第１２案,新北市,三重區,博愛里,664,1329,447,289,736,47,783
公投第１２案,新北市,三重區,二重里,665,1459,468,352,820,23,843
公投第１２案,新北市,三重區,頂崁里,666,1024,311,261,572,47,619
公投第１２案,新北市,三重區,頂崁里,667,1066,353,253,606,41,647
公投第１２案,新北市,三重區,谷王里,668,856,312,220,532,37,569
公投第１２案,新北市,三重區,五谷里,669,764,225,177,402,34,436
公投第１２案,新北市,三重區,五谷里,670,821,277,200,477,42,519
公投第１２案,新北市,三重區,中興里,671,1887,545,396,941,57,998
公投第１２案,新北市,三重區,中興里,672,1646,488,300,788,41,829
公投第１２案,新北市,三重區,德厚里,673,358,116,96,212,11,223
公投第１２案,新北市,三重區,成功里,674,1039,338,248,586,39,625
公投第１２案,新北市,三重區,成功里,675,1114,372,277,649,30,679
公投第１２案,新北市,三重區,成功里,676,1588,513,400,913,35,948
公投第１２案,新北市,三重區,成功里,677,1702,536,344,880,31,911
公投第１２案,新北市,三重區,福祉里,678,1288,431,314,745,42,787
公投第１２案,新北市,三重區,福祉里,679,1629,552,390,942,40,982
公投第１２案,新北市,三重區,福祉里,680,1861,608,385,993,56,1049
公投第１２案,新北市,三重區,福德里,681,1727,521,348,869,41,910
公投第１２案,新北市,三重區,福德里,682,1813,540,413,953,47,1000
公投第１２案,新北市,三重區,福民里,683,1595,542,309,851,55,906
公投第１２案,新北市,三重區,福民里,684,1513,497,336,833,50,883
公投第１２案,新北市,三重區,過田里,685,4433,419,369,788,37,825
公投第１２案,新北市,三重區,過田里,686,1283,443,272,715,34,749
公投第１２案,新北市,三重區,過田里,687,1430,511,324,835,40,875
公投第１２案,新北市,三重區,過田里,688,1357,465,328,793,21,814
公投第１２案,新北市,三重區,錦田里,689,963,331,217,548,25,573
公投第１２案,新北市,三重區,錦田里,690,883,276,211,487,33,520
公投第１２案,新北市,三重區,重明里,691,1494,493,297,790,65,855
公投第１２案,新北市,三重區,重明里,692,1616,533,261,794,64,858
公投第１２案,新北市,三重區,光田里,693,1329,416,306,722,40,762
公投第１２案,新北市,三重區,光田里,694,1289,471,295,766,40,806
公投第１２案,新北市,三重區,光田里,695,1380,442,314,756,49,805
公投第１２案,新北市,三重區,光陽里,696,1668,544,385,929,33,962
公投第１２案,新北市,三重區,光陽里,697,1226,430,299,729,47,776
公投第１２案,新北市,三重區,光陽里,698,1421,495,333,828,29,857
公投第１２案,新北市,三重區,光陽里,699,1364,461,311,772,41,813
公投第１２案,新北市,三重區,田心里,700,1232,406,286,692,42,734
公投第１２案,新北市,三重區,田心里,701,1248,418,319,737,44,781
公投第１２案,新北市,三重區,田心里,702,1256,411,294,705,50,755
公投第１２案,新北市,三重區,福田里,703,1506,492,400,892,39,931
公投第１２案,新北市,三重區,福田里,704,1669,543,304,847,40,887
公投第１２案,新北市,三重區,田中里,705,1308,427,284,711,49,760
公投第１２案,新北市,三重區,田中里,706,1263,491,300,791,41,832
公投第１２案,新北市,三重區,田中里,707,1471,461,314,775,65,840
公投第１２案,新北市,三重區,田中里,708,1447,488,330,818,59,877
公投第１２案,新北市,三重區,田安里,709,1693,435,346,781,54,835
公投第１２案,新北市,三重區,田安里,710,2015,607,438,1045,50,1095
公投第１２案,新北市,三重區,田安里,711,1812,554,335,889,65,954
公投第１２案,新北市,三重區,三民里,712,1509,463,327,790,29,819
公投第１２案,新北市,三重區,三民里,713,1439,464,344,808,38,846
公投第１２案,新北市,三重區,光明里,714,1437,473,317,790,36,826
公投第１２案,新北市,三重區,光明里,715,1697,463,406,869,53,922
公投第１２案,新北市,三重區,光明里,716,1793,544,356,900,37,937
公投第１２案,新北市,三重區,光明里,717,1603,563,364,927,34,961
公投第１２案,新北市,三重區,光正里,718,1166,360,260,620,16,636
公投第１２案,新北市,三重區,光正里,719,1126,377,251,628,39,667
公投第１２案,新北市,三重區,同安里,720,1291,362,256,618,36,654
公投第１２案,新北市,三重區,同慶里,721,1597,499,371,870,56,926
公投第１２案,新北市,三重區,菜寮里,722,1081,356,254,610,55,665
公投第１２案,新北市,三重區,菜寮里,723,911,314,242,556,34,590
公投第１２案,新北市,三重區,永春里,724,1719,489,335,824,33,857
公投第１２案,新北市,三重區,中正里,725,1289,408,268,676,51,727
公投第１２案,新北市,三重區,吉利里,726,1318,451,296,747,57,804
公投第１２案,新北市,三重區,大同里,727,1822,527,375,902,62,964
公投第１２案,新北市,三重區,中民里,728,1185,396,242,638,61,699
公投第１２案,新北市,三重區,平和里,729,1369,381,285,666,56,722
公投第１２案,新北市,三重區,大安里,730,1507,487,319,806,58,864
公投第１２案,新北市,三重區,仁德里,731,926,307,201,508,47,555
公投第１２案,新北市,三重區,仁德里,732,950,279,217,496,19,515
公投第１２案,新北市,三重區,忠孝里,733,1678,349,500,849,49,898
公投第１２案,新北市,三重區,仁義里,734,1117,332,244,576,62,638
公投第１２案,新北市,三重區,光榮里,735,1318,401,267,668,44,712
公投第１２案,新北市,三重區,光輝里,736,1388,416,351,767,34,801
公投第１２案,新北市,三重區,福星里,737,1026,310,244,554,46,600
公投第１２案,新北市,三重區,福利里,738,1096,346,295,641,42,683
公投第１２案,新北市,三重區,福利里,739,967,315,222,537,36,573
公投第１２案,新北市,三重區,清和里,740,1871,563,382,945,41,986
公投第１２案,新北市,三重區,清和里,741,1663,517,359,876,64,940
公投第１２案,新北市,三重區,永興里,742,1208,412,244,656,27,683
公投第１２案,新北市,三重區,中山里,743,1398,405,286,691,53,744
公投第１２案,新北市,三重區,中山里,744,1078,352,218,570,20,590
公投第１２案,新北市,三重區,大園里,745,1102,345,218,563,50,613
公投第１２案,新北市,三重區,大園里,746,1393,394,313,707,60,767
公投第１２案,新北市,三重區,國隆里,747,1251,406,279,685,56,741
公投第１２案,新北市,三重區,國隆里,748,1234,445,301,746,43,789
公投第１２案,新北市,三重區,重陽里,749,1661,492,425,917,43,960
公投第１２案,新北市,三重區,重陽里,750,1590,530,326,856,52,908
公投第１２案,新北市,三重區,民生里,751,1182,369,287,656,50,706
公投第１２案,新北市,三重區,民生里,752,1369,420,347,767,51,818
公投第１２案,新北市,三重區,民生里,753,1222,434,283,717,41,758
公投第１２案,新北市,三重區,重新里,754,1304,421,261,682,61,743
公投第１２案,新北市,三重區,正德里,755,1054,314,220,534,32,566
公投第１２案,新北市,三重區,正義里,756,1635,504,357,861,58,919
公投第１２案,新北市,三重區,正安里,757,1779,524,363,887,50,937
公投第１２案,新北市,三重區,自強里,758,1633,503,379,882,53,935
公投第１２案,新北市,三重區,文化里,759,1107,354,255,609,36,645
公投第１２案,新北市,三重區,文化里,760,1021,358,259,617,29,646
公投第１２案,新北市,三重區,中央里,761,1649,438,346,784,71,855
公投第１２案,新北市,三重區,雙園里,762,874,266,197,463,34,497
公投第１２案,新北市,三重區,錦通里,763,1402,465,301,766,68,834
公投第１２案,新北市,三重區,錦安里,764,1713,488,330,818,55,873
公投第１２案,新北市,三重區,長安里,765,973,240,199,439,52,491
公投第１２案,新北市,三重區,長安里,766,1038,331,248,579,38,617
公投第１２案,新北市,三重區,光華里,767,1833,480,359,839,102,941
公投第１２案,新北市,三重區,長生里,768,817,235,202,437,28,465
公投第１２案,新北市,三重區,開元里,769,1387,505,308,813,50,863
公投第１２案,新北市,三重區,大德里,770,784,253,203,456,26,482
公投第１２案,新北市,三重區,長元里,771,1096,329,244,573,23,596
公投第１２案,新北市,三重區,長元里,772,1163,372,255,627,63,690
公投第１２案,新北市,三重區,長江里,773,1868,537,395,932,50,982
公投第１２案,新北市,三重區,長泰里,774,1117,344,219,563,51,614
公投第１２案,新北市,三重區,長泰里,775,934,281,185,466,34,500
公投第１２案,新北市,三重區,長福里,776,1412,407,294,701,47,748
公投第１２案,新北市,三重區,介壽里,777,1062,378,266,644,32,676
公投第１２案,新北市,三重區,萬壽里,778,891,259,190,449,62,511
公投第１２案,新北市,三重區,萬壽里,779,936,349,232,581,64,645
公投第１２案,新北市,三重區,錦江里,780,1085,309,238,547,52,599
公投第１２案,新北市,三重區,錦江里,781,1065,292,234,526,17,543
公投第１２案,新北市,三重區,龍濱里,782,1398,415,338,753,51,804
公投第１２案,新北市,三重區,龍濱里,783,1550,531,320,851,36,887
公投第１２案,新北市,三重區,龍門里,784,1674,490,357,847,64,911
公投第１２案,新北市,三重區,秀江里,785,1215,410,262,672,46,718
公投第１２案,新北市,三重區,奕壽里,786,1606,486,344,830,56,886
公投第１２案,新北市,三重區,三安里,787,1182,355,280,635,35,670
公投第１２案,新北市,三重區,三安里,788,1238,373,304,677,57,734
公投第１２案,新北市,三重區,福安里,789,1342,404,348,752,51,803
公投第１２案,新北市,三重區,福安里,790,1408,457,319,776,47,823
公投第１２案,新北市,三重區,信安里,791,1770,540,396,936,60,996
公投第１２案,新北市,三重區,安慶里,792,940,297,208,505,47,552
公投第１２案,新北市,三重區,安慶里,793,975,296,226,522,24,546
公投第１２案,新北市,三重區,幸福里,794,1507,440,335,775,34,809
公投第１２案,新北市,三重區,幸福里,795,1419,443,312,755,58,813
公投第１２案,新北市,三重區,幸福里,796,1257,400,268,668,49,717
公投第１２案,新北市,三重區,六合里,797,1619,522,353,875,40,915
公投第１２案,新北市,三重區,六合里,798,1745,566,338,904,49,953
公投第１２案,新北市,三重區,六福里,799,1519,452,335,787,69,856
公投第１２案,新北市,三重區,六福里,800,1682,509,338,847,42,889
公投第１２案,新北市,三重區,六福里,801,1697,536,407,943,54,997
公投第１２案,新北市,三重區,順德里,802,1073,332,215,547,43,590
公投第１２案,新北市,三重區,順德里,803,924,285,200,485,28,513
公投第１２案,新北市,三重區,承德里,804,1613,434,335,769,42,811
公投第１２案,新北市,三重區,瑞德里,805,1034,307,212,519,29,548
公投第１２案,新北市,三重區,瑞德里,806,1118,360,243,603,47,650
公投第１２案,新北市,三重區,崇德里,807,1269,406,279,685,47,732
公投第１２案,新北市,三重區,崇德里,808,990,306,202,508,49,557
公投第１２案,新北市,三重區,崇德里,809,1336,428,291,719,45,764
公投第１２案,新北市,三重區,厚德里,810,1601,500,348,848,47,895
公投第１２案,新北市,三重區,厚德里,811,1581,536,367,903,53,956
公投第１２案,新北市,三重區,維德里,812,1345,424,309,733,45,778
公投第１２案,新北市,三重區,維德里,813,1226,411,300,711,44,755
公投第１２案,新北市,三重區,尚德里,814,1650,462,331,793,75,868
公投第１２案,新北市,三重區,尚德里,815,1140,365,254,619,37,656
公投第１２案,新北市,三重區,培德里,816,1639,471,334,805,41,846
公投第１２案,新北市,三重區,培德里,817,1699,544,354,898,52,950
公投第１２案,新北市,三重區,立德里,818,1501,552,387,939,55,994
公投第１２案,新北市,三重區,立德里,819,1538,486,351,837,32,869
公投第１２案,新北市,三重區,永德里,820,1540,453,335,788,60,848
公投第１２案,新北市,三重區,永德里,821,1276,387,283,670,47,717
公投第１２案,新北市,三重區,永德里,822,1539,450,320,770,50,820
公投第１２案,新北市,三重區,永煇里,823,1170,370,304,674,30,704
公投第１２案,新北市,三重區,永煇里,824,1120,430,167,597,41,638
公投第１２案,新北市,三重區,永發里,825,1789,575,374,949,63,1012
公投第１２案,新北市,三重區,永發里,826,1520,395,356,751,60,811
公投第１２案,新北市,三重區,永發里,827,1821,554,388,942,67,1009
公投第１２案,新北市,三重區,永盛里,828,1407,392,342,734,55,789
公投第１２案,新北市,三重區,永盛里,829,1491,450,341,791,45,836
公投第１２案,新北市,三重區,永吉里,830,1381,460,325,785,45,830
公投第１２案,新北市,三重區,永吉里,831,1222,391,273,664,51,715
公投第１２案,新北市,三重區,永安里,832,1938,569,426,995,45,1040
公投第１２案,新北市,三重區,永安里,833,1639,517,352,869,30,899
公投第１２案,新北市,三重區,永豐里,834,1614,487,351,838,68,906
公投第１２案,新北市,三重區,永豐里,835,1709,514,372,886,53,939
公投第１２案,新北市,三重區,永豐里,836,1753,556,315,871,60,931
公投第１２案,新北市,三重區,永福里,837,1398,429,336,765,54,819
公投第１２案,新北市,三重區,永福里,838,1706,480,387,867,66,933
公投第１２案,新北市,三重區,永福里,839,1614,506,370,876,48,924
公投第１２案,新北市,三重區,永清里,840,1591,535,345,880,66,946
公投第１２案,新北市,三重區,永清里,841,1627,519,371,890,34,924
公投第１２案,新北市,三重區,永清里,842,1505,473,343,816,60,876
公投第１２案,新北市,三重區,永順里,843,1331,414,301,715,44,759
公投第１２案,新北市,三重區,永順里,844,1678,489,304,793,46,839
公投第１２案,新北市,三重區,永順里,845,1498,436,372,808,39,847
公投第１２案,新北市,三重區,溪美里,846,1800,558,441,999,58,1057
公投第１２案,新北市,三重區,溪美里,847,1703,451,340,791,44,835
公投第１２案,新北市,三重區,溪美里,848,1975,649,288,937,47,984
公投第１２案,新北市,三重區,溪美里,849,1894,545,396,941,40,981
公投第１２案,新北市,三重區,福隆里,850,1405,421,365,786,37,823
公投第１２案,新北市,三重區,福隆里,851,1293,402,313,715,37,752
公投第１２案,新北市,三重區,福隆里,852,1259,361,327,688,40,728
公投第１２案,新北市,三重區,五常里,853,1144,388,272,660,52,712
公投第１２案,新北市,三重區,五常里,854,1254,396,320,716,51,767
公投第１２案,新北市,三重區,五常里,855,1313,407,305,712,43,755
公投第１２案,新北市,三重區,五福里,856,1594,468,350,818,60,878
公投第１２案,新北市,三重區,五福里,857,1775,560,363,923,53,976
公投第１２案,新北市,三重區,仁忠里,858,1516,493,300,793,56,849
公投第１２案,新北市,三重區,仁忠里,859,1315,454,318,772,58,830
公投第１２案,新北市,三重區,慈福里,860,843,274,192,466,55,521
公投第１２案,新北市,三重區,慈福里,861,1160,323,242,565,46,611
公投第１２案,新北市,三重區,慈生里,862,1052,376,204,580,41,621
公投第１２案,新北市,三重區,慈生里,863,1054,346,269,615,52,667
公投第１２案,新北市,三重區,慈惠里,864,997,293,253,546,42,588
公投第１２案,新北市,三重區,慈惠里,865,936,275,212,487,26,513
公投第１２案,新北市,三重區,慈愛里,866,1658,625,236,861,55,916
公投第１２案,新北市,三重區,慈愛里,867,1496,445,315,760,57,817
公投第１２案,新北市,三重區,慈化里,868,1064,380,253,633,30,663
公投第１２案,新北市,三重區,慈化里,869,1152,401,258,659,45,704
公投第１２案,新北市,三重區,慈祐里,870,1532,453,330,783,42,825
公投第１２案,新北市,三重區,慈祐里,871,1338,371,271,642,30,672
公投第１２案,新北市,三重區,慈祐里,872,1303,431,276,707,46,753
公投第１２案,新北市,三重區,富華里,873,1369,444,318,762,58,820
公投第１２案,新北市,三重區,富華里,874,1491,498,299,797,41,838
公投第１２案,新北市,三重區,富貴里,875,1821,491,392,883,65,948
公投第１２案,新北市,三重區,富貴里,876,1906,566,372,938,33,971
公投第１２案,新北市,三重區,富貴里,877,1842,593,407,1000,46,1046
公投第１２案,新北市,三重區,富福里,878,878,251,192,443,34,477
公投第１２案,新北市,三重區,富福里,879,963,315,256,571,46,617
公投第１２案,新北市,三重區,五華里,880,1381,383,265,648,25,673
公投第１２案,新北市,三重區,五華里,881,1681,428,365,793,54,847
公投第１２案,新北市,三重區,五華里,882,1548,452,327,779,34,813
公投第１２案,新北市,三重區,碧華里,883,1542,481,371,852,42,894
公投第１２案,新北市,三重區,碧華里,884,1557,476,324,800,50,850
公投第１２案,新北市,三重區,碧華里,885,1661,518,343,861,40,901
公投第１２案,新北市,三重區,碧華里,886,2024,634,428,1062,28,1090
公投第１２案,新北市,三重區,福樂里,887,1588,427,326,753,49,802
公投第１２案,新北市,三重區,福樂里,888,1706,535,334,869,69,938
公投第１２案,新北市,三重區,仁華里,889,1341,419,324,743,43,786
公投第１２案,新北市,三重區,仁華里,890,1025,317,221,538,34,572
公投第１２案,新北市,三重區,仁華里,891,1339,414,305,719,47,766
公投第１２案,新北市,三重區,五順里,892,1725,545,338,883,79,962
公投第１２案,新北市,三重區,五順里,893,1826,539,407,946,53,999
公投第１２案,新北市,板橋區,留侯里,894,1388,419,314,733,47,780
公投第１２案,新北市,板橋區,流芳里,895,1294,420,299,719,42,761
公投第１２案,新北市,板橋區,赤松里,896,667,234,170,404,15,419
公投第１２案,新北市,板橋區,黃石里,897,898,290,179,469,30,499
公投第１２案,新北市,板橋區,挹秀里,898,829,293,186,479,27,506
公投第１２案,新北市,板橋區,挹秀里,899,739,282,147,429,34,463
公投第１２案,新北市,板橋區,湳興里,900,1035,351,250,601,36,637
公投第１２案,新北市,板橋區,湳興里,901,1713,465,318,783,24,807
公投第１２案,新北市,板橋區,湳興里,902,658,211,129,340,11,351
公投第１２案,新北市,板橋區,湳興里,903,1312,411,261,672,65,737
公投第１２案,新北市,板橋區,新興里,904,1492,439,310,749,35,784
公投第１２案,新北市,板橋區,新興里,905,1393,405,279,684,40,724
公投第１２案,新北市,板橋區,社後里,906,4742,513,338,851,33,884
公投第１２案,新北市,板橋區,社後里,907,1439,484,297,781,26,807
公投第１２案,新北市,板橋區,社後里,908,1187,401,273,674,53,727
公投第１２案,新北市,板橋區,社後里,909,1122,369,240,609,30,639
公投第１２案,新北市,板橋區,香社里,910,1363,479,281,760,45,805
公投第１２案,新北市,板橋區,香社里,911,1093,370,244,614,36,650
公投第１２案,新北市,板橋區,香社里,912,1331,459,306,765,31,796
公投第１２案,新北市,板橋區,香雅里,913,1026,360,252,612,31,643
公投第１２案,新北市,板橋區,香雅里,914,1244,431,246,677,54,731
公投第１２案,新北市,板橋區,中正里,915,1268,392,249,641,54,695
公投第１２案,新北市,板橋區,中正里,916,1313,426,268,694,22,716
公投第１２案,新北市,板橋區,中正里,917,1196,388,307,695,39,734
公投第１２案,新北市,板橋區,自強里,918,1137,438,309,747,36,783
公投第１２案,新北市,板橋區,自強里,919,1269,458,322,780,31,811
公投第１２案,新北市,板橋區,自強里,920,1117,378,281,659,36,695
公投第１２案,新北市,板橋區,自強里,921,1042,395,237,632,30,662
公投第１２案,新北市,板橋區,自立里,922,1257,460,261,721,45,766
公投第１２案,新北市,板橋區,自立里,923,1216,439,256,695,34,729
公投第１２案,新北市,板橋區,光華里,924,1126,357,258,615,43,658
公投第１２案,新北市,板橋區,光華里,925,1290,516,297,813,42,855
公投第１２案,新北市,板橋區,光榮里,926,1215,385,245,630,17,647
公投第１２案,新北市,板橋區,光榮里,927,1099,399,210,609,21,630
公投第１２案,新北市,板橋區,國光里,928,1329,534,285,819,31,850
公投第１２案,新北市,板橋區,國光里,929,996,394,189,583,23,606
公投第１２案,新北市,板橋區,國光里,930,1047,361,249,610,24,634
公投第１２案,新北市,板橋區,港尾里,931,1272,454,282,736,37,773
公投第１２案,新北市,板橋區,港尾里,932,1252,424,297,721,36,757
公投第１２案,新北市,板橋區,新生里,933,1238,426,268,694,38,732
公投第１２案,新北市,板橋區,新生里,934,1389,506,331,837,51,888
公投第１２案,新北市,板橋區,新生里,935,1194,439,285,724,35,759
公投第１２案,新北市,板橋區,金華里,936,1093,351,220,571,38,609
公投第１２案,新北市,板橋區,金華里,937,1148,405,218,623,46,669
公投第１２案,新北市,板橋區,金華里,938,1268,444,300,744,32,776
公投第１２案,新北市,板橋區,港德里,939,1230,416,257,673,45,718
公投第１２案,新北市,板橋區,港德里,940,1012,342,203,545,32,577
公投第１２案,新北市,板橋區,港德里,941,811,296,170,466,26,492
公投第１２案,新北市,板橋區,港德里,942,1197,437,285,722,41,763
公投第１２案,新北市,板橋區,民權里,943,1142,422,206,628,26,654
公投第１２案,新北市,板橋區,民權里,944,1222,429,263,692,30,722
公投第１２案,新北市,板橋區,民安里,945,796,315,160,475,35,510
公投第１２案,新北市,板橋區,民安里,946,997,371,224,595,54,649
公投第１２案,新北市,板橋區,建國里,947,1011,350,247,597,31,628
公投第１２案,新北市,板橋區,建國里,948,1157,407,251,658,46,704
公投第１２案,新北市,板橋區,建國里,949,1040,372,212,584,37,621
公投第１２案,新北市,板橋區,漢生里,950,1173,420,270,690,23,713
公投第１２案,新北市,板橋區,漢生里,951,1193,379,255,634,31,665
公投第１２案,新北市,板橋區,漢生里,952,1255,460,268,728,30,758
公投第１２案,新北市,板橋區,公舘里,953,1306,435,306,741,31,772
公投第１２案,新北市,板橋區,公舘里,954,1050,376,240,616,15,631
公投第１２案,新北市,板橋區,公舘里,955,942,335,218,553,15,568
公投第１２案,新北市,板橋區,新民里,956,1133,432,249,681,34,715
公投第１２案,新北市,板橋區,新民里,957,1251,408,296,704,40,744
公投第１２案,新北市,板橋區,新民里,958,1293,483,275,758,31,789
公投第１２案,新北市,板橋區,幸福里,959,1208,374,255,629,31,660
公投第１２案,新北市,板橋區,幸福里,960,1223,398,272,670,46,716
公投第１２案,新北市,板橋區,幸福里,961,1061,333,220,553,51,604
公投第１２案,新北市,板橋區,文德里,962,1515,509,346,855,38,893
公投第１２案,新北市,板橋區,文德里,963,1225,468,250,718,37,755
公投第１２案,新北市,板橋區,忠誠里,964,1120,437,263,700,23,723
公投第１２案,新北市,板橋區,忠誠里,965,1091,421,243,664,30,694
公投第１２案,新北市,板橋區,忠誠里,966,1385,565,257,822,29,851
公投第１２案,新北市,板橋區,陽明里,967,1283,465,285,750,46,796
公投第１２案,新北市,板橋區,陽明里,968,1204,400,266,666,58,724
公投第１２案,新北市,板橋區,百壽里,969,1191,465,274,739,25,764
公投第１２案,新北市,板橋區,百壽里,970,1078,413,240,653,37,690
公投第１２案,新北市,板橋區,介壽里,971,1351,487,275,762,44,806
公投第１２案,新北市,板橋區,介壽里,972,1322,453,292,745,38,783
公投第１２案,新北市,板橋區,新埔里,973,868,312,186,498,30,528
公投第１２案,新北市,板橋區,新埔里,974,1029,428,228,656,35,691
公投第１２案,新北市,板橋區,華江里,975,1602,604,300,904,33,937
公投第１２案,新北市,板橋區,華江里,976,1362,477,308,785,40,825
公投第１２案,新北市,板橋區,華江里,977,1698,536,367,903,58,961
公投第１２案,新北市,板橋區,華江里,978,1495,497,328,825,25,850
公投第１２案,新北市,板橋區,江翠里,979,1522,484,324,808,42,850
公投第１２案,新北市,板橋區,江翠里,980,1279,427,278,705,51,756
公投第１２案,新北市,板橋區,江翠里,981,1559,461,284,745,29,774
公投第１２案,新北市,板橋區,純翠里,982,1537,459,318,777,53,830
公投第１２案,新北市,板橋區,純翠里,983,1531,432,311,743,50,793
公投第１２案,新北市,板橋區,純翠里,984,1720,520,376,896,30,926
公投第１２案,新北市,板橋區,溪頭里,985,1165,358,261,619,31,650
公投第１２案,新北市,板橋區,溪頭里,986,1857,725,395,1120,41,1161
公投第１２案,新北市,板橋區,溪頭里,987,1078,376,211,587,39,626
公投第１２案,新北市,板橋區,溪頭里,988,1177,377,261,638,17,655
公投第１２案,新北市,板橋區,聯翠里,989,1798,600,396,996,55,1051
公投第１２案,新北市,板橋區,聯翠里,990,1455,508,317,825,53,878
公投第１２案,新北市,板橋區,文化里,991,1245,433,285,718,53,771
公投第１２案,新北市,板橋區,文化里,992,1704,526,367,893,47,940
公投第１２案,新北市,板橋區,宏翠里,993,1600,532,370,902,25,927
公投第１２案,新北市,板橋區,宏翠里,994,1409,488,258,746,24,770
公投第１２案,新北市,板橋區,宏翠里,995,1286,423,281,704,39,743
公投第１２案,新北市,板橋區,仁翠里,996,1359,372,235,607,67,674
公投第１２案,新北市,板橋區,仁翠里,997,1188,354,256,610,23,633
公投第１２案,新北市,板橋區,新翠里,998,1627,546,312,858,41,899
公投第１２案,新北市,板橋區,新翠里,999,1633,498,335,833,26,859
公投第１２案,新北市,板橋區,新翠里,1000,1814,612,430,1042,43,1085
公投第１２案,新北市,板橋區,新翠里,1001,1810,598,404,1002,50,1052
公投第１２案,新北市,板橋區,朝陽里,1002,1133,405,218,623,44,667
公投第１２案,新北市,板橋區,朝陽里,1003,841,292,203,495,18,513
公投第１２案,新北市,板橋區,朝陽里,1004,1050,389,241,630,35,665
公投第１２案,新北市,板橋區,吉翠里,1005,1130,363,235,598,43,641
公投第１２案,新北市,板橋區,吉翠里,1006,1056,351,269,620,40,660
公投第１２案,新北市,板橋區,吉翠里,1007,1129,359,239,598,36,634
公投第１２案,新北市,板橋區,德翠里,1008,1713,581,354,935,49,984
公投第１２案,新北市,板橋區,德翠里,1009,1622,538,362,900,48,948
公投第１２案,新北市,板橋區,德翠里,1010,1427,510,350,860,37,897
公投第１２案,新北市,板橋區,德翠里,1011,1471,554,346,900,21,921
公投第１２案,新北市,板橋區,新海里,1012,1076,399,243,642,15,657
公投第１２案,新北市,板橋區,新海里,1013,979,324,199,523,10,533
公投第１２案,新北市,板橋區,新海里,1014,1079,407,263,670,20,690
公投第１２案,新北市,板橋區,滿翠里,1015,828,279,174,453,23,476
公投第１２案,新北市,板橋區,滿翠里,1016,820,288,187,475,46,521
公投第１２案,新北市,板橋區,滿翠里,1017,989,378,218,596,32,628
公投第１２案,新北市,板橋區,明翠里,1018,1023,336,230,566,37,603
公投第１２案,新北市,板橋區,明翠里,1019,1044,359,216,575,32,607
公投第１２案,新北市,板橋區,明翠里,1020,968,335,205,540,36,576
公投第１２案,新北市,板橋區,明翠里,1021,1222,423,278,701,22,723
公投第１２案,新北市,板橋區,松翠里,1022,1385,470,268,738,43,781
公投第１２案,新北市,板橋區,松翠里,1023,1585,526,318,844,48,892
公投第１２案,新北市,板橋區,柏翠里,1024,1840,576,373,949,47,996
公投第１２案,新北市,板橋區,柏翠里,1025,1806,681,397,1078,55,1133
公投第１２案,新北市,板橋區,龍翠里,1026,1506,487,311,798,60,858
公投第１２案,新北市,板橋區,龍翠里,1027,1476,474,312,786,43,829
公投第１２案,新北市,板橋區,龍翠里,1028,1500,507,323,830,51,881
公投第１２案,新北市,板橋區,松柏里,1029,1096,387,266,653,52,705
公投第１２案,新北市,板橋區,松柏里,1030,963,376,193,569,34,603
公投第１２案,新北市,板橋區,華翠里,1031,1601,479,397,876,33,909
公投第１２案,新北市,板橋區,華翠里,1032,1507,524,345,869,52,921
公投第１２案,新北市,板橋區,莒光里,1033,1315,461,307,768,52,820
公投第１２案,新北市,板橋區,莒光里,1034,1178,409,259,668,22,690
公投第１２案,新北市,板橋區,忠翠里,1035,1822,654,396,1050,53,1103
公投第１２案,新北市,板橋區,忠翠里,1036,1605,576,374,950,52,1002
公投第１２案,新北市,板橋區,忠翠里,1037,1549,548,338,886,26,912
公投第１２案,新北市,板橋區,忠翠里,1038,1948,596,456,1052,29,1081
公投第１２案,新北市,板橋區,忠翠里,1039,1935,649,415,1064,30,1094
公投第１２案,新北市,板橋區,嵐翠里,1040,1097,357,223,580,31,611
公投第１２案,新北市,板橋區,嵐翠里,1041,1095,381,205,586,25,611
公投第１２案,新北市,板橋區,文聖里,1042,1678,538,320,858,67,925
公投第１２案,新北市,板橋區,文聖里,1043,1750,570,348,918,47,965
公投第１２案,新北市,板橋區,文翠里,1044,1187,383,250,633,33,666
公投第１２案,新北市,板橋區,文翠里,1045,1154,389,276,665,27,692
公投第１２案,新北市,板橋區,文翠里,1046,1262,455,293,748,28,776
公投第１２案,新北市,板橋區,青翠里,1047,1271,408,278,686,41,727
公投第１２案,新北市,板橋區,青翠里,1048,1410,467,295,762,47,809
公投第１２案,新北市,板橋區,懷翠里,1049,1745,526,343,869,48,917
公投第１２案,新北市,板橋區,懷翠里,1050,1867,606,377,983,77,1060
公投第１２案,新北市,板橋區,懷翠里,1051,1753,623,369,992,62,1054
公投第１２案,新北市,板橋區,福翠里,1052,1204,382,295,677,49,726
公投第１２案,新北市,板橋區,港嘴里,1053,1614,505,340,845,42,887
公投第１２案,新北市,板橋區,港嘴里,1054,1237,396,307,703,39,742
公投第１２案,新北市,板橋區,港嘴里,1055,1361,448,318,766,52,818
公投第１２案,新北市,板橋區,港嘴里,1056,1243,392,308,700,27,727
公投第１２案,新北市,板橋區,振興里,1057,1515,450,320,770,30,800
公投第１２案,新北市,板橋區,振興里,1058,1515,495,365,860,51,911
公投第１２案,新北市,板橋區,振興里,1059,949,311,244,555,33,588
公投第１２案,新北市,板橋區,振義里,1060,1629,630,239,869,38,907
公投第１２案,新北市,板橋區,振義里,1061,1238,409,281,690,33,723
公投第１２案,新北市,板橋區,振義里,1062,901,246,137,383,15,398
公投第１２案,新北市,板橋區,光復里,1063,1475,466,353,819,43,862
公投第１２案,新北市,板橋區,光復里,1064,1481,477,308,785,49,834
公投第１２案,新北市,板橋區,埔墘里,1065,1800,557,366,923,41,964
公投第１２案,新北市,板橋區,埔墘里,1066,1630,532,330,862,52,914
公投第１２案,新北市,板橋區,埔墘里,1067,1298,453,304,757,26,783
公投第１２案,新北市,板橋區,埔墘里,1068,874,292,203,495,32,527
公投第１２案,新北市,板橋區,富貴里,1069,992,338,246,584,13,597
公投第１２案,新北市,板橋區,富貴里,1070,1034,414,241,655,25,680
公投第１２案,新北市,板橋區,長壽里,1071,1451,496,323,819,48,867
公投第１２案,新北市,板橋區,長壽里,1072,1130,389,279,668,28,696
公投第１２案,新北市,板橋區,福壽里,1073,1440,481,335,816,33,849
公投第１２案,新北市,板橋區,福壽里,1074,1531,507,336,843,65,908
公投第１２案,新北市,板橋區,居仁里,1075,1349,477,350,827,39,866
公投第１２案,新北市,板橋區,居仁里,1076,1593,506,340,846,27,873
公投第１２案,新北市,板橋區,海山里,1077,1174,415,247,662,23,685
公投第１２案,新北市,板橋區,海山里,1078,1228,441,250,691,35,726
公投第１２案,新北市,板橋區,海山里,1079,1187,422,270,692,28,720
公投第１２案,新北市,板橋區,海山里,1080,870,299,204,503,35,538
公投第１２案,新北市,板橋區,海山里,1081,2033,742,455,1197,32,1229
公投第１２案,新北市,板橋區,九如里,1082,1418,442,290,732,40,772
公投第１２案,新北市,板橋區,九如里,1083,1075,359,236,595,29,624
公投第１２案,新北市,板橋區,正泰里,1084,1515,512,298,810,33,843
公投第１２案,新北市,板橋區,正泰里,1085,1182,481,270,751,26,777
公投第１２案,新北市,板橋區,玉光里,1086,1893,594,407,1001,54,1055
公投第１２案,新北市,板橋區,玉光里,1087,1302,416,265,681,41,722
公投第１２案,新北市,板橋區,玉光里,1088,1366,416,282,698,38,736
公投第１２案,新北市,板橋區,光仁里,1089,1318,446,326,772,56,828
公投第１２案,新北市,板橋區,光仁里,1090,1200,381,266,647,45,692
公投第１２案,新北市,板橋區,埤墘里,1091,2028,625,480,1105,37,1142
公投第１２案,新北市,板橋區,埤墘里,1092,1746,599,359,958,68,1026
公投第１２案,新北市,板橋區,莊敬里,1093,1954,573,405,978,23,1001
公投第１２案,新北市,板橋區,莊敬里,1094,1474,494,300,794,38,832
公投第１２案,新北市,板橋區,永安里,1095,1418,483,301,784,37,821
公投第１２案,新北市,板橋區,永安里,1096,1563,562,376,938,46,984
公投第１２案,新北市,板橋區,雙玉里,1097,1780,579,344,923,64,987
公投第１２案,新北市,板橋區,雙玉里,1098,1707,541,385,926,40,966
公投第１２案,新北市,板橋區,廣新里,1099,906,241,136,377,10,387
公投第１２案,新北市,板橋區,廣新里,1100,1030,327,227,554,43,597
公投第１２案,新北市,板橋區,廣新里,1101,1115,366,257,623,35,658
公投第１２案,新北市,板橋區,深丘里,1102,1836,615,373,988,20,1008
公投第１２案,新北市,板橋區,深丘里,1103,1881,581,411,992,61,1053
公投第１２案,新北市,板橋區,深丘里,1104,1688,544,370,914,28,942
公投第１２案,新北市,板橋區,深丘里,1105,1760,619,383,1002,35,1037
公投第１２案,新北市,板橋區,香丘里,1106,1044,384,240,624,32,656
公投第１２案,新北市,板橋區,香丘里,1107,1043,381,250,631,28,659
公投第１２案,新北市,板橋區,香丘里,1108,1099,387,270,657,36,693
公投第１２案,新北市,板橋區,西安里,1109,1260,389,286,675,53,728
公投第１２案,新北市,板橋區,西安里,1110,1131,382,252,634,25,659
公投第１２案,新北市,板橋區,東丘里,1111,1225,421,272,693,28,721
公投第１２案,新北市,板橋區,東丘里,1112,1455,524,352,876,34,910
公投第１２案,新北市,板橋區,東丘里,1113,1267,427,271,698,32,730
公投第１２案,新北市,板橋區,民生里,1114,972,335,231,566,32,598
公投第１２案,新北市,板橋區,民生里,1115,994,356,219,575,32,607
公投第１２案,新北市,板橋區,長安里,1116,1111,396,234,630,18,648
公投第１２案,新北市,板橋區,長安里,1117,1177,474,261,735,45,780
公投第１２案,新北市,板橋區,長安里,1118,1544,471,343,814,48,862
公投第１２案,新北市,板橋區,東安里,1119,1021,316,228,544,54,598
公投第１２案,新北市,板橋區,東安里,1120,1040,359,205,564,31,595
公投第１２案,新北市,板橋區,福丘里,1121,1504,470,338,808,25,833
公投第１２案,新北市,板橋區,福丘里,1122,1373,430,283,713,32,745
公投第１２案,新北市,板橋區,福丘里,1123,1210,405,298,703,19,722
公投第１２案,新北市,板橋區,福祿里,1124,1809,578,341,919,43,962
公投第１２案,新北市,板橋區,福祿里,1125,1551,559,322,881,51,932
公投第１２案,新北市,板橋區,民族里,1126,1408,481,308,789,31,820
公投第１２案,新北市,板橋區,民族里,1127,1285,468,289,757,26,783
公投第１２案,新北市,板橋區,民族里,1128,1102,431,266,697,24,721
公投第１２案,新北市,板橋區,國泰里,1129,1399,452,269,721,29,750
公投第１２案,新北市,板橋區,國泰里,1130,1692,582,334,916,54,970
公投第１２案,新北市,板橋區,後埔里,1131,1625,587,387,974,26,1000
公投第１２案,新北市,板橋區,後埔里,1132,1712,523,389,912,57,969
公投第１２案,新北市,板橋區,福德里,1133,1246,426,270,696,35,731
公投第１２案,新北市,板橋區,福德里,1134,1471,520,324,844,34,878
公投第１２案,新北市,板橋區,福德里,1135,1761,619,370,989,48,1037
公投第１２案,新北市,板橋區,景星里,1136,1499,489,328,817,45,862
公投第１２案,新北市,板橋區,景星里,1137,1528,449,319,768,45,813
公投第１２案,新北市,板橋區,福星里,1138,1536,523,353,876,46,922
公投第１２案,新北市,板橋區,福星里,1139,1550,542,331,873,35,908
公投第１２案,新北市,板橋區,鄉雲里,1140,2050,662,458,1120,66,1186
公投第１２案,新北市,板橋區,鄉雲里,1141,1300,445,292,737,40,777
公投第１２案,新北市,板橋區,廣德里,1142,1537,544,307,851,37,888
公投第１２案,新北市,板橋區,廣德里,1143,1341,438,267,705,29,734
公投第１２案,新北市,板橋區,廣德里,1144,1606,525,366,891,29,920
公投第１２案,新北市,板橋區,廣德里,1145,1433,466,269,735,40,775
公投第１２案,新北市,板橋區,大豐里,1146,1685,532,338,870,38,908
公投第１２案,新北市,板橋區,大豐里,1147,1248,457,271,728,46,774
公投第１２案,新北市,板橋區,大豐里,1148,1172,407,223,630,34,664
公投第１２案,新北市,板橋區,重慶里,1149,1640,485,313,798,36,834
公投第１２案,新北市,板橋區,重慶里,1150,1428,509,285,794,31,825
公投第１２案,新北市,板橋區,重慶里,1151,1527,466,371,837,48,885
公投第１２案,新北市,板橋區,重慶里,1152,1350,474,296,770,24,794
公投第１２案,新北市,板橋區,重慶里,1153,1582,523,323,846,52,898
公投第１２案,新北市,板橋區,仁愛里,1154,919,367,206,573,30,603
公投第１２案,新北市,板橋區,仁愛里,1155,930,367,182,549,15,564
公投第１２案,新北市,板橋區,仁愛里,1156,974,397,208,605,19,624
公投第１２案,新北市,板橋區,和平里,1157,1732,612,357,969,43,1012
公投第１２案,新北市,板橋區,和平里,1158,1438,460,295,755,54,809
公投第１２案,新北市,板橋區,廣福里,1159,1777,567,364,931,45,976
公投第１２案,新北市,板橋區,廣福里,1160,1764,535,319,854,30,884
公投第１２案,新北市,板橋區,五權里,1161,1289,440,287,727,21,748
公投第１２案,新北市,板橋區,五權里,1162,1182,422,232,654,42,696
公投第１２案,新北市,板橋區,五權里,1163,1174,424,249,673,32,705
公投第１２案,新北市,板橋區,華興里,1164,1870,590,362,952,59,1011
公投第１２案,新北市,板橋區,華興里,1165,1842,607,431,1038,43,1081
公投第１２案,新北市,板橋區,華貴里,1166,1094,377,236,613,35,648
公投第１２案,新北市,板橋區,華貴里,1167,1228,399,244,643,36,679
公投第１２案,新北市,板橋區,華福里,1168,998,411,232,643,33,676
公投第１２案,新北市,板橋區,華福里,1169,862,341,210,551,24,575
公投第１２案,新北市,板橋區,華德里,1170,1622,494,325,819,40,859
公投第１２案,新北市,板橋區,華德里,1171,1205,448,247,695,32,727
公投第１２案,新北市,板橋區,華德里,1172,1787,490,391,881,40,921
公投第１２案,新北市,板橋區,華德里,1173,1610,523,354,877,32,909
公投第１２案,新北市,板橋區,華東里,1174,2216,743,544,1287,30,1317
公投第１２案,新北市,板橋區,華東里,1175,2294,740,485,1225,45,1270
公投第１２案,新北市,板橋區,華東里,1176,2090,657,436,1093,54,1147
公投第１２案,新北市,板橋區,信義里,1177,1356,421,234,655,27,682
公投第１２案,新北市,板橋區,信義里,1178,1067,388,222,610,34,644
公投第１２案,新北市,板橋區,信義里,1179,1319,432,300,732,27,759
公投第１２案,新北市,板橋區,浮洲里,1180,1316,444,274,718,26,744
公投第１２案,新北市,板橋區,浮洲里,1181,1195,397,217,614,39,653
公投第１２案,新北市,板橋區,浮洲里,1182,857,265,214,479,22,501
公投第１２案,新北市,板橋區,華中里,1183,1417,428,295,723,53,776
公投第１２案,新北市,板橋區,華中里,1184,1560,490,358,848,65,913
公投第１２案,新北市,板橋區,華中里,1185,1747,558,388,946,65,1011
公投第１２案,新北市,板橋區,僑中里,1186,1176,431,280,711,37,748
公投第１２案,新北市,板橋區,僑中里,1187,1101,346,285,631,27,658
公投第１２案,新北市,板橋區,僑中里,1188,1458,498,341,839,28,867
公投第１２案,新北市,板橋區,大觀里,1189,1630,498,283,781,40,821
公投第１２案,新北市,板橋區,大觀里,1190,1611,512,326,838,62,900
公投第１２案,新北市,板橋區,歡園里,1191,1139,347,243,590,38,628
公投第１２案,新北市,板橋區,中山里,1192,1120,358,257,615,18,633
公投第１２案,新北市,板橋區,中山里,1193,1022,344,251,595,60,655
公投第１２案,新北市,板橋區,中山里,1194,1049,362,231,593,51,644
公投第１２案,新北市,板橋區,中山里,1195,1007,345,223,568,27,595
公投第１２案,新北市,板橋區,中山里,1196,1393,467,297,764,28,792
公投第１２案,新北市,板橋區,復興里,1197,474,91,77,168,34,202
公投第１２案,新北市,板橋區,復興里,1198,500,165,114,279,21,300
公投第１２案,新北市,板橋區,大安里,1199,1177,371,245,616,32,648
公投第１２案,新北市,板橋區,大安里,1200,1186,424,236,660,26,686
公投第１２案,新北市,板橋區,大安里,1201,1139,391,278,669,37,706
公投第１２案,新北市,板橋區,福安里,1202,1750,559,368,927,44,971
公投第１２案,新北市,板橋區,福安里,1203,3451,716,458,1174,58,1232
公投第１２案,新北市,板橋區,聚安里,1204,1620,488,317,805,56,861
公投第１２案,新北市,板橋區,聚安里,1205,903,278,174,452,24,476
公投第１２案,新北市,板橋區,聚安里,1206,1232,408,287,695,27,722
公投第１２案,新北市,板橋區,聚安里,1207,975,293,198,491,18,509
公投第１２案,新北市,板橋區,龍安里,1208,1224,414,250,664,29,693
公投第１２案,新北市,板橋區,龍安里,1209,1291,454,256,710,28,738
公投第１２案,新北市,板橋區,崑崙里,1210,1828,507,391,898,38,936
公投第１２案,新北市,板橋區,崑崙里,1211,1725,504,333,837,52,889
公投第１２案,新北市,板橋區,崑崙里,1212,1085,309,221,530,27,557
公投第１２案,新北市,板橋區,崑崙里,1213,2357,694,474,1168,54,1222
公投第１２案,新北市,板橋區,崑崙里,1214,1560,465,362,827,22,849
公投第１２案,新北市,板橋區,成和里,1215,2201,604,386,990,21,1011
公投第１２案,新北市,板橋區,成和里,1216,1626,507,337,844,30,874
公投第１２案,新北市,板橋區,成和里,1217,1786,693,123,816,21,837
公投第１２案,新北市,板橋區,溪洲里,1218,1763,557,374,931,30,961
公投第１２案,新北市,板橋區,溪洲里,1219,1744,533,348,881,22,903
公投第１２案,新北市,板橋區,溪洲里,1220,1645,489,348,837,58,895
公投第１２案,新北市,板橋區,溪福里,1221,1861,547,367,914,25,939
公投第１２案,新北市,板橋區,溪福里,1222,1596,480,301,781,29,810
公投第１２案,新北市,板橋區,溪福里,1223,1871,579,389,968,46,1014
公投第１２案,新北市,板橋區,溪福里,1224,1938,621,384,1005,45,1050
公投第１２案,新北市,板橋區,溪福里,1225,1827,608,370,978,36,1014
公投第１２案,新北市,板橋區,溪福里,1226,1359,433,269,702,21,723
公投第１２案,新北市,板橋區,溪福里,1227,1613,510,343,853,41,894
公投第１２案,新北市,板橋區,溪北里,1228,1566,513,331,844,45,889
公投第１２案,新北市,板橋區,溪北里,1229,1552,544,372,916,38,954
公投第１２案,新北市,板橋區,堂春里,1230,1885,568,393,961,34,995
公投第１２案,新北市,板橋區,堂春里,1231,1893,564,375,939,49,988
公投第１２案,新北市,中和區,中原里,1232,1630,472,322,794,50,844
公投第１２案,新北市,中和區,中原里,1233,1775,568,366,934,57,991
公投第１２案,新北市,中和區,中原里,1234,1844,565,337,902,35,937
公投第１２案,新北市,中和區,連和里,1235,1019,343,275,618,20,638
公投第１２案,新北市,中和區,連和里,1236,1138,422,249,671,25,696
公投第１２案,新北市,中和區,連城里,1237,1878,633,304,937,34,971
公投第１２案,新北市,中和區,連城里,1238,1980,758,331,1089,44,1133
公投第１２案,新北市,中和區,連城里,1239,1844,625,367,992,46,1038
公投第１２案,新北市,中和區,力行里,1240,2085,758,341,1099,27,1126
公投第１２案,新北市,中和區,力行里,1241,1498,506,289,795,38,833
公投第１２案,新北市,中和區,力行里,1242,1761,585,400,985,24,1009
公投第１２案,新北市,中和區,正行里,1243,1254,410,263,673,30,703
公投第１２案,新北市,中和區,正行里,1244,1343,470,294,764,26,790
公投第１２案,新北市,中和區,德行里,1245,1789,580,387,967,32,999
公投第１２案,新北市,中和區,德行里,1246,2000,621,464,1085,33,1118
公投第１２案,新北市,中和區,德行里,1247,1953,548,392,940,38,978
公投第１２案,新北市,中和區,枋寮里,1248,1712,541,367,908,53,961
公投第１２案,新北市,中和區,枋寮里,1249,1582,563,306,869,46,915
公投第１２案,新北市,中和區,漳和里,1250,1742,571,337,908,52,960
公投第１２案,新北市,中和區,漳和里,1251,1493,534,344,878,46,924
公投第１２案,新北市,中和區,廟美里,1252,1352,439,265,704,34,738
公投第１２案,新北市,中和區,廟美里,1253,1244,460,248,708,30,738
公投第１２案,新北市,中和區,廟美里,1254,1394,459,304,763,50,813
公投第１２案,新北市,中和區,福真里,1255,1917,496,354,850,27,877
公投第１２案,新北市,中和區,福真里,1256,1830,500,420,920,38,958
公投第１２案,新北市,中和區,福善里,1257,1124,378,255,633,29,662
公投第１２案,新北市,中和區,福善里,1258,1412,393,294,687,42,729
公投第１２案,新北市,中和區,福善里,1259,1356,409,303,712,39,751
公投第１２案,新北市,中和區,福美里,1260,1425,454,281,735,23,758
公投第１２案,新北市,中和區,福美里,1261,1259,450,274,724,35,759
公投第１２案,新北市,中和區,福美里,1262,1256,422,274,696,42,738
公投第１２案,新北市,中和區,福祥里,1263,1423,488,283,771,32,803
公投第１２案,新北市,中和區,福祥里,1264,1221,424,270,694,23,717
公投第１２案,新北市,中和區,福祥里,1265,1858,522,384,906,38,944
公投第１２案,新北市,中和區,瓦磘里,1266,1804,554,360,914,36,950
公投第１２案,新北市,中和區,瓦磘里,1267,1669,545,389,934,31,965
公投第１２案,新北市,中和區,瓦磘里,1268,1485,518,282,800,36,836
公投第１２案,新北市,中和區,福和里,1269,1005,386,202,588,24,612
公投第１２案,新北市,中和區,福和里,1270,1175,418,284,702,50,752
公投第１２案,新北市,中和區,福和里,1271,1171,401,256,657,33,690
公投第１２案,新北市,中和區,佳和里,1272,1746,532,322,854,32,886
公投第１２案,新北市,中和區,佳和里,1273,1555,463,284,747,31,778
公投第１２案,新北市,中和區,佳和里,1274,1112,345,266,611,23,634
公投第１２案,新北市,中和區,新南里,1275,1780,607,404,1011,46,1057
公投第１２案,新北市,中和區,新南里,1276,1918,619,405,1024,33,1057
公投第１２案,新北市,中和區,新南里,1277,1689,458,287,745,25,770
公投第１２案,新北市,中和區,新南里,1278,1781,625,361,986,31,1017
公投第１２案,新北市,中和區,南山里,1279,1419,473,303,776,38,814
公投第１２案,新北市,中和區,南山里,1280,1344,436,273,709,26,735
公投第１２案,新北市,中和區,南山里,1281,1804,654,406,1060,58,1118
公投第１２案,新北市,中和區,平河里,1282,1788,531,372,903,57,960
公投第１２案,新北市,中和區,平河里,1283,1793,556,429,985,35,1020
公投第１２案,新北市,中和區,平河里,1284,1352,451,295,746,39,785
公投第１２案,新北市,中和區,平河里,1285,1813,587,391,978,47,1025
公投第１２案,新北市,中和區,平河里,1286,1288,480,312,792,29,821
公投第１２案,新北市,中和區,信和里,1287,1186,402,253,655,34,689
公投第１２案,新北市,中和區,信和里,1288,1237,416,249,665,15,680
公投第１２案,新北市,中和區,信和里,1289,1406,508,251,759,38,797
公投第１２案,新北市,中和區,仁和里,1290,1442,443,316,759,53,812
公投第１２案,新北市,中和區,仁和里,1291,1040,369,245,614,35,649
公投第１２案,新北市,中和區,仁和里,1292,1292,478,287,765,39,804
公投第１２案,新北市,中和區,中正里,1293,1811,594,349,943,50,993
公投第１２案,新北市,中和區,中正里,1294,1789,646,333,979,51,1030
公投第１２案,新北市,中和區,建和里,1295,859,338,198,536,30,566
公投第１２案,新北市,中和區,建和里,1296,972,392,213,605,22,627
公投第１２案,新北市,中和區,建和里,1297,1346,450,289,739,38,777
公投第１２案,新北市,中和區,中山里,1298,1034,355,238,593,26,619
公投第１２案,新北市,中和區,中山里,1299,1387,458,310,768,36,804
公投第１２案,新北市,中和區,碧河里,1300,2067,674,440,1114,67,1181
公投第１２案,新北市,中和區,碧河里,1301,1670,446,334,780,28,808
公投第１２案,新北市,中和區,正南里,1302,1166,390,234,624,38,662
公投第１２案,新北市,中和區,正南里,1303,963,349,195,544,30,574
公投第１２案,新北市,中和區,正南里,1304,1070,336,205,541,26,567
公投第１２案,新北市,中和區,頂南里,1305,1319,461,256,717,32,749
公投第１２案,新北市,中和區,頂南里,1306,1438,533,303,836,48,884
公投第１２案,新北市,中和區,華新里,1307,1808,583,336,919,28,947
公投第１２案,新北市,中和區,華新里,1308,1191,401,220,621,18,639
公投第１２案,新北市,中和區,華新里,1309,1632,521,342,863,48,911
公投第１２案,新北市,中和區,華新里,1310,1765,530,341,871,33,904
公投第１２案,新北市,中和區,東南里,1311,1168,449,222,671,32,703
公投第１２案,新北市,中和區,東南里,1312,1176,426,204,630,29,659
公投第１２案,新北市,中和區,東南里,1313,1565,622,322,944,47,991
公投第１２案,新北市,中和區,華南里,1314,1578,480,294,774,37,811
公投第１２案,新北市,中和區,華南里,1315,2029,664,404,1068,36,1104
公投第１２案,新北市,中和區,華南里,1316,905,290,199,489,35,524
公投第１２案,新北市,中和區,忠孝里,1317,839,263,152,415,26,441
公投第１２案,新北市,中和區,忠孝里,1318,762,255,180,435,18,453
公投第１２案,新北市,中和區,忠孝里,1319,1420,462,301,763,43,806
公投第１２案,新北市,中和區,忠孝里,1320,1272,411,242,653,47,700
公投第１２案,新北市,中和區,崇南里,1321,1976,604,383,987,59,1046
公投第１２案,新北市,中和區,崇南里,1322,1779,604,328,932,36,968
公投第１２案,新北市,中和區,興南里,1323,1454,432,254,686,32,718
公投第１２案,新北市,中和區,興南里,1324,1374,430,261,691,35,726
公投第１２案,新北市,中和區,景南里,1325,1369,413,258,671,26,697
公投第１２案,新北市,中和區,景南里,1326,1501,487,298,785,46,831
公投第１２案,新北市,中和區,景本里,1327,920,377,195,572,31,603
公投第１２案,新北市,中和區,景本里,1328,1050,390,233,623,31,654
公投第１２案,新北市,中和區,橫路里,1329,321,100,77,177,20,197
公投第１２案,新北市,中和區,內南里,1330,1474,462,278,740,49,789
公投第１２案,新北市,中和區,內南里,1331,1461,497,287,784,57,841
公投第１２案,新北市,中和區,內南里,1332,1621,516,323,839,40,879
公投第１２案,新北市,中和區,壽南里,1333,1327,487,287,774,48,822
公投第１２案,新北市,中和區,壽南里,1334,775,264,170,434,20,454
公投第１２案,新北市,中和區,福南里,1335,1916,549,376,925,40,965
公投第１２案,新北市,中和區,福南里,1336,1901,566,367,933,53,986
公投第１２案,新北市,中和區,外南里,1337,4411,481,277,758,41,799
公投第１２案,新北市,中和區,外南里,1338,1212,381,272,653,27,680
公投第１２案,新北市,中和區,外南里,1339,1126,403,230,633,20,653
公投第１２案,新北市,中和區,中興里,1340,1507,506,293,799,25,824
公投第１２案,新北市,中和區,中興里,1341,1519,515,307,822,23,845
公投第１２案,新北市,中和區,中興里,1342,1467,494,321,815,34,849
公投第１２案,新北市,中和區,中興里,1343,1453,543,296,839,48,887
公投第１２案,新北市,中和區,吉興里,1344,1364,493,300,793,33,826
公投第１２案,新北市,中和區,吉興里,1345,1302,430,272,702,36,738
公投第１２案,新北市,中和區,復興里,1346,1627,464,257,721,27,748
公投第１２案,新北市,中和區,復興里,1347,1503,497,306,803,30,833
公投第１２案,新北市,中和區,復興里,1348,1392,470,266,736,30,766
公投第１２案,新北市,中和區,和興里,1349,1067,370,234,604,34,638
公投第１２案,新北市,中和區,和興里,1350,1623,500,324,824,34,858
公投第１２案,新北市,中和區,和興里,1351,1208,402,273,675,28,703
公投第１２案,新北市,中和區,景平里,1352,1991,570,290,860,32,892
公投第１２案,新北市,中和區,景平里,1353,1932,555,322,877,25,902
公投第１２案,新北市,中和區,景平里,1354,947,372,249,621,18,639
公投第１２案,新北市,中和區,景新里,1355,1660,573,334,907,49,956
公投第１２案,新北市,中和區,景新里,1356,1574,480,272,752,34,786
公投第１２案,新北市,中和區,景福里,1357,2136,632,403,1035,32,1067
公投第１２案,新北市,中和區,景福里,1358,1462,423,302,725,57,782
公投第１２案,新北市,中和區,景福里,1359,1548,485,281,766,45,811
公投第１２案,新北市,中和區,景安里,1360,692,266,173,439,18,457
公投第１２案,新北市,中和區,景安里,1361,1221,451,272,723,48,771
公投第１２案,新北市,中和區,景安里,1362,1331,464,287,751,41,792
公投第１２案,新北市,中和區,景安里,1363,984,374,220,594,31,625
公投第１２案,新北市,中和區,景文里,1364,1871,576,343,919,27,946
公投第１２案,新北市,中和區,景文里,1365,1279,419,245,664,42,706
公投第１２案,新北市,中和區,錦和里,1366,1629,539,352,891,33,924
公投第１２案,新北市,中和區,錦和里,1367,1482,479,340,819,28,847
公投第１２案,新北市,中和區,錦和里,1368,1715,616,337,953,47,1000
公投第１２案,新北市,中和區,錦昌里,1369,1952,679,370,1049,47,1096
公投第１２案,新北市,中和區,灰磘里,1370,686,223,159,382,22,404
公投第１２案,新北市,中和區,積穗里,1371,1577,420,340,760,26,786
公投第１２案,新北市,中和區,積穗里,1372,1158,402,257,659,24,683
公投第１２案,新北市,中和區,積穗里,1373,1195,439,297,736,21,757
公投第１２案,新北市,中和區,積穗里,1374,1054,399,250,649,27,676
公投第１２案,新北市,中和區,積穗里,1375,612,223,155,378,20,398
公投第１２案,新北市,中和區,積穗里,1376,1668,558,384,942,26,968
公投第１２案,新北市,中和區,民享里,1377,1071,392,254,646,38,684
公投第１２案,新北市,中和區,民享里,1378,1169,476,291,767,39,806
公投第１２案,新北市,中和區,員山里,1379,1370,445,282,727,32,759
公投第１２案,新北市,中和區,員山里,1380,1574,557,342,899,54,953
公投第１２案,新北市,中和區,員山里,1381,2614,699,468,1167,26,1193
公投第１２案,新北市,中和區,嘉穗里,1382,1477,486,372,858,27,885
公投第１２案,新北市,中和區,嘉穗里,1383,1041,339,226,565,46,611
公投第１２案,新北市,中和區,文元里,1384,1538,465,323,788,39,827
公投第１２案,新北市,中和區,文元里,1385,1599,528,327,855,44,899
公投第１２案,新北市,中和區,文元里,1386,1586,577,312,889,54,943
公投第１２案,新北市,中和區,嘉新里,1387,1726,626,395,1021,50,1071
公投第１２案,新北市,中和區,嘉新里,1388,1854,597,459,1056,60,1116
公投第１２案,新北市,中和區,民安里,1389,1472,545,312,857,43,900
公投第１２案,新北市,中和區,民安里,1390,1430,517,320,837,37,874
公投第１２案,新北市,中和區,民安里,1391,1488,501,349,850,35,885
公投第１２案,新北市,中和區,安穗里,1392,1251,406,273,679,28,707
公投第１２案,新北市,中和區,安穗里,1393,1487,517,303,820,43,863
公投第１２案,新北市,中和區,安穗里,1394,1328,402,295,697,46,743
公投第１２案,新北市,中和區,瑞穗里,1395,1128,405,258,663,34,697
公投第１２案,新北市,中和區,瑞穗里,1396,1008,406,227,633,35,668
公投第１２案,新北市,中和區,明穗里,1397,1786,608,382,990,39,1029
公投第１２案,新北市,中和區,明穗里,1398,2219,653,459,1112,57,1169
公投第１２案,新北市,中和區,清穗里,1399,1322,427,263,690,33,723
公投第１２案,新北市,中和區,清穗里,1400,1495,532,297,829,19,848
公投第１２案,新北市,中和區,自強里,1401,1414,489,261,750,42,792
公投第１２案,新北市,中和區,自強里,1402,1681,592,333,925,55,980
公投第１２案,新北市,中和區,自強里,1403,1361,447,290,737,45,782
公投第１２案,新北市,中和區,德穗里,1404,1442,482,289,771,37,808
公投第１２案,新北市,中和區,德穗里,1405,1383,437,287,724,28,752
公投第１２案,新北市,中和區,德穗里,1406,1264,452,251,703,30,733
公投第１２案,新北市,中和區,民生里,1407,1810,634,398,1032,64,1096
公投第１２案,新北市,中和區,民生里,1408,1951,558,381,939,37,976
公投第１２案,新北市,中和區,國光里,1409,1582,520,264,784,35,819
公投第１２案,新北市,中和區,國光里,1410,1945,695,399,1094,58,1152
公投第１２案,新北市,中和區,壽德里,1411,1390,454,316,770,44,814
公投第１２案,新北市,中和區,壽德里,1412,1161,398,262,660,15,675
公投第１２案,新北市,中和區,壽德里,1413,1399,510,233,743,33,776
公投第１２案,新北市,中和區,明德里,1414,1070,368,217,585,32,617
公投第１２案,新北市,中和區,明德里,1415,1169,406,234,640,29,669
公投第１２案,新北市,中和區,明德里,1416,1214,453,278,731,39,770
公投第１２案,新北市,中和區,錦中里,1417,1398,467,315,782,41,823
公投第１２案,新北市,中和區,錦中里,1418,1049,354,236,590,26,616
公投第１２案,新北市,中和區,錦中里,1419,1324,532,258,790,40,830
公投第１２案,新北市,中和區,錦盛里,1420,1765,521,330,851,19,870
公投第１２案,新北市,中和區,錦盛里,1421,1709,513,340,853,46,899
公投第１２案,新北市,中和區,民有里,1422,1186,399,250,649,47,696
公投第１２案,新北市,中和區,民有里,1423,1318,492,269,761,26,787
公投第１２案,新北市,中和區,員富里,1424,1430,446,349,795,34,829
公投第１２案,新北市,中和區,員富里,1425,1637,417,285,702,27,729
公投第１２案,新北市,中和區,嘉慶里,1426,1283,443,272,715,41,756
公投第１２案,新北市,中和區,嘉慶里,1427,1310,438,286,724,39,763
公投第１２案,新北市,中和區,嘉慶里,1428,1301,468,266,734,34,768
公投第１２案,新北市,中和區,冠穗里,1429,1681,566,381,947,42,989
公投第１２案,新北市,中和區,冠穗里,1430,1384,488,304,792,27,819
公投第１２案,新北市,中和區,國華里,1431,1187,380,280,660,26,686
公投第１２案,新北市,中和區,國華里,1432,1779,484,314,798,11,809
公投第１２案,新北市,中和區,宜安里,1433,1712,589,323,912,46,958
公投第１２案,新北市,中和區,安樂里,1434,1462,450,302,752,45,797
公投第１２案,新北市,中和區,安樂里,1435,1824,579,362,941,24,965
公投第１２案,新北市,中和區,安和里,1436,1389,428,302,730,47,777
公投第１２案,新北市,中和區,安和里,1437,1434,506,300,806,39,845
公投第１２案,新北市,中和區,安順里,1438,1953,629,373,1002,55,1057
公投第１２案,新北市,中和區,安順里,1439,2002,630,432,1062,58,1120
公投第１２案,新北市,中和區,安平里,1440,1858,672,312,984,30,1014
公投第１２案,新北市,中和區,安平里,1441,1801,506,342,848,30,878
公投第１２案,新北市,中和區,安平里,1442,1691,602,331,933,47,980
公投第１２案,新北市,中和區,中安里,1443,1363,485,292,777,36,813
公投第１２案,新北市,中和區,中安里,1444,1220,470,276,746,28,774
公投第１２案,新北市,中和區,中安里,1445,1365,541,297,838,32,870
公投第１２案,新北市,中和區,泰安里,1446,1178,418,251,669,23,692
公投第１２案,新北市,中和區,泰安里,1447,830,310,172,482,28,510
公投第１２案,新北市,中和區,泰安里,1448,1197,350,256,606,34,640
公投第１２案,新北市,中和區,秀山里,1449,1369,486,274,760,43,803
公投第１２案,新北市,中和區,秀山里,1450,1336,476,295,771,33,804
公投第１２案,新北市,中和區,秀山里,1451,1377,538,287,825,40,865
公投第１２案,新北市,中和區,秀成里,1452,1499,535,311,846,38,884
公投第１２案,新北市,中和區,秀成里,1453,1689,606,366,972,39,1011
公投第１２案,新北市,中和區,秀義里,1454,1323,446,317,763,35,798
公投第１２案,新北市,中和區,秀義里,1455,1079,396,266,662,19,681
公投第１２案,新北市,中和區,秀福里,1456,1545,514,352,866,43,909
公投第１２案,新北市,中和區,秀福里,1457,1326,426,279,705,37,742
公投第１２案,新北市,中和區,秀福里,1458,1443,469,292,761,35,796
公投第１２案,新北市,中和區,秀景里,1459,1712,595,330,925,36,961
公投第１２案,新北市,中和區,秀景里,1460,1916,625,384,1009,40,1049
公投第１２案,新北市,中和區,秀景里,1461,863,324,185,509,32,541
公投第１２案,新北市,中和區,秀景里,1462,1203,462,267,729,6,735
公投第１２案,新北市,中和區,秀明里,1463,1483,494,284,778,25,803
公投第１２案,新北市,中和區,秀明里,1464,1575,539,285,824,25,849
公投第１２案,新北市,中和區,秀明里,1465,1432,452,244,696,25,721
公投第１２案,新北市,中和區,秀峰里,1466,1441,447,318,765,50,815
公投第１２案,新北市,中和區,秀峰里,1467,1269,433,279,712,45,757
公投第１２案,新北市,中和區,秀峰里,1468,1363,491,292,783,29,812
公投第１２案,新北市,中和區,秀士里,1469,1089,411,213,624,19,643
公投第１２案,新北市,中和區,秀士里,1470,1171,363,235,598,28,626
公投第１２案,新北市,中和區,秀水里,1471,1150,408,243,651,37,688
公投第１２案,新北市,中和區,秀水里,1472,1154,438,255,693,31,724
公投第１２案,新北市,中和區,秀水里,1473,1067,437,211,648,16,664
公投第１２案,新北市,中和區,秀仁里,1474,1526,492,297,789,36,825
公投第１２案,新北市,中和區,秀仁里,1475,1447,511,311,822,27,849
公投第１２案,新北市,永和區,光復里,1476,1554,514,351,865,57,922
公投第１２案,新北市,永和區,網溪里,1477,1065,406,215,621,18,639
公投第１２案,新北市,永和區,復興里,1478,854,332,184,516,27,543
公投第１２案,新北市,永和區,復興里,1479,1253,468,256,724,35,759
公投第１２案,新北市,永和區,竹林里,1480,1733,556,402,958,35,993
公投第１２案,新北市,永和區,竹林里,1481,1581,530,328,858,39,897
公投第１２案,新北市,永和區,桂林里,1482,1735,589,325,914,45,959
公投第１２案,新北市,永和區,桂林里,1483,1563,525,296,821,25,846
公投第１２案,新北市,永和區,上林里,1484,1650,520,362,882,61,943
公投第１２案,新北市,永和區,上林里,1485,1454,507,290,797,33,830
公投第１２案,新北市,永和區,福林里,1486,1568,470,327,797,40,837
公投第１２案,新北市,永和區,福林里,1487,1444,473,284,757,30,787
公投第１２案,新北市,永和區,勵行里,1488,1140,341,259,600,47,647
公投第１２案,新北市,永和區,中興里,1489,1188,460,245,705,32,737
公投第１２案,新北市,永和區,中興里,1490,1516,496,311,807,47,854
公投第１２案,新北市,永和區,永興里,1491,1397,467,270,737,40,777
公投第１２案,新北市,永和區,永興里,1492,1438,477,307,784,36,820
公投第１２案,新北市,永和區,正興里,1493,1084,381,244,625,29,654
公投第１２案,新北市,永和區,正興里,1494,941,342,196,538,18,556
公投第１２案,新北市,永和區,豫溪里,1495,1598,534,318,852,27,879
公投第１２案,新北市,永和區,豫溪里,1496,2842,505,328,833,34,867
公投第１２案,新北市,永和區,光明里,1497,1261,450,303,753,37,790
公投第１２案,新北市,永和區,光明里,1498,1449,551,341,892,36,928
公投第１２案,新北市,永和區,福和里,1499,1511,575,280,855,33,888
公投第１２案,新北市,永和區,福和里,1500,1470,574,315,889,36,925
公投第１２案,新北市,永和區,福和里,1501,1580,564,323,887,29,916
公投第１２案,新北市,永和區,得和里,1502,1438,532,346,878,31,909
公投第１２案,新北市,永和區,得和里,1503,1305,519,283,802,28,830
公投第１２案,新北市,永和區,得和里,1504,1046,406,230,636,23,659
公投第１２案,新北市,永和區,永貞里,1505,1566,551,361,912,16,928
公投第１２案,新北市,永和區,永貞里,1506,1468,511,329,840,29,869
公投第１２案,新北市,永和區,永福里,1507,1305,511,313,824,34,858
公投第１２案,新北市,永和區,永福里,1508,1181,410,289,699,32,731
公投第１２案,新北市,永和區,河濱里,1509,1720,555,357,912,43,955
公投第１２案,新北市,永和區,河濱里,1510,1103,413,274,687,28,715
公投第１２案,新北市,永和區,秀和里,1511,1649,553,348,901,68,969
公投第１２案,新北市,永和區,秀和里,1512,1206,424,302,726,28,754
公投第１２案,新北市,永和區,秀和里,1513,1506,514,378,892,28,920
公投第１２案,新北市,永和區,永元里,1514,1488,534,316,850,38,888
公投第１２案,新北市,永和區,永元里,1515,1288,445,310,755,51,806
公投第１２案,新北市,永和區,永元里,1516,1413,401,325,726,30,756
公投第１２案,新北市,永和區,民權里,1517,1329,461,274,735,41,776
公投第１２案,新北市,永和區,民權里,1518,1436,555,305,860,30,890
公投第１２案,新北市,永和區,民權里,1519,1112,387,242,629,36,665
公投第１２案,新北市,永和區,民族里,1520,1100,463,249,712,34,746
公投第１２案,新北市,永和區,民族里,1521,1545,510,411,921,39,960
公投第１２案,新北市,永和區,民族里,1522,1436,509,306,815,25,840
公投第１２案,新北市,永和區,秀朗里,1523,1731,642,388,1030,55,1085
公投第１２案,新北市,永和區,秀朗里,1524,1762,628,387,1015,68,1083
公投第１２案,新北市,永和區,秀成里,1525,1320,421,293,714,35,749
公投第１２案,新北市,永和區,秀成里,1526,1297,400,235,635,16,651
公投第１２案,新北市,永和區,秀林里,1527,1798,538,429,967,47,1014
公投第１２案,新北市,永和區,秀林里,1528,1491,501,366,867,42,909
公投第１２案,新北市,永和區,秀得里,1529,1223,419,260,679,24,703
公投第１２案,新北市,永和區,秀得里,1530,1108,391,255,646,12,658
公投第１２案,新北市,永和區,秀元里,1531,1408,511,322,833,30,863
公投第１２案,新北市,永和區,秀元里,1532,1265,451,276,727,46,773
公投第１２案,新北市,永和區,民生里,1533,1115,382,232,614,20,634
公投第１２案,新北市,永和區,民生里,1534,1133,447,245,692,36,728
公投第１２案,新北市,永和區,民生里,1535,1217,437,256,693,47,740
公投第１２案,新北市,永和區,民本里,1536,1713,534,388,922,44,966
公投第１２案,新北市,永和區,民本里,1537,1721,542,361,903,46,949
公投第１２案,新北市,永和區,民富里,1538,1327,439,274,713,41,754
公投第１２案,新北市,永和區,民富里,1539,1257,477,295,772,18,790
公投第１２案,新北市,永和區,民樂里,1540,1348,482,329,811,43,854
公投第１２案,新北市,永和區,民樂里,1541,1461,577,316,893,37,930
公投第１２案,新北市,永和區,民樂里,1542,1368,474,303,777,42,819
公投第１２案,新北市,永和區,民治里,1543,1234,445,238,683,41,724
公投第１２案,新北市,永和區,民治里,1544,1303,458,271,729,37,766
公投第１２案,新北市,永和區,智光里,1545,1516,528,309,837,23,860
公投第１２案,新北市,永和區,智光里,1546,1422,550,276,826,50,876
公投第１２案,新北市,永和區,潭安里,1547,991,369,211,580,22,602
公投第１２案,新北市,永和區,潭安里,1548,1016,383,237,620,19,639
公投第１２案,新北市,永和區,潭安里,1549,1146,432,238,670,23,693
公投第１２案,新北市,永和區,潭安里,1550,1043,417,205,622,18,640
公投第１２案,新北市,永和區,潭墘里,1551,1210,442,281,723,26,749
公投第１２案,新北市,永和區,潭墘里,1552,1630,586,345,931,26,957
公投第１２案,新北市,永和區,潭墘里,1553,1092,349,295,644,23,667
公投第１２案,新北市,永和區,店街里,1554,1872,660,401,1061,48,1109
公投第１２案,新北市,永和區,店街里,1555,1781,632,360,992,29,1021
公投第１２案,新北市,永和區,大新里,1556,1049,387,240,627,26,653
公投第１２案,新北市,永和區,大新里,1557,1285,480,308,788,32,820
公投第１２案,新北市,永和區,永安里,1558,1209,435,291,726,28,754
公投第１２案,新北市,永和區,永安里,1559,1132,420,265,685,25,710
公投第１２案,新北市,永和區,永安里,1560,1287,474,305,779,32,811
公投第１２案,新北市,永和區,永樂里,1561,1068,375,253,628,44,672
公投第１２案,新北市,永和區,永樂里,1562,1098,380,273,653,45,698
公投第１２案,新北市,永和區,水源里,1563,1222,462,262,724,45,769
公投第１２案,新北市,永和區,水源里,1564,1157,446,238,684,36,720
公投第１２案,新北市,永和區,水源里,1565,1168,404,320,724,41,765
公投第１２案,新北市,永和區,協和里,1566,1283,417,296,713,41,754
公投第１２案,新北市,永和區,協和里,1567,1372,441,303,744,29,773
公投第１２案,新北市,永和區,雙和里,1568,1876,671,418,1089,45,1134
公投第１２案,新北市,永和區,雙和里,1569,1576,598,347,945,59,1004
公投第１２案,新北市,永和區,安和里,1570,1661,600,361,961,38,999
公投第１２案,新北市,永和區,安和里,1571,1808,606,401,1007,28,1035
公投第１２案,新北市,永和區,前溪里,1572,1898,640,391,1031,59,1090
公投第１２案,新北市,永和區,和平里,1573,1508,547,349,896,38,934
公投第１２案,新北市,永和區,和平里,1574,1341,487,309,796,41,837
公投第１２案,新北市,永和區,和平里,1575,1422,500,293,793,46,839
公投第１２案,新北市,永和區,保平里,1576,1177,404,260,664,29,693
公投第１２案,新北市,永和區,保平里,1577,1557,534,343,877,48,925
公投第１２案,新北市,永和區,保平里,1578,1491,474,320,794,34,828
公投第１２案,新北市,永和區,中溪里,1579,1586,542,337,879,32,911
公投第１２案,新北市,永和區,中溪里,1580,1313,459,260,719,13,732
公投第１２案,新北市,永和區,中溪里,1581,1636,524,380,904,35,939
公投第１２案,新北市,永和區,保安里,1582,1598,526,353,879,50,929
公投第１２案,新北市,永和區,保安里,1583,1609,551,383,934,37,971
公投第１２案,新北市,永和區,保安里,1584,1375,485,322,807,44,851
公投第１２案,新北市,永和區,保安里,1585,1648,586,417,1003,35,1038
公投第１２案,新北市,永和區,保順里,1586,1077,371,258,629,29,658
公投第１２案,新北市,永和區,保順里,1587,1157,417,263,680,24,704
公投第１２案,新北市,永和區,保順里,1588,1339,513,315,828,26,854
公投第１２案,新北市,永和區,保順里,1589,1306,483,313,796,13,809
公投第１２案,新北市,永和區,保順里,1590,1236,490,282,772,13,785
公投第１２案,新北市,永和區,保順里,1591,1133,425,256,681,23,704
公投第１２案,新北市,永和區,保順里,1592,1425,524,313,837,29,866
公投第１２案,新北市,永和區,下溪里,1593,1938,654,397,1051,66,1117
公投第１２案,新北市,永和區,下溪里,1594,1607,562,359,921,41,962
公投第１２案,新北市,永和區,大同里,1595,853,322,185,507,21,528
公投第１２案,新北市,永和區,新生里,1596,768,255,140,395,34,429
公投第１２案,新北市,永和區,永成里,1597,893,287,149,436,24,460
公投第１２案,新北市,永和區,忠義里,1598,743,268,140,408,29,437
公投第１２案,新北市,永和區,仁愛里,1599,1155,409,273,682,38,720
公投第１２案,新北市,永和區,仁愛里,1600,1263,454,297,751,40,791
公投第１２案,新北市,永和區,文化里,1601,1189,444,270,714,24,738
公投第１２案,新北市,永和區,文化里,1602,1346,427,294,721,44,765
公投第１２案,新北市,永和區,信義里,1603,1368,434,313,747,37,784
公投第１２案,新北市,永和區,信義里,1604,1043,377,234,611,13,624
公投第１２案,新北市,永和區,後溪里,1605,1709,597,398,995,41,1036
公投第１２案,新北市,永和區,上溪里,1606,879,277,192,469,16,485
公投第１２案,新北市,永和區,上溪里,1607,904,293,224,517,24,541
公投第１２案,新北市,永和區,頂溪里,1608,1221,478,257,735,44,779
公投第１２案,新北市,永和區,頂溪里,1609,1018,361,248,609,33,642
公投第１２案,新北市,永和區,河堤里,1610,1551,499,357,856,28,884
公投第１２案,新北市,永和區,河堤里,1611,1428,493,329,822,42,864
公投第１２案,新北市,永和區,新廍里,1612,1044,363,239,602,46,648
公投第１２案,新北市,永和區,新廍里,1613,967,344,231,575,34,609
公投第１２案,新北市,樹林區,三興里,1614,1408,399,298,697,47,744
公投第１２案,新北市,樹林區,三興里,1615,1310,407,269,676,26,702
公投第１２案,新北市,樹林區,三興里,1616,1534,419,289,708,51,759
公投第１２案,新北市,樹林區,三福里,1617,1211,386,237,623,54,677
公投第１２案,新北市,樹林區,三福里,1618,1125,366,258,624,39,663
公投第１２案,新北市,樹林區,三福里,1619,1134,431,229,660,26,686
公投第１２案,新北市,樹林區,三多里,1620,1897,456,370,826,68,894
公投第１２案,新北市,樹林區,三多里,1621,1716,483,383,866,49,915
公投第１２案,新北市,樹林區,三龍里,1622,736,234,187,421,38,459
公投第１２案,新北市,樹林區,三龍里,1623,1137,376,302,678,17,695
公投第１２案,新北市,樹林區,獇寮里,1624,1542,431,340,771,34,805
公投第１２案,新北市,樹林區,獇寮里,1625,1470,443,325,768,52,820
公投第１２案,新北市,樹林區,獇寮里,1626,1456,415,279,694,26,720
公投第１２案,新北市,樹林區,光興里,1627,1124,363,258,621,26,647
公投第１２案,新北市,樹林區,光興里,1628,1235,359,276,635,23,658
公投第１２案,新北市,樹林區,光興里,1629,1212,338,316,654,31,685
公投第１２案,新北市,樹林區,金寮里,1630,1223,357,233,590,46,636
公投第１２案,新北市,樹林區,金寮里,1631,1335,406,279,685,51,736
公投第１２案,新北市,樹林區,金寮里,1632,1206,353,281,634,33,667
公投第１２案,新北市,樹林區,潭底里,1633,1927,381,265,646,62,708
公投第１２案,新北市,樹林區,潭底里,1634,914,288,198,486,37,523
公投第１２案,新北市,樹林區,潭底里,1635,1456,482,316,798,44,842
公投第１２案,新北市,樹林區,文林里,1636,1409,461,262,723,45,768
公投第１２案,新北市,樹林區,文林里,1637,1500,532,320,852,49,901
公投第１２案,新北市,樹林區,文林里,1638,1545,490,339,829,38,867
公投第１２案,新北市,樹林區,保安里,1639,1483,420,340,760,27,787
公投第１２案,新北市,樹林區,保安里,1640,1524,511,297,808,27,835
公投第１２案,新北市,樹林區,保安里,1641,1431,462,308,770,38,808
公投第１２案,新北市,樹林區,保安里,1642,1181,373,249,622,34,656
公投第１２案,新北市,樹林區,圳安里,1643,1116,343,264,607,45,652
公投第１２案,新北市,樹林區,圳安里,1644,1077,289,250,539,26,565
公投第１２案,新北市,樹林區,圳安里,1645,1103,295,260,555,19,574
公投第１２案,新北市,樹林區,圳福里,1646,1385,401,330,731,45,776
公投第１２案,新北市,樹林區,圳福里,1647,1266,370,276,646,30,676
公投第１２案,新北市,樹林區,圳福里,1648,1195,335,281,616,38,654
公投第１２案,新北市,樹林區,圳民里,1649,1254,347,294,641,45,686
公投第１２案,新北市,樹林區,圳民里,1650,1263,388,319,707,26,733
公投第１２案,新北市,樹林區,圳生里,1651,1473,456,380,836,65,901
公投第１２案,新北市,樹林區,樹德里,1652,870,292,185,477,25,502
公投第１２案,新北市,樹林區,樹德里,1653,1338,440,325,765,54,819
公投第１２案,新北市,樹林區,樹德里,1654,1010,316,213,529,35,564
公投第１２案,新北市,樹林區,樹福里,1655,1658,525,408,933,41,974
公投第１２案,新北市,樹林區,樹福里,1656,1538,535,381,916,54,970
公投第１２案,新北市,樹林區,樹西里,1657,1405,489,352,841,48,889
公投第１２案,新北市,樹林區,樹西里,1658,1587,489,350,839,51,890
公投第１２案,新北市,樹林區,樹西里,1659,1566,493,367,860,31,891
公投第１２案,新北市,樹林區,樹興里,1660,997,306,216,522,15,537
公投第１２案,新北市,樹林區,樹興里,1661,1187,380,256,636,51,687
公投第１２案,新北市,樹林區,樹興里,1662,1061,315,227,542,39,581
公投第１２案,新北市,樹林區,樹人里,1663,1701,578,368,946,37,983
公投第１２案,新北市,樹林區,樹人里,1664,1278,415,267,682,43,725
公投第１２案,新北市,樹林區,育英里,1665,1433,523,305,828,41,869
公投第１２案,新北市,樹林區,育英里,1666,1306,454,298,752,52,804
公投第１２案,新北市,樹林區,樹南里,1667,1268,443,286,729,52,781
公投第１２案,新北市,樹林區,樹南里,1668,1281,414,315,729,24,753
公投第１２案,新北市,樹林區,樹南里,1669,1200,374,303,677,40,717
公投第１２案,新北市,樹林區,坡內里,1670,1491,450,320,770,33,803
公投第１２案,新北市,樹林區,樹東里,1671,1066,331,218,549,30,579
公投第１２案,新北市,樹林區,樹北里,1672,877,302,205,507,52,559
公投第１２案,新北市,樹林區,彭福里,1673,1616,516,308,824,53,877
公投第１２案,新北市,樹林區,彭福里,1674,1589,393,310,703,45,748
公投第１２案,新北市,樹林區,彭福里,1675,1367,466,296,762,33,795
公投第１２案,新北市,樹林區,和平里,1676,1144,396,264,660,28,688
公投第１２案,新北市,樹林區,和平里,1677,1059,332,207,539,31,570
公投第１２案,新北市,樹林區,和平里,1678,1224,372,249,621,57,678
公投第１２案,新北市,樹林區,彭興里,1679,1141,334,214,548,34,582
公投第１２案,新北市,樹林區,彭興里,1680,1396,389,249,638,22,660
公投第１２案,新北市,樹林區,彭興里,1681,1157,333,269,602,35,637
公投第１２案,新北市,樹林區,彭興里,1682,1498,403,310,713,64,777
公投第１２案,新北市,樹林區,彭厝里,1683,1514,433,344,777,58,835
公投第１２案,新北市,樹林區,彭厝里,1684,1546,442,310,752,32,784
公投第１２案,新北市,樹林區,彭厝里,1685,1392,425,313,738,43,781
公投第１２案,新北市,樹林區,大同里,1686,1566,506,348,854,34,888
公投第１２案,新北市,樹林區,大同里,1687,1566,491,328,819,41,860
公投第１２案,新北市,樹林區,中華里,1688,1517,454,338,792,42,834
公投第１２案,新北市,樹林區,中華里,1689,1481,456,347,803,19,822
公投第１２案,新北市,樹林區,太順里,1690,1261,374,278,652,28,680
公投第１２案,新北市,樹林區,太順里,1691,1163,352,234,586,31,617
公投第１２案,新北市,樹林區,東昇里,1692,1661,547,387,934,64,998
公投第１２案,新北市,樹林區,東昇里,1693,1585,435,428,863,37,900
公投第１２案,新北市,樹林區,東昇里,1694,1018,392,194,586,32,618
公投第１２案,新北市,樹林區,東陽里,1695,1247,367,275,642,56,698
公投第１２案,新北市,樹林區,東陽里,1696,1390,428,271,699,56,755
公投第１２案,新北市,樹林區,東陽里,1697,1293,405,306,711,35,746
公投第１２案,新北市,樹林區,東陽里,1698,1301,379,281,660,32,692
公投第１２案,新北市,樹林區,東山里,1699,1606,430,385,815,42,857
公投第１２案,新北市,樹林區,東山里,1700,1277,378,268,646,62,708
公投第１２案,新北市,樹林區,山佳里,1701,1219,393,260,653,43,696
公投第１２案,新北市,樹林區,山佳里,1702,1454,442,294,736,34,770
公投第１２案,新北市,樹林區,山佳里,1703,1314,429,244,673,31,704
公投第１２案,新北市,樹林區,山佳里,1704,1008,378,244,622,18,640
公投第１２案,新北市,樹林區,中山里,1705,1574,467,322,789,60,849
公投第１２案,新北市,樹林區,中山里,1706,1364,463,298,761,33,794
公投第１２案,新北市,樹林區,中山里,1707,1677,497,314,811,50,861
公投第１２案,新北市,樹林區,樂山里,1708,1683,464,294,758,21,779
公投第１２案,新北市,樹林區,柑園里,1709,1452,460,333,793,51,844
公投第１２案,新北市,樹林區,柑園里,1710,1592,526,369,895,25,920
公投第１２案,新北市,樹林區,柑園里,1711,1619,539,371,910,30,940
公投第１２案,新北市,樹林區,柑園里,1712,1642,631,336,967,38,1005
公投第１２案,新北市,樹林區,柑園里,1713,1357,470,276,746,16,762
公投第１２案,新北市,樹林區,西園里,1714,1638,500,372,872,71,943
公投第１２案,新北市,樹林區,南園里,1715,1592,461,381,842,33,875
公投第１２案,新北市,樹林區,南園里,1716,1521,566,289,855,33,888
公投第１２案,新北市,樹林區,南園里,1717,1707,618,373,991,42,1033
公投第１２案,新北市,樹林區,南園里,1718,1741,587,366,953,59,1012
公投第１２案,新北市,樹林區,南園里,1719,1655,570,327,897,32,929
公投第１２案,新北市,樹林區,南園里,1720,1775,521,345,866,46,912
公投第１２案,新北市,樹林區,南園里,1721,1781,674,338,1012,39,1051
公投第１２案,新北市,樹林區,東園里,1722,1565,414,301,715,38,753
公投第１２案,新北市,樹林區,北園里,1723,936,247,223,470,32,502
公投第１２案,新北市,樹林區,北園里,1724,1030,334,243,577,21,598
公投第１２案,新北市,鶯歌區,建德里,1725,515,162,124,286,14,300
公投第１２案,新北市,鶯歌區,東鶯里,1726,965,331,223,554,31,585
公投第１２案,新北市,鶯歌區,北鶯里,1727,1931,582,425,1007,57,1064
公投第１２案,新北市,鶯歌區,北鶯里,1728,1797,497,356,853,41,894
公投第１２案,新北市,鶯歌區,西鶯里,1729,1057,345,221,566,34,600
公投第１２案,新北市,鶯歌區,西鶯里,1730,962,283,202,485,20,505
公投第１２案,新北市,鶯歌區,中鶯里,1731,934,347,221,568,18,586
公投第１２案,新北市,鶯歌區,南鶯里,1732,1742,609,405,1014,49,1063
公投第１２案,新北市,鶯歌區,南鶯里,1733,1634,502,340,842,33,875
公投第１２案,新北市,鶯歌區,南鶯里,1734,1676,517,320,837,31,868
公投第１２案,新北市,鶯歌區,建國里,1735,2052,632,456,1088,53,1141
公投第１２案,新北市,鶯歌區,建國里,1736,1977,524,396,920,27,947
公投第１２案,新北市,鶯歌區,建國里,1737,1957,612,425,1037,24,1061
公投第１２案,新北市,鶯歌區,二甲里,1738,850,266,160,426,16,442
公投第１２案,新北市,鶯歌區,二橋里,1739,1782,510,369,879,34,913
公投第１２案,新北市,鶯歌區,二橋里,1740,1496,441,324,765,37,802
公投第１２案,新北市,鶯歌區,二橋里,1741,2071,586,411,997,35,1032
公投第１２案,新北市,鶯歌區,二橋里,1742,1753,427,329,756,34,790
公投第１２案,新北市,鶯歌區,尖山里,1743,1737,530,340,870,32,902
公投第１２案,新北市,鶯歌區,尖山里,1744,1669,469,330,799,47,846
公投第１２案,新北市,鶯歌區,尖山里,1745,1842,481,346,827,28,855
公投第１２案,新北市,鶯歌區,尖山里,1746,1454,411,304,715,34,749
公投第１２案,新北市,鶯歌區,南靖里,1747,942,265,217,482,27,509
公投第１２案,新北市,鶯歌區,南靖里,1748,1317,362,296,658,47,705
公投第１２案,新北市,鶯歌區,南靖里,1749,949,289,177,466,17,483
公投第１２案,新北市,鶯歌區,同慶里,1750,1440,471,327,798,44,842
公投第１２案,新北市,鶯歌區,永昌里,1751,1809,556,387,943,49,992
公投第１２案,新北市,鶯歌區,永昌里,1752,1758,538,406,944,45,989
公投第１２案,新北市,鶯歌區,永昌里,1753,1589,487,339,826,41,867
公投第１２案,新北市,鶯歌區,永昌里,1754,1067,359,240,599,39,638
公投第１２案,新北市,鶯歌區,永昌里,1755,1092,341,275,616,31,647
公投第１２案,新北市,鶯歌區,永吉里,1756,1730,571,370,941,35,976
公投第１２案,新北市,鶯歌區,永吉里,1757,1281,436,251,687,27,714
公投第１２案,新北市,鶯歌區,永吉里,1758,1238,431,309,740,34,774
公投第１２案,新北市,鶯歌區,鳳祥里,1759,1568,476,343,819,50,869
公投第１２案,新北市,鶯歌區,鳳祥里,1760,1271,400,251,651,32,683
公投第１２案,新北市,鶯歌區,鳳祥里,1761,1183,317,199,516,19,535
公投第１２案,新北市,鶯歌區,鳳鳴里,1762,1026,299,197,496,24,520
公投第１２案,新北市,鶯歌區,鳳鳴里,1763,1721,481,347,828,35,863
公投第１２案,新北市,鶯歌區,鳳鳴里,1764,1317,367,273,640,50,690
公投第１２案,新北市,鶯歌區,鳳福里,1765,1046,337,252,589,39,628
公投第１２案,新北市,鶯歌區,鳳福里,1766,1144,364,286,650,39,689
公投第１２案,新北市,鶯歌區,鳳福里,1767,1336,380,268,648,50,698
公投第１２案,新北市,鶯歌區,大湖里,1768,1479,376,280,656,60,716
公投第１２案,新北市,鶯歌區,大湖里,1769,1736,450,398,848,58,906
公投第１２案,新北市,鶯歌區,大湖里,1770,1389,458,200,658,56,714
公投第１２案,新北市,鶯歌區,中湖里,1771,1956,574,395,969,66,1035
公投第１２案,新北市,鶯歌區,中湖里,1772,1371,359,361,720,44,764
公投第１２案,新北市,鶯歌區,中湖里,1773,1810,419,287,706,30,736
公投第１２案,新北市,鶯歌區,東湖里,1774,227,88,38,126,7,133
公投第１２案,新北市,土城區,祖田里,1775,1505,431,314,745,59,804
公投第１２案,新北市,土城區,頂新里,1776,1242,427,296,723,27,750
公投第１２案,新北市,土城區,頂新里,1777,1206,428,270,698,18,716
公投第１２案,新北市,土城區,頂福里,1778,1474,450,308,758,56,814
公投第１２案,新北市,土城區,頂福里,1779,1489,422,305,727,42,769
公投第１２案,新北市,土城區,頂福里,1780,1675,482,339,821,44,865
公投第１２案,新北市,土城區,頂埔里,1781,1499,479,309,788,37,825
公投第１２案,新北市,土城區,頂埔里,1782,1495,453,305,758,24,782
公投第１２案,新北市,土城區,頂埔里,1783,1411,425,270,695,65,760
公投第１２案,新北市,土城區,沛陂里,1784,1378,405,273,678,30,708
公投第１２案,新北市,土城區,沛陂里,1785,1256,360,274,634,34,668
公投第１２案,新北市,土城區,沛陂里,1786,1379,438,310,748,42,790
公投第１２案,新北市,土城區,永寧里,1787,1424,389,310,699,41,740
公投第１２案,新北市,土城區,永寧里,1788,1455,429,312,741,45,786
公投第１２案,新北市,土城區,永寧里,1789,1419,390,314,704,31,735
公投第１２案,新北市,土城區,永寧里,1790,1357,478,299,777,31,808
公投第１２案,新北市,土城區,永寧里,1791,1501,451,318,769,34,803
公投第１２案,新北市,土城區,大安里,1792,1206,398,255,653,51,704
公投第１２案,新北市,土城區,大安里,1793,1255,421,281,702,28,730
公投第１２案,新北市,土城區,大安里,1794,1869,527,384,911,58,969
公投第１２案,新北市,土城區,員仁里,1795,1292,434,262,696,27,723
公投第１２案,新北市,土城區,員仁里,1796,1324,406,275,681,31,712
公投第１２案,新北市,土城區,員仁里,1797,1155,342,233,575,42,617
公投第１２案,新北市,土城區,員仁里,1798,1183,334,276,610,48,658
公投第１２案,新北市,土城區,埤塘里,1799,2518,298,221,519,26,545
公投第１２案,新北市,土城區,埤塘里,1800,1218,389,243,632,33,665
公投第１２案,新北市,土城區,埤塘里,1801,1133,383,227,610,41,651
公投第１２案,新北市,土城區,土城里,1802,894,305,179,484,20,504
公投第１２案,新北市,土城區,土城里,1803,931,313,204,517,32,549
公投第１２案,新北市,土城區,長風里,1804,1820,709,387,1096,59,1155
公投第１２案,新北市,土城區,員信里,1805,1320,420,273,693,27,720
公投第１２案,新北市,土城區,員信里,1806,1241,377,263,640,23,663
公投第１２案,新北市,土城區,員信里,1807,1414,425,319,744,38,782
公投第１２案,新北市,土城區,員林里,1808,1378,419,332,751,35,786
公投第１２案,新北市,土城區,員林里,1809,1421,443,338,781,48,829
公投第１２案,新北市,土城區,員林里,1810,1340,435,263,698,43,741
公投第１２案,新北市,土城區,員林里,1811,1144,375,268,643,37,680
公投第１２案,新北市,土城區,員福里,1812,1268,406,281,687,41,728
公投第１２案,新北市,土城區,員福里,1813,1196,386,249,635,57,692
公投第１２案,新北市,土城區,員福里,1814,1308,432,319,751,28,779
公投第１２案,新北市,土城區,員福里,1815,1175,387,244,631,43,674
公投第１２案,新北市,土城區,日和里,1816,1230,387,266,653,41,694
公投第１２案,新北市,土城區,日和里,1817,1342,412,328,740,34,774
公投第１２案,新北市,土城區,日和里,1818,1268,419,291,710,42,752
公投第１２案,新北市,土城區,日和里,1819,1227,421,292,713,63,776
公投第１２案,新北市,土城區,日新里,1820,1356,449,267,716,63,779
公投第１２案,新北市,土城區,日新里,1821,1496,473,323,796,47,843
公投第１２案,新北市,土城區,日新里,1822,1309,436,252,688,57,745
公投第１２案,新北市,土城區,裕生里,1823,1175,383,277,660,47,707
公投第１２案,新北市,土城區,裕生里,1824,1237,388,271,659,41,700
公投第１２案,新北市,土城區,裕生里,1825,1256,446,243,689,38,727
公投第１２案,新北市,土城區,裕生里,1826,1228,372,274,646,22,668
公投第１２案,新北市,土城區,貨饒里,1827,1182,364,261,625,54,679
公投第１２案,新北市,土城區,貨饒里,1828,1558,506,331,837,36,873
公投第１２案,新北市,土城區,貨饒里,1829,1160,373,269,642,28,670
公投第１２案,新北市,土城區,瑞興里,1830,1357,438,299,737,35,772
公投第１２案,新北市,土城區,瑞興里,1831,1464,441,316,757,55,812
公投第１２案,新北市,土城區,復興里,1832,1335,397,273,670,34,704
公投第１２案,新北市,土城區,復興里,1833,1346,403,284,687,40,727
公投第１２案,新北市,土城區,復興里,1834,1435,489,348,837,27,864
公投第１２案,新北市,土城區,廣福里,1835,1639,509,351,860,47,907
公投第１２案,新北市,土城區,廣福里,1836,1728,601,368,969,19,988
公投第１２案,新北市,土城區,廣福里,1837,1665,418,348,766,17,783
公投第１２案,新北市,土城區,學成里,1838,1333,453,323,776,39,815
公投第１２案,新北市,土城區,學成里,1839,1567,528,371,899,37,936
公投第１２案,新北市,土城區,埤林里,1840,1576,488,329,817,51,868
公投第１２案,新北市,土城區,埤林里,1841,1458,485,308,793,36,829
公投第１２案,新北市,土城區,埤林里,1842,1517,505,316,821,51,872
公投第１２案,新北市,土城區,埤林里,1843,1489,521,327,848,32,880
公投第１２案,新北市,土城區,埤林里,1844,1463,478,364,842,28,870
公投第１２案,新北市,土城區,廣興里,1845,1584,533,347,880,29,909
公投第１２案,新北市,土城區,廣興里,1846,1464,464,309,773,33,806
公投第１２案,新北市,土城區,樂利里,1847,1598,513,342,855,43,898
公投第１２案,新北市,土城區,樂利里,1848,1500,437,329,766,45,811
公投第１２案,新北市,土城區,樂利里,1849,1542,501,314,815,27,842
公投第１２案,新北市,土城區,學府里,1850,1619,518,393,911,49,960
公投第１２案,新北市,土城區,學府里,1851,1521,448,320,768,28,796
公投第１２案,新北市,土城區,明德里,1852,1691,493,395,888,37,925
公投第１２案,新北市,土城區,明德里,1853,1657,492,359,851,39,890
公投第１２案,新北市,土城區,明德里,1854,1772,569,427,996,35,1031
公投第１２案,新北市,土城區,學士里,1855,1423,576,209,785,22,807
公投第１２案,新北市,土城區,學士里,1856,1321,468,303,771,40,811
公投第１２案,新北市,土城區,學士里,1857,1429,499,331,830,46,876
公投第１２案,新北市,土城區,柑林里,1858,1445,435,300,735,45,780
公投第１２案,新北市,土城區,柑林里,1859,1520,566,289,855,36,891
公投第１２案,新北市,土城區,中正里,1860,1484,405,283,688,16,704
公投第１２案,新北市,土城區,中正里,1861,1362,408,294,702,26,728
公投第１２案,新北市,土城區,青雲里,1862,1262,414,257,671,27,698
公投第１２案,新北市,土城區,青雲里,1863,1343,458,287,745,30,775
公投第１２案,新北市,土城區,清和里,1864,1337,359,269,628,28,656
公投第１２案,新北市,土城區,清和里,1865,1325,349,216,565,26,591
公投第１２案,新北市,土城區,清和里,1866,1390,397,278,675,35,710
公投第１２案,新北市,土城區,清和里,1867,1534,456,332,788,44,832
公投第１２案,新北市,土城區,清化里,1868,1484,438,301,739,51,790
公投第１２案,新北市,土城區,清溪里,1869,1532,487,262,749,43,792
公投第１２案,新北市,土城區,清溪里,1870,1507,476,337,813,42,855
公投第１２案,新北市,土城區,清溪里,1871,1550,523,312,835,37,872
公投第１２案,新北市,土城區,清溪里,1872,1567,527,295,822,42,864
公投第１２案,新北市,土城區,青山里,1873,1367,453,294,747,38,785
公投第１２案,新北市,土城區,青山里,1874,1293,368,281,649,49,698
公投第１２案,新北市,土城區,清水里,1875,1402,424,324,748,41,789
公投第１２案,新北市,土城區,清水里,1876,1379,414,306,720,42,762
公投第１２案,新北市,土城區,清水里,1877,1471,458,295,753,30,783
公投第１２案,新北市,土城區,清水里,1878,1410,440,278,718,28,746
公投第１２案,新北市,土城區,清水里,1879,1542,463,331,794,40,834
公投第１２案,新北市,土城區,永豐里,1880,1238,361,274,635,48,683
公投第１２案,新北市,土城區,永豐里,1881,1301,408,245,653,51,704
公投第１２案,新北市,土城區,永豐里,1882,1311,493,331,824,19,843
公投第１２案,新北市,土城區,永富里,1883,1511,401,327,728,36,764
公投第１２案,新北市,土城區,永富里,1884,1531,447,329,776,42,818
公投第１２案,新北市,土城區,永富里,1885,1638,472,346,818,47,865
公投第１２案,新北市,土城區,廷寮里,1886,1335,446,308,754,34,788
公投第１２案,新北市,土城區,廷寮里,1887,1459,470,302,772,36,808
公投第１２案,新北市,土城區,廷寮里,1888,1489,448,338,786,23,809
公投第１２案,新北市,土城區,金城里,1889,1774,720,339,1059,58,1117
公投第１２案,新北市,土城區,金城里,1890,1792,548,398,946,37,983
公投第１２案,新北市,土城區,金城里,1891,1798,591,342,933,60,993
公投第１２案,新北市,土城區,峯廷里,1892,1312,396,259,655,55,710
公投第１２案,新北市,土城區,峯廷里,1893,1301,371,264,635,46,681
公投第１２案,新北市,土城區,峯廷里,1894,1254,353,266,619,46,665
公投第１２案,新北市,土城區,峯廷里,1895,1215,356,276,632,25,657
公投第１２案,新北市,土城區,峯廷里,1896,1448,546,226,772,27,799
公投第１２案,新北市,土城區,延吉里,1897,1321,393,266,659,57,716
公投第１２案,新北市,土城區,延吉里,1898,1150,325,228,553,51,604
公投第１２案,新北市,土城區,延吉里,1899,1425,358,301,659,47,706
公投第１２案,新北市,土城區,延壽里,1900,1366,459,304,763,53,816
公投第１２案,新北市,土城區,延壽里,1901,1292,419,295,714,39,753
公投第１２案,新北市,土城區,延壽里,1902,1317,391,289,680,41,721
公投第１２案,新北市,土城區,延祿里,1903,1324,434,277,711,40,751
公投第１２案,新北市,土城區,延祿里,1904,1189,350,246,596,47,643
公投第１２案,新北市,土城區,延祿里,1905,1223,401,270,671,44,715
公投第１２案,新北市,土城區,平和里,1906,1550,461,338,799,38,837
公投第１２案,新北市,土城區,平和里,1907,1606,509,359,868,53,921
公投第１２案,新北市,土城區,平和里,1908,1509,465,344,809,30,839
公投第１２案,新北市,土城區,平和里,1909,1529,466,319,785,48,833
公投第１２案,新北市,土城區,安和里,1910,1458,418,300,718,52,770
公投第１２案,新北市,土城區,安和里,1911,1468,435,353,788,48,836
公投第１２案,新北市,土城區,安和里,1912,1495,449,319,768,35,803
公投第１２案,新北市,土城區,延和里,1913,1303,421,281,702,48,750
公投第１２案,新北市,土城區,延和里,1914,1365,429,294,723,47,770
公投第１２案,新北市,土城區,延和里,1915,1476,442,324,766,54,820
公投第１２案,新北市,土城區,延和里,1916,1519,490,323,813,29,842
公投第１２案,新北市,三峽區,三峽里,1917,274,95,79,174,13,187
公投第１２案,新北市,三峽區,秀川里,1918,583,186,111,297,26,323
公投第１２案,新北市,三峽區,八張里,1919,1765,449,350,799,20,819
公投第１２案,新北市,三峽區,八張里,1920,1714,521,354,875,31,906
公投第１２案,新北市,三峽區,中埔里,1921,1355,413,270,683,28,711
公投第１２案,新北市,三峽區,中埔里,1922,1329,409,307,716,39,755
公投第１２案,新北市,三峽區,弘道里,1923,1059,332,197,529,36,565
公投第１２案,新北市,三峽區,永舘里,1924,1364,434,309,743,43,786
公投第１２案,新北市,三峽區,永舘里,1925,1098,369,240,609,37,646
公投第１２案,新北市,三峽區,永舘里,1926,1296,387,287,674,45,719
公投第１２案,新北市,三峽區,永舘里,1927,1240,351,281,632,33,665
公投第１２案,新北市,三峽區,永舘里,1928,1531,438,337,775,39,814
公投第１２案,新北市,三峽區,鳶山里,1929,1444,415,277,692,30,722
公投第１２案,新北市,三峽區,鳶山里,1930,1347,375,288,663,63,726
公投第１２案,新北市,三峽區,鳶山里,1931,1455,440,311,751,40,791
公投第１２案,新北市,三峽區,鳶山里,1932,1556,411,301,712,29,741
公投第１２案,新北市,三峽區,鳶山里,1933,1390,334,254,588,34,622
公投第１２案,新北市,三峽區,鳶山里,1934,1532,477,307,784,35,819
公投第１２案,新北市,三峽區,龍埔里,1935,1377,380,250,630,43,673
公投第１２案,新北市,三峽區,龍埔里,1936,1731,501,361,862,37,899
公投第１２案,新北市,三峽區,龍埔里,1937,1705,508,328,836,30,866
公投第１２案,新北市,三峽區,龍埔里,1938,1590,480,365,845,38,883
公投第１２案,新北市,三峽區,龍埔里,1939,1650,528,391,919,29,948
公投第１２案,新北市,三峽區,龍恩里,1940,1441,467,310,777,21,798
公投第１２案,新北市,三峽區,龍恩里,1941,1404,469,315,784,26,810
公投第１２案,新北市,三峽區,龍恩里,1942,1295,453,295,748,24,772
公投第１２案,新北市,三峽區,龍恩里,1943,1348,402,238,640,32,672
公投第１２案,新北市,三峽區,龍學里,1944,1579,528,330,858,17,875
公投第１２案,新北市,三峽區,龍學里,1945,1435,466,279,745,25,770
公投第１２案,新北市,三峽區,龍學里,1946,1659,624,312,936,33,969
公投第１２案,新北市,三峽區,龍學里,1947,1512,566,323,889,30,919
公投第１２案,新北市,三峽區,龍學里,1948,1463,527,291,818,29,847
公投第１２案,新北市,三峽區,龍學里,1949,1465,518,312,830,26,856
公投第１２案,新北市,三峽區,龍學里,1950,1463,535,308,843,21,864
公投第１２案,新北市,三峽區,龍學里,1951,1443,533,277,810,29,839
公投第１２案,新北市,三峽區,礁溪里,1952,1634,463,328,791,41,832
公投第１２案,新北市,三峽區,礁溪里,1953,1716,533,364,897,35,932
公投第１２案,新北市,三峽區,礁溪里,1954,1675,297,343,640,30,670
公投第１２案,新北市,三峽區,安溪里,1955,1649,433,292,725,28,753
公投第１２案,新北市,三峽區,安溪里,1956,1489,440,308,748,41,789
公投第１２案,新北市,三峽區,安溪里,1957,1771,508,323,831,39,870
公投第１２案,新北市,三峽區,安溪里,1958,1726,508,405,913,34,947
公投第１２案,新北市,三峽區,介壽里,1959,1363,421,274,695,34,729
公投第１２案,新北市,三峽區,介壽里,1960,1624,525,336,861,33,894
公投第１２案,新北市,三峽區,介壽里,1961,1352,439,292,731,34,765
公投第１２案,新北市,三峽區,介壽里,1962,1608,393,275,668,14,682
公投第１２案,新北市,三峽區,中正里,1963,1458,440,304,744,40,784
公投第１２案,新北市,三峽區,中正里,1964,1641,418,350,768,39,807
公投第１２案,新北市,三峽區,中正里,1965,1530,446,290,736,79,815
公投第１２案,新北市,三峽區,大埔里,1966,1389,374,220,594,41,635
公投第１２案,新北市,三峽區,大埔里,1967,1315,367,237,604,62,666
公投第１２案,新北市,三峽區,大埔里,1968,934,370,177,547,24,571
公投第１２案,新北市,三峽區,嘉添里,1969,1270,353,247,600,33,633
公投第１２案,新北市,三峽區,嘉添里,1970,929,230,197,427,31,458
公投第１２案,新北市,三峽區,添福里,1971,1035,330,192,522,23,545
公投第１２案,新北市,三峽區,金圳里,1972,502,137,97,234,15,249
公投第１２案,新北市,三峽區,五寮里,1973,836,251,134,385,30,415
公投第１２案,新北市,三峽區,插角里,1974,669,167,115,282,48,330
公投第１２案,新北市,三峽區,有木里,1975,733,212,168,380,58,438
公投第１２案,新北市,三峽區,二鬮里,1976,1560,857,28,885,49,934
公投第１２案,新北市,三峽區,二鬮里,1977,1638,481,328,809,39,848
公投第１２案,新北市,三峽區,溪南里,1978,1394,427,267,694,33,727
公投第１２案,新北市,三峽區,溪北里,1979,771,204,211,415,30,445
公投第１２案,新北市,三峽區,溪北里,1980,1367,360,311,671,31,702
公投第１２案,新北市,三峽區,溪東里,1981,1241,334,254,588,59,647
公投第１２案,新北市,三峽區,溪東里,1982,1520,439,288,727,22,749
公投第１２案,新北市,三峽區,成福里,1983,873,326,207,533,26,559
公投第１２案,新北市,三峽區,竹崙里,1984,768,179,124,303,70,373
公投第１２案,新北市,三峽區,竹崙里,1985,1097,301,201,502,24,526
公投第１２案,新北市,三峽區,安坑里,1986,1322,338,228,566,45,611
公投第１２案,新北市,新店區,新店里,1987,1603,516,340,856,42,898
公投第１２案,新北市,新店區,張南里,1988,1921,617,418,1035,45,1080
公投第１２案,新北市,新店區,國校里,1989,1082,340,239,579,21,600
公投第１２案,新北市,新店區,國校里,1990,1235,414,267,681,41,722
公投第１２案,新北市,新店區,文中里,1991,1568,604,295,899,21,920
公投第１２案,新北市,新店區,廣明里,1992,771,160,181,341,27,368
公投第１２案,新北市,新店區,文明里,1993,1256,396,299,695,28,723
公投第１２案,新北市,新店區,文明里,1994,1008,440,127,567,37,604
公投第１２案,新北市,新店區,中興里,1995,1515,556,296,852,42,894
公投第１２案,新北市,新店區,中興里,1996,1637,652,328,980,41,1021
公投第１２案,新北市,新店區,中興里,1997,1549,550,321,871,33,904
公投第１２案,新北市,新店區,新生里,1998,2011,783,430,1213,45,1258
公投第１２案,新北市,新店區,新生里,1999,1554,522,333,855,53,908
公投第１２案,新北市,新店區,新生里,2000,1770,559,387,946,46,992
公投第１２案,新北市,新店區,新德里,2001,1316,474,273,747,36,783
公投第１２案,新北市,新店區,新德里,2002,1126,410,204,614,34,648
公投第１２案,新北市,新店區,張北里,2003,1460,462,306,768,35,803
公投第１２案,新北市,新店區,張北里,2004,1584,561,338,899,51,950
公投第１２案,新北市,新店區,張北里,2005,1449,484,319,803,32,835
公投第１２案,新北市,新店區,張北里,2006,1520,595,338,933,33,966
公投第１２案,新北市,新店區,張北里,2007,1821,662,379,1041,30,1071
公投第１２案,新北市,新店區,五峯里,2008,1956,671,421,1092,31,1123
公投第１２案,新北市,新店區,五峯里,2009,1665,590,351,941,40,981
公投第１２案,新北市,新店區,五峯里,2010,1588,572,360,932,38,970
公投第１２案,新北市,新店區,五峯里,2011,1519,498,330,828,27,855
公投第１２案,新北市,新店區,長春里,2012,1185,438,282,720,32,752
公投第１２案,新北市,新店區,長春里,2013,1095,407,274,681,22,703
公投第１２案,新北市,新店區,新安里,2014,1106,426,234,660,34,694
公投第１２案,新北市,新店區,新安里,2015,2700,213,177,390,23,413
公投第１２案,新北市,新店區,新安里,2016,995,392,198,590,20,610
公投第１２案,新北市,新店區,新安里,2017,1168,432,219,651,39,690
公投第１２案,新北市,新店區,忠誠里,2018,1123,485,239,724,40,764
公投第１２案,新北市,新店區,忠誠里,2019,1085,409,268,677,30,707
公投第１２案,新北市,新店區,中正里,2020,1412,531,308,839,45,884
公投第１２案,新北市,新店區,中正里,2021,1659,576,376,952,29,981
公投第１２案,新北市,新店區,中正里,2022,1198,454,264,718,47,765
公投第１２案,新北市,新店區,中正里,2023,1376,448,263,711,38,749
公投第１２案,新北市,新店區,中華里,2024,1300,459,243,702,26,728
公投第１２案,新北市,新店區,中華里,2025,1238,431,268,699,29,728
公投第１２案,新北市,新店區,中華里,2026,1388,469,263,732,30,762
公投第１２案,新北市,新店區,仁愛里,2027,933,339,225,564,27,591
公投第１２案,新北市,新店區,仁愛里,2028,908,353,205,558,24,582
公投第１２案,新北市,新店區,建國里,2029,1582,550,316,866,49,915
公投第１２案,新北市,新店區,建國里,2030,1247,473,272,745,36,781
公投第１２案,新北市,新店區,百忍里,2031,971,339,227,566,39,605
公投第１２案,新北市,新店區,百忍里,2032,1145,435,238,673,36,709
公投第１２案,新北市,新店區,百忍里,2033,1392,505,299,804,33,837
公投第１２案,新北市,新店區,百和里,2034,1452,557,314,871,47,918
公投第１２案,新北市,新店區,百和里,2035,1440,488,316,804,33,837
公投第１２案,新北市,新店區,福德里,2036,1786,575,381,956,64,1020
公投第１２案,新北市,新店區,福德里,2037,1825,640,383,1023,42,1065
公投第１２案,新北市,新店區,百福里,2038,1477,553,328,881,28,909
公投第１２案,新北市,新店區,百福里,2039,1750,619,374,993,38,1031
公投第１２案,新北市,新店區,福民里,2040,1792,656,331,987,35,1022
公投第１２案,新北市,新店區,福民里,2041,1979,704,381,1085,43,1128
公投第１２案,新北市,新店區,中山里,2042,826,303,185,488,18,506
公投第１２案,新北市,新店區,中山里,2043,1924,756,354,1110,34,1144
公投第１２案,新北市,新店區,中山里,2044,1383,549,307,856,20,876
公投第１２案,新北市,新店區,和平里,2045,830,261,148,409,23,432
公投第１２案,新北市,新店區,中央里,2046,1759,664,369,1033,42,1075
公投第１２案,新北市,新店區,中央里,2047,1957,720,415,1135,46,1181
公投第１２案,新北市,新店區,中央里,2048,1481,528,353,881,22,903
公投第１２案,新北市,新店區,國豐里,2049,1552,555,311,866,51,917
公投第１２案,新北市,新店區,國豐里,2050,1467,496,292,788,62,850
公投第１２案,新北市,新店區,明德里,2051,1371,463,293,756,44,800
公投第１２案,新北市,新店區,明德里,2052,991,359,224,583,23,606
公投第１２案,新北市,新店區,明德里,2053,1231,436,285,721,36,757
公投第１２案,新北市,新店區,大豐里,2054,1701,591,367,958,41,999
公投第１２案,新北市,新店區,大豐里,2055,1707,603,359,962,48,1010
公投第１２案,新北市,新店區,大同里,2056,1773,631,360,991,30,1021
公投第１２案,新北市,新店區,大同里,2057,1866,602,349,951,41,992
公投第１２案,新北市,新店區,江陵里,2058,1735,612,388,1000,35,1035
公投第１２案,新北市,新店區,江陵里,2059,1632,612,401,1013,37,1050
公投第１２案,新北市,新店區,江陵里,2060,1591,542,362,904,48,952
公投第１２案,新北市,新店區,復興里,2061,1495,497,274,771,47,818
公投第１２案,新北市,新店區,復興里,2062,1511,486,279,765,29,794
公投第１２案,新北市,新店區,寶興里,2063,1260,437,268,705,34,739
公投第１２案,新北市,新店區,寶興里,2064,1948,705,406,1111,48,1159
公投第１２案,新北市,新店區,寶興里,2065,1582,568,379,947,39,986
公投第１２案,新北市,新店區,寶福里,2066,1315,449,281,730,37,767
公投第１２案,新北市,新店區,寶福里,2067,1562,498,340,838,42,880
公投第１２案,新北市,新店區,寶福里,2068,1982,765,400,1165,23,1188
公投第１２案,新北市,新店區,寶福里,2069,1518,513,353,866,43,909
公投第１２案,新北市,新店區,寶安里,2070,1735,599,369,968,26,994
公投第１２案,新北市,新店區,寶安里,2071,1716,623,301,924,46,970
公投第１２案,新北市,新店區,寶安里,2072,1580,550,348,898,42,940
公投第１２案,新北市,新店區,信義里,2073,1358,513,312,825,26,851
公投第１２案,新北市,新店區,信義里,2074,1610,571,377,948,54,1002
公投第１２案,新北市,新店區,信義里,2075,1383,443,306,749,28,777
公投第１２案,新北市,新店區,信義里,2076,1596,588,329,917,26,943
公投第１２案,新北市,新店區,忠孝里,2077,1360,429,257,686,40,726
公投第１２案,新北市,新店區,忠孝里,2078,1160,386,213,599,19,618
公投第１２案,新北市,新店區,大鵬里,2079,1236,577,219,796,23,819
公投第１２案,新北市,新店區,大鵬里,2080,1234,521,254,775,22,797
公投第１２案,新北市,新店區,太平里,2081,1579,509,364,873,44,917
公投第１２案,新北市,新店區,太平里,2082,1241,451,221,672,38,710
公投第１２案,新北市,新店區,美城里,2083,1275,434,276,710,21,731
公投第１２案,新北市,新店區,美城里,2084,1214,378,237,615,30,645
公投第１２案,新北市,新店區,頂城里,2085,1578,426,313,739,51,790
公投第１２案,新北市,新店區,下城里,2086,1442,457,294,751,48,799
公投第１２案,新北市,新店區,下城里,2087,1475,426,231,657,57,714
公投第１２案,新北市,新店區,柴埕里,2088,1580,516,363,879,34,913
公投第１２案,新北市,新店區,柴埕里,2089,1585,524,338,862,27,889
公投第１２案,新北市,新店區,柴埕里,2090,1586,515,339,854,45,899
公投第１２案,新北市,新店區,柴埕里,2091,1931,652,381,1033,53,1086
公投第１２案,新北市,新店區,柴埕里,2092,1239,419,244,663,22,685
公投第１２案,新北市,新店區,安和里,2093,1892,652,356,1008,43,1051
公投第１２案,新北市,新店區,安和里,2094,1529,490,291,781,35,816
公投第１２案,新北市,新店區,安和里,2095,1358,503,264,767,28,795
公投第１２案,新北市,新店區,安和里,2096,1905,575,392,967,29,996
公投第１２案,新北市,新店區,永安里,2097,1885,599,376,975,44,1019
公投第１２案,新北市,新店區,永安里,2098,1345,459,239,698,41,739
公投第１２案,新北市,新店區,永安里,2099,1387,478,288,766,42,808
公投第１２案,新北市,新店區,新和里,2100,1960,617,428,1045,36,1081
公投第１２案,新北市,新店區,新和里,2101,1837,591,371,962,67,1029
公投第１２案,新北市,新店區,永平里,2102,1662,558,358,916,33,949
公投第１２案,新北市,新店區,永平里,2103,1617,579,371,950,45,995
公投第１２案,新北市,新店區,永平里,2104,1704,568,392,960,32,992
公投第１２案,新北市,新店區,公崙里,2105,1835,568,373,941,51,992
公投第１２案,新北市,新店區,公崙里,2106,2009,639,390,1029,60,1089
公投第１２案,新北市,新店區,公崙里,2107,1450,473,292,765,47,812
公投第１２案,新北市,新店區,公崙里,2108,1726,549,374,923,40,963
公投第１２案,新北市,新店區,公崙里,2109,1797,551,386,937,40,977
公投第１２案,新北市,新店區,公崙里,2110,1739,561,375,936,32,968
公投第１２案,新北市,新店區,安昌里,2111,1523,512,320,832,26,858
公投第１２案,新北市,新店區,安昌里,2112,1642,589,308,897,19,916
公投第１２案,新北市,新店區,安昌里,2113,1644,576,341,917,23,940
公投第１２案,新北市,新店區,德安里,2114,1662,492,337,829,29,858
公投第１２案,新北市,新店區,德安里,2115,2067,679,468,1147,38,1185
公投第１２案,新北市,新店區,德安里,2116,1870,482,363,845,40,885
公投第１２案,新北市,新店區,達觀里,2117,1982,650,394,1044,44,1088
公投第１２案,新北市,新店區,達觀里,2118,1546,555,293,848,30,878
公投第１２案,新北市,新店區,明城里,2119,1712,642,354,996,39,1035
公投第１２案,新北市,新店區,明城里,2120,1423,538,315,853,30,883
公投第１２案,新北市,新店區,小城里,2121,1666,570,387,957,48,1005
公投第１２案,新北市,新店區,小城里,2122,1769,665,391,1056,50,1106
公投第１２案,新北市,新店區,雙城里,2123,1079,313,208,521,26,547
公投第１２案,新北市,新店區,雙城里,2124,1140,358,259,617,24,641
公投第１２案,新北市,新店區,雙城里,2125,1825,596,358,954,51,1005
公投第１２案,新北市,新店區,雙城里,2126,1178,412,254,666,49,715
公投第１２案,新北市,新店區,香坡里,2127,1463,479,288,767,32,799
公投第１２案,新北市,新店區,香坡里,2128,1152,389,246,635,27,662
公投第１２案,新北市,新店區,香坡里,2129,2008,548,372,920,30,950
公投第１２案,新北市,新店區,香坡里,2130,2120,587,360,947,29,976
公投第１２案,新北市,新店區,香坡里,2131,1153,441,236,677,19,696
公投第１２案,新北市,新店區,香坡里,2132,1573,513,288,801,30,831
公投第１２案,新北市,新店區,日興里,2133,1992,559,369,928,50,978
公投第１２案,新北市,新店區,日興里,2134,1668,445,321,766,38,804
公投第１２案,新北市,新店區,日興里,2135,1617,468,291,759,37,796
公投第１２案,新北市,新店區,玫瑰里,2136,2013,619,371,990,88,1078
公投第１２案,新北市,新店區,玫瑰里,2137,1791,611,400,1011,35,1046
公投第１２案,新北市,新店區,玫瑰里,2138,1624,529,367,896,34,930
公投第１２案,新北市,新店區,吉祥里,2139,1178,442,242,684,33,717
公投第１２案,新北市,新店區,吉祥里,2140,1277,447,285,732,23,755
公投第１２案,新北市,新店區,吉祥里,2141,1879,613,417,1030,38,1068
公投第１２案,新北市,新店區,塗潭里,2142,939,276,164,440,29,469
公投第１２案,新北市,新店區,華城里,2143,960,293,230,523,24,547
公投第１２案,新北市,新店區,華城里,2144,1434,532,302,834,48,882
公投第１２案,新北市,新店區,青潭里,2145,1838,564,355,919,40,959
公投第１２案,新北市,新店區,青潭里,2146,1453,463,318,781,35,816
公投第１２案,新北市,新店區,青潭里,2147,1549,326,467,793,43,836
公投第１２案,新北市,新店區,美潭里,2148,1860,655,398,1053,33,1086
公投第１２案,新北市,新店區,美潭里,2149,1743,574,311,885,37,922
公投第１２案,新北市,新店區,美潭里,2150,1122,443,262,705,33,738
公投第１２案,新北市,新店區,員潭里,2151,1468,512,273,785,33,818
公投第１２案,新北市,新店區,員潭里,2152,1763,350,583,933,40,973
公投第１２案,新北市,新店區,員潭里,2153,1344,421,267,688,28,716
公投第１２案,新北市,新店區,雙坑里,2154,753,245,139,384,24,408
公投第１２案,新北市,新店區,粗坑里,2155,602,176,155,331,10,341
公投第１２案,新北市,新店區,粗坑里,2156,2237,639,485,1124,52,1176
公投第１２案,新北市,新店區,屈尺里,2157,1096,364,225,589,26,615
公投第１２案,新北市,新店區,屈尺里,2158,1143,310,190,500,37,537
公投第１２案,新北市,新店區,龜山里,2159,1569,489,302,791,51,842
公投第１２案,新北市,新店區,廣興里,2160,1284,378,275,653,65,718
公投第１２案,新北市,新店區,直潭里,2161,439,76,75,151,10,161
公投第１２案,新北市,新店區,直潭里,2162,750,231,180,411,28,439
公投第１２案,新北市,深坑區,萬順里,2163,1142,231,342,573,34,607
公投第１２案,新北市,深坑區,萬順里,2164,1139,367,270,637,40,677
公投第１２案,新北市,深坑區,萬福里,2165,1065,303,229,532,44,576
公投第１２案,新北市,深坑區,萬福里,2166,1400,390,287,677,42,719
公投第１２案,新北市,深坑區,土庫里,2167,1330,350,289,639,49,688
公投第１２案,新北市,深坑區,土庫里,2168,1380,503,265,768,32,800
公投第１２案,新北市,深坑區,深坑里,2169,1496,411,289,700,20,720
公投第１２案,新北市,深坑區,深坑里,2170,1508,468,329,797,48,845
公投第１２案,新北市,深坑區,埔新里,2171,1624,528,356,884,48,932
公投第１２案,新北市,深坑區,埔新里,2172,2165,690,432,1122,51,1173
公投第１２案,新北市,深坑區,埔新里,2173,1790,609,406,1015,43,1058
公投第１２案,新北市,深坑區,昇高里,2174,782,235,156,391,19,410
公投第１２案,新北市,深坑區,昇高里,2175,1164,407,239,646,38,684
公投第１２案,新北市,深坑區,賴仲里,2176,1344,489,271,760,45,805
公投第１２案,新北市,深坑區,賴仲里,2177,739,247,180,427,27,454
公投第１２案,新北市,深坑區,阿柔里,2178,556,171,143,314,27,341
公投第１２案,新北市,石碇區,石碇里,2179,391,120,105,225,22,247
公投第１２案,新北市,石碇區,潭邊里,2180,789,206,157,363,42,405
公投第１２案,新北市,石碇區,烏塗里,2181,662,149,105,254,22,276
公投第１２案,新北市,石碇區,彭山里,2182,310,89,58,147,14,161
公投第１２案,新北市,石碇區,豐田里,2183,280,81,59,140,10,150
公投第１２案,新北市,石碇區,豐田里,2184,93,21,12,33,5,38
公投第１２案,新北市,石碇區,隆盛里,2185,683,145,128,273,36,309
公投第１２案,新北市,石碇區,豐林里,2186,323,117,80,197,11,208
公投第１２案,新北市,石碇區,中民里,2187,726,187,93,280,14,294
公投第１２案,新北市,石碇區,永定里,2188,591,160,133,293,22,315
公投第１２案,新北市,石碇區,光明里,2189,282,105,60,165,26,191
公投第１２案,新北市,石碇區,永安里,2190,788,219,144,363,12,375
公投第１２案,新北市,石碇區,格頭里,2191,943,296,225,521,37,558
公投第１２案,新北市,坪林區,坪林里,2192,1248,399,239,638,34,672
公投第１２案,新北市,坪林區,水德里,2193,612,154,106,260,32,292
公投第１２案,新北市,坪林區,大林里,2194,1141,376,223,599,54,653
公投第１２案,新北市,坪林區,石𥕢里,2195,417,100,73,173,9,182
公投第１２案,新北市,坪林區,粗窟里,2196,595,165,131,296,36,332
公投第１２案,新北市,坪林區,粗窟里,2197,248,84,49,133,21,154
公投第１２案,新北市,坪林區,上德里,2198,338,94,64,158,9,167
公投第１２案,新北市,坪林區,上德里,2199,478,126,76,202,11,213
公投第１２案,新北市,坪林區,漁光里,2200,390,93,55,148,11,159
公投第１２案,新北市,坪林區,漁光里,2201,424,123,73,196,13,209
公投第１２案,新北市,烏來區,忠治里,2202,1568,581,331,912,34,946
公投第１２案,新北市,烏來區,烏來里,2203,1198,363,229,592,15,607
公投第１２案,新北市,烏來區,烏來里,2204,1169,386,198,584,20,604
公投第１２案,新北市,烏來區,孝義里,2205,228,71,53,124,3,127
公投第１２案,新北市,烏來區,信賢里,2206,486,164,110,274,8,282
公投第１２案,新北市,烏來區,福山里,2207,615,208,97,305,18,323
公投第１２案,新北市,平溪區,薯榔里,2208,384,121,55,176,20,196
公投第１２案,新北市,平溪區,菁桐里,2209,232,60,39,99,3,102
公投第１２案,新北市,平溪區,白石里,2210,249,77,55,132,10,142
公投第１２案,新北市,平溪區,石底里,2211,458,131,94,225,30,255
公投第１２案,新北市,平溪區,平溪里,2212,232,76,37,113,15,128
公投第１２案,新北市,平溪區,嶺腳里,2213,635,165,86,251,16,267
公投第１２案,新北市,平溪區,東勢里,2214,427,131,77,208,39,247
公投第１２案,新北市,平溪區,十分里,2215,862,222,133,355,29,384
公投第１２案,新北市,平溪區,望古里,2216,147,50,22,72,2,74
公投第１２案,新北市,平溪區,南山里,2217,365,82,51,133,11,144
公投第１２案,新北市,平溪區,新寮里,2218,153,37,25,62,8,70
公投第１２案,新北市,平溪區,平湖里,2219,177,66,29,95,14,109
公投第１２案,新北市,瑞芳區,龍潭里,2220,725,234,159,393,29,422
公投第１２案,新北市,瑞芳區,龍興里,2221,1074,342,227,569,42,611
公投第１２案,新北市,瑞芳區,龍興里,2222,825,261,144,405,23,428
公投第１２案,新北市,瑞芳區,龍鎮里,2223,1242,380,247,627,38,665
公投第１２案,新北市,瑞芳區,龍安里,2224,598,161,136,297,31,328
公投第１２案,新北市,瑞芳區,龍川里,2225,872,269,164,433,33,466
公投第１２案,新北市,瑞芳區,龍川里,2226,760,189,142,331,38,369
公投第１２案,新北市,瑞芳區,龍山里,2227,1330,324,260,584,45,629
公投第１２案,新北市,瑞芳區,爪峯里,2228,1683,434,303,737,47,784
公投第１２案,新北市,瑞芳區,爪峯里,2229,980,285,157,442,47,489
公投第１２案,新北市,瑞芳區,爪峯里,2230,946,274,190,464,39,503
公投第１２案,新北市,瑞芳區,新峰里,2231,1375,420,193,613,21,634
公投第１２案,新北市,瑞芳區,新峰里,2232,1671,474,312,786,37,823
公投第１２案,新北市,瑞芳區,東和里,2233,978,264,158,422,24,446
公投第１２案,新北市,瑞芳區,東和里,2234,645,167,129,296,18,314
公投第１２案,新北市,瑞芳區,柑坪里,2235,1089,306,195,501,62,563
公投第１２案,新北市,瑞芳區,弓橋里,2236,286,68,42,110,13,123
公投第１２案,新北市,瑞芳區,猴硐里,2237,461,110,104,214,24,238
公投第１２案,新北市,瑞芳區,光復里,2238,274,75,44,119,19,138
公投第１２案,新北市,瑞芳區,碩仁里,2239,155,51,35,86,9,95
公投第１２案,新北市,瑞芳區,吉慶里,2240,817,245,172,417,32,449
公投第１２案,新北市,瑞芳區,吉慶里,2241,884,228,180,408,59,467
公投第１２案,新北市,瑞芳區,吉安里,2242,1333,358,218,576,44,620
公投第１２案,新北市,瑞芳區,吉安里,2243,607,134,121,255,7,262
公投第１２案,新北市,瑞芳區,吉安里,2244,1045,317,201,518,38,556
公投第１２案,新北市,瑞芳區,上天里,2245,673,197,138,335,33,368
公投第１２案,新北市,瑞芳區,上天里,2246,618,136,104,240,14,254
公投第１２案,新北市,瑞芳區,傑魚里,2247,1063,168,202,370,32,402
公投第１２案,新北市,瑞芳區,傑魚里,2248,860,233,194,427,40,467
公投第１２案,新北市,瑞芳區,基山里,2249,432,75,60,135,5,140
公投第１２案,新北市,瑞芳區,永慶里,2250,445,105,62,167,12,179
公投第１２案,新北市,瑞芳區,崇文里,2251,318,81,48,129,9,138
公投第１２案,新北市,瑞芳區,福住里,2252,159,49,22,71,6,77
公投第１２案,新北市,瑞芳區,頌德里,2253,337,67,66,133,14,147
公投第１２案,新北市,瑞芳區,瓜山里,2254,180,58,30,88,11,99
公投第１２案,新北市,瑞芳區,銅山里,2255,187,47,23,70,11,81
公投第１２案,新北市,瑞芳區,新山里,2256,369,118,61,179,11,190
公投第１２案,新北市,瑞芳區,石山里,2257,335,100,68,168,20,188
公投第１２案,新北市,瑞芳區,濓洞里,2258,470,118,75,193,14,207
公投第１２案,新北市,瑞芳區,濓新里,2259,297,70,40,110,5,115
公投第１２案,新北市,瑞芳區,南雅里,2260,267,115,59,174,7,181
公投第１２案,新北市,瑞芳區,鼻頭里,2261,876,158,90,248,11,259
公投第１２案,新北市,瑞芳區,海濱里,2262,1241,284,174,458,26,484
公投第１２案,新北市,瑞芳區,瑞濱里,2263,998,274,207,481,54,535
公投第１２案,新北市,瑞芳區,瑞濱里,2264,948,259,195,454,49,503
公投第１２案,新北市,瑞芳區,深澳里,2265,1308,292,204,496,27,523
公投第１２案,新北市,雙溪區,雙溪里,2266,455,134,68,202,15,217
公投第１２案,新北市,雙溪區,新基里,2267,286,87,57,144,5,149
公投第１２案,新北市,雙溪區,新基里,2268,496,154,101,255,21,276
公投第１２案,新北市,雙溪區,三港里,2269,383,99,58,157,12,169
公投第１２案,新北市,雙溪區,牡丹里,2270,887,219,140,359,25,384
公投第１２案,新北市,雙溪區,牡丹里,2271,652,147,109,256,26,282
公投第１２案,新北市,雙溪區,三貂里,2272,333,89,64,153,16,169
公投第１２案,新北市,雙溪區,平林里,2273,642,157,140,297,25,322
公投第１２案,新北市,雙溪區,平林里,2274,282,57,70,127,11,138
公投第１２案,新北市,雙溪區,上林里,2275,621,142,103,245,28,273
公投第１２案,新北市,雙溪區,外柑里,2276,422,90,67,157,14,171
公投第１２案,新北市,雙溪區,長源里,2277,369,76,42,118,18,136
公投第１２案,新北市,雙溪區,共和里,2278,120,26,35,61,4,65
公投第１２案,新北市,雙溪區,共和里,2279,271,71,54,125,9,134
公投第１２案,新北市,雙溪區,魚行里,2280,362,98,94,192,21,213
公投第１２案,新北市,雙溪區,魚行里,2281,371,100,67,167,26,193
公投第１２案,新北市,雙溪區,泰平里,2282,1047,376,207,583,35,618
公投第１２案,新北市,貢寮區,貢寮里,2283,876,232,166,398,41,439
公投第１２案,新北市,貢寮區,龍崗里,2284,433,111,87,198,23,221
公投第１２案,新北市,貢寮區,吉林里,2285,516,126,82,208,19,227
公投第１２案,新北市,貢寮區,雙玉里,2286,373,67,54,121,32,153
公投第１２案,新北市,貢寮區,雙玉里,2287,313,72,54,126,24,150
公投第１２案,新北市,貢寮區,福連里,2288,485,137,95,232,10,242
公投第１２案,新北市,貢寮區,福連里,2289,415,98,91,189,22,211
公投第１２案,新北市,貢寮區,福隆里,2290,812,197,124,321,33,354
公投第１２案,新北市,貢寮區,福隆里,2291,861,207,167,374,43,417
公投第１２案,新北市,貢寮區,龍門里,2292,676,120,121,241,31,272
公投第１２案,新北市,貢寮區,真理里,2293,1091,232,172,404,21,425
公投第１２案,新北市,貢寮區,真理里,2294,955,223,119,342,49,391
公投第１２案,新北市,貢寮區,仁里里,2295,769,188,117,305,13,318
公投第１２案,新北市,貢寮區,仁里里,2296,962,219,213,432,37,469
公投第１２案,新北市,貢寮區,美豐里,2297,390,111,89,200,8,208
公投第１２案,新北市,貢寮區,美豐里,2298,349,95,61,156,5,161
公投第１２案,新北市,貢寮區,和美里,2299,508,120,64,184,29,213
公投第１２案,新北市,貢寮區,和美里,2300,495,94,63,157,12,169
公投第１２案,新北市,金山區,和平里,2301,481,150,89,239,23,262
公投第１２案,新北市,金山區,大同里,2302,715,207,140,347,33,380
公投第１２案,新北市,金山區,豐漁里,2303,481,122,70,192,22,214
公投第１２案,新北市,金山區,磺港里,2304,1792,496,297,793,50,843
公投第１２案,新北市,金山區,美田里,2305,1781,511,336,847,66,913
公投第１２案,新北市,金山區,美田里,2306,2010,550,462,1012,60,1072
公投第１２案,新北市,金山區,金美里,2307,1572,434,279,713,58,771
公投第１２案,新北市,金山區,金美里,2308,1777,447,400,847,63,910
公投第１２案,新北市,金山區,金美里,2309,1631,426,288,714,59,773
公投第１２案,新北市,金山區,五湖里,2310,828,239,169,408,28,436
公投第１２案,新北市,金山區,五湖里,2311,888,258,178,436,36,472
公投第１２案,新北市,金山區,重和里,2312,1211,350,201,551,61,612
公投第１２案,新北市,金山區,兩湖里,2313,416,126,95,221,18,239
公投第１２案,新北市,金山區,六股里,2314,682,200,161,361,37,398
公投第１２案,新北市,金山區,三界里,2315,644,186,130,316,33,349
公投第１２案,新北市,金山區,清泉里,2316,830,245,129,374,36,410
公投第１２案,新北市,金山區,西湖里,2317,188,43,42,85,15,100
公投第１２案,新北市,金山區,萬壽里,2318,469,133,108,241,21,262
公投第１２案,新北市,金山區,永興里,2319,582,105,79,184,34,218
公投第１２案,新北市,萬里區,萬里里,2320,1286,408,242,650,49,699
公投第１２案,新北市,萬里區,萬里里,2321,1576,498,326,824,37,861
公投第１２案,新北市,萬里區,萬里里,2322,1447,403,263,666,40,706
公投第１２案,新北市,萬里區,北基里,2323,1466,385,238,623,48,671
公投第１２案,新北市,萬里區,北基里,2324,1369,351,202,553,36,589
公投第１２案,新北市,萬里區,龜吼里,2325,1215,269,163,432,45,477
公投第１２案,新北市,萬里區,龜吼里,2326,1317,407,241,648,43,691
公投第１２案,新北市,萬里區,野柳里,2327,1676,445,263,708,46,754
公投第１２案,新北市,萬里區,野柳里,2328,1550,388,273,661,78,739
公投第１２案,新北市,萬里區,大鵬里,2329,945,303,239,542,50,592
公投第１２案,新北市,萬里區,大鵬里,2330,1760,533,355,888,72,960
公投第１２案,新北市,萬里區,磺潭里,2331,570,166,98,264,26,290
公投第１２案,新北市,萬里區,雙興里,2332,952,251,196,447,29,476
公投第１２案,新北市,萬里區,溪底里,2333,674,205,144,349,47,396
公投第１２案,新北市,萬里區,崁脚里,2334,405,122,76,198,16,214
公投第１２案,新北市,萬里區,中幅里,2335,1089,299,219,518,32,550
公投第１２案,新北市,汐止區,仁德里,2336,1595,490,314,804,61,865
公投第１２案,新北市,汐止區,義民里,2337,1262,390,277,667,41,708
公投第１２案,新北市,汐止區,禮門里,2338,917,279,214,493,48,541
公投第１２案,新北市,汐止區,智慧里,2339,1929,628,404,1032,42,1074
公投第１２案,新北市,汐止區,智慧里,2340,2227,660,470,1130,60,1190
公投第１２案,新北市,汐止區,大同里,2341,1143,344,250,594,53,647
公投第１２案,新北市,汐止區,大同里,2342,1367,445,295,740,25,765
公投第１２案,新北市,汐止區,信望里,2343,322,85,77,162,15,177
公投第１２案,新北市,汐止區,新昌里,2344,1460,464,330,794,12,806
公投第１２案,新北市,汐止區,新昌里,2345,1719,477,372,849,33,882
公投第１２案,新北市,汐止區,新昌里,2346,1661,524,302,826,61,887
公投第１２案,新北市,汐止區,福安里,2347,1590,488,362,850,51,901
公投第１２案,新北市,汐止區,福安里,2348,1599,517,327,844,35,879
公投第１２案,新北市,汐止區,福安里,2349,1749,550,384,934,34,968
公投第１２案,新北市,汐止區,秀峰里,2350,1809,197,141,338,18,356
公投第１２案,新北市,汐止區,秀峰里,2351,1601,424,321,745,26,771
公投第１２案,新北市,汐止區,秀峰里,2352,1387,421,265,686,52,738
公投第１２案,新北市,汐止區,秀山里,2353,1779,551,392,943,57,1000
公投第１２案,新北市,汐止區,秀山里,2354,2074,668,428,1096,50,1146
公投第１２案,新北市,汐止區,復興里,2355,2072,632,451,1083,35,1118
公投第１２案,新北市,汐止區,復興里,2356,2120,707,465,1172,67,1239
公投第１２案,新北市,汐止區,復興里,2357,1952,612,434,1046,34,1080
公投第１２案,新北市,汐止區,自強里,2358,1654,492,342,834,47,881
公投第１２案,新北市,汐止區,自強里,2359,1444,433,292,725,42,767
公投第１２案,新北市,汐止區,自強里,2360,1627,560,373,933,35,968
公投第１２案,新北市,汐止區,文化里,2361,1751,536,320,856,51,907
公投第１２案,新北市,汐止區,文化里,2362,2066,585,457,1042,41,1083
公投第１２案,新北市,汐止區,白雲里,2363,1941,483,352,835,43,878
公投第１２案,新北市,汐止區,白雲里,2364,1906,477,403,880,32,912
公投第１２案,新北市,汐止區,茄苳里,2365,1363,412,254,666,52,718
公投第１２案,新北市,汐止區,茄苳里,2366,1368,399,270,669,38,707
公投第１２案,新北市,汐止區,茄苳里,2367,1233,330,243,573,36,609
公投第１２案,新北市,汐止區,崇德里,2368,1554,456,343,799,22,821
公投第１２案,新北市,汐止區,崇德里,2369,1700,489,350,839,39,878
公投第１２案,新北市,汐止區,崇德里,2370,1124,374,233,607,25,632
公投第１２案,新北市,汐止區,城中里,2371,1900,611,430,1041,46,1087
公投第１２案,新北市,汐止區,城中里,2372,2050,627,417,1044,55,1099
公投第１２案,新北市,汐止區,橋東里,2373,1244,351,270,621,47,668
公投第１２案,新北市,汐止區,橋東里,2374,1320,396,250,646,26,672
公投第１２案,新北市,汐止區,建成里,2375,1473,454,330,784,49,833
公投第１２案,新北市,汐止區,建成里,2376,1802,606,340,946,48,994
公投第１２案,新北市,汐止區,建成里,2377,1266,445,266,711,31,742
公投第１２案,新北市,汐止區,長安里,2378,1481,400,288,688,58,746
公投第１２案,新北市,汐止區,保安里,2379,1497,367,346,713,64,777
公投第１２案,新北市,汐止區,東山里,2380,556,176,125,301,18,319
公投第１２案,新北市,汐止區,保長里,2381,1913,516,401,917,45,962
公投第１２案,新北市,汐止區,保長里,2382,2027,548,431,979,38,1017
公投第１２案,新北市,汐止區,保新里,2383,1927,530,383,913,33,946
公投第１２案,新北市,汐止區,保新里,2384,696,209,145,354,33,387
公投第１２案,新北市,汐止區,鄉長里,2385,2127,582,423,1005,51,1056
公投第１２案,新北市,汐止區,江北里,2386,1642,435,301,736,41,777
公投第１２案,新北市,汐止區,江北里,2387,1912,629,302,931,67,998
公投第１２案,新北市,汐止區,江北里,2388,1893,468,364,832,52,884
公投第１２案,新北市,汐止區,拱北里,2389,1466,410,274,684,32,716
公投第１２案,新北市,汐止區,拱北里,2390,1538,456,291,747,45,792
公投第１２案,新北市,汐止區,拱北里,2391,1550,427,324,751,35,786
公投第１２案,新北市,汐止區,烘內里,2392,1456,411,292,703,44,747
公投第１２案,新北市,汐止區,八連里,2393,947,309,228,537,38,575
公投第１２案,新北市,汐止區,長青里,2394,923,302,208,510,15,525
公投第１２案,新北市,汐止區,北峰里,2395,2043,592,359,951,83,1034
公投第１２案,新北市,汐止區,北峰里,2396,2012,549,358,907,78,985
公投第１２案,新北市,汐止區,金龍里,2397,1471,422,248,670,26,696
公投第１２案,新北市,汐止區,金龍里,2398,1603,448,325,773,42,815
公投第１２案,新北市,汐止區,金龍里,2399,1530,421,349,770,54,824
公投第１２案,新北市,汐止區,樟樹里,2400,1988,532,325,857,31,888
公投第１２案,新北市,汐止區,忠孝里,2401,2198,610,446,1056,38,1094
公投第１２案,新北市,汐止區,忠孝里,2402,1712,470,362,832,38,870
公投第１２案,新北市,汐止區,忠孝里,2403,1806,595,365,960,48,1008
公投第１２案,新北市,汐止區,忠孝里,2404,1576,484,305,789,53,842
公投第１２案,新北市,汐止區,厚德里,2405,1511,461,308,769,28,797
公投第１２案,新北市,汐止區,厚德里,2406,1691,481,325,806,24,830
公投第１２案,新北市,汐止區,厚德里,2407,1636,526,317,843,32,875
公投第１２案,新北市,汐止區,厚德里,2408,1676,518,322,840,32,872
公投第１２案,新北市,汐止區,山光里,2409,1264,413,224,637,27,664
公投第１２案,新北市,汐止區,山光里,2410,1165,376,219,595,22,617
公投第１２案,新北市,汐止區,中興里,2411,1765,497,359,856,40,896
公投第１２案,新北市,汐止區,中興里,2412,1815,489,297,786,31,817
公投第１２案,新北市,汐止區,中興里,2413,1778,488,359,847,46,893
公投第１２案,新北市,汐止區,中興里,2414,1580,406,423,829,47,876
公投第１２案,新北市,汐止區,福德里,2415,1516,444,326,770,39,809
公投第１２案,新北市,汐止區,福德里,2416,1425,432,256,688,40,728
公投第１２案,新北市,汐止區,興福里,2417,1388,454,272,726,39,765
公投第１２案,新北市,汐止區,興福里,2418,1436,444,301,745,44,789
公投第１２案,新北市,汐止區,康福里,2419,1591,464,343,807,32,839
公投第１２案,新北市,汐止區,康福里,2420,1639,436,349,785,29,814
公投第１２案,新北市,汐止區,康福里,2421,1394,360,325,685,20,705
公投第１２案,新北市,汐止區,湖光里,2422,2035,566,396,962,35,997
公投第１２案,新北市,汐止區,湖光里,2423,1895,552,393,945,37,982
公投第１２案,新北市,汐止區,湖光里,2424,1374,470,287,757,30,787
公投第１２案,新北市,汐止區,湖蓮里,2425,1061,425,181,606,20,626
公投第１２案,新北市,汐止區,湖蓮里,2426,1312,489,310,799,30,829
公投第１２案,新北市,汐止區,湖興里,2427,1548,499,321,820,33,853
公投第１２案,新北市,汐止區,湖興里,2428,1350,424,324,748,29,777
公投第１２案,新北市,汐止區,湖興里,2429,1499,462,320,782,34,816
公投第１２案,新北市,汐止區,湖興里,2430,1366,437,317,754,37,791
公投第１２案,新北市,汐止區,北山里,2431,1335,426,301,727,39,766
公投第１２案,新北市,汐止區,北山里,2432,1324,489,279,768,42,810
公投第１２案,新北市,汐止區,北山里,2433,1286,442,297,739,46,785
公投第１２案,新北市,汐止區,北山里,2434,1155,352,243,595,42,637
公投第１２案,新北市,汐止區,忠山里,2435,1682,618,402,1020,37,1057
公投第１２案,新北市,汐止區,忠山里,2436,1494,540,336,876,46,922
公投第１２案,新北市,汐止區,環河里,2437,1166,344,312,656,49,705
公投第１２案,新北市,汐止區,橫科里,2438,2184,649,467,1116,92,1208
公投第１２案,新北市,汐止區,橫科里,2439,2031,636,426,1062,67,1129
公投第１２案,新北市,汐止區,福山里,2440,1759,561,359,920,59,979
公投第１２案,新北市,汐止區,福山里,2441,1577,496,362,858,44,902
公投第１２案,新北市,汐止區,宜興里,2442,1364,444,278,722,28,750
公投第１２案,新北市,汐止區,宜興里,2443,1401,460,312,772,50,822
公投第１２案,新北市,汐止區,東勢里,2444,1173,388,277,665,34,699
公投第１２案,新北市,汐止區,東勢里,2445,993,346,220,566,15,581
公投第１２案,新北市,汐止區,東勢里,2446,1587,521,296,817,28,845
公投第１２案,臺中市,大甲區,朝陽里,1,1356,501,254,755,59,814
公投第１２案,臺中市,大甲區,大甲里,2,1059,388,241,629,36,665
公投第１２案,臺中市,大甲區,順天里,3,694,252,163,415,30,445
公投第１２案,臺中市,大甲區,順天里,4,874,318,206,524,17,541
公投第１２案,臺中市,大甲區,孔門里,5,763,244,162,406,24,430
公投第１２案,臺中市,大甲區,平安里,6,856,311,213,524,28,552
公投第１２案,臺中市,大甲區,平安里,7,1249,444,292,736,33,769
公投第１２案,臺中市,大甲區,庄美里,8,922,308,195,503,27,530
公投第１２案,臺中市,大甲區,庄美里,9,1189,432,255,687,30,717
公投第１２案,臺中市,大甲區,新美里,10,1065,392,237,629,51,680
公投第１２案,臺中市,大甲區,新美里,11,1252,485,272,757,48,805
公投第１２案,臺中市,大甲區,新美里,12,1057,350,223,573,57,630
公投第１２案,臺中市,大甲區,岷山里,13,1031,375,218,593,34,627
公投第１２案,臺中市,大甲區,岷山里,14,1060,402,247,649,23,672
公投第１２案,臺中市,大甲區,中山里,15,1311,439,277,716,52,768
公投第１２案,臺中市,大甲區,中山里,16,1424,479,305,784,37,821
公投第１２案,臺中市,大甲區,中山里,17,1670,519,357,876,52,928
公投第１２案,臺中市,大甲區,南陽里,18,812,290,165,455,31,486
公投第１２案,臺中市,大甲區,薰風里,19,863,347,173,520,42,562
公投第１２案,臺中市,大甲區,義和里,20,1598,664,244,908,42,950
公投第１２案,臺中市,大甲區,義和里,21,1588,552,320,872,37,909
公投第１２案,臺中市,大甲區,武陵里,22,1197,405,253,658,41,699
公投第１２案,臺中市,大甲區,文曲里,23,1106,420,39,459,60,519
公投第１２案,臺中市,大甲區,武曲里,24,903,318,211,529,40,569
公投第１２案,臺中市,大甲區,武曲里,25,869,442,76,518,32,550
公投第１２案,臺中市,大甲區,文武里,26,1350,466,335,801,29,830
公投第１２案,臺中市,大甲區,文武里,27,1144,395,231,626,63,689
公投第１２案,臺中市,大甲區,文武里,28,1208,460,248,708,37,745
公投第１２案,臺中市,大甲區,文武里,29,1567,536,368,904,34,938
公投第１２案,臺中市,大甲區,奉化里,30,1246,446,328,774,28,802
公投第１２案,臺中市,大甲區,奉化里,31,767,282,169,451,26,477
公投第１２案,臺中市,大甲區,德化里,32,790,278,182,460,26,486
公投第１２案,臺中市,大甲區,德化里,33,972,393,188,581,32,613
公投第１２案,臺中市,大甲區,江南里,34,1388,449,301,750,27,777
公投第１２案,臺中市,大甲區,頂店里,35,1331,412,282,694,26,720
公投第１２案,臺中市,大甲區,頂店里,36,1167,466,228,694,34,728
公投第１２案,臺中市,大甲區,頂店里,37,1934,705,438,1143,44,1187
公投第１２案,臺中市,大甲區,太白里,38,1263,368,254,622,39,661
公投第１２案,臺中市,大甲區,孟春里,39,1390,446,320,766,39,805
公投第１２案,臺中市,大甲區,孟春里,40,1186,358,227,585,28,613
公投第１２案,臺中市,大甲區,孟春里,41,1397,453,316,769,33,802
公投第１２案,臺中市,大甲區,幸福里,42,1173,311,234,545,16,561
公投第１２案,臺中市,大甲區,幸福里,43,1398,414,298,712,60,772
公投第１２案,臺中市,大甲區,日南里,44,1228,337,261,598,42,640
公投第１２案,臺中市,大甲區,日南里,45,1258,383,263,646,36,682
公投第１２案,臺中市,大甲區,日南里,46,1435,404,334,738,44,782
公投第１２案,臺中市,大甲區,日南里,47,1532,460,349,809,34,843
公投第１２案,臺中市,大甲區,龍泉里,48,652,208,143,351,31,382
公投第１２案,臺中市,大甲區,龍泉里,49,870,229,186,415,32,447
公投第１２案,臺中市,大甲區,西岐里,50,891,276,180,456,24,480
公投第１２案,臺中市,大甲區,西岐里,51,784,278,159,437,28,465
公投第１２案,臺中市,大甲區,銅安里,52,1368,411,270,681,72,753
公投第１２案,臺中市,大甲區,福德里,53,1126,316,222,538,66,604
公投第１２案,臺中市,大甲區,建興里,54,1486,401,280,681,57,738
公投第１２案,臺中市,大安區,南埔里,55,1068,322,186,508,62,570
公投第１２案,臺中市,大安區,南庄里,56,1050,289,281,570,47,617
公投第１２案,臺中市,大安區,中庄里,57,1246,399,305,704,57,761
公投第１２案,臺中市,大安區,中庄里,58,1397,449,289,738,48,786
公投第１２案,臺中市,大安區,東安里,59,1227,402,302,704,64,768
公投第１２案,臺中市,大安區,福興里,60,1170,385,252,637,56,693
公投第１２案,臺中市,大安區,龜壳里,61,914,334,203,537,58,595
公投第１２案,臺中市,大安區,龜壳里,62,667,169,148,317,30,347
公投第１２案,臺中市,大安區,頂安里,63,890,271,166,437,49,486
公投第１２案,臺中市,大安區,永安里,64,1289,396,278,674,62,736
公投第１２案,臺中市,大安區,永安里,65,455,130,92,222,21,243
公投第１２案,臺中市,大安區,福住里,66,1028,344,217,561,38,599
公投第１２案,臺中市,大安區,海墘里,67,1446,501,296,797,74,871
公投第１２案,臺中市,大安區,西安里,68,688,259,160,419,26,445
公投第１２案,臺中市,大安區,西安里,69,1062,375,227,602,47,649
公投第１２案,臺中市,大安區,松雅里,70,923,348,224,572,31,603
公投第１２案,臺中市,外埔區,永豐里,71,1059,319,234,553,49,602
公投第１２案,臺中市,外埔區,六分里,72,1013,348,235,583,25,608
公投第１２案,臺中市,外埔區,六分里,73,1150,410,273,683,37,720
公投第１２案,臺中市,外埔區,大同里,74,1855,713,399,1112,64,1176
公投第１２案,臺中市,外埔區,大同里,75,1327,448,315,763,37,800
公投第１２案,臺中市,外埔區,大同里,76,1453,549,297,846,43,889
公投第１２案,臺中市,外埔區,大東里,77,1653,542,323,865,61,926
公投第１２案,臺中市,外埔區,大東里,78,1615,421,420,841,35,876
公投第１２案,臺中市,外埔區,大東里,79,1470,513,275,788,31,819
公投第１２案,臺中市,外埔區,大東里,80,1559,551,338,889,57,946
公投第１２案,臺中市,外埔區,三崁里,81,1902,597,395,992,77,1069
公投第１２案,臺中市,外埔區,水美里,82,1138,458,229,687,48,735
公投第１２案,臺中市,外埔區,水美里,83,1065,390,241,631,52,683
公投第１２案,臺中市,外埔區,水美里,84,1243,467,273,740,42,782
公投第１２案,臺中市,外埔區,鐵山里,85,962,280,207,487,43,530
公投第１２案,臺中市,外埔區,鐵山里,86,1169,348,267,615,46,661
公投第１２案,臺中市,外埔區,中山里,87,1216,495,272,767,34,801
公投第１２案,臺中市,外埔區,馬鳴里,88,1391,474,267,741,50,791
公投第１２案,臺中市,外埔區,土城里,89,1616,520,326,846,68,914
公投第１２案,臺中市,外埔區,廍子里,90,1203,319,238,557,40,597
公投第１２案,臺中市,清水區,鰲峰里,91,1076,327,224,551,36,587
公投第１２案,臺中市,清水區,靈泉里,92,953,364,223,587,38,625
公投第１２案,臺中市,清水區,清水里,93,914,304,219,523,54,577
公投第１２案,臺中市,清水區,清水里,94,1143,441,250,691,40,731
公投第１２案,臺中市,清水區,文昌里,95,680,240,157,397,28,425
公投第１２案,臺中市,清水區,南寧里,96,904,324,208,532,32,564
公投第１２案,臺中市,清水區,南寧里,97,893,334,212,546,38,584
公投第１２案,臺中市,清水區,西寧里,98,1577,532,349,881,39,920
公投第１２案,臺中市,清水區,北寧里,99,690,253,133,386,30,416
公投第１２案,臺中市,清水區,中興里,100,403,145,89,234,16,250
公投第１２案,臺中市,清水區,西社里,101,1413,470,311,781,55,836
公投第１２案,臺中市,清水區,西社里,102,777,267,164,431,28,459
公投第１２案,臺中市,清水區,南社里,103,1313,498,263,761,38,799
公投第１２案,臺中市,清水區,南社里,104,1439,512,325,837,59,896
公投第１２案,臺中市,清水區,南社里,105,1265,411,261,672,24,696
公投第１２案,臺中市,清水區,南社里,106,1277,479,282,761,39,800
公投第１２案,臺中市,清水區,南社里,107,1276,473,266,739,40,779
公投第１２案,臺中市,清水區,南社里,108,1376,502,327,829,39,868
公投第１２案,臺中市,清水區,南社里,109,1291,492,314,806,24,830
公投第１２案,臺中市,清水區,裕嘉里,110,1510,498,375,873,48,921
公投第１２案,臺中市,清水區,臨江里,111,1524,514,323,837,70,907
公投第１２案,臺中市,清水區,秀水里,112,1474,440,315,755,41,796
公投第１２案,臺中市,清水區,秀水里,113,1507,537,279,816,45,861
公投第１２案,臺中市,清水區,秀水里,114,1321,482,322,804,57,861
公投第１２案,臺中市,清水區,武鹿里,115,1157,348,232,580,34,614
公投第１２案,臺中市,清水區,武鹿里,116,1255,424,302,726,35,761
公投第１２案,臺中市,清水區,武鹿里,117,881,290,194,484,26,510
公投第１２案,臺中市,清水區,海濱里,118,1083,356,280,636,44,680
公投第１２案,臺中市,清水區,海濱里,119,951,329,215,544,42,586
公投第１２案,臺中市,清水區,槺榔里,120,1424,446,287,733,54,787
公投第１２案,臺中市,清水區,槺榔里,121,1233,388,225,613,61,674
公投第１２案,臺中市,清水區,槺榔里,122,1288,342,249,591,44,635
公投第１２案,臺中市,清水區,槺榔里,123,1200,429,247,676,46,722
公投第１２案,臺中市,清水區,中社里,124,1609,633,298,931,38,969
公投第１２案,臺中市,清水區,中社里,125,1136,419,279,698,27,725
公投第１２案,臺中市,清水區,高西里,126,1302,404,270,674,64,738
公投第１２案,臺中市,清水區,高南里,127,1373,443,272,715,67,782
公投第１２案,臺中市,清水區,高東里,128,1257,327,263,590,66,656
公投第１２案,臺中市,清水區,高北里,129,1184,332,224,556,49,605
公投第１２案,臺中市,清水區,高美里,130,1322,419,278,697,52,749
公投第１２案,臺中市,清水區,國姓里,131,1193,357,228,585,45,630
公投第１２案,臺中市,清水區,國姓里,132,927,286,188,474,72,546
公投第１２案,臺中市,清水區,菁埔里,133,1073,388,240,628,44,672
公投第１２案,臺中市,清水區,菁埔里,134,1163,390,275,665,64,729
公投第１２案,臺中市,清水區,頂湳里,135,855,265,175,440,38,478
公投第１２案,臺中市,清水區,頂湳里,136,902,267,188,455,49,504
公投第１２案,臺中市,清水區,田寮里,137,1415,427,346,773,43,816
公投第１２案,臺中市,清水區,田寮里,138,1066,309,237,546,37,583
公投第１２案,臺中市,清水區,橋頭里,139,1391,438,290,728,63,791
公投第１２案,臺中市,清水區,橋頭里,140,1449,439,294,733,33,766
公投第１２案,臺中市,清水區,橋頭里,141,1377,448,338,786,50,836
公投第１２案,臺中市,清水區,橋頭里,142,1423,481,323,804,44,848
公投第１２案,臺中市,清水區,橋頭里,143,1624,567,337,904,40,944
公投第１２案,臺中市,清水區,下湳里,144,1358,319,382,701,77,778
公投第１２案,臺中市,清水區,下湳里,145,1464,430,355,785,70,855
公投第１２案,臺中市,清水區,東山里,146,1211,399,254,653,56,709
公投第１２案,臺中市,清水區,吳厝里,147,1456,466,297,763,34,797
公投第１２案,臺中市,清水區,楊厝里,148,1162,446,227,673,55,728
公投第１２案,臺中市,清水區,海風里,149,1368,555,261,816,63,879
公投第１２案,臺中市,梧棲區,頂寮里,150,1541,473,336,809,63,872
公投第１２案,臺中市,梧棲區,頂寮里,151,1581,515,325,840,45,885
公投第１２案,臺中市,梧棲區,下寮里,152,1083,350,234,584,56,640
公投第１２案,臺中市,梧棲區,下寮里,153,876,303,217,520,10,530
公投第１２案,臺中市,梧棲區,中正里,154,1043,339,244,583,38,621
公投第１２案,臺中市,梧棲區,中正里,155,1502,438,303,741,44,785
公投第１２案,臺中市,梧棲區,中正里,156,1384,455,302,757,44,801
公投第１２案,臺中市,梧棲區,中和里,157,517,191,129,320,29,349
公投第１２案,臺中市,梧棲區,文化里,158,1169,404,278,682,68,750
公投第１２案,臺中市,梧棲區,安仁里,159,863,263,218,481,43,524
公投第１２案,臺中市,梧棲區,草湳里,160,1277,364,242,606,38,644
公投第１２案,臺中市,梧棲區,草湳里,161,1742,515,384,899,51,950
公投第１２案,臺中市,梧棲區,草湳里,162,1342,377,360,737,55,792
公投第１２案,臺中市,梧棲區,草湳里,163,1767,528,432,960,65,1025
公投第１２案,臺中市,梧棲區,南簡里,164,1542,394,326,720,64,784
公投第１２案,臺中市,梧棲區,南簡里,165,1636,507,357,864,33,897
公投第１２案,臺中市,梧棲區,南簡里,166,1796,545,364,909,51,960
公投第１２案,臺中市,梧棲區,福德里,167,1450,441,316,757,46,803
公投第１２案,臺中市,梧棲區,福德里,168,1548,436,333,769,85,854
公投第１２案,臺中市,梧棲區,福德里,169,1366,454,311,765,43,808
公投第１２案,臺中市,梧棲區,大庄里,170,955,327,269,596,25,621
公投第１２案,臺中市,梧棲區,大庄里,171,1305,423,254,677,41,718
公投第１２案,臺中市,梧棲區,大庄里,172,1239,411,289,700,34,734
公投第１２案,臺中市,梧棲區,大庄里,173,1079,359,259,618,51,669
公投第１２案,臺中市,梧棲區,大庄里,174,1220,368,289,657,34,691
公投第１２案,臺中市,梧棲區,大庄里,175,1544,523,350,873,61,934
公投第１２案,臺中市,梧棲區,大村里,176,1460,464,382,846,39,885
公投第１２案,臺中市,梧棲區,大村里,177,1292,419,325,744,46,790
公投第１２案,臺中市,梧棲區,大村里,178,1300,400,290,690,51,741
公投第１２案,臺中市,梧棲區,大村里,179,1555,488,320,808,33,841
公投第１２案,臺中市,梧棲區,興農里,180,1031,321,222,543,34,577
公投第１２案,臺中市,梧棲區,興農里,181,1277,406,306,712,52,764
公投第１２案,臺中市,梧棲區,永寧里,182,1037,308,235,543,40,583
公投第１２案,臺中市,梧棲區,永寧里,183,1187,370,284,654,60,714
公投第１２案,臺中市,梧棲區,永安里,184,1399,419,307,726,49,775
公投第１２案,臺中市,梧棲區,永安里,185,1135,361,250,611,34,645
公投第１２案,臺中市,沙鹿區,居仁里,186,1380,419,294,713,37,750
公投第１２案,臺中市,沙鹿區,洛泉里,187,852,308,178,486,35,521
公投第１２案,臺中市,沙鹿區,洛泉里,188,1176,459,240,699,34,733
公投第１２案,臺中市,沙鹿區,沙鹿里,189,958,341,250,591,55,646
公投第１２案,臺中市,沙鹿區,美仁里,190,488,206,99,305,30,335
公投第１２案,臺中市,沙鹿區,興仁里,191,1177,366,286,652,40,692
公投第１２案,臺中市,沙鹿區,興仁里,192,1285,430,266,696,43,739
公投第１２案,臺中市,沙鹿區,興安里,193,1736,504,378,882,62,944
公投第１２案,臺中市,沙鹿區,興安里,194,1628,542,380,922,70,992
公投第１２案,臺中市,沙鹿區,斗抵里,195,1469,470,295,765,36,801
公投第１２案,臺中市,沙鹿區,斗抵里,196,1423,534,298,832,40,872
公投第１２案,臺中市,沙鹿區,斗抵里,197,1444,473,318,791,70,861
公投第１２案,臺中市,沙鹿區,鹿峰里,198,1469,489,312,801,64,865
公投第１２案,臺中市,沙鹿區,鹿峰里,199,1902,610,422,1032,69,1101
公投第１２案,臺中市,沙鹿區,鹿峰里,200,1675,549,392,941,47,988
公投第１２案,臺中市,沙鹿區,鹿寮里,201,1098,364,230,594,44,638
公投第１２案,臺中市,沙鹿區,鹿寮里,202,1539,516,362,878,61,939
公投第１２案,臺中市,沙鹿區,鹿寮里,203,1329,480,301,781,31,812
公投第１２案,臺中市,沙鹿區,鹿寮里,204,1255,396,371,767,39,806
公投第１２案,臺中市,沙鹿區,鹿寮里,205,1507,493,359,852,59,911
公投第１２案,臺中市,沙鹿區,竹林里,206,1463,473,338,811,58,869
公投第１２案,臺中市,沙鹿區,竹林里,207,1279,411,241,652,60,712
公投第１２案,臺中市,沙鹿區,竹林里,208,1024,308,204,512,38,550
公投第１２案,臺中市,沙鹿區,竹林里,209,1388,428,270,698,60,758
公投第１２案,臺中市,沙鹿區,竹林里,210,1074,381,249,630,22,652
公投第１２案,臺中市,沙鹿區,竹林里,211,1072,381,252,633,31,664
公投第１２案,臺中市,沙鹿區,犁分里,212,1107,384,253,637,48,685
公投第１２案,臺中市,沙鹿區,福興里,213,1947,539,403,942,47,989
公投第１２案,臺中市,沙鹿區,福興里,214,1682,512,338,850,51,901
公投第１２案,臺中市,沙鹿區,北勢里,215,1633,582,327,909,48,957
公投第１２案,臺中市,沙鹿區,北勢里,216,1533,489,298,787,45,832
公投第１２案,臺中市,沙鹿區,北勢里,217,1605,479,285,764,32,796
公投第１２案,臺中市,沙鹿區,晉江里,218,1694,529,348,877,29,906
公投第１２案,臺中市,沙鹿區,六路里,219,1628,495,335,830,47,877
公投第１２案,臺中市,沙鹿區,六路里,220,1665,560,397,957,24,981
公投第１２案,臺中市,沙鹿區,六路里,221,1651,533,335,868,47,915
公投第１２案,臺中市,沙鹿區,南勢里,222,1108,388,259,647,18,665
公投第１２案,臺中市,沙鹿區,南勢里,223,1142,428,239,667,38,705
公投第１２案,臺中市,沙鹿區,南勢里,224,1039,360,210,570,33,603
公投第１２案,臺中市,沙鹿區,埔子里,225,1840,601,364,965,52,1017
公投第１２案,臺中市,沙鹿區,埔子里,226,1872,642,359,1001,38,1039
公投第１２案,臺中市,沙鹿區,埔子里,227,1558,477,302,779,58,837
公投第１２案,臺中市,沙鹿區,三鹿里,228,1739,525,326,851,54,905
公投第１２案,臺中市,沙鹿區,三鹿里,229,1672,496,299,795,45,840
公投第１２案,臺中市,沙鹿區,三鹿里,230,1634,551,331,882,29,911
公投第１２案,臺中市,沙鹿區,三鹿里,231,1616,490,295,785,41,826
公投第１２案,臺中市,沙鹿區,公明里,232,1593,517,354,871,38,909
公投第１２案,臺中市,沙鹿區,公明里,233,981,340,178,518,23,541
公投第１２案,臺中市,沙鹿區,公明里,234,1740,632,353,985,63,1048
公投第１２案,臺中市,沙鹿區,清泉里,235,1247,452,272,724,45,769
公投第１２案,臺中市,沙鹿區,清泉里,236,1047,396,214,610,19,629
公投第１２案,臺中市,沙鹿區,西勢里,237,1119,348,241,589,59,648
公投第１２案,臺中市,沙鹿區,西勢里,238,1025,319,229,548,21,569
公投第１２案,臺中市,龍井區,竹坑里,239,1758,580,407,987,72,1059
公投第１２案,臺中市,龍井區,竹坑里,240,1275,414,278,692,46,738
公投第１２案,臺中市,龍井區,龍東里,241,1379,396,273,669,30,699
公投第１２案,臺中市,龍井區,龍東里,242,1403,434,272,706,43,749
公投第１２案,臺中市,龍井區,龍西里,243,974,324,206,530,39,569
公投第１２案,臺中市,龍井區,龍西里,244,901,310,193,503,42,545
公投第１２案,臺中市,龍井區,田中里,245,1779,509,429,938,60,998
公投第１２案,臺中市,龍井區,田中里,246,1609,516,379,895,63,958
公投第１２案,臺中市,龍井區,福田里,247,1038,332,198,530,23,553
公投第１２案,臺中市,龍井區,麗水里,248,1328,444,303,747,64,811
公投第１２案,臺中市,龍井區,麗水里,249,921,288,238,526,47,573
公投第１２案,臺中市,龍井區,龍津里,250,1609,454,331,785,56,841
公投第１２案,臺中市,龍井區,龍津里,251,1227,328,254,582,28,610
公投第１２案,臺中市,龍井區,龍津里,252,1278,407,275,682,47,729
公投第１２案,臺中市,龍井區,龍津里,253,914,211,189,400,26,426
公投第１２案,臺中市,龍井區,三德里,254,1678,452,336,788,38,826
公投第１２案,臺中市,龍井區,三德里,255,1233,383,216,599,39,638
公投第１２案,臺中市,龍井區,忠和里,256,1520,483,312,795,69,864
公投第１２案,臺中市,龍井區,忠和里,257,1905,596,359,955,41,996
公投第１２案,臺中市,龍井區,忠和里,258,1520,797,71,868,45,913
公投第１２案,臺中市,龍井區,山腳里,259,1385,265,393,658,92,750
公投第１２案,臺中市,龍井區,山腳里,260,1212,366,270,636,43,679
公投第１２案,臺中市,龍井區,山腳里,261,1432,507,288,795,30,825
公投第１２案,臺中市,龍井區,山腳里,262,1663,535,330,865,43,908
公投第１２案,臺中市,龍井區,龍泉里,263,1422,429,295,724,39,763
公投第１２案,臺中市,龍井區,龍泉里,264,1616,450,306,756,62,818
公投第１２案,臺中市,龍井區,龍泉里,265,1422,485,300,785,58,843
公投第１２案,臺中市,龍井區,龍泉里,266,1165,439,229,668,28,696
公投第１２案,臺中市,龍井區,龍泉里,267,1624,530,344,874,26,900
公投第１２案,臺中市,龍井區,龍崗里,268,1613,504,348,852,55,907
公投第１２案,臺中市,龍井區,龍崗里,269,943,365,190,555,34,589
公投第１２案,臺中市,龍井區,新庄里,270,1595,511,294,805,63,868
公投第１２案,臺中市,龍井區,新庄里,271,1508,526,317,843,46,889
公投第１２案,臺中市,龍井區,新庄里,272,1479,472,287,759,32,791
公投第１２案,臺中市,龍井區,新庄里,273,1509,524,318,842,36,878
公投第１２案,臺中市,龍井區,南寮里,274,1582,595,333,928,50,978
公投第１２案,臺中市,龍井區,東海里,275,1725,584,352,936,53,989
公投第１２案,臺中市,龍井區,東海里,276,1616,699,203,902,35,937
公投第１２案,臺中市,龍井區,東海里,277,1657,614,341,955,39,994
公投第１２案,臺中市,龍井區,東海里,278,1774,583,430,1013,43,1056
公投第１２案,臺中市,龍井區,東海里,279,1701,608,392,1000,37,1037
公投第１２案,臺中市,龍井區,新東里,280,1121,375,260,635,33,668
公投第１２案,臺中市,龍井區,新東里,281,987,255,332,587,36,623
公投第１２案,臺中市,龍井區,新東里,282,1206,410,251,661,50,711
公投第１２案,臺中市,龍井區,新東里,283,1378,514,297,811,36,847
公投第１２案,臺中市,大肚區,王田里,284,1415,437,344,781,28,809
公投第１２案,臺中市,大肚區,王田里,285,1392,383,322,705,43,748
公投第１２案,臺中市,大肚區,王田里,286,1520,544,323,867,55,922
公投第１２案,臺中市,大肚區,中和里,287,862,294,226,520,64,584
公投第１２案,臺中市,大肚區,福山里,288,1256,469,266,735,46,781
公投第１２案,臺中市,大肚區,福山里,289,1292,446,260,706,42,748
公投第１２案,臺中市,大肚區,福山里,290,1010,346,240,586,31,617
公投第１２案,臺中市,大肚區,營埔里,291,1485,471,379,850,68,918
公投第１２案,臺中市,大肚區,社腳里,292,1190,437,264,701,65,766
公投第１２案,臺中市,大肚區,社腳里,293,1250,406,272,678,66,744
公投第１２案,臺中市,大肚區,新興里,294,1310,426,318,744,38,782
公投第１２案,臺中市,大肚區,新興里,295,1294,400,295,695,40,735
公投第１２案,臺中市,大肚區,大東里,296,1734,619,432,1051,45,1096
公投第１２案,臺中市,大肚區,大東里,297,1316,416,282,698,56,754
公投第１２案,臺中市,大肚區,大肚里,298,854,274,195,469,41,510
公投第１２案,臺中市,大肚區,大肚里,299,1273,443,326,769,53,822
公投第１２案,臺中市,大肚區,永和里,300,851,337,167,504,32,536
公投第１２案,臺中市,大肚區,磺溪里,301,1629,534,351,885,32,917
公投第１２案,臺中市,大肚區,永順里,302,1709,498,380,878,87,965
公投第１２案,臺中市,大肚區,成功里,303,953,302,188,490,32,522
公投第１２案,臺中市,大肚區,山陽里,304,1336,445,320,765,47,812
公投第１２案,臺中市,大肚區,頂街里,305,2113,599,475,1074,71,1145
公投第１２案,臺中市,大肚區,頂街里,306,1730,575,371,946,77,1023
公投第１２案,臺中市,大肚區,頂街里,307,1692,547,381,928,29,957
公投第１２案,臺中市,大肚區,頂街里,308,1747,602,362,964,51,1015
公投第１２案,臺中市,大肚區,瑞井里,309,1672,585,321,906,54,960
公投第１２案,臺中市,大肚區,瑞井里,310,1675,514,341,855,51,906
公投第１２案,臺中市,大肚區,瑞井里,311,1673,566,351,917,44,961
公投第１２案,臺中市,大肚區,蔗廍里,312,1636,605,332,937,43,980
公投第１２案,臺中市,大肚區,蔗廍里,313,1753,571,355,926,29,955
公投第１２案,臺中市,大肚區,蔗廍里,314,1343,424,265,689,30,719
公投第１２案,臺中市,大肚區,自強里,315,1822,619,348,967,57,1024
公投第１２案,臺中市,大肚區,自強里,316,1670,622,316,938,95,1033
公投第１２案,臺中市,烏日區,烏日里,317,1480,560,331,891,39,930
公投第１２案,臺中市,烏日區,烏日里,318,1841,625,450,1075,72,1147
公投第１２案,臺中市,烏日區,烏日里,319,1751,584,363,947,51,998
公投第１２案,臺中市,烏日區,烏日里,320,1547,550,350,900,56,956
公投第１２案,臺中市,烏日區,烏日里,321,1836,637,394,1031,36,1067
公投第１２案,臺中市,烏日區,湖日里,322,1239,482,295,777,59,836
公投第１２案,臺中市,烏日區,湖日里,323,1295,400,292,692,57,749
公投第１２案,臺中市,烏日區,三和里,324,1263,395,272,667,53,720
公投第１２案,臺中市,烏日區,三和里,325,1622,512,367,879,37,916
公投第１２案,臺中市,烏日區,三和里,326,1822,604,355,959,81,1040
公投第１２案,臺中市,烏日區,榮泉里,327,1966,577,460,1037,66,1103
公投第１２案,臺中市,烏日區,榮泉里,328,1615,563,350,913,39,952
公投第１２案,臺中市,烏日區,榮泉里,329,1232,448,273,721,31,752
公投第１２案,臺中市,烏日區,學田里,330,1347,461,254,715,31,746
公投第１２案,臺中市,烏日區,學田里,331,1165,347,247,594,32,626
公投第１２案,臺中市,烏日區,九德里,332,1664,607,351,958,48,1006
公投第１２案,臺中市,烏日區,九德里,333,1230,454,274,728,48,776
公投第１２案,臺中市,烏日區,九德里,334,1574,584,346,930,68,998
公投第１２案,臺中市,烏日區,九德里,335,1452,531,361,892,38,930
公投第１２案,臺中市,烏日區,九德里,336,1879,632,339,971,59,1030
公投第１２案,臺中市,烏日區,九德里,337,1601,510,367,877,51,928
公投第１２案,臺中市,烏日區,九德里,338,1546,586,351,937,37,974
公投第１２案,臺中市,烏日區,九德里,339,1866,462,454,916,40,956
公投第１２案,臺中市,烏日區,仁德里,340,1938,665,418,1083,67,1150
公投第１２案,臺中市,烏日區,仁德里,341,1759,621,357,978,43,1021
公投第１２案,臺中市,烏日區,仁德里,342,2061,778,313,1091,62,1153
公投第１２案,臺中市,烏日區,仁德里,343,1691,626,325,951,50,1001
公投第１２案,臺中市,烏日區,前竹里,344,1039,387,250,637,44,681
公投第１２案,臺中市,烏日區,前竹里,345,1221,440,272,712,47,759
公投第１２案,臺中市,烏日區,五光里,346,1650,542,396,938,74,1012
公投第１２案,臺中市,烏日區,光明里,347,937,311,234,545,40,585
公投第１２案,臺中市,烏日區,光明里,348,1220,388,312,700,28,728
公投第１２案,臺中市,烏日區,東園里,349,2139,547,485,1032,76,1108
公投第１２案,臺中市,烏日區,溪埧里,350,1371,544,304,848,48,896
公投第１２案,臺中市,烏日區,溪埧里,351,1277,415,275,690,59,749
公投第１２案,臺中市,烏日區,溪埧里,352,1708,523,373,896,63,959
公投第１２案,臺中市,烏日區,螺潭里,353,2048,666,405,1071,78,1149
公投第１２案,臺中市,烏日區,北里里,354,1632,501,354,855,53,908
公投第１２案,臺中市,烏日區,南里里,355,1327,455,296,751,59,810
公投第１２案,臺中市,烏日區,溪尾里,356,854,266,171,437,59,496
公投第１２案,臺中市,后里區,廣福里,357,852,313,184,497,50,547
公投第１２案,臺中市,后里區,廣福里,358,1135,357,237,594,56,650
公投第１２案,臺中市,后里區,仁里里,359,1079,322,205,527,53,580
公投第１２案,臺中市,后里區,義里里,360,1539,518,332,850,55,905
公投第１２案,臺中市,后里區,義里里,361,1591,512,364,876,53,929
公投第１２案,臺中市,后里區,義德里,362,1376,402,276,678,39,717
公投第１２案,臺中市,后里區,義德里,363,1298,281,434,715,30,745
公投第１２案,臺中市,后里區,后里里,364,1428,452,324,776,78,854
公投第１２案,臺中市,后里區,后里里,365,1178,433,302,735,48,783
公投第１２案,臺中市,后里區,后里里,366,1095,368,251,619,37,656
公投第１２案,臺中市,后里區,厚里里,367,963,318,213,531,20,551
公投第１２案,臺中市,后里區,厚里里,368,1163,388,244,632,43,675
公投第１２案,臺中市,后里區,墩東里,369,1018,339,246,585,35,620
公投第１２案,臺中市,后里區,墩東里,370,854,296,219,515,37,552
公投第１２案,臺中市,后里區,墩東里,371,1485,413,344,757,57,814
公投第１２案,臺中市,后里區,墩東里,372,1355,489,331,820,43,863
公投第１２案,臺中市,后里區,墩西里,373,840,255,173,428,39,467
公投第１２案,臺中市,后里區,墩西里,374,1146,388,259,647,41,688
公投第１２案,臺中市,后里區,墩南里,375,1669,565,406,971,56,1027
公投第１２案,臺中市,后里區,墩南里,376,1673,516,450,966,78,1044
公投第１２案,臺中市,后里區,墩北里,377,1493,494,346,840,35,875
公投第１２案,臺中市,后里區,墩北里,378,1052,356,252,608,52,660
公投第１２案,臺中市,后里區,墩北里,379,909,274,203,477,28,505
公投第１２案,臺中市,后里區,中和里,380,1091,382,227,609,64,673
公投第１２案,臺中市,后里區,中和里,381,1342,471,280,751,80,831
公投第１２案,臺中市,后里區,舊社里,382,1138,343,251,594,55,649
公投第１２案,臺中市,后里區,舊社里,383,977,304,254,558,34,592
公投第１２案,臺中市,后里區,聯合里,384,1584,434,299,733,42,775
公投第１２案,臺中市,后里區,太平里,385,915,293,199,492,39,531
公投第１２案,臺中市,后里區,太平里,386,1225,367,312,679,64,743
公投第１２案,臺中市,后里區,眉山里,387,1552,468,372,840,34,874
公投第１２案,臺中市,后里區,眉山里,388,1600,523,345,868,23,891
公投第１２案,臺中市,后里區,月眉里,389,942,299,206,505,31,536
公投第１２案,臺中市,后里區,月眉里,390,943,297,200,497,30,527
公投第１２案,臺中市,后里區,公館里,391,1055,318,204,522,40,562
公投第１２案,臺中市,后里區,公館里,392,1067,340,244,584,48,632
公投第１２案,臺中市,后里區,泰安里,393,1340,390,278,668,46,714
公投第１２案,臺中市,豐原區,豐原里,394,983,327,202,529,34,563
公投第１２案,臺中市,豐原區,豐原里,395,1309,486,289,775,50,825
公投第１２案,臺中市,豐原區,豐榮里,396,1116,401,264,665,33,698
公投第１２案,臺中市,豐原區,頂街里,397,945,362,215,577,37,614
公投第１２案,臺中市,豐原區,中山里,398,850,302,204,506,48,554
公投第１２案,臺中市,豐原區,下街里,399,760,281,194,475,24,499
公投第１２案,臺中市,豐原區,中陽里,400,1617,591,325,916,13,929
公投第１２案,臺中市,豐原區,中陽里,401,1677,537,303,840,52,892
公投第１２案,臺中市,豐原區,中陽里,402,1771,656,436,1092,47,1139
公投第１２案,臺中市,豐原區,大湳里,403,1145,381,236,617,51,668
公投第１２案,臺中市,豐原區,大湳里,404,1362,473,273,746,37,783
公投第１２案,臺中市,豐原區,北湳里,405,1389,504,294,798,48,846
公投第１２案,臺中市,豐原區,北湳里,406,1530,544,343,887,45,932
公投第１２案,臺中市,豐原區,東湳里,407,1471,478,346,824,60,884
公投第１２案,臺中市,豐原區,東湳里,408,1410,483,325,808,58,866
公投第１２案,臺中市,豐原區,東湳里,409,1162,392,251,643,40,683
公投第１２案,臺中市,豐原區,西湳里,410,1656,554,363,917,36,953
公投第１２案,臺中市,豐原區,西湳里,411,1838,624,373,997,51,1048
公投第１２案,臺中市,豐原區,西湳里,412,1666,550,351,901,52,953
公投第１２案,臺中市,豐原區,西湳里,413,1821,655,362,1017,82,1099
公投第１２案,臺中市,豐原區,西湳里,414,1821,697,462,1159,58,1217
公投第１２案,臺中市,豐原區,豐西里,415,1647,559,352,911,34,945
公投第１２案,臺中市,豐原區,圳寮里,416,1256,483,312,795,52,847
公投第１２案,臺中市,豐原區,豐圳里,417,1552,570,387,957,48,1005
公投第１２案,臺中市,豐原區,豐圳里,418,1793,630,387,1017,46,1063
公投第１２案,臺中市,豐原區,富春里,419,759,312,185,497,35,532
公投第１２案,臺中市,豐原區,葫蘆里,420,642,250,152,402,23,425
公投第１２案,臺中市,豐原區,西安里,421,1528,591,329,920,27,947
公投第１２案,臺中市,豐原區,西安里,422,1788,671,416,1087,56,1143
公投第１２案,臺中市,豐原區,西安里,423,1663,654,373,1027,63,1090
公投第１２案,臺中市,豐原區,西勢里,424,1260,531,293,824,50,874
公投第１２案,臺中市,豐原區,西勢里,425,902,321,190,511,28,539
公投第１２案,臺中市,豐原區,中興里,426,1357,465,276,741,21,762
公投第１２案,臺中市,豐原區,中興里,427,1592,475,366,841,42,883
公投第１２案,臺中市,豐原區,社皮里,428,1873,701,341,1042,58,1100
公投第１２案,臺中市,豐原區,社皮里,429,1867,627,415,1042,50,1092
公投第１２案,臺中市,豐原區,社皮里,430,1823,636,358,994,68,1062
公投第１２案,臺中市,豐原區,社皮里,431,1962,578,409,987,58,1045
公投第１２案,臺中市,豐原區,社皮里,432,2313,811,539,1350,61,1411
公投第１２案,臺中市,豐原區,三村里,433,1510,556,336,892,52,944
公投第１２案,臺中市,豐原區,三村里,434,1824,648,393,1041,55,1096
公投第１２案,臺中市,豐原區,三村里,435,1363,521,289,810,33,843
公投第１２案,臺中市,豐原區,三村里,436,1535,567,367,934,45,979
公投第１２案,臺中市,豐原區,東勢里,437,1457,515,351,866,46,912
公投第１２案,臺中市,豐原區,民生里,438,1184,422,285,707,30,737
公投第１２案,臺中市,豐原區,田心里,439,2299,652,432,1084,42,1126
公投第１２案,臺中市,豐原區,田心里,440,1940,655,440,1095,57,1152
公投第１２案,臺中市,豐原區,田心里,441,2067,684,459,1143,38,1181
公投第１２案,臺中市,豐原區,豐田里,442,2038,669,407,1076,84,1160
公投第１２案,臺中市,豐原區,豐田里,443,1835,602,427,1029,38,1067
公投第１２案,臺中市,豐原區,豐田里,444,1979,635,437,1072,76,1148
公投第１２案,臺中市,豐原區,豐田里,445,2014,619,450,1069,76,1145
公投第１２案,臺中市,豐原區,豐田里,446,2257,766,476,1242,85,1327
公投第１２案,臺中市,豐原區,鎌村里,447,1406,506,330,836,57,893
公投第１２案,臺中市,豐原區,鎌村里,448,1418,500,333,833,35,868
公投第１２案,臺中市,豐原區,鎌村里,449,1772,654,412,1066,61,1127
公投第１２案,臺中市,豐原區,陽明里,450,1202,449,293,742,37,779
公投第１２案,臺中市,豐原區,陽明里,451,1447,573,293,866,32,898
公投第１２案,臺中市,豐原區,南陽里,452,1758,617,383,1000,82,1082
公投第１２案,臺中市,豐原區,南陽里,453,1546,580,367,947,49,996
公投第１２案,臺中市,豐原區,南陽里,454,1815,679,397,1076,47,1123
公投第１２案,臺中市,豐原區,南陽里,455,1932,648,454,1102,71,1173
公投第１２案,臺中市,豐原區,南陽里,456,1770,665,422,1087,51,1138
公投第１２案,臺中市,豐原區,南陽里,457,1560,549,289,838,34,872
公投第１２案,臺中市,豐原區,北陽里,458,1810,626,397,1023,44,1067
公投第１２案,臺中市,豐原區,北陽里,459,1653,609,404,1013,40,1053
公投第１２案,臺中市,豐原區,北陽里,460,1444,504,301,805,58,863
公投第１２案,臺中市,豐原區,北陽里,461,1318,478,326,804,37,841
公投第１２案,臺中市,豐原區,北陽里,462,1566,529,366,895,63,958
公投第１２案,臺中市,豐原區,北陽里,463,1748,596,376,972,57,1029
公投第１２案,臺中市,豐原區,北陽里,464,1772,512,385,897,73,970
公投第１２案,臺中市,豐原區,北陽里,465,1721,587,364,951,63,1014
公投第１２案,臺中市,豐原區,東陽里,466,1578,560,347,907,46,953
公投第１２案,臺中市,豐原區,南村里,467,1859,596,429,1025,70,1095
公投第１２案,臺中市,豐原區,南村里,468,1479,510,330,840,45,885
公投第１２案,臺中市,豐原區,南村里,469,1889,664,405,1069,61,1130
公投第１２案,臺中市,豐原區,南田里,470,1803,575,408,983,54,1037
公投第１２案,臺中市,豐原區,南田里,471,1421,417,357,774,47,821
公投第１２案,臺中市,豐原區,南嵩里,472,1585,556,391,947,54,1001
公投第１２案,臺中市,豐原區,南嵩里,473,1774,657,398,1055,67,1122
公投第１２案,臺中市,豐原區,翁明里,474,2132,762,444,1206,62,1268
公投第１２案,臺中市,豐原區,翁子里,475,1515,550,306,856,54,910
公投第１２案,臺中市,豐原區,翁子里,476,1359,467,263,730,36,766
公投第１２案,臺中市,豐原區,翁社里,477,948,337,212,549,51,600
公投第１２案,臺中市,豐原區,翁社里,478,1134,382,290,672,39,711
公投第１２案,臺中市,豐原區,朴子里,479,1114,425,263,688,61,749
公投第１２案,臺中市,豐原區,朴子里,480,1050,338,264,602,48,650
公投第１２案,臺中市,豐原區,朴子里,481,1182,394,333,727,49,776
公投第１２案,臺中市,神岡區,神岡里,482,1684,581,384,965,58,1023
公投第１２案,臺中市,神岡區,神岡里,483,1559,548,343,891,36,927
公投第１２案,臺中市,神岡區,庄前里,484,1095,360,240,600,44,644
公投第１２案,臺中市,神岡區,庄前里,485,1044,390,286,676,34,710
公投第１２案,臺中市,神岡區,北庄里,486,1310,509,308,817,40,857
公投第１２案,臺中市,神岡區,北庄里,487,1294,477,291,768,55,823
公投第１２案,臺中市,神岡區,庄後里,488,1143,390,257,647,49,696
公投第１２案,臺中市,神岡區,庄後里,489,1022,375,216,591,48,639
公投第１２案,臺中市,神岡區,圳前里,490,1269,428,258,686,41,727
公投第１２案,臺中市,神岡區,圳前里,491,1085,337,178,515,29,544
公投第１２案,臺中市,神岡區,圳堵里,492,942,297,272,569,30,599
公投第１２案,臺中市,神岡區,圳堵里,493,1154,389,261,650,37,687
公投第１２案,臺中市,神岡區,新庄里,494,1390,452,286,738,52,790
公投第１２案,臺中市,神岡區,新庄里,495,1372,492,320,812,56,868
公投第１２案,臺中市,神岡區,新庄里,496,1328,415,277,692,42,734
公投第１２案,臺中市,神岡區,山皮里,497,1038,346,233,579,28,607
公投第１２案,臺中市,神岡區,社口里,498,1452,443,335,778,43,821
公投第１２案,臺中市,神岡區,社口里,499,1551,544,367,911,48,959
公投第１２案,臺中市,神岡區,社口里,500,1567,485,333,818,50,868
公投第１２案,臺中市,神岡區,社口里,501,1449,474,338,812,31,843
公投第１２案,臺中市,神岡區,社口里,502,1246,379,254,633,31,664
公投第１２案,臺中市,神岡區,社南里,503,1431,508,313,821,41,862
公投第１２案,臺中市,神岡區,社南里,504,1163,395,279,674,61,735
公投第１２案,臺中市,神岡區,社南里,505,1402,546,310,856,47,903
公投第１２案,臺中市,神岡區,社南里,506,1271,436,283,719,48,767
公投第１２案,臺中市,神岡區,三角里,507,1198,266,420,686,55,741
公投第１２案,臺中市,神岡區,三角里,508,1312,485,288,773,39,812
公投第１２案,臺中市,神岡區,大社里,509,1590,551,324,875,35,910
公投第１２案,臺中市,神岡區,大社里,510,1324,431,270,701,39,740
公投第１２案,臺中市,神岡區,大社里,511,1415,448,310,758,36,794
公投第１２案,臺中市,神岡區,岸裡里,512,1483,563,348,911,51,962
公投第１２案,臺中市,神岡區,岸裡里,513,1402,477,263,740,33,773
公投第１２案,臺中市,神岡區,豐洲里,514,1275,397,278,675,41,716
公投第１２案,臺中市,神岡區,豐洲里,515,1288,402,265,667,40,707
公投第１２案,臺中市,神岡區,豐洲里,516,1080,347,222,569,49,618
公投第１２案,臺中市,神岡區,豐洲里,517,1344,434,300,734,30,764
公投第１２案,臺中市,神岡區,豐洲里,518,1061,378,254,632,38,670
公投第１２案,臺中市,神岡區,豐洲里,519,1176,413,292,705,44,749
公投第１２案,臺中市,神岡區,神洲里,520,1244,455,272,727,56,783
公投第１２案,臺中市,神岡區,神洲里,521,1318,476,322,798,58,856
公投第１２案,臺中市,神岡區,溪洲里,522,1471,491,306,797,51,848
公投第１２案,臺中市,神岡區,溪洲里,523,1323,484,329,813,65,878
公投第１２案,臺中市,大雅區,上雅里,524,2027,640,473,1113,49,1162
公投第１２案,臺中市,大雅區,上雅里,525,1967,636,363,999,38,1037
公投第１２案,臺中市,大雅區,上雅里,526,1912,603,404,1007,42,1049
公投第１２案,臺中市,大雅區,大雅里,527,1537,525,377,902,42,944
公投第１２案,臺中市,大雅區,大雅里,528,1439,553,321,874,37,911
公投第１２案,臺中市,大雅區,大雅里,529,1402,474,315,789,48,837
公投第１２案,臺中市,大雅區,文雅里,530,2013,619,441,1060,43,1103
公投第１２案,臺中市,大雅區,文雅里,531,1917,623,438,1061,63,1124
公投第１２案,臺中市,大雅區,文雅里,532,2011,625,451,1076,42,1118
公投第１２案,臺中市,大雅區,三和里,533,1887,730,336,1066,50,1116
公投第１２案,臺中市,大雅區,三和里,534,1480,517,361,878,34,912
公投第１２案,臺中市,大雅區,三和里,535,1816,605,397,1002,46,1048
公投第１２案,臺中市,大雅區,二和里,536,1898,558,369,927,60,987
公投第１２案,臺中市,大雅區,二和里,537,2008,661,425,1086,65,1151
公投第１２案,臺中市,大雅區,二和里,538,1976,702,407,1109,44,1153
公投第１２案,臺中市,大雅區,四德里,539,1673,564,394,958,25,983
公投第１２案,臺中市,大雅區,四德里,540,1409,522,330,852,35,887
公投第１２案,臺中市,大雅區,四德里,541,1382,491,325,816,16,832
公投第１２案,臺中市,大雅區,西寶里,542,1635,524,344,868,64,932
公投第１２案,臺中市,大雅區,西寶里,543,1565,557,334,891,43,934
公投第１２案,臺中市,大雅區,西寶里,544,1528,494,321,815,39,854
公投第１２案,臺中市,大雅區,上楓里,545,1963,639,405,1044,32,1076
公投第１２案,臺中市,大雅區,上楓里,546,2073,685,381,1066,43,1109
公投第１２案,臺中市,大雅區,上楓里,547,1984,665,374,1039,65,1104
公投第１２案,臺中市,大雅區,大楓里,548,1688,532,378,910,38,948
公投第１２案,臺中市,大雅區,大楓里,549,1387,484,298,782,29,811
公投第１２案,臺中市,大雅區,大楓里,550,1701,595,367,962,76,1038
公投第１２案,臺中市,大雅區,雅楓里,551,1721,547,384,931,46,977
公投第１２案,臺中市,大雅區,雅楓里,552,1879,578,301,879,50,929
公投第１２案,臺中市,大雅區,員林里,553,1568,524,382,906,49,955
公投第１２案,臺中市,大雅區,員林里,554,1761,562,409,971,70,1041
公投第１２案,臺中市,大雅區,員林里,555,1752,601,380,981,93,1074
公投第１２案,臺中市,大雅區,員林里,556,1264,435,283,718,42,760
公投第１２案,臺中市,大雅區,員林里,557,1302,497,287,784,34,818
公投第１２案,臺中市,大雅區,員林里,558,1449,446,334,780,54,834
公投第１２案,臺中市,大雅區,六寶里,559,1621,564,359,923,64,987
公投第１２案,臺中市,大雅區,六寶里,560,1647,525,338,863,64,927
公投第１２案,臺中市,大雅區,六寶里,561,1441,486,299,785,36,821
公投第１２案,臺中市,大雅區,六寶里,562,1460,477,314,791,28,819
公投第１２案,臺中市,大雅區,秀山里,563,1832,648,431,1079,48,1127
公投第１２案,臺中市,大雅區,秀山里,564,1371,484,343,827,45,872
公投第１２案,臺中市,大雅區,橫山里,565,1418,446,302,748,16,764
公投第１２案,臺中市,大雅區,橫山里,566,1473,512,354,866,35,901
公投第１２案,臺中市,大雅區,橫山里,567,1335,441,311,752,43,795
公投第１２案,臺中市,大雅區,忠義里,568,1733,663,285,948,48,996
公投第１２案,臺中市,大雅區,忠義里,569,1884,596,307,903,60,963
公投第１２案,臺中市,潭子區,潭秀里,570,1306,464,292,756,48,804
公投第１２案,臺中市,潭子區,潭北里,571,1128,406,252,658,46,704
公投第１２案,臺中市,潭子區,潭北里,572,1159,404,295,699,49,748
公投第１２案,臺中市,潭子區,潭陽里,573,1630,575,366,941,64,1005
公投第１２案,臺中市,潭子區,潭陽里,574,1532,543,309,852,32,884
公投第１２案,臺中市,潭子區,潭陽里,575,1677,524,333,857,40,897
公投第１２案,臺中市,潭子區,潭陽里,576,1744,559,339,898,37,935
公投第１２案,臺中市,潭子區,潭陽里,577,1795,574,412,986,52,1038
公投第１２案,臺中市,潭子區,潭陽里,578,1171,395,251,646,38,684
公投第１２案,臺中市,潭子區,潭陽里,579,1427,480,317,797,22,819
公投第１２案,臺中市,潭子區,福仁里,580,1709,572,380,952,43,995
公投第１２案,臺中市,潭子區,福仁里,581,1723,578,364,942,46,988
公投第１２案,臺中市,潭子區,福仁里,582,1782,561,368,929,58,987
公投第１２案,臺中市,潭子區,福仁里,583,1407,433,300,733,37,770
公投第１２案,臺中市,潭子區,福仁里,584,1771,602,425,1027,36,1063
公投第１２案,臺中市,潭子區,福仁里,585,1795,668,346,1014,70,1084
公投第１２案,臺中市,潭子區,頭家里,586,1612,616,339,955,52,1007
公投第１２案,臺中市,潭子區,頭家里,587,1894,623,408,1031,42,1073
公投第１２案,臺中市,潭子區,頭家里,588,1689,555,373,928,43,971
公投第１２案,臺中市,潭子區,頭家東里,589,1525,499,306,805,46,851
公投第１２案,臺中市,潭子區,頭家東里,590,1622,557,331,888,37,925
公投第１２案,臺中市,潭子區,頭家東里,591,1200,392,271,663,59,722
公投第１２案,臺中市,潭子區,家興里,592,1355,457,267,724,22,746
公投第１２案,臺中市,潭子區,家興里,593,1777,611,347,958,26,984
公投第１２案,臺中市,潭子區,家興里,594,1923,698,366,1064,32,1096
公投第１２案,臺中市,潭子區,家興里,595,1674,619,260,879,47,926
公投第１２案,臺中市,潭子區,家福里,596,1451,534,341,875,39,914
公投第１２案,臺中市,潭子區,家福里,597,1486,522,312,834,51,885
公投第１２案,臺中市,潭子區,家福里,598,1511,519,356,875,39,914
公投第１２案,臺中市,潭子區,甘蔗里,599,1666,587,371,958,45,1003
公投第１２案,臺中市,潭子區,甘蔗里,600,1750,688,255,943,49,992
公投第１２案,臺中市,潭子區,甘蔗里,601,1437,490,292,782,36,818
公投第１２案,臺中市,潭子區,甘蔗里,602,1735,620,329,949,37,986
公投第１２案,臺中市,潭子區,甘蔗里,603,1612,546,345,891,30,921
公投第１２案,臺中市,潭子區,甘蔗里,604,1143,418,260,678,26,704
公投第１２案,臺中市,潭子區,東寶里,605,2096,713,409,1122,46,1168
公投第１２案,臺中市,潭子區,東寶里,606,1549,598,310,908,36,944
公投第１２案,臺中市,潭子區,東寶里,607,1573,546,365,911,42,953
公投第１２案,臺中市,潭子區,東寶里,608,1585,550,287,837,42,879
公投第１２案,臺中市,潭子區,東寶里,609,1572,532,324,856,33,889
公投第１２案,臺中市,潭子區,東寶里,610,1738,618,385,1003,54,1057
公投第１２案,臺中市,潭子區,東寶里,611,1883,620,372,992,63,1055
公投第１２案,臺中市,潭子區,大富里,612,1401,514,341,855,30,885
公投第１２案,臺中市,潭子區,大富里,613,1352,472,326,798,34,832
公投第１２案,臺中市,潭子區,大豐里,614,2085,712,440,1152,78,1230
公投第１２案,臺中市,潭子區,大豐里,615,2047,725,441,1166,76,1242
公投第１２案,臺中市,潭子區,大豐里,616,1673,553,328,881,30,911
公投第１２案,臺中市,潭子區,栗林里,617,1874,608,434,1042,74,1116
公投第１２案,臺中市,潭子區,栗林里,618,1051,349,251,600,38,638
公投第１２案,臺中市,潭子區,栗林里,619,1674,519,351,870,28,898
公投第１２案,臺中市,潭子區,嘉仁里,620,1831,573,434,1007,70,1077
公投第１２案,臺中市,潭子區,嘉仁里,621,2003,640,416,1056,61,1117
公投第１２案,臺中市,潭子區,新田里,622,1535,559,311,870,40,910
公投第１２案,臺中市,潭子區,聚興里,623,2286,702,393,1095,77,1172
公投第１２案,臺中市,潭子區,聚興里,624,1861,593,357,950,56,1006
公投第１２案,臺中市,西屯區,西安里,625,1638,601,388,989,38,1027
公投第１２案,臺中市,西屯區,西安里,626,1335,421,305,726,25,751
公投第１２案,臺中市,西屯區,西安里,627,1776,661,358,1019,29,1048
公投第１２案,臺中市,西屯區,至善里,628,1351,453,297,750,33,783
公投第１２案,臺中市,西屯區,至善里,629,1338,466,320,786,31,817
公投第１２案,臺中市,西屯區,至善里,630,1582,554,341,895,30,925
公投第１２案,臺中市,西屯區,西平里,631,1710,562,342,904,27,931
公投第１２案,臺中市,西屯區,西平里,632,1595,474,340,814,37,851
公投第１２案,臺中市,西屯區,西平里,633,1585,574,300,874,65,939
公投第１２案,臺中市,西屯區,西墩里,634,1749,586,346,932,56,988
公投第１２案,臺中市,西屯區,西墩里,635,1877,690,350,1040,35,1075
公投第１２案,臺中市,西屯區,西墩里,636,1697,555,343,898,30,928
公投第１２案,臺中市,西屯區,潮洋里,637,1480,540,339,879,31,910
公投第１２案,臺中市,西屯區,潮洋里,638,1483,555,370,925,47,972
公投第１２案,臺中市,西屯區,潮洋里,639,2484,526,351,877,29,906
公投第１２案,臺中市,西屯區,龍潭里,640,781,311,186,497,30,527
公投第１２案,臺中市,西屯區,惠來里,641,1477,549,311,860,44,904
公投第１２案,臺中市,西屯區,惠來里,642,1784,578,377,955,45,1000
公投第１２案,臺中市,西屯區,惠來里,643,1686,581,338,919,39,958
公投第１２案,臺中市,西屯區,惠來里,644,1692,569,366,935,36,971
公投第１２案,臺中市,西屯區,惠來里,645,1659,652,226,878,28,906
公投第１２案,臺中市,西屯區,惠來里,646,1648,585,354,939,23,962
公投第１２案,臺中市,西屯區,惠來里,647,1536,554,358,912,28,940
公投第１２案,臺中市,西屯區,惠來里,648,1666,589,381,970,32,1002
公投第１２案,臺中市,西屯區,上石里,649,1428,480,335,815,49,864
公投第１２案,臺中市,西屯區,上石里,650,1810,568,370,938,51,989
公投第１２案,臺中市,西屯區,上石里,651,1574,528,338,866,23,889
公投第１２案,臺中市,西屯區,上安里,652,1650,579,348,927,12,939
公投第１２案,臺中市,西屯區,上安里,653,1681,528,366,894,79,973
公投第１２案,臺中市,西屯區,上安里,654,1656,528,352,880,33,913
公投第１２案,臺中市,西屯區,上德里,655,1243,470,252,722,45,767
公投第１２案,臺中市,西屯區,上德里,656,1471,547,351,898,41,939
公投第１２案,臺中市,西屯區,上德里,657,1431,535,329,864,32,896
公投第１２案,臺中市,西屯區,逢甲里,658,1714,579,364,943,35,978
公投第１２案,臺中市,西屯區,逢甲里,659,1424,497,308,805,42,847
公投第１２案,臺中市,西屯區,逢甲里,660,1176,410,255,665,32,697
公投第１２案,臺中市,西屯區,逢福里,661,1456,530,326,856,32,888
公投第１２案,臺中市,西屯區,逢福里,662,1451,546,341,887,25,912
公投第１２案,臺中市,西屯區,逢福里,663,1063,428,244,672,27,699
公投第１２案,臺中市,西屯區,逢福里,664,1357,398,269,667,33,700
公投第１２案,臺中市,西屯區,鵬程里,665,1355,514,277,791,54,845
公投第１２案,臺中市,西屯區,鵬程里,666,1384,551,293,844,21,865
公投第１２案,臺中市,西屯區,何厝里,667,1613,565,369,934,36,970
公投第１２案,臺中市,西屯區,何厝里,668,1562,520,347,867,42,909
公投第１２案,臺中市,西屯區,何明里,669,1219,442,322,764,44,808
公投第１２案,臺中市,西屯區,何明里,670,1235,423,290,713,37,750
公投第１２案,臺中市,西屯區,何明里,671,1131,391,244,635,42,677
公投第１２案,臺中市,西屯區,何南里,672,1494,564,355,919,20,939
公投第１２案,臺中市,西屯區,何南里,673,1325,456,303,759,32,791
公投第１２案,臺中市,西屯區,何南里,674,1386,452,342,794,40,834
公投第１２案,臺中市,西屯區,何成里,675,1816,642,389,1031,44,1075
公投第１２案,臺中市,西屯區,何成里,676,1734,556,362,918,35,953
公投第１２案,臺中市,西屯區,何成里,677,1777,592,426,1018,46,1064
公投第１２案,臺中市,西屯區,何成里,678,1818,556,386,942,53,995
公投第１２案,臺中市,西屯區,何安里,679,1699,550,365,915,54,969
公投第１２案,臺中市,西屯區,何安里,680,1715,527,349,876,34,910
公投第１２案,臺中市,西屯區,何安里,681,1654,517,354,871,36,907
公投第１２案,臺中市,西屯區,何仁里,682,1636,523,363,886,22,908
公投第１２案,臺中市,西屯區,何仁里,683,1298,414,304,718,27,745
公投第１２案,臺中市,西屯區,何仁里,684,1391,486,321,807,38,845
公投第１２案,臺中市,西屯區,何仁里,685,1853,599,453,1052,48,1100
公投第１２案,臺中市,西屯區,何德里,686,1820,506,373,879,48,927
公投第１２案,臺中市,西屯區,何德里,687,1809,614,398,1012,44,1056
公投第１２案,臺中市,西屯區,何福里,688,1352,496,374,870,34,904
公投第１２案,臺中市,西屯區,何福里,689,1521,495,350,845,50,895
公投第１２案,臺中市,西屯區,何福里,690,1486,561,324,885,27,912
公投第１２案,臺中市,西屯區,何源里,691,1674,554,386,940,51,991
公投第１２案,臺中市,西屯區,何源里,692,1610,561,399,960,54,1014
公投第１２案,臺中市,西屯區,何源里,693,1695,561,384,945,47,992
公投第１２案,臺中市,西屯區,何源里,694,1684,535,372,907,37,944
公投第１２案,臺中市,西屯區,大河里,695,1221,474,257,731,25,756
公投第１２案,臺中市,西屯區,大河里,696,1252,488,314,802,53,855
公投第１２案,臺中市,西屯區,大河里,697,1301,475,298,773,44,817
公投第１２案,臺中市,西屯區,大石里,698,1049,433,200,633,40,673
公投第１２案,臺中市,西屯區,大石里,699,1113,438,208,646,34,680
公投第１２案,臺中市,西屯區,大福里,700,1557,567,272,839,30,869
公投第１２案,臺中市,西屯區,大福里,701,1640,571,294,865,47,912
公投第１２案,臺中市,西屯區,大鵬里,702,1402,538,334,872,66,938
公投第１２案,臺中市,西屯區,大鵬里,703,1717,521,332,853,53,906
公投第１２案,臺中市,西屯區,大鵬里,704,1688,582,352,934,37,971
公投第１２案,臺中市,西屯區,港尾里,705,1168,403,232,635,88,723
公投第１２案,臺中市,西屯區,港尾里,706,1729,569,339,908,45,953
公投第１２案,臺中市,西屯區,港尾里,707,2007,625,416,1041,41,1082
公投第１２案,臺中市,西屯區,廣福里,708,1296,423,327,750,54,804
公投第１２案,臺中市,西屯區,廣福里,709,1068,336,203,539,31,570
公投第１２案,臺中市,西屯區,林厝里,710,1707,406,348,754,57,811
公投第１２案,臺中市,西屯區,林厝里,711,1636,533,398,931,38,969
公投第１２案,臺中市,西屯區,永安里,712,1761,486,332,818,37,855
公投第１２案,臺中市,西屯區,永安里,713,1314,475,281,756,44,800
公投第１２案,臺中市,西屯區,永安里,714,1233,467,294,761,34,795
公投第１２案,臺中市,西屯區,永安里,715,1549,512,309,821,39,860
公投第１２案,臺中市,西屯區,永安里,716,1639,552,312,864,27,891
公投第１２案,臺中市,西屯區,永安里,717,1486,542,236,778,37,815
公投第１２案,臺中市,西屯區,永安里,718,1806,583,371,954,31,985
公投第１２案,臺中市,西屯區,永安里,719,1451,455,318,773,19,792
公投第１２案,臺中市,西屯區,福安里,720,1302,506,253,759,24,783
公投第１２案,臺中市,西屯區,福安里,721,1353,482,321,803,43,846
公投第１２案,臺中市,西屯區,福雅里,722,2162,761,452,1213,52,1265
公投第１２案,臺中市,西屯區,福雅里,723,1520,521,305,826,37,863
公投第１２案,臺中市,西屯區,福雅里,724,1935,665,378,1043,42,1085
公投第１２案,臺中市,西屯區,福林里,725,1847,634,372,1006,43,1049
公投第１２案,臺中市,西屯區,福林里,726,1738,584,395,979,38,1017
公投第１２案,臺中市,西屯區,福林里,727,1640,610,365,975,36,1011
公投第１２案,臺中市,西屯區,福林里,728,1908,657,393,1050,36,1086
公投第１２案,臺中市,西屯區,福瑞里,729,1402,480,307,787,27,814
公投第１２案,臺中市,西屯區,福瑞里,730,1515,458,325,783,36,819
公投第１２案,臺中市,西屯區,福聯里,731,1541,473,255,728,30,758
公投第１２案,臺中市,西屯區,福聯里,732,1502,467,344,811,24,835
公投第１２案,臺中市,西屯區,福和里,733,1526,505,366,871,37,908
公投第１２案,臺中市,西屯區,福和里,734,1425,490,337,827,48,875
公投第１２案,臺中市,西屯區,福和里,735,1334,505,303,808,29,837
公投第１２案,臺中市,西屯區,福中里,736,1649,617,366,983,39,1022
公投第１２案,臺中市,西屯區,福中里,737,1566,513,340,853,34,887
公投第１２案,臺中市,西屯區,福恩里,738,1629,600,360,960,38,998
公投第１２案,臺中市,西屯區,福恩里,739,1628,694,374,1068,50,1118
公投第１２案,臺中市,西屯區,福恩里,740,1442,515,344,859,29,888
公投第１２案,臺中市,西屯區,協和里,741,1206,362,266,628,45,673
公投第１２案,臺中市,西屯區,協和里,742,1086,415,227,642,45,687
公投第１２案,臺中市,西屯區,協和里,743,1088,414,230,644,42,686
公投第１２案,臺中市,西屯區,協和里,744,1140,401,261,662,26,688
公投第１２案,臺中市,南屯區,南屯里,745,1321,465,276,741,61,802
公投第１２案,臺中市,南屯區,南屯里,746,1346,487,326,813,34,847
公投第１２案,臺中市,南屯區,南屯里,747,1428,511,337,848,36,884
公投第１２案,臺中市,南屯區,南屯里,748,1442,514,302,816,35,851
公投第１２案,臺中市,南屯區,南屯里,749,1408,552,326,878,30,908
公投第１２案,臺中市,南屯區,南屯里,750,1404,524,315,839,25,864
公投第１２案,臺中市,南屯區,豐樂里,751,1354,529,305,834,31,865
公投第１２案,臺中市,南屯區,豐樂里,752,1332,481,328,809,30,839
公投第１２案,臺中市,南屯區,豐樂里,753,1463,534,356,890,38,928
公投第１２案,臺中市,南屯區,豐樂里,754,1413,464,343,807,39,846
公投第１２案,臺中市,南屯區,豐樂里,755,1218,470,293,763,31,794
公投第１２案,臺中市,南屯區,豐樂里,756,1308,488,285,773,30,803
公投第１２案,臺中市,南屯區,豐樂里,757,1527,593,330,923,48,971
公投第１２案,臺中市,南屯區,豐樂里,758,1294,459,327,786,40,826
公投第１２案,臺中市,南屯區,楓樹里,759,1516,471,313,784,32,816
公投第１２案,臺中市,南屯區,楓樹里,760,1529,547,353,900,57,957
公投第１２案,臺中市,南屯區,楓樹里,761,1397,498,318,816,49,865
公投第１２案,臺中市,南屯區,楓樹里,762,1406,495,267,762,35,797
公投第１２案,臺中市,南屯區,中和里,763,1497,499,302,801,40,841
公投第１２案,臺中市,南屯區,中和里,764,1424,463,314,777,46,823
公投第１２案,臺中市,南屯區,中和里,765,1488,423,307,730,48,778
公投第１２案,臺中市,南屯區,鎮平里,766,608,209,160,369,39,408
公投第１２案,臺中市,南屯區,鎮平里,767,813,294,185,479,58,537
公投第１２案,臺中市,南屯區,春社里,768,1190,433,269,702,35,737
公投第１２案,臺中市,南屯區,春社里,769,1174,429,233,662,26,688
公投第１２案,臺中市,南屯區,春社里,770,1224,435,277,712,14,726
公投第１２案,臺中市,南屯區,春社里,771,1466,460,259,719,35,754
公投第１２案,臺中市,南屯區,春社里,772,1333,362,198,560,16,576
公投第１２案,臺中市,南屯區,春安里,773,814,315,182,497,25,522
公投第１２案,臺中市,南屯區,文山里,774,1436,500,251,751,47,798
公投第１２案,臺中市,南屯區,文山里,775,1515,527,333,860,46,906
公投第１２案,臺中市,南屯區,文山里,776,1545,459,264,723,74,797
公投第１２案,臺中市,南屯區,文山里,777,1383,476,313,789,32,821
公投第１２案,臺中市,南屯區,文山里,778,1433,511,312,823,35,858
公投第１２案,臺中市,南屯區,文山里,779,1134,343,259,602,27,629
公投第１２案,臺中市,南屯區,文山里,780,1216,446,280,726,36,762
公投第１２案,臺中市,南屯區,寶山里,781,1271,404,261,665,70,735
公投第１２案,臺中市,南屯區,寶山里,782,1203,408,250,658,16,674
公投第１２案,臺中市,南屯區,寶山里,783,1268,430,298,728,22,750
公投第１２案,臺中市,南屯區,寶山里,784,1390,554,246,800,31,831
公投第１２案,臺中市,南屯區,新生里,785,1397,462,314,776,35,811
公投第１２案,臺中市,南屯區,永定里,786,1607,511,362,873,52,925
公投第１２案,臺中市,南屯區,永定里,787,1582,564,362,926,28,954
公投第１２案,臺中市,南屯區,永定里,788,1611,632,302,934,34,968
公投第１２案,臺中市,南屯區,三厝里,789,1322,514,300,814,29,843
公投第１２案,臺中市,南屯區,三厝里,790,1321,518,312,830,32,862
公投第１２案,臺中市,南屯區,三厝里,791,1360,521,284,805,45,850
公投第１２案,臺中市,南屯區,三厝里,792,1361,553,278,831,15,846
公投第１２案,臺中市,南屯區,三厝里,793,1257,461,295,756,38,794
公投第１２案,臺中市,南屯區,三義里,794,1207,476,284,760,25,785
公投第１２案,臺中市,南屯區,三義里,795,1282,499,303,802,20,822
公投第１２案,臺中市,南屯區,三義里,796,1248,473,306,779,40,819
公投第１２案,臺中市,南屯區,三義里,797,1304,484,328,812,45,857
公投第１２案,臺中市,南屯區,三義里,798,1214,448,264,712,33,745
公投第１２案,臺中市,南屯區,三和里,799,1102,394,283,677,37,714
公投第１２案,臺中市,南屯區,三和里,800,1630,672,343,1015,41,1056
公投第１２案,臺中市,南屯區,三和里,801,1333,495,308,803,28,831
公投第１２案,臺中市,南屯區,三和里,802,1292,599,122,721,24,745
公投第１２案,臺中市,南屯區,三和里,803,1272,473,283,756,34,790
公投第１２案,臺中市,南屯區,三和里,804,1345,499,279,778,33,811
公投第１２案,臺中市,南屯區,黎明里,805,981,407,231,638,54,692
公投第１２案,臺中市,南屯區,黎明里,806,1097,435,223,658,46,704
公投第１２案,臺中市,南屯區,黎明里,807,991,418,211,629,20,649
公投第１２案,臺中市,南屯區,黎明里,808,1170,439,261,700,24,724
公投第１２案,臺中市,南屯區,溝墘里,809,1171,416,288,704,43,747
公投第１２案,臺中市,南屯區,溝墘里,810,1349,454,307,761,50,811
公投第１２案,臺中市,南屯區,溝墘里,811,1368,496,348,844,27,871
公投第１２案,臺中市,南屯區,溝墘里,812,1263,488,303,791,31,822
公投第１２案,臺中市,南屯區,大業里,813,1547,556,359,915,42,957
公投第１２案,臺中市,南屯區,大業里,814,1649,502,395,897,54,951
公投第１２案,臺中市,南屯區,大業里,815,1629,559,346,905,35,940
公投第１２案,臺中市,南屯區,大業里,816,1580,468,358,826,34,860
公投第１２案,臺中市,南屯區,惠中里,817,1444,579,338,917,32,949
公投第１２案,臺中市,南屯區,惠中里,818,1413,519,302,821,24,845
公投第１２案,臺中市,南屯區,惠中里,819,1377,493,292,785,29,814
公投第１２案,臺中市,南屯區,惠中里,820,1527,503,402,905,27,932
公投第１２案,臺中市,南屯區,惠中里,821,1335,515,302,817,25,842
公投第１２案,臺中市,南屯區,田心里,822,1544,611,384,995,41,1036
公投第１２案,臺中市,南屯區,田心里,823,1482,567,374,941,34,975
公投第１２案,臺中市,南屯區,田心里,824,1488,563,320,883,47,930
公投第１２案,臺中市,南屯區,田心里,825,1538,462,312,774,40,814
公投第１２案,臺中市,南屯區,向心里,826,1674,627,379,1006,53,1059
公投第１２案,臺中市,南屯區,向心里,827,1996,506,322,828,36,864
公投第１２案,臺中市,南屯區,向心里,828,1514,578,298,876,46,922
公投第１２案,臺中市,南屯區,文心里,829,1217,496,245,741,44,785
公投第１２案,臺中市,南屯區,文心里,830,1347,468,310,778,29,807
公投第１２案,臺中市,南屯區,文心里,831,1109,429,246,675,23,698
公投第１２案,臺中市,南屯區,同心里,832,1546,527,344,871,31,902
公投第１２案,臺中市,南屯區,同心里,833,1408,537,322,859,48,907
公投第１２案,臺中市,南屯區,同心里,834,1057,294,300,594,26,620
公投第１２案,臺中市,南屯區,同心里,835,1133,399,250,649,46,695
公投第１２案,臺中市,南屯區,大同里,836,1278,454,305,759,32,791
公投第１２案,臺中市,南屯區,大同里,837,1144,463,263,726,30,756
公投第１２案,臺中市,南屯區,大同里,838,1140,394,269,663,41,704
公投第１２案,臺中市,南屯區,大同里,839,1171,439,275,714,31,745
公投第１２案,臺中市,南屯區,大興里,840,1303,503,307,810,29,839
公投第１２案,臺中市,南屯區,大興里,841,1402,469,297,766,39,805
公投第１２案,臺中市,南屯區,大興里,842,1571,552,298,850,53,903
公投第１２案,臺中市,南屯區,大誠里,843,1139,425,286,711,28,739
公投第１２案,臺中市,南屯區,大誠里,844,1216,475,275,750,38,788
公投第１２案,臺中市,南屯區,大誠里,845,1162,473,244,717,30,747
公投第１２案,臺中市,北屯區,北屯里,846,1670,622,388,1010,36,1046
公投第１２案,臺中市,北屯區,北屯里,847,1706,583,304,887,47,934
公投第１２案,臺中市,北屯區,北京里,848,1507,505,289,794,12,806
公投第１２案,臺中市,北屯區,北京里,849,1652,553,388,941,48,989
公投第１２案,臺中市,北屯區,北興里,850,1107,368,238,606,18,624
公投第１２案,臺中市,北屯區,北興里,851,2151,723,387,1110,56,1166
公投第１２案,臺中市,北屯區,三光里,852,1612,627,327,954,35,989
公投第１２案,臺中市,北屯區,三光里,853,1743,571,392,963,35,998
公投第１２案,臺中市,北屯區,三光里,854,2099,645,431,1076,37,1113
公投第１２案,臺中市,北屯區,三光里,855,1595,600,303,903,31,934
公投第１２案,臺中市,北屯區,三和里,856,1923,599,384,983,39,1022
公投第１２案,臺中市,北屯區,三和里,857,1641,541,327,868,42,910
公投第１２案,臺中市,北屯區,三和里,858,1157,445,280,725,39,764
公投第１２案,臺中市,北屯區,三和里,859,1041,400,240,640,26,666
公投第１２案,臺中市,北屯區,東光里,860,1563,502,304,806,42,848
公投第１２案,臺中市,北屯區,東光里,861,1559,490,314,804,42,846
公投第１２案,臺中市,北屯區,東光里,862,1411,472,247,719,24,743
公投第１２案,臺中市,北屯區,水景里,863,1761,608,400,1008,35,1043
公投第１２案,臺中市,北屯區,水景里,864,1361,528,278,806,58,864
公投第１２案,臺中市,北屯區,水景里,865,1852,640,372,1012,49,1061
公投第１２案,臺中市,北屯區,水景里,866,1928,661,424,1085,45,1130
公投第１２案,臺中市,北屯區,水景里,867,1492,600,340,940,25,965
公投第１２案,臺中市,北屯區,水景里,868,1998,645,406,1051,54,1105
公投第１２案,臺中市,北屯區,水景里,869,1272,485,314,799,31,830
公投第１２案,臺中市,北屯區,水景里,870,1317,481,291,772,38,810
公投第１２案,臺中市,北屯區,軍功里,871,1327,383,284,667,52,719
公投第１２案,臺中市,北屯區,軍功里,872,1280,384,293,677,25,702
公投第１２案,臺中市,北屯區,軍功里,873,1865,578,367,945,45,990
公投第１２案,臺中市,北屯區,軍功里,874,1230,450,300,750,42,792
公投第１２案,臺中市,北屯區,軍功里,875,1356,438,268,706,44,750
公投第１２案,臺中市,北屯區,軍功里,876,1732,615,344,959,37,996
公投第１２案,臺中市,北屯區,軍功里,877,1586,563,346,909,37,946
公投第１２案,臺中市,北屯區,軍功里,878,1441,480,303,783,34,817
公投第１２案,臺中市,北屯區,和平里,879,2045,596,447,1043,71,1114
公投第１２案,臺中市,北屯區,和平里,880,1914,564,387,951,58,1009
公投第１２案,臺中市,北屯區,和平里,881,1918,666,384,1050,47,1097
公投第１２案,臺中市,北屯區,和平里,882,2079,650,404,1054,30,1084
公投第１２案,臺中市,北屯區,和平里,883,2040,669,431,1100,61,1161
公投第１２案,臺中市,北屯區,廍子里,884,2027,563,390,953,56,1009
公投第１２案,臺中市,北屯區,廍子里,885,1402,488,266,754,43,797
公投第１２案,臺中市,北屯區,廍子里,886,1826,596,416,1012,61,1073
公投第１２案,臺中市,北屯區,廍子里,887,2162,679,380,1059,38,1097
公投第１２案,臺中市,北屯區,廍子里,888,2332,651,448,1099,25,1124
公投第１２案,臺中市,北屯區,民政里,889,985,302,243,545,37,582
公投第１２案,臺中市,北屯區,東山里,890,2037,642,396,1038,41,1079
公投第１２案,臺中市,北屯區,大坑里,891,1032,344,253,597,37,634
公投第１２案,臺中市,北屯區,大坑里,892,1062,351,239,590,34,624
公投第１２案,臺中市,北屯區,民德里,893,909,304,177,481,46,527
公投第１２案,臺中市,北屯區,舊社里,894,1445,520,301,821,55,876
公投第１２案,臺中市,北屯區,舊社里,895,1842,582,365,947,46,993
公投第１２案,臺中市,北屯區,舊社里,896,1187,413,278,691,31,722
公投第１２案,臺中市,北屯區,舊社里,897,1456,547,287,834,39,873
公投第１２案,臺中市,北屯區,松茂里,898,1866,643,397,1040,48,1088
公投第１２案,臺中市,北屯區,松茂里,899,1667,532,334,866,41,907
公投第１２案,臺中市,北屯區,松茂里,900,1683,595,380,975,25,1000
公投第１２案,臺中市,北屯區,松強里,901,1642,559,338,897,28,925
公投第１２案,臺中市,北屯區,松強里,902,1475,544,328,872,26,898
公投第１２案,臺中市,北屯區,松強里,903,1644,568,328,896,24,920
公投第１２案,臺中市,北屯區,松強里,904,1603,596,344,940,36,976
公投第１２案,臺中市,北屯區,松勇里,905,1949,666,439,1105,59,1164
公投第１２案,臺中市,北屯區,松勇里,906,1790,680,417,1097,43,1140
公投第１２案,臺中市,北屯區,松勇里,907,1440,480,345,825,33,858
公投第１２案,臺中市,北屯區,松安里,908,1601,578,353,931,57,988
公投第１２案,臺中市,北屯區,松安里,909,1527,516,304,820,46,866
公投第１２案,臺中市,北屯區,松安里,910,1675,625,225,850,42,892
公投第１２案,臺中市,北屯區,松和里,911,1579,526,241,767,42,809
公投第１２案,臺中市,北屯區,松和里,912,1524,498,336,834,53,887
公投第１２案,臺中市,北屯區,松和里,913,1677,564,321,885,42,927
公投第１２案,臺中市,北屯區,松和里,914,1599,558,320,878,43,921
公投第１２案,臺中市,北屯區,松竹里,915,1458,469,375,844,44,888
公投第１２案,臺中市,北屯區,松竹里,916,1571,633,282,915,41,956
公投第１２案,臺中市,北屯區,松竹里,917,1579,559,345,904,42,946
公投第１２案,臺中市,北屯區,松竹里,918,1849,661,388,1049,46,1095
公投第１２案,臺中市,北屯區,松竹里,919,1682,586,351,937,32,969
公投第１２案,臺中市,北屯區,平興里,920,1760,591,343,934,38,972
公投第１２案,臺中市,北屯區,平興里,921,1699,555,384,939,55,994
公投第１２案,臺中市,北屯區,平興里,922,1626,596,381,977,46,1023
公投第１２案,臺中市,北屯區,平興里,923,1491,522,367,889,12,901
公投第１２案,臺中市,北屯區,平田里,924,1640,547,360,907,39,946
公投第１２案,臺中市,北屯區,平田里,925,2052,542,437,979,57,1036
公投第１２案,臺中市,北屯區,平田里,926,1875,644,390,1034,47,1081
公投第１２案,臺中市,北屯區,平昌里,927,1559,528,344,872,32,904
公投第１２案,臺中市,北屯區,平昌里,928,1480,494,350,844,42,886
公投第１２案,臺中市,北屯區,平昌里,929,1397,446,336,782,46,828
公投第１２案,臺中市,北屯區,平安里,930,1889,646,405,1051,44,1095
公投第１２案,臺中市,北屯區,平安里,931,1728,571,363,934,38,972
公投第１２案,臺中市,北屯區,平安里,932,1592,519,330,849,47,896
公投第１２案,臺中市,北屯區,平順里,933,1656,533,355,888,43,931
公投第１２案,臺中市,北屯區,平順里,934,1524,477,316,793,32,825
公投第１２案,臺中市,北屯區,平心里,935,1502,519,331,850,32,882
公投第１２案,臺中市,北屯區,平心里,936,1772,625,339,964,31,995
公投第１２案,臺中市,北屯區,平心里,937,1461,491,338,829,47,876
公投第１２案,臺中市,北屯區,平福里,938,1769,549,346,895,28,923
公投第１２案,臺中市,北屯區,平福里,939,1894,627,459,1086,50,1136
公投第１２案,臺中市,北屯區,平德里,940,2033,603,423,1026,49,1075
公投第１２案,臺中市,北屯區,平德里,941,1947,615,404,1019,46,1065
公投第１２案,臺中市,北屯區,平德里,942,2188,715,493,1208,52,1260
公投第１２案,臺中市,北屯區,平和里,943,1661,580,361,941,66,1007
公投第１２案,臺中市,北屯區,平和里,944,1667,577,367,944,30,974
公投第１２案,臺中市,北屯區,平和里,945,1728,595,337,932,51,983
公投第１２案,臺中市,北屯區,平陽里,946,1688,572,357,929,17,946
公投第１２案,臺中市,北屯區,平陽里,947,1475,501,325,826,24,850
公投第１２案,臺中市,北屯區,平陽里,948,1681,619,409,1028,33,1061
公投第１２案,臺中市,北屯區,仁和里,949,2078,717,469,1186,49,1235
公投第１２案,臺中市,北屯區,仁和里,950,2059,701,414,1115,50,1165
公投第１２案,臺中市,北屯區,仁和里,951,1792,628,413,1041,34,1075
公投第１２案,臺中市,北屯區,仁和里,952,2974,618,411,1029,30,1059
公投第１２案,臺中市,北屯區,仁愛里,953,1072,380,218,598,36,634
公投第１２案,臺中市,北屯區,仁美里,954,2099,794,457,1251,45,1296
公投第１２案,臺中市,北屯區,仁美里,955,1823,701,423,1124,59,1183
公投第１２案,臺中市,北屯區,仁美里,956,2022,734,426,1160,75,1235
公投第１２案,臺中市,北屯區,仁美里,957,1992,680,432,1112,41,1153
公投第１２案,臺中市,北屯區,四民里,958,1585,568,362,930,54,984
公投第１２案,臺中市,北屯區,同榮里,959,1565,555,361,916,46,962
公投第１２案,臺中市,北屯區,同榮里,960,1780,590,313,903,50,953
公投第１２案,臺中市,北屯區,同榮里,961,1874,655,447,1102,56,1158
公投第１２案,臺中市,北屯區,后庄里,962,1755,717,322,1039,43,1082
公投第１２案,臺中市,北屯區,后庄里,963,1497,601,384,985,29,1014
公投第１２案,臺中市,北屯區,后庄里,964,1567,590,351,941,44,985
公投第１２案,臺中市,北屯區,后庄里,965,1624,543,329,872,49,921
公投第１２案,臺中市,北屯區,后庄里,966,1614,602,358,960,43,1003
公投第１２案,臺中市,北屯區,后庄里,967,1595,544,344,888,28,916
公投第１２案,臺中市,北屯區,新平里,968,1782,603,293,896,56,952
公投第１２案,臺中市,北屯區,新平里,969,1357,452,246,698,24,722
公投第１２案,臺中市,北屯區,新平里,970,1071,365,220,585,42,627
公投第１２案,臺中市,北屯區,陳平里,971,1372,444,269,713,58,771
公投第１２案,臺中市,北屯區,陳平里,972,1415,518,279,797,46,843
公投第１２案,臺中市,北屯區,陳平里,973,1789,632,410,1042,71,1113
公投第１２案,臺中市,北屯區,忠平里,974,1907,747,384,1131,69,1200
公投第１２案,臺中市,北屯區,忠平里,975,2008,717,426,1143,47,1190
公投第１２案,臺中市,北屯區,大德里,976,1541,557,283,840,46,886
公投第１２案,臺中市,北屯區,大德里,977,1669,634,337,971,40,1011
公投第１２案,臺中市,北屯區,大德里,978,1685,599,354,953,43,996
公投第１２案,臺中市,北屯區,水湳里,979,1785,621,371,992,68,1060
公投第１２案,臺中市,北屯區,水湳里,980,1596,600,336,936,49,985
公投第１２案,臺中市,北屯區,水湳里,981,1731,603,399,1002,50,1052
公投第１２案,臺中市,北屯區,水湳里,982,1496,517,270,787,65,852
公投第１２案,臺中市,北區,中正里,983,1437,458,302,760,36,796
公投第１２案,臺中市,北區,六合里,984,1708,499,352,851,70,921
公投第１２案,臺中市,北區,光大里,985,1051,302,225,527,30,557
公投第１２案,臺中市,北區,光大里,986,996,337,210,547,35,582
公投第１２案,臺中市,北區,文莊里,987,1504,537,302,839,34,873
公投第１２案,臺中市,北區,文莊里,988,975,338,223,561,48,609
公投第１２案,臺中市,北區,文莊里,989,886,309,194,503,28,531
公投第１２案,臺中市,北區,大湖里,990,1276,346,242,588,28,616
公投第１２案,臺中市,北區,大湖里,991,938,277,222,499,21,520
公投第１２案,臺中市,北區,五常里,992,1404,446,286,732,45,777
公投第１２案,臺中市,北區,錦平里,993,996,330,213,543,24,567
公投第１２案,臺中市,北區,錦平里,994,869,276,192,468,38,506
公投第１２案,臺中市,北區,新北里,995,704,261,166,427,22,449
公投第１２案,臺中市,北區,新北里,996,979,317,211,528,22,550
公投第１２案,臺中市,北區,新興里,997,773,246,152,398,14,412
公投第１２案,臺中市,北區,新興里,998,759,289,162,451,22,473
公投第１２案,臺中市,北區,樂英里,999,1438,532,266,798,49,847
公投第１２案,臺中市,北區,樂英里,1000,1212,334,278,612,33,645
公投第１２案,臺中市,北區,錦村里,1001,1731,603,358,961,47,1008
公投第１２案,臺中市,北區,錦村里,1002,1445,596,295,891,29,920
公投第１２案,臺中市,北區,建成里,1003,1855,603,400,1003,54,1057
公投第１２案,臺中市,北區,建成里,1004,1728,509,322,831,50,881
公投第１２案,臺中市,北區,建成里,1005,1878,561,372,933,37,970
公投第１２案,臺中市,北區,建德里,1006,1793,548,345,893,54,947
公投第１２案,臺中市,北區,建德里,1007,1555,537,315,852,56,908
公投第１２案,臺中市,北區,錦洲里,1008,1761,525,337,862,35,897
公投第１２案,臺中市,北區,錦洲里,1009,1579,664,202,866,33,899
公投第１２案,臺中市,北區,錦祥里,1010,2192,708,412,1120,63,1183
公投第１２案,臺中市,北區,錦祥里,1011,1560,564,343,907,31,938
公投第１２案,臺中市,北區,金華里,1012,1476,510,312,822,35,857
公投第１２案,臺中市,北區,金華里,1013,1006,376,221,597,23,620
公投第１２案,臺中市,北區,金龍里,1014,1403,490,289,779,37,816
公投第１２案,臺中市,北區,金龍里,1015,1446,461,287,748,24,772
公投第１２案,臺中市,北區,金龍里,1016,1460,450,331,781,42,823
公投第１２案,臺中市,北區,邱厝里,1017,1233,442,251,693,25,718
公投第１２案,臺中市,北區,邱厝里,1018,1027,394,263,657,21,678
公投第１２案,臺中市,北區,建興里,1019,1207,396,288,684,23,707
公投第１２案,臺中市,北區,建興里,1020,1167,427,274,701,27,728
公投第１２案,臺中市,北區,建興里,1021,1150,387,262,649,19,668
公投第１２案,臺中市,北區,建興里,1022,1061,363,239,602,27,629
公投第１２案,臺中市,北區,建興里,1023,1005,376,220,596,27,623
公投第１２案,臺中市,北區,頂厝里,1024,1250,418,276,694,27,721
公投第１２案,臺中市,北區,頂厝里,1025,1448,490,346,836,43,879
公投第１２案,臺中市,北區,頂厝里,1026,1379,471,302,773,56,829
公投第１２案,臺中市,北區,崇德里,1027,1652,566,339,905,59,964
公投第１２案,臺中市,北區,崇德里,1028,1867,583,413,996,26,1022
公投第１２案,臺中市,北區,賴厝里,1029,2078,373,202,575,18,593
公投第１２案,臺中市,北區,賴厝里,1030,1562,615,304,919,33,952
公投第１２案,臺中市,北區,賴厝里,1031,1430,519,285,804,23,827
公投第１２案,臺中市,北區,賴福里,1032,2018,669,434,1103,44,1147
公投第１２案,臺中市,北區,賴福里,1033,1710,541,301,842,33,875
公投第１２案,臺中市,北區,賴興里,1034,1432,469,292,761,35,796
公投第１２案,臺中市,北區,賴興里,1035,1157,457,225,682,31,713
公投第１２案,臺中市,北區,賴興里,1036,1188,430,262,692,29,721
公投第１２案,臺中市,北區,賴旺里,1037,1419,500,280,780,30,810
公投第１２案,臺中市,北區,賴旺里,1038,1653,547,345,892,19,911
公投第１２案,臺中市,北區,賴旺里,1039,1233,407,304,711,24,735
公投第１２案,臺中市,北區,賴明里,1040,1243,423,283,706,24,730
公投第１２案,臺中市,北區,賴明里,1041,1219,412,223,635,17,652
公投第１２案,臺中市,北區,賴明里,1042,1272,435,297,732,19,751
公投第１２案,臺中市,北區,梅川里,1043,1285,448,300,748,23,771
公投第１２案,臺中市,北區,梅川里,1044,1780,610,408,1018,37,1055
公投第１２案,臺中市,北區,賴村里,1045,1461,459,288,747,30,777
公投第１２案,臺中市,北區,賴村里,1046,1310,478,283,761,30,791
公投第１２案,臺中市,北區,賴村里,1047,1669,532,398,930,24,954
公投第１２案,臺中市,北區,育德里,1048,1932,676,409,1085,45,1130
公投第１２案,臺中市,北區,育德里,1049,1682,512,391,903,28,931
公投第１２案,臺中市,北區,淡溝里,1050,1891,600,397,997,38,1035
公投第１２案,臺中市,北區,淡溝里,1051,1882,638,374,1012,56,1068
公投第１２案,臺中市,北區,淡溝里,1052,1159,399,249,648,24,672
公投第１２案,臺中市,北區,健行里,1053,1553,540,317,857,48,905
公投第１２案,臺中市,北區,健行里,1054,1607,496,369,865,39,904
公投第１２案,臺中市,北區,健行里,1055,1773,550,411,961,38,999
公投第１２案,臺中市,北區,健行里,1056,1524,484,351,835,53,888
公投第１２案,臺中市,北區,明德里,1057,1613,590,366,956,56,1012
公投第１２案,臺中市,北區,明德里,1058,1877,675,383,1058,51,1109
公投第１２案,臺中市,北區,明德里,1059,1792,602,390,992,45,1037
公投第１２案,臺中市,北區,明新里,1060,1392,524,270,794,37,831
公投第１２案,臺中市,北區,明新里,1061,1297,435,286,721,29,750
公投第１２案,臺中市,北區,長青里,1062,1556,561,349,910,42,952
公投第１２案,臺中市,北區,長青里,1063,1497,458,342,800,42,842
公投第１２案,臺中市,北區,長青里,1064,1550,532,301,833,41,874
公投第１２案,臺中市,北區,長青里,1065,1434,437,313,750,36,786
公投第１２案,臺中市,北區,立人里,1066,1793,609,382,991,49,1040
公投第１２案,臺中市,北區,立人里,1067,1866,597,422,1019,40,1059
公投第１２案,臺中市,北區,中達里,1068,1346,460,312,772,34,806
公投第１２案,臺中市,北區,中達里,1069,1267,429,258,687,46,733
公投第１２案,臺中市,中區,綠川里,1070,1652,600,376,976,75,1051
公投第１２案,臺中市,中區,繼光里,1071,1531,494,314,808,56,864
公投第１２案,臺中市,中區,公園里,1072,1431,515,280,795,25,820
公投第１２案,臺中市,中區,光復里,1073,1060,350,228,578,34,612
公投第１２案,臺中市,中區,光復里,1074,982,299,208,507,42,549
公投第１２案,臺中市,中區,大墩里,1075,1191,393,254,647,41,688
公投第１２案,臺中市,中區,大墩里,1076,855,263,191,454,40,494
公投第１２案,臺中市,中區,柳川里,1077,1135,336,187,523,25,548
公投第１２案,臺中市,中區,柳川里,1078,705,256,155,411,21,432
公投第１２案,臺中市,中區,大誠里,1079,1009,365,209,574,40,614
公投第１２案,臺中市,中區,大誠里,1080,1304,403,273,676,52,728
公投第１２案,臺中市,中區,中華里,1081,1841,554,346,900,32,932
公投第１２案,臺中市,西區,三民里,1082,1400,303,186,489,26,515
公投第１２案,臺中市,西區,三民里,1083,861,345,206,551,20,571
公投第１２案,臺中市,西區,利民里,1084,1416,537,275,812,46,858
公投第１２案,臺中市,西區,民生里,1085,1020,367,235,602,43,645
公投第１２案,臺中市,西區,民生里,1086,778,298,182,480,34,514
公投第１２案,臺中市,西區,廣民里,1087,1465,509,295,804,45,849
公投第１２案,臺中市,西區,平和里,1088,1017,386,214,600,19,619
公投第１２案,臺中市,西區,平和里,1089,868,295,215,510,21,531
公投第１２案,臺中市,西區,東昇里,1090,1251,474,292,766,42,808
公投第１２案,臺中市,西區,東昇里,1091,1044,405,242,647,44,691
公投第１２案,臺中市,西區,公民里,1092,1487,491,335,826,42,868
公投第１２案,臺中市,西區,公民里,1093,1573,529,371,900,36,936
公投第１２案,臺中市,西區,公民里,1094,1731,660,363,1023,36,1059
公投第１２案,臺中市,西區,藍興里,1095,1209,444,270,714,27,741
公投第１２案,臺中市,西區,藍興里,1096,1564,530,328,858,51,909
公投第１２案,臺中市,西區,藍興里,1097,1175,417,279,696,29,725
公投第１２案,臺中市,西區,公舘里,1098,1505,525,320,845,32,877
公投第１２案,臺中市,西區,公舘里,1099,1418,498,336,834,37,871
公投第１２案,臺中市,西區,公舘里,1100,1497,461,252,713,18,731
公投第１２案,臺中市,西區,公舘里,1101,1260,457,287,744,38,782
公投第１２案,臺中市,西區,安龍里,1102,1399,448,355,803,51,854
公投第１２案,臺中市,西區,安龍里,1103,1447,492,300,792,46,838
公投第１２案,臺中市,西區,吉龍里,1104,1683,562,381,943,43,986
公投第１２案,臺中市,西區,吉龍里,1105,1585,563,366,929,34,963
公投第１２案,臺中市,西區,吉龍里,1106,1557,574,375,949,21,970
公投第１２案,臺中市,西區,吉龍里,1107,1663,524,329,853,56,909
公投第１２案,臺中市,西區,土庫里,1108,1921,611,473,1084,40,1124
公投第１２案,臺中市,西區,土庫里,1109,1952,577,427,1004,42,1046
公投第１２案,臺中市,西區,土庫里,1110,1708,574,367,941,34,975
公投第１２案,臺中市,西區,大忠里,1111,1131,423,268,691,30,721
公投第１２案,臺中市,西區,大忠里,1112,1916,609,415,1024,40,1064
公投第１２案,臺中市,西區,大忠里,1113,1275,463,313,776,15,791
公投第１２案,臺中市,西區,民龍里,1114,1822,558,353,911,56,967
公投第１２案,臺中市,西區,民龍里,1115,1374,492,286,778,34,812
公投第１２案,臺中市,西區,和龍里,1116,1129,411,200,611,49,660
公投第１２案,臺中市,西區,和龍里,1117,1201,365,276,641,39,680
公投第１２案,臺中市,西區,後龍里,1118,1639,537,337,874,47,921
公投第１２案,臺中市,西區,後龍里,1119,1863,592,442,1034,59,1093
公投第１２案,臺中市,西區,双龍里,1120,1287,506,280,786,39,825
公投第１２案,臺中市,西區,双龍里,1121,1504,536,343,879,45,924
公投第１２案,臺中市,西區,昇平里,1122,1308,447,284,731,38,769
公投第１２案,臺中市,西區,昇平里,1123,1433,492,309,801,44,845
公投第１２案,臺中市,西區,昇平里,1124,1450,495,294,789,35,824
公投第１２案,臺中市,西區,昇平里,1125,1465,513,367,880,44,924
公投第１２案,臺中市,西區,中興里,1126,1818,579,370,949,44,993
公投第１２案,臺中市,西區,中興里,1127,1782,600,392,992,52,1044
公投第１２案,臺中市,西區,公益里,1128,1428,494,362,856,39,895
公投第１２案,臺中市,西區,公益里,1129,1366,432,266,698,33,731
公投第１２案,臺中市,西區,公德里,1130,1498,495,338,833,31,864
公投第１２案,臺中市,西區,公德里,1131,1350,495,306,801,33,834
公投第１２案,臺中市,西區,公德里,1132,1339,448,304,752,27,779
公投第１２案,臺中市,西區,公正里,1133,1613,555,367,922,40,962
公投第１２案,臺中市,西區,公正里,1134,1454,486,338,824,33,857
公投第１２案,臺中市,西區,公正里,1135,1597,546,402,948,32,980
公投第１２案,臺中市,西區,公正里,1136,1411,504,350,854,44,898
公投第１２案,臺中市,西區,公平里,1137,1493,498,349,847,51,898
公投第１２案,臺中市,西區,公平里,1138,1600,590,350,940,43,983
公投第１２案,臺中市,西區,公平里,1139,1710,548,381,929,49,978
公投第１２案,臺中市,西區,忠明里,1140,1139,423,235,658,23,681
公投第１２案,臺中市,西區,忠明里,1141,1105,397,254,651,29,680
公投第１２案,臺中市,西區,忠明里,1142,1498,506,319,825,41,866
公投第１２案,臺中市,西區,忠明里,1143,1921,601,341,942,47,989
公投第１２案,臺中市,西區,忠誠里,1144,1340,458,288,746,41,787
公投第１２案,臺中市,西區,忠誠里,1145,1536,559,371,930,41,971
公投第１２案,臺中市,西區,忠誠里,1146,1361,463,305,768,46,814
公投第１２案,臺中市,西區,忠誠里,1147,1430,536,342,878,29,907
公投第１２案,臺中市,東區,新庄里,1148,1138,268,164,432,18,450
公投第１２案,臺中市,東區,新庄里,1149,984,347,215,562,23,585
公投第１２案,臺中市,東區,新庄里,1150,877,295,203,498,28,526
公投第１２案,臺中市,東區,振興里,1151,1070,395,250,645,41,686
公投第１２案,臺中市,東區,振興里,1152,1106,362,287,649,40,689
公投第１２案,臺中市,東區,振興里,1153,953,330,210,540,44,584
公投第１２案,臺中市,東區,東橋里,1154,1195,456,257,713,31,744
公投第１２案,臺中市,東區,東橋里,1155,1251,469,227,696,28,724
公投第１２案,臺中市,東區,東橋里,1156,1190,389,288,677,40,717
公投第１２案,臺中市,東區,東興里,1157,1394,429,318,747,47,794
公投第１２案,臺中市,東區,東興里,1158,1443,521,330,851,49,900
公投第１２案,臺中市,東區,泉源里,1159,762,273,164,437,34,471
公投第１２案,臺中市,東區,泉源里,1160,1140,451,263,714,32,746
公投第１２案,臺中市,東區,干城里,1161,1211,416,286,702,54,756
公投第１２案,臺中市,東區,干城里,1162,755,288,167,455,28,483
公投第１２案,臺中市,東區,旱溪里,1163,1491,497,307,804,47,851
公投第１２案,臺中市,東區,旱溪里,1164,1000,347,207,554,23,577
公投第１２案,臺中市,東區,樂成里,1165,1114,377,267,644,47,691
公投第１２案,臺中市,東區,樂成里,1166,1101,377,235,612,31,643
公投第１２案,臺中市,東區,東門里,1167,1169,448,257,705,52,757
公投第１２案,臺中市,東區,東門里,1168,1283,499,246,745,44,789
公投第１２案,臺中市,東區,東門里,1169,1168,392,287,679,44,723
公投第１２案,臺中市,東區,東門里,1170,1386,471,290,761,32,793
公投第１２案,臺中市,東區,東門里,1171,1557,524,373,897,25,922
公投第１２案,臺中市,東區,十甲里,1172,1380,462,303,765,50,815
公投第１２案,臺中市,東區,十甲里,1173,1674,611,355,966,43,1009
公投第１２案,臺中市,東區,十甲里,1174,1604,564,380,944,45,989
公投第１２案,臺中市,東區,東英里,1175,1815,631,419,1050,49,1099
公投第１２案,臺中市,東區,東英里,1176,1700,580,354,934,37,971
公投第１２案,臺中市,東區,東英里,1177,1592,495,386,881,35,916
公投第１２案,臺中市,東區,東英里,1178,1850,586,362,948,53,1001
公投第１２案,臺中市,東區,東南里,1179,1252,450,284,734,30,764
公投第１２案,臺中市,東區,東南里,1180,1250,439,321,760,38,798
公投第１２案,臺中市,東區,東南里,1181,1241,443,282,725,27,752
公投第１２案,臺中市,東區,東勢里,1182,1318,369,292,661,50,711
公投第１２案,臺中市,東區,東勢里,1183,1288,440,259,699,42,741
公投第１２案,臺中市,東區,合作里,1184,1442,527,329,856,55,911
公投第１２案,臺中市,東區,合作里,1185,1202,409,266,675,49,724
公投第１２案,臺中市,東區,合作里,1186,1452,528,275,803,54,857
公投第１２案,臺中市,東區,富仁里,1187,1480,483,300,783,44,827
公投第１２案,臺中市,東區,富仁里,1188,1736,602,345,947,45,992
公投第１２案,臺中市,東區,富仁里,1189,867,273,183,456,34,490
公投第１２案,臺中市,東區,富台里,1190,1693,594,269,863,44,907
公投第１２案,臺中市,東區,東信里,1191,1538,565,338,903,47,950
公投第１２案,臺中市,東區,東信里,1192,1593,531,406,937,62,999
公投第１２案,臺中市,東區,東信里,1193,1481,482,301,783,28,811
公投第１２案,臺中市,東區,東信里,1194,1414,505,341,846,38,884
公投第１２案,臺中市,東區,東信里,1195,1297,427,300,727,35,762
公投第１２案,臺中市,東區,東信里,1196,1394,488,309,797,38,835
公投第１２案,臺中市,南區,長春里,1197,937,348,200,548,29,577
公投第１２案,臺中市,南區,長春里,1198,1001,363,252,615,40,655
公投第１２案,臺中市,南區,長榮里,1199,1249,501,279,780,46,826
公投第１２案,臺中市,南區,長榮里,1200,1202,468,311,779,43,822
公投第１２案,臺中市,南區,城隍里,1201,1130,400,262,662,59,721
公投第１２案,臺中市,南區,城隍里,1202,1239,451,294,745,39,784
公投第１２案,臺中市,南區,城隍里,1203,1238,417,275,692,41,733
公投第１２案,臺中市,南區,國光里,1204,1272,454,301,755,43,798
公投第１２案,臺中市,南區,國光里,1205,1273,443,303,746,36,782
公投第１２案,臺中市,南區,國光里,1206,1317,474,270,744,63,807
公投第１２案,臺中市,南區,南門里,1207,1160,497,258,755,44,799
公投第１２案,臺中市,南區,南門里,1208,1205,443,303,746,50,796
公投第１２案,臺中市,南區,南門里,1209,1111,426,229,655,37,692
公投第１２案,臺中市,南區,德義里,1210,1407,530,362,892,46,938
公投第１２案,臺中市,南區,德義里,1211,1419,541,279,820,34,854
公投第１２案,臺中市,南區,積善里,1212,1157,455,248,703,35,738
公投第１２案,臺中市,南區,積善里,1213,1415,467,342,809,32,841
公投第１２案,臺中市,南區,江川里,1214,1289,519,292,811,37,848
公投第１２案,臺中市,南區,江川里,1215,1454,544,286,830,49,879
公投第１２案,臺中市,南區,新榮里,1216,1491,525,305,830,46,876
公投第１２案,臺中市,南區,新榮里,1217,1394,491,316,807,29,836
公投第１２案,臺中市,南區,新榮里,1218,1430,503,318,821,42,863
公投第１２案,臺中市,南區,福興里,1219,1342,475,286,761,91,852
公投第１２案,臺中市,南區,福興里,1220,1304,496,317,813,71,884
公投第１２案,臺中市,南區,福興里,1221,1190,450,290,740,34,774
公投第１２案,臺中市,南區,福平里,1222,1273,464,140,604,57,661
公投第１２案,臺中市,南區,福平里,1223,1387,537,322,859,46,905
公投第１２案,臺中市,南區,福平里,1224,1356,468,296,764,55,819
公投第１２案,臺中市,南區,福平里,1225,1304,498,283,781,47,828
公投第１２案,臺中市,南區,福順里,1226,1256,485,306,791,28,819
公投第１２案,臺中市,南區,福順里,1227,1364,482,348,830,31,861
公投第１２案,臺中市,南區,福順里,1228,1361,466,325,791,60,851
公投第１２案,臺中市,南區,福順里,1229,1407,539,312,851,23,874
公投第１２案,臺中市,南區,和平里,1230,1308,476,277,753,47,800
公投第１２案,臺中市,南區,和平里,1231,1250,435,280,715,31,746
公投第１２案,臺中市,南區,和平里,1232,1284,449,254,703,37,740
公投第１２案,臺中市,南區,平和里,1233,1175,436,298,734,29,763
公投第１２案,臺中市,南區,平和里,1234,1158,477,260,737,33,770
公投第１２案,臺中市,南區,平和里,1235,1168,433,240,673,45,718
公投第１２案,臺中市,南區,南和里,1236,1626,630,363,993,49,1042
公投第１２案,臺中市,南區,南和里,1237,2115,526,329,855,29,884
公投第１２案,臺中市,南區,南和里,1238,1805,622,362,984,29,1013
公投第１２案,臺中市,南區,南和里,1239,1695,557,361,918,31,949
公投第１２案,臺中市,南區,永興里,1240,1643,601,412,1013,36,1049
公投第１２案,臺中市,南區,永興里,1241,1423,502,355,857,33,890
公投第１２案,臺中市,南區,永興里,1242,1542,522,359,881,50,931
公投第１２案,臺中市,南區,永興里,1243,1533,534,374,908,29,937
公投第１２案,臺中市,南區,永興里,1244,1531,595,344,939,53,992
公投第１２案,臺中市,南區,永和里,1245,1392,502,264,766,35,801
公投第１２案,臺中市,南區,永和里,1246,1592,534,352,886,29,915
公投第１２案,臺中市,南區,永和里,1247,1431,538,313,851,47,898
公投第１２案,臺中市,南區,樹義里,1248,1799,559,387,946,38,984
公投第１２案,臺中市,南區,樹義里,1249,1708,653,388,1041,49,1090
公投第１２案,臺中市,南區,樹義里,1250,1700,571,362,933,61,994
公投第１２案,臺中市,南區,樹義里,1251,1751,662,394,1056,33,1089
公投第１２案,臺中市,南區,樹義里,1252,2109,712,483,1195,73,1268
公投第１２案,臺中市,南區,樹義里,1253,1697,588,369,957,50,1007
公投第１２案,臺中市,南區,工學里,1254,1456,489,332,821,47,868
公投第１２案,臺中市,南區,工學里,1255,1726,697,409,1106,57,1163
公投第１２案,臺中市,南區,工學里,1256,1723,632,410,1042,39,1081
公投第１２案,臺中市,南區,工學里,1257,1569,597,344,941,35,976
公投第１２案,臺中市,南區,樹德里,1258,1274,466,281,747,52,799
公投第１２案,臺中市,南區,樹德里,1259,1390,574,310,884,37,921
公投第１２案,臺中市,南區,樹德里,1260,1295,502,316,818,28,846
公投第１２案,臺中市,南區,樹德里,1261,1312,621,160,781,33,814
公投第１２案,臺中市,南區,樹德里,1262,1417,561,310,871,36,907
公投第１２案,臺中市,南區,樹德里,1263,1230,493,328,821,36,857
公投第１２案,臺中市,南區,西川里,1264,1308,473,278,751,43,794
公投第１２案,臺中市,南區,西川里,1265,1467,502,335,837,49,886
公投第１２案,臺中市,南區,西川里,1266,1399,500,323,823,36,859
公投第１２案,臺中市,南區,崇倫里,1267,1207,448,231,679,54,733
公投第１２案,臺中市,南區,崇倫里,1268,1317,436,332,768,33,801
公投第１２案,臺中市,南區,崇倫里,1269,1563,516,372,888,28,916
公投第１２案,臺中市,南區,崇倫里,1270,1221,469,267,736,36,772
公投第１２案,臺中市,太平區,太平里,1271,1821,553,371,924,68,992
公投第１２案,臺中市,太平區,太平里,1272,1680,509,337,846,35,881
公投第１２案,臺中市,太平區,太平里,1273,1947,645,420,1065,66,1131
公投第１２案,臺中市,太平區,長億里,1274,1910,701,388,1089,65,1154
公投第１２案,臺中市,太平區,長億里,1275,1894,615,368,983,41,1024
公投第１２案,臺中市,太平區,長億里,1276,1953,615,400,1015,49,1064
公投第１２案,臺中市,太平區,永成里,1277,1846,618,380,998,66,1064
公投第１２案,臺中市,太平區,永成里,1278,1493,623,227,850,37,887
公投第１２案,臺中市,太平區,永成里,1279,1605,535,318,853,49,902
公投第１２案,臺中市,太平區,永成里,1280,1619,587,349,936,40,976
公投第１２案,臺中市,太平區,中平里,1281,2011,642,404,1046,60,1106
公投第１２案,臺中市,太平區,中平里,1282,2056,680,414,1094,28,1122
公投第１２案,臺中市,太平區,中政里,1283,1876,621,369,990,42,1032
公投第１２案,臺中市,太平區,中政里,1284,1815,593,351,944,46,990
公投第１２案,臺中市,太平區,平安里,1285,1281,410,281,691,40,731
公投第１２案,臺中市,太平區,平安里,1286,1004,347,256,603,49,652
公投第１２案,臺中市,太平區,中興里,1287,1886,654,399,1053,76,1129
公投第１２案,臺中市,太平區,中興里,1288,1431,501,308,809,50,859
公投第１２案,臺中市,太平區,永平里,1289,1930,598,394,992,65,1057
公投第１２案,臺中市,太平區,永平里,1290,2164,631,443,1074,50,1124
公投第１２案,臺中市,太平區,東平里,1291,2048,671,387,1058,53,1111
公投第１２案,臺中市,太平區,東平里,1292,2035,689,368,1057,39,1096
公投第１２案,臺中市,太平區,成功里,1293,1685,510,347,857,65,922
公投第１２案,臺中市,太平區,成功里,1294,2185,600,397,997,84,1081
公投第１２案,臺中市,太平區,東和里,1295,1176,393,227,620,17,637
公投第１２案,臺中市,太平區,東和里,1296,1597,494,339,833,33,866
公投第１２案,臺中市,太平區,建國里,1297,1378,524,185,709,52,761
公投第１２案,臺中市,太平區,建國里,1298,1546,510,335,845,33,878
公投第１２案,臺中市,太平區,建興里,1299,1890,536,362,898,61,959
公投第１２案,臺中市,太平區,建興里,1300,1053,345,221,566,31,597
公投第１２案,臺中市,太平區,坪林里,1301,1582,537,348,885,76,961
公投第１２案,臺中市,太平區,坪林里,1302,1699,610,351,961,40,1001
公投第１２案,臺中市,太平區,大興里,1303,1493,444,315,759,57,816
公投第１２案,臺中市,太平區,大興里,1304,1063,302,243,545,41,586
公投第１２案,臺中市,太平區,勤益里,1305,1117,408,235,643,36,679
公投第１２案,臺中市,太平區,勤益里,1306,1084,382,229,611,50,661
公投第１２案,臺中市,太平區,光華里,1307,1776,521,379,900,42,942
公投第１２案,臺中市,太平區,光華里,1308,1729,559,340,899,41,940
公投第１２案,臺中市,太平區,光華里,1309,1658,483,285,768,71,839
公投第１２案,臺中市,太平區,光明里,1310,2010,634,400,1034,45,1079
公投第１２案,臺中市,太平區,光明里,1311,1752,550,341,891,43,934
公投第１２案,臺中市,太平區,中山里,1312,1654,624,317,941,59,1000
公投第１２案,臺中市,太平區,中山里,1313,1951,450,303,753,32,785
公投第１２案,臺中市,太平區,豐年里,1314,2170,703,604,1307,77,1384
公投第１２案,臺中市,太平區,豐年里,1315,2231,796,504,1300,51,1351
公投第１２案,臺中市,太平區,宜欣里,1316,1623,566,351,917,37,954
公投第１２案,臺中市,太平區,宜欣里,1317,1548,448,296,744,39,783
公投第１２案,臺中市,太平區,宜欣里,1318,1442,464,276,740,56,796
公投第１２案,臺中市,太平區,宜欣里,1319,1501,436,270,706,45,751
公投第１２案,臺中市,太平區,宜佳里,1320,2025,573,392,965,43,1008
公投第１２案,臺中市,太平區,宜佳里,1321,1885,582,382,964,39,1003
公投第１２案,臺中市,太平區,宜佳里,1322,2155,610,380,990,52,1042
公投第１２案,臺中市,太平區,宜昌里,1323,1775,512,377,889,62,951
公投第１２案,臺中市,太平區,宜昌里,1324,2021,519,332,851,78,929
公投第１２案,臺中市,太平區,新坪里,1325,2075,697,442,1139,72,1211
公投第１２案,臺中市,太平區,新坪里,1326,1723,472,362,834,46,880
公投第１２案,臺中市,太平區,新坪里,1327,2049,676,424,1100,44,1144
公投第１２案,臺中市,太平區,新坪里,1328,1415,456,313,769,17,786
公投第１２案,臺中市,太平區,新吉里,1329,1778,582,391,973,41,1014
公投第１２案,臺中市,太平區,新吉里,1330,1706,497,356,853,53,906
公投第１２案,臺中市,太平區,新吉里,1331,2090,673,382,1055,51,1106
公投第１２案,臺中市,太平區,新城里,1332,2093,596,396,992,49,1041
公投第１２案,臺中市,太平區,新城里,1333,1688,492,306,798,31,829
公投第１２案,臺中市,太平區,新城里,1334,1488,427,297,724,27,751
公投第１２案,臺中市,太平區,新光里,1335,1667,584,342,926,53,979
公投第１２案,臺中市,太平區,新光里,1336,1793,550,312,862,63,925
公投第１２案,臺中市,太平區,新光里,1337,1903,648,413,1061,35,1096
公投第１２案,臺中市,太平區,新光里,1338,1834,615,345,960,50,1010
公投第１２案,臺中市,太平區,新興里,1339,1526,518,299,817,34,851
公投第１２案,臺中市,太平區,新興里,1340,1483,537,373,910,20,930
公投第１２案,臺中市,太平區,新興里,1341,1694,536,404,940,21,961
公投第１２案,臺中市,太平區,新高里,1342,1952,568,370,938,34,972
公投第１２案,臺中市,太平區,新高里,1343,1995,640,412,1052,48,1100
公投第１２案,臺中市,太平區,新高里,1344,1311,444,293,737,26,763
公投第１２案,臺中市,太平區,新高里,1345,1537,554,438,992,26,1018
公投第１２案,臺中市,太平區,新福里,1346,1974,590,354,944,49,993
公投第１２案,臺中市,太平區,新福里,1347,1828,582,424,1006,33,1039
公投第１２案,臺中市,太平區,新福里,1348,2191,658,394,1052,45,1097
公投第１２案,臺中市,太平區,頭汴里,1349,1825,588,324,912,66,978
公投第１２案,臺中市,太平區,聖和里,1350,1559,490,311,801,19,820
公投第１２案,臺中市,太平區,東汴里,1351,1225,385,243,628,58,686
公投第１２案,臺中市,太平區,興隆里,1352,1678,555,321,876,62,938
公投第１２案,臺中市,太平區,興隆里,1353,1501,437,283,720,73,793
公投第１２案,臺中市,太平區,福隆里,1354,1450,537,331,868,57,925
公投第１２案,臺中市,太平區,福隆里,1355,2126,627,432,1059,71,1130
公投第１２案,臺中市,太平區,黃竹里,1356,699,262,153,415,37,452
公投第１２案,臺中市,太平區,光隆里,1357,1428,381,322,703,33,736
公投第１２案,臺中市,太平區,光隆里,1358,1666,531,376,907,68,975
公投第１２案,臺中市,太平區,永隆里,1359,1241,444,250,694,36,730
公投第１２案,臺中市,太平區,永隆里,1360,1266,447,272,719,45,764
公投第１２案,臺中市,太平區,德隆里,1361,1166,418,214,632,37,669
公投第１２案,臺中市,太平區,德隆里,1362,1790,576,391,967,81,1048
公投第１２案,臺中市,太平區,德隆里,1363,1754,472,295,767,37,804
公投第１２案,臺中市,大里區,東湖里,1364,1614,533,286,819,32,851
公投第１２案,臺中市,大里區,東湖里,1365,1599,489,309,798,37,835
公投第１２案,臺中市,大里區,東湖里,1366,1715,467,367,834,35,869
公投第１２案,臺中市,大里區,東湖里,1367,1264,436,286,722,27,749
公投第１２案,臺中市,大里區,東湖里,1368,1416,417,304,721,39,760
公投第１２案,臺中市,大里區,東湖里,1369,1188,374,260,634,28,662
公投第１２案,臺中市,大里區,東湖里,1370,1359,448,257,705,52,757
公投第１２案,臺中市,大里區,西湖里,1371,1457,462,340,802,49,851
公投第１２案,臺中市,大里區,西湖里,1372,1403,456,328,784,49,833
公投第１２案,臺中市,大里區,大里里,1373,1697,539,369,908,58,966
公投第１２案,臺中市,大里區,大里里,1374,1811,635,401,1036,72,1108
公投第１２案,臺中市,大里區,新里里,1375,1830,596,331,927,52,979
公投第１２案,臺中市,大里區,新里里,1376,2228,532,313,845,101,946
公投第１２案,臺中市,大里區,新里里,1377,1997,710,440,1150,57,1207
公投第１２案,臺中市,大里區,新里里,1378,2033,798,459,1257,43,1300
公投第１２案,臺中市,大里區,新里里,1379,1835,626,447,1073,34,1107
公投第１２案,臺中市,大里區,國光里,1380,1268,425,288,713,23,736
公投第１２案,臺中市,大里區,國光里,1381,1645,549,352,901,55,956
公投第１２案,臺中市,大里區,國光里,1382,1561,610,310,920,36,956
公投第１２案,臺中市,大里區,國光里,1383,1301,519,288,807,41,848
公投第１２案,臺中市,大里區,樹王里,1384,1621,539,301,840,53,893
公投第１２案,臺中市,大里區,樹王里,1385,1797,548,378,926,54,980
公投第１２案,臺中市,大里區,祥興里,1386,1230,396,260,656,32,688
公投第１２案,臺中市,大里區,祥興里,1387,1488,482,280,762,47,809
公投第１２案,臺中市,大里區,祥興里,1388,1459,447,295,742,52,794
公投第１２案,臺中市,大里區,祥興里,1389,1647,574,326,900,44,944
公投第１２案,臺中市,大里區,祥興里,1390,1100,385,259,644,50,694
公投第１２案,臺中市,大里區,內新里,1391,1410,467,303,770,39,809
公投第１２案,臺中市,大里區,內新里,1392,1807,595,317,912,48,960
公投第１２案,臺中市,大里區,內新里,1393,1331,419,299,718,45,763
公投第１２案,臺中市,大里區,內新里,1394,1801,674,273,947,27,974
公投第１２案,臺中市,大里區,內新里,1395,1909,591,348,939,40,979
公投第１２案,臺中市,大里區,中新里,1396,1699,499,317,816,52,868
公投第１２案,臺中市,大里區,中新里,1397,1627,564,329,893,46,939
公投第１２案,臺中市,大里區,中新里,1398,1912,608,401,1009,38,1047
公投第１２案,臺中市,大里區,東昇里,1399,1753,569,324,893,48,941
公投第１２案,臺中市,大里區,東昇里,1400,1602,570,295,865,34,899
公投第１２案,臺中市,大里區,大元里,1401,1144,354,266,620,45,665
公投第１２案,臺中市,大里區,大元里,1402,1655,558,370,928,51,979
公投第１２案,臺中市,大里區,大元里,1403,1438,328,447,775,35,810
公投第１２案,臺中市,大里區,夏田里,1404,1000,325,225,550,44,594
公投第１２案,臺中市,大里區,仁化里,1405,1711,545,364,909,57,966
公投第１２案,臺中市,大里區,仁化里,1406,1698,577,354,931,17,948
公投第１２案,臺中市,大里區,仁化里,1407,1914,621,400,1021,53,1074
公投第１２案,臺中市,大里區,仁化里,1408,1465,486,353,839,21,860
公投第１２案,臺中市,大里區,仁化里,1409,1581,513,334,847,60,907
公投第１２案,臺中市,大里區,仁德里,1410,1509,521,233,754,46,800
公投第１２案,臺中市,大里區,仁德里,1411,1570,510,326,836,25,861
公投第１２案,臺中市,大里區,仁德里,1412,1425,428,364,792,37,829
公投第１２案,臺中市,大里區,仁德里,1413,1384,460,316,776,47,823
公投第１２案,臺中市,大里區,健民里,1414,1204,335,248,583,32,615
公投第１２案,臺中市,大里區,健民里,1415,1761,510,364,874,33,907
公投第１２案,臺中市,大里區,健民里,1416,1473,431,270,701,25,726
公投第１２案,臺中市,大里區,塗城里,1417,1675,553,351,904,47,951
公投第１２案,臺中市,大里區,塗城里,1418,1755,629,323,952,44,996
公投第１２案,臺中市,大里區,塗城里,1419,1593,543,347,890,66,956
公投第１２案,臺中市,大里區,塗城里,1420,1799,569,376,945,56,1001
公投第１２案,臺中市,大里區,塗城里,1421,1606,517,339,856,64,920
公投第１２案,臺中市,大里區,東興里,1422,1875,602,391,993,37,1030
公投第１２案,臺中市,大里區,東興里,1423,1670,563,350,913,46,959
公投第１２案,臺中市,大里區,東興里,1424,1898,568,428,996,54,1050
公投第１２案,臺中市,大里區,東興里,1425,1679,530,340,870,35,905
公投第１２案,臺中市,大里區,大明里,1426,1373,421,293,714,45,759
公投第１２案,臺中市,大里區,大明里,1427,1299,463,251,714,38,752
公投第１２案,臺中市,大里區,大明里,1428,1430,480,303,783,33,816
公投第１２案,臺中市,大里區,永隆里,1429,1805,714,395,1109,37,1146
公投第１２案,臺中市,大里區,永隆里,1430,1806,691,467,1158,28,1186
公投第１２案,臺中市,大里區,永隆里,1431,1826,740,391,1131,58,1189
公投第１２案,臺中市,大里區,永隆里,1432,1805,729,423,1152,27,1179
公投第１２案,臺中市,大里區,永隆里,1433,1907,710,400,1110,41,1151
公投第１２案,臺中市,大里區,日新里,1434,1103,455,215,670,32,702
公投第１２案,臺中市,大里區,日新里,1435,1419,412,272,684,42,726
公投第１２案,臺中市,大里區,日新里,1436,1434,548,235,783,40,823
公投第１２案,臺中市,大里區,西榮里,1437,1875,595,336,931,41,972
公投第１２案,臺中市,大里區,西榮里,1438,1862,597,392,989,56,1045
公投第１２案,臺中市,大里區,西榮里,1439,1850,628,355,983,31,1014
公投第１２案,臺中市,大里區,長榮里,1440,1622,543,327,870,61,931
公投第１２案,臺中市,大里區,長榮里,1441,1638,603,358,961,58,1019
公投第１２案,臺中市,大里區,長榮里,1442,1633,584,368,952,70,1022
公投第１２案,臺中市,大里區,長榮里,1443,1662,571,358,929,32,961
公投第１２案,臺中市,大里區,長榮里,1444,1917,643,451,1094,37,1131
公投第１２案,臺中市,大里區,金城里,1445,1701,521,304,825,72,897
公投第１２案,臺中市,大里區,金城里,1446,1549,479,306,785,48,833
公投第１２案,臺中市,大里區,金城里,1447,1567,558,348,906,42,948
公投第１２案,臺中市,大里區,金城里,1448,1614,553,345,898,12,910
公投第１２案,臺中市,大里區,金城里,1449,1811,596,372,968,71,1039
公投第１２案,臺中市,大里區,金城里,1450,1336,436,290,726,39,765
公投第１２案,臺中市,大里區,立仁里,1451,1759,620,312,932,37,969
公投第１２案,臺中市,大里區,立仁里,1452,1783,560,338,898,47,945
公投第１２案,臺中市,大里區,立仁里,1453,1736,506,336,842,45,887
公投第１２案,臺中市,大里區,立德里,1454,1874,662,368,1030,48,1078
公投第１２案,臺中市,大里區,立德里,1455,1889,629,365,994,81,1075
公投第１２案,臺中市,大里區,立德里,1456,1947,669,368,1037,57,1094
公投第１２案,臺中市,大里區,立德里,1457,1938,672,424,1096,37,1133
公投第１２案,臺中市,大里區,新仁里,1458,1836,588,379,967,62,1029
公投第１２案,臺中市,大里區,新仁里,1459,1913,628,371,999,52,1051
公投第１２案,臺中市,大里區,新仁里,1460,1913,578,378,956,69,1025
公投第１２案,臺中市,大里區,新仁里,1461,1937,619,349,968,45,1013
公投第１２案,臺中市,大里區,瑞城里,1462,1508,491,311,802,33,835
公投第１２案,臺中市,大里區,瑞城里,1463,1340,465,312,777,32,809
公投第１２案,臺中市,大里區,瑞城里,1464,1656,569,355,924,47,971
公投第１２案,臺中市,大里區,瑞城里,1465,1290,439,270,709,32,741
公投第１２案,臺中市,大里區,瑞城里,1466,1655,515,359,874,43,917
公投第１２案,臺中市,大里區,瑞城里,1467,1260,358,265,623,23,646
公投第１２案,臺中市,大里區,瑞城里,1468,1247,425,295,720,27,747
公投第１２案,臺中市,大里區,瑞城里,1469,1548,469,294,763,105,868
公投第１２案,臺中市,霧峰區,桐林里,1470,1205,434,280,714,36,750
公投第１２案,臺中市,霧峰區,吉峰里,1471,1620,552,327,879,44,923
公投第１２案,臺中市,霧峰區,吉峰里,1472,1559,558,353,911,57,968
公投第１２案,臺中市,霧峰區,吉峰里,1473,1660,554,334,888,65,953
公投第１２案,臺中市,霧峰區,吉峰里,1474,1602,570,367,937,50,987
公投第１２案,臺中市,霧峰區,吉峰里,1475,1325,422,275,697,39,736
公投第１２案,臺中市,霧峰區,吉峰里,1476,1515,515,339,854,42,896
公投第１２案,臺中市,霧峰區,甲寅里,1477,1561,486,339,825,57,882
公投第１２案,臺中市,霧峰區,甲寅里,1478,1691,579,283,862,56,918
公投第１２案,臺中市,霧峰區,甲寅里,1479,1486,493,311,804,82,886
公投第１２案,臺中市,霧峰區,本鄉里,1480,975,358,211,569,46,615
公投第１２案,臺中市,霧峰區,本鄉里,1481,1358,536,270,806,48,854
公投第１２案,臺中市,霧峰區,中正里,1482,1141,466,288,754,24,778
公投第１２案,臺中市,霧峰區,中正里,1483,855,348,188,536,32,568
公投第１２案,臺中市,霧峰區,錦榮里,1484,1202,408,258,666,59,725
公投第１２案,臺中市,霧峰區,萊園里,1485,1078,350,217,567,40,607
公投第１２案,臺中市,霧峰區,本堂里,1486,1456,528,320,848,53,901
公投第１２案,臺中市,霧峰區,本堂里,1487,1573,556,361,917,35,952
公投第１２案,臺中市,霧峰區,本堂里,1488,1591,565,326,891,49,940
公投第１２案,臺中市,霧峰區,本堂里,1489,1214,456,275,731,53,784
公投第１２案,臺中市,霧峰區,北柳里,1490,1267,408,265,673,58,731
公投第１２案,臺中市,霧峰區,北柳里,1491,1277,433,276,709,51,760
公投第１２案,臺中市,霧峰區,北柳里,1492,1366,424,325,749,41,790
公投第１２案,臺中市,霧峰區,南柳里,1493,994,382,259,641,48,689
公投第１２案,臺中市,霧峰區,南柳里,1494,863,312,198,510,37,547
公投第１２案,臺中市,霧峰區,四德里,1495,1274,404,285,689,47,736
公投第１２案,臺中市,霧峰區,四德里,1496,1162,349,265,614,66,680
公投第１２案,臺中市,霧峰區,五福里,1497,1252,451,267,718,64,782
公投第１２案,臺中市,霧峰區,五福里,1498,1322,449,290,739,50,789
公投第１２案,臺中市,霧峰區,丁台里,1499,1116,401,257,658,54,712
公投第１２案,臺中市,霧峰區,丁台里,1500,1156,394,288,682,59,741
公投第１２案,臺中市,霧峰區,北勢里,1501,1147,449,241,690,42,732
公投第１２案,臺中市,霧峰區,北勢里,1502,928,365,222,587,43,630
公投第１２案,臺中市,霧峰區,南勢里,1503,1296,405,272,677,55,732
公投第１２案,臺中市,霧峰區,萬豐里,1504,1314,373,273,646,74,720
公投第１２案,臺中市,霧峰區,萬豐里,1505,1328,460,302,762,57,819
公投第１２案,臺中市,霧峰區,舊正里,1506,989,296,241,537,52,589
公投第１２案,臺中市,霧峰區,舊正里,1507,1088,379,261,640,47,687
公投第１２案,臺中市,霧峰區,坑口里,1508,1363,513,286,799,61,860
公投第１２案,臺中市,霧峰區,坑口里,1509,1573,521,376,897,67,964
公投第１２案,臺中市,霧峰區,峰谷里,1510,1117,370,241,611,49,660
公投第１２案,臺中市,霧峰區,六股里,1511,1342,506,297,803,68,871
公投第１２案,臺中市,霧峰區,六股里,1512,1024,372,266,638,46,684
公投第１２案,臺中市,東勢區,慶福里,1513,1299,391,271,662,61,723
公投第１２案,臺中市,東勢區,慶東里,1514,1007,342,194,536,49,585
公投第１２案,臺中市,東勢區,慶東里,1515,859,266,172,438,43,481
公投第１２案,臺中市,東勢區,上城里,1516,991,428,180,608,42,650
公投第１２案,臺中市,東勢區,下城里,1517,863,268,160,428,26,454
公投第１２案,臺中市,東勢區,詒福里,1518,1628,540,312,852,78,930
公投第１２案,臺中市,東勢區,新盛里,1519,1335,419,256,675,52,727
公投第１２案,臺中市,東勢區,新盛里,1520,1092,427,242,669,39,708
公投第１２案,臺中市,東勢區,新盛里,1521,1050,429,208,637,41,678
公投第１２案,臺中市,東勢區,新盛里,1522,1431,537,250,787,40,827
公投第１２案,臺中市,東勢區,福隆里,1523,1372,537,244,781,43,824
公投第１２案,臺中市,東勢區,福隆里,1524,1412,538,275,813,29,842
公投第１２案,臺中市,東勢區,福隆里,1525,878,311,144,455,65,520
公投第１２案,臺中市,東勢區,隆興里,1526,1475,434,267,701,63,764
公投第１２案,臺中市,東勢區,中嵙里,1527,872,310,145,455,19,474
公投第１２案,臺中市,東勢區,中嵙里,1528,1006,331,168,499,71,570
公投第１２案,臺中市,東勢區,泰昌里,1529,1222,434,234,668,27,695
公投第１２案,臺中市,東勢區,泰昌里,1530,1228,513,247,760,50,810
公投第１２案,臺中市,東勢區,泰昌里,1531,1036,436,186,622,42,664
公投第１２案,臺中市,東勢區,上新里,1532,977,413,198,611,27,638
公投第１２案,臺中市,東勢區,廣興里,1533,1395,506,257,763,39,802
公投第１２案,臺中市,東勢區,延平里,1534,1169,460,211,671,72,743
公投第１２案,臺中市,東勢區,延平里,1535,1027,410,193,603,41,644
公投第１２案,臺中市,東勢區,南平里,1536,984,390,184,574,30,604
公投第１２案,臺中市,東勢區,南平里,1537,866,377,180,557,27,584
公投第１２案,臺中市,東勢區,東安里,1538,1031,384,182,566,74,640
公投第１２案,臺中市,東勢區,中寧里,1539,865,329,193,522,57,579
公投第１２案,臺中市,東勢區,北興里,1540,1357,573,248,821,41,862
公投第１２案,臺中市,東勢區,粵寧里,1541,736,268,152,420,30,450
公投第１２案,臺中市,東勢區,粵寧里,1542,1314,500,235,735,46,781
公投第１２案,臺中市,東勢區,下新里,1543,1677,507,317,824,78,902
公投第１２案,臺中市,東勢區,東新里,1544,950,366,210,576,21,597
公投第１２案,臺中市,東勢區,東新里,1545,1007,371,223,594,38,632
公投第１２案,臺中市,東勢區,興隆里,1546,1214,384,215,599,48,647
公投第１２案,臺中市,東勢區,茂興里,1547,907,277,208,485,36,521
公投第１２案,臺中市,東勢區,茂興里,1548,902,246,212,458,39,497
公投第１２案,臺中市,東勢區,泰興里,1549,720,205,116,321,10,331
公投第１２案,臺中市,東勢區,埤頭里,1550,666,165,140,305,18,323
公投第１２案,臺中市,東勢區,明正里,1551,1361,437,262,699,48,747
公投第１２案,臺中市,石岡區,石岡里,1552,1244,443,254,697,44,741
公投第１２案,臺中市,石岡區,萬安里,1553,1539,479,322,801,62,863
公投第１２案,臺中市,石岡區,九房里,1554,1202,406,259,665,51,716
公投第１２案,臺中市,石岡區,金星里,1555,1272,379,243,622,75,697
公投第１２案,臺中市,石岡區,龍興里,1556,652,215,142,357,33,390
公投第１２案,臺中市,石岡區,萬興里,1557,1457,533,368,901,61,962
公投第１２案,臺中市,石岡區,梅子里,1558,1836,568,408,976,72,1048
公投第１２案,臺中市,石岡區,土牛里,1559,1001,330,205,535,42,577
公投第１２案,臺中市,石岡區,德興里,1560,1448,512,339,851,49,900
公投第１２案,臺中市,石岡區,和盛里,1561,1229,438,280,718,46,764
公投第１２案,臺中市,新社區,新社里,1562,1011,366,190,556,28,584
公投第１２案,臺中市,新社區,新社里,1563,1195,467,226,693,29,722
公投第１２案,臺中市,新社區,新社里,1564,1053,429,222,651,20,671
公投第１２案,臺中市,新社區,復盛里,1565,961,256,168,424,24,448
公投第１２案,臺中市,新社區,復盛里,1566,919,312,167,479,14,493
公投第１２案,臺中市,新社區,中正里,1567,1367,536,255,791,56,847
公投第１２案,臺中市,新社區,月湖里,1568,1010,327,214,541,25,566
公投第１２案,臺中市,新社區,崑山里,1569,1169,297,223,520,64,584
公投第１２案,臺中市,新社區,大南里,1570,989,319,210,529,39,568
公投第１２案,臺中市,新社區,大南里,1571,894,310,177,487,26,513
公投第１２案,臺中市,新社區,永源里,1572,1033,350,196,546,22,568
公投第１２案,臺中市,新社區,永源里,1573,1058,297,165,462,27,489
公投第１２案,臺中市,新社區,永源里,1574,845,259,157,416,17,433
公投第１２案,臺中市,新社區,中興里,1575,576,254,115,369,21,390
公投第１２案,臺中市,新社區,協成里,1576,1229,353,238,591,41,632
公投第１２案,臺中市,新社區,協成里,1577,890,233,180,413,27,440
公投第１２案,臺中市,新社區,協成里,1578,781,229,165,394,33,427
公投第１２案,臺中市,新社區,東興里,1579,1244,380,256,636,47,683
公投第１２案,臺中市,新社區,慶西里,1580,213,46,27,73,9,82
公投第１２案,臺中市,新社區,慶西里,1581,676,172,128,300,26,326
公投第１２案,臺中市,新社區,中和里,1582,585,165,100,265,16,281
公投第１２案,臺中市,新社區,福興里,1583,938,347,145,492,50,542
公投第１２案,臺中市,新社區,福興里,1584,224,59,45,104,7,111
公投第１２案,臺中市,和平區,南勢里,1585,956,358,227,585,32,617
公投第１２案,臺中市,和平區,南勢里,1586,963,366,214,580,47,627
公投第１２案,臺中市,和平區,天輪里,1587,456,140,120,260,14,274
公投第１２案,臺中市,和平區,博愛里,1588,1011,405,214,619,44,663
公投第１２案,臺中市,和平區,博愛里,1589,636,220,147,367,19,386
公投第１２案,臺中市,和平區,自由里,1590,270,77,64,141,10,151
公投第１２案,臺中市,和平區,自由里,1591,460,238,95,333,24,357
公投第１２案,臺中市,和平區,自由里,1592,321,109,120,229,13,242
公投第１２案,臺中市,和平區,達觀里,1593,783,293,195,488,28,516
公投第１２案,臺中市,和平區,達觀里,1594,336,135,68,203,13,216
公投第１２案,臺中市,和平區,中坑里,1595,451,187,125,312,7,319
公投第１２案,臺中市,和平區,梨山里,1596,366,135,71,206,13,219
公投第１２案,臺中市,和平區,梨山里,1597,771,240,124,364,11,375
公投第１２案,臺中市,和平區,梨山里,1598,574,185,114,299,22,321
公投第１２案,臺中市,和平區,梨山里,1599,274,110,51,161,10,171
公投第１２案,臺中市,和平區,平等里,1600,157,40,42,82,6,88
公投第１２案,臺中市,和平區,平等里,1601,713,269,125,394,21,415
公投第１２案,臺南市,後壁區,後壁里,1,743,257,133,390,35,425
公投第１２案,臺南市,後壁區,後壁里,2,898,272,160,432,28,460
公投第１２案,臺南市,後壁區,侯伯里,3,786,208,144,352,34,386
公投第１２案,臺南市,後壁區,侯伯里,4,534,173,83,256,22,278
公投第１２案,臺南市,後壁區,嘉苳里,5,1034,284,203,487,51,538
公投第１２案,臺南市,後壁區,嘉苳里,6,232,46,43,89,17,106
公投第１２案,臺南市,後壁區,土溝里,7,479,109,95,204,32,236
公投第１２案,臺南市,後壁區,土溝里,8,837,239,138,377,29,406
公投第１２案,臺南市,後壁區,上茄苳里,9,1085,240,178,418,37,455
公投第１２案,臺南市,後壁區,上茄苳里,10,1157,238,171,409,23,432
公投第１２案,臺南市,後壁區,菁豐里,11,755,219,125,344,44,388
公投第１２案,臺南市,後壁區,菁豐里,12,458,150,87,237,19,256
公投第１２案,臺南市,後壁區,菁寮里,13,371,104,51,155,23,178
公投第１２案,臺南市,後壁區,菁寮里,14,676,192,106,298,35,333
公投第１２案,臺南市,後壁區,菁寮里,15,428,111,58,169,21,190
公投第１２案,臺南市,後壁區,新嘉里,16,547,152,72,224,17,241
公投第１２案,臺南市,後壁區,新嘉里,17,455,141,64,205,28,233
公投第１２案,臺南市,後壁區,長短樹里,18,984,266,124,390,47,437
公投第１２案,臺南市,後壁區,長短樹里,19,483,121,85,206,21,227
公投第１２案,臺南市,後壁區,長短樹里,20,536,131,75,206,21,227
公投第１２案,臺南市,後壁區,竹新里,21,958,175,161,336,13,349
公投第１２案,臺南市,後壁區,竹新里,22,441,144,75,219,36,255
公投第１２案,臺南市,後壁區,新東里,23,677,209,123,332,45,377
公投第１２案,臺南市,後壁區,新東里,24,996,341,169,510,33,543
公投第１２案,臺南市,後壁區,頂安里,25,1255,361,195,556,25,581
公投第１２案,臺南市,後壁區,長安里,26,678,190,99,289,12,301
公投第１２案,臺南市,後壁區,長安里,27,553,145,92,237,8,245
公投第１２案,臺南市,後壁區,福安里,28,616,146,82,228,15,243
公投第１２案,臺南市,後壁區,福安里,29,1189,344,208,552,38,590
公投第１２案,臺南市,白河區,白河里,30,1176,368,216,584,56,640
公投第１２案,臺南市,白河區,白河里,31,546,164,106,270,11,281
公投第１２案,臺南市,白河區,永安里,32,859,279,182,461,16,477
公投第１２案,臺南市,白河區,永安里,33,946,314,194,508,30,538
公投第１２案,臺南市,白河區,永安里,34,1116,349,210,559,25,584
公投第１２案,臺南市,白河區,外角里,35,1397,360,204,564,17,581
公投第１２案,臺南市,白河區,庄內里,36,756,162,141,303,19,322
公投第１２案,臺南市,白河區,庄內里,37,871,261,132,393,34,427
公投第１２案,臺南市,白河區,秀祐里,38,897,249,171,420,32,452
公投第１２案,臺南市,白河區,河東里,39,784,152,103,255,32,287
公投第１２案,臺南市,白河區,河東里,40,572,126,102,228,16,244
公投第１２案,臺南市,白河區,虎山里,41,457,97,59,156,6,162
公投第１２案,臺南市,白河區,大林里,42,600,145,77,222,16,238
公投第１２案,臺南市,白河區,崁頭里,43,375,61,51,112,5,117
公投第１２案,臺南市,白河區,六溪里,44,508,86,53,139,13,152
公投第１２案,臺南市,白河區,關嶺里,45,631,117,80,197,12,209
公投第１２案,臺南市,白河區,關嶺里,46,391,70,37,107,15,122
公投第１２案,臺南市,白河區,仙草里,47,799,212,74,286,19,305
公投第１２案,臺南市,白河區,仙草里,48,506,109,65,174,11,185
公投第１２案,臺南市,白河區,詔豐里,49,832,215,133,348,28,376
公投第１２案,臺南市,白河區,詔豐里,50,1179,310,216,526,35,561
公投第１２案,臺南市,白河區,大竹里,51,744,156,105,261,12,273
公投第１２案,臺南市,白河區,大竹里,52,699,145,108,253,17,270
公投第１２案,臺南市,白河區,廣蓮里,53,633,144,86,230,9,239
公投第１２案,臺南市,白河區,廣蓮里,54,859,242,175,417,49,466
公投第１２案,臺南市,白河區,竹門里,55,884,202,153,355,39,394
公投第１２案,臺南市,白河區,崎內里,56,740,127,73,200,16,216
公投第１２案,臺南市,白河區,昇安里,57,1334,328,211,539,39,578
公投第１２案,臺南市,白河區,汴頭里,58,723,188,118,306,49,355
公投第１２案,臺南市,白河區,內角里,59,682,222,118,340,47,387
公投第１２案,臺南市,白河區,馬稠後里,60,855,228,175,403,38,441
公投第１２案,臺南市,白河區,馬稠後里,61,543,126,79,205,24,229
公投第１２案,臺南市,東山區,東山里,62,1401,379,211,590,31,621
公投第１２案,臺南市,東山區,東中里,63,1185,294,181,475,32,507
公投第１２案,臺南市,東山區,東中里,64,1303,291,187,478,57,535
公投第１２案,臺南市,東山區,東正里,65,732,159,121,280,18,298
公投第１２案,臺南市,東山區,東正里,66,721,166,96,262,25,287
公投第１２案,臺南市,東山區,大客里,67,1104,190,182,372,36,408
公投第１２案,臺南市,東山區,三榮里,68,943,253,131,384,23,407
公投第１２案,臺南市,東山區,科里里,69,653,110,65,175,1,176
公投第１２案,臺南市,東山區,科里里,70,596,160,95,255,39,294
公投第１２案,臺南市,東山區,東河里,71,878,230,132,362,38,400
公投第１２案,臺南市,東山區,聖賢里,72,771,163,117,280,45,325
公投第１２案,臺南市,東山區,聖賢里,73,483,119,75,194,17,211
公投第１２案,臺南市,東山區,聖賢里,74,640,171,107,278,38,316
公投第１２案,臺南市,東山區,南溪里,75,425,71,34,105,2,107
公投第１２案,臺南市,東山區,水雲里,76,394,96,44,140,11,151
公投第１２案,臺南市,東山區,林安里,77,373,107,64,171,21,192
公投第１２案,臺南市,東山區,東原里,78,1257,303,161,464,27,491
公投第１２案,臺南市,東山區,東原里,79,887,181,85,266,5,271
公投第１２案,臺南市,東山區,嶺南里,80,658,130,62,192,12,204
公投第１２案,臺南市,東山區,南勢里,81,1101,195,123,318,26,344
公投第１２案,臺南市,東山區,青山里,82,1057,193,118,311,15,326
公投第１２案,臺南市,東山區,高原里,83,639,186,102,288,22,310
公投第１２案,臺南市,東山區,高原里,84,270,58,49,107,10,117
公投第１２案,臺南市,鹽水區,水秀里,85,1037,337,180,517,45,562
公投第１２案,臺南市,鹽水區,水秀里,86,480,157,85,242,14,256
公投第１２案,臺南市,鹽水區,津城里,87,636,224,140,364,17,381
公投第１２案,臺南市,鹽水區,津城里,88,321,108,60,168,12,180
公投第１２案,臺南市,鹽水區,津城里,89,497,184,87,271,27,298
公投第１２案,臺南市,鹽水區,月港里,90,759,264,166,430,16,446
公投第１２案,臺南市,鹽水區,月港里,91,341,106,50,156,11,167
公投第１２案,臺南市,鹽水區,月港里,92,507,157,108,265,18,283
公投第１２案,臺南市,鹽水區,橋南里,93,863,222,157,379,21,400
公投第１２案,臺南市,鹽水區,橋南里,94,1373,380,263,643,19,662
公投第１２案,臺南市,鹽水區,橋南里,95,1507,440,267,707,44,751
公投第１２案,臺南市,鹽水區,岸內里,96,1374,421,266,687,44,731
公投第１２案,臺南市,鹽水區,岸內里,97,1244,345,220,565,33,598
公投第１２案,臺南市,鹽水區,岸內里,98,1022,317,186,503,35,538
公投第１２案,臺南市,鹽水區,汫水里,99,921,194,123,317,39,356
公投第１２案,臺南市,鹽水區,義中里,100,847,251,176,427,32,459
公投第１２案,臺南市,鹽水區,義中里,101,736,146,100,246,11,257
公投第１２案,臺南市,鹽水區,三明里,102,761,234,143,377,18,395
公投第１２案,臺南市,鹽水區,三明里,103,285,81,49,130,11,141
公投第１２案,臺南市,鹽水區,三明里,104,493,111,101,212,15,227
公投第１２案,臺南市,鹽水區,文昌里,105,621,129,100,229,17,246
公投第１２案,臺南市,鹽水區,文昌里,106,392,94,50,144,9,153
公投第１２案,臺南市,鹽水區,歡雅里,107,925,249,182,431,21,452
公投第１２案,臺南市,鹽水區,歡雅里,108,728,181,115,296,32,328
公投第１２案,臺南市,鹽水區,三和里,109,214,42,25,67,18,85
公投第１２案,臺南市,鹽水區,三和里,110,387,120,52,172,7,179
公投第１２案,臺南市,鹽水區,三和里,111,301,91,52,143,14,157
公投第１２案,臺南市,鹽水區,竹林里,112,755,152,123,275,29,304
公投第１２案,臺南市,鹽水區,竹林里,113,365,90,48,138,17,155
公投第１２案,臺南市,鹽水區,坔頭港里,114,935,258,166,424,23,447
公投第１２案,臺南市,鹽水區,坔頭港里,115,494,137,76,213,21,234
公投第１２案,臺南市,新營區,忠政里,116,1693,465,299,764,36,800
公投第１２案,臺南市,新營區,忠政里,117,1561,519,311,830,41,871
公投第１２案,臺南市,新營區,忠政里,118,1487,474,302,776,33,809
公投第１２案,臺南市,新營區,民權里,119,1232,419,213,632,27,659
公投第１２案,臺南市,新營區,民權里,120,1067,306,227,533,19,552
公投第１２案,臺南市,新營區,三仙里,121,1419,389,258,647,36,683
公投第１２案,臺南市,新營區,三仙里,122,1466,505,289,794,29,823
公投第１２案,臺南市,新營區,永平里,123,932,327,206,533,41,574
公投第１２案,臺南市,新營區,永平里,124,1099,337,189,526,14,540
公投第１２案,臺南市,新營區,永平里,125,757,220,141,361,14,375
公投第１２案,臺南市,新營區,大宏里,126,888,309,181,490,26,516
公投第１２案,臺南市,新營區,大宏里,127,1115,342,221,563,19,582
公投第１２案,臺南市,新營區,大宏里,128,937,287,167,454,14,468
公投第１２案,臺南市,新營區,王公里,129,1387,389,273,662,30,692
公投第１２案,臺南市,新營區,王公里,130,1526,460,261,721,43,764
公投第１２案,臺南市,新營區,王公里,131,1301,413,295,708,26,734
公投第１２案,臺南市,新營區,新東里,132,1538,498,334,832,38,870
公投第１２案,臺南市,新營區,新東里,133,1584,494,330,824,31,855
公投第１２案,臺南市,新營區,新東里,134,1583,532,342,874,17,891
公投第１２案,臺南市,新營區,新東里,135,1530,473,338,811,29,840
公投第１２案,臺南市,新營區,中營里,136,1193,401,271,672,35,707
公投第１２案,臺南市,新營區,土庫里,137,1439,324,236,560,23,583
公投第１２案,臺南市,新營區,興業里,138,1438,490,284,774,36,810
公投第１２案,臺南市,新營區,興業里,139,359,119,73,192,18,210
公投第１２案,臺南市,新營區,南興里,140,1233,310,204,514,26,540
公投第１２案,臺南市,新營區,南興里,141,1227,329,183,512,20,532
公投第１２案,臺南市,新營區,民生里,142,1320,350,240,590,23,613
公投第１２案,臺南市,新營區,民生里,143,1930,471,347,818,27,845
公投第１２案,臺南市,新營區,新北里,144,1501,472,287,759,35,794
公投第１２案,臺南市,新營區,新北里,145,1475,441,256,697,29,726
公投第１２案,臺南市,新營區,新北里,146,1753,641,256,897,39,936
公投第１２案,臺南市,新營區,新南里,147,1748,490,351,841,28,869
公投第１２案,臺南市,新營區,新南里,148,1741,545,322,867,37,904
公投第１２案,臺南市,新營區,新南里,149,1433,411,271,682,19,701
公投第１２案,臺南市,新營區,民榮里,150,1595,476,320,796,38,834
公投第１２案,臺南市,新營區,民榮里,151,959,268,172,440,22,462
公投第１２案,臺南市,新營區,民榮里,152,1865,519,331,850,54,904
公投第１２案,臺南市,新營區,埤寮里,153,1678,416,305,721,68,789
公投第１２案,臺南市,新營區,護鎮里,154,1373,361,230,591,32,623
公投第１２案,臺南市,新營區,太南里,155,1431,342,215,557,23,580
公投第１２案,臺南市,新營區,太南里,156,291,71,44,115,1,116
公投第１２案,臺南市,新營區,太北里,157,1749,517,326,843,42,885
公投第１２案,臺南市,新營區,南紙里,158,1862,478,339,817,46,863
公投第１２案,臺南市,新營區,南紙里,159,1821,542,374,916,66,982
公投第１２案,臺南市,新營區,嘉芳里,160,1845,505,316,821,46,867
公投第１２案,臺南市,新營區,姑爺里,161,542,137,73,210,5,215
公投第１２案,臺南市,新營區,姑爺里,162,402,97,51,148,5,153
公投第１２案,臺南市,新營區,五興里,163,703,223,141,364,47,411
公投第１２案,臺南市,新營區,五興里,164,941,241,153,394,26,420
公投第１２案,臺南市,柳營區,士林里,165,1166,317,223,540,39,579
公投第１２案,臺南市,柳營區,士林里,166,625,214,126,340,10,350
公投第１２案,臺南市,柳營區,光福里,167,738,222,116,338,16,354
公投第１２案,臺南市,柳營區,光福里,168,834,312,173,485,17,502
公投第１２案,臺南市,柳營區,中埕里,169,1104,329,188,517,28,545
公投第１２案,臺南市,柳營區,東昇里,170,1015,279,190,469,14,483
公投第１２案,臺南市,柳營區,東昇里,171,1720,561,298,859,96,955
公投第１２案,臺南市,柳營區,八翁里,172,1391,363,226,589,73,662
公投第１２案,臺南市,柳營區,人和里,173,425,133,65,198,9,207
公投第１２案,臺南市,柳營區,人和里,174,318,81,45,126,10,136
公投第１２案,臺南市,柳營區,太康里,175,753,205,145,350,28,378
公投第１２案,臺南市,柳營區,太康里,176,730,186,114,300,43,343
公投第１２案,臺南市,柳營區,重溪里,177,725,228,117,345,24,369
公投第１２案,臺南市,柳營區,重溪里,178,787,238,158,396,32,428
公投第１２案,臺南市,柳營區,重溪里,179,297,86,69,155,17,172
公投第１２案,臺南市,柳營區,篤農里,180,673,210,143,353,23,376
公投第１２案,臺南市,柳營區,篤農里,181,640,205,115,320,44,364
公投第１２案,臺南市,柳營區,大農里,182,660,138,124,262,28,290
公投第１２案,臺南市,柳營區,神農里,183,1212,379,143,522,35,557
公投第１２案,臺南市,柳營區,神農里,184,202,52,31,83,7,90
公投第１２案,臺南市,柳營區,果毅里,185,1049,293,167,460,56,516
公投第１２案,臺南市,柳營區,果毅里,186,158,42,34,76,0,76
公投第１２案,臺南市,柳營區,旭山里,187,921,240,164,404,60,464
公投第１２案,臺南市,柳營區,旭山里,188,504,137,83,220,16,236
公投第１２案,臺南市,柳營區,旭山里,189,157,38,25,63,3,66
公投第１２案,臺南市,北門區,永隆里,190,484,141,93,234,10,244
公投第１２案,臺南市,北門區,永隆里,191,401,94,61,155,11,166
公投第１２案,臺南市,北門區,北門里,192,456,142,55,197,4,201
公投第１２案,臺南市,北門區,北門里,193,382,122,83,205,9,214
公投第１２案,臺南市,北門區,玉港里,194,356,121,49,170,14,184
公投第１２案,臺南市,北門區,玉港里,195,389,112,49,161,6,167
公投第１２案,臺南市,北門區,保吉里,196,742,210,97,307,13,320
公投第１２案,臺南市,北門區,保吉里,197,599,180,86,266,8,274
公投第１２案,臺南市,北門區,蚵寮里,198,594,155,76,231,19,250
公投第１２案,臺南市,北門區,蚵寮里,199,572,145,90,235,13,248
公投第１２案,臺南市,北門區,蚵寮里,200,318,62,47,109,4,113
公投第１２案,臺南市,北門區,雙春里,201,473,90,79,169,10,179
公投第１２案,臺南市,北門區,錦湖里,202,954,214,126,340,14,354
公投第１２案,臺南市,北門區,慈安里,203,737,233,138,371,30,401
公投第１２案,臺南市,北門區,三光里,204,679,148,73,221,15,236
公投第１２案,臺南市,北門區,三光里,205,521,112,69,181,24,205
公投第１２案,臺南市,北門區,文山里,206,632,152,74,226,18,244
公投第１２案,臺南市,北門區,文山里,207,636,159,92,251,7,258
公投第１２案,臺南市,學甲區,秀昌里,208,862,273,189,462,31,493
公投第１２案,臺南市,學甲區,秀昌里,209,611,223,127,350,4,354
公投第１２案,臺南市,學甲區,秀昌里,210,936,297,170,467,18,485
公投第１２案,臺南市,學甲區,明宜里,211,1066,306,186,492,30,522
公投第１２案,臺南市,學甲區,明宜里,212,869,290,178,468,18,486
公投第１２案,臺南市,學甲區,慈福里,213,635,198,123,321,17,338
公投第１２案,臺南市,學甲區,慈福里,214,822,237,129,366,20,386
公投第１２案,臺南市,學甲區,慈福里,215,443,117,68,185,13,198
公投第１２案,臺南市,學甲區,仁得里,216,1370,413,269,682,26,708
公投第１２案,臺南市,學甲區,仁得里,217,1117,354,225,579,35,614
公投第１２案,臺南市,學甲區,仁得里,218,1365,375,265,640,46,686
公投第１２案,臺南市,學甲區,新達里,219,1489,419,257,676,38,714
公投第１２案,臺南市,學甲區,新達里,220,627,145,94,239,30,269
公投第１２案,臺南市,學甲區,新榮里,221,1052,304,206,510,24,534
公投第１２案,臺南市,學甲區,新榮里,222,1183,338,221,559,19,578
公投第１２案,臺南市,學甲區,大灣里,223,979,259,149,408,18,426
公投第１２案,臺南市,學甲區,豐和里,224,1241,276,245,521,39,560
公投第１２案,臺南市,學甲區,中洲里,225,843,207,115,322,17,339
公投第１２案,臺南市,學甲區,中洲里,226,580,161,99,260,25,285
公投第１２案,臺南市,學甲區,光華里,227,832,213,100,313,15,328
公投第１２案,臺南市,學甲區,光華里,228,406,85,61,146,8,154
公投第１２案,臺南市,學甲區,宅港里,229,818,243,157,400,27,427
公投第１２案,臺南市,學甲區,平和里,230,1052,246,163,409,11,420
公投第１２案,臺南市,學甲區,三慶里,231,578,143,99,242,15,257
公投第１２案,臺南市,學甲區,三慶里,232,430,123,48,171,11,182
公投第１２案,臺南市,學甲區,三慶里,233,361,117,52,169,10,179
公投第１２案,臺南市,將軍區,長榮里,234,1110,394,216,610,39,649
公投第１２案,臺南市,將軍區,西甲里,235,1418,462,230,692,22,714
公投第１２案,臺南市,將軍區,西甲里,236,969,341,153,494,19,513
公投第１２案,臺南市,將軍區,忠嘉里,237,519,195,98,293,23,316
公投第１２案,臺南市,將軍區,忠嘉里,238,1106,361,183,544,18,562
公投第１２案,臺南市,將軍區,忠嘉里,239,542,141,114,255,19,274
公投第１２案,臺南市,將軍區,忠嘉里,240,315,82,49,131,5,136
公投第１２案,臺南市,將軍區,苓仔寮里,241,584,142,91,233,18,251
公投第１２案,臺南市,將軍區,苓仔寮里,242,398,111,66,177,8,185
公投第１２案,臺南市,將軍區,苓仔寮里,243,608,153,98,251,17,268
公投第１２案,臺南市,將軍區,苓仔寮里,244,442,128,86,214,17,231
公投第１２案,臺南市,將軍區,巷埔里,245,650,156,100,256,7,263
公投第１２案,臺南市,將軍區,巷埔里,246,573,146,64,210,14,224
公投第１２案,臺南市,將軍區,將軍里,247,617,197,77,274,7,281
公投第１２案,臺南市,將軍區,將軍里,248,573,186,89,275,20,295
公投第１２案,臺南市,將軍區,將軍里,249,434,148,62,210,13,223
公投第１２案,臺南市,將軍區,玉山里,250,849,242,115,357,13,370
公投第１２案,臺南市,將軍區,廣山里,251,645,176,76,252,15,267
公投第１２案,臺南市,將軍區,長沙里,252,690,212,84,296,20,316
公投第１２案,臺南市,將軍區,長沙里,253,663,168,14,182,13,195
公投第１２案,臺南市,將軍區,平沙里,254,1175,379,155,534,28,562
公投第１２案,臺南市,將軍區,鯤鯓里,255,837,225,100,325,18,343
公投第１２案,臺南市,將軍區,鯤鯓里,256,1061,62,166,228,328,556
公投第１２案,臺南市,將軍區,鯤溟里,257,976,283,122,405,14,419
公投第１２案,臺南市,七股區,後港里,258,534,160,90,250,9,259
公投第１２案,臺南市,七股區,後港里,259,508,200,84,284,14,298
公投第１２案,臺南市,七股區,大潭里,260,665,179,81,260,11,271
公投第１２案,臺南市,七股區,篤加里,261,834,250,123,373,16,389
公投第１２案,臺南市,七股區,頂山里,262,810,280,111,391,12,403
公投第１２案,臺南市,七股區,西寮里,263,480,146,48,194,12,206
公投第１２案,臺南市,七股區,塩埕里,264,445,117,61,178,6,184
公投第１２案,臺南市,七股區,中寮里,265,680,141,72,213,7,220
公投第１２案,臺南市,七股區,龍山里,266,838,254,117,371,12,383
公投第１２案,臺南市,七股區,龍山里,267,780,230,95,325,16,341
公投第１２案,臺南市,七股區,溪南里,268,350,112,74,186,13,199
公投第１２案,臺南市,七股區,七股里,269,907,301,185,486,43,529
公投第１２案,臺南市,七股區,玉成里,270,780,218,116,334,23,357
公投第１２案,臺南市,七股區,大埕里,271,1658,448,270,718,42,760
公投第１２案,臺南市,七股區,大埕里,272,913,330,123,453,21,474
公投第１２案,臺南市,七股區,樹林里,273,1202,344,207,551,55,606
公投第１２案,臺南市,七股區,樹林里,274,696,175,101,276,7,283
公投第１２案,臺南市,七股區,竹橋里,275,647,182,126,308,26,334
公投第１２案,臺南市,七股區,竹橋里,276,622,251,110,361,29,390
公投第１２案,臺南市,七股區,義合里,277,1175,426,210,636,50,686
公投第１２案,臺南市,七股區,義合里,278,698,174,145,319,16,335
公投第１２案,臺南市,七股區,永吉里,279,983,327,157,484,31,515
公投第１２案,臺南市,七股區,三股里,280,1366,441,164,605,27,632
公投第１２案,臺南市,七股區,十份里,281,1379,348,232,580,31,611
公投第１２案,臺南市,佳里區,東寧里,282,1391,459,284,743,39,782
公投第１２案,臺南市,佳里區,東寧里,283,829,311,167,478,17,495
公投第１２案,臺南市,佳里區,忠仁里,284,1401,424,216,640,45,685
公投第１２案,臺南市,佳里區,忠仁里,285,1452,400,246,646,21,667
公投第１２案,臺南市,佳里區,鎮山里,286,1382,446,258,704,48,752
公投第１２案,臺南市,佳里區,鎮山里,287,1463,448,267,715,65,780
公投第１２案,臺南市,佳里區,鎮山里,288,1280,416,201,617,29,646
公投第１２案,臺南市,佳里區,鎮山里,289,1486,468,305,773,57,830
公投第１２案,臺南市,佳里區,安西里,290,1378,454,267,721,50,771
公投第１２案,臺南市,佳里區,安西里,291,1505,518,273,791,48,839
公投第１２案,臺南市,佳里區,安西里,292,1860,583,344,927,49,976
公投第１２案,臺南市,佳里區,安西里,293,1134,376,202,578,55,633
公投第１２案,臺南市,佳里區,文新里,294,1426,462,273,735,28,763
公投第１２案,臺南市,佳里區,文新里,295,1779,536,365,901,48,949
公投第１２案,臺南市,佳里區,文新里,296,1906,614,390,1004,36,1040
公投第１２案,臺南市,佳里區,建南里,297,1425,414,284,698,26,724
公投第１２案,臺南市,佳里區,建南里,298,1255,380,248,628,31,659
公投第１２案,臺南市,佳里區,建南里,299,1524,444,261,705,56,761
公投第１２案,臺南市,佳里區,南勢里,300,1631,496,312,808,31,839
公投第１２案,臺南市,佳里區,南勢里,301,1546,517,327,844,26,870
公投第１２案,臺南市,佳里區,南勢里,302,1187,417,265,682,30,712
公投第１２案,臺南市,佳里區,六安里,303,1381,415,286,701,34,735
公投第１２案,臺南市,佳里區,六安里,304,1364,418,249,667,19,686
公投第１２案,臺南市,佳里區,六安里,305,1314,419,261,680,25,705
公投第１２案,臺南市,佳里區,佳化里,306,1164,378,238,616,36,652
公投第１２案,臺南市,佳里區,佳化里,307,961,326,158,484,34,518
公投第１２案,臺南市,佳里區,佳興里,308,1218,383,222,605,36,641
公投第１２案,臺南市,佳里區,佳興里,309,919,394,101,495,17,512
公投第１２案,臺南市,佳里區,營溪里,310,689,210,121,331,35,366
公投第１２案,臺南市,佳里區,營溪里,311,383,109,61,170,15,185
公投第１２案,臺南市,佳里區,海澄里,312,1507,454,231,685,40,725
公投第１２案,臺南市,佳里區,海澄里,313,702,202,123,325,21,346
公投第１２案,臺南市,佳里區,下營里,314,907,315,155,470,41,511
公投第１２案,臺南市,佳里區,下營里,315,937,317,200,517,41,558
公投第１２案,臺南市,佳里區,塭內里,316,1030,286,201,487,74,561
公投第１２案,臺南市,佳里區,塭內里,317,981,292,188,480,38,518
公投第１２案,臺南市,佳里區,塭內里,318,787,251,123,374,18,392
公投第１２案,臺南市,佳里區,民安里,319,1513,473,257,730,54,784
公投第１２案,臺南市,佳里區,子龍里,320,714,193,112,305,22,327
公投第１２案,臺南市,佳里區,子龍里,321,745,214,128,342,32,374
公投第１２案,臺南市,佳里區,子龍里,322,951,259,176,435,30,465
公投第１２案,臺南市,西港區,西港里,323,933,287,167,454,22,476
公投第１２案,臺南市,西港區,西港里,324,901,249,199,448,24,472
公投第１２案,臺南市,西港區,西港里,325,1314,364,247,611,25,636
公投第１２案,臺南市,西港區,慶安里,326,1349,398,246,644,54,698
公投第１２案,臺南市,西港區,慶安里,327,1014,340,189,529,38,567
公投第１２案,臺南市,西港區,慶安里,328,1900,448,300,748,30,778
公投第１２案,臺南市,西港區,南海里,329,1663,431,278,709,48,757
公投第１２案,臺南市,西港區,南海里,330,738,189,127,316,9,325
公投第１２案,臺南市,西港區,港東里,331,1211,362,251,613,39,652
公投第１２案,臺南市,西港區,港東里,332,382,119,57,176,15,191
公投第１２案,臺南市,西港區,檨林里,333,786,240,126,366,22,388
公投第１２案,臺南市,西港區,檨林里,334,838,253,136,389,16,405
公投第１２案,臺南市,西港區,後營里,335,1449,341,255,596,33,629
公投第１２案,臺南市,西港區,營西里,336,1479,361,237,598,30,628
公投第１２案,臺南市,西港區,金砂里,337,763,249,141,390,42,432
公投第１２案,臺南市,西港區,劉厝里,338,1297,336,221,557,29,586
公投第１２案,臺南市,西港區,竹林里,339,1393,403,229,632,47,679
公投第１２案,臺南市,西港區,永樂里,340,958,243,138,381,22,403
公投第１２案,臺南市,西港區,永樂里,341,391,119,87,206,17,223
公投第１２案,臺南市,西港區,新復里,342,805,235,160,395,28,423
公投第１２案,臺南市,下營區,下營里,343,1558,436,241,677,30,707
公投第１２案,臺南市,下營區,仁里里,344,1112,263,167,430,42,472
公投第１２案,臺南市,下營區,仁里里,345,893,256,140,396,31,427
公投第１２案,臺南市,下營區,宅內里,346,1623,378,277,655,69,724
公投第１２案,臺南市,下營區,後街里,347,1568,421,292,713,75,788
公投第１２案,臺南市,下營區,新興里,348,985,305,167,472,38,510
公投第１２案,臺南市,下營區,新興里,349,953,277,159,436,16,452
公投第１２案,臺南市,下營區,營前里,350,1031,309,157,466,37,503
公投第１２案,臺南市,下營區,營前里,351,1077,375,195,570,37,607
公投第１２案,臺南市,下營區,大吉里,352,703,163,104,267,32,299
公投第１２案,臺南市,下營區,大吉里,353,854,208,148,356,18,374
公投第１２案,臺南市,下營區,茅營里,354,1164,326,210,536,66,602
公投第１２案,臺南市,下營區,茅營里,355,1091,286,186,472,22,494
公投第１２案,臺南市,下營區,開化里,356,959,289,160,449,41,490
公投第１２案,臺南市,下營區,開化里,357,935,277,148,425,27,452
公投第１２案,臺南市,下營區,西連里,358,893,255,171,426,43,469
公投第１２案,臺南市,下營區,賀建里,359,1293,425,184,609,72,681
公投第１２案,臺南市,下營區,紅甲里,360,1185,340,201,541,87,628
公投第１２案,臺南市,下營區,紅甲里,361,1070,254,156,410,18,428
公投第１２案,臺南市,六甲區,六甲里,362,819,251,172,423,47,470
公投第１２案,臺南市,六甲區,六甲里,363,645,189,124,313,21,334
公投第１２案,臺南市,六甲區,六甲里,364,1444,345,287,632,42,674
公投第１２案,臺南市,六甲區,甲東里,365,1554,372,269,641,44,685
公投第１２案,臺南市,六甲區,甲東里,366,1171,286,207,493,34,527
公投第１２案,臺南市,六甲區,甲南里,367,1351,350,251,601,54,655
公投第１２案,臺南市,六甲區,七甲里,368,1010,230,166,396,74,470
公投第１２案,臺南市,六甲區,七甲里,369,919,225,165,390,52,442
公投第１２案,臺南市,六甲區,二甲里,370,1369,360,251,611,50,661
公投第１２案,臺南市,六甲區,二甲里,371,976,277,188,465,52,517
公投第１２案,臺南市,六甲區,二甲里,372,1015,284,209,493,62,555
公投第１２案,臺南市,六甲區,水林里,373,1176,304,203,507,35,542
公投第１２案,臺南市,六甲區,水林里,374,939,248,189,437,50,487
公投第１２案,臺南市,六甲區,中社里,375,712,187,143,330,45,375
公投第１２案,臺南市,六甲區,中社里,376,881,244,189,433,31,464
公投第１２案,臺南市,六甲區,龜港里,377,1184,350,293,643,46,689
公投第１２案,臺南市,六甲區,菁埔里,378,599,208,127,335,33,368
公投第１２案,臺南市,六甲區,王爺里,379,759,138,93,231,13,244
公投第１２案,臺南市,六甲區,大丘里,380,621,137,89,226,25,251
公投第１２案,臺南市,麻豆區,新興里,381,1205,364,228,592,45,637
公投第１２案,臺南市,麻豆區,新興里,382,660,200,150,350,22,372
公投第１２案,臺南市,麻豆區,巷口里,383,523,174,110,284,12,296
公投第１２案,臺南市,麻豆區,巷口里,384,1597,439,335,774,30,804
公投第１２案,臺南市,麻豆區,東角里,385,1262,374,283,657,45,702
公投第１２案,臺南市,麻豆區,東角里,386,1325,425,287,712,46,758
公投第１２案,臺南市,麻豆區,晋江里,387,1384,388,282,670,40,710
公投第１２案,臺南市,麻豆區,晋江里,388,1121,288,244,532,14,546
公投第１２案,臺南市,麻豆區,中興里,389,1021,319,171,490,11,501
公投第１２案,臺南市,麻豆區,中興里,390,954,261,190,451,22,473
公投第１２案,臺南市,麻豆區,興農里,391,1513,416,262,678,24,702
公投第１２案,臺南市,麻豆區,油車里,392,1726,465,281,746,43,789
公投第１２案,臺南市,麻豆區,油車里,393,1804,539,336,875,46,921
公投第１２案,臺南市,麻豆區,北勢里,394,1106,303,202,505,37,542
公投第１２案,臺南市,麻豆區,大埕里,395,1503,451,299,750,43,793
公投第１２案,臺南市,麻豆區,大埕里,396,1302,352,246,598,65,663
公投第１２案,臺南市,麻豆區,清水里,397,645,190,125,315,12,327
公投第１２案,臺南市,麻豆區,清水里,398,777,251,155,406,32,438
公投第１２案,臺南市,麻豆區,南勢里,399,1612,433,301,734,48,782
公投第１２案,臺南市,麻豆區,南勢里,400,718,202,122,324,16,340
公投第１２案,臺南市,麻豆區,寮廍里,401,1656,474,258,732,25,757
公投第１２案,臺南市,麻豆區,埤頭里,402,1355,356,255,611,60,671
公投第１２案,臺南市,麻豆區,埤頭里,403,977,230,154,384,24,408
公投第１２案,臺南市,麻豆區,海埔里,404,1012,282,164,446,29,475
公投第１２案,臺南市,麻豆區,海埔里,405,626,175,157,332,20,352
公投第１２案,臺南市,麻豆區,海埔里,406,467,97,60,157,2,159
公投第１２案,臺南市,麻豆區,港尾里,407,1260,362,200,562,34,596
公投第１２案,臺南市,麻豆區,麻口里,408,1111,388,174,562,38,600
公投第１２案,臺南市,麻豆區,安業里,409,550,155,133,288,12,300
公投第１２案,臺南市,麻豆區,安業里,410,798,225,165,390,38,428
公投第１２案,臺南市,麻豆區,謝厝寮里,411,852,277,186,463,49,512
公投第１２案,臺南市,麻豆區,謝厝寮里,412,830,221,107,328,22,350
公投第１２案,臺南市,麻豆區,安正里,413,941,239,158,397,23,420
公投第１２案,臺南市,麻豆區,井東里,414,1158,377,224,601,31,632
公投第１２案,臺南市,麻豆區,井東里,415,612,173,107,280,12,292
公投第１２案,臺南市,官田區,官田里,416,1104,321,171,492,25,517
公投第１２案,臺南市,官田區,官田里,417,965,288,156,444,30,474
公投第１２案,臺南市,官田區,二鎮里,418,1402,388,289,677,44,721
公投第１２案,臺南市,官田區,二鎮里,419,1653,490,349,839,72,911
公投第１２案,臺南市,官田區,烏山頭里,420,966,241,163,404,46,450
公投第１２案,臺南市,官田區,烏山頭里,421,284,65,52,117,10,127
公投第１２案,臺南市,官田區,大崎里,422,402,68,63,131,2,133
公投第１２案,臺南市,官田區,隆田里,423,982,319,174,493,16,509
公投第１２案,臺南市,官田區,隆田里,424,975,274,143,417,31,448
公投第１２案,臺南市,官田區,隆本里,425,802,223,153,376,22,398
公投第１２案,臺南市,官田區,隆本里,426,1118,361,220,581,40,621
公投第１２案,臺南市,官田區,隆本里,427,1455,419,292,711,31,742
公投第１２案,臺南市,官田區,南廍里,428,1208,350,223,573,42,615
公投第１２案,臺南市,官田區,東西庄里,429,1293,355,229,584,62,646
公投第１２案,臺南市,官田區,東西庄里,430,607,138,108,246,18,264
公投第１２案,臺南市,官田區,渡拔里,431,501,159,76,235,13,248
公投第１２案,臺南市,官田區,渡拔里,432,728,222,156,378,30,408
公投第１２案,臺南市,官田區,渡拔里,433,842,253,165,418,23,441
公投第１２案,臺南市,官田區,渡拔里,434,515,147,102,249,31,280
公投第１２案,臺南市,官田區,社子里,435,873,236,115,351,31,382
公投第１２案,臺南市,大內區,石湖里,436,759,180,131,311,22,333
公投第１２案,臺南市,大內區,石湖里,437,262,46,38,84,4,88
公投第１２案,臺南市,大內區,石林里,438,646,165,87,252,15,267
公投第１２案,臺南市,大內區,石城里,439,1473,358,208,566,44,610
公投第１２案,臺南市,大內區,內江里,440,915,291,151,442,60,502
公投第１２案,臺南市,大內區,大內里,441,779,245,152,397,44,441
公投第１２案,臺南市,大內區,內郭里,442,637,197,155,352,41,393
公投第１２案,臺南市,大內區,頭社里,443,993,287,169,456,32,488
公投第１２案,臺南市,大內區,環湖里,444,766,237,145,382,35,417
公投第１２案,臺南市,大內區,二溪里,445,841,276,139,415,28,443
公投第１２案,臺南市,大內區,曲溪里,446,583,190,74,264,28,292
公投第１２案,臺南市,楠西區,楠西里,447,978,277,149,426,50,476
公投第１２案,臺南市,楠西區,楠西里,448,870,264,172,436,39,475
公投第１２案,臺南市,楠西區,灣丘里,449,1160,242,147,389,19,408
公投第１２案,臺南市,楠西區,密枝里,450,699,188,107,295,17,312
公投第１２案,臺南市,楠西區,照興里,451,990,253,126,379,20,399
公投第１２案,臺南市,楠西區,鹿田里,452,928,258,133,391,34,425
公投第１２案,臺南市,楠西區,龜丹里,453,660,200,105,305,33,338
公投第１２案,臺南市,楠西區,東勢里,454,1187,311,210,521,67,588
公投第１２案,臺南市,楠西區,東勢里,455,1056,265,199,464,34,498
公投第１２案,臺南市,南化區,南化里,456,690,182,144,326,47,373
公投第１２案,臺南市,南化區,南化里,457,695,192,158,350,37,387
公投第１２案,臺南市,南化區,小崙里,458,806,181,146,327,38,365
公投第１２案,臺南市,南化區,東和里,459,654,142,104,246,27,273
公投第１２案,臺南市,南化區,西埔里,460,783,150,99,249,36,285
公投第１２案,臺南市,南化區,中坑里,461,425,129,68,197,11,208
公投第１２案,臺南市,南化區,北平里,462,559,152,99,251,25,276
公投第１２案,臺南市,南化區,北寮里,463,1189,306,196,502,32,534
公投第１２案,臺南市,南化區,玉山里,464,1044,340,188,528,27,555
公投第１２案,臺南市,南化區,關山里,465,941,302,158,460,31,491
公投第１２案,臺南市,玉井區,玉井里,466,1242,363,212,575,45,620
公投第１２案,臺南市,玉井區,玉田里,467,1141,374,196,570,40,610
公投第１２案,臺南市,玉井區,玉田里,468,698,213,110,323,26,349
公投第１２案,臺南市,玉井區,玉田里,469,849,259,146,405,33,438
公投第１２案,臺南市,玉井區,玉田里,470,949,308,159,467,45,512
公投第１２案,臺南市,玉井區,中正里,471,618,184,108,292,26,318
公投第１２案,臺南市,玉井區,中正里,472,594,166,88,254,14,268
公投第１２案,臺南市,玉井區,竹圍里,473,927,232,142,374,32,406
公投第１２案,臺南市,玉井區,竹圍里,474,512,158,86,244,30,274
公投第１２案,臺南市,玉井區,沙田里,475,509,134,89,223,22,245
公投第１２案,臺南市,玉井區,三埔里,476,496,155,100,255,29,284
公投第１２案,臺南市,玉井區,三和里,477,759,212,130,342,24,366
公投第１２案,臺南市,玉井區,望明里,478,669,154,98,252,17,269
公投第１２案,臺南市,玉井區,望明里,479,787,210,130,340,52,392
公投第１２案,臺南市,玉井區,層林里,480,620,189,85,274,32,306
公投第１２案,臺南市,玉井區,豐里里,481,987,272,183,455,49,504
公投第１２案,臺南市,左鎮區,光和里,482,392,114,65,179,13,192
公投第１２案,臺南市,左鎮區,榮和里,483,644,241,82,323,22,345
公投第１２案,臺南市,左鎮區,左鎮里,484,468,122,70,192,8,200
公投第１２案,臺南市,左鎮區,中正里,485,753,206,109,315,18,333
公投第１２案,臺南市,左鎮區,睦光里,486,345,94,59,153,9,162
公投第１２案,臺南市,左鎮區,內庄里,487,393,106,59,165,11,176
公投第１２案,臺南市,左鎮區,岡林里,488,420,149,71,220,8,228
公投第１２案,臺南市,左鎮區,草山里,489,313,71,46,117,12,129
公投第１２案,臺南市,左鎮區,二寮里,490,186,47,26,73,4,77
公投第１２案,臺南市,左鎮區,澄山里,491,504,144,64,208,23,231
公投第１２案,臺南市,善化區,東關里,492,1132,338,189,527,13,540
公投第１２案,臺南市,善化區,坐駕里,493,1845,531,340,871,49,920
公投第１２案,臺南市,善化區,坐駕里,494,2090,625,369,994,58,1052
公投第１２案,臺南市,善化區,光文里,495,1582,549,287,836,43,879
公投第１２案,臺南市,善化區,光文里,496,1901,601,406,1007,49,1056
公投第１２案,臺南市,善化區,光文里,497,1818,571,353,924,36,960
公投第１２案,臺南市,善化區,文昌里,498,1639,519,281,800,58,858
公投第１２案,臺南市,善化區,文昌里,499,1061,339,227,566,31,597
公投第１２案,臺南市,善化區,南關里,500,1786,618,340,958,53,1011
公投第１２案,臺南市,善化區,頂街里,501,1147,399,192,591,35,626
公投第１２案,臺南市,善化區,文正里,502,1581,481,266,747,40,787
公投第１２案,臺南市,善化區,胡家里,503,1240,367,249,616,53,669
公投第１２案,臺南市,善化區,胡厝里,504,1743,520,279,799,33,832
公投第１２案,臺南市,善化區,什乃里,505,1246,422,263,685,34,719
公投第１２案,臺南市,善化區,溪美里,506,961,290,192,482,19,501
公投第１２案,臺南市,善化區,溪美里,507,938,289,157,446,8,454
公投第１２案,臺南市,善化區,六分里,508,722,254,133,387,15,402
公投第１２案,臺南市,善化區,六德里,509,1062,339,170,509,28,537
公投第１２案,臺南市,善化區,田寮里,510,1715,513,312,825,55,880
公投第１２案,臺南市,善化區,昌隆里,511,1120,313,183,496,60,556
公投第１２案,臺南市,善化區,昌隆里,512,865,270,147,417,23,440
公投第１２案,臺南市,善化區,牛庄里,513,1574,429,344,773,45,818
公投第１２案,臺南市,善化區,嘉北里,514,1535,401,249,650,50,700
公投第１２案,臺南市,善化區,嘉南里,515,1106,306,226,532,57,589
公投第１２案,臺南市,善化區,小新里,516,1402,452,237,689,35,724
公投第１２案,臺南市,善化區,小新里,517,1458,501,323,824,52,876
公投第１２案,臺南市,善化區,小新里,518,1380,356,260,616,32,648
公投第１２案,臺南市,善化區,蓮潭里,519,1232,373,260,633,10,643
公投第１２案,臺南市,善化區,蓮潭里,520,1069,318,249,567,15,582
公投第１２案,臺南市,安定區,蘇林里,521,1251,474,242,716,63,779
公投第１２案,臺南市,安定區,蘇林里,522,899,307,170,477,32,509
公投第１２案,臺南市,安定區,蘇厝里,523,1106,374,193,567,45,612
公投第１２案,臺南市,安定區,蘇厝里,524,948,351,159,510,24,534
公投第１２案,臺南市,安定區,安定里,525,1442,417,266,683,38,721
公投第１２案,臺南市,安定區,安加里,526,1385,436,238,674,53,727
公投第１２案,臺南市,安定區,安加里,527,801,303,134,437,22,459
公投第１２案,臺南市,安定區,港尾里,528,736,195,133,328,17,345
公投第１２案,臺南市,安定區,港尾里,529,781,232,147,379,29,408
公投第１２案,臺南市,安定區,中榮里,530,795,254,170,424,20,444
公投第１２案,臺南市,安定區,中榮里,531,862,308,171,479,31,510
公投第１２案,臺南市,安定區,港口里,532,1487,445,266,711,30,741
公投第１２案,臺南市,安定區,港口里,533,1385,457,241,698,29,727
公投第１２案,臺南市,安定區,港南里,534,1518,454,273,727,22,749
公投第１２案,臺南市,安定區,港南里,535,1094,397,215,612,35,647
公投第１２案,臺南市,安定區,嘉同里,536,1590,541,290,831,58,889
公投第１２案,臺南市,安定區,嘉同里,537,754,269,145,414,16,430
公投第１２案,臺南市,安定區,中沙里,538,716,228,154,382,29,411
公投第１２案,臺南市,安定區,新吉里,539,1492,485,299,784,32,816
公投第１２案,臺南市,安定區,新吉里,540,943,314,189,503,24,527
公投第１２案,臺南市,安定區,海寮里,541,1157,379,237,616,29,645
公投第１２案,臺南市,安定區,海寮里,542,1384,450,274,724,46,770
公投第１２案,臺南市,安定區,文科里,543,967,281,222,503,31,534
公投第１２案,臺南市,安定區,文科里,544,611,207,137,344,14,358
公投第１２案,臺南市,新市區,新市里,545,960,294,169,463,21,484
公投第１２案,臺南市,新市區,新市里,546,1118,383,250,633,27,660
公投第１２案,臺南市,新市區,新市里,547,850,269,136,405,12,417
公投第１２案,臺南市,新市區,新和里,548,1241,378,254,632,29,661
公投第１２案,臺南市,新市區,新和里,549,1297,418,262,680,26,706
公投第１２案,臺南市,新市區,新和里,550,962,328,191,519,26,545
公投第１２案,臺南市,新市區,新和里,551,1237,425,249,674,27,701
公投第１２案,臺南市,新市區,新和里,552,1326,412,271,683,36,719
公投第１２案,臺南市,新市區,社內里,553,1211,412,251,663,38,701
公投第１２案,臺南市,新市區,社內里,554,1305,404,236,640,30,670
公投第１２案,臺南市,新市區,大洲里,555,688,242,110,352,25,377
公投第１２案,臺南市,新市區,豐華里,556,911,312,176,488,29,517
公投第１２案,臺南市,新市區,三舍里,557,1525,445,261,706,37,743
公投第１２案,臺南市,新市區,大營里,558,1091,315,158,473,8,481
公投第１２案,臺南市,新市區,大營里,559,1122,353,196,549,19,568
公投第１２案,臺南市,新市區,大營里,560,1049,317,189,506,27,533
公投第１２案,臺南市,新市區,大社里,561,1564,453,270,723,20,743
公投第１２案,臺南市,新市區,大社里,562,1515,364,414,778,34,812
公投第１２案,臺南市,新市區,大社里,563,1378,446,256,702,32,734
公投第１２案,臺南市,新市區,潭頂里,564,827,313,166,479,38,517
公投第１２案,臺南市,新市區,潭頂里,565,960,367,197,564,53,617
公投第１２案,臺南市,新市區,港墘里,566,951,306,166,472,29,501
公投第１２案,臺南市,新市區,港墘里,567,1264,312,349,661,35,696
公投第１２案,臺南市,新市區,港墘里,568,1173,381,234,615,25,640
公投第１２案,臺南市,新市區,永就里,569,684,230,152,382,17,399
公投第１２案,臺南市,新市區,永就里,570,1055,403,219,622,31,653
公投第１２案,臺南市,新市區,永就里,571,1122,401,263,664,30,694
公投第１２案,臺南市,山上區,明和里,572,855,207,121,328,38,366
公投第１２案,臺南市,山上區,明和里,573,836,178,130,308,35,343
公投第１２案,臺南市,山上區,南洲里,574,753,206,143,349,33,382
公投第１２案,臺南市,山上區,南洲里,575,788,236,118,354,26,380
公投第１２案,臺南市,山上區,山上里,576,984,286,174,460,37,497
公投第１２案,臺南市,山上區,新莊里,577,972,246,188,434,12,446
公投第１２案,臺南市,山上區,玉峯里,578,553,112,64,176,5,181
公投第１２案,臺南市,山上區,平陽里,579,378,97,56,153,11,164
公投第１２案,臺南市,山上區,豐德里,580,392,109,59,168,20,188
公投第１２案,臺南市,新化區,武安里,581,746,276,154,430,25,455
公投第１２案,臺南市,新化區,武安里,582,1102,395,222,617,37,654
公投第１２案,臺南市,新化區,武安里,583,370,133,71,204,15,219
公投第１２案,臺南市,新化區,武安里,584,947,333,201,534,33,567
公投第１２案,臺南市,新化區,東榮里,585,1154,380,182,562,48,610
公投第１２案,臺南市,新化區,東榮里,586,1082,323,221,544,63,607
公投第１２案,臺南市,新化區,東榮里,587,1075,367,209,576,35,611
公投第１２案,臺南市,新化區,東榮里,588,640,213,110,323,18,341
公投第１２案,臺南市,新化區,護國里,589,410,130,77,207,14,221
公投第１２案,臺南市,新化區,護國里,590,533,175,87,262,20,282
公投第１２案,臺南市,新化區,護國里,591,836,297,175,472,16,488
公投第１２案,臺南市,新化區,護國里,592,978,257,145,402,21,423
公投第１２案,臺南市,新化區,太平里,593,1348,446,291,737,31,768
公投第１２案,臺南市,新化區,太平里,594,1015,300,203,503,35,538
公投第１２案,臺南市,新化區,太平里,595,1228,381,199,580,19,599
公投第１２案,臺南市,新化區,太平里,596,789,244,173,417,38,455
公投第１２案,臺南市,新化區,協興里,597,1022,326,197,523,28,551
公投第１２案,臺南市,新化區,協興里,598,1021,360,156,516,25,541
公投第１２案,臺南市,新化區,協興里,599,1229,423,252,675,37,712
公投第１２案,臺南市,新化區,唪口里,600,1153,354,222,576,27,603
公投第１２案,臺南市,新化區,唪口里,601,1012,271,157,428,26,454
公投第１２案,臺南市,新化區,北勢里,602,1458,481,281,762,48,810
公投第１２案,臺南市,新化區,豐榮里,603,1645,589,290,879,47,926
公投第１２案,臺南市,新化區,豐榮里,604,1016,323,233,556,37,593
公投第１２案,臺南市,新化區,豐榮里,605,559,161,119,280,19,299
公投第１２案,臺南市,新化區,全興里,606,1222,384,262,646,37,683
公投第１２案,臺南市,新化區,全興里,607,1562,537,347,884,38,922
公投第１２案,臺南市,新化區,崙頂里,608,994,243,203,446,32,478
公投第１２案,臺南市,新化區,崙頂里,609,1013,327,173,500,61,561
公投第１２案,臺南市,新化區,知義里,610,1197,403,233,636,46,682
公投第１２案,臺南市,新化區,知義里,611,1021,293,165,458,60,518
公投第１２案,臺南市,新化區,山脚里,612,1428,412,206,618,39,657
公投第１２案,臺南市,新化區,大坑里,613,456,120,71,191,27,218
公投第１２案,臺南市,新化區,𦰡拔里,614,1037,351,200,551,45,596
公投第１２案,臺南市,新化區,𦰡拔里,615,1097,306,266,572,46,618
公投第１２案,臺南市,新化區,羊林里,616,902,297,174,471,32,503
公投第１２案,臺南市,新化區,礁坑里,617,999,273,163,436,79,515
公投第１２案,臺南市,安南區,東和里,618,2549,808,520,1328,26,1354
公投第１２案,臺南市,安南區,󻕯南里,619,2321,783,398,1181,41,1222
公投第１２案,臺南市,安南區,󻕯南里,620,2156,699,460,1159,35,1194
公投第１２案,臺南市,安南區,州南里,621,1662,593,334,927,48,975
公投第１２案,臺南市,安南區,州南里,622,1512,582,258,840,59,899
公投第１２案,臺南市,安南區,州南里,623,1625,488,297,785,41,826
公投第１２案,臺南市,安南區,安順里,624,2143,634,370,1004,31,1035
公投第１２案,臺南市,安南區,安順里,625,2457,847,472,1319,81,1400
公投第１２案,臺南市,安南區,州北里,626,2148,690,448,1138,68,1206
公投第１２案,臺南市,安南區,州北里,627,2364,732,434,1166,64,1230
公投第１２案,臺南市,安南區,新順里,628,1868,536,347,883,37,920
公投第１２案,臺南市,安南區,新順里,629,1797,613,389,1002,49,1051
公投第１２案,臺南市,安南區,新順里,630,2268,768,411,1179,51,1230
公投第１２案,臺南市,安南區,頂安里,631,2291,666,355,1021,45,1066
公投第１２案,臺南市,安南區,頂安里,632,2255,694,425,1119,37,1156
公投第１２案,臺南市,安南區,安慶里,633,1940,582,327,909,41,950
公投第１２案,臺南市,安南區,安慶里,634,2013,675,421,1096,33,1129
公投第１２案,臺南市,安南區,安慶里,635,2024,620,367,987,47,1034
公投第１２案,臺南市,安南區,溪北里,636,1613,556,367,923,66,989
公投第１２案,臺南市,安南區,溪北里,637,1178,372,226,598,28,626
公投第１２案,臺南市,安南區,安和里,638,2143,675,416,1091,60,1151
公投第１２案,臺南市,安南區,安西里,639,1721,536,382,918,49,967
公投第１２案,臺南市,安南區,安西里,640,1773,607,362,969,42,1011
公投第１２案,臺南市,安南區,溪頂里,641,1428,489,281,770,13,783
公投第１２案,臺南市,安南區,溪頂里,642,1626,514,352,866,25,891
公投第１２案,臺南市,安南區,溪頂里,643,1358,418,281,699,36,735
公投第１２案,臺南市,安南區,安東里,644,1447,525,299,824,30,854
公投第１２案,臺南市,安南區,安東里,645,1358,449,267,716,58,774
公投第１２案,臺南市,安南區,鳳凰里,646,2116,669,363,1032,32,1064
公投第１２案,臺南市,安南區,鳳凰里,647,2321,733,371,1104,35,1139
公投第１２案,臺南市,安南區,梅花里,648,2117,698,363,1061,26,1087
公投第１２案,臺南市,安南區,梅花里,649,1927,571,350,921,42,963
公投第１２案,臺南市,安南區,理想里,650,2242,654,421,1075,70,1145
公投第１２案,臺南市,安南區,理想里,651,2334,718,387,1105,50,1155
公投第１２案,臺南市,安南區,大安里,652,1822,605,357,962,31,993
公投第１２案,臺南市,安南區,大安里,653,1813,598,380,978,56,1034
公投第１２案,臺南市,安南區,原佃里,654,2188,678,424,1102,69,1171
公投第１２案,臺南市,安南區,長安里,655,2399,728,394,1122,54,1176
公投第１２案,臺南市,安南區,長安里,656,2247,610,402,1012,57,1069
公投第１２案,臺南市,安南區,公親里,657,1165,398,285,683,42,725
公投第１２案,臺南市,安南區,布袋里,658,1539,484,266,750,35,785
公投第１２案,臺南市,安南區,總頭里,659,1835,592,370,962,76,1038
公投第１２案,臺南市,安南區,南興里,660,1797,548,372,920,61,981
公投第１２案,臺南市,安南區,學東里,661,2223,571,463,1034,63,1097
公投第１２案,臺南市,安南區,公󻕯里,662,977,354,225,579,45,624
公投第１２案,臺南市,安南區,佃東里,663,1642,466,293,759,19,778
公投第１２案,臺南市,安南區,佃東里,664,1697,551,341,892,47,939
公投第１２案,臺南市,安南區,佃西里,665,1966,573,349,922,48,970
公投第１２案,臺南市,安南區,淵西里,666,1319,401,255,656,47,703
公投第１２案,臺南市,安南區,淵西里,667,1909,536,358,894,41,935
公投第１２案,臺南市,安南區,海西里,668,1763,564,340,904,43,947
公投第１２案,臺南市,安南區,海西里,669,965,290,195,485,35,520
公投第１２案,臺南市,安南區,海東里,670,1547,397,264,661,56,717
公投第１２案,臺南市,安南區,海東里,671,1784,552,308,860,49,909
公投第１２案,臺南市,安南區,海東里,672,2145,622,345,967,56,1023
公投第１２案,臺南市,安南區,溪心里,673,2443,697,575,1272,38,1310
公投第１２案,臺南市,安南區,溪心里,674,2565,696,398,1094,42,1136
公投第１２案,臺南市,安南區,溪心里,675,2480,763,465,1228,64,1292
公投第１２案,臺南市,安南區,淵東里,676,2349,595,394,989,69,1058
公投第１２案,臺南市,安南區,淵東里,677,2168,690,425,1115,49,1164
公投第１２案,臺南市,安南區,淵中里,678,1630,531,282,813,40,853
公投第１２案,臺南市,安南區,淵中里,679,1675,487,275,762,43,805
公投第１２案,臺南市,安南區,溪墘里,680,1627,608,356,964,55,1019
公投第１２案,臺南市,安南區,溪墘里,681,1493,516,261,777,46,823
公投第１２案,臺南市,安南區,海佃里,682,1397,504,244,748,42,790
公投第１２案,臺南市,安南區,海佃里,683,1416,465,255,720,36,756
公投第１２案,臺南市,安南區,海佃里,684,1460,433,309,742,27,769
公投第１２案,臺南市,安南區,國安里,685,2222,640,340,980,36,1016
公投第１２案,臺南市,安南區,溪東里,686,2070,643,398,1041,57,1098
公投第１２案,臺南市,安南區,溪東里,687,1739,569,371,940,27,967
公投第１２案,臺南市,安南區,安富里,688,1830,555,326,881,59,940
公投第１２案,臺南市,安南區,安富里,689,1803,653,347,1000,58,1058
公投第１２案,臺南市,安南區,安富里,690,1800,604,383,987,32,1019
公投第１２案,臺南市,安南區,幸福里,691,1815,496,318,814,37,851
公投第１２案,臺南市,安南區,幸福里,692,1846,544,325,869,46,915
公投第１２案,臺南市,安南區,海南里,693,905,313,209,522,35,557
公投第１２案,臺南市,安南區,海南里,694,1073,359,255,614,55,669
公投第１２案,臺南市,安南區,城東里,695,1579,486,361,847,69,916
公投第１２案,臺南市,安南區,城南里,696,1876,532,375,907,71,978
公投第１２案,臺南市,安南區,城南里,697,1194,345,241,586,39,625
公投第１２案,臺南市,安南區,青草里,698,1475,380,217,597,31,628
公投第１２案,臺南市,安南區,城西里,699,1380,443,229,672,35,707
公投第１２案,臺南市,安南區,城北里,700,1462,405,301,706,37,743
公投第１２案,臺南市,安南區,城中里,701,1044,385,203,588,28,616
公投第１２案,臺南市,安南區,砂崙里,702,603,224,124,348,47,395
公投第１２案,臺南市,安南區,砂崙里,703,690,232,152,384,15,399
公投第１２案,臺南市,安南區,顯宮里,704,1447,403,280,683,40,723
公投第１２案,臺南市,安南區,鹿耳里,705,910,358,209,567,32,599
公投第１２案,臺南市,安南區,四草里,706,1850,516,339,855,51,906
公投第１２案,臺南市,安南區,塩田里,707,1501,519,334,853,36,889
公投第１２案,臺南市,永康區,五王里,708,1398,444,276,720,39,759
公投第１２案,臺南市,永康區,五王里,709,1478,409,235,644,42,686
公投第１２案,臺南市,永康區,五王里,710,1442,428,275,703,15,718
公投第１２案,臺南市,永康區,五王里,711,1353,407,235,642,27,669
公投第１２案,臺南市,永康區,三合里,712,1160,395,214,609,14,623
公投第１２案,臺南市,永康區,三合里,713,1122,374,240,614,16,630
公投第１２案,臺南市,永康區,三合里,714,1165,368,215,583,10,593
公投第１２案,臺南市,永康區,六合里,715,1317,412,237,649,11,660
公投第１２案,臺南市,永康區,六合里,716,1376,441,247,688,22,710
公投第１２案,臺南市,永康區,六合里,717,1361,419,273,692,37,729
公投第１２案,臺南市,永康區,六合里,718,1374,469,320,789,18,807
公投第１２案,臺南市,永康區,網寮里,719,1709,485,313,798,37,835
公投第１２案,臺南市,永康區,網寮里,720,1717,518,282,800,34,834
公投第１２案,臺南市,永康區,網寮里,721,1759,519,308,827,24,851
公投第１２案,臺南市,永康區,網寮里,722,1636,514,324,838,22,860
公投第１２案,臺南市,永康區,二王里,723,1442,471,253,724,33,757
公投第１２案,臺南市,永康區,二王里,724,1545,466,290,756,22,778
公投第１２案,臺南市,永康區,二王里,725,1565,522,254,776,26,802
公投第１２案,臺南市,永康區,二王里,726,1684,485,311,796,25,821
公投第１２案,臺南市,永康區,二王里,727,1548,479,275,754,19,773
公投第１２案,臺南市,永康區,永康里,728,1389,470,281,751,24,775
公投第１２案,臺南市,永康區,永康里,729,1369,447,257,704,31,735
公投第１２案,臺南市,永康區,永康里,730,1415,479,250,729,49,778
公投第１２案,臺南市,永康區,永康里,731,1386,395,236,631,11,642
公投第１２案,臺南市,永康區,永康里,732,1747,275,153,428,9,437
公投第１２案,臺南市,永康區,永康里,733,1485,455,289,744,27,771
公投第１２案,臺南市,永康區,埔園里,734,1747,563,297,860,33,893
公投第１２案,臺南市,永康區,埔園里,735,1744,475,304,779,29,808
公投第１２案,臺南市,永康區,埔園里,736,1797,554,280,834,43,877
公投第１２案,臺南市,永康區,埔園里,737,1800,617,313,930,44,974
公投第１２案,臺南市,永康區,龍埔里,738,1720,549,273,822,21,843
公投第１２案,臺南市,永康區,龍埔里,739,1708,552,345,897,24,921
公投第１２案,臺南市,永康區,正強里,740,1519,548,318,866,12,878
公投第１２案,臺南市,永康區,正強里,741,1497,522,285,807,40,847
公投第１２案,臺南市,永康區,正強里,742,1509,507,306,813,22,835
公投第１２案,臺南市,永康區,正強里,743,1542,586,299,885,32,917
公投第１２案,臺南市,永康區,正強里,744,1536,500,325,825,19,844
公投第１２案,臺南市,永康區,大橋里,745,1531,491,303,794,29,823
公投第１２案,臺南市,永康區,大橋里,746,1327,452,287,739,28,767
公投第１２案,臺南市,永康區,大橋里,747,1456,450,314,764,11,775
公投第１２案,臺南市,永康區,大橋里,748,1396,440,329,769,20,789
公投第１２案,臺南市,永康區,東橋里,749,1636,513,296,809,40,849
公投第１２案,臺南市,永康區,東橋里,750,1592,510,322,832,31,863
公投第１２案,臺南市,永康區,東橋里,751,2017,532,411,943,18,961
公投第１２案,臺南市,永康區,東橋里,752,672,229,131,360,13,373
公投第１２案,臺南市,永康區,西橋里,753,1611,480,296,776,15,791
公投第１２案,臺南市,永康區,西橋里,754,1502,465,303,768,31,799
公投第１２案,臺南市,永康區,安康里,755,1660,431,301,732,19,751
公投第１２案,臺南市,永康區,安康里,756,1561,406,278,684,12,696
公投第１２案,臺南市,永康區,安康里,757,1590,465,317,782,25,807
公投第１２案,臺南市,永康區,蔦松里,758,924,205,275,480,14,494
公投第１２案,臺南市,永康區,蔦松里,759,938,339,194,533,16,549
公投第１２案,臺南市,永康區,三民里,760,957,331,188,519,29,548
公投第１２案,臺南市,永康區,三民里,761,496,135,113,248,30,278
公投第１２案,臺南市,永康區,塩行里,762,1717,536,336,872,39,911
公投第１２案,臺南市,永康區,塩行里,763,1615,479,281,760,26,786
公投第１２案,臺南市,永康區,塩行里,764,1554,500,275,775,17,792
公投第１２案,臺南市,永康區,塩興里,765,1196,366,238,604,14,618
公投第１２案,臺南市,永康區,塩興里,766,1274,389,256,645,20,665
公投第１２案,臺南市,永康區,塩興里,767,1215,394,248,642,16,658
公投第１２案,臺南市,永康區,塩洲里,768,1457,452,310,762,12,774
公投第１２案,臺南市,永康區,塩洲里,769,1451,502,280,782,13,795
公投第１２案,臺南市,永康區,塩洲里,770,1423,417,246,663,28,691
公投第１２案,臺南市,永康區,塩洲里,771,1394,464,277,741,31,772
公投第１２案,臺南市,永康區,甲頂里,772,890,291,195,486,30,516
公投第１２案,臺南市,永康區,甲頂里,773,1018,391,194,585,32,617
公投第１２案,臺南市,永康區,甲頂里,774,368,120,79,199,16,215
公投第１２案,臺南市,永康區,尚頂里,775,1208,411,289,700,31,731
公投第１２案,臺南市,永康區,尚頂里,776,1187,333,238,571,20,591
公投第１２案,臺南市,永康區,尚頂里,777,1381,436,252,688,13,701
公投第１２案,臺南市,永康區,龍潭里,778,1405,424,279,703,40,743
公投第１２案,臺南市,永康區,龍潭里,779,1445,395,291,686,44,730
公投第１２案,臺南市,永康區,龍潭里,780,1687,485,330,815,36,851
公投第１２案,臺南市,永康區,龍潭里,781,1535,425,290,715,14,729
公投第１２案,臺南市,永康區,永明里,782,1542,482,324,806,31,837
公投第１２案,臺南市,永康區,永明里,783,1618,503,301,804,23,827
公投第１２案,臺南市,永康區,永明里,784,1338,459,273,732,17,749
公投第１２案,臺南市,永康區,王行里,785,1285,423,291,714,30,744
公投第１２案,臺南市,永康區,王行里,786,1240,381,260,641,21,662
公投第１２案,臺南市,永康區,烏竹里,787,1343,391,250,641,36,677
公投第１２案,臺南市,永康區,烏竹里,788,1327,451,293,744,22,766
公投第１２案,臺南市,永康區,西勢里,789,1565,491,302,793,24,817
公投第１２案,臺南市,永康區,西勢里,790,1476,459,315,774,52,826
公投第１２案,臺南市,永康區,西勢里,791,1476,454,300,754,30,784
公投第１２案,臺南市,永康區,西勢里,792,1463,498,323,821,28,849
公投第１２案,臺南市,永康區,新樹里,793,983,320,223,543,32,575
公投第１２案,臺南市,永康區,新樹里,794,1116,378,245,623,34,657
公投第１２案,臺南市,永康區,大灣里,795,1117,360,195,555,39,594
公投第１２案,臺南市,永康區,大灣里,796,1069,317,194,511,24,535
公投第１２案,臺南市,永康區,大灣里,797,1180,400,277,677,23,700
公投第１２案,臺南市,永康區,東灣里,798,1176,377,227,604,49,653
公投第１２案,臺南市,永康區,東灣里,799,1158,337,245,582,28,610
公投第１２案,臺南市,永康區,東灣里,800,1208,417,255,672,39,711
公投第１２案,臺南市,永康區,西灣里,801,1501,465,298,763,47,810
公投第１２案,臺南市,永康區,西灣里,802,1298,448,277,725,20,745
公投第１２案,臺南市,永康區,西灣里,803,1542,269,530,799,19,818
公投第１２案,臺南市,永康區,西灣里,804,1537,515,325,840,21,861
公投第１２案,臺南市,永康區,西灣里,805,1359,471,319,790,37,827
公投第１２案,臺南市,永康區,南灣里,806,1139,321,214,535,24,559
公投第１２案,臺南市,永康區,南灣里,807,1158,345,212,557,23,580
公投第１２案,臺南市,永康區,南灣里,808,1538,439,310,749,37,786
公投第１２案,臺南市,永康區,崑山里,809,1166,365,221,586,13,599
公投第１２案,臺南市,永康區,崑山里,810,1228,401,240,641,17,658
公投第１２案,臺南市,永康區,崑山里,811,1200,409,245,654,30,684
公投第１２案,臺南市,永康區,崑山里,812,1131,300,300,600,42,642
公投第１２案,臺南市,永康區,崑山里,813,1147,385,226,611,18,629
公投第１２案,臺南市,永康區,北灣里,814,1442,421,277,698,38,736
公投第１２案,臺南市,永康區,北灣里,815,1325,506,250,756,24,780
公投第１２案,臺南市,永康區,北灣里,816,1260,361,213,574,25,599
公投第１２案,臺南市,永康區,北興里,817,1631,494,284,778,21,799
公投第１２案,臺南市,永康區,北興里,818,1549,443,299,742,26,768
公投第１２案,臺南市,永康區,北興里,819,1666,503,324,827,20,847
公投第１２案,臺南市,永康區,復興里,820,1012,303,161,464,34,498
公投第１２案,臺南市,永康區,復興里,821,976,307,146,453,13,466
公投第１２案,臺南市,永康區,光復里,822,531,187,96,283,13,296
公投第１２案,臺南市,永康區,建國里,823,859,317,156,473,26,499
公投第１２案,臺南市,永康區,建國里,824,937,273,179,452,18,470
公投第１２案,臺南市,永康區,復國里,825,1307,446,235,681,25,706
公投第１２案,臺南市,永康區,復國里,826,1482,470,239,709,12,721
公投第１２案,臺南市,永康區,復國里,827,1341,383,232,615,16,631
公投第１２案,臺南市,永康區,復國里,828,1376,390,284,674,29,703
公投第１２案,臺南市,永康區,復國里,829,1390,425,242,667,23,690
公投第１２案,臺南市,永康區,復國里,830,1534,486,321,807,28,835
公投第１２案,臺南市,永康區,復華里,831,1460,536,256,792,17,809
公投第１２案,臺南市,永康區,復華里,832,1383,433,266,699,10,709
公投第１２案,臺南市,永康區,復華里,833,1299,429,259,688,20,708
公投第１２案,臺南市,永康區,復華里,834,1264,437,260,697,6,703
公投第１２案,臺南市,永康區,復華里,835,1355,452,299,751,21,772
公投第１２案,臺南市,永康區,復華里,836,1414,461,230,691,27,718
公投第１２案,臺南市,永康區,復華里,837,1109,367,249,616,13,629
公投第１２案,臺南市,永康區,神洲里,838,1151,373,199,572,18,590
公投第１２案,臺南市,永康區,成功里,839,1026,428,212,640,23,663
公投第１２案,臺南市,永康區,成功里,840,1071,396,168,564,18,582
公投第１２案,臺南市,永康區,中華里,841,1387,540,299,839,40,879
公投第１２案,臺南市,永康區,中華里,842,1377,480,300,780,36,816
公投第１２案,臺南市,永康區,中興里,843,1687,534,347,881,35,916
公投第１２案,臺南市,永康區,中興里,844,1700,529,298,827,22,849
公投第１２案,臺南市,永康區,勝利里,845,1444,487,300,787,20,807
公投第１２案,臺南市,永康區,勝利里,846,1485,477,272,749,17,766
公投第１２案,臺南市,永康區,勝利里,847,1717,521,283,804,29,833
公投第１２案,臺南市,永康區,勝利里,848,1701,475,297,772,27,799
公投第１２案,臺南市,永康區,勝利里,849,1382,445,245,690,19,709
公投第１２案,臺南市,北區,開元里,850,1793,534,325,859,54,913
公投第１２案,臺南市,北區,開元里,851,1708,525,293,818,44,862
公投第１２案,臺南市,北區,元寶里,852,997,282,225,507,7,514
公投第１２案,臺南市,北區,元寶里,853,1452,361,278,639,15,654
公投第１２案,臺南市,北區,元寶里,854,1351,390,278,668,24,692
公投第１２案,臺南市,北區,合興里,855,1323,510,291,801,33,834
公投第１２案,臺南市,北區,合興里,856,1073,394,212,606,25,631
公投第１２案,臺南市,北區,合興里,857,1138,432,213,645,31,676
公投第１２案,臺南市,北區,力行里,858,1189,413,201,614,30,644
公投第１２案,臺南市,北區,力行里,859,1262,471,276,747,30,777
公投第１２案,臺南市,北區,重興里,860,1017,383,209,592,20,612
公投第１２案,臺南市,北區,重興里,861,847,285,172,457,18,475
公投第１２案,臺南市,北區,東興里,862,1076,400,192,592,33,625
公投第１２案,臺南市,北區,東興里,863,954,358,195,553,17,570
公投第１２案,臺南市,北區,長勝里,864,1300,415,230,645,53,698
公投第１２案,臺南市,北區,長勝里,865,1390,479,236,715,22,737
公投第１２案,臺南市,北區,長勝里,866,1318,477,236,713,28,741
公投第１２案,臺南市,北區,振興里,867,974,337,175,512,14,526
公投第１２案,臺南市,北區,振興里,868,990,336,192,528,20,548
公投第１２案,臺南市,北區,仁愛里,869,1016,353,253,606,24,630
公投第１２案,臺南市,北區,仁愛里,870,1053,351,205,556,35,591
公投第１２案,臺南市,北區,中樓里,871,1466,456,251,707,62,769
公投第１２案,臺南市,北區,永祥里,872,1535,534,286,820,36,856
公投第１２案,臺南市,北區,永祥里,873,1544,506,255,761,50,811
公投第１２案,臺南市,北區,北門里,874,1760,607,338,945,47,992
公投第１２案,臺南市,北區,北門里,875,1372,452,260,712,29,741
公投第１２案,臺南市,北區,北門里,876,1002,360,201,561,25,586
公投第１２案,臺南市,北區,北門里,877,1171,424,234,658,27,685
公投第１２案,臺南市,北區,大光里,878,1285,376,236,612,27,639
公投第１２案,臺南市,北區,大光里,879,1036,367,152,519,27,546
公投第１２案,臺南市,北區,大光里,880,1392,451,259,710,43,753
公投第１２案,臺南市,北區,大光里,881,1147,417,199,616,26,642
公投第１２案,臺南市,北區,大興里,882,1526,463,237,700,19,719
公投第１２案,臺南市,北區,大興里,883,1559,530,296,826,28,854
公投第１２案,臺南市,北區,公園里,884,892,295,172,467,48,515
公投第１２案,臺南市,北區,公園里,885,937,270,197,467,20,487
公投第１２案,臺南市,北區,北華里,886,1449,491,294,785,49,834
公投第１２案,臺南市,北區,北華里,887,1160,394,207,601,26,627
公投第１２案,臺南市,北區,北華里,888,1567,340,229,569,34,603
公投第１２案,臺南市,北區,長興里,889,1346,443,249,692,34,726
公投第１２案,臺南市,北區,長興里,890,1451,431,261,692,20,712
公投第１２案,臺南市,北區,小北里,891,1522,481,304,785,25,810
公投第１２案,臺南市,北區,小北里,892,1278,415,239,654,27,681
公投第１２案,臺南市,北區,小北里,893,1164,343,230,573,40,613
公投第１２案,臺南市,北區,正覺里,894,1091,354,201,555,10,565
公投第１２案,臺南市,北區,正覺里,895,993,334,181,515,21,536
公投第１２案,臺南市,北區,正覺里,896,1119,349,172,521,22,543
公投第１２案,臺南市,北區,成功里,897,1685,556,330,886,43,929
公投第１２案,臺南市,北區,成功里,898,1368,482,252,734,12,746
公投第１２案,臺南市,北區,成功里,899,1389,458,262,720,36,756
公投第１２案,臺南市,北區,華德里,900,1469,529,304,833,21,854
公投第１２案,臺南市,北區,華德里,901,1655,542,371,913,42,955
公投第１２案,臺南市,北區,福德里,902,1261,422,277,699,20,719
公投第１２案,臺南市,北區,福德里,903,1490,492,286,778,19,797
公投第１２案,臺南市,北區,福德里,904,1436,506,303,809,23,832
公投第１２案,臺南市,北區,成德里,905,1340,491,259,750,44,794
公投第１２案,臺南市,北區,成德里,906,1464,481,294,775,33,808
公投第１２案,臺南市,北區,成德里,907,1513,495,356,851,25,876
公投第１２案,臺南市,北區,和順里,908,1709,559,388,947,26,973
公投第１２案,臺南市,北區,和順里,909,1517,526,352,878,31,909
公投第１２案,臺南市,北區,和順里,910,1598,494,331,825,18,843
公投第１２案,臺南市,北區,立人里,911,1399,414,296,710,35,745
公投第１２案,臺南市,北區,立人里,912,1214,412,222,634,34,668
公投第１２案,臺南市,北區,雙安里,913,1064,340,247,587,18,605
公投第１２案,臺南市,北區,雙安里,914,1148,394,277,671,34,705
公投第１２案,臺南市,北區,文成里,915,1391,461,312,773,25,798
公投第１２案,臺南市,北區,文成里,916,1584,546,322,868,36,904
公投第１２案,臺南市,北區,元美里,917,1595,543,325,868,23,891
公投第１２案,臺南市,北區,元美里,918,1397,495,247,742,19,761
公投第１２案,臺南市,北區,文元里,919,1662,539,321,860,34,894
公投第１２案,臺南市,北區,文元里,920,1634,487,336,823,26,849
公投第１２案,臺南市,北區,大和里,921,1793,645,344,989,30,1019
公投第１２案,臺南市,北區,大和里,922,1872,624,382,1006,43,1049
公投第１２案,臺南市,北區,大港里,923,1874,613,356,969,49,1018
公投第１２案,臺南市,北區,大港里,924,1760,588,280,868,49,917
公投第１２案,臺南市,北區,大港里,925,1753,535,323,858,48,906
公投第１２案,臺南市,北區,大豐里,926,1502,410,265,675,25,700
公投第１２案,臺南市,北區,大豐里,927,1470,512,266,778,20,798
公投第１２案,臺南市,北區,大豐里,928,1319,422,253,675,33,708
公投第１２案,臺南市,北區,賢北里,929,1876,628,394,1022,33,1055
公投第１２案,臺南市,北區,賢北里,930,1720,574,320,894,17,911
公投第１２案,臺南市,中西區,赤嵌里,931,1332,414,289,703,37,740
公投第１２案,臺南市,中西區,赤嵌里,932,1246,424,264,688,40,728
公投第１２案,臺南市,中西區,赤嵌里,933,1276,420,217,637,39,676
公投第１２案,臺南市,中西區,郡王里,934,1583,516,355,871,33,904
公投第１２案,臺南市,中西區,郡王里,935,1464,489,324,813,26,839
公投第１２案,臺南市,中西區,法華里,936,1234,380,260,640,15,655
公投第１２案,臺南市,中西區,法華里,937,1368,472,292,764,26,790
公投第１２案,臺南市,中西區,開山里,938,1322,407,231,638,31,669
公投第１２案,臺南市,中西區,開山里,939,1216,363,241,604,41,645
公投第１２案,臺南市,中西區,永華里,940,1289,433,242,675,35,710
公投第１２案,臺南市,中西區,永華里,941,1237,460,221,681,26,707
公投第１２案,臺南市,中西區,藥王里,942,1189,334,231,565,27,592
公投第１２案,臺南市,中西區,藥王里,943,1201,382,249,631,56,687
公投第１２案,臺南市,中西區,藥王里,944,1065,373,225,598,40,638
公投第１２案,臺南市,中西區,光賢里,945,1055,400,199,599,23,622
公投第１２案,臺南市,中西區,光賢里,946,1170,398,297,695,23,718
公投第１２案,臺南市,中西區,光賢里,947,1280,489,288,777,22,799
公投第１２案,臺南市,中西區,大涼里,948,1223,410,255,665,31,696
公投第１２案,臺南市,中西區,大涼里,949,1292,565,140,705,40,745
公投第１２案,臺南市,中西區,西湖里,950,993,348,231,579,10,589
公投第１２案,臺南市,中西區,西湖里,951,1541,474,348,822,40,862
公投第１２案,臺南市,中西區,西湖里,952,1652,598,353,951,45,996
公投第１２案,臺南市,中西區,西湖里,953,1212,420,251,671,19,690
公投第１２案,臺南市,中西區,西賢里,954,1621,548,328,876,51,927
公投第１２案,臺南市,中西區,西賢里,955,1660,532,388,920,25,945
公投第１２案,臺南市,中西區,西賢里,956,1595,497,334,831,38,869
公投第１２案,臺南市,中西區,城隍里,957,1436,460,281,741,29,770
公投第１２案,臺南市,中西區,城隍里,958,1265,444,247,691,37,728
公投第１２案,臺南市,中西區,城隍里,959,856,345,167,512,18,530
公投第１２案,臺南市,中西區,南美里,960,1168,371,225,596,30,626
公投第１２案,臺南市,中西區,南美里,961,1134,381,257,638,32,670
公投第１２案,臺南市,中西區,南美里,962,995,393,203,596,31,627
公投第１２案,臺南市,中西區,南門里,963,1313,514,276,790,26,816
公投第１２案,臺南市,中西區,南門里,964,1265,431,285,716,42,758
公投第１２案,臺南市,中西區,小西門里,965,1215,375,253,628,23,651
公投第１２案,臺南市,中西區,小西門里,966,1248,400,257,657,33,690
公投第１２案,臺南市,中西區,小西門里,967,687,192,170,362,19,381
公投第１２案,臺南市,中西區,五條港里,968,1139,373,219,592,49,641
公投第１２案,臺南市,中西區,五條港里,969,971,324,212,536,31,567
公投第１２案,臺南市,中西區,兌悅里,970,1254,333,187,520,33,553
公投第１２案,臺南市,中西區,兌悅里,971,979,351,197,548,32,580
公投第１２案,臺南市,中西區,兌悅里,972,1745,515,351,866,43,909
公投第１２案,臺南市,中西區,淺草里,973,1074,356,210,566,26,592
公投第１２案,臺南市,中西區,淺草里,974,1436,445,251,696,32,728
公投第１２案,臺南市,中西區,府前里,975,865,276,191,467,34,501
公投第１２案,臺南市,中西區,府前里,976,1164,392,214,606,32,638
公投第１２案,臺南市,中西區,南廠里,977,1285,395,233,628,30,658
公投第１２案,臺南市,中西區,南廠里,978,1078,366,194,560,33,593
公投第１２案,臺南市,中西區,南廠里,979,1704,493,275,768,41,809
公投第１２案,臺南市,中西區,西和里,980,1296,467,243,710,49,759
公投第１２案,臺南市,中西區,西和里,981,1128,363,237,600,35,635
公投第１２案,臺南市,中西區,西和里,982,1245,414,250,664,24,688
公投第１２案,臺南市,安平區,文平里,983,1753,570,354,924,46,970
公投第１２案,臺南市,安平區,文平里,984,1859,582,354,936,26,962
公投第１２案,臺南市,安平區,文平里,985,1382,491,290,781,30,811
公投第１２案,臺南市,安平區,建平里,986,2547,804,436,1240,35,1275
公投第１２案,臺南市,安平區,建平里,987,2407,759,468,1227,33,1260
公投第１２案,臺南市,安平區,怡平里,988,2070,560,387,947,26,973
公投第１２案,臺南市,安平區,怡平里,989,2132,668,450,1118,23,1141
公投第１２案,臺南市,安平區,華平里,990,1450,509,289,798,9,807
公投第１２案,臺南市,安平區,華平里,991,1605,488,312,800,20,820
公投第１２案,臺南市,安平區,華平里,992,1755,550,343,893,54,947
公投第１２案,臺南市,安平區,平通里,993,1728,499,295,794,23,817
公投第１２案,臺南市,安平區,平通里,994,1754,434,309,743,17,760
公投第１２案,臺南市,安平區,平通里,995,1686,504,330,834,38,872
公投第１２案,臺南市,安平區,平通里,996,1843,611,361,972,27,999
公投第１２案,臺南市,安平區,億載里,997,1565,520,348,868,21,889
公投第１２案,臺南市,安平區,億載里,998,1288,450,246,696,18,714
公投第１２案,臺南市,安平區,育平里,999,1653,480,327,807,13,820
公投第１２案,臺南市,安平區,育平里,1000,1697,537,296,833,7,840
公投第１２案,臺南市,安平區,育平里,1001,2154,611,384,995,22,1017
公投第１２案,臺南市,安平區,育平里,1002,2107,655,345,1000,32,1032
公投第１２案,臺南市,安平區,國平里,1003,1675,563,337,900,31,931
公投第１２案,臺南市,安平區,國平里,1004,1979,566,423,989,39,1028
公投第１２案,臺南市,安平區,國平里,1005,1602,479,300,779,20,799
公投第１２案,臺南市,安平區,國平里,1006,1586,477,304,781,25,806
公投第１２案,臺南市,安平區,漁光里,1007,438,131,71,202,9,211
公投第１２案,臺南市,安平區,平安里,1008,1780,525,347,872,28,900
公投第１２案,臺南市,安平區,平安里,1009,1623,452,330,782,37,819
公投第１２案,臺南市,安平區,天妃里,1010,2157,664,349,1013,56,1069
公投第１２案,臺南市,安平區,天妃里,1011,1286,418,228,646,32,678
公投第１２案,臺南市,安平區,王城里,1012,1492,470,281,751,38,789
公投第１２案,臺南市,安平區,王城里,1013,1325,399,223,622,14,636
公投第１２案,臺南市,安平區,金城里,1014,2001,630,305,935,57,992
公投第１２案,臺南市,南區,大恩里,1015,1221,415,264,679,30,709
公投第１２案,臺南市,南區,大恩里,1016,2171,632,337,969,44,1013
公投第１２案,臺南市,南區,大林里,1017,1150,413,235,648,21,669
公投第１２案,臺南市,南區,大林里,1018,1122,444,201,645,19,664
公投第１２案,臺南市,南區,大忠里,1019,1444,435,264,699,30,729
公投第１２案,臺南市,南區,大忠里,1020,1765,544,313,857,28,885
公投第１２案,臺南市,南區,大忠里,1021,1298,471,271,742,25,767
公投第１２案,臺南市,南區,新生里,1022,1458,528,259,787,21,808
公投第１２案,臺南市,南區,新生里,1023,1940,632,331,963,19,982
公投第１２案,臺南市,南區,竹溪里,1024,1637,519,314,833,38,871
公投第１２案,臺南市,南區,明德里,1025,871,237,161,398,10,408
公投第１２案,臺南市,南區,大成里,1026,589,179,151,330,9,339
公投第１２案,臺南市,南區,大成里,1027,801,290,200,490,43,533
公投第１２案,臺南市,南區,田寮里,1028,990,371,173,544,32,576
公投第１２案,臺南市,南區,田寮里,1029,1222,477,242,719,24,743
公投第１２案,臺南市,南區,田寮里,1030,997,364,187,551,48,599
公投第１２案,臺南市,南區,新興里,1031,1204,367,233,600,26,626
公投第１２案,臺南市,南區,新興里,1032,1570,451,280,731,27,758
公投第１２案,臺南市,南區,再興里,1033,1222,387,266,653,26,679
公投第１２案,臺南市,南區,再興里,1034,1076,314,210,524,20,544
公投第１２案,臺南市,南區,廣州里,1035,1127,389,245,634,13,647
公投第１２案,臺南市,南區,廣州里,1036,1135,397,217,614,34,648
公投第１２案,臺南市,南區,新昌里,1037,1263,423,216,639,33,672
公投第１２案,臺南市,南區,新昌里,1038,1014,321,186,507,25,532
公投第１２案,臺南市,南區,文華里,1039,1491,520,285,805,37,842
公投第１２案,臺南市,南區,文華里,1040,1815,579,364,943,33,976
公投第１２案,臺南市,南區,文南里,1041,1398,432,287,719,18,737
公投第１２案,臺南市,南區,文南里,1042,2107,549,344,893,27,920
公投第１２案,臺南市,南區,文南里,1043,1587,621,295,916,32,948
公投第１２案,臺南市,南區,金華里,1044,1626,643,293,936,43,979
公投第１２案,臺南市,南區,金華里,1045,1761,514,337,851,32,883
公投第１２案,臺南市,南區,金華里,1046,1630,537,298,835,41,876
公投第１２案,臺南市,南區,國宅里,1047,1542,494,297,791,41,832
公投第１２案,臺南市,南區,國宅里,1048,1464,453,283,736,49,785
公投第１２案,臺南市,南區,鹽埕里,1049,1727,562,302,864,53,917
公投第１２案,臺南市,南區,鹽埕里,1050,1085,405,223,628,37,665
公投第１２案,臺南市,南區,鹽埕里,1051,939,314,181,495,15,510
公投第１２案,臺南市,南區,光明里,1052,1419,399,242,641,38,679
公投第１２案,臺南市,南區,光明里,1053,1333,399,244,643,30,673
公投第１２案,臺南市,南區,光明里,1054,1465,446,266,712,32,744
公投第１２案,臺南市,南區,明亮里,1055,1099,396,203,599,16,615
公投第１２案,臺南市,南區,明亮里,1056,1133,366,201,567,11,578
公投第１２案,臺南市,南區,明亮里,1057,1375,450,234,684,30,714
公投第１２案,臺南市,南區,府南里,1058,1781,473,338,811,24,835
公投第１２案,臺南市,南區,府南里,1059,1542,529,318,847,29,876
公投第１２案,臺南市,南區,府南里,1060,1486,469,247,716,25,741
公投第１２案,臺南市,南區,明興里,1061,1640,574,287,861,52,913
公投第１２案,臺南市,南區,明興里,1062,1701,475,271,746,26,772
公投第１２案,臺南市,南區,郡南里,1063,1541,487,241,728,38,766
公投第１２案,臺南市,南區,郡南里,1064,2027,661,312,973,55,1028
公投第１２案,臺南市,南區,建南里,1065,1774,624,369,993,49,1042
公投第１２案,臺南市,南區,建南里,1066,1613,487,332,819,37,856
公投第１２案,臺南市,南區,建南里,1067,1707,527,322,849,15,864
公投第１２案,臺南市,南區,南都里,1068,1657,357,225,582,18,600
公投第１２案,臺南市,南區,南都里,1069,1077,345,218,563,22,585
公投第１２案,臺南市,南區,南華里,1070,1185,399,216,615,21,636
公投第１２案,臺南市,南區,南華里,1071,1249,390,231,621,15,636
公投第１２案,臺南市,南區,開南里,1072,1985,570,300,870,28,898
公投第１２案,臺南市,南區,開南里,1073,2017,541,338,879,40,919
公投第１２案,臺南市,南區,開南里,1074,1717,506,304,810,37,847
公投第１２案,臺南市,南區,彰南里,1075,929,315,188,503,22,525
公投第１２案,臺南市,南區,彰南里,1076,695,222,156,378,17,395
公投第１２案,臺南市,南區,鯤鯓里,1077,997,330,160,490,13,503
公投第１２案,臺南市,南區,鯤鯓里,1078,784,257,129,386,14,400
公投第１２案,臺南市,南區,喜北里,1079,1119,404,206,610,41,651
公投第１２案,臺南市,南區,喜北里,1080,1054,320,162,482,22,504
公投第１２案,臺南市,南區,喜南里,1081,1245,383,206,589,56,645
公投第１２案,臺南市,南區,喜東里,1082,2064,588,343,931,52,983
公投第１２案,臺南市,南區,省躬里,1083,2056,555,301,856,18,874
公投第１２案,臺南市,南區,省躬里,1084,1373,447,210,657,19,676
公投第１２案,臺南市,南區,永寧里,1085,1002,318,172,490,23,513
公投第１２案,臺南市,南區,永寧里,1086,760,267,138,405,45,450
公投第１２案,臺南市,南區,松安里,1087,1031,335,205,540,39,579
公投第１２案,臺南市,南區,松安里,1088,744,243,142,385,29,414
公投第１２案,臺南市,南區,佛壇里,1089,1186,414,202,616,33,649
公投第１２案,臺南市,南區,佛壇里,1090,1358,450,263,713,33,746
公投第１２案,臺南市,南區,同安里,1091,897,260,158,418,18,436
公投第１２案,臺南市,南區,同安里,1092,1265,415,226,641,27,668
公投第１２案,臺南市,南區,興農里,1093,1093,341,192,533,24,557
公投第１２案,臺南市,南區,興農里,1094,1016,360,206,566,19,585
公投第１２案,臺南市,東區,崇信里,1095,2681,666,371,1037,40,1077
公投第１２案,臺南市,東區,崇信里,1096,1811,652,333,985,39,1024
公投第１２案,臺南市,東區,崇學里,1097,1491,553,337,890,48,938
公投第１２案,臺南市,東區,崇學里,1098,1378,447,282,729,23,752
公投第１２案,臺南市,東區,崇德里,1099,1552,551,326,877,30,907
公投第１２案,臺南市,東區,崇德里,1100,1326,467,299,766,17,783
公投第１２案,臺南市,東區,崇德里,1101,1594,549,308,857,46,903
公投第１２案,臺南市,東區,崇善里,1102,1639,568,345,913,35,948
公投第１２案,臺南市,東區,崇善里,1103,1724,560,334,894,53,947
公投第１２案,臺南市,東區,崇善里,1104,1629,568,297,865,46,911
公投第１２案,臺南市,東區,崇成里,1105,1399,471,292,763,32,795
公投第１２案,臺南市,東區,崇成里,1106,1534,525,312,837,25,862
公投第１２案,臺南市,東區,崇文里,1107,1656,559,352,911,29,940
公投第１２案,臺南市,東區,崇文里,1108,1322,454,242,696,36,732
公投第１２案,臺南市,東區,崇文里,1109,1620,635,233,868,33,901
公投第１２案,臺南市,東區,崇文里,1110,1331,514,280,794,26,820
公投第１２案,臺南市,東區,東智里,1111,1039,385,178,563,43,606
公投第１２案,臺南市,東區,東智里,1112,1257,420,215,635,24,659
公投第１２案,臺南市,東區,大智里,1113,2067,655,355,1010,64,1074
公投第１２案,臺南市,東區,大智里,1114,2153,799,356,1155,29,1184
公投第１２案,臺南市,東區,大智里,1115,2363,784,434,1218,33,1251
公投第１２案,臺南市,東區,德高里,1116,1427,496,251,747,39,786
公投第１２案,臺南市,東區,德高里,1117,1555,583,316,899,34,933
公投第１２案,臺南市,東區,仁和里,1118,2115,590,333,923,45,968
公投第１２案,臺南市,東區,仁和里,1119,2340,689,425,1114,50,1164
公投第１２案,臺南市,東區,和平里,1120,2474,769,514,1283,33,1316
公投第１２案,臺南市,東區,和平里,1121,2391,794,395,1189,57,1246
公投第１２案,臺南市,東區,虎尾里,1122,1673,593,332,925,28,953
公投第１２案,臺南市,東區,虎尾里,1123,1594,539,313,852,33,885
公投第１２案,臺南市,東區,虎尾里,1124,1607,557,318,875,45,920
公投第１２案,臺南市,東區,裕聖里,1125,2087,751,445,1196,24,1220
公投第１２案,臺南市,東區,裕聖里,1126,2369,820,508,1328,36,1364
公投第１２案,臺南市,東區,復興里,1127,1696,576,290,866,51,917
公投第１２案,臺南市,東區,復興里,1128,1612,540,337,877,35,912
公投第１２案,臺南市,東區,自強里,1129,1708,524,335,859,37,896
公投第１２案,臺南市,東區,自強里,1130,1560,517,307,824,37,861
公投第１２案,臺南市,東區,自強里,1131,1854,683,272,955,40,995
公投第１２案,臺南市,東區,東聖里,1132,2278,726,398,1124,32,1156
公投第１２案,臺南市,東區,關聖里,1133,2093,683,394,1077,34,1111
公投第１２案,臺南市,東區,關聖里,1134,2242,785,459,1244,37,1281
公投第１２案,臺南市,東區,南聖里,1135,1152,430,228,658,36,694
公投第１２案,臺南市,東區,南聖里,1136,1318,486,300,786,11,797
公投第１２案,臺南市,東區,文聖里,1137,2200,763,451,1214,39,1253
公投第１２案,臺南市,東區,文聖里,1138,1960,726,392,1118,26,1144
公投第１２案,臺南市,東區,後甲里,1139,1489,507,305,812,26,838
公投第１２案,臺南市,東區,後甲里,1140,1443,450,314,764,34,798
公投第１２案,臺南市,東區,東光里,1141,1498,503,374,877,33,910
公投第１２案,臺南市,東區,東光里,1142,1622,556,341,897,22,919
公投第１２案,臺南市,東區,東光里,1143,1738,583,357,940,35,975
公投第１２案,臺南市,東區,東明里,1144,1501,447,303,750,45,795
公投第１２案,臺南市,東區,東明里,1145,1482,502,291,793,41,834
公投第１２案,臺南市,東區,莊敬里,1146,1829,527,351,878,36,914
公投第１２案,臺南市,東區,莊敬里,1147,1764,570,346,916,43,959
公投第１２案,臺南市,東區,小東里,1148,1427,488,322,810,22,832
公投第１２案,臺南市,東區,小東里,1149,1427,433,294,727,45,772
公投第１２案,臺南市,東區,小東里,1150,1388,466,286,752,32,784
公投第１２案,臺南市,東區,大學里,1151,1131,375,300,675,23,698
公投第１２案,臺南市,東區,成大里,1152,1000,321,198,519,31,550
公投第１２案,臺南市,東區,成大里,1153,996,347,184,531,24,555
公投第１２案,臺南市,東區,東門里,1154,935,314,156,470,30,500
公投第１２案,臺南市,東區,東門里,1155,947,294,222,516,31,547
公投第１２案,臺南市,東區,圍下里,1156,1090,356,233,589,8,597
公投第１２案,臺南市,東區,圍下里,1157,896,283,174,457,23,480
公投第１２案,臺南市,東區,中西里,1158,1589,534,316,850,26,876
公投第１２案,臺南市,東區,中西里,1159,1497,507,320,827,25,852
公投第１２案,臺南市,東區,東安里,1160,1386,428,265,693,38,731
公投第１２案,臺南市,東區,新東里,1161,1101,376,233,609,16,625
公投第１２案,臺南市,東區,新東里,1162,1332,471,276,747,29,776
公投第１２案,臺南市,東區,崇誨里,1163,1185,405,245,650,31,681
公投第１２案,臺南市,東區,崇誨里,1164,1262,460,260,720,28,748
公投第１２案,臺南市,東區,衛國里,1165,1517,508,249,757,40,797
公投第１２案,臺南市,東區,裕農里,1166,1287,411,255,666,50,716
公投第１２案,臺南市,東區,裕農里,1167,1657,577,318,895,36,931
公投第１２案,臺南市,東區,富強里,1168,2238,709,427,1136,77,1213
公投第１２案,臺南市,東區,富強里,1169,2246,681,460,1141,53,1194
公投第１２案,臺南市,東區,富裕里,1170,2191,703,425,1128,39,1167
公投第１２案,臺南市,東區,忠孝里,1171,2063,649,387,1036,44,1080
公投第１２案,臺南市,東區,忠孝里,1172,2177,757,446,1203,51,1254
公投第１２案,臺南市,東區,崇明里,1173,1863,675,368,1043,46,1089
公投第１２案,臺南市,東區,崇明里,1174,2185,762,438,1200,28,1228
公投第１２案,臺南市,東區,大福里,1175,1721,541,267,808,33,841
公投第１２案,臺南市,東區,大德里,1176,1556,498,295,793,70,863
公投第１２案,臺南市,東區,路東里,1177,1602,519,369,888,33,921
公投第１２案,臺南市,東區,大同里,1178,1523,526,245,771,39,810
公投第１２案,臺南市,東區,大同里,1179,1382,424,261,685,33,718
公投第１２案,臺南市,東區,泉南里,1180,1486,480,299,779,30,809
公投第１２案,臺南市,東區,泉南里,1181,1560,531,307,838,43,881
公投第１２案,臺南市,東區,泉南里,1182,1684,503,298,801,36,837
公投第１２案,臺南市,東區,龍山里,1183,1653,539,346,885,29,914
公投第１２案,臺南市,東區,龍山里,1184,1554,498,360,858,12,870
公投第１２案,臺南市,東區,龍山里,1185,1408,486,300,786,22,808
公投第１２案,臺南市,東區,德光里,1186,2084,754,448,1202,25,1227
公投第１２案,臺南市,東區,德光里,1187,1896,579,423,1002,35,1037
公投第１２案,臺南市,仁德區,太子里,1188,1318,421,268,689,40,729
公投第１２案,臺南市,仁德區,太子里,1189,1406,460,259,719,50,769
公投第１２案,臺南市,仁德區,太子里,1190,1465,475,253,728,43,771
公投第１２案,臺南市,仁德區,太子里,1191,1192,418,262,680,41,721
公投第１２案,臺南市,仁德區,土庫里,1192,1429,486,291,777,50,827
公投第１２案,臺南市,仁德區,土庫里,1193,1320,380,261,641,85,726
公投第１２案,臺南市,仁德區,一甲里,1194,1373,511,279,790,47,837
公投第１２案,臺南市,仁德區,一甲里,1195,1330,465,269,734,37,771
公投第１２案,臺南市,仁德區,仁德里,1196,1687,593,322,915,35,950
公投第１２案,臺南市,仁德區,仁德里,1197,1491,436,276,712,48,760
公投第１２案,臺南市,仁德區,仁德里,1198,1151,320,199,519,28,547
公投第１２案,臺南市,仁德區,仁德里,1199,1407,475,245,720,15,735
公投第１２案,臺南市,仁德區,仁德里,1200,1465,540,265,805,31,836
公投第１２案,臺南市,仁德區,仁義里,1201,1335,445,280,725,32,757
公投第１２案,臺南市,仁德區,仁義里,1202,1490,466,277,743,44,787
公投第１２案,臺南市,仁德區,仁義里,1203,1453,532,283,815,41,856
公投第１２案,臺南市,仁德區,仁義里,1204,990,319,185,504,28,532
公投第１２案,臺南市,仁德區,仁義里,1205,1573,534,317,851,37,888
公投第１２案,臺南市,仁德區,仁義里,1206,1031,331,210,541,27,568
公投第１２案,臺南市,仁德區,仁義里,1207,1194,362,255,617,27,644
公投第１２案,臺南市,仁德區,新田里,1208,1268,397,222,619,43,662
公投第１２案,臺南市,仁德區,新田里,1209,929,296,206,502,29,531
公投第１２案,臺南市,仁德區,新田里,1210,1145,363,198,561,9,570
公投第１２案,臺南市,仁德區,後壁里,1211,1413,455,257,712,32,744
公投第１２案,臺南市,仁德區,後壁里,1212,1465,481,256,737,51,788
公投第１２案,臺南市,仁德區,後壁里,1213,1390,465,294,759,39,798
公投第１２案,臺南市,仁德區,後壁里,1214,1396,439,278,717,50,767
公投第１２案,臺南市,仁德區,後壁里,1215,1906,581,383,964,34,998
公投第１２案,臺南市,仁德區,後壁里,1216,1546,480,267,747,28,775
公投第１２案,臺南市,仁德區,上崙里,1217,1546,417,269,686,25,711
公投第１２案,臺南市,仁德區,上崙里,1218,1399,482,295,777,34,811
公投第１２案,臺南市,仁德區,上崙里,1219,1748,564,316,880,52,932
公投第１２案,臺南市,仁德區,上崙里,1220,1140,408,210,618,27,645
公投第１２案,臺南市,仁德區,文賢里,1221,1277,431,236,667,22,689
公投第１２案,臺南市,仁德區,文賢里,1222,1019,399,223,622,32,654
公投第１２案,臺南市,仁德區,保安里,1223,1414,476,249,725,22,747
公投第１２案,臺南市,仁德區,保安里,1224,1349,420,231,651,14,665
公投第１２案,臺南市,仁德區,成功里,1225,1471,500,230,730,28,758
公投第１２案,臺南市,仁德區,成功里,1226,1324,443,260,703,17,720
公投第１２案,臺南市,仁德區,成功里,1227,1310,424,189,613,36,649
公投第１２案,臺南市,仁德區,成功里,1228,554,189,111,300,14,314
公投第１２案,臺南市,仁德區,仁和里,1229,1395,491,216,707,43,750
公投第１２案,臺南市,仁德區,仁愛里,1230,1264,442,198,640,20,660
公投第１２案,臺南市,仁德區,二行里,1231,1180,422,201,623,36,659
公投第１２案,臺南市,仁德區,二行里,1232,928,280,169,449,25,474
公投第１２案,臺南市,仁德區,大甲里,1233,965,304,167,471,22,493
公投第１２案,臺南市,仁德區,大甲里,1234,1119,387,185,572,26,598
公投第１２案,臺南市,仁德區,中洲里,1235,1206,404,218,622,38,660
公投第１２案,臺南市,仁德區,中洲里,1236,1466,475,251,726,35,761
公投第１２案,臺南市,歸仁區,南保里,1237,1560,485,287,772,43,815
公投第１２案,臺南市,歸仁區,南保里,1238,1383,516,308,824,20,844
公投第１２案,臺南市,歸仁區,南保里,1239,1491,478,305,783,23,806
公投第１２案,臺南市,歸仁區,南保里,1240,1482,455,274,729,32,761
公投第１２案,臺南市,歸仁區,南興里,1241,1330,447,280,727,25,752
公投第１２案,臺南市,歸仁區,南興里,1242,1399,447,309,756,33,789
公投第１２案,臺南市,歸仁區,南興里,1243,1416,434,263,697,39,736
公投第１２案,臺南市,歸仁區,六甲里,1244,1336,334,228,562,33,595
公投第１２案,臺南市,歸仁區,六甲里,1245,1183,376,178,554,43,597
公投第１２案,臺南市,歸仁區,六甲里,1246,1237,387,223,610,28,638
公投第１２案,臺南市,歸仁區,歸南里,1247,1133,365,233,598,37,635
公投第１２案,臺南市,歸仁區,歸南里,1248,1149,334,232,566,35,601
公投第１２案,臺南市,歸仁區,後市里,1249,1105,371,212,583,10,593
公投第１２案,臺南市,歸仁區,後市里,1250,1099,349,230,579,32,611
公投第１２案,臺南市,歸仁區,後市里,1251,1082,373,219,592,44,636
公投第１２案,臺南市,歸仁區,文化里,1252,1519,573,275,848,28,876
公投第１２案,臺南市,歸仁區,文化里,1253,1467,527,286,813,29,842
公投第１２案,臺南市,歸仁區,辜厝里,1254,1090,332,213,545,33,578
公投第１２案,臺南市,歸仁區,辜厝里,1255,1131,362,218,580,16,596
公投第１２案,臺南市,歸仁區,辜厝里,1256,1080,358,208,566,23,589
公投第１２案,臺南市,歸仁區,新厝里,1257,1121,348,176,524,22,546
公投第１２案,臺南市,歸仁區,新厝里,1258,1336,403,267,670,58,728
公投第１２案,臺南市,歸仁區,許厝里,1259,1128,335,233,568,49,617
公投第１２案,臺南市,歸仁區,許厝里,1260,1055,352,196,548,18,566
公投第１２案,臺南市,歸仁區,許厝里,1261,1102,367,200,567,27,594
公投第１２案,臺南市,歸仁區,看西里,1262,1068,370,229,599,29,628
公投第１２案,臺南市,歸仁區,看西里,1263,1033,357,205,562,38,600
公投第１２案,臺南市,歸仁區,看東里,1264,1772,438,289,727,19,746
公投第１２案,臺南市,歸仁區,崙頂里,1265,1399,454,284,738,43,781
公投第１２案,臺南市,歸仁區,崙頂里,1266,1544,520,285,805,20,825
公投第１２案,臺南市,歸仁區,沙崙里,1267,684,191,109,300,12,312
公投第１２案,臺南市,歸仁區,大潭里,1268,839,297,180,477,26,503
公投第１２案,臺南市,歸仁區,大潭里,1269,1014,358,214,572,36,608
公投第１２案,臺南市,歸仁區,武東里,1270,1906,438,252,690,19,709
公投第１２案,臺南市,歸仁區,歸仁里,1271,1245,420,266,686,32,718
公投第１２案,臺南市,歸仁區,歸仁里,1272,1048,367,171,538,22,560
公投第１２案,臺南市,歸仁區,八甲里,1273,1175,387,225,612,18,630
公投第１２案,臺南市,歸仁區,八甲里,1274,1411,435,274,709,6,715
公投第１２案,臺南市,歸仁區,七甲里,1275,1514,517,308,825,33,858
公投第１２案,臺南市,歸仁區,七甲里,1276,1678,515,345,860,45,905
公投第１２案,臺南市,歸仁區,媽廟里,1277,949,294,212,506,35,541
公投第１２案,臺南市,歸仁區,媽廟里,1278,1009,371,196,567,48,615
公投第１２案,臺南市,歸仁區,西埔里,1279,984,345,247,592,5,597
公投第１２案,臺南市,歸仁區,西埔里,1280,756,282,148,430,27,457
公投第１２案,臺南市,歸仁區,大廟里,1281,1478,518,317,835,42,877
公投第１２案,臺南市,歸仁區,大廟里,1282,1467,481,335,816,56,872
公投第１２案,臺南市,關廟區,關廟里,1283,982,344,175,519,15,534
公投第１２案,臺南市,關廟區,關廟里,1284,1156,443,225,668,31,699
公投第１２案,臺南市,關廟區,山西里,1285,1006,313,172,485,18,503
公投第１２案,臺南市,關廟區,山西里,1286,1043,374,216,590,48,638
公投第１２案,臺南市,關廟區,香洋里,1287,1012,345,206,551,39,590
公投第１２案,臺南市,關廟區,香洋里,1288,1013,304,166,470,18,488
公投第１２案,臺南市,關廟區,香洋里,1289,1294,394,239,633,20,653
公投第１２案,臺南市,關廟區,北勢里,1290,1264,377,242,619,39,658
公投第１２案,臺南市,關廟區,北勢里,1291,1166,382,220,602,29,631
公投第１２案,臺南市,關廟區,新埔里,1292,1018,216,310,526,12,538
公投第１２案,臺南市,關廟區,新光里,1293,733,197,110,307,35,342
公投第１２案,臺南市,關廟區,五甲里,1294,1093,383,247,630,24,654
公投第１２案,臺南市,關廟區,五甲里,1295,1081,383,215,598,19,617
公投第１２案,臺南市,關廟區,五甲里,1296,978,314,239,553,28,581
公投第１２案,臺南市,關廟區,東勢里,1297,1116,316,198,514,30,544
公投第１２案,臺南市,關廟區,東勢里,1298,972,283,205,488,33,521
公投第１２案,臺南市,關廟區,東勢里,1299,1045,327,228,555,54,609
公投第１２案,臺南市,關廟區,松腳里,1300,872,278,180,458,28,486
公投第１２案,臺南市,關廟區,松腳里,1301,1007,342,207,549,43,592
公投第１２案,臺南市,關廟區,花園里,1302,763,264,166,430,30,460
公投第１２案,臺南市,關廟區,花園里,1303,630,182,120,302,32,334
公投第１２案,臺南市,關廟區,花園里,1304,959,318,201,519,47,566
公投第１２案,臺南市,關廟區,花園里,1305,1123,380,195,575,25,600
公投第１２案,臺南市,關廟區,深坑里,1306,804,276,142,418,50,468
公投第１２案,臺南市,關廟區,深坑里,1307,720,240,139,379,21,400
公投第１２案,臺南市,關廟區,布袋里,1308,843,255,122,377,12,389
公投第１２案,臺南市,關廟區,布袋里,1309,358,101,69,170,13,183
公投第１２案,臺南市,關廟區,南雄里,1310,797,227,148,375,56,431
公投第１２案,臺南市,關廟區,南雄里,1311,709,213,102,315,15,330
公投第１２案,臺南市,關廟區,埤頭里,1312,904,306,123,429,13,442
公投第１２案,臺南市,關廟區,埤頭里,1313,963,310,198,508,20,528
公投第１２案,臺南市,關廟區,下湖里,1314,489,169,114,283,11,294
公投第１２案,臺南市,龍崎區,崎頂里,1315,1047,316,209,525,35,560
公投第１２案,臺南市,龍崎區,土崎里,1316,630,195,109,304,12,316
公投第１２案,臺南市,龍崎區,中坑里,1317,141,38,15,53,5,58
公投第１２案,臺南市,龍崎區,楠坑里,1318,367,98,70,168,16,184
公投第１２案,臺南市,龍崎區,牛埔里,1319,337,116,58,174,11,185
公投第１２案,臺南市,龍崎區,大坪里,1320,318,86,53,139,5,144
公投第１２案,臺南市,龍崎區,龍船里,1321,427,135,61,196,18,214
公投第１２案,臺南市,龍崎區,石𥕢里,1322,446,122,64,186,14,200
公投第１２案,桃園市,桃園區,大林里,1,1593,457,311,768,37,805
公投第１２案,桃園市,桃園區,大林里,2,1934,445,350,795,32,827
公投第１２案,桃園市,桃園區,大林里,3,1661,516,345,861,54,915
公投第１２案,桃園市,桃園區,大林里,4,1448,390,275,665,20,685
公投第１２案,桃園市,桃園區,大樹里,5,1974,501,409,910,38,948
公投第１２案,桃園市,桃園區,大樹里,6,1882,507,321,828,41,869
公投第１２案,桃園市,桃園區,大豐里,7,1800,472,381,853,31,884
公投第１２案,桃園市,桃園區,大豐里,8,1598,477,358,835,56,891
公投第１２案,桃園市,桃園區,大豐里,9,1626,403,307,710,64,774
公投第１２案,桃園市,桃園區,建國里,10,1590,432,300,732,48,780
公投第１２案,桃園市,桃園區,建國里,11,1637,448,354,802,39,841
公投第１２案,桃園市,桃園區,建國里,12,1943,527,369,896,55,951
公投第１２案,桃園市,桃園區,雲林里,13,1482,413,331,744,36,780
公投第１２案,桃園市,桃園區,雲林里,14,1423,446,294,740,44,784
公投第１２案,桃園市,桃園區,雲林里,15,1509,451,346,797,35,832
公投第１２案,桃園市,桃園區,雲林里,16,1567,491,328,819,32,851
公投第１２案,桃園市,桃園區,福安里,17,1305,411,266,677,37,714
公投第１２案,桃園市,桃園區,福安里,18,1416,409,258,667,31,698
公投第１２案,桃園市,桃園區,福安里,19,1439,459,319,778,28,806
公投第１２案,桃園市,桃園區,福林里,20,1399,445,300,745,40,785
公投第１２案,桃園市,桃園區,福林里,21,1540,487,335,822,40,862
公投第１２案,桃園市,桃園區,福林里,22,1638,470,308,778,29,807
公投第１２案,桃園市,桃園區,福林里,23,1228,377,262,639,26,665
公投第１２案,桃園市,桃園區,豐林里,24,1649,497,286,783,46,829
公投第１２案,桃園市,桃園區,豐林里,25,1601,497,305,802,30,832
公投第１２案,桃園市,桃園區,豐林里,26,1477,393,300,693,63,756
公投第１２案,桃園市,桃園區,豐林里,27,1503,486,309,795,27,822
公投第１２案,桃園市,桃園區,中和里,28,1375,453,302,755,47,802
公投第１２案,桃園市,桃園區,中興里,29,1743,547,363,910,37,947
公投第１２案,桃園市,桃園區,中興里,30,1862,529,337,866,50,916
公投第１２案,桃園市,桃園區,中興里,31,1728,520,354,874,31,905
公投第１２案,桃園市,桃園區,文化里,32,690,204,143,347,19,366
公投第１２案,桃園市,桃園區,文昌里,33,852,296,196,492,24,516
公投第１２案,桃園市,桃園區,文明里,34,1353,425,319,744,47,791
公投第１２案,桃園市,桃園區,北門里,35,1698,389,276,665,17,682
公投第１２案,桃園市,桃園區,民生里,36,1452,397,303,700,40,740
公投第１２案,桃園市,桃園區,永興里,37,1681,494,338,832,51,883
公投第１２案,桃園市,桃園區,光興里,38,1669,499,325,824,42,866
公投第１２案,桃園市,桃園區,光興里,39,1530,500,353,853,33,886
公投第１２案,桃園市,桃園區,光興里,40,1582,482,350,832,33,865
公投第１２案,桃園市,桃園區,西門里,41,1587,436,296,732,33,765
公投第１２案,桃園市,桃園區,西湖里,42,1451,440,309,749,48,797
公投第１２案,桃園市,桃園區,武陵里,43,1582,382,314,696,40,736
公投第１２案,桃園市,桃園區,長美里,44,1028,326,229,555,33,588
公投第１２案,桃園市,桃園區,南門里,45,1934,551,365,916,51,967
公投第１２案,桃園市,桃園區,南門里,46,1016,316,205,521,40,561
公投第１２案,桃園市,桃園區,南門里,47,1079,319,242,561,23,584
公投第１２案,桃園市,桃園區,南門里,48,1837,526,351,877,25,902
公投第１２案,桃園市,桃園區,南華里,49,1390,423,298,721,49,770
公投第１２案,桃園市,桃園區,中山里,50,1489,438,334,772,28,800
公投第１２案,桃園市,桃園區,中山里,51,1821,548,445,993,25,1018
公投第１２案,桃園市,桃園區,中山里,52,1563,460,291,751,18,769
公投第１２案,桃園市,桃園區,中山里,53,1697,521,366,887,29,916
公投第１２案,桃園市,桃園區,中平里,54,1740,534,371,905,35,940
公投第１２案,桃園市,桃園區,中平里,55,1626,500,324,824,37,861
公投第１２案,桃園市,桃園區,中平里,56,1239,421,276,697,18,715
公投第１２案,桃園市,桃園區,中正里,57,1766,513,394,907,34,941
公投第１２案,桃園市,桃園區,中正里,58,1555,460,337,797,41,838
公投第１２案,桃園市,桃園區,中正里,59,1831,567,369,936,36,972
公投第１２案,桃園市,桃園區,中成里,60,1115,374,268,642,28,670
公投第１２案,桃園市,桃園區,中成里,61,1562,486,343,829,35,864
公投第１２案,桃園市,桃園區,中成里,62,1744,539,322,861,32,893
公投第１２案,桃園市,桃園區,中信里,63,1838,467,369,836,30,866
公投第１２案,桃園市,桃園區,中信里,64,1889,612,380,992,44,1036
公投第１２案,桃園市,桃園區,中信里,65,1985,525,365,890,56,946
公投第１２案,桃園市,桃園區,中原里,66,1524,471,359,830,49,879
公投第１２案,桃園市,桃園區,中原里,67,1425,512,335,847,33,880
公投第１２案,桃園市,桃園區,中原里,68,1606,547,349,896,30,926
公投第１２案,桃園市,桃園區,中泰里,69,2056,694,429,1123,24,1147
公投第１２案,桃園市,桃園區,中泰里,70,2010,655,415,1070,37,1107
公投第１２案,桃園市,桃園區,中聖里,71,2245,630,428,1058,50,1108
公投第１２案,桃園市,桃園區,中聖里,72,1590,461,359,820,29,849
公投第１２案,桃園市,桃園區,中聖里,73,1536,527,359,886,24,910
公投第１２案,桃園市,桃園區,中路里,74,1949,507,400,907,41,948
公投第１２案,桃園市,桃園區,中路里,75,1965,522,411,933,37,970
公投第１２案,桃園市,桃園區,中德里,76,2414,614,423,1037,42,1079
公投第１２案,桃園市,桃園區,中德里,77,1942,545,389,934,59,993
公投第１２案,桃園市,桃園區,中德里,78,2156,628,440,1068,39,1107
公投第１２案,桃園市,桃園區,文中里,79,1404,449,312,761,36,797
公投第１２案,桃園市,桃園區,文中里,80,1194,416,279,695,30,725
公投第１２案,桃園市,桃園區,玉山里,81,1449,436,343,779,58,837
公投第１２案,桃園市,桃園區,玉山里,82,1803,480,355,835,56,891
公投第１２案,桃園市,桃園區,玉山里,83,1692,522,354,876,33,909
公投第１２案,桃園市,桃園區,泰山里,84,1913,595,379,974,34,1008
公投第１２案,桃園市,桃園區,泰山里,85,1815,504,396,900,40,940
公投第１２案,桃園市,桃園區,龍山里,86,1173,307,244,551,42,593
公投第１２案,桃園市,桃園區,龍山里,87,1162,349,222,571,24,595
公投第１２案,桃園市,桃園區,龍山里,88,1194,275,235,510,44,554
公投第１２案,桃園市,桃園區,龍安里,89,1695,512,355,867,34,901
公投第１２案,桃園市,桃園區,龍安里,90,1797,499,386,885,22,907
公投第１２案,桃園市,桃園區,龍安里,91,1592,519,279,798,26,824
公投第１２案,桃園市,桃園區,龍岡里,92,1780,522,331,853,49,902
公投第１２案,桃園市,桃園區,龍岡里,93,1904,508,340,848,27,875
公投第１２案,桃園市,桃園區,龍岡里,94,2021,567,409,976,25,1001
公投第１２案,桃園市,桃園區,龍祥里,95,1545,486,280,766,36,802
公投第１２案,桃園市,桃園區,龍祥里,96,1617,484,280,764,22,786
公投第１２案,桃園市,桃園區,龍祥里,97,1683,502,325,827,26,853
公投第１２案,桃園市,桃園區,龍壽里,98,1834,556,383,939,60,999
公投第１２案,桃園市,桃園區,龍壽里,99,2055,536,409,945,35,980
公投第１２案,桃園市,桃園區,龍壽里,100,1828,508,340,848,18,866
公投第１２案,桃園市,桃園區,龍鳳里,101,1873,551,333,884,33,917
公投第１２案,桃園市,桃園區,龍鳳里,102,3687,451,273,724,39,763
公投第１２案,桃園市,桃園區,龍鳳里,103,1850,549,374,923,42,965
公投第１２案,桃園市,桃園區,龍鳳里,104,1827,529,366,895,28,923
公投第１２案,桃園市,桃園區,中埔里,105,1149,420,249,669,27,696
公投第１２案,桃園市,桃園區,中埔里,106,1061,335,254,589,40,629
公投第１２案,桃園市,桃園區,中寧里,107,1831,469,358,827,36,863
公投第１２案,桃園市,桃園區,中寧里,108,2168,614,435,1049,39,1088
公投第１２案,桃園市,桃園區,中寧里,109,1874,563,349,912,8,920
公投第１２案,桃園市,桃園區,北埔里,110,1524,394,295,689,18,707
公投第１２案,桃園市,桃園區,北埔里,111,1528,460,332,792,18,810
公投第１２案,桃園市,桃園區,北埔里,112,1489,454,326,780,26,806
公投第１２案,桃園市,桃園區,永安里,113,1308,351,278,629,51,680
公投第１２案,桃園市,桃園區,永安里,114,1583,460,317,777,44,821
公投第１２案,桃園市,桃園區,永安里,115,1618,494,347,841,40,881
公投第１２案,桃園市,桃園區,同安里,116,2127,566,433,999,54,1053
公投第１２案,桃園市,桃園區,同安里,117,2033,571,392,963,26,989
公投第１２案,桃園市,桃園區,同安里,118,2098,640,397,1037,27,1064
公投第１２案,桃園市,桃園區,同安里,119,2126,679,418,1097,50,1147
公投第１２案,桃園市,桃園區,同德里,120,1917,580,331,911,35,946
公投第１２案,桃園市,桃園區,同德里,121,1997,547,399,946,34,980
公投第１２案,桃園市,桃園區,同德里,122,1929,589,380,969,37,1006
公投第１２案,桃園市,桃園區,自強里,123,1691,483,340,823,36,859
公投第１２案,桃園市,桃園區,自強里,124,1900,570,375,945,25,970
公投第１２案,桃園市,桃園區,自強里,125,1761,539,353,892,44,936
公投第１２案,桃園市,桃園區,自強里,126,1922,533,405,938,20,958
公投第１２案,桃園市,桃園區,西埔里,127,1995,557,397,954,41,995
公投第１２案,桃園市,桃園區,西埔里,128,1063,341,229,570,21,591
公投第１２案,桃園市,桃園區,明德里,129,1412,419,283,702,30,732
公投第１２案,桃園市,桃園區,明德里,130,1746,534,395,929,20,949
公投第１２案,桃園市,桃園區,東埔里,131,1689,436,329,765,39,804
公投第１２案,桃園市,桃園區,東埔里,132,1542,412,260,672,24,696
公投第１２案,桃園市,桃園區,東埔里,133,1437,420,266,686,38,724
公投第１２案,桃園市,桃園區,長安里,134,1679,490,360,850,23,873
公投第１２案,桃園市,桃園區,長安里,135,1886,487,345,832,46,878
公投第１２案,桃園市,桃園區,長德里,136,1657,487,349,836,55,891
公投第１２案,桃園市,桃園區,長德里,137,1349,398,304,702,24,726
公投第１２案,桃園市,桃園區,長德里,138,1805,551,367,918,23,941
公投第１２案,桃園市,桃園區,信光里,139,1846,504,385,889,53,942
公投第１２案,桃園市,桃園區,信光里,140,1644,441,293,734,44,778
公投第１２案,桃園市,桃園區,信光里,141,1674,441,326,767,38,805
公投第１２案,桃園市,桃園區,信光里,142,1737,520,333,853,31,884
公投第１２案,桃園市,桃園區,南埔里,143,1566,503,301,804,40,844
公投第１２案,桃園市,桃園區,南埔里,144,1517,458,316,774,38,812
公投第１２案,桃園市,桃園區,南埔里,145,1619,524,201,725,26,751
公投第１２案,桃園市,桃園區,莊敬里,146,1774,539,336,875,32,907
公投第１２案,桃園市,桃園區,莊敬里,147,1666,495,344,839,31,870
公投第１２案,桃園市,桃園區,莊敬里,148,1528,483,300,783,16,799
公投第１２案,桃園市,桃園區,莊敬里,149,1709,472,354,826,46,872
公投第１２案,桃園市,桃園區,莊敬里,150,1719,474,353,827,15,842
公投第１２案,桃園市,桃園區,慈文里,151,1569,414,271,685,50,735
公投第１２案,桃園市,桃園區,慈文里,152,1505,464,256,720,26,746
公投第１２案,桃園市,桃園區,慈文里,153,1496,408,321,729,34,763
公投第１２案,桃園市,桃園區,慈文里,154,1505,442,328,770,33,803
公投第１２案,桃園市,桃園區,新埔里,155,1807,499,380,879,34,913
公投第１２案,桃園市,桃園區,新埔里,156,1857,560,360,920,37,957
公投第１２案,桃園市,桃園區,新埔里,157,1589,516,336,852,45,897
公投第１２案,桃園市,桃園區,新埔里,158,2088,588,440,1028,32,1060
公投第１２案,桃園市,桃園區,新埔里,159,1893,559,362,921,32,953
公投第１２案,桃園市,桃園區,瑞慶里,160,1303,340,224,564,25,589
公投第１２案,桃園市,桃園區,瑞慶里,161,1416,429,295,724,33,757
公投第１２案,桃園市,桃園區,瑞慶里,162,1351,388,256,644,22,666
公投第１２案,桃園市,桃園區,瑞慶里,163,1659,460,332,792,26,818
公投第１２案,桃園市,桃園區,寶安里,164,2103,634,353,987,31,1018
公投第１２案,桃園市,桃園區,寶安里,165,1943,553,382,935,27,962
公投第１２案,桃園市,桃園區,寶安里,166,1927,556,393,949,31,980
公投第１２案,桃園市,桃園區,寶安里,167,1929,494,354,848,46,894
公投第１２案,桃園市,桃園區,寶慶里,168,2204,703,503,1206,33,1239
公投第１２案,桃園市,桃園區,寶慶里,169,2033,530,378,908,26,934
公投第１２案,桃園市,桃園區,寶慶里,170,1656,539,281,820,24,844
公投第１２案,桃園市,桃園區,三元里,171,1712,481,341,822,49,871
公投第１２案,桃園市,桃園區,三元里,172,1738,463,387,850,30,880
公投第１２案,桃園市,桃園區,三民里,173,1432,530,308,838,19,857
公投第１２案,桃園市,桃園區,三民里,174,1421,465,366,831,34,865
公投第１２案,桃園市,桃園區,三民里,175,1344,395,288,683,20,703
公投第１２案,桃園市,桃園區,大有里,176,1942,543,341,884,21,905
公投第１２案,桃園市,桃園區,大有里,177,2001,597,381,978,30,1008
公投第１２案,桃園市,桃園區,大有里,178,1941,524,344,868,22,890
公投第１２案,桃園市,桃園區,大業里,179,1702,511,365,876,37,913
公投第１２案,桃園市,桃園區,大業里,180,1589,451,342,793,30,823
公投第１２案,桃園市,桃園區,大業里,181,1544,489,276,765,26,791
公投第１２案,桃園市,桃園區,大興里,182,1860,452,338,790,32,822
公投第１２案,桃園市,桃園區,大興里,183,1726,473,343,816,53,869
公投第１２案,桃園市,桃園區,大興里,184,1798,478,362,840,30,870
公投第１２案,桃園市,桃園區,成功里,185,1925,570,372,942,25,967
公投第１２案,桃園市,桃園區,成功里,186,1945,564,382,946,35,981
公投第１２案,桃園市,桃園區,汴洲里,187,1764,437,353,790,43,833
公投第１２案,桃園市,桃園區,汴洲里,188,1899,597,386,983,53,1036
公投第１２案,桃園市,桃園區,汴洲里,189,1415,425,272,697,28,725
公投第１２案,桃園市,桃園區,忠義里,190,1790,484,351,835,23,858
公投第１２案,桃園市,桃園區,忠義里,191,1693,471,330,801,22,823
公投第１２案,桃園市,桃園區,東山里,192,1916,546,366,912,34,946
公投第１２案,桃園市,桃園區,東門里,193,1434,393,267,660,25,685
公投第１２案,桃園市,桃園區,東門里,194,1494,459,349,808,39,847
公投第１２案,桃園市,桃園區,青溪里,195,1311,383,293,676,47,723
公投第１２案,桃園市,桃園區,青溪里,196,1476,436,317,753,35,788
公投第１２案,桃園市,桃園區,青溪里,197,1484,458,335,793,39,832
公投第１２案,桃園市,桃園區,春日里,198,1514,457,304,761,31,792
公投第１２案,桃園市,桃園區,春日里,199,1446,454,260,714,45,759
公投第１２案,桃園市,桃園區,春日里,200,1573,412,311,723,26,749
公投第１２案,桃園市,桃園區,春日里,201,1564,410,290,700,28,728
公投第１２案,桃園市,桃園區,朝陽里,202,1015,329,215,544,31,575
公投第１２案,桃園市,桃園區,朝陽里,203,955,252,213,465,26,491
公投第１２案,桃園市,桃園區,會稽里,204,1796,506,364,870,35,905
公投第１２案,桃園市,桃園區,會稽里,205,1878,494,393,887,23,910
公投第１２案,桃園市,桃園區,會稽里,206,1729,504,325,829,28,857
公投第１２案,桃園市,桃園區,會稽里,207,1843,494,326,820,28,848
公投第１２案,桃園市,桃園區,會稽里,208,1817,449,309,758,26,784
公投第１２案,桃園市,桃園區,萬壽里,209,979,415,118,533,22,555
公投第１２案,桃園市,桃園區,福元里,210,1363,413,296,709,19,728
公投第１２案,桃園市,桃園區,福元里,211,1546,445,333,778,19,797
公投第１２案,桃園市,桃園區,福元里,212,1308,363,274,637,24,661
公投第１２案,桃園市,桃園區,寶山里,213,2164,613,416,1029,43,1072
公投第１２案,桃園市,桃園區,寶山里,214,2020,540,388,928,41,969
公投第１２案,桃園市,桃園區,寶山里,215,1924,485,345,830,29,859
公投第１２案,桃園市,桃園區,寶山里,216,2088,547,332,879,33,912
公投第１２案,桃園市,龜山區,精忠里,217,874,318,145,463,24,487
公投第１２案,桃園市,龜山區,精忠里,218,2014,711,312,1023,58,1081
公投第１２案,桃園市,龜山區,精忠里,219,2145,594,439,1033,23,1056
公投第１２案,桃園市,龜山區,陸光里,220,1744,644,253,897,47,944
公投第１２案,桃園市,龜山區,陸光里,221,1885,673,291,964,48,1012
公投第１２案,桃園市,龜山區,中興里,222,1546,459,249,708,49,757
公投第１２案,桃園市,龜山區,中興里,223,1684,472,318,790,49,839
公投第１２案,桃園市,龜山區,中興里,224,1477,381,275,656,37,693
公投第１２案,桃園市,龜山區,新興里,225,1528,568,262,830,45,875
公投第１２案,桃園市,龜山區,新興里,226,1428,156,126,282,11,293
公投第１２案,桃園市,龜山區,新路里,227,1525,480,312,792,43,835
公投第１２案,桃園市,龜山區,新路里,228,1041,339,237,576,33,609
公投第１２案,桃園市,龜山區,新路里,229,1404,385,303,688,31,719
公投第１２案,桃園市,龜山區,新路里,230,1478,497,279,776,41,817
公投第１２案,桃園市,龜山區,龜山里,231,2178,684,400,1084,54,1138
公投第１２案,桃園市,龜山區,龜山里,232,1672,506,333,839,62,901
公投第１２案,桃園市,龜山區,龜山里,233,1376,379,273,652,33,685
公投第１２案,桃園市,龜山區,龜山里,234,1480,403,320,723,32,755
公投第１２案,桃園市,龜山區,大同里,235,1258,387,270,657,34,691
公投第１２案,桃園市,龜山區,大同里,236,1464,427,305,732,32,764
公投第１２案,桃園市,龜山區,大同里,237,1844,487,394,881,64,945
公投第１２案,桃園市,龜山區,大同里,238,1169,322,269,591,22,613
公投第１２案,桃園市,龜山區,山頂里,239,1921,424,298,722,41,763
公投第１２案,桃園市,龜山區,山頂里,240,1694,429,349,778,32,810
公投第１２案,桃園市,龜山區,山頂里,241,1771,647,280,927,55,982
公投第１２案,桃園市,龜山區,山德里,242,1665,437,302,739,45,784
公投第１２案,桃園市,龜山區,山德里,243,1439,385,303,688,51,739
公投第１２案,桃園市,龜山區,山德里,244,1728,461,276,737,54,791
公投第１２案,桃園市,龜山區,山福里,245,1788,525,375,900,35,935
公投第１２案,桃園市,龜山區,山福里,246,1465,372,296,668,36,704
公投第１２案,桃園市,龜山區,幸福里,247,1659,367,283,650,46,696
公投第１２案,桃園市,龜山區,幸福里,248,1693,396,315,711,35,746
公投第１２案,桃園市,龜山區,幸福里,249,1818,386,306,692,15,707
公投第１２案,桃園市,龜山區,龍壽里,250,1752,468,384,852,43,895
公投第１２案,桃園市,龜山區,龍華里,251,1818,523,404,927,19,946
公投第１２案,桃園市,龜山區,龍華里,252,1499,438,311,749,18,767
公投第１２案,桃園市,龜山區,迴龍里,253,1916,545,394,939,40,979
公投第１２案,桃園市,龜山區,迴龍里,254,1804,512,389,901,25,926
公投第１２案,桃園市,龜山區,迴龍里,255,2127,594,392,986,37,1023
公投第１２案,桃園市,龜山區,嶺頂里,256,1005,268,225,493,50,543
公投第１２案,桃園市,龜山區,嶺頂里,257,1449,407,326,733,32,765
公投第１２案,桃園市,龜山區,嶺頂里,258,1498,364,312,676,51,727
公投第１２案,桃園市,龜山區,新嶺里,259,2149,523,380,903,53,956
公投第１２案,桃園市,龜山區,新嶺里,260,1771,401,276,677,38,715
公投第１２案,桃園市,龜山區,兔坑里,261,841,235,187,422,25,447
公投第１２案,桃園市,龜山區,兔坑里,262,2284,586,407,993,53,1046
公投第１２案,桃園市,龜山區,兔坑里,263,1228,339,271,610,42,652
公投第１２案,桃園市,龜山區,福源里,264,1979,506,356,862,35,897
公投第１２案,桃園市,龜山區,舊路里,265,1378,370,238,608,44,652
公投第１２案,桃園市,龜山區,舊路里,266,1061,295,200,495,41,536
公投第１２案,桃園市,龜山區,大坑里,267,1917,541,346,887,37,924
公投第１２案,桃園市,龜山區,楓福里,268,1540,496,371,867,35,902
公投第１２案,桃園市,龜山區,楓福里,269,1433,440,314,754,24,778
公投第１２案,桃園市,龜山區,楓樹里,270,1455,388,336,724,26,750
公投第１２案,桃園市,龜山區,楓樹里,271,2280,669,491,1160,59,1219
公投第１２案,桃園市,龜山區,樂善里,272,1668,486,340,826,36,862
公投第１２案,桃園市,龜山區,樂善里,273,1885,509,369,878,44,922
公投第１２案,桃園市,龜山區,長庚里,274,1849,489,407,896,12,908
公投第１２案,桃園市,龜山區,長庚里,275,1704,482,447,929,17,946
公投第１２案,桃園市,龜山區,公西里,276,1156,327,260,587,30,617
公投第１２案,桃園市,龜山區,大崗里,277,2114,487,365,852,45,897
公投第１２案,桃園市,龜山區,大崗里,278,1943,446,363,809,37,846
公投第１２案,桃園市,龜山區,大湖里,279,1800,462,355,817,25,842
公投第１２案,桃園市,龜山區,大湖里,280,2020,528,408,936,46,982
公投第１２案,桃園市,龜山區,大湖里,281,1319,411,293,704,27,731
公投第１２案,桃園市,龜山區,大華里,282,2229,640,509,1149,35,1184
公投第１２案,桃園市,龜山區,大華里,283,1992,526,398,924,29,953
公投第１２案,桃園市,龜山區,大華里,284,2237,562,444,1006,50,1056
公投第１２案,桃園市,龜山區,大華里,285,2133,570,421,991,35,1026
公投第１２案,桃園市,龜山區,文化里,286,2187,608,456,1064,41,1105
公投第１２案,桃園市,龜山區,文化里,287,1959,501,411,912,40,952
公投第１２案,桃園市,龜山區,文化里,288,1910,470,403,873,19,892
公投第１２案,桃園市,龜山區,南上里,289,1840,578,347,925,54,979
公投第１２案,桃園市,龜山區,南美里,290,2266,651,446,1097,36,1133
公投第１２案,桃園市,龜山區,文青里,291,2387,643,411,1054,23,1077
公投第１２案,桃園市,龜山區,文青里,292,1692,482,312,794,19,813
公投第１２案,桃園市,龜山區,文青里,293,904,245,205,450,16,466
公投第１２案,桃園市,龜山區,文青里,294,1469,440,314,754,30,784
公投第１２案,桃園市,八德區,興仁里,295,1761,462,313,775,57,832
公投第１２案,桃園市,八德區,興仁里,296,1804,425,292,717,19,736
公投第１２案,桃園市,八德區,興仁里,297,1813,272,220,492,14,506
公投第１２案,桃園市,八德區,興仁里,298,1784,457,347,804,22,826
公投第１２案,桃園市,八德區,福興里,299,2257,576,346,922,24,946
公投第１２案,桃園市,八德區,福興里,300,1857,479,291,770,28,798
公投第１２案,桃園市,八德區,福興里,301,2261,574,393,967,31,998
公投第１２案,桃園市,八德區,福興里,302,1903,545,383,928,47,975
公投第１２案,桃園市,八德區,瑞豐里,303,1955,578,332,910,72,982
公投第１２案,桃園市,八德區,瑞豐里,304,1665,415,303,718,21,739
公投第１２案,桃園市,八德區,瑞興里,305,1431,409,317,726,53,779
公投第１２案,桃園市,八德區,瑞興里,306,1263,406,270,676,25,701
公投第１２案,桃園市,八德區,瑞泰里,307,1583,530,313,843,45,888
公投第１２案,桃園市,八德區,瑞泰里,308,1246,397,254,651,33,684
公投第１２案,桃園市,八德區,瑞泰里,309,1356,421,277,698,32,730
公投第１２案,桃園市,八德區,瑞發里,310,1630,518,317,835,67,902
公投第１２案,桃園市,八德區,瑞發里,311,1586,499,283,782,33,815
公投第１２案,桃園市,八德區,瑞德里,312,1649,472,337,809,61,870
公投第１２案,桃園市,八德區,瑞德里,313,1910,477,349,826,71,897
公投第１２案,桃園市,八德區,瑞祥里,314,1612,487,342,829,72,901
公投第１２案,桃園市,八德區,瑞祥里,315,1640,527,290,817,41,858
公投第１２案,桃園市,八德區,廣德里,316,1303,367,272,639,36,675
公投第１２案,桃園市,八德區,廣德里,317,1413,429,339,768,43,811
公投第１２案,桃園市,八德區,廣興里,318,1711,470,369,839,36,875
公投第１２案,桃園市,八德區,廣興里,319,1562,468,311,779,62,841
公投第１２案,桃園市,八德區,廣隆里,320,1735,536,300,836,47,883
公投第１２案,桃園市,八德區,廣隆里,321,1658,485,335,820,28,848
公投第１２案,桃園市,八德區,廣隆里,322,1022,352,103,455,37,492
公投第１２案,桃園市,八德區,竹園里,323,1673,431,298,729,40,769
公投第１２案,桃園市,八德區,竹園里,324,1741,526,313,839,32,871
公投第１２案,桃園市,八德區,霄裡里,325,2110,613,399,1012,59,1071
公投第１２案,桃園市,八德區,龍友里,326,1145,387,208,595,23,618
公投第１２案,桃園市,八德區,龍友里,327,1010,386,204,590,28,618
公投第１２案,桃園市,八德區,茄明里,328,1848,449,346,795,22,817
公投第１２案,桃園市,八德區,茄明里,329,1334,433,265,698,29,727
公投第１２案,桃園市,八德區,茄明里,330,1349,356,219,575,22,597
公投第１２案,桃園市,八德區,茄苳里,331,1341,399,331,730,41,771
公投第１２案,桃園市,八德區,茄苳里,332,1178,400,257,657,32,689
公投第１２案,桃園市,八德區,永豐里,333,1374,397,312,709,41,750
公投第１２案,桃園市,八德區,永豐里,334,1462,371,319,690,50,740
公投第１２案,桃園市,八德區,高明里,335,1943,494,300,794,73,867
公投第１２案,桃園市,八德區,高明里,336,1928,399,276,675,70,745
公投第１２案,桃園市,八德區,高城里,337,1403,399,286,685,17,702
公投第１２案,桃園市,八德區,高城里,338,1672,447,308,755,49,804
公投第１２案,桃園市,八德區,白鷺里,339,1947,469,400,869,40,909
公投第１２案,桃園市,八德區,白鷺里,340,1200,348,270,618,41,659
公投第１２案,桃園市,八德區,大湳里,341,1895,497,357,854,48,902
公投第１２案,桃園市,八德區,大湳里,342,1988,484,375,859,56,915
公投第１２案,桃園市,八德區,大發里,343,2006,574,412,986,65,1051
公投第１２案,桃園市,八德區,大仁里,344,2061,526,393,919,13,932
公投第１２案,桃園市,八德區,大仁里,345,2108,512,398,910,61,971
公投第１２案,桃園市,八德區,大明里,346,1862,514,334,848,48,896
公投第１２案,桃園市,八德區,大明里,347,1681,465,231,696,27,723
公投第１２案,桃園市,八德區,大安里,348,1317,376,287,663,50,713
公投第１２案,桃園市,八德區,大安里,349,2093,591,527,1118,48,1166
公投第１２案,桃園市,八德區,大竹里,350,1499,461,347,808,46,854
公投第１２案,桃園市,八德區,大興里,351,1782,518,342,860,47,907
公投第１２案,桃園市,八德區,大興里,352,1763,533,352,885,18,903
公投第１２案,桃園市,八德區,大愛里,353,1226,381,249,630,41,671
公投第１２案,桃園市,八德區,大愛里,354,1311,410,292,702,25,727
公投第１２案,桃園市,八德區,大華里,355,1170,334,296,630,37,667
公投第１２案,桃園市,八德區,大華里,356,1313,435,267,702,28,730
公投第１２案,桃園市,八德區,大順里,357,1186,352,283,635,23,658
公投第１２案,桃園市,八德區,大順里,358,1481,404,282,686,38,724
公投第１２案,桃園市,八德區,大和里,359,1998,550,420,970,57,1027
公投第１２案,桃園市,八德區,大和里,360,916,302,188,490,26,516
公投第１２案,桃園市,八德區,大和里,361,1943,559,338,897,30,927
公投第１２案,桃園市,八德區,大和里,362,2076,591,366,957,30,987
公投第１２案,桃園市,八德區,大昌里,363,1363,427,256,683,53,736
公投第１２案,桃園市,八德區,大昌里,364,1491,462,279,741,47,788
公投第１２案,桃園市,八德區,大信里,365,1474,426,289,715,49,764
公投第１２案,桃園市,八德區,大信里,366,718,93,67,160,14,174
公投第１２案,桃園市,八德區,大信里,367,1386,385,302,687,44,731
公投第１２案,桃園市,八德區,陸光里,368,1487,470,247,717,57,774
公投第１２案,桃園市,八德區,陸光里,369,1552,502,238,740,74,814
公投第１２案,桃園市,八德區,陸光里,370,1255,367,205,572,46,618
公投第１２案,桃園市,八德區,大同里,371,1505,548,251,799,46,845
公投第１２案,桃園市,八德區,大慶里,372,1436,401,262,663,39,702
公投第１２案,桃園市,八德區,大成里,373,1618,441,388,829,54,883
公投第１２案,桃園市,八德區,大成里,374,1685,528,279,807,52,859
公投第１２案,桃園市,八德區,大義里,375,1835,558,249,807,46,853
公投第１２案,桃園市,八德區,大義里,376,1881,526,382,908,43,951
公投第１２案,桃園市,八德區,大忠里,377,1766,502,323,825,45,870
公投第１２案,桃園市,八德區,大智里,378,1817,522,328,850,79,929
公投第１２案,桃園市,八德區,大智里,379,2198,681,426,1107,27,1134
公投第１２案,桃園市,八德區,大宏里,380,1732,488,383,871,32,903
公投第１２案,桃園市,八德區,大宏里,381,2089,619,444,1063,17,1080
公投第１２案,桃園市,八德區,大正里,382,1257,420,272,692,33,725
公投第１２案,桃園市,八德區,大正里,383,1267,357,266,623,34,657
公投第１２案,桃園市,八德區,大正里,384,1427,467,290,757,22,779
公投第１２案,桃園市,八德區,大福里,385,1685,575,347,922,53,975
公投第１２案,桃園市,八德區,大福里,386,1748,556,350,906,40,946
公投第１２案,桃園市,八德區,大福里,387,1650,743,336,1079,51,1130
公投第１２案,桃園市,八德區,大強里,388,1478,426,340,766,41,807
公投第１２案,桃園市,八德區,大強里,389,1607,512,309,821,45,866
公投第１２案,桃園市,八德區,大勇里,390,1841,583,387,970,53,1023
公投第１２案,桃園市,八德區,大勇里,391,2082,596,431,1027,41,1068
公投第１２案,桃園市,八德區,大榮里,392,1959,530,337,867,51,918
公投第１２案,桃園市,八德區,大千里,393,2209,605,483,1088,49,1137
公投第１２案,桃園市,八德區,大漢里,394,1864,582,350,932,43,975
公投第１２案,桃園市,八德區,大漢里,395,2000,528,405,933,38,971
公投第１２案,桃園市,蘆竹區,新興里,396,1358,393,249,642,74,716
公投第１２案,桃園市,蘆竹區,新興里,397,1538,440,285,725,51,776
公投第１２案,桃園市,蘆竹區,中福里,398,2118,532,322,854,49,903
公投第１２案,桃園市,蘆竹區,中福里,399,1673,536,343,879,62,941
公投第１２案,桃園市,蘆竹區,上興里,400,1500,482,369,851,30,881
公投第１２案,桃園市,蘆竹區,上興里,401,1699,546,325,871,38,909
公投第１２案,桃園市,蘆竹區,中興里,402,2250,696,426,1122,27,1149
公投第１２案,桃園市,蘆竹區,中興里,403,2354,614,424,1038,15,1053
公投第１２案,桃園市,蘆竹區,新莊里,404,1446,391,302,693,26,719
公投第１２案,桃園市,蘆竹區,新莊里,405,1623,445,293,738,39,777
公投第１２案,桃園市,蘆竹區,新莊里,406,1747,509,328,837,28,865
公投第１２案,桃園市,蘆竹區,上竹里,407,1988,600,384,984,42,1026
公投第１２案,桃園市,蘆竹區,上竹里,408,1437,470,258,728,33,761
公投第１２案,桃園市,蘆竹區,宏竹里,409,1532,487,337,824,39,863
公投第１２案,桃園市,蘆竹區,宏竹里,410,1447,397,312,709,37,746
公投第１２案,桃園市,蘆竹區,大竹里,411,2189,665,423,1088,39,1127
公投第１２案,桃園市,蘆竹區,大竹里,412,2498,709,428,1137,40,1177
公投第１２案,桃園市,蘆竹區,富竹里,413,1322,406,289,695,30,725
公投第１２案,桃園市,蘆竹區,蘆竹里,414,1991,455,330,785,72,857
公投第１２案,桃園市,蘆竹區,蘆竹里,415,2097,539,379,918,70,988
公投第１２案,桃園市,蘆竹區,南興里,416,1558,500,322,822,31,853
公投第１２案,桃園市,蘆竹區,南興里,417,1891,400,563,963,31,994
公投第１２案,桃園市,蘆竹區,南興里,418,1590,472,278,750,23,773
公投第１２案,桃園市,蘆竹區,福昌里,419,2404,625,420,1045,39,1084
公投第１２案,桃園市,蘆竹區,福昌里,420,2522,736,481,1217,32,1249
公投第１２案,桃園市,蘆竹區,福興里,421,1633,484,329,813,29,842
公投第１２案,桃園市,蘆竹區,福興里,422,1715,520,331,851,37,888
公投第１２案,桃園市,蘆竹區,正興里,423,2215,616,398,1014,20,1034
公投第１２案,桃園市,蘆竹區,正興里,424,2029,548,365,913,40,953
公投第１２案,桃園市,蘆竹區,順興里,425,1731,472,317,789,25,814
公投第１２案,桃園市,蘆竹區,順興里,426,1820,551,341,892,32,924
公投第１２案,桃園市,蘆竹區,蘆興里,427,1633,500,345,845,37,882
公投第１２案,桃園市,蘆竹區,南榮里,428,1668,501,283,784,19,803
公投第１２案,桃園市,蘆竹區,南榮里,429,1493,477,314,791,21,812
公投第１２案,桃園市,蘆竹區,南崁里,430,1864,577,369,946,32,978
公投第１２案,桃園市,蘆竹區,南崁里,431,1703,472,338,810,29,839
公投第１２案,桃園市,蘆竹區,錦興里,432,1893,564,398,962,21,983
公投第１２案,桃園市,蘆竹區,錦興里,433,1922,648,387,1035,27,1062
公投第１２案,桃園市,蘆竹區,興榮里,434,1393,484,260,744,16,760
公投第１２案,桃園市,蘆竹區,興榮里,435,1338,440,280,720,19,739
公投第１２案,桃園市,蘆竹區,錦中里,436,1688,530,298,828,27,855
公投第１２案,桃園市,蘆竹區,錦中里,437,1462,440,266,706,46,752
公投第１２案,桃園市,蘆竹區,長興里,438,1232,354,275,629,22,651
公投第１２案,桃園市,蘆竹區,長興里,439,1356,365,255,620,25,645
公投第１２案,桃園市,蘆竹區,五福里,440,1181,418,263,681,37,718
公投第１２案,桃園市,蘆竹區,五福里,441,1199,343,247,590,21,611
公投第１２案,桃園市,蘆竹區,中山里,442,1710,545,340,885,19,904
公投第１２案,桃園市,蘆竹區,中山里,443,1423,394,295,689,24,713
公投第１２案,桃園市,蘆竹區,福祿里,444,1522,457,337,794,24,818
公投第１２案,桃園市,蘆竹區,福祿里,445,1639,547,325,872,26,898
公投第１２案,桃園市,蘆竹區,羊稠里,446,2055,606,387,993,36,1029
公投第１２案,桃園市,蘆竹區,羊稠里,447,2178,611,457,1068,22,1090
公投第１２案,桃園市,蘆竹區,吉祥里,448,1709,521,374,895,23,918
公投第１２案,桃園市,蘆竹區,長壽里,449,1667,547,329,876,42,918
公投第１２案,桃園市,蘆竹區,長壽里,450,1745,590,339,929,16,945
公投第１２案,桃園市,蘆竹區,長壽里,451,1967,632,411,1043,33,1076
公投第１２案,桃園市,蘆竹區,吉祥里,452,1802,640,341,981,29,1010
公投第１２案,桃園市,蘆竹區,營盤里,453,2727,813,482,1295,29,1324
公投第１２案,桃園市,蘆竹區,營盤里,454,1868,507,357,864,24,888
公投第１２案,桃園市,蘆竹區,營福里,455,1537,449,300,749,34,783
公投第１２案,桃園市,蘆竹區,營福里,456,1616,470,352,822,27,849
公投第１２案,桃園市,蘆竹區,瓦窯里,457,1483,509,323,832,27,859
公投第１２案,桃園市,蘆竹區,瓦窯里,458,1689,492,317,809,38,847
公投第１２案,桃園市,蘆竹區,內厝里,459,1318,354,181,535,33,568
公投第１２案,桃園市,蘆竹區,內厝里,460,1203,435,244,679,88,767
公投第１２案,桃園市,蘆竹區,山鼻里,461,1771,509,307,816,28,844
公投第１２案,桃園市,蘆竹區,山腳里,462,1832,482,347,829,47,876
公投第１２案,桃園市,蘆竹區,山腳里,463,1763,505,331,836,54,890
公投第１２案,桃園市,蘆竹區,外社里,464,1497,379,281,660,19,679
公投第１２案,桃園市,蘆竹區,坑子里,465,1671,494,401,895,98,993
公投第１２案,桃園市,蘆竹區,坑口里,466,929,283,213,496,41,537
公投第１２案,桃園市,蘆竹區,坑口里,467,1559,501,325,826,54,880
公投第１２案,桃園市,蘆竹區,海湖里,468,1497,527,265,792,21,813
公投第１２案,桃園市,蘆竹區,海湖里,469,1441,551,316,867,45,912
公投第１２案,桃園市,蘆竹區,濱海里,470,1465,406,300,706,45,751
公投第１２案,桃園市,蘆竹區,濱海里,471,1029,291,215,506,29,535
公投第１２案,桃園市,大園區,大園里,472,1538,393,287,680,30,710
公投第１２案,桃園市,大園區,大園里,473,1616,362,284,646,19,665
公投第１２案,桃園市,大園區,大園里,474,1437,450,326,776,38,814
公投第１２案,桃園市,大園區,大園里,475,1554,518,312,830,31,861
公投第１２案,桃園市,大園區,田心里,476,1237,346,270,616,27,643
公投第１２案,桃園市,大園區,田心里,477,1347,382,265,647,48,695
公投第１２案,桃園市,大園區,田心里,478,1261,359,274,633,24,657
公投第１２案,桃園市,大園區,田心里,479,1256,354,258,612,26,638
公投第１２案,桃園市,大園區,田心里,480,1370,339,283,622,27,649
公投第１２案,桃園市,大園區,溪海里,481,1610,382,327,709,37,746
公投第１２案,桃園市,大園區,溪海里,482,1419,407,267,674,39,713
公投第１２案,桃園市,大園區,溪海里,483,1588,393,236,629,32,661
公投第１２案,桃園市,大園區,和平里,484,1612,432,338,770,45,815
公投第１２案,桃園市,大園區,橫峰里,485,1440,382,297,679,40,719
公投第１２案,桃園市,大園區,橫峰里,486,1326,339,275,614,36,650
公投第１２案,桃園市,大園區,橫峰里,487,1455,474,299,773,48,821
公投第１２案,桃園市,大園區,橫峰里,488,1562,452,349,801,40,841
公投第１２案,桃園市,大園區,橫峰里,489,1284,412,291,703,28,731
公投第１２案,桃園市,大園區,橫峰里,490,1454,371,305,676,14,690
公投第１２案,桃園市,大園區,橫峰里,491,1490,432,306,738,21,759
公投第１２案,桃園市,大園區,五權里,492,1617,459,284,743,32,775
公投第１２案,桃園市,大園區,五權里,493,1594,465,337,802,32,834
公投第１２案,桃園市,大園區,五權里,494,1650,461,331,792,49,841
公投第１２案,桃園市,大園區,埔心里,495,1467,397,307,704,15,719
公投第１２案,桃園市,大園區,埔心里,496,1494,428,312,740,29,769
公投第１２案,桃園市,大園區,埔心里,497,1538,431,319,750,34,784
公投第１２案,桃園市,大園區,埔心里,498,1397,394,307,701,24,725
公投第１２案,桃園市,大園區,大海里,499,1637,455,309,764,23,787
公投第１２案,桃園市,大園區,三石里,500,1452,396,273,669,33,702
公投第１２案,桃園市,大園區,三石里,501,1414,515,313,828,48,876
公投第１２案,桃園市,大園區,菓林里,502,1670,530,304,834,32,866
公投第１２案,桃園市,大園區,菓林里,503,1701,503,301,804,16,820
公投第１２案,桃園市,大園區,菓林里,504,1813,491,292,783,21,804
公投第１２案,桃園市,大園區,菓林里,505,1687,457,338,795,24,819
公投第１２案,桃園市,大園區,竹圍里,506,1650,509,331,840,5,845
公投第１２案,桃園市,大園區,竹圍里,507,1556,481,359,840,44,884
公投第１２案,桃園市,大園區,海口里,508,1844,440,360,800,27,827
公投第１２案,桃園市,大園區,沙崙里,509,1336,353,251,604,49,653
公投第１２案,桃園市,大園區,沙崙里,510,1414,421,329,750,38,788
公投第１２案,桃園市,大園區,後厝里,511,1238,421,302,723,35,758
公投第１２案,桃園市,大園區,後厝里,512,1227,424,281,705,35,740
公投第１２案,桃園市,大園區,圳頭里,513,1199,319,278,597,24,621
公投第１２案,桃園市,大園區,圳頭里,514,1349,347,262,609,24,633
公投第１２案,桃園市,大園區,內海里,515,1120,308,240,548,31,579
公投第１２案,桃園市,大園區,內海里,516,1080,302,253,555,22,577
公投第１２案,桃園市,大園區,北港里,517,1341,379,247,626,34,660
公投第１２案,桃園市,大園區,北港里,518,1345,383,307,690,23,713
公投第１２案,桃園市,大園區,南港里,519,1565,391,281,672,34,706
公投第１２案,桃園市,大園區,南港里,520,1519,354,274,628,32,660
公投第１２案,桃園市,大園區,南港里,521,2130,547,387,934,42,976
公投第１２案,桃園市,大溪區,興和里,522,1477,455,346,801,36,837
公投第１２案,桃園市,大溪區,福仁里,523,1006,325,208,533,29,562
公投第１２案,桃園市,大溪區,田心里,524,1553,456,303,759,54,813
公投第１２案,桃園市,大溪區,田心里,525,1597,448,362,810,61,871
公投第１２案,桃園市,大溪區,田心里,526,1358,424,270,694,35,729
公投第１２案,桃園市,大溪區,一心里,527,1585,452,273,725,37,762
公投第１２案,桃園市,大溪區,一心里,528,1612,459,338,797,39,836
公投第１２案,桃園市,大溪區,一心里,529,1555,416,289,705,25,730
公投第１２案,桃園市,大溪區,一德里,530,1282,419,319,738,36,774
公投第１２案,桃園市,大溪區,一德里,531,1392,419,259,678,54,732
公投第１２案,桃園市,大溪區,一德里,532,1422,393,284,677,44,721
公投第１２案,桃園市,大溪區,一德里,533,1448,423,314,737,55,792
公投第１２案,桃園市,大溪區,月眉里,534,1269,411,318,729,49,778
公投第１２案,桃園市,大溪區,永福里,535,977,330,211,541,51,592
公投第１２案,桃園市,大溪區,康安里,536,1359,400,326,726,45,771
公投第１２案,桃園市,大溪區,義和里,537,1135,339,291,630,60,690
公投第１２案,桃園市,大溪區,義和里,538,660,177,137,314,38,352
公投第１２案,桃園市,大溪區,美華里,539,1056,262,222,484,48,532
公投第１２案,桃園市,大溪區,美華里,540,1263,381,229,610,42,652
公投第１２案,桃園市,大溪區,美華里,541,717,199,170,369,31,400
公投第１２案,桃園市,大溪區,福安里,542,1299,291,250,541,23,564
公投第１２案,桃園市,大溪區,福安里,543,976,298,193,491,50,541
公投第１２案,桃園市,大溪區,復興里,544,938,274,198,472,36,508
公投第１２案,桃園市,大溪區,新峰里,545,832,259,153,412,20,432
公投第１２案,桃園市,大溪區,中新里,546,866,206,175,381,23,404
公投第１２案,桃園市,大溪區,中新里,547,694,182,135,317,30,347
公投第１２案,桃園市,大溪區,瑞興里,548,1410,395,264,659,51,710
公投第１２案,桃園市,大溪區,瑞興里,549,1303,360,244,604,48,652
公投第１２案,桃園市,大溪區,仁善里,550,1125,316,241,557,33,590
公投第１２案,桃園市,大溪區,仁善里,551,1170,343,274,617,27,644
公投第１２案,桃園市,大溪區,仁善里,552,1308,436,296,732,32,764
公投第１２案,桃園市,大溪區,仁美里,553,1094,317,256,573,36,609
公投第１２案,桃園市,大溪區,仁美里,554,2153,690,416,1106,43,1149
公投第１２案,桃園市,大溪區,僑愛里,555,1173,459,191,650,38,688
公投第１２案,桃園市,大溪區,僑愛里,556,1369,430,251,681,21,702
公投第１２案,桃園市,大溪區,仁義里,557,1446,443,258,701,43,744
公投第１２案,桃園市,大溪區,仁義里,558,1406,400,193,593,38,631
公投第１２案,桃園市,大溪區,仁和里,559,1592,531,312,843,20,863
公投第１２案,桃園市,大溪區,仁和里,560,1497,487,330,817,40,857
公投第１２案,桃園市,大溪區,仁和里,561,1559,484,341,825,60,885
公投第１２案,桃園市,大溪區,仁愛里,562,1684,508,328,836,29,865
公投第１２案,桃園市,大溪區,仁愛里,563,1959,648,375,1023,53,1076
公投第１２案,桃園市,大溪區,仁愛里,564,1369,481,265,746,34,780
公投第１２案,桃園市,大溪區,仁武里,565,1431,424,327,751,53,804
公投第１２案,桃園市,大溪區,仁武里,566,1657,417,246,663,25,688
公投第１２案,桃園市,大溪區,仁文里,567,1387,387,217,604,22,626
公投第１２案,桃園市,大溪區,仁文里,568,1085,340,216,556,21,577
公投第１２案,桃園市,大溪區,仁文里,569,1403,501,260,761,28,789
公投第１２案,桃園市,大溪區,南興里,570,1511,422,292,714,70,784
公投第１２案,桃園市,大溪區,南興里,571,1719,410,323,733,69,802
公投第１２案,桃園市,大溪區,南興里,572,1717,423,306,729,64,793
公投第１２案,桃園市,大溪區,光明里,573,1207,353,227,580,70,650
公投第１２案,桃園市,大溪區,光明里,574,1188,417,210,627,48,675
公投第１２案,桃園市,大溪區,員林里,575,1514,450,283,733,21,754
公投第１２案,桃園市,大溪區,三元里,576,1529,539,272,811,49,860
公投第１２案,桃園市,大溪區,三元里,577,1260,469,245,714,30,744
公投第１２案,桃園市,大溪區,瑞源里,578,831,302,171,473,14,487
公投第１２案,桃園市,大溪區,瑞源里,579,1407,445,291,736,44,780
公投第１２案,桃園市,大溪區,瑞源里,580,1494,434,284,718,42,760
公投第１２案,桃園市,復興區,三民里,581,1991,691,368,1059,70,1129
公投第１２案,桃園市,復興區,澤仁里,582,1392,495,244,739,61,800
公投第１２案,桃園市,復興區,霞雲里,583,564,210,118,328,9,337
公投第１２案,桃園市,復興區,義盛里,584,716,258,152,410,19,429
公投第１２案,桃園市,復興區,羅浮里,585,1016,384,220,604,45,649
公投第１２案,桃園市,復興區,長興里,586,669,180,125,305,9,314
公投第１２案,桃園市,復興區,奎輝里,587,760,251,128,379,16,395
公投第１２案,桃園市,復興區,高義里,588,751,258,164,422,17,439
公投第１２案,桃園市,復興區,三光里,589,683,250,131,381,15,396
公投第１２案,桃園市,復興區,華陵里,590,1224,535,155,690,24,714
公投第１２案,桃園市,中壢區,後寮里,591,1401,443,277,720,24,744
公投第１２案,桃園市,中壢區,後寮里,592,1798,508,349,857,43,900
公投第１２案,桃園市,中壢區,後寮里,593,1642,450,299,749,30,779
公投第１２案,桃園市,中壢區,明德里,594,1670,531,321,852,39,891
公投第１２案,桃園市,中壢區,明德里,595,1456,466,304,770,37,807
公投第１２案,桃園市,中壢區,明德里,596,1531,584,298,882,39,921
公投第１２案,桃園市,中壢區,至善里,597,1623,574,329,903,27,930
公投第１２案,桃園市,中壢區,至善里,598,1953,561,311,872,25,897
公投第１２案,桃園市,中壢區,龍慈里,599,1155,409,230,639,25,664
公投第１２案,桃園市,中壢區,龍慈里,600,1800,528,283,811,27,838
公投第１２案,桃園市,中壢區,龍慈里,601,1757,523,305,828,22,850
公投第１２案,桃園市,中壢區,龍興里,602,1281,480,230,710,43,753
公投第１２案,桃園市,中壢區,龍興里,603,1462,499,309,808,24,832
公投第１２案,桃園市,中壢區,龍興里,604,1560,471,255,726,40,766
公投第１２案,桃園市,中壢區,龍德里,605,1602,589,333,922,19,941
公投第１２案,桃園市,中壢區,龍德里,606,1006,406,217,623,24,647
公投第１２案,桃園市,中壢區,龍德里,607,1474,522,287,809,30,839
公投第１２案,桃園市,中壢區,龍岡里,608,1627,530,299,829,56,885
公投第１２案,桃園市,中壢區,龍岡里,609,1519,512,315,827,32,859
公投第１２案,桃園市,中壢區,龍岡里,610,1526,484,316,800,44,844
公投第１２案,桃園市,中壢區,龍東里,611,1618,529,298,827,46,873
公投第１２案,桃園市,中壢區,龍東里,612,1554,584,288,872,34,906
公投第１２案,桃園市,中壢區,龍東里,613,1706,577,296,873,50,923
公投第１２案,桃園市,中壢區,龍昌里,614,1818,617,373,990,43,1033
公投第１２案,桃園市,中壢區,龍昌里,615,1991,607,358,965,35,1000
公投第１２案,桃園市,中壢區,龍昌里,616,1609,538,299,837,28,865
公投第１２案,桃園市,中壢區,龍平里,617,1329,410,216,626,32,658
公投第１２案,桃園市,中壢區,龍平里,618,1587,473,264,737,58,795
公投第１２案,桃園市,中壢區,仁美里,619,1955,596,391,987,27,1014
公投第１２案,桃園市,中壢區,仁美里,620,1711,476,364,840,46,886
公投第１２案,桃園市,中壢區,仁美里,621,1712,533,307,840,37,877
公投第１２案,桃園市,中壢區,仁福里,622,1448,492,313,805,32,837
公投第１２案,桃園市,中壢區,仁福里,623,1605,470,322,792,30,822
公投第１２案,桃園市,中壢區,仁福里,624,1633,458,309,767,15,782
公投第１２案,桃園市,中壢區,華愛里,625,1795,642,367,1009,51,1060
公投第１２案,桃園市,中壢區,華愛里,626,1689,518,362,880,35,915
公投第１２案,桃園市,中壢區,普仁里,627,1201,392,258,650,23,673
公投第１２案,桃園市,中壢區,普仁里,628,1353,437,256,693,34,727
公投第１２案,桃園市,中壢區,普仁里,629,1587,462,307,769,28,797
公投第１２案,桃園市,中壢區,普忠里,630,1883,703,260,963,34,997
公投第１２案,桃園市,中壢區,普忠里,631,1448,485,242,727,20,747
公投第１２案,桃園市,中壢區,普強里,632,1810,535,387,922,30,952
公投第１２案,桃園市,中壢區,普強里,633,1916,599,335,934,49,983
公投第１２案,桃園市,中壢區,普慶里,634,1177,433,230,663,21,684
公投第１２案,桃園市,中壢區,普慶里,635,1410,494,302,796,45,841
公投第１２案,桃園市,中壢區,信義里,636,1368,441,261,702,24,726
公投第１２案,桃園市,中壢區,信義里,637,1424,548,290,838,28,866
公投第１２案,桃園市,中壢區,信義里,638,1573,532,327,859,21,880
公投第１２案,桃園市,中壢區,正義里,639,1152,394,142,536,24,560
公投第１２案,桃園市,中壢區,正義里,640,1178,379,269,648,21,669
公投第１２案,桃園市,中壢區,正義里,641,1966,631,359,990,43,1033
公投第１２案,桃園市,中壢區,普義里,642,3474,404,281,685,34,719
公投第１２案,桃園市,中壢區,普義里,643,2099,654,435,1089,46,1135
公投第１２案,桃園市,中壢區,德義里,644,1178,379,255,634,27,661
公投第１２案,桃園市,中壢區,德義里,645,1397,476,337,813,42,855
公投第１２案,桃園市,中壢區,仁義里,646,1669,477,411,888,37,925
公投第１２案,桃園市,中壢區,仁義里,647,2087,578,401,979,43,1022
公投第１２案,桃園市,中壢區,忠義里,648,1900,536,414,950,34,984
公投第１２案,桃園市,中壢區,忠義里,649,1640,432,268,700,19,719
公投第１２案,桃園市,中壢區,龍安里,650,994,359,209,568,27,595
公投第１２案,桃園市,中壢區,龍安里,651,1131,446,246,692,36,728
公投第１２案,桃園市,中壢區,仁愛里,652,1625,559,369,928,26,954
公投第１２案,桃園市,中壢區,仁愛里,653,1384,487,334,821,40,861
公投第１２案,桃園市,中壢區,仁德里,654,1588,508,313,821,39,860
公投第１２案,桃園市,中壢區,仁德里,655,1445,508,257,765,28,793
公投第１２案,桃園市,中壢區,仁和里,656,1743,464,299,763,47,810
公投第１２案,桃園市,中壢區,仁和里,657,1812,524,312,836,25,861
公投第１２案,桃園市,中壢區,仁祥里,658,1546,437,316,753,37,790
公投第１２案,桃園市,中壢區,仁祥里,659,1290,452,201,653,33,686
公投第１２案,桃園市,中壢區,華勛里,660,2145,608,380,988,60,1048
公投第１２案,桃園市,中壢區,華勛里,661,1451,404,287,691,27,718
公投第１２案,桃園市,中壢區,中堅里,662,1489,488,266,754,26,780
公投第１２案,桃園市,中壢區,中堅里,663,827,263,174,437,25,462
公投第１２案,桃園市,中壢區,中堅里,664,1442,423,258,681,40,721
公投第１２案,桃園市,中壢區,興仁里,665,1842,544,312,856,25,881
公投第１２案,桃園市,中壢區,興仁里,666,1520,446,262,708,35,743
公投第１２案,桃園市,中壢區,中正里,667,1764,470,317,787,34,821
公投第１２案,桃園市,中壢區,中正里,668,1488,517,297,814,11,825
公投第１２案,桃園市,中壢區,中正里,669,1593,501,317,818,32,850
公投第１２案,桃園市,中壢區,中山里,670,1505,446,329,775,28,803
公投第１２案,桃園市,中壢區,中山里,671,1661,515,325,840,28,868
公投第１２案,桃園市,中壢區,中山里,672,1492,486,320,806,28,834
公投第１２案,桃園市,中壢區,篤行里,673,1249,330,257,587,32,619
公投第１２案,桃園市,中壢區,篤行里,674,1257,417,264,681,22,703
公投第１２案,桃園市,中壢區,自強里,675,1659,489,328,817,47,864
公投第１２案,桃園市,中壢區,自強里,676,1815,605,363,968,23,991
公投第１２案,桃園市,中壢區,中興里,677,1702,487,349,836,33,869
公投第１２案,桃園市,中壢區,中興里,678,1541,476,315,791,23,814
公投第１２案,桃園市,中壢區,自立里,679,1659,550,248,798,25,823
公投第１２案,桃園市,中壢區,自立里,680,1874,614,302,916,47,963
公投第１２案,桃園市,中壢區,自立里,681,1603,550,229,779,26,805
公投第１２案,桃園市,中壢區,自信里,682,1735,512,330,842,38,880
公投第１２案,桃園市,中壢區,自信里,683,1815,555,340,895,26,921
公投第１２案,桃園市,中壢區,自信里,684,1873,453,469,922,29,951
公投第１２案,桃園市,中壢區,莊敬里,685,1739,590,333,923,46,969
公投第１２案,桃園市,中壢區,莊敬里,686,1709,519,294,813,39,852
公投第１２案,桃園市,中壢區,自治里,687,1655,540,335,875,36,911
公投第１２案,桃園市,中壢區,自治里,688,1664,555,300,855,35,890
公投第１２案,桃園市,中壢區,內壢里,689,1087,344,181,525,22,547
公投第１２案,桃園市,中壢區,內壢里,690,1065,342,192,534,47,581
公投第１２案,桃園市,中壢區,成功里,691,1844,609,342,951,51,1002
公投第１２案,桃園市,中壢區,成功里,692,1220,335,225,560,31,591
公投第１２案,桃園市,中壢區,成功里,693,1219,359,276,635,22,657
公投第１２案,桃園市,中壢區,福德里,694,1260,392,267,659,40,699
公投第１２案,桃園市,中壢區,福德里,695,1594,562,329,891,37,928
公投第１２案,桃園市,中壢區,中原里,696,1733,497,377,874,61,935
公投第１２案,桃園市,中壢區,中原里,697,1979,614,394,1008,40,1048
公投第１２案,桃園市,中壢區,忠孝里,698,1621,504,363,867,25,892
公投第１２案,桃園市,中壢區,忠孝里,699,1391,476,282,758,28,786
公投第１２案,桃園市,中壢區,忠孝里,700,1531,521,314,835,15,850
公投第１２案,桃園市,中壢區,復興里,701,1943,574,330,904,38,942
公投第１２案,桃園市,中壢區,復興里,702,1363,421,274,695,24,719
公投第１２案,桃園市,中壢區,復興里,703,2172,602,333,935,47,982
公投第１２案,桃園市,中壢區,復興里,704,1798,565,283,848,31,879
公投第１２案,桃園市,中壢區,復興里,705,1671,512,305,817,14,831
公投第１２案,桃園市,中壢區,復華里,706,1969,589,354,943,36,979
公投第１２案,桃園市,中壢區,復華里,707,1563,592,354,946,38,984
公投第１２案,桃園市,中壢區,復華里,708,1762,591,361,952,28,980
公投第１２案,桃園市,中壢區,文化里,709,1923,481,311,792,36,828
公投第１２案,桃園市,中壢區,文化里,710,1572,520,343,863,37,900
公投第１２案,桃園市,中壢區,文化里,711,1850,597,385,982,32,1014
公投第１２案,桃園市,中壢區,文化里,712,1583,463,314,777,43,820
公投第１２案,桃園市,中壢區,文化里,713,1735,512,354,866,38,904
公投第１２案,桃園市,中壢區,和平里,714,1292,354,302,656,31,687
公投第１２案,桃園市,中壢區,和平里,715,1265,423,247,670,21,691
公投第１２案,桃園市,中壢區,內定里,716,1798,575,288,863,26,889
公投第１２案,桃園市,中壢區,內定里,717,1822,570,418,988,54,1042
公投第１２案,桃園市,中壢區,內定里,718,1613,494,352,846,23,869
公投第１２案,桃園市,中壢區,內定里,719,1405,404,328,732,26,758
公投第１２案,桃園市,中壢區,石頭里,720,1730,542,380,922,62,984
公投第１２案,桃園市,中壢區,中央里,721,1384,596,335,931,22,953
公投第１２案,桃園市,中壢區,中央里,722,1122,356,265,621,13,634
公投第１２案,桃園市,中壢區,中央里,723,992,346,227,573,33,606
公投第１２案,桃園市,中壢區,新興里,724,1820,531,492,1023,32,1055
公投第１２案,桃園市,中壢區,新興里,725,1847,570,322,892,35,927
公投第１２案,桃園市,中壢區,林森里,726,1302,475,247,722,40,762
公投第１２案,桃園市,中壢區,林森里,727,1203,429,238,667,33,700
公投第１２案,桃園市,中壢區,林森里,728,1226,476,281,757,31,788
公投第１２案,桃園市,中壢區,振興里,729,1234,414,284,698,37,735
公投第１２案,桃園市,中壢區,振興里,730,2023,526,387,913,41,954
公投第１２案,桃園市,中壢區,振興里,731,1555,398,321,719,27,746
公投第１２案,桃園市,中壢區,東興里,732,1951,592,351,943,38,981
公投第１２案,桃園市,中壢區,東興里,733,1383,478,303,781,33,814
公投第１２案,桃園市,中壢區,健行里,734,1164,445,226,671,34,705
公投第１２案,桃園市,中壢區,健行里,735,1482,523,268,791,31,822
公投第１２案,桃園市,中壢區,健行里,736,1770,575,340,915,31,946
公投第１２案,桃園市,中壢區,水尾里,737,1703,583,360,943,54,997
公投第１２案,桃園市,中壢區,水尾里,738,1841,576,345,921,49,970
公投第１２案,桃園市,中壢區,金華里,739,1941,627,409,1036,32,1068
公投第１２案,桃園市,中壢區,金華里,740,2029,670,408,1078,41,1119
公投第１２案,桃園市,中壢區,忠福里,741,1636,588,342,930,21,951
公投第１２案,桃園市,中壢區,忠福里,742,1528,504,336,840,33,873
公投第１２案,桃園市,中壢區,忠福里,743,2289,612,436,1048,52,1100
公投第１２案,桃園市,中壢區,忠福里,744,2020,547,393,940,28,968
公投第１２案,桃園市,中壢區,幸福里,745,2027,626,419,1045,35,1080
公投第１２案,桃園市,中壢區,幸福里,746,1883,480,340,820,18,838
公投第１２案,桃園市,中壢區,幸福里,747,2080,581,410,991,38,1029
公投第１２案,桃園市,中壢區,永福里,748,646,192,140,332,15,347
公投第１２案,桃園市,中壢區,永福里,749,1780,811,282,1093,35,1128
公投第１２案,桃園市,中壢區,永福里,750,1372,488,279,767,24,791
公投第１２案,桃園市,中壢區,永福里,751,1668,571,372,943,23,966
公投第１２案,桃園市,中壢區,青埔里,752,1987,582,400,982,16,998
公投第１２案,桃園市,中壢區,青埔里,753,1520,489,317,806,21,827
公投第１２案,桃園市,中壢區,新街里,754,852,261,179,440,28,468
公投第１２案,桃園市,中壢區,新街里,755,1209,354,284,638,31,669
公投第１２案,桃園市,中壢區,興南里,756,1481,457,297,754,53,807
公投第１２案,桃園市,中壢區,興南里,757,1564,437,292,729,17,746
公投第１２案,桃園市,中壢區,興國里,758,1957,641,392,1033,45,1078
公投第１２案,桃園市,中壢區,興平里,759,1223,419,289,708,34,742
公投第１２案,桃園市,中壢區,興平里,760,1182,428,264,692,28,720
公投第１２案,桃園市,中壢區,興和里,761,1066,351,251,602,29,631
公投第１２案,桃園市,中壢區,興和里,762,1701,576,360,936,41,977
公投第１２案,桃園市,中壢區,永興里,763,943,295,175,470,32,502
公投第１２案,桃園市,中壢區,中壢里,764,731,252,171,423,21,444
公投第１２案,桃園市,中壢區,中榮里,765,851,273,190,463,33,496
公投第１２案,桃園市,中壢區,中建里,766,1011,304,231,535,26,561
公投第１２案,桃園市,中壢區,舊明里,767,1532,486,363,849,38,887
公投第１２案,桃園市,中壢區,新明里,768,1028,325,207,532,29,561
公投第１２案,桃園市,中壢區,新明里,769,1157,405,248,653,24,677
公投第１２案,桃園市,中壢區,新明里,770,1591,451,342,793,53,846
公投第１２案,桃園市,中壢區,光明里,771,2156,585,395,980,48,1028
公投第１２案,桃園市,中壢區,光明里,772,1479,423,267,690,19,709
公投第１２案,桃園市,中壢區,光明里,773,1780,566,350,916,30,946
公投第１２案,桃園市,中壢區,永光里,774,1651,492,360,852,44,896
公投第１２案,桃園市,中壢區,永光里,775,1870,785,194,979,34,1013
公投第１２案,桃園市,中壢區,永光里,776,1913,510,343,853,25,878
公投第１２案,桃園市,中壢區,三民里,777,1609,464,268,732,36,768
公投第１２案,桃園市,中壢區,三民里,778,1539,447,301,748,25,773
公投第１２案,桃園市,中壢區,五權里,779,1426,435,300,735,28,763
公投第１２案,桃園市,中壢區,五權里,780,1618,462,301,763,27,790
公投第１２案,桃園市,中壢區,五權里,781,1441,448,310,758,29,787
公投第１２案,桃園市,中壢區,五權里,782,1528,486,328,814,28,842
公投第１２案,桃園市,中壢區,五福里,783,1683,493,359,852,47,899
公投第１２案,桃園市,中壢區,五福里,784,1945,632,386,1018,56,1074
公投第１２案,桃園市,中壢區,芝芭里,785,1534,436,333,769,44,813
公投第１２案,桃園市,中壢區,芝芭里,786,1810,508,352,860,44,904
公投第１２案,桃園市,中壢區,洽溪里,787,1097,320,194,514,48,562
公投第１２案,桃園市,中壢區,洽溪里,788,1917,508,394,902,30,932
公投第１２案,桃園市,中壢區,洽溪里,789,1858,496,421,917,40,957
公投第１２案,桃園市,中壢區,內厝里,790,1576,526,310,836,46,882
公投第１２案,桃園市,中壢區,內厝里,791,1478,474,317,791,36,827
公投第１２案,桃園市,中壢區,內厝里,792,1589,474,349,823,17,840
公投第１２案,桃園市,中壢區,月眉里,793,2037,633,423,1056,62,1118
公投第１２案,桃園市,中壢區,月眉里,794,1158,409,265,674,29,703
公投第１２案,桃園市,中壢區,月眉里,795,1967,607,409,1016,42,1058
公投第１２案,桃園市,中壢區,山東里,796,1830,536,349,885,43,928
公投第１２案,桃園市,中壢區,山東里,797,1856,599,377,976,41,1017
公投第１２案,桃園市,中壢區,過嶺里,798,2068,554,401,955,49,1004
公投第１２案,桃園市,中壢區,過嶺里,799,2152,481,372,853,41,894
公投第１２案,桃園市,中壢區,過嶺里,800,2158,563,399,962,27,989
公投第１２案,桃園市,平鎮區,平鎮里,801,1487,375,318,693,39,732
公投第１２案,桃園市,平鎮區,平鎮里,802,1453,439,284,723,42,765
公投第１２案,桃園市,平鎮區,平鎮里,803,1491,573,185,758,47,805
公投第１２案,桃園市,平鎮區,鎮興里,804,1346,375,289,664,40,704
公投第１２案,桃園市,平鎮區,鎮興里,805,1660,472,341,813,34,847
公投第１２案,桃園市,平鎮區,南勢里,806,1921,550,345,895,42,937
公投第１２案,桃園市,平鎮區,南勢里,807,1974,660,364,1024,45,1069
公投第１２案,桃園市,平鎮區,南勢里,808,1867,501,390,891,44,935
公投第１２案,桃園市,平鎮區,金星里,809,1786,582,319,901,27,928
公投第１２案,桃園市,平鎮區,金星里,810,1634,389,269,658,28,686
公投第１２案,桃園市,平鎮區,金星里,811,1080,380,211,591,23,614
公投第１２案,桃園市,平鎮區,金星里,812,1514,458,305,763,36,799
公投第１２案,桃園市,平鎮區,平安里,813,1918,508,328,836,48,884
公投第１２案,桃園市,平鎮區,平安里,814,1182,347,260,607,58,665
公投第１２案,桃園市,平鎮區,平安里,815,1667,457,320,777,27,804
公投第１２案,桃園市,平鎮區,平南里,816,1640,448,186,634,31,665
公投第１２案,桃園市,平鎮區,平南里,817,1603,477,321,798,34,832
公投第１２案,桃園市,平鎮區,平南里,818,1556,529,335,864,11,875
公投第１２案,桃園市,平鎮區,平南里,819,1697,527,308,835,30,865
公投第１２案,桃園市,平鎮區,山峰里,820,1130,356,210,566,19,585
公投第１２案,桃園市,平鎮區,山峰里,821,1196,421,210,631,27,658
公投第１２案,桃園市,平鎮區,福林里,822,1685,523,338,861,29,890
公投第１２案,桃園市,平鎮區,福林里,823,1532,500,336,836,25,861
公投第１２案,桃園市,平鎮區,湧光里,824,1564,491,316,807,33,840
公投第１２案,桃園市,平鎮區,湧光里,825,1824,524,273,797,37,834
公投第１２案,桃園市,平鎮區,湧光里,826,1912,562,362,924,20,944
公投第１２案,桃園市,平鎮區,莊敬里,827,1048,331,182,513,51,564
公投第１２案,桃園市,平鎮區,莊敬里,828,1259,444,227,671,36,707
公投第１２案,桃園市,平鎮區,莊敬里,829,1061,333,207,540,28,568
公投第１２案,桃園市,平鎮區,莊敬里,830,1072,408,211,619,24,643
公投第１２案,桃園市,平鎮區,湧豐里,831,1788,543,333,876,55,931
公投第１２案,桃園市,平鎮區,湧安里,832,1510,468,303,771,26,797
公投第１２案,桃園市,平鎮區,湧安里,833,1403,444,253,697,41,738
公投第１２案,桃園市,平鎮區,湧安里,834,1407,445,284,729,38,767
公投第１２案,桃園市,平鎮區,宋屋里,835,1901,589,394,983,33,1016
公投第１２案,桃園市,平鎮區,宋屋里,836,1994,561,346,907,27,934
公投第１２案,桃園市,平鎮區,平興里,837,1730,518,346,864,38,902
公投第１２案,桃園市,平鎮區,平興里,838,1905,598,377,975,34,1009
公投第１２案,桃園市,平鎮區,平興里,839,1723,605,328,933,16,949
公投第１２案,桃園市,平鎮區,廣興里,840,1307,458,240,698,36,734
公投第１２案,桃園市,平鎮區,廣興里,841,1337,426,295,721,27,748
公投第１２案,桃園市,平鎮區,廣興里,842,980,363,252,615,25,640
公投第１２案,桃園市,平鎮區,廣興里,843,1818,550,345,895,39,934
公投第１２案,桃園市,平鎮區,廣達里,844,1463,462,308,770,37,807
公投第１２案,桃園市,平鎮區,廣達里,845,1213,439,263,702,25,727
公投第１２案,桃園市,平鎮區,廣達里,846,1085,373,237,610,32,642
公投第１２案,桃園市,平鎮區,廣仁里,847,1458,475,244,719,4,723
公投第１２案,桃園市,平鎮區,廣仁里,848,1408,453,293,746,33,779
公投第１２案,桃園市,平鎮區,廣仁里,849,1396,427,264,691,33,724
公投第１２案,桃園市,平鎮區,復旦里,850,1044,389,257,646,24,670
公投第１２案,桃園市,平鎮區,復旦里,851,1124,406,210,616,16,632
公投第１２案,桃園市,平鎮區,復旦里,852,1517,483,326,809,22,831
公投第１２案,桃園市,平鎮區,復旦里,853,1571,487,327,814,16,830
公投第１２案,桃園市,平鎮區,復興里,854,1752,600,372,972,32,1004
公投第１２案,桃園市,平鎮區,復興里,855,1434,535,302,837,30,867
公投第１２案,桃園市,平鎮區,復興里,856,1710,578,379,957,22,979
公投第１２案,桃園市,平鎮區,義民里,857,1555,535,302,837,36,873
公投第１２案,桃園市,平鎮區,義民里,858,2051,603,366,969,25,994
公投第１２案,桃園市,平鎮區,義民里,859,1477,440,327,767,23,790
公投第１２案,桃園市,平鎮區,義興里,860,1501,494,311,805,17,822
公投第１２案,桃園市,平鎮區,義興里,861,1405,451,300,751,36,787
公投第１２案,桃園市,平鎮區,義興里,862,1656,500,326,826,50,876
公投第１２案,桃園市,平鎮區,義興里,863,1921,529,358,887,23,910
公投第１２案,桃園市,平鎮區,雙連里,864,1717,498,306,804,39,843
公投第１２案,桃園市,平鎮區,雙連里,865,1319,394,299,693,30,723
公投第１２案,桃園市,平鎮區,雙連里,866,1745,499,345,844,48,892
公投第１２案,桃園市,平鎮區,高雙里,867,1721,525,374,899,42,941
公投第１２案,桃園市,平鎮區,高雙里,868,1206,382,272,654,19,673
公投第１２案,桃園市,平鎮區,高雙里,869,1202,546,204,750,32,782
公投第１２案,桃園市,平鎮區,北勢里,870,1208,407,269,676,29,705
公投第１２案,桃園市,平鎮區,北勢里,871,1267,448,289,737,30,767
公投第１２案,桃園市,平鎮區,北華里,872,1094,371,215,586,27,613
公投第１２案,桃園市,平鎮區,北華里,873,1394,476,301,777,47,824
公投第１２案,桃園市,平鎮區,北華里,874,1215,426,281,707,26,733
公投第１２案,桃園市,平鎮區,新勢里,875,1010,364,203,567,23,590
公投第１２案,桃園市,平鎮區,新勢里,876,1261,430,269,699,28,727
公投第１２案,桃園市,平鎮區,新勢里,877,1314,473,272,745,28,773
公投第１２案,桃園市,平鎮區,北安里,878,722,248,142,390,32,422
公投第１２案,桃園市,平鎮區,北安里,879,839,273,154,427,23,450
公投第１２案,桃園市,平鎮區,新榮里,880,1399,454,292,746,31,777
公投第１２案,桃園市,平鎮區,新榮里,881,1968,560,384,944,44,988
公投第１２案,桃園市,平鎮區,新榮里,882,1672,526,342,868,31,899
公投第１２案,桃園市,平鎮區,新富里,883,2213,388,239,627,23,650
公投第１２案,桃園市,平鎮區,新富里,884,949,323,244,567,26,593
公投第１２案,桃園市,平鎮區,新富里,885,1621,546,379,925,39,964
公投第１２案,桃園市,平鎮區,新富里,886,1643,393,424,817,23,840
公投第１２案,桃園市,平鎮區,新英里,887,1844,589,388,977,36,1013
公投第１２案,桃園市,平鎮區,新英里,888,1752,532,372,904,38,942
公投第１２案,桃園市,平鎮區,新貴里,889,1577,433,308,741,49,790
公投第１２案,桃園市,平鎮區,新貴里,890,1517,446,361,807,29,836
公投第１２案,桃園市,平鎮區,北興里,891,1039,318,264,582,32,614
公投第１２案,桃園市,平鎮區,北興里,892,1318,452,294,746,31,777
公投第１２案,桃園市,平鎮區,北興里,893,1636,500,346,846,26,872
公投第１２案,桃園市,平鎮區,金陵里,894,1316,421,283,704,32,736
公投第１２案,桃園市,平鎮區,金陵里,895,1474,453,365,818,18,836
公投第１２案,桃園市,平鎮區,北貴里,896,1480,384,281,665,44,709
公投第１２案,桃園市,平鎮區,北貴里,897,1330,425,252,677,18,695
公投第１２案,桃園市,平鎮區,北貴里,898,1228,388,257,645,36,681
公投第１２案,桃園市,平鎮區,北富里,899,1377,438,331,769,41,810
公投第１２案,桃園市,平鎮區,北富里,900,1198,437,267,704,27,731
公投第１２案,桃園市,平鎮區,北富里,901,1231,426,308,734,28,762
公投第１２案,桃園市,平鎮區,建安里,902,1243,404,266,670,46,716
公投第１２案,桃園市,平鎮區,建安里,903,1590,514,292,806,33,839
公投第１２案,桃園市,平鎮區,建安里,904,1366,413,289,702,37,739
公投第１２案,桃園市,平鎮區,華安里,905,1332,437,237,674,39,713
公投第１２案,桃園市,平鎮區,華安里,906,1201,335,232,567,34,601
公投第１２案,桃園市,平鎮區,華安里,907,1668,467,294,761,28,789
公投第１２案,桃園市,平鎮區,東安里,908,1351,423,243,666,40,706
公投第１２案,桃園市,平鎮區,東安里,909,1460,461,234,695,23,718
公投第１２案,桃園市,平鎮區,新安里,910,1841,573,333,906,29,935
公投第１２案,桃園市,平鎮區,新安里,911,1475,420,288,708,8,716
公投第１２案,桃園市,平鎮區,新安里,912,1011,333,196,529,31,560
公投第１２案,桃園市,平鎮區,東勢里,913,1052,290,195,485,37,522
公投第１２案,桃園市,平鎮區,東勢里,914,1154,383,286,669,38,707
公投第１２案,桃園市,平鎮區,東勢里,915,1645,480,319,799,31,830
公投第１２案,桃園市,平鎮區,東勢里,916,1539,422,291,713,72,785
公投第１２案,桃園市,平鎮區,龍恩里,917,1385,442,255,697,54,751
公投第１２案,桃園市,平鎮區,龍恩里,918,1395,483,235,718,29,747
公投第１２案,桃園市,平鎮區,東社里,919,1711,544,284,828,38,866
公投第１２案,桃園市,平鎮區,東社里,920,1631,521,265,786,51,837
公投第１２案,桃園市,平鎮區,忠貞里,921,1110,358,236,594,31,625
公投第１２案,桃園市,平鎮區,貿易里,922,1931,684,346,1030,34,1064
公投第１２案,桃園市,平鎮區,龍興里,923,1127,353,242,595,28,623
公投第１２案,桃園市,平鎮區,龍興里,924,1414,494,246,740,44,784
公投第１２案,桃園市,平鎮區,中正里,925,1609,533,279,812,39,851
公投第１２案,桃園市,楊梅區,仁美里,926,1269,401,266,667,41,708
公投第１２案,桃園市,楊梅區,仁美里,927,1246,504,239,743,33,776
公投第１２案,桃園市,楊梅區,仁美里,928,1408,508,272,780,45,825
公投第１２案,桃園市,楊梅區,埔心里,929,1434,500,268,768,43,811
公投第１２案,桃園市,楊梅區,光華里,930,1515,488,257,745,45,790
公投第１２案,桃園市,楊梅區,光華里,931,1657,502,272,774,44,818
公投第１２案,桃園市,楊梅區,金龍里,932,1137,416,200,616,25,641
公投第１２案,桃園市,楊梅區,四維里,933,2211,694,385,1079,32,1111
公投第１２案,桃園市,楊梅區,四維里,934,2008,609,357,966,44,1010
公投第１２案,桃園市,楊梅區,永平里,935,1911,623,354,977,28,1005
公投第１２案,桃園市,楊梅區,瑞塘里,936,1449,489,287,776,38,814
公投第１２案,桃園市,楊梅區,瑞塘里,937,1877,508,318,826,41,867
公投第１２案,桃園市,楊梅區,瑞塘里,938,1988,623,313,936,21,957
公投第１２案,桃園市,楊梅區,瑞坪里,939,1931,592,382,974,28,1002
公投第１２案,桃園市,楊梅區,瑞坪里,940,1938,600,327,927,37,964
公投第１２案,桃園市,楊梅區,瑞坪里,941,1677,565,293,858,21,879
公投第１２案,桃園市,楊梅區,梅溪里,942,1848,549,352,901,22,923
公投第１２案,桃園市,楊梅區,梅溪里,943,1882,601,355,956,23,979
公投第１２案,桃園市,楊梅區,瑞溪里,944,1541,394,231,625,11,636
公投第１２案,桃園市,楊梅區,瑞溪里,945,1938,575,353,928,32,960
公投第１２案,桃園市,楊梅區,金溪里,946,1562,451,258,709,18,727
公投第１２案,桃園市,楊梅區,金溪里,947,2125,633,464,1097,37,1134
公投第１２案,桃園市,楊梅區,三民里,948,1516,533,320,853,37,890
公投第１２案,桃園市,楊梅區,三民里,949,1807,575,324,899,18,917
公投第１２案,桃園市,楊梅區,楊明里,950,2101,614,353,967,36,1003
公投第１２案,桃園市,楊梅區,楊明里,951,2054,610,411,1021,42,1063
公投第１２案,桃園市,楊梅區,楊明里,952,2226,632,367,999,29,1028
公投第１２案,桃園市,楊梅區,裕成里,953,1405,488,269,757,14,771
公投第１２案,桃園市,楊梅區,裕成里,954,1843,525,322,847,26,873
公投第１２案,桃園市,楊梅區,裕新里,955,2324,593,390,983,53,1036
公投第１２案,桃園市,楊梅區,大同里,956,1713,570,310,880,25,905
公投第１２案,桃園市,楊梅區,大同里,957,1587,630,271,901,40,941
公投第１２案,桃園市,楊梅區,中山里,958,1416,517,276,793,29,822
公投第１２案,桃園市,楊梅區,中山里,959,1591,538,308,846,27,873
公投第１２案,桃園市,楊梅區,楊梅里,960,1943,600,400,1000,31,1031
公投第１２案,桃園市,楊梅區,楊梅里,961,1762,604,310,914,28,942
公投第１２案,桃園市,楊梅區,楊江里,962,1083,373,201,574,17,591
公投第１２案,桃園市,楊梅區,梅新里,963,2027,645,360,1005,43,1048
公投第１２案,桃園市,楊梅區,紅梅里,964,1274,438,259,697,38,735
公投第１２案,桃園市,楊梅區,紅梅里,965,1359,486,268,754,36,790
公投第１２案,桃園市,楊梅區,永寧里,966,2444,503,328,831,37,868
公投第１２案,桃園市,楊梅區,永寧里,967,2298,609,395,1004,28,1032
公投第１２案,桃園市,楊梅區,永寧里,968,2222,640,432,1072,24,1096
公投第１２案,桃園市,楊梅區,大平里,969,1610,519,290,809,57,866
公投第１２案,桃園市,楊梅區,大平里,970,1627,541,284,825,46,871
公投第１２案,桃園市,楊梅區,秀才里,971,1589,507,321,828,46,874
公投第１２案,桃園市,楊梅區,秀才里,972,1758,549,344,893,41,934
公投第１２案,桃園市,楊梅區,東流里,973,1776,412,321,733,40,773
公投第１２案,桃園市,楊梅區,東流里,974,1000,236,233,469,17,486
公投第１２案,桃園市,楊梅區,豐野里,975,2290,621,322,943,112,1055
公投第１２案,桃園市,楊梅區,豐野里,976,1551,433,338,771,46,817
公投第１２案,桃園市,楊梅區,富岡里,977,1861,513,378,891,46,937
公投第１２案,桃園市,楊梅區,富豐里,978,1141,280,208,488,53,541
公投第１２案,桃園市,楊梅區,富豐里,979,1785,515,309,824,43,867
公投第１２案,桃園市,楊梅區,員本里,980,1498,448,297,745,55,800
公投第１２案,桃園市,楊梅區,員本里,981,1187,311,258,569,51,620
公投第１２案,桃園市,楊梅區,三湖里,982,1270,419,246,665,46,711
公投第１２案,桃園市,楊梅區,三湖里,983,1424,434,270,704,45,749
公投第１２案,桃園市,楊梅區,頭湖里,984,1273,488,275,763,17,780
公投第１２案,桃園市,楊梅區,頭湖里,985,1534,394,298,692,36,728
公投第１２案,桃園市,楊梅區,上湖里,986,1783,425,339,764,52,816
公投第１２案,桃園市,楊梅區,上湖里,987,1709,509,27,536,31,567
公投第１２案,桃園市,楊梅區,上湖里,988,1920,516,330,846,42,888
公投第１２案,桃園市,楊梅區,上田里,989,1194,366,256,622,30,652
公投第１２案,桃園市,楊梅區,上田里,990,1408,455,292,747,17,764
公投第１２案,桃園市,楊梅區,高山里,991,1737,555,200,755,29,784
公投第１２案,桃園市,楊梅區,高山里,992,1920,591,333,924,31,955
公投第１２案,桃園市,楊梅區,高上里,993,1234,366,252,618,35,653
公投第１２案,桃園市,楊梅區,高上里,994,1491,458,319,777,53,830
公投第１２案,桃園市,楊梅區,青山里,995,2020,552,363,915,30,945
公投第１２案,桃園市,楊梅區,青山里,996,1863,495,333,828,28,856
公投第１２案,桃園市,楊梅區,高榮里,997,1692,508,360,868,48,916
公投第１２案,桃園市,楊梅區,高榮里,998,1686,501,351,852,21,873
公投第１２案,桃園市,楊梅區,雙榮里,999,1626,497,343,840,48,888
公投第１２案,桃園市,楊梅區,雙榮里,1000,1557,520,301,821,25,846
公投第１２案,桃園市,楊梅區,新榮里,1001,1603,571,317,888,41,929
公投第１２案,桃園市,楊梅區,新榮里,1002,1889,515,355,870,66,936
公投第１２案,桃園市,楊梅區,水美里,1003,1448,470,298,768,42,810
公投第１２案,桃園市,楊梅區,水美里,1004,1351,432,290,722,41,763
公投第１２案,桃園市,楊梅區,水美里,1005,1313,457,269,726,42,768
公投第１２案,桃園市,楊梅區,瑞原里,1006,1689,496,335,831,49,880
公投第１２案,桃園市,楊梅區,瑞原里,1007,2063,571,381,952,24,976
公投第１２案,桃園市,龍潭區,黃唐里,1008,1482,482,273,755,26,781
公投第１２案,桃園市,龍潭區,黃唐里,1009,1528,453,285,738,36,774
公投第１２案,桃園市,龍潭區,黃唐里,1010,1503,471,307,778,31,809
公投第１２案,桃園市,龍潭區,永興里,1011,1568,490,266,756,38,794
公投第１２案,桃園市,龍潭區,永興里,1012,1216,383,204,587,44,631
公投第１２案,桃園市,龍潭區,中山里,1013,2088,593,308,901,48,949
公投第１２案,桃園市,龍潭區,中山里,1014,1987,656,390,1046,66,1112
公投第１２案,桃園市,龍潭區,中山里,1015,1586,595,239,834,72,906
公投第１２案,桃園市,龍潭區,烏樹林里,1016,1221,372,240,612,23,635
公投第１２案,桃園市,龍潭區,烏樹林里,1017,1134,400,219,619,27,646
公投第１２案,桃園市,龍潭區,烏林里,1018,2081,602,370,972,35,1007
公投第１２案,桃園市,龍潭區,烏林里,1019,1925,594,306,900,31,931
公投第１２案,桃園市,龍潭區,百年里,1020,2095,728,380,1108,28,1136
公投第１２案,桃園市,龍潭區,百年里,1021,2040,799,340,1139,31,1170
公投第１２案,桃園市,龍潭區,凌雲里,1022,1790,508,330,838,52,890
公投第１２案,桃園市,龍潭區,凌雲里,1023,1872,565,387,952,63,1015
公投第１２案,桃園市,龍潭區,龍祥里,1024,1726,621,327,948,43,991
公投第１２案,桃園市,龍潭區,龍祥里,1025,1792,588,339,927,44,971
公投第１２案,桃園市,龍潭區,八德里,1026,1398,490,266,756,25,781
公投第１２案,桃園市,龍潭區,八德里,1027,1345,400,266,666,24,690
公投第１２案,桃園市,龍潭區,八德里,1028,1409,447,278,725,33,758
公投第１２案,桃園市,龍潭區,聖德里,1029,1362,378,269,647,25,672
公投第１２案,桃園市,龍潭區,聖德里,1030,1650,559,350,909,28,937
公投第１２案,桃園市,龍潭區,上林里,1031,1597,512,273,785,46,831
公投第１２案,桃園市,龍潭區,上林里,1032,1410,433,295,728,22,750
公投第１２案,桃園市,龍潭區,上林里,1033,1275,424,256,680,28,708
公投第１２案,桃園市,龍潭區,龍潭里,1034,1909,678,397,1075,39,1114
公投第１２案,桃園市,龍潭區,龍星里,1035,2024,721,375,1096,23,1119
公投第１２案,桃園市,龍潭區,龍星里,1036,2002,689,351,1040,37,1077
公投第１２案,桃園市,龍潭區,中正里,1037,1786,642,334,976,35,1011
公投第１２案,桃園市,龍潭區,中正里,1038,1756,594,324,918,29,947
公投第１２案,桃園市,龍潭區,中正里,1039,1830,657,321,978,17,995
公投第１２案,桃園市,龍潭區,上華里,1040,1697,722,253,975,29,1004
公投第１２案,桃園市,龍潭區,上華里,1041,1519,549,269,818,44,862
公投第１２案,桃園市,龍潭區,九龍里,1042,1805,569,311,880,39,919
公投第１２案,桃園市,龍潭區,九龍里,1043,1792,520,268,788,23,811
公投第１２案,桃園市,龍潭區,武漢里,1044,1500,549,297,846,39,885
公投第１２案,桃園市,龍潭區,祥和里,1045,1427,454,243,697,21,718
公投第１２案,桃園市,龍潭區,東興里,1046,1444,392,237,629,29,658
公投第１２案,桃園市,龍潭區,東興里,1047,1321,423,210,633,38,671
公投第１２案,桃園市,龍潭區,東興里,1048,1215,450,242,692,29,721
公投第１２案,桃園市,龍潭區,中興里,1049,1297,425,219,644,49,693
公投第１２案,桃園市,龍潭區,中興里,1050,1407,457,233,690,17,707
公投第１２案,桃園市,龍潭區,中興里,1051,1564,469,277,746,32,778
公投第１２案,桃園市,龍潭區,北興里,1052,1317,413,249,662,39,701
公投第１２案,桃園市,龍潭區,北興里,1053,1023,316,160,476,32,508
公投第１２案,桃園市,龍潭區,佳安里,1054,1721,619,308,927,36,963
公投第１２案,桃園市,龍潭區,佳安里,1055,1764,660,277,937,35,972
公投第１２案,桃園市,龍潭區,三坑里,1056,1499,491,289,780,44,824
公投第１２案,桃園市,龍潭區,大平里,1057,2151,622,370,992,40,1032
公投第１２案,桃園市,龍潭區,三林里,1058,1524,555,283,838,24,862
公投第１２案,桃園市,龍潭區,三林里,1059,1456,552,299,851,25,876
公投第１２案,桃園市,龍潭區,建林里,1060,1847,770,311,1081,29,1110
公投第１２案,桃園市,龍潭區,建林里,1061,1899,798,326,1124,24,1148
公投第１２案,桃園市,龍潭區,富林里,1062,1725,613,297,910,32,942
公投第１２案,桃園市,龍潭區,富林里,1063,1665,649,311,960,55,1015
公投第１２案,桃園市,龍潭區,高平里,1064,1649,481,304,785,35,820
公投第１２案,桃園市,龍潭區,高平里,1065,1539,459,252,711,42,753
公投第１２案,桃園市,龍潭區,高原里,1066,1541,575,274,849,35,884
公投第１２案,桃園市,龍潭區,高原里,1067,1375,406,307,713,40,753
公投第１２案,桃園市,龍潭區,高原里,1068,1453,440,323,763,28,791
公投第１２案,桃園市,龍潭區,三和里,1069,1074,355,220,575,39,614
公投第１２案,桃園市,龍潭區,三和里,1070,1299,466,269,735,25,760
公投第１２案,桃園市,龍潭區,三水里,1071,678,210,220,430,14,444
公投第１２案,桃園市,新屋區,新屋里,1072,1306,465,296,761,21,782
公投第１２案,桃園市,新屋區,新屋里,1073,1556,476,334,810,49,859
公投第１２案,桃園市,新屋區,新生里,1074,1849,646,427,1073,49,1122
公投第１２案,桃園市,新屋區,新生里,1075,2096,695,446,1141,66,1207
公投第１２案,桃園市,新屋區,後湖里,1076,1517,415,334,749,48,797
公投第１２案,桃園市,新屋區,清華里,1077,2095,633,492,1125,60,1185
公投第１２案,桃園市,新屋區,清華里,1078,1856,491,352,843,54,897
公投第１２案,桃園市,新屋區,石磊里,1079,1986,612,426,1038,59,1097
公投第１２案,桃園市,新屋區,東明里,1080,1425,383,274,657,50,707
公投第１２案,桃園市,新屋區,社子里,1081,1385,370,285,655,45,700
公投第１２案,桃園市,新屋區,埔頂里,1082,1271,413,323,736,46,782
公投第１２案,桃園市,新屋區,埔頂里,1083,1271,369,287,656,26,682
公投第１２案,桃園市,新屋區,九斗里,1084,1234,368,290,658,45,703
公投第１２案,桃園市,新屋區,九斗里,1085,1085,293,272,565,42,607
公投第１２案,桃園市,新屋區,頭洲里,1086,1992,656,440,1096,37,1133
公投第１２案,桃園市,新屋區,頭洲里,1087,2032,663,471,1134,61,1195
公投第１２案,桃園市,新屋區,大坡里,1088,1291,366,274,640,66,706
公投第１２案,桃園市,新屋區,望間里,1089,1401,409,284,693,37,730
公投第１２案,桃園市,新屋區,後庄里,1090,1106,369,240,609,38,647
公投第１２案,桃園市,新屋區,蚵間里,1091,908,299,207,506,12,518
公投第１２案,桃園市,新屋區,深圳里,1092,663,231,145,376,32,408
公投第１２案,桃園市,新屋區,槺榔里,1093,1088,294,250,544,39,583
公投第１２案,桃園市,新屋區,笨港里,1094,1050,383,236,619,59,678
公投第１２案,桃園市,新屋區,永安里,1095,896,298,210,508,18,526
公投第１２案,桃園市,新屋區,永安里,1096,1369,420,325,745,73,818
公投第１２案,桃園市,新屋區,永興里,1097,995,238,226,464,35,499
公投第１２案,桃園市,新屋區,下埔里,1098,741,248,167,415,19,434
公投第１２案,桃園市,新屋區,石牌里,1099,943,297,228,525,57,582
公投第１２案,桃園市,新屋區,下田里,1100,1714,523,328,851,53,904
公投第１２案,桃園市,新屋區,赤欄里,1101,1340,418,283,701,26,727
公投第１２案,桃園市,觀音區,觀音里,1102,1371,366,258,624,34,658
公投第１２案,桃園市,觀音區,觀音里,1103,1362,335,222,557,30,587
公投第１２案,桃園市,觀音區,白玉里,1104,997,250,226,476,57,533
公投第１２案,桃園市,觀音區,廣興里,1105,1407,382,275,657,28,685
公投第１２案,桃園市,觀音區,大潭里,1106,1692,448,418,866,39,905
公投第１２案,桃園市,觀音區,保生里,1107,1279,411,234,645,29,674
公投第１２案,桃園市,觀音區,保生里,1108,791,241,163,404,17,421
公投第１２案,桃園市,觀音區,武威里,1109,892,303,179,482,24,506
公投第１２案,桃園市,觀音區,三和里,1110,886,296,213,509,22,531
公投第１２案,桃園市,觀音區,新興里,1111,712,221,149,370,26,396
公投第１２案,桃園市,觀音區,坑尾里,1112,1609,423,295,718,95,813
公投第１２案,桃園市,觀音區,金湖里,1113,1274,385,285,670,36,706
公投第１２案,桃園市,觀音區,金湖里,1114,1351,329,255,584,21,605
公投第１２案,桃園市,觀音區,藍埔里,1115,1262,409,264,673,54,727
公投第１２案,桃園市,觀音區,藍埔里,1116,1242,365,296,661,46,707
公投第１２案,桃園市,觀音區,大同里,1117,1461,433,305,738,40,778
公投第１２案,桃園市,觀音區,大同里,1118,1613,458,351,809,38,847
公投第１２案,桃園市,觀音區,大堀里,1119,1479,408,370,778,41,819
公投第１２案,桃園市,觀音區,崙坪里,1120,1552,382,315,697,49,746
公投第１２案,桃園市,觀音區,崙坪里,1121,1517,445,319,764,23,787
公投第１２案,桃園市,觀音區,崙坪里,1122,1691,468,316,784,52,836
公投第１２案,桃園市,觀音區,富源里,1123,1157,460,171,631,12,643
公投第１２案,桃園市,觀音區,富源里,1124,1455,419,293,712,39,751
公投第１２案,桃園市,觀音區,富源里,1125,1150,341,243,584,29,613
公投第１２案,桃園市,觀音區,上大里,1126,1112,317,267,584,42,626
公投第１２案,桃園市,觀音區,上大里,1127,1251,336,252,588,27,615
公投第１２案,桃園市,觀音區,新坡里,1128,1446,408,313,721,62,783
公投第１２案,桃園市,觀音區,新坡里,1129,1493,409,303,712,77,789
公投第１２案,桃園市,觀音區,廣福里,1130,1339,397,257,654,54,708
公投第１２案,桃園市,觀音區,廣福里,1131,1137,393,242,635,34,669
公投第１２案,桃園市,觀音區,塔腳里,1132,1043,267,226,493,35,528
公投第１２案,桃園市,觀音區,保障里,1133,993,251,191,442,20,462
公投第１２案,桃園市,觀音區,保障里,1134,975,238,240,478,23,501
公投第１２案,桃園市,觀音區,草漯里,1135,2029,457,406,863,43,906
公投第１２案,桃園市,觀音區,草新里,1136,1765,531,395,926,37,963
公投第１２案,桃園市,觀音區,草新里,1137,1809,522,360,882,44,926
公投第１２案,桃園市,觀音區,草新里,1138,1869,535,335,870,38,908
公投第１２案,桃園市,觀音區,樹林里,1139,1870,424,343,767,45,812
公投第１２案,桃園市,觀音區,樹林里,1140,1932,354,312,666,31,697
公投第１２案,桃園市,觀音區,富林里,1141,899,235,180,415,8,423
公投第１２案,桃園市,觀音區,富林里,1142,985,250,173,423,8,431
