公投案編號,縣市,行政區,村里,投開票所,投票權人數,同意票數,不同意票數,有效票數,無效票數,投票人數
公投第１５案,連江縣,,,,11205,1480,4110,5590,171,5761
公投第１５案,金門縣,,,,122695,10826,30970,41796,2118,43914
公投第１５案,宜蘭縣,,,,386089,69188,130483,199671,14890,214561
公投第１５案,新竹縣,,,,445051,77180,163313,240493,11783,252276
公投第１５案,苗栗縣,,,,461580,74809,172173,246982,15638,262620
公投第１５案,彰化縣,,,,1066994,177421,398192,575613,38235,613848
公投第１５案,南投縣,,,,427089,68393,165077,233470,14440,247910
公投第１５案,雲林縣,,,,584480,88127,190434,278561,23887,302448
公投第１５案,嘉義縣,,,,442775,65100,139182,204282,19875,224157
公投第１５案,屏東縣,,,,711720,113331,229686,343017,28411,371428
公投第１５案,臺東縣,,,,185996,24813,62900,87713,8135,95848
公投第１５案,花蓮縣,,,,278059,38850,97972,136822,9514,146336
公投第１５案,澎湖縣,,,,90405,11489,26451,37940,2808,40748
公投第１５案,基隆市,,,,320030,54369,102268,156637,8427,165064
公投第１５案,新竹市,,,,351775,67231,123030,190261,8894,199155
公投第１５案,嘉義市,,,,221553,39449,75746,115195,5781,120976
公投第１５案,臺北市,,,,2228430,479771,751265,1231036,58945,1289981
公投第１５案,高雄市,,,,2353342,436565,870018,1306583,78331,1384914
公投第１５案,新北市,,,,3375513,631350,1127654,1759004,107872,1866876
公投第１５案,臺中市,,,,2295642,411320,850532,1261852,71273,1333125
公投第１５案,臺南市,,,,1594821,270957,502776,773733,45753,819486
公投第１５案,桃園市,,,,1801823,295646,590939,886585,43820,930405
公投第１５案,連江縣,北竿鄉,,,2125,266,811,1077,33,1110
公投第１５案,連江縣,南竿鄉,,,6461,849,2342,3191,98,3289
公投第１５案,連江縣,東引鄉,,,1138,165,397,562,15,577
公投第１５案,連江縣,莒光鄉,,,1481,200,560,760,25,785
公投第１５案,金門縣,金寧鄉,,,28162,3170,6573,9743,448,10191
公投第１５案,金門縣,烏坵鄉,,,567,38,125,163,2,165
公投第１５案,金門縣,烈嶼鄉,,,11676,869,3202,4071,186,4257
公投第１５案,金門縣,金城鎮,,,37815,3241,9347,12588,645,13233
公投第１５案,金門縣,金沙鎮,,,18560,1258,4967,6225,347,6572
公投第１５案,金門縣,金湖鎮,,,25915,2250,6756,9006,490,9496
公投第１５案,宜蘭縣,三星鄉,,,19051,3118,6076,9194,797,9991
公投第１５案,宜蘭縣,宜蘭市,,,79167,14997,27404,42401,2549,44950
公投第１５案,宜蘭縣,礁溪鄉,,,31084,5360,10197,15557,1238,16795
公投第１５案,宜蘭縣,頭城鎮,,,25135,4332,8342,12674,1159,13833
公投第１５案,宜蘭縣,壯圍鄉,,,21447,3935,7302,11237,1133,12370
公投第１５案,宜蘭縣,員山鄉,,,28131,4651,9182,13833,1333,15166
公投第１５案,宜蘭縣,冬山鄉,,,45405,8099,14995,23094,1420,24514
公投第１５案,宜蘭縣,蘇澳鎮,,,34512,6130,11634,17764,1642,19406
公投第１５案,宜蘭縣,大同鄉,,,4935,528,2137,2665,217,2882
公投第１５案,宜蘭縣,南澳鄉,,,4644,538,2088,2626,183,2809
公投第１５案,宜蘭縣,五結鄉,,,34892,6188,11329,17517,1217,18734
公投第１５案,宜蘭縣,羅東鎮,,,57686,11312,19797,31109,2002,33111
公投第１５案,新竹縣,新豐鄉,,,45790,7296,17099,24395,1239,25634
公投第１５案,新竹縣,峨眉鄉,,,5068,742,2039,2781,279,3060
公投第１５案,新竹縣,新埔鎮,,,28894,4611,10817,15428,889,16317
公投第１５案,新竹縣,竹北市,,,137129,27936,49115,77051,2874,79925
公投第１５案,新竹縣,湖口鄉,,,63511,10422,23740,34162,1657,35819
公投第１５案,新竹縣,尖石鄉,,,7364,710,2826,3536,217,3753
公投第１５案,新竹縣,五峰鄉,,,3997,387,1487,1874,94,1968
公投第１５案,新竹縣,芎林鄉,,,17293,2855,6702,9557,645,10202
公投第１５案,新竹縣,竹東鎮,,,78794,12563,28093,40656,1955,42611
公投第１５案,新竹縣,橫山鄉,,,11346,1742,4507,6249,452,6701
公投第１５案,新竹縣,關西鎮,,,24712,3759,9450,13209,834,14043
公投第１５案,新竹縣,北埔鄉,,,8180,1549,2847,4396,238,4634
公投第１５案,新竹縣,寶山鄉,,,12973,2608,4591,7199,410,7609
公投第１５案,苗栗縣,頭份市,,,83617,13417,31783,45200,2218,47418
公投第１５案,苗栗縣,三灣鄉,,,5852,855,2253,3108,280,3388
公投第１５案,苗栗縣,頭屋鄉,,,9390,1691,4087,5778,346,6124
公投第１５案,苗栗縣,獅潭鄉,,,3968,497,1381,1878,161,2039
公投第１５案,苗栗縣,南庄鄉,,,8784,1189,2880,4069,270,4339
公投第１５案,苗栗縣,造橋鄉,,,11027,1696,4224,5920,499,6419
公投第１５案,苗栗縣,通霄鎮,,,29709,4556,10178,14734,1346,16080
公投第１５案,苗栗縣,卓蘭鎮,,,14772,2341,5742,8083,604,8687
公投第１５案,苗栗縣,竹南鎮,,,68528,11697,24847,36544,1967,38511
公投第１５案,苗栗縣,西湖鄉,,,6382,987,2288,3275,253,3528
公投第１５案,苗栗縣,苗栗市,,,74249,12854,28018,40872,1971,42843
公投第１５案,苗栗縣,大湖鄉,,,12653,1898,4329,6227,534,6761
公投第１５案,苗栗縣,泰安鄉,,,5180,777,2490,3267,199,3466
公投第１５案,苗栗縣,後龍鎮,,,30948,5002,10779,15781,1327,17108
公投第１５案,苗栗縣,苑裡鎮,,,38890,6245,14548,20793,1583,22376
公投第１５案,苗栗縣,三義鄉,,,13889,2166,5583,7749,402,8151
公投第１５案,苗栗縣,公館鄉,,,28318,4595,10963,15558,1176,16734
公投第１５案,苗栗縣,銅鑼鄉,,,15424,2346,5800,8146,502,8648
公投第１５案,彰化縣,和美鎮,,,75286,12951,27751,40702,2235,42937
公投第１５案,彰化縣,花壇鄉,,,38924,6224,15562,21786,1329,23115
公投第１５案,彰化縣,芬園鄉,,,20408,3045,7442,10487,885,11372
公投第１５案,彰化縣,埤頭鄉,,,25677,3871,8865,12736,1221,13957
公投第１５案,彰化縣,北斗鎮,,,27593,4843,10218,15061,1070,16131
公投第１５案,彰化縣,芳苑鄉,,,29291,3674,9277,12951,1350,14301
公投第１５案,彰化縣,彰化市,,,190995,35239,74545,109784,5749,115533
公投第１５案,彰化縣,鹿港鎮,,,70505,11517,26869,38386,2697,41083
公投第１５案,彰化縣,福興鄉,,,39745,6368,13715,20083,1533,21616
公投第１５案,彰化縣,竹塘鄉,,,12821,1832,4539,6371,581,6952
公投第１５案,彰化縣,社頭鄉,,,36306,5908,13849,19757,1224,20981
公投第１５案,彰化縣,線西鄉,,,14065,2323,5545,7868,507,8375
公投第１５案,彰化縣,秀水鄉,,,32394,5578,12461,18039,1225,19264
公投第１５案,彰化縣,溪湖鎮,,,45147,7695,17023,24718,1567,26285
公投第１５案,彰化縣,二水鄉,,,13339,2152,5295,7447,672,8119
公投第１５案,彰化縣,大村鄉,,,31492,5500,11990,17490,1089,18579
公投第１５案,彰化縣,溪州鄉,,,25405,3775,8280,12055,1098,13153
公投第１５案,彰化縣,伸港鄉,,,30407,4958,11141,16099,1159,17258
公投第１５案,彰化縣,永靖鄉,,,31239,5651,11781,17432,1192,18624
公投第１５案,彰化縣,田中鎮,,,35391,5778,13245,19023,1405,20428
公投第１５案,彰化縣,二林鎮,,,42976,6416,14593,21009,1678,22687
公投第１５案,彰化縣,埔鹽鄉,,,28026,4272,11478,15750,1191,16941
公投第１５案,彰化縣,田尾鄉,,,23179,3867,8997,12864,893,13757
公投第１５案,彰化縣,員林市,,,102028,17321,38055,55376,2876,58252
公投第１５案,彰化縣,埔心鄉,,,29642,5282,11827,17109,1294,18403
公投第１５案,彰化縣,大城鄉,,,14713,1381,3849,5230,515,5745
公投第１５案,南投縣,草屯鎮,,,82922,14396,31506,45902,2285,48187
公投第１５案,南投縣,鹿谷鄉,,,15941,2276,5778,8054,566,8620
公投第１５案,南投縣,信義鄉,,,13299,1461,6133,7594,602,8196
公投第１５案,南投縣,南投市,,,84328,14491,34230,48721,2383,51104
公投第１５案,南投縣,水里鄉,,,15458,2326,5784,8110,569,8679
公投第１５案,南投縣,名間鄉,,,33408,5405,13160,18565,1467,20032
公投第１５案,南投縣,國姓鄉,,,16597,2268,6510,8778,625,9403
公投第１５案,南投縣,仁愛鄉,,,12589,1695,5070,6765,388,7153
公投第１５案,南投縣,魚池鄉,,,13958,2123,4942,7065,546,7611
公投第１５案,南投縣,集集鎮,,,9611,1562,3642,5204,378,5582
公投第１５案,南投縣,中寮鄉,,,13181,1943,5131,7074,556,7630
公投第１５案,南投縣,竹山鎮,,,47034,7543,16737,24280,1780,26060
公投第１５案,南投縣,埔里鎮,,,68763,10904,26454,37358,2295,39653
公投第１５案,雲林縣,臺西鄉,,,21125,2524,6237,8761,912,9673
公投第１５案,雲林縣,斗南鎮,,,38138,6583,13713,20296,1405,21701
公投第１５案,雲林縣,林內鄉,,,15551,2539,5386,7925,877,8802
公投第１５案,雲林縣,大埤鄉,,,16509,2538,5310,7848,671,8519
公投第１５案,雲林縣,東勢鄉,,,13239,1761,4200,5961,625,6586
公投第１５案,雲林縣,二崙鄉,,,23367,3275,6738,10013,1146,11159
公投第１５案,雲林縣,褒忠鄉,,,11381,1790,3641,5431,430,5861
公投第１５案,雲林縣,麥寮鄉,,,37119,4927,11731,16658,1443,18101
公投第１５案,雲林縣,虎尾鎮,,,58167,9596,19755,29351,1753,31104
公投第１５案,雲林縣,北港鎮,,,33958,5486,11404,16890,1664,18554
公投第１５案,雲林縣,四湖鄉,,,20983,2192,5251,7443,829,8272
公投第１５案,雲林縣,元長鄉,,,22830,2717,6177,8894,945,9839
公投第１５案,雲林縣,西螺鎮,,,38142,6128,12384,18512,1819,20331
公投第１５案,雲林縣,崙背鄉,,,21050,2880,6338,9218,927,10145
公投第１５案,雲林縣,莿桐鄉,,,24570,4027,8252,12279,1291,13570
公投第１５案,雲林縣,斗六市,,,89761,15497,33537,49034,2528,51562
公投第１５案,雲林縣,水林鄉,,,22508,2689,6034,8723,1040,9763
公投第１５案,雲林縣,古坑鄉,,,27477,4164,9260,13424,1136,14560
公投第１５案,雲林縣,口湖鄉,,,24193,2990,7195,10185,1280,11465
公投第１５案,雲林縣,土庫鎮,,,24412,3824,7891,11715,1166,12881
公投第１５案,嘉義縣,番路鄉,,,10156,1436,3778,5214,453,5667
公投第１５案,嘉義縣,水上鄉,,,43857,6712,14609,21321,1928,23249
公投第１５案,嘉義縣,朴子市,,,35191,5426,11329,16755,1428,18183
公投第１５案,嘉義縣,六腳鄉,,,20821,2568,5282,7850,873,8723
公投第１５案,嘉義縣,溪口鄉,,,13105,2024,3870,5894,726,6620
公投第１５案,嘉義縣,鹿草鄉,,,13937,1996,3726,5722,841,6563
公投第１５案,嘉義縣,布袋鎮,,,23965,3048,7395,10443,1180,11623
公投第１５案,嘉義縣,義竹鄉,,,16647,2458,5021,7479,910,8389
公投第１５案,嘉義縣,中埔鄉,,,39139,5328,11537,16865,1466,18331
公投第１５案,嘉義縣,大林鎮,,,26922,4191,8594,12785,1117,13902
公投第１５案,嘉義縣,太保市,,,31568,5217,10385,15602,1236,16838
公投第１５案,嘉義縣,大埔鄉,,,3999,634,1397,2031,157,2188
公投第１５案,嘉義縣,梅山鄉,,,17083,2612,5888,8500,875,9375
公投第１５案,嘉義縣,阿里山鄉,,,4691,430,1610,2040,134,2174
公投第１５案,嘉義縣,民雄鄉,,,61209,10079,19984,30063,2724,32787
公投第１５案,嘉義縣,東石鄉,,,21915,2179,5707,7886,985,8871
公投第１５案,嘉義縣,新港鄉,,,27342,4330,8597,12927,1648,14575
公投第１５案,嘉義縣,竹崎鄉,,,31228,4432,10473,14905,1194,16099
公投第１５案,屏東縣,新園鄉,,,30706,4787,9799,14586,1559,16145
公投第１５案,屏東縣,長治鄉,,,26256,4527,8662,13189,1270,14459
公投第１５案,屏東縣,崁頂鄉,,,12270,2014,3865,5879,553,6432
公投第１５案,屏東縣,三地門鄉,,,6373,985,2381,3366,249,3615
公投第１５案,屏東縣,高樹鄉,,,21697,3246,6296,9542,1121,10663
公投第１５案,屏東縣,牡丹鄉,,,4314,570,1137,1707,84,1791
公投第１５案,屏東縣,佳冬鄉,,,17063,2520,4918,7438,988,8426
公投第１５案,屏東縣,枋山鄉,,,4856,707,1563,2270,220,2490
公投第１５案,屏東縣,春日鄉,,,3923,440,877,1317,43,1360
公投第１５案,屏東縣,車城鄉,,,7595,1020,1844,2864,269,3133
公投第１５案,屏東縣,滿州鄉,,,7206,971,1913,2884,197,3081
公投第１５案,屏東縣,泰武鄉,,,4344,699,1915,2614,195,2809
公投第１５案,屏東縣,屏東市,,,170148,29361,56512,85873,4547,90420
公投第１５案,屏東縣,潮州鎮,,,46444,7197,15460,22657,1559,24216
公投第１５案,屏東縣,里港鄉,,,22128,3616,7226,10842,1218,12060
公投第１５案,屏東縣,鹽埔鄉,,,22402,3430,7284,10714,908,11622
公投第１５案,屏東縣,獅子鄉,,,4230,525,1655,2180,93,2273
公投第１５案,屏東縣,九如鄉,,,19132,2950,6397,9347,1075,10422
公投第１５案,屏東縣,琉球鄉,,,10706,1041,3387,4428,327,4755
公投第１５案,屏東縣,新埤鄉,,,9033,1301,2812,4113,445,4558
公投第１５案,屏東縣,瑪家鄉,,,5663,880,2505,3385,178,3563
公投第１５案,屏東縣,麟洛鄉,,,9970,2021,3381,5402,362,5764
公投第１５案,屏東縣,竹田鄉,,,15353,3162,4856,8018,812,8830
公投第１５案,屏東縣,林邊鄉,,,15691,2763,5109,7872,849,8721
公投第１５案,屏東縣,來義鄉,,,6257,822,2639,3461,271,3732
公投第１５案,屏東縣,南州鄉,,,9479,1618,2921,4539,476,5015
公投第１５案,屏東縣,內埔鄉,,,47558,6775,14248,21023,1649,22672
公投第１５案,屏東縣,東港鎮,,,39495,6062,13078,19140,1842,20982
公投第１５案,屏東縣,霧臺鄉,,,2950,433,1268,1701,108,1809
公投第１５案,屏東縣,恆春鎮,,,25661,3668,7587,11255,822,12077
公投第１５案,屏東縣,枋寮鄉,,,21394,3196,6773,9969,1214,11183
公投第１５案,屏東縣,萬巒鄉,,,17945,2813,5417,8230,920,9150
公投第１５案,屏東縣,萬丹鄉,,,43478,7211,14001,21212,1988,23200
公投第１５案,臺東縣,金峰鄉,,,3028,454,1176,1630,170,1800
公投第１５案,臺東縣,延平鄉,,,2930,335,1118,1453,146,1599
公投第１５案,臺東縣,達仁鄉,,,3137,382,1261,1643,188,1831
公投第１５案,臺東縣,鹿野鄉,,,6936,896,1965,2861,259,3120
公投第１５案,臺東縣,長濱鄉,,,6484,593,1717,2310,401,2711
公投第１５案,臺東縣,東河鄉,,,7635,831,2088,2919,420,3339
公投第１５案,臺東縣,卑南鄉,,,14976,2112,4952,7064,803,7867
公投第１５案,臺東縣,綠島鄉,,,3579,467,1039,1506,73,1579
公投第１５案,臺東縣,關山鎮,,,7509,1032,2442,3474,270,3744
公投第１５案,臺東縣,蘭嶼鄉,,,4181,452,1032,1484,117,1601
公投第１５案,臺東縣,成功鎮,,,12426,1217,4110,5327,818,6145
公投第１５案,臺東縣,大武鄉,,,5266,636,1670,2306,399,2705
公投第１５案,臺東縣,海端鄉,,,3278,373,1226,1599,155,1754
公投第１５案,臺東縣,臺東市,,,87803,12992,31881,44873,3100,47973
公投第１５案,臺東縣,太麻里鄉,,,9666,1147,3148,4295,480,4775
公投第１５案,臺東縣,池上鄉,,,7162,894,2075,2969,336,3305
公投第１５案,花蓮縣,花蓮市,,,84807,13072,30596,43668,2054,45722
公投第１５案,花蓮縣,壽豐鄉,,,15847,2363,5703,8066,734,8800
公投第１５案,花蓮縣,瑞穗鄉,,,10279,1135,3451,4586,509,5095
公投第１５案,花蓮縣,吉安鄉,,,72116,10232,26015,36247,1847,38094
公投第１５案,花蓮縣,富里鄉,,,9065,1034,2693,3727,424,4151
公投第１５案,花蓮縣,萬榮鄉,,,5269,668,1986,2654,279,2933
公投第１５案,花蓮縣,豐濱鄉,,,4395,520,1207,1727,271,1998
公投第１５案,花蓮縣,秀林鄉,,,12562,1694,4326,6020,415,6435
公投第１５案,花蓮縣,新城鄉,,,17029,2473,6193,8666,586,9252
公投第１５案,花蓮縣,鳳林鎮,,,9676,1327,3547,4874,466,5340
公投第１５案,花蓮縣,光復鄉,,,11417,1345,3871,5216,674,5890
公投第１５案,花蓮縣,玉里鎮,,,20650,2402,6382,8784,997,9781
公投第１５案,花蓮縣,卓溪鄉,,,4947,585,2002,2587,258,2845
公投第１５案,澎湖縣,西嶼鄉,,,7382,684,1598,2282,276,2558
公投第１５案,澎湖縣,七美鄉,,,3374,326,614,940,78,1018
公投第１５案,澎湖縣,望安鄉,,,4628,487,1186,1673,167,1840
公投第１５案,澎湖縣,湖西鄉,,,12741,1473,3640,5113,407,5520
公投第１５案,澎湖縣,馬公市,,,53655,7572,17018,24590,1571,26161
公投第１５案,澎湖縣,白沙鄉,,,8625,947,2395,3342,309,3651
公投第１５案,基隆市,中正區,,,45545,6983,13181,20164,1324,21488
公投第１５案,基隆市,中山區,,,41856,6929,13362,20291,1097,21388
公投第１５案,基隆市,信義區,,,46014,7869,15251,23120,1012,24132
公投第１５案,基隆市,仁愛區,,,36738,6390,11793,18183,1326,19509
公投第１５案,基隆市,七堵區,,,46256,8017,15107,23124,1356,24480
公投第１５案,基隆市,安樂區,,,70396,12312,22626,34938,1633,36571
公投第１５案,基隆市,暖暖區,,,33225,5869,10948,16817,679,17496
公投第１５案,新竹市,東區,,,163757,32753,57090,89843,3696,93539
公投第１５案,新竹市,香山區,,,64896,11553,23040,34593,1975,36568
公投第１５案,新竹市,北區,,,123122,22925,42900,65825,3223,69048
公投第１５案,嘉義市,東區,,,100647,18474,33619,52093,2560,54653
公投第１５案,嘉義市,西區,,,120906,20975,42127,63102,3221,66323
公投第１５案,臺北市,中正區,,,128292,27634,44386,72020,3023,75043
公投第１５案,臺北市,文山區,,,227211,49133,81140,130273,5773,136046
公投第１５案,臺北市,大安區,,,252645,54598,85851,140449,5548,145997
公投第１５案,臺北市,南港區,,,101907,22312,34517,56829,2479,59308
公投第１５案,臺北市,中山區,,,195148,42578,64018,106596,5211,111807
公投第１５案,臺北市,信義區,,,190444,40135,65500,105635,4827,110462
公投第１５案,臺北市,大同區,,,107557,24094,34885,58979,3537,62516
公投第１５案,臺北市,松山區,,,169278,37298,58829,96127,4313,100440
公投第１５案,臺北市,士林區,,,241854,51855,79244,131099,7642,138741
公投第１５案,臺北市,北投區,,,213250,44378,69714,114092,6007,120099
公投第１５案,臺北市,內湖區,,,236824,52518,80236,132754,5283,138037
公投第１５案,臺北市,萬華區,,,164020,33238,52945,86183,5302,91485
公投第１５案,高雄市,仁武區,,,73611,13068,28094,41162,1991,43153
公投第１５案,高雄市,燕巢區,,,26012,4398,9355,13753,1159,14912
公投第１５案,高雄市,旗山區,,,31996,5654,10819,16473,1483,17956
公投第１５案,高雄市,杉林區,,,10607,1437,2898,4335,460,4795
公投第１５案,高雄市,美濃區,,,35311,4922,12858,17780,1641,19421
公投第１５案,高雄市,大寮區,,,97309,16588,35551,52139,3391,55530
公投第１５案,高雄市,永安區,,,12001,2323,4723,7046,527,7573
公投第１５案,高雄市,內門區,,,13002,1695,3965,5660,645,6305
公投第１５案,高雄市,林園區,,,59129,10174,20560,30734,2234,32968
公投第１５案,高雄市,前金區,,,23928,4776,8995,13771,738,14509
公投第１５案,高雄市,鹽埕區,,,21617,4613,7277,11890,575,12465
公投第１５案,高雄市,田寮區,,,6671,897,1982,2879,325,3204
公投第１５案,高雄市,鳥松區,,,39191,7877,14661,22538,1305,23843
公投第１５案,高雄市,旗津區,,,24860,4223,7751,11974,1017,12991
公投第１５案,高雄市,新興區,,,44355,9445,16428,25873,1336,27209
公投第１５案,高雄市,苓雅區,,,146786,29700,55824,85524,4183,89707
公投第１５案,高雄市,路竹區,,,43850,7908,16072,23980,1964,25944
公投第１５案,高雄市,楠梓區,,,153132,28585,57582,86167,5512,91679
公投第１５案,高雄市,小港區,,,132733,25181,48504,73685,4154,77839
公投第１５案,高雄市,六龜區,,,11501,1451,3386,4837,642,5479
公投第１５案,高雄市,茄萣區,,,26212,4510,8546,13056,1111,14167
公投第１５案,高雄市,三民區,,,289519,56856,106137,162993,8385,171378
公投第１５案,高雄市,鼓山區,,,114979,22321,42999,65320,3097,68417
公投第１５案,高雄市,橋頭區,,,32565,6321,12345,18666,1594,20260
公投第１５案,高雄市,湖內區,,,25729,4289,9148,13437,942,14379
公投第１５案,高雄市,大社區,,,30046,5753,10353,16106,1205,17311
公投第１５案,高雄市,左營區,,,161367,30605,63666,94271,3966,98237
公投第１５案,高雄市,鳳山區,,,300510,55770,113855,169625,9216,178841
公投第１５案,高雄市,彌陀區,,,16487,2893,6438,9331,889,10220
公投第１５案,高雄市,岡山區,,,81244,14680,32567,47247,2620,49867
公投第１５案,高雄市,大樹區,,,36772,6166,13003,19169,1427,20596
公投第１５案,高雄市,梓官區,,,31025,5238,11624,16862,1304,18166
公投第１５案,高雄市,阿蓮區,,,24534,4353,8139,12492,792,13284
公投第１５案,高雄市,桃源區,,,3498,385,1450,1835,100,1935
公投第１５案,高雄市,甲仙區,,,5417,706,1702,2408,279,2687
公投第１５案,高雄市,茂林區,,,1615,246,812,1058,52,1110
公投第１５案,高雄市,那瑪夏區,,,2424,283,1184,1467,122,1589
公投第１５案,高雄市,前鎮區,,,161797,30275,58765,89040,5948,94988
公投第１５案,新北市,蘆洲區,,,167457,31191,52571,83762,5891,89653
公投第１５案,新北市,林口區,,,86203,16881,29035,45916,2376,48292
公投第１５案,新北市,貢寮區,,,11279,1418,3049,4467,482,4949
公投第１５案,新北市,金山區,,,18978,3271,5466,8737,890,9627
公投第１５案,新北市,新莊區,,,344981,67789,117471,185260,11395,196655
公投第１５案,新北市,烏來區,,,5264,832,1919,2751,105,2856
公投第１５案,新北市,平溪區,,,4321,547,1297,1844,233,2077
公投第１５案,新北市,三重區,,,329846,64488,107248,171736,12610,184346
公投第１５案,新北市,鶯歌區,,,71645,12659,23037,35696,2140,37836
公投第１５案,新北市,樹林區,,,152102,28180,51144,79324,4931,84255
公投第１５案,新北市,石碇區,,,6861,1094,2082,3176,293,3469
公投第１５案,新北市,五股區,,,72443,12868,23458,36326,2422,38748
公投第１５案,新北市,深坑區,,,20624,3861,6894,10755,625,11380
公投第１５案,新北市,瑞芳區,,,35036,5235,10465,15700,1265,16965
公投第１５案,新北市,萬里區,,,19297,2609,6072,8681,926,9607
公投第１５案,新北市,汐止區,,,173831,32285,54856,87141,4848,91989
公投第１５案,新北市,坪林區,,,5891,898,1829,2727,291,3018
公投第１５案,新北市,永和區,,,187798,37605,68429,106034,5143,111177
公投第１５案,新北市,中和區,,,355978,65604,122740,188344,9839,198183
公投第１５案,新北市,石門區,,,10528,1579,3331,4910,541,5451
公投第１５案,新北市,泰山區,,,64252,11793,21896,33689,1893,35582
公投第１５案,新北市,八里區,,,32970,5690,10721,16411,1076,17487
公投第１５案,新北市,新店區,,,264053,48345,93966,142311,7075,149386
公投第１５案,新北市,淡水區,,,147272,26552,47418,73970,3662,77632
公投第１５案,新北市,三峽區,,,94291,16312,30727,47039,2757,49796
公投第１５案,新北市,板橋區,,,463411,89876,156175,246051,16356,262407
公投第１５案,新北市,三芝區,,,20119,3186,5837,9023,741,9764
公投第１５案,新北市,土城區,,,200783,37665,66049,103714,6692,110406
公投第１５案,新北市,雙溪區,,,7999,1037,2472,3509,374,3883
公投第１５案,臺中市,神岡區,,,54565,9121,21157,30278,2144,32422
公投第１５案,臺中市,龍井區,,,63584,10744,23229,33973,2116,36089
公投第１５案,臺中市,大里區,,,171769,29508,62260,91768,5115,96883
公投第１５案,臺中市,大甲區,,,63069,10769,23336,34105,2368,36473
公投第１５案,臺中市,清水區,,,71528,12574,26528,39102,2788,41890
公投第１５案,臺中市,新社區,,,20860,2984,7517,10501,684,11185
公投第１５案,臺中市,南區,,,103643,20975,39392,60367,3321,63688
公投第１５案,臺中市,大安區,,,16520,2665,6258,8923,829,9752
公投第１５案,臺中市,西區,,,95040,19150,34098,53248,2543,55791
公投第１５案,臺中市,太平區,,,157926,25949,55823,81772,4731,86503
公投第１５案,臺中市,北屯區,,,227720,41689,83227,124916,5529,130445
公投第１５案,臺中市,豐原區,,,136658,25365,52434,77799,4495,82294
公投第１５案,臺中市,大雅區,,,77189,13441,28615,42056,2356,44412
公投第１５案,臺中市,后里區,,,44962,7622,16964,24586,1666,26252
公投第１５案,臺中市,中區,,,14696,2487,5268,7755,485,8240
公投第１５案,臺中市,東勢區,,,43181,6696,16783,23479,1855,25334
公投第１５案,臺中市,霧峰區,,,55225,9513,21777,31290,2297,33587
公投第１５案,臺中市,潭子區,,,89487,15257,33803,49060,2572,51632
公投第１５案,臺中市,南屯區,,,135448,27215,51229,78444,3663,82107
公投第１５案,臺中市,烏日區,,,61705,10735,23059,33794,2375,36169
公投第１５案,臺中市,沙鹿區,,,74207,12711,27332,40043,2280,42323
公投第１５案,臺中市,石岡區,,,12880,2109,4964,7073,552,7625
公投第１５案,臺中市,外埔區,,,27059,4102,10757,14859,1018,15877
公投第１５案,臺中市,北區,,,124621,23371,44261,67632,2943,70575
公投第１５案,臺中市,東區,,,64291,11829,23874,35703,2239,37942
公投第１５案,臺中市,梧棲區,,,47040,7915,17312,25227,1665,26892
公投第１５案,臺中市,和平區,,,9498,1280,4348,5628,376,6004
公投第１５案,臺中市,大肚區,,,47457,7860,18142,26002,1772,27774
公投第１５案,臺中市,西屯區,,,183814,35684,66785,102469,4496,106965
公投第１５案,臺南市,南化區,,,7786,1054,2331,3385,323,3708
公投第１５案,臺南市,鹽水區,,,22121,3508,6307,9815,774,10589
公投第１５案,臺南市,六甲區,,,19144,3197,5234,8431,830,9261
公投第１５案,臺南市,官田區,,,18675,3068,5351,8419,669,9088
公投第１５案,臺南市,將軍區,,,17754,2093,5114,7207,609,7816
公投第１５案,臺南市,新營區,,,64949,10841,20018,30859,1481,32340
公投第１５案,臺南市,山上區,,,6511,928,1713,2641,228,2869
公投第１５案,臺南市,東區,,,153359,29616,50890,80506,3419,83925
公投第１５案,臺南市,七股區,,,19950,2723,5757,8480,620,9100
公投第１５案,臺南市,安南區,,,159654,27446,51577,79023,4606,83629
公投第１５案,臺南市,佳里區,,,50407,8520,16286,24806,1494,26300
公投第１５案,臺南市,北區,,,110906,20680,36676,57356,2527,59883
公投第１５案,臺南市,新化區,,,37296,6530,12063,18593,1427,20020
公投第１５案,臺南市,永康區,,,195001,34171,62863,97034,4478,101512
公投第１５案,臺南市,關廟區,,,29913,4948,9878,14826,1096,15922
公投第１５案,臺南市,歸仁區,,,57387,9988,18728,28716,1767,30483
公投第１５案,臺南市,仁德區,,,64632,10819,21560,32379,2074,34453
公投第１５案,臺南市,善化區,,,39950,7092,12087,19179,1284,20463
公投第１５案,臺南市,東山區,,,18471,2089,4204,6293,647,6940
公投第１５案,臺南市,後壁區,,,20841,2975,5775,8750,867,9617
公投第１５案,臺南市,大內區,,,8654,1171,2546,3717,426,4143
公投第１５案,臺南市,楠西區,,,8528,995,2544,3539,319,3858
公投第１５案,臺南市,左鎮區,,,4418,501,1245,1746,232,1978
公投第１５案,臺南市,北門區,,,9925,1139,2677,3816,260,4076
公投第１５案,臺南市,中西區,,,65261,12476,21937,34413,1793,36206
公投第１５案,臺南市,龍崎區,,,3713,485,1167,1652,150,1802
公投第１５案,臺南市,下營區,,,20947,3091,5832,8923,913,9836
公投第１５案,臺南市,白河區,,,24894,3476,6415,9891,838,10729
公投第１５案,臺南市,西港區,,,21564,3256,6328,9584,568,10152
公投第１５案,臺南市,學甲區,,,22567,3357,6682,10039,668,10707
公投第１５案,臺南市,麻豆區,,,37963,6621,10960,17581,1048,18629
公投第１５案,臺南市,柳營區,,,18804,2872,5658,8530,766,9296
公投第１５案,臺南市,玉井區,,,12357,1665,3878,5543,462,6005
公投第１５案,臺南市,南區,,,108650,18076,34732,52808,3166,55974
公投第１５案,臺南市,安定區,,,26104,4337,8389,12726,919,13645
公投第１５案,臺南市,安平區,,,55379,9779,17393,27172,1048,28220
公投第１５案,臺南市,新市區,,,30386,5374,9981,15355,957,16312
公投第１５案,桃園市,桃園區,,,359790,63229,111711,174940,7703,182643
公投第１５案,桃園市,八德區,,,165065,26246,52650,78896,4541,83437
公投第１５案,桃園市,平鎮區,,,183560,29969,63734,93703,4046,97749
公投第１５案,桃園市,龍潭區,,,101574,15518,36190,51708,2635,54343
公投第１５案,桃園市,龜山區,,,131702,22419,39443,61862,3057,64919
公投第１５案,桃園市,大溪區,,,78285,12329,26181,38510,2824,41334
公投第１５案,桃園市,觀音區,,,55149,8475,17670,26145,1647,27792
公投第１５案,桃園市,中壢區,,,334402,55628,113277,168905,7506,176411
公投第１５案,桃園市,楊梅區,,,137917,21210,46233,67443,3207,70650
公投第１５案,桃園市,新屋區,,,41461,6408,15202,21610,1394,23004
公投第１５案,桃園市,復興區,,,9766,984,4041,5025,294,5319
公投第１５案,桃園市,大園區,,,73900,11444,23644,35088,1798,36886
公投第１５案,桃園市,蘆竹區,,,129252,21787,40963,62750,3168,65918
公投第１５案,連江縣,南竿鄉,介壽村,1,1967,296,690,986,28,1014
公投第１５案,連江縣,南竿鄉,福沃村、復興村,2,1837,224,622,846,38,884
公投第１５案,連江縣,南竿鄉,清水村、珠螺村,3,1114,163,407,570,18,588
公投第１５案,連江縣,南竿鄉,馬祖村、津沙村、四維村、仁愛村,4,1543,166,623,789,14,803
公投第１５案,連江縣,北竿鄉,后沃村、橋仔村、塘岐村,5,1515,189,599,788,26,814
公投第１５案,連江縣,北竿鄉,坂里村、白沙村、芹壁村,6,610,77,212,289,7,296
公投第１５案,連江縣,莒光鄉,田沃村、西坵村、青帆村,7,698,96,235,331,11,342
公投第１５案,連江縣,莒光鄉,大坪村、福正村,8,783,104,325,429,14,443
公投第１５案,連江縣,東引鄉,樂華村、中柳村,9,1138,165,397,562,15,577
公投第１５案,金門縣,金城鎮,東門里,1,1396,115,358,473,30,503
公投第１５案,金門縣,金城鎮,東門里,2,1831,170,501,671,24,695
公投第１５案,金門縣,金城鎮,東門里,3,1750,146,464,610,32,642
公投第１５案,金門縣,金城鎮,南門里,4,1889,167,495,662,55,717
公投第１５案,金門縣,金城鎮,南門里,5,1675,165,346,511,25,536
公投第１５案,金門縣,金城鎮,南門里,6,1901,163,592,755,23,778
公投第１５案,金門縣,金城鎮,西門里,7,1610,163,352,515,42,557
公投第１５案,金門縣,金城鎮,西門里,8,1687,143,428,571,31,602
公投第１５案,金門縣,金城鎮,西門里,9,1594,225,339,564,17,581
公投第１５案,金門縣,金城鎮,西門里,10,1726,156,449,605,13,618
公投第１５案,金門縣,金城鎮,西門里,11,1733,153,461,614,17,631
公投第１５案,金門縣,金城鎮,西門里,12,1532,140,449,589,27,616
公投第１５案,金門縣,金城鎮,北門里,13,2079,168,511,679,42,721
公投第１５案,金門縣,金城鎮,北門里,14,2033,177,451,628,25,653
公投第１５案,金門縣,金城鎮,賢庵里,15,2517,220,614,834,48,882
公投第１５案,金門縣,金城鎮,賢庵里,16,2083,172,521,693,37,730
公投第１５案,金門縣,金城鎮,金水里,17,2140,148,554,702,33,735
公投第１５案,金門縣,金城鎮,古城里,18,2435,163,507,670,50,720
公投第１５案,金門縣,金城鎮,古城里,19,1353,67,259,326,19,345
公投第１５案,金門縣,金城鎮,珠沙里,20,1574,100,374,474,19,493
公投第１５案,金門縣,金城鎮,珠沙里,21,1277,120,322,442,36,478
公投第１５案,金門縣,金寧鄉,古寧村,22,1735,99,385,484,57,541
公投第１５案,金門縣,金寧鄉,古寧村,23,1537,112,352,464,22,486
公投第１５案,金門縣,金寧鄉,安美村,24,1766,178,382,560,35,595
公投第１５案,金門縣,金寧鄉,安美村,25,1015,93,264,357,18,375
公投第１５案,金門縣,金寧鄉,安美村,26,1726,117,460,577,33,610
公投第１５案,金門縣,金寧鄉,湖埔村,27,1691,121,396,517,21,538
公投第１５案,金門縣,金寧鄉,湖埔村,28,2044,538,307,845,21,866
公投第１５案,金門縣,金寧鄉,湖埔村,29,1848,191,545,736,28,764
公投第１５案,金門縣,金寧鄉,湖埔村,30,1735,156,437,593,27,620
公投第１５案,金門縣,金寧鄉,榜林村,31,1795,162,434,596,31,627
公投第１５案,金門縣,金寧鄉,榜林村,32,1834,97,446,543,38,581
公投第１５案,金門縣,金寧鄉,榜林村,33,1528,126,367,493,19,512
公投第１５案,金門縣,金寧鄉,盤山村,34,1473,120,424,544,24,568
公投第１５案,金門縣,金寧鄉,盤山村,35,1679,147,429,576,26,602
公投第１５案,金門縣,金寧鄉,盤山村,36,1921,674,245,919,14,933
公投第１５案,金門縣,金寧鄉,盤山村,37,1298,126,326,452,15,467
公投第１５案,金門縣,金寧鄉,后盤村,38,1537,113,374,487,19,506
公投第１５案,金門縣,烈嶼鄉,林湖村,39,1647,149,553,702,20,722
公投第１５案,金門縣,烈嶼鄉,林湖村,40,1733,121,462,583,34,617
公投第１５案,金門縣,烈嶼鄉,黃埔村,41,1635,128,455,583,24,607
公投第１５案,金門縣,烈嶼鄉,西口村,42,1296,103,319,422,18,440
公投第１５案,金門縣,烈嶼鄉,西口村,43,1099,63,273,336,20,356
公投第１５案,金門縣,烈嶼鄉,上林村,44,1425,108,347,455,28,483
公投第１５案,金門縣,烈嶼鄉,上岐村,45,1412,96,413,509,16,525
公投第１５案,金門縣,烈嶼鄉,上岐村,46,1429,101,380,481,26,507
公投第１５案,金門縣,烏坵鄉,大坵村,47,275,22,54,76,2,78
公投第１５案,金門縣,烏坵鄉,小坵村,48,292,16,71,87,0,87
公投第１５案,金門縣,金湖鎮,新市里,49,1348,144,368,512,28,540
公投第１５案,金門縣,金湖鎮,新市里,50,1386,119,344,463,26,489
公投第１５案,金門縣,金湖鎮,新市里,51,1403,130,449,579,26,605
公投第１５案,金門縣,金湖鎮,山外里,52,1771,155,493,648,26,674
公投第１５案,金門縣,金湖鎮,山外里,53,1493,143,368,511,45,556
公投第１５案,金門縣,金湖鎮,溪湖里,54,1510,99,382,481,54,535
公投第１５案,金門縣,金湖鎮,蓮庵里,55,1607,131,448,579,30,609
公投第１５案,金門縣,金湖鎮,料羅里,56,2006,140,498,638,32,670
公投第１５案,金門縣,金湖鎮,新湖里,57,1780,196,416,612,30,642
公投第１５案,金門縣,金湖鎮,新湖里,58,1739,176,442,618,17,635
公投第１５案,金門縣,金湖鎮,新湖里,59,1384,115,340,455,24,479
公投第１５案,金門縣,金湖鎮,新湖里,60,1400,139,363,502,26,528
公投第１５案,金門縣,金湖鎮,新湖里,61,1325,151,420,571,16,587
公投第１５案,金門縣,金湖鎮,正義里,62,1236,102,292,394,20,414
公投第１５案,金門縣,金湖鎮,正義里,63,1382,112,333,445,35,480
公投第１５案,金門縣,金湖鎮,瓊林里,64,1631,99,441,540,20,560
公投第１５案,金門縣,金湖鎮,瓊林里,65,1514,99,359,458,35,493
公投第１５案,金門縣,金沙鎮,汶沙里,66,1909,120,498,618,42,660
公投第１５案,金門縣,金沙鎮,汶沙里,67,1524,125,468,593,32,625
公投第１５案,金門縣,金沙鎮,汶沙里,68,1673,96,422,518,29,547
公投第１５案,金門縣,金沙鎮,何斗里,69,2003,112,516,628,30,658
公投第１５案,金門縣,金沙鎮,浦山里,70,1212,106,361,467,26,493
公投第１５案,金門縣,金沙鎮,浦山里,71,1126,90,292,382,27,409
公投第１５案,金門縣,金沙鎮,西園里,72,1540,97,354,451,28,479
公投第１５案,金門縣,金沙鎮,官嶼里,73,1216,73,285,358,20,378
公投第１５案,金門縣,金沙鎮,官嶼里,74,950,46,202,248,11,259
公投第１５案,金門縣,金沙鎮,三山里,75,1895,122,547,669,32,701
公投第１５案,金門縣,金沙鎮,大洋里,76,1135,84,346,430,32,462
公投第１５案,金門縣,金沙鎮,光前里,77,1252,96,317,413,25,438
公投第１５案,金門縣,金沙鎮,光前里,78,1125,91,359,450,13,463
公投第１５案,宜蘭縣,宜蘭市,民族里,1,982,165,352,517,17,534
公投第１５案,宜蘭縣,宜蘭市,民族里,2,1270,216,438,654,47,701
公投第１５案,宜蘭縣,宜蘭市,建軍里,3,849,180,278,458,14,472
公投第１５案,宜蘭縣,宜蘭市,建軍里,4,756,150,269,419,20,439
公投第１５案,宜蘭縣,宜蘭市,泰山里,5,1107,162,363,525,38,563
公投第１５案,宜蘭縣,宜蘭市,泰山里,6,893,147,308,455,42,497
公投第１５案,宜蘭縣,宜蘭市,負郭里,7,912,177,301,478,32,510
公投第１５案,宜蘭縣,宜蘭市,負郭里,8,1335,253,459,712,40,752
公投第１５案,宜蘭縣,宜蘭市,負郭里,9,686,108,236,344,23,367
公投第１５案,宜蘭縣,宜蘭市,思源里,10,1366,307,493,800,26,826
公投第１５案,宜蘭縣,宜蘭市,思源里,11,1363,317,441,758,18,776
公投第１５案,宜蘭縣,宜蘭市,思源里,12,1540,312,541,853,36,889
公投第１５案,宜蘭縣,宜蘭市,七結里,13,1341,264,477,741,13,754
公投第１５案,宜蘭縣,宜蘭市,七結里,14,1209,224,421,645,42,687
公投第１５案,宜蘭縣,宜蘭市,文化里,15,900,179,300,479,34,513
公投第１５案,宜蘭縣,宜蘭市,文化里,16,980,164,320,484,28,512
公投第１５案,宜蘭縣,宜蘭市,文化里,17,1165,243,381,624,27,651
公投第１５案,宜蘭縣,宜蘭市,復興里,18,904,144,331,475,28,503
公投第１５案,宜蘭縣,宜蘭市,復興里,19,813,153,292,445,21,466
公投第１５案,宜蘭縣,宜蘭市,復興里,20,978,196,315,511,32,543
公投第１５案,宜蘭縣,宜蘭市,民權里,21,1282,186,366,552,31,583
公投第１５案,宜蘭縣,宜蘭市,民權里,22,465,92,175,267,10,277
公投第１５案,宜蘭縣,宜蘭市,神農里,23,669,121,245,366,32,398
公投第１５案,宜蘭縣,宜蘭市,神農里,24,923,170,334,504,23,527
公投第１５案,宜蘭縣,宜蘭市,神農里,25,1006,181,333,514,25,539
公投第１５案,宜蘭縣,宜蘭市,大新里,26,762,156,298,454,46,500
公投第１５案,宜蘭縣,宜蘭市,新民里,27,727,141,290,431,35,466
公投第１５案,宜蘭縣,宜蘭市,新民里,28,833,169,340,509,50,559
公投第１５案,宜蘭縣,宜蘭市,進士里,29,1143,217,399,616,31,647
公投第１５案,宜蘭縣,宜蘭市,進士里,30,979,196,330,526,16,542
公投第１５案,宜蘭縣,宜蘭市,南橋里,31,1214,209,418,627,55,682
公投第１５案,宜蘭縣,宜蘭市,凱旋里,32,1283,246,435,681,58,739
公投第１５案,宜蘭縣,宜蘭市,南津里,33,946,183,343,526,25,551
公投第１５案,宜蘭縣,宜蘭市,南津里,34,1090,183,371,554,31,585
公投第１５案,宜蘭縣,宜蘭市,建業里,35,943,214,323,537,24,561
公投第１５案,宜蘭縣,宜蘭市,建業里,36,774,224,249,473,25,498
公投第１５案,宜蘭縣,宜蘭市,擺厘里,37,968,201,359,560,31,591
公投第１５案,宜蘭縣,宜蘭市,擺厘里,38,926,210,335,545,27,572
公投第１５案,宜蘭縣,宜蘭市,擺厘里,39,1019,224,354,578,34,612
公投第１５案,宜蘭縣,宜蘭市,延平里,40,1084,193,377,570,48,618
公投第１５案,宜蘭縣,宜蘭市,延平里,41,1095,208,360,568,28,596
公投第１５案,宜蘭縣,宜蘭市,延平里,42,1083,227,368,595,27,622
公投第１５案,宜蘭縣,宜蘭市,成功里,43,1108,196,360,556,36,592
公投第１５案,宜蘭縣,宜蘭市,成功里,44,848,178,303,481,12,493
公投第１５案,宜蘭縣,宜蘭市,成功里,45,1095,204,375,579,25,604
公投第１５案,宜蘭縣,宜蘭市,東村里,46,1110,220,382,602,26,628
公投第１５案,宜蘭縣,宜蘭市,東村里,47,1104,224,391,615,31,646
公投第１５案,宜蘭縣,宜蘭市,新東里,48,1134,212,404,616,32,648
公投第１５案,宜蘭縣,宜蘭市,新東里,49,1146,209,424,633,28,661
公投第１５案,宜蘭縣,宜蘭市,新東里,50,876,173,316,489,44,533
公投第１５案,宜蘭縣,宜蘭市,黎明里,51,905,152,317,469,38,507
公投第１５案,宜蘭縣,宜蘭市,黎明里,52,910,173,327,500,34,534
公投第１５案,宜蘭縣,宜蘭市,七張里,53,1434,233,431,664,39,703
公投第１５案,宜蘭縣,宜蘭市,孝廉里,54,1152,209,374,583,54,637
公投第１５案,宜蘭縣,宜蘭市,東門里,55,966,211,334,545,33,578
公投第１５案,宜蘭縣,宜蘭市,小東里,56,711,160,230,390,27,417
公投第１５案,宜蘭縣,宜蘭市,小東里,57,884,185,315,500,36,536
公投第１５案,宜蘭縣,宜蘭市,菜園里,58,1326,251,475,726,39,765
公投第１５案,宜蘭縣,宜蘭市,慈安里,59,909,165,288,453,21,474
公投第１５案,宜蘭縣,宜蘭市,慈安里,60,894,161,300,461,30,491
公投第１５案,宜蘭縣,宜蘭市,中興里,61,1259,212,396,608,31,639
公投第１５案,宜蘭縣,宜蘭市,中興里,62,789,126,269,395,22,417
公投第１５案,宜蘭縣,宜蘭市,中興里,63,867,154,300,454,31,485
公投第１５案,宜蘭縣,宜蘭市,新生里,64,1454,249,482,731,77,808
公投第１５案,宜蘭縣,宜蘭市,新生里,65,1130,188,479,667,25,692
公投第１５案,宜蘭縣,宜蘭市,茭白里,66,1087,157,345,502,16,518
公投第１５案,宜蘭縣,宜蘭市,茭白里,67,938,173,350,523,55,578
公投第１５案,宜蘭縣,宜蘭市,北津里,68,1285,237,450,687,37,724
公投第１５案,宜蘭縣,宜蘭市,北津里,69,952,184,299,483,26,509
公投第１５案,宜蘭縣,宜蘭市,梅洲里,70,948,180,344,524,48,572
公投第１５案,宜蘭縣,宜蘭市,梅洲里,71,1160,202,367,569,42,611
公投第１５案,宜蘭縣,宜蘭市,梅洲里,72,1015,175,376,551,51,602
公投第１５案,宜蘭縣,宜蘭市,南門里,73,424,91,158,249,12,261
公投第１５案,宜蘭縣,宜蘭市,南門里,74,964,196,337,533,36,569
公投第１５案,宜蘭縣,宜蘭市,中山里,75,959,170,305,475,40,515
公投第１５案,宜蘭縣,宜蘭市,西門里,76,814,165,320,485,35,520
公投第１５案,宜蘭縣,宜蘭市,西門里,77,885,143,352,495,31,526
公投第１５案,宜蘭縣,宜蘭市,北門里,78,1162,267,411,678,59,737
公投第１５案,宜蘭縣,羅東鎮,開明里,79,689,153,226,379,29,408
公投第１５案,宜蘭縣,羅東鎮,開明里,80,718,133,247,380,19,399
公投第１５案,宜蘭縣,羅東鎮,大新里,81,1475,284,477,761,62,823
公投第１５案,宜蘭縣,羅東鎮,東安里,82,1466,283,448,731,66,797
公投第１５案,宜蘭縣,羅東鎮,東安里,83,1075,215,363,578,28,606
公投第１５案,宜蘭縣,羅東鎮,東安里,84,963,183,322,505,32,537
公投第１５案,宜蘭縣,羅東鎮,新群里,85,1511,270,471,741,74,815
公投第１５案,宜蘭縣,羅東鎮,新群里,86,1166,235,373,608,28,636
公投第１５案,宜蘭縣,羅東鎮,羅莊里,87,1273,262,329,591,48,639
公投第１５案,宜蘭縣,羅東鎮,羅莊里,88,1735,314,571,885,30,915
公投第１５案,宜蘭縣,羅東鎮,南昌里,89,1487,281,530,811,37,848
公投第１５案,宜蘭縣,羅東鎮,南昌里,90,837,185,286,471,33,504
公投第１５案,宜蘭縣,羅東鎮,南豪里,91,1312,265,464,729,57,786
公投第１５案,宜蘭縣,羅東鎮,成功里,92,1502,284,467,751,46,797
公投第１５案,宜蘭縣,羅東鎮,仁德里,93,1138,225,358,583,21,604
公投第１５案,宜蘭縣,羅東鎮,仁和里,94,1010,184,339,523,37,560
公投第１５案,宜蘭縣,羅東鎮,中山里,95,1373,241,470,711,82,793
公投第１５案,宜蘭縣,羅東鎮,漢民里,96,1089,202,377,579,34,613
公投第１５案,宜蘭縣,羅東鎮,漢民里,97,1304,207,461,668,42,710
公投第１５案,宜蘭縣,羅東鎮,漢民里,98,1288,237,395,632,63,695
公投第１５案,宜蘭縣,羅東鎮,維揚里,99,1036,220,375,595,46,641
公投第１５案,宜蘭縣,羅東鎮,維揚里,100,969,179,402,581,37,618
公投第１５案,宜蘭縣,羅東鎮,維揚里,101,985,200,346,546,46,592
公投第１５案,宜蘭縣,羅東鎮,西安里,102,1420,266,496,762,69,831
公投第１５案,宜蘭縣,羅東鎮,西安里,103,1430,270,506,776,43,819
公投第１５案,宜蘭縣,羅東鎮,北成里,104,1075,214,372,586,47,633
公投第１５案,宜蘭縣,羅東鎮,北成里,105,879,182,308,490,40,530
公投第１５案,宜蘭縣,羅東鎮,北成里,106,850,173,282,455,20,475
公投第１５案,宜蘭縣,羅東鎮,國華里,107,1111,258,378,636,29,665
公投第１５案,宜蘭縣,羅東鎮,國華里,108,1139,230,444,674,40,714
公投第１５案,宜蘭縣,羅東鎮,國華里,109,1130,254,410,664,33,697
公投第１５案,宜蘭縣,羅東鎮,國華里,110,980,198,357,555,25,580
公投第１５案,宜蘭縣,羅東鎮,賢文里,111,1431,292,478,770,35,805
公投第１５案,宜蘭縣,羅東鎮,賢文里,112,1109,226,372,598,35,633
公投第１５案,宜蘭縣,羅東鎮,賢文里,113,1083,206,377,583,27,610
公投第１５案,宜蘭縣,羅東鎮,公正里,114,1404,261,511,772,41,813
公投第１５案,宜蘭縣,羅東鎮,公正里,115,1288,264,442,706,36,742
公投第１５案,宜蘭縣,羅東鎮,集祥里,116,1183,182,319,501,45,546
公投第１５案,宜蘭縣,羅東鎮,信義里,117,1105,208,420,628,31,659
公投第１５案,宜蘭縣,羅東鎮,信義里,118,987,209,360,569,35,604
公投第１５案,宜蘭縣,羅東鎮,信義里,119,773,158,282,440,34,474
公投第１５案,宜蘭縣,羅東鎮,樹林里,120,1366,302,525,827,38,865
公投第１５案,宜蘭縣,羅東鎮,樹林里,121,907,208,356,564,21,585
公投第１５案,宜蘭縣,羅東鎮,樹林里,122,1158,241,447,688,31,719
公投第１５案,宜蘭縣,羅東鎮,竹林里,123,977,204,307,511,58,569
公投第１５案,宜蘭縣,羅東鎮,竹林里,124,972,180,302,482,49,531
公投第１５案,宜蘭縣,羅東鎮,竹林里,125,977,195,353,548,33,581
公投第１５案,宜蘭縣,羅東鎮,仁愛里,126,1398,267,509,776,50,826
公投第１５案,宜蘭縣,羅東鎮,仁愛里,127,1022,195,352,547,28,575
公投第１５案,宜蘭縣,羅東鎮,仁愛里,128,1131,227,435,662,32,694
公投第１５案,宜蘭縣,蘇澳鎮,龍德里,129,1194,217,403,620,54,674
公投第１５案,宜蘭縣,蘇澳鎮,龍德里,130,1128,189,391,580,30,610
公投第１５案,宜蘭縣,蘇澳鎮,龍德里,131,1042,238,360,598,45,643
公投第１５案,宜蘭縣,蘇澳鎮,頂寮里,132,997,217,335,552,35,587
公投第１５案,宜蘭縣,蘇澳鎮,永榮里,133,1303,268,413,681,56,737
公投第１５案,宜蘭縣,蘇澳鎮,永榮里,134,1260,265,422,687,58,745
公投第１５案,宜蘭縣,蘇澳鎮,永榮里,135,1130,203,385,588,63,651
公投第１５案,宜蘭縣,蘇澳鎮,存仁里,136,559,98,177,275,41,316
公投第１５案,宜蘭縣,蘇澳鎮,存仁里,137,351,62,101,163,24,187
公投第１５案,宜蘭縣,蘇澳鎮,港邊里,138,889,161,278,439,56,495
公投第１５案,宜蘭縣,蘇澳鎮,港邊里,139,434,69,147,216,25,241
公投第１５案,宜蘭縣,蘇澳鎮,隘丁里,140,835,174,307,481,29,510
公投第１５案,宜蘭縣,蘇澳鎮,隘丁里,141,975,194,324,518,41,559
公投第１５案,宜蘭縣,蘇澳鎮,隘丁里,142,1135,225,377,602,73,675
公投第１５案,宜蘭縣,蘇澳鎮,新城里,143,788,198,282,480,34,514
公投第１５案,宜蘭縣,蘇澳鎮,新城里,144,469,79,162,241,21,262
公投第１５案,宜蘭縣,蘇澳鎮,聖愛里,145,811,126,279,405,33,438
公投第１５案,宜蘭縣,蘇澳鎮,聖愛里,146,867,128,323,451,22,473
公投第１５案,宜蘭縣,蘇澳鎮,聖愛里,147,1139,198,411,609,33,642
公投第１５案,宜蘭縣,蘇澳鎮,聖湖里,148,1146,174,378,552,50,602
公投第１５案,宜蘭縣,蘇澳鎮,聖湖里,149,1154,193,412,605,49,654
公投第１５案,宜蘭縣,蘇澳鎮,蘇西里,150,908,158,283,441,18,459
公投第１５案,宜蘭縣,蘇澳鎮,蘇西里,151,656,97,245,342,21,363
公投第１５案,宜蘭縣,蘇澳鎮,蘇西里,152,834,152,324,476,45,521
公投第１５案,宜蘭縣,蘇澳鎮,蘇北里,153,1025,196,381,577,37,614
公投第１５案,宜蘭縣,蘇澳鎮,蘇南里,154,455,89,163,252,12,264
公投第１５案,宜蘭縣,蘇澳鎮,蘇東里,155,535,112,172,284,29,313
公投第１５案,宜蘭縣,蘇澳鎮,長安里,156,536,105,219,324,20,344
公投第１５案,宜蘭縣,蘇澳鎮,永光里,157,451,82,174,256,19,275
公投第１５案,宜蘭縣,蘇澳鎮,永春里,158,593,101,193,294,38,332
公投第１５案,宜蘭縣,蘇澳鎮,永樂里,159,441,73,162,235,21,256
公投第１５案,宜蘭縣,蘇澳鎮,南安里,160,954,169,338,507,44,551
公投第１５案,宜蘭縣,蘇澳鎮,南正里,161,952,153,316,469,49,518
公投第１５案,宜蘭縣,蘇澳鎮,南成里,162,1125,162,357,519,72,591
公投第１５案,宜蘭縣,蘇澳鎮,南興里,163,763,114,256,370,63,433
公投第１５案,宜蘭縣,蘇澳鎮,南興里,164,706,89,200,289,31,320
公投第１５案,宜蘭縣,蘇澳鎮,南寧里,165,1068,146,305,451,62,513
公投第１５案,宜蘭縣,蘇澳鎮,南建里,166,666,119,220,339,49,388
公投第１５案,宜蘭縣,蘇澳鎮,南建里,167,574,88,184,272,58,330
公投第１５案,宜蘭縣,蘇澳鎮,東澳里,168,351,54,88,142,9,151
公投第１５案,宜蘭縣,蘇澳鎮,南強里,169,717,117,238,355,50,405
公投第１５案,宜蘭縣,蘇澳鎮,朝陽里,170,373,37,106,143,13,156
公投第１５案,宜蘭縣,蘇澳鎮,朝陽里,171,223,41,43,84,10,94
公投第１５案,宜蘭縣,頭城鎮,石城里,172,292,28,65,93,12,105
公投第１５案,宜蘭縣,頭城鎮,大里里,173,688,111,223,334,38,372
公投第１５案,宜蘭縣,頭城鎮,龜山里,174,688,101,253,354,42,396
公投第１５案,宜蘭縣,頭城鎮,大溪里,175,879,130,271,401,48,449
公投第１５案,宜蘭縣,頭城鎮,合興里,176,335,59,121,180,24,204
公投第１５案,宜蘭縣,頭城鎮,更新里,177,624,107,245,352,41,393
公投第１５案,宜蘭縣,頭城鎮,更新里,178,732,109,207,316,27,343
公投第１５案,宜蘭縣,頭城鎮,外澳里,179,892,149,234,383,35,418
公投第１５案,宜蘭縣,頭城鎮,港口里,180,690,110,166,276,37,313
公投第１５案,宜蘭縣,頭城鎮,武營里,181,842,141,282,423,29,452
公投第１５案,宜蘭縣,頭城鎮,武營里,182,736,145,232,377,34,411
公投第１５案,宜蘭縣,頭城鎮,大坑里,183,788,134,239,373,28,401
公投第１５案,宜蘭縣,頭城鎮,大坑里,184,560,86,179,265,21,286
公投第１５案,宜蘭縣,頭城鎮,城東里,185,712,133,259,392,32,424
公投第１５案,宜蘭縣,頭城鎮,城北里,186,502,97,204,301,21,322
公投第１５案,宜蘭縣,頭城鎮,城西里,187,569,122,208,330,28,358
公投第１５案,宜蘭縣,頭城鎮,城南里,188,633,110,224,334,27,361
公投第１５案,宜蘭縣,頭城鎮,竹安里,189,1132,181,310,491,44,535
公投第１５案,宜蘭縣,頭城鎮,竹安里,190,1035,157,300,457,38,495
公投第１５案,宜蘭縣,頭城鎮,新建里,191,847,156,305,461,43,504
公投第１５案,宜蘭縣,頭城鎮,新建里,192,1172,238,384,622,39,661
公投第１５案,宜蘭縣,頭城鎮,拔雅里,193,896,171,273,444,27,471
公投第１５案,宜蘭縣,頭城鎮,拔雅里,194,1075,213,412,625,23,648
公投第１５案,宜蘭縣,頭城鎮,福成里,195,931,155,335,490,57,547
公投第１５案,宜蘭縣,頭城鎮,金面里,196,1021,158,359,517,45,562
公投第１５案,宜蘭縣,頭城鎮,金面里,197,709,97,215,312,39,351
公投第１５案,宜蘭縣,頭城鎮,金盈里,198,689,118,279,397,45,442
公投第１５案,宜蘭縣,頭城鎮,頂埔里,199,615,122,232,354,31,385
公投第１５案,宜蘭縣,頭城鎮,頂埔里,200,759,138,238,376,39,415
公投第１５案,宜蘭縣,頭城鎮,下埔里,201,917,175,337,512,54,566
公投第１５案,宜蘭縣,頭城鎮,中崙里,202,1045,179,363,542,59,601
公投第１５案,宜蘭縣,頭城鎮,二城里,203,1130,202,388,590,52,642
公投第１５案,宜蘭縣,礁溪鄉,白雲村,204,1122,176,327,503,40,543
公投第１５案,宜蘭縣,礁溪鄉,白雲村,205,505,86,158,244,24,268
公投第１５案,宜蘭縣,礁溪鄉,玉石村,206,988,164,314,478,33,511
公投第１５案,宜蘭縣,礁溪鄉,玉石村,207,971,159,325,484,36,520
公投第１５案,宜蘭縣,礁溪鄉,德陽村,208,1246,200,379,579,41,620
公投第１５案,宜蘭縣,礁溪鄉,德陽村,209,1655,257,485,742,39,781
公投第１５案,宜蘭縣,礁溪鄉,德陽村,210,1132,163,324,487,29,516
公投第１５案,宜蘭縣,礁溪鄉,大忠村,211,783,156,261,417,25,442
公投第１５案,宜蘭縣,礁溪鄉,大忠村,212,928,154,316,470,28,498
公投第１５案,宜蘭縣,礁溪鄉,大忠村,213,848,142,279,421,35,456
公投第１５案,宜蘭縣,礁溪鄉,大義村,214,663,145,247,392,30,422
公投第１５案,宜蘭縣,礁溪鄉,六結村,215,608,99,223,322,18,340
公投第１５案,宜蘭縣,礁溪鄉,六結村,216,833,140,301,441,29,470
公投第１５案,宜蘭縣,礁溪鄉,二龍村,217,1233,221,358,579,20,599
公投第１５案,宜蘭縣,礁溪鄉,時潮村,218,854,160,281,441,39,480
公投第１５案,宜蘭縣,礁溪鄉,時潮村,219,575,104,181,285,15,300
公投第１５案,宜蘭縣,礁溪鄉,玉田村,220,835,147,285,432,37,469
公投第１５案,宜蘭縣,礁溪鄉,玉田村,221,1305,253,441,694,56,750
公投第１５案,宜蘭縣,礁溪鄉,三民村,222,830,140,272,412,49,461
公投第１５案,宜蘭縣,礁溪鄉,三民村,223,649,144,236,380,47,427
公投第１５案,宜蘭縣,礁溪鄉,三民村,224,923,137,265,402,44,446
公投第１５案,宜蘭縣,礁溪鄉,林美村,225,1177,153,351,504,40,544
公投第１５案,宜蘭縣,礁溪鄉,白鵝村,226,840,139,282,421,40,461
公投第１５案,宜蘭縣,礁溪鄉,玉光村,227,1051,187,382,569,27,596
公投第１５案,宜蘭縣,礁溪鄉,光武村,228,1339,233,404,637,45,682
公投第１５案,宜蘭縣,礁溪鄉,吳沙村,229,1194,192,475,667,41,708
公投第１５案,宜蘭縣,礁溪鄉,吳沙村,230,1314,219,480,699,73,772
公投第１５案,宜蘭縣,礁溪鄉,龍潭村,231,1125,232,370,602,20,622
公投第１５案,宜蘭縣,礁溪鄉,龍潭村,232,1207,231,434,665,56,721
公投第１５案,宜蘭縣,礁溪鄉,龍潭村,233,979,186,299,485,64,549
公投第１５案,宜蘭縣,礁溪鄉,匏崙村,234,954,171,302,473,112,585
公投第１５案,宜蘭縣,礁溪鄉,二結村,235,418,70,160,230,6,236
公投第１５案,宜蘭縣,壯圍鄉,吉祥村,236,1435,264,526,790,75,865
公投第１５案,宜蘭縣,壯圍鄉,吉祥村,237,1049,200,378,578,49,627
公投第１５案,宜蘭縣,壯圍鄉,古結村,238,1068,229,385,614,43,657
公投第１５案,宜蘭縣,壯圍鄉,美福村,239,868,140,285,425,76,501
公投第１５案,宜蘭縣,壯圍鄉,美福村,240,967,167,332,499,29,528
公投第１５案,宜蘭縣,壯圍鄉,新南村,241,940,195,315,510,62,572
公投第１５案,宜蘭縣,壯圍鄉,東港村,242,975,154,297,451,23,474
公投第１５案,宜蘭縣,壯圍鄉,復興村,243,797,148,278,426,63,489
公投第１５案,宜蘭縣,壯圍鄉,復興村,244,808,121,289,410,51,461
公投第１５案,宜蘭縣,壯圍鄉,過嶺村,245,911,204,274,478,65,543
公投第１５案,宜蘭縣,壯圍鄉,過嶺村,246,612,94,183,277,39,316
公投第１５案,宜蘭縣,壯圍鄉,永鎮村,247,790,152,288,440,56,496
公投第１５案,宜蘭縣,壯圍鄉,忠孝村,248,878,159,302,461,63,524
公投第１５案,宜蘭縣,壯圍鄉,忠孝村,249,723,153,279,432,43,475
公投第１５案,宜蘭縣,壯圍鄉,忠孝村,250,737,121,234,355,31,386
公投第１５案,宜蘭縣,壯圍鄉,古亭村,251,686,138,218,356,57,413
公投第１５案,宜蘭縣,壯圍鄉,古亭村,252,895,161,291,452,9,461
公投第１５案,宜蘭縣,壯圍鄉,功勞村,253,1237,215,452,667,89,756
公投第１５案,宜蘭縣,壯圍鄉,美城村,254,1134,218,388,606,45,651
公投第１５案,宜蘭縣,壯圍鄉,美城村,255,1107,187,379,566,46,612
公投第１５案,宜蘭縣,壯圍鄉,新社村,256,1057,203,377,580,43,623
公投第１５案,宜蘭縣,壯圍鄉,大福村,257,1051,162,342,504,34,538
公投第１５案,宜蘭縣,壯圍鄉,大福村,258,722,150,210,360,42,402
公投第１５案,宜蘭縣,員山鄉,員山村,259,1393,247,433,680,36,716
公投第１５案,宜蘭縣,員山鄉,員山村,260,895,176,264,440,24,464
公投第１５案,宜蘭縣,員山鄉,員山村,261,1231,189,426,615,52,667
公投第１５案,宜蘭縣,員山鄉,員山村,262,1098,182,364,546,18,564
公投第１５案,宜蘭縣,員山鄉,員山村,263,1031,186,326,512,24,536
公投第１５案,宜蘭縣,員山鄉,尚德村,264,1030,148,336,484,72,556
公投第１５案,宜蘭縣,員山鄉,尚德村,265,1168,162,346,508,47,555
公投第１５案,宜蘭縣,員山鄉,惠好村,266,809,136,283,419,43,462
公投第１５案,宜蘭縣,員山鄉,惠好村,267,778,142,270,412,36,448
公投第１５案,宜蘭縣,員山鄉,七賢村,268,1465,200,582,782,64,846
公投第１５案,宜蘭縣,員山鄉,深溝村,269,979,199,330,529,52,581
公投第１５案,宜蘭縣,員山鄉,深溝村,270,860,138,303,441,38,479
公投第１５案,宜蘭縣,員山鄉,蓁巷村,271,1205,175,361,536,63,599
公投第１５案,宜蘭縣,員山鄉,內城村,272,1082,185,359,544,68,612
公投第１５案,宜蘭縣,員山鄉,內城村,273,412,71,146,217,27,244
公投第１５案,宜蘭縣,員山鄉,中華村,274,403,58,116,174,18,192
公投第１５案,宜蘭縣,員山鄉,中華村,275,232,20,77,97,7,104
公投第１５案,宜蘭縣,員山鄉,永和村,276,944,178,296,474,38,512
公投第１５案,宜蘭縣,員山鄉,永和村,277,894,175,281,456,44,500
公投第１５案,宜蘭縣,員山鄉,頭分村,278,1356,215,487,702,59,761
公投第１５案,宜蘭縣,員山鄉,枕山村,279,780,133,275,408,46,454
公投第１５案,宜蘭縣,員山鄉,枕山村,280,932,180,337,517,69,586
公投第１５案,宜蘭縣,員山鄉,枕山村,281,583,95,169,264,35,299
公投第１５案,宜蘭縣,員山鄉,同樂村,282,900,133,316,449,55,504
公投第１５案,宜蘭縣,員山鄉,同樂村,283,747,119,248,367,38,405
公投第１５案,宜蘭縣,員山鄉,同樂村,284,788,124,248,372,59,431
公投第１５案,宜蘭縣,員山鄉,湖東村,285,884,153,265,418,46,464
公投第１５案,宜蘭縣,員山鄉,逸仙村,286,857,132,279,411,27,438
公投第１５案,宜蘭縣,員山鄉,湖北村,287,1016,193,296,489,26,515
公投第１５案,宜蘭縣,員山鄉,湖西村,288,690,96,182,278,31,309
公投第１５案,宜蘭縣,員山鄉,湖西村,289,689,111,181,292,71,363
公投第１５案,宜蘭縣,冬山鄉,珍珠村,290,807,181,259,440,46,486
公投第１５案,宜蘭縣,冬山鄉,珍珠村,291,817,180,282,462,15,477
公投第１５案,宜蘭縣,冬山鄉,補城村,292,1156,215,402,617,43,660
公投第１５案,宜蘭縣,冬山鄉,三奇村,293,892,163,282,445,41,486
公投第１５案,宜蘭縣,冬山鄉,大興村,294,897,169,313,482,42,524
公投第１５案,宜蘭縣,冬山鄉,東城村,295,1392,268,523,791,44,835
公投第１５案,宜蘭縣,冬山鄉,香和村,296,1471,349,454,803,34,837
公投第１５案,宜蘭縣,冬山鄉,香和村,297,1435,212,418,630,37,667
公投第１５案,宜蘭縣,冬山鄉,南興村,298,1519,260,486,746,35,781
公投第１５案,宜蘭縣,冬山鄉,南興村,299,1456,285,543,828,41,869
公投第１５案,宜蘭縣,冬山鄉,安平村,300,711,144,254,398,36,434
公投第１５案,宜蘭縣,冬山鄉,冬山村,301,694,118,260,378,25,403
公投第１５案,宜蘭縣,冬山鄉,太和村,302,1526,277,627,904,59,963
公投第１５案,宜蘭縣,冬山鄉,八寶村,303,884,167,290,457,35,492
公投第１５案,宜蘭縣,冬山鄉,丸山村,304,1465,268,418,686,49,735
公投第１５案,宜蘭縣,冬山鄉,中山村,305,488,81,170,251,27,278
公投第１５案,宜蘭縣,冬山鄉,順安村,306,1218,197,414,611,43,654
公投第１５案,宜蘭縣,冬山鄉,順安村,307,1291,207,410,617,42,659
公投第１５案,宜蘭縣,冬山鄉,順安村,308,1324,215,422,637,28,665
公投第１５案,宜蘭縣,冬山鄉,順安村,309,1160,173,365,538,35,573
公投第１５案,宜蘭縣,冬山鄉,永美村,310,1246,219,408,627,46,673
公投第１５案,宜蘭縣,冬山鄉,永美村,311,1754,333,531,864,33,897
公投第１５案,宜蘭縣,冬山鄉,武淵村,312,1217,208,399,607,42,649
公投第１５案,宜蘭縣,冬山鄉,群英村,313,1495,221,448,669,50,719
公投第１５案,宜蘭縣,冬山鄉,群英村,314,937,172,302,474,37,511
公投第１５案,宜蘭縣,冬山鄉,群英村,315,1101,195,348,543,36,579
公投第１５案,宜蘭縣,冬山鄉,群英村,316,1118,172,360,532,52,584
公投第１５案,宜蘭縣,冬山鄉,清溝村,317,1301,257,470,727,22,749
公投第１５案,宜蘭縣,冬山鄉,清溝村,318,1225,223,403,626,28,654
公投第１５案,宜蘭縣,冬山鄉,清溝村,319,1206,244,429,673,30,703
公投第１５案,宜蘭縣,冬山鄉,鹿埔村,320,1278,196,406,602,36,638
公投第１５案,宜蘭縣,冬山鄉,鹿埔村,321,1151,191,375,566,34,600
公投第１５案,宜蘭縣,冬山鄉,得安村,322,1094,141,357,498,40,538
公投第１５案,宜蘭縣,冬山鄉,廣興村,323,1247,261,410,671,32,703
公投第１５案,宜蘭縣,冬山鄉,廣興村,324,1247,205,386,591,40,631
公投第１５案,宜蘭縣,冬山鄉,廣安村,325,979,181,336,517,21,538
公投第１５案,宜蘭縣,冬山鄉,廣安村,326,698,140,257,397,27,424
公投第１５案,宜蘭縣,冬山鄉,柯林村,327,1726,303,566,869,39,908
公投第１５案,宜蘭縣,冬山鄉,大進村,328,782,108,212,320,18,338
公投第１５案,宜蘭縣,五結鄉,三興村,329,1076,177,340,517,40,557
公投第１５案,宜蘭縣,五結鄉,三興村,330,944,185,291,476,22,498
公投第１５案,宜蘭縣,五結鄉,二結村,331,836,157,302,459,19,478
公投第１５案,宜蘭縣,五結鄉,二結村,332,937,172,326,498,35,533
公投第１５案,宜蘭縣,五結鄉,鎮安村,333,1255,214,414,628,29,657
公投第１５案,宜蘭縣,五結鄉,鎮安村,334,1270,243,380,623,60,683
公投第１５案,宜蘭縣,五結鄉,上四村,335,801,139,243,382,22,404
公投第１５案,宜蘭縣,五結鄉,上四村,336,802,146,239,385,32,417
公投第１５案,宜蘭縣,五結鄉,中興村,337,1306,218,396,614,36,650
公投第１５案,宜蘭縣,五結鄉,四結村,338,1190,230,366,596,32,628
公投第１５案,宜蘭縣,五結鄉,四結村,339,1316,240,433,673,24,697
公投第１５案,宜蘭縣,五結鄉,福興村,340,965,184,322,506,29,535
公投第１５案,宜蘭縣,五結鄉,福興村,341,814,135,274,409,30,439
公投第１５案,宜蘭縣,五結鄉,五結村,342,1254,209,421,630,27,657
公投第１５案,宜蘭縣,五結鄉,五結村,343,1060,163,407,570,38,608
公投第１５案,宜蘭縣,五結鄉,五結村,344,1323,255,447,702,31,733
公投第１５案,宜蘭縣,五結鄉,協和村,345,1120,215,383,598,42,640
公投第１５案,宜蘭縣,五結鄉,協和村,346,893,169,292,461,22,483
公投第１５案,宜蘭縣,五結鄉,協和村,347,1220,216,385,601,41,642
公投第１５案,宜蘭縣,五結鄉,大吉村,348,924,168,346,514,22,536
公投第１５案,宜蘭縣,五結鄉,大吉村,349,933,188,331,519,44,563
公投第１５案,宜蘭縣,五結鄉,大吉村,350,986,152,347,499,29,528
公投第１５案,宜蘭縣,五結鄉,大吉村,351,748,131,235,366,41,407
公投第１５案,宜蘭縣,五結鄉,孝威村,352,1550,264,502,766,71,837
公投第１５案,宜蘭縣,五結鄉,錦眾村,353,629,110,232,342,22,364
公投第１５案,宜蘭縣,五結鄉,錦眾村,354,806,146,258,404,37,441
公投第１５案,宜蘭縣,五結鄉,利澤村,355,956,186,271,457,44,501
公投第１５案,宜蘭縣,五結鄉,利澤村,356,1066,164,364,528,39,567
公投第１５案,宜蘭縣,五結鄉,成興村,357,1513,256,438,694,56,750
公投第１５案,宜蘭縣,五結鄉,成興村,358,1566,279,504,783,41,824
公投第１５案,宜蘭縣,五結鄉,季新村,359,894,169,264,433,64,497
公投第１５案,宜蘭縣,五結鄉,季新村,360,1235,197,326,523,59,582
公投第１５案,宜蘭縣,五結鄉,季新村,361,704,111,250,361,37,398
公投第１５案,宜蘭縣,三星鄉,員山村,362,215,32,70,102,15,117
公投第１５案,宜蘭縣,三星鄉,天山村,363,523,73,131,204,36,240
公投第１５案,宜蘭縣,三星鄉,天福村,364,745,134,211,345,43,388
公投第１５案,宜蘭縣,三星鄉,萬德村,365,617,111,180,291,25,316
公投第１５案,宜蘭縣,三星鄉,貴林村,366,497,80,155,235,30,265
公投第１５案,宜蘭縣,三星鄉,萬富村,367,735,127,235,362,49,411
公投第１５案,宜蘭縣,三星鄉,雙賢村,368,583,96,200,296,28,324
公投第１５案,宜蘭縣,三星鄉,人和村,369,436,50,159,209,26,235
公投第１５案,宜蘭縣,三星鄉,義德村,370,1224,198,399,597,47,644
公投第１５案,宜蘭縣,三星鄉,集慶村,371,1151,167,356,523,31,554
公投第１５案,宜蘭縣,三星鄉,月眉村,372,870,139,310,449,33,482
公投第１５案,宜蘭縣,三星鄉,拱照村,373,1284,153,347,500,34,534
公投第１５案,宜蘭縣,三星鄉,行健村,374,897,153,327,480,51,531
公投第１５案,宜蘭縣,三星鄉,大隱村,375,1439,240,482,722,55,777
公投第１５案,宜蘭縣,三星鄉,大隱村,376,1445,257,433,690,47,737
公投第１５案,宜蘭縣,三星鄉,大隱村,377,1402,223,479,702,34,736
公投第１５案,宜蘭縣,三星鄉,大義村,378,1230,223,379,602,46,648
公投第１５案,宜蘭縣,三星鄉,尚武村,379,774,115,279,394,38,432
公投第１５案,宜蘭縣,三星鄉,大洲村,380,827,158,280,438,42,480
公投第１５案,宜蘭縣,三星鄉,大洲村,381,736,144,228,372,22,394
公投第１５案,宜蘭縣,三星鄉,尾塹村,382,1421,245,436,681,65,746
公投第１５案,宜蘭縣,大同鄉,寒溪村,383,893,101,298,399,42,441
公投第１５案,宜蘭縣,大同鄉,崙埤村,384,632,85,341,426,34,460
公投第１５案,宜蘭縣,大同鄉,松羅村,385,684,77,335,412,23,435
公投第１５案,宜蘭縣,大同鄉,復興村,386,264,44,106,150,25,175
公投第１５案,宜蘭縣,大同鄉,英士村,387,337,27,145,172,4,176
公投第１５案,宜蘭縣,大同鄉,樂水村,388,404,32,200,232,8,240
公投第１５案,宜蘭縣,大同鄉,太平村,389,55,4,20,24,3,27
公投第１５案,宜蘭縣,大同鄉,茂安村,390,199,25,109,134,20,154
公投第１５案,宜蘭縣,大同鄉,四季村,391,787,73,244,317,12,329
公投第１５案,宜蘭縣,大同鄉,南山村,392,680,60,339,399,46,445
公投第１５案,宜蘭縣,南澳鄉,東岳村,393,444,66,175,241,6,247
公投第１５案,宜蘭縣,南澳鄉,南澳村,394,1210,138,464,602,24,626
公投第１５案,宜蘭縣,南澳鄉,碧候村,395,962,108,475,583,61,644
公投第１５案,宜蘭縣,南澳鄉,金岳村,396,411,36,152,188,5,193
公投第１５案,宜蘭縣,南澳鄉,武塔村,397,447,66,227,293,16,309
公投第１５案,宜蘭縣,南澳鄉,金洋村,398,475,61,276,337,36,373
公投第１５案,宜蘭縣,南澳鄉,澳花村,399,695,63,319,382,35,417
公投第１５案,新竹縣,竹北市,鹿場里,1,1319,286,543,829,23,852
公投第１５案,新竹縣,竹北市,鹿場里,2,1321,278,514,792,13,805
公投第１５案,新竹縣,竹北市,鹿場里,3,1272,262,514,776,25,801
公投第１５案,新竹縣,竹北市,鹿場里,4,1467,293,542,835,16,851
公投第１５案,新竹縣,竹北市,鹿場里,5,1226,268,426,694,19,713
公投第１５案,新竹縣,竹北市,鹿場里,6,1412,281,516,797,10,807
公投第１５案,新竹縣,竹北市,鹿場里,7,1400,348,532,880,10,890
公投第１５案,新竹縣,竹北市,東平里,8,1415,356,498,854,25,879
公投第１５案,新竹縣,竹北市,東平里,9,1361,314,475,789,14,803
公投第１５案,新竹縣,竹北市,東平里,10,1515,381,441,822,13,835
公投第１５案,新竹縣,竹北市,東平里,11,1495,519,337,856,38,894
公投第１５案,新竹縣,竹北市,東平里,12,1417,325,487,812,30,842
公投第１５案,新竹縣,竹北市,東平里,13,1548,407,470,877,12,889
公投第１５案,新竹縣,竹北市,東平里,14,1434,370,396,766,13,779
公投第１５案,新竹縣,竹北市,中興里,15,1385,289,500,789,27,816
公投第１５案,新竹縣,竹北市,中興里,16,1247,275,495,770,26,796
公投第１５案,新竹縣,竹北市,中興里,17,1373,303,470,773,22,795
公投第１５案,新竹縣,竹北市,中興里,18,1345,364,486,850,9,859
公投第１５案,新竹縣,竹北市,中興里,19,1165,212,435,647,26,673
公投第１５案,新竹縣,竹北市,隘口里,20,1164,302,426,728,26,754
公投第１５案,新竹縣,竹北市,隘口里,21,1212,285,446,731,25,756
公投第１５案,新竹縣,竹北市,東海里,22,1507,195,548,743,19,762
公投第１５案,新竹縣,竹北市,東海里,23,1576,216,589,805,32,837
公投第１５案,新竹縣,竹北市,東興里,24,1464,303,504,807,25,832
公投第１５案,新竹縣,竹北市,東興里,25,1428,325,469,794,24,818
公投第１５案,新竹縣,竹北市,東興里,26,1442,372,343,715,16,731
公投第１５案,新竹縣,竹北市,東興里,27,1415,287,509,796,47,843
公投第１５案,新竹縣,竹北市,北興里,28,1666,349,492,841,17,858
公投第１５案,新竹縣,竹北市,北興里,29,1751,398,526,924,19,943
公投第１５案,新竹縣,竹北市,十興里,30,1196,254,471,725,17,742
公投第１５案,新竹縣,竹北市,十興里,31,1235,241,482,723,20,743
公投第１５案,新竹縣,竹北市,十興里,32,1204,247,427,674,14,688
公投第１５案,新竹縣,竹北市,十興里,33,1308,261,520,781,21,802
公投第１５案,新竹縣,竹北市,十興里,34,1233,267,437,704,14,718
公投第１５案,新竹縣,竹北市,興安里,35,1129,216,444,660,13,673
公投第１５案,新竹縣,竹北市,興安里,36,1069,232,418,650,11,661
公投第１５案,新竹縣,竹北市,興安里,37,1114,235,446,681,29,710
公投第１５案,新竹縣,竹北市,文化里,38,1103,243,423,666,27,693
公投第１５案,新竹縣,竹北市,文化里,39,1029,252,401,653,16,669
公投第１５案,新竹縣,竹北市,文化里,40,1133,272,439,711,18,729
公投第１５案,新竹縣,竹北市,斗崙里,41,1301,266,477,743,14,757
公投第１５案,新竹縣,竹北市,斗崙里,42,1798,417,611,1028,18,1046
公投第１５案,新竹縣,竹北市,斗崙里,43,1427,403,426,829,22,851
公投第１５案,新竹縣,竹北市,斗崙里,44,1462,286,595,881,25,906
公投第１５案,新竹縣,竹北市,中崙里,45,1342,294,543,837,16,853
公投第１５案,新竹縣,竹北市,中崙里,46,1480,308,578,886,15,901
公投第１５案,新竹縣,竹北市,中崙里,47,1645,333,579,912,18,930
公投第１５案,新竹縣,竹北市,中崙里,48,1256,276,510,786,20,806
公投第１５案,新竹縣,竹北市,北崙里,49,1181,267,438,705,18,723
公投第１５案,新竹縣,竹北市,北崙里,50,1329,292,544,836,28,864
公投第１５案,新竹縣,竹北市,北崙里,51,1228,232,539,771,25,796
公投第１５案,新竹縣,竹北市,新崙里,52,1552,324,520,844,32,876
公投第１５案,新竹縣,竹北市,新崙里,53,1480,291,578,869,24,893
公投第１５案,新竹縣,竹北市,新崙里,54,1487,283,520,803,15,818
公投第１５案,新竹縣,竹北市,新崙里,55,1470,373,403,776,33,809
公投第１５案,新竹縣,竹北市,竹北里,56,1477,236,525,761,27,788
公投第１５案,新竹縣,竹北市,竹北里,57,1611,340,600,940,33,973
公投第１５案,新竹縣,竹北市,竹北里,58,1555,289,573,862,46,908
公投第１５案,新竹縣,竹北市,竹北里,59,1468,257,510,767,35,802
公投第１５案,新竹縣,竹北市,竹仁里,60,1509,279,592,871,29,900
公投第１５案,新竹縣,竹北市,竹仁里,61,1602,268,593,861,29,890
公投第１５案,新竹縣,竹北市,竹仁里,62,1448,256,527,783,35,818
公投第１５案,新竹縣,竹北市,竹仁里,63,1318,253,514,767,31,798
公投第１５案,新竹縣,竹北市,竹仁里,64,1634,341,625,966,36,1002
公投第１５案,新竹縣,竹北市,竹仁里,65,1345,213,496,709,60,769
公投第１５案,新竹縣,竹北市,福德里,66,958,100,486,586,22,608
公投第１５案,新竹縣,竹北市,福德里,67,1112,233,446,679,26,705
公投第１５案,新竹縣,竹北市,福德里,68,1134,194,439,633,38,671
公投第１５案,新竹縣,竹北市,竹義里,69,1483,271,555,826,35,861
公投第１５案,新竹縣,竹北市,竹義里,70,1332,237,474,711,39,750
公投第１５案,新竹縣,竹北市,竹義里,71,1482,237,502,739,28,767
公投第１５案,新竹縣,竹北市,竹義里,72,1449,210,392,602,18,620
公投第１５案,新竹縣,竹北市,泰和里,73,1319,219,484,703,17,720
公投第１５案,新竹縣,竹北市,泰和里,74,1332,212,484,696,33,729
公投第１５案,新竹縣,竹北市,泰和里,75,1412,266,452,718,31,749
公投第１５案,新竹縣,竹北市,泰和里,76,1640,313,530,843,39,882
公投第１５案,新竹縣,竹北市,新社里,77,1323,237,491,728,30,758
公投第１５案,新竹縣,竹北市,新社里,78,1428,283,520,803,48,851
公投第１５案,新竹縣,竹北市,新社里,79,1533,280,576,856,41,897
公投第１５案,新竹縣,竹北市,新社里,80,1346,257,444,701,22,723
公投第１５案,新竹縣,竹北市,新社里,81,1219,180,453,633,36,669
公投第１５案,新竹縣,竹北市,新國里,82,1466,275,570,845,51,896
公投第１５案,新竹縣,竹北市,新國里,83,1147,244,354,598,34,632
公投第１５案,新竹縣,竹北市,新國里,84,1529,259,482,741,35,776
公投第１５案,新竹縣,竹北市,新國里,85,1522,268,576,844,35,879
公投第１５案,新竹縣,竹北市,聯興里,86,1383,245,545,790,41,831
公投第１５案,新竹縣,竹北市,聯興里,87,1569,287,581,868,42,910
公投第１５案,新竹縣,竹北市,聯興里,88,1506,250,535,785,23,808
公投第１５案,新竹縣,竹北市,麻園里,89,877,135,351,486,21,507
公投第１５案,新竹縣,竹北市,麻園里,90,1074,209,379,588,39,627
公投第１５案,新竹縣,竹北市,溪州里,91,1089,227,455,682,23,705
公投第１５案,新竹縣,竹北市,溪州里,92,1336,248,496,744,49,793
公投第１５案,新竹縣,竹北市,新庄里,93,1058,188,383,571,32,603
公投第１５案,新竹縣,竹北市,白地里,94,937,301,285,586,42,628
公投第１５案,新竹縣,竹北市,白地里,95,1206,209,436,645,44,689
公投第１５案,新竹縣,竹北市,新港里,96,1205,213,441,654,47,701
公投第１５案,新竹縣,竹北市,大眉里,97,1718,336,628,964,65,1029
公投第１５案,新竹縣,竹北市,大義里,98,917,148,341,489,37,526
公投第１５案,新竹縣,竹北市,大義里,99,668,144,240,384,20,404
公投第１５案,新竹縣,竹北市,尚義里,100,824,143,279,422,39,461
公投第１５案,新竹縣,竹北市,尚義里,101,782,146,259,405,60,465
公投第１５案,新竹縣,竹北市,崇義里,102,977,155,378,533,67,600
公投第１５案,新竹縣,竹北市,崇義里,103,937,317,140,457,20,477
公投第１５案,新竹縣,竹東鎮,上坪里,104,309,29,114,143,13,156
公投第１５案,新竹縣,竹東鎮,瑞峰里,105,416,61,127,188,26,214
公投第１５案,新竹縣,竹東鎮,軟橋里,106,386,53,138,191,7,198
公投第１５案,新竹縣,竹東鎮,員崠里,107,950,128,326,454,25,479
公投第１５案,新竹縣,竹東鎮,員崠里,108,1275,191,467,658,18,676
公投第１５案,新竹縣,竹東鎮,上舘里,109,1213,163,463,626,31,657
公投第１５案,新竹縣,竹東鎮,上舘里,110,1548,257,582,839,32,871
公投第１５案,新竹縣,竹東鎮,上舘里,111,1246,181,417,598,26,624
公投第１５案,新竹縣,竹東鎮,上舘里,112,1252,163,385,548,27,575
公投第１５案,新竹縣,竹東鎮,上舘里,113,1359,168,513,681,39,720
公投第１５案,新竹縣,竹東鎮,上舘里,114,1255,186,456,642,35,677
公投第１５案,新竹縣,竹東鎮,上舘里,115,1304,209,500,709,41,750
公投第１５案,新竹縣,竹東鎮,東寧里,116,1292,214,467,681,39,720
公投第１５案,新竹縣,竹東鎮,東寧里,117,1111,140,407,547,21,568
公投第１５案,新竹縣,竹東鎮,東寧里,118,880,144,341,485,41,526
公投第１５案,新竹縣,竹東鎮,中正里,119,670,120,257,377,17,394
公投第１５案,新竹縣,竹東鎮,中正里,120,1244,196,498,694,32,726
公投第１５案,新竹縣,竹東鎮,大鄉里,121,1126,164,409,573,38,611
公投第１５案,新竹縣,竹東鎮,大鄉里,122,1073,158,393,551,40,591
公投第１５案,新竹縣,竹東鎮,大鄉里,123,1215,199,465,664,30,694
公投第１５案,新竹縣,竹東鎮,大鄉里,124,1155,190,458,648,13,661
公投第１５案,新竹縣,竹東鎮,中山里,125,852,144,309,453,34,487
公投第１５案,新竹縣,竹東鎮,中山里,126,875,150,355,505,21,526
公投第１５案,新竹縣,竹東鎮,南華里,127,1070,188,437,625,27,652
公投第１５案,新竹縣,竹東鎮,東華里,128,704,118,249,367,22,389
公投第１５案,新竹縣,竹東鎮,商華里,129,951,99,264,363,19,382
公投第１５案,新竹縣,竹東鎮,商華里,130,984,188,356,544,19,563
公投第１５案,新竹縣,竹東鎮,商華里,131,1113,138,344,482,8,490
公投第１５案,新竹縣,竹東鎮,竹東里,132,595,90,246,336,21,357
公投第１５案,新竹縣,竹東鎮,竹東里,133,762,127,303,430,38,468
公投第１５案,新竹縣,竹東鎮,忠孝里,134,763,142,268,410,20,430
公投第１５案,新竹縣,竹東鎮,忠孝里,135,813,134,267,401,18,419
公投第１５案,新竹縣,竹東鎮,鷄林里,136,1310,166,449,615,29,644
公投第１５案,新竹縣,竹東鎮,鷄林里,137,1434,191,476,667,38,705
公投第１５案,新竹縣,竹東鎮,鷄林里,138,1131,204,413,617,21,638
公投第１５案,新竹縣,竹東鎮,仁愛里,139,967,163,352,515,16,531
公投第１５案,新竹縣,竹東鎮,仁愛里,140,1196,176,411,587,25,612
公投第１５案,新竹縣,竹東鎮,仁愛里,141,1154,194,433,627,29,656
公投第１５案,新竹縣,竹東鎮,榮樂里,142,715,117,284,401,38,439
公投第１５案,新竹縣,竹東鎮,榮樂里,143,685,118,268,386,15,401
公投第１５案,新竹縣,竹東鎮,榮華里,144,1352,210,470,680,39,719
公投第１５案,新竹縣,竹東鎮,榮華里,145,1407,218,546,764,42,806
公投第１５案,新竹縣,竹東鎮,榮華里,146,1362,220,501,721,26,747
公投第１５案,新竹縣,竹東鎮,榮華里,147,1330,212,530,742,23,765
公投第１５案,新竹縣,竹東鎮,榮華里,148,1441,214,523,737,45,782
公投第１５案,新竹縣,竹東鎮,五豐里,149,1248,213,409,622,17,639
公投第１５案,新竹縣,竹東鎮,五豐里,150,1263,203,361,564,15,579
公投第１５案,新竹縣,竹東鎮,五豐里,151,1232,162,423,585,31,616
公投第１５案,新竹縣,竹東鎮,五豐里,152,1143,158,363,521,23,544
公投第１５案,新竹縣,竹東鎮,五豐里,153,1529,262,555,817,19,836
公投第１５案,新竹縣,竹東鎮,五豐里,154,1140,184,410,594,34,628
公投第１５案,新竹縣,竹東鎮,陸豐里,155,570,99,234,333,33,366
公投第１５案,新竹縣,竹東鎮,三重里,156,1345,218,421,639,21,660
公投第１５案,新竹縣,竹東鎮,三重里,157,1381,258,428,686,49,735
公投第１５案,新竹縣,竹東鎮,三重里,158,1379,256,464,720,43,763
公投第１５案,新竹縣,竹東鎮,三重里,159,1033,160,406,566,37,603
公投第１５案,新竹縣,竹東鎮,三重里,160,1066,176,381,557,26,583
公投第１５案,新竹縣,竹東鎮,二重里,161,938,142,373,515,40,555
公投第１５案,新竹縣,竹東鎮,二重里,162,952,167,378,545,42,587
公投第１５案,新竹縣,竹東鎮,二重里,163,1468,292,554,846,36,882
公投第１５案,新竹縣,竹東鎮,二重里,164,1915,445,515,960,21,981
公投第１５案,新竹縣,竹東鎮,二重里,165,1220,191,414,605,34,639
公投第１５案,新竹縣,竹東鎮,二重里,166,1166,160,356,516,16,532
公投第１５案,新竹縣,竹東鎮,二重里,167,1492,229,488,717,16,733
公投第１５案,新竹縣,竹東鎮,二重里,168,1245,204,435,639,21,660
公投第１５案,新竹縣,竹東鎮,頭重里,169,1083,195,399,594,30,624
公投第１５案,新竹縣,竹東鎮,頭重里,170,1102,207,371,578,30,608
公投第１５案,新竹縣,竹東鎮,頭重里,171,1068,179,400,579,21,600
公投第１５案,新竹縣,竹東鎮,頭重里,172,1097,185,424,609,15,624
公投第１５案,新竹縣,竹東鎮,員山里,173,962,142,352,494,18,512
公投第１５案,新竹縣,竹東鎮,員山里,174,909,159,339,498,25,523
公投第１５案,新竹縣,竹東鎮,柯湖里,175,603,82,203,285,18,303
公投第１５案,新竹縣,新埔鎮,新埔里,176,983,155,402,557,30,587
公投第１５案,新竹縣,新埔鎮,新生里,177,597,134,214,348,20,368
公投第１５案,新竹縣,新埔鎮,新民里,178,1070,177,410,587,19,606
公投第１５案,新竹縣,新埔鎮,田新里,179,935,127,368,495,29,524
公投第１５案,新竹縣,新埔鎮,田新里,180,753,113,302,415,20,435
公投第１５案,新竹縣,新埔鎮,田新里,181,838,151,374,525,26,551
公投第１５案,新竹縣,新埔鎮,旱坑里,182,924,148,363,511,26,537
公投第１５案,新竹縣,新埔鎮,旱坑里,183,905,135,299,434,25,459
公投第１５案,新竹縣,新埔鎮,五埔里,184,948,108,401,509,29,538
公投第１５案,新竹縣,新埔鎮,五埔里,185,1017,158,395,553,42,595
公投第１５案,新竹縣,新埔鎮,四座里,186,1176,215,475,690,28,718
公投第１５案,新竹縣,新埔鎮,四座里,187,1122,212,447,659,40,699
公投第１５案,新竹縣,新埔鎮,四座里,188,1022,152,316,468,11,479
公投第１５案,新竹縣,新埔鎮,照門里,189,1429,203,477,680,37,717
公投第１５案,新竹縣,新埔鎮,清水里,190,451,73,197,270,34,304
公投第１５案,新竹縣,新埔鎮,鹿鳴里,191,724,130,256,386,24,410
公投第１５案,新竹縣,新埔鎮,新北里,192,617,97,264,361,33,394
公投第１５案,新竹縣,新埔鎮,巨埔里,193,1144,204,422,626,53,679
公投第１５案,新竹縣,新埔鎮,內立里,194,1139,182,443,625,34,659
公投第１５案,新竹縣,新埔鎮,寶石里,195,861,116,367,483,11,494
公投第１５案,新竹縣,新埔鎮,文山里,196,1093,162,379,541,23,564
公投第１５案,新竹縣,新埔鎮,文山里,197,978,144,336,480,31,511
公投第１５案,新竹縣,新埔鎮,文山里,198,1040,151,339,490,23,513
公投第１５案,新竹縣,新埔鎮,文山里,199,1160,185,405,590,31,621
公投第１５案,新竹縣,新埔鎮,上寮里,200,950,188,359,547,29,576
公投第１５案,新竹縣,新埔鎮,上寮里,201,882,127,348,475,26,501
公投第１５案,新竹縣,新埔鎮,下寮里,202,1281,232,462,694,47,741
公投第１５案,新竹縣,新埔鎮,下寮里,203,1212,198,412,610,40,650
公投第１５案,新竹縣,新埔鎮,南平里,204,1013,114,334,448,37,485
公投第１５案,新竹縣,新埔鎮,北平里,205,630,120,251,371,31,402
公投第１５案,新竹縣,關西鎮,東興里,206,480,70,220,290,19,309
公投第１５案,新竹縣,關西鎮,西安里,207,903,167,350,517,23,540
公投第１５案,新竹縣,關西鎮,西安里,208,1020,167,389,556,38,594
公投第１５案,新竹縣,關西鎮,南雄里,209,705,118,273,391,15,406
公投第１５案,新竹縣,關西鎮,北斗里,210,1056,151,399,550,30,580
公投第１５案,新竹縣,關西鎮,北斗里,211,1275,177,489,666,36,702
公投第１５案,新竹縣,關西鎮,北斗里,212,1287,205,512,717,39,756
公投第１５案,新竹縣,關西鎮,北山里,213,771,130,301,431,35,466
公投第１５案,新竹縣,關西鎮,仁安里,214,1046,176,361,537,36,573
公投第１５案,新竹縣,關西鎮,南山里,215,1030,142,417,559,44,603
公投第１５案,新竹縣,關西鎮,東安里,216,1208,208,451,659,31,690
公投第１５案,新竹縣,關西鎮,東安里,217,1095,151,367,518,15,533
公投第１５案,新竹縣,關西鎮,東安里,218,1350,197,440,637,74,711
公投第１５案,新竹縣,關西鎮,東山里,219,846,152,359,511,25,536
公投第１５案,新竹縣,關西鎮,東光里,220,1362,201,500,701,47,748
公投第１５案,新竹縣,關西鎮,南新里,221,903,105,318,423,27,450
公投第１５案,新竹縣,關西鎮,新富里,222,551,72,174,246,23,269
公投第１５案,新竹縣,關西鎮,玉山里,223,461,54,122,176,15,191
公投第１５案,新竹縣,關西鎮,金山里,224,572,80,210,290,29,319
公投第１５案,新竹縣,關西鎮,錦山里,225,943,99,382,481,25,506
公投第１５案,新竹縣,關西鎮,大同里,226,808,135,294,429,42,471
公投第１５案,新竹縣,關西鎮,石光里,227,923,153,398,551,31,582
公投第１５案,新竹縣,關西鎮,石光里,228,903,144,370,514,22,536
公投第１５案,新竹縣,關西鎮,東平里,229,977,129,396,525,41,566
公投第１５案,新竹縣,關西鎮,上林里,230,824,129,353,482,30,512
公投第１５案,新竹縣,關西鎮,新力里,231,559,92,254,346,14,360
公投第１５案,新竹縣,關西鎮,南和里,232,854,155,351,506,28,534
公投第１５案,新竹縣,湖口鄉,和興村,233,1393,213,479,692,33,725
公投第１５案,新竹縣,湖口鄉,和興村,234,1505,249,584,833,41,874
公投第１５案,新竹縣,湖口鄉,東興村,235,1188,217,516,733,30,763
公投第１５案,新竹縣,湖口鄉,東興村,236,1267,166,531,697,32,729
公投第１５案,新竹縣,湖口鄉,東興村,237,1668,236,685,921,31,952
公投第１５案,新竹縣,湖口鄉,德盛村,238,1719,310,638,948,50,998
公投第１５案,新竹縣,湖口鄉,德盛村,239,1162,191,497,688,35,723
公投第１５案,新竹縣,湖口鄉,德盛村,240,1833,240,654,894,46,940
公投第１５案,新竹縣,湖口鄉,愛勢村,241,1444,264,514,778,44,822
公投第１５案,新竹縣,湖口鄉,愛勢村,242,1347,224,575,799,45,844
公投第１５案,新竹縣,湖口鄉,愛勢村,243,1202,202,488,690,26,716
公投第１５案,新竹縣,湖口鄉,仁勢村,244,851,143,341,484,32,516
公投第１５案,新竹縣,湖口鄉,孝勢村,245,1272,240,493,733,37,770
公投第１５案,新竹縣,湖口鄉,中勢村,246,1275,180,518,698,39,737
公投第１５案,新竹縣,湖口鄉,中勢村,247,1560,265,650,915,53,968
公投第１５案,新竹縣,湖口鄉,中正村,248,1147,199,478,677,58,735
公投第１５案,新竹縣,湖口鄉,中正村,249,1729,254,687,941,32,973
公投第１５案,新竹縣,湖口鄉,信勢村,250,1402,234,499,733,32,765
公投第１５案,新竹縣,湖口鄉,信勢村,251,1183,191,474,665,39,704
公投第１５案,新竹縣,湖口鄉,信勢村,252,1282,223,524,747,31,778
公投第１５案,新竹縣,湖口鄉,信勢村,253,1335,232,537,769,35,804
公投第１５案,新竹縣,湖口鄉,信義村,254,1493,293,602,895,38,933
公投第１５案,新竹縣,湖口鄉,信義村,255,1877,289,708,997,19,1016
公投第１５案,新竹縣,湖口鄉,波羅村,256,1082,162,472,634,37,671
公投第１５案,新竹縣,湖口鄉,波羅村,257,1115,188,463,651,34,685
公投第１５案,新竹縣,湖口鄉,長嶺村,258,1193,179,395,574,39,613
公投第１５案,新竹縣,湖口鄉,長嶺村,259,1947,267,737,1004,38,1042
公投第１５案,新竹縣,湖口鄉,長安村,260,1125,194,429,623,59,682
公投第１５案,新竹縣,湖口鄉,湖口村,261,1050,157,416,573,38,611
公投第１５案,新竹縣,湖口鄉,湖口村,262,1733,297,666,963,39,1002
公投第１５案,新竹縣,湖口鄉,湖鏡村,263,1284,231,498,729,31,760
公投第１５案,新竹縣,湖口鄉,湖鏡村,264,1062,171,433,604,29,633
公投第１５案,新竹縣,湖口鄉,湖南村,265,1547,214,615,829,56,885
公投第１５案,新竹縣,湖口鄉,中興村,266,1494,201,517,718,26,744
公投第１５案,新竹縣,湖口鄉,中興村,267,1634,540,215,755,29,784
公投第１５案,新竹縣,湖口鄉,中興村,268,1444,235,430,665,18,683
公投第１５案,新竹縣,湖口鄉,中興村,269,1324,216,471,687,15,702
公投第１５案,新竹縣,湖口鄉,鳳凰村,270,1058,201,369,570,31,601
公投第１５案,新竹縣,湖口鄉,鳳凰村,271,1220,163,347,510,17,527
公投第１５案,新竹縣,湖口鄉,鳳凰村,272,1333,246,476,722,29,751
公投第１５案,新竹縣,湖口鄉,鳳凰村,273,1461,198,517,715,51,766
公投第１５案,新竹縣,湖口鄉,勝利村,274,1429,233,523,756,32,788
公投第１５案,新竹縣,湖口鄉,勝利村,275,1506,205,481,686,26,712
公投第１５案,新竹縣,湖口鄉,勝利村,276,1103,176,450,626,47,673
公投第１５案,新竹縣,湖口鄉,鳳山村,277,1495,213,499,712,29,741
公投第１５案,新竹縣,湖口鄉,鳳山村,278,752,114,288,402,30,432
公投第１５案,新竹縣,湖口鄉,鳳山村,279,986,166,361,527,19,546
公投第１５案,新竹縣,新豐鄉,福興村,280,1080,167,374,541,43,584
公投第１５案,新竹縣,新豐鄉,青埔村,281,887,138,308,446,22,468
公投第１５案,新竹縣,新豐鄉,青埔村,282,954,141,355,496,40,536
公投第１５案,新竹縣,新豐鄉,中崙村,283,1003,172,368,540,35,575
公投第１５案,新竹縣,新豐鄉,中崙村,284,1106,169,406,575,29,604
公投第１５案,新竹縣,新豐鄉,中崙村,285,1123,205,415,620,40,660
公投第１５案,新竹縣,新豐鄉,瑞興村,286,891,143,339,482,45,527
公投第１５案,新竹縣,新豐鄉,瑞興村,287,874,128,284,412,28,440
公投第１５案,新竹縣,新豐鄉,後湖村,288,824,134,296,430,29,459
公投第１５案,新竹縣,新豐鄉,後湖村,289,975,136,325,461,29,490
公投第１５案,新竹縣,新豐鄉,坡頭村,290,847,165,280,445,38,483
公投第１５案,新竹縣,新豐鄉,埔和村,291,1477,256,533,789,55,844
公投第１５案,新竹縣,新豐鄉,埔和村,292,1266,220,393,613,52,665
公投第１５案,新竹縣,新豐鄉,新豐村,293,1029,137,360,497,63,560
公投第１５案,新竹縣,新豐鄉,新豐村,294,1063,141,393,534,43,577
公投第１５案,新竹縣,新豐鄉,員山村,295,1055,163,403,566,23,589
公投第１５案,新竹縣,新豐鄉,員山村,296,1445,241,548,789,20,809
公投第１５案,新竹縣,新豐鄉,忠孝村,297,1413,256,589,845,22,867
公投第１５案,新竹縣,新豐鄉,忠孝村,298,971,186,420,606,16,622
公投第１５案,新竹縣,新豐鄉,忠孝村,299,1135,189,459,648,26,674
公投第１５案,新竹縣,新豐鄉,山崎村,300,1269,210,439,649,32,681
公投第１５案,新竹縣,新豐鄉,山崎村,301,1257,195,481,676,34,710
公投第１５案,新竹縣,新豐鄉,山崎村,302,1662,305,627,932,34,966
公投第１５案,新竹縣,新豐鄉,上坑村,303,1486,113,620,733,39,772
公投第１５案,新竹縣,新豐鄉,鳳坑村,304,1067,170,451,621,48,669
公投第１５案,新竹縣,新豐鄉,重興村,305,1302,209,544,753,34,787
公投第１５案,新竹縣,新豐鄉,重興村,306,1410,204,544,748,39,787
公投第１５案,新竹縣,新豐鄉,重興村,307,1267,199,469,668,27,695
公投第１５案,新竹縣,新豐鄉,重興村,308,1258,187,409,596,36,632
公投第１５案,新竹縣,新豐鄉,崎頂村,309,1217,183,409,592,19,611
公投第１５案,新竹縣,新豐鄉,崎頂村,310,1456,207,569,776,26,802
公投第１５案,新竹縣,新豐鄉,松林村,311,1157,177,478,655,24,679
公投第１５案,新竹縣,新豐鄉,松林村,312,1089,155,391,546,24,570
公投第１５案,新竹縣,新豐鄉,松林村,313,1160,195,456,651,10,661
公投第１５案,新竹縣,新豐鄉,松林村,314,976,182,416,598,15,613
公投第１５案,新竹縣,新豐鄉,松柏村,315,1443,253,529,782,30,812
公投第１５案,新竹縣,新豐鄉,松柏村,316,1247,204,410,614,21,635
公投第１５案,新竹縣,新豐鄉,松柏村,317,1411,239,528,767,14,781
公投第１５案,新竹縣,新豐鄉,松柏村,318,1238,222,481,703,35,738
公投第１５案,新竹縣,芎林鄉,華龍村,319,417,74,155,229,13,242
公投第１５案,新竹縣,芎林鄉,五龍村,320,534,96,265,361,20,381
公投第１５案,新竹縣,芎林鄉,秀湖村,321,963,168,372,540,25,565
公投第１５案,新竹縣,芎林鄉,永興村,322,418,25,226,251,21,272
公投第１５案,新竹縣,芎林鄉,石潭村,323,1312,177,503,680,44,724
公投第１５案,新竹縣,芎林鄉,石潭村,324,1354,200,450,650,34,684
公投第１５案,新竹縣,芎林鄉,新鳳村,325,785,151,296,447,28,475
公投第１５案,新竹縣,芎林鄉,新鳳村,326,797,108,307,415,74,489
公投第１５案,新竹縣,芎林鄉,中坑村,327,623,94,273,367,28,395
公投第１５案,新竹縣,芎林鄉,水坑村,328,759,103,299,402,39,441
公投第１５案,新竹縣,芎林鄉,文林村,329,1272,202,401,603,45,648
公投第１５案,新竹縣,芎林鄉,文林村,330,1129,175,464,639,34,673
公投第１５案,新竹縣,芎林鄉,芎林村,331,713,134,283,417,27,444
公投第１５案,新竹縣,芎林鄉,芎林村,332,839,149,333,482,41,523
公投第１５案,新竹縣,芎林鄉,上山村,333,1123,214,496,710,29,739
公投第１５案,新竹縣,芎林鄉,上山村,334,981,188,384,572,19,591
公投第１５案,新竹縣,芎林鄉,上山村,335,1078,235,373,608,52,660
公投第１５案,新竹縣,芎林鄉,上山村,336,1094,179,396,575,25,600
公投第１５案,新竹縣,芎林鄉,下山村,337,1102,183,426,609,47,656
公投第１５案,新竹縣,橫山鄉,橫山村,338,1231,217,488,705,44,749
公投第１５案,新竹縣,橫山鄉,橫山村,339,1041,168,418,586,42,628
公投第１５案,新竹縣,橫山鄉,橫山村,340,1132,191,457,648,39,687
公投第１５案,新竹縣,橫山鄉,田寮村,341,859,131,351,482,36,518
公投第１５案,新竹縣,橫山鄉,南昌村,342,204,23,81,104,13,117
公投第１５案,新竹縣,橫山鄉,豐鄉村,343,222,21,69,90,10,100
公投第１５案,新竹縣,橫山鄉,豐田村,344,338,51,137,188,30,218
公投第１５案,新竹縣,橫山鄉,內灣村,345,916,111,360,471,21,492
公投第１５案,新竹縣,橫山鄉,力行村,346,573,65,162,227,13,240
公投第１５案,新竹縣,橫山鄉,力行村,347,275,56,122,178,11,189
公投第１５案,新竹縣,橫山鄉,福興村,348,463,50,161,211,20,231
公投第１５案,新竹縣,橫山鄉,沙坑村,349,690,98,291,389,49,438
公投第１５案,新竹縣,橫山鄉,沙坑村,350,288,39,98,137,12,149
公投第１５案,新竹縣,橫山鄉,新興村,351,685,129,284,413,28,441
公投第１５案,新竹縣,橫山鄉,新興村,352,868,145,364,509,28,537
公投第１５案,新竹縣,橫山鄉,大肚村,353,1561,247,664,911,56,967
公投第１５案,新竹縣,北埔鄉,北埔村,354,1158,190,403,593,9,602
公投第１５案,新竹縣,北埔鄉,南興村,355,1238,236,453,689,51,740
公投第１５案,新竹縣,北埔鄉,大湖村,356,580,111,213,324,16,340
公投第１５案,新竹縣,北埔鄉,埔尾村,357,931,147,372,519,26,545
公投第１５案,新竹縣,北埔鄉,埔尾村,358,1653,286,587,873,55,928
公投第１５案,新竹縣,北埔鄉,水磜村,359,845,129,324,453,32,485
公投第１５案,新竹縣,北埔鄉,南埔村,360,384,54,147,201,14,215
公投第１５案,新竹縣,北埔鄉,大林村,361,763,303,123,426,10,436
公投第１５案,新竹縣,北埔鄉,南坑村,362,333,61,105,166,17,183
公投第１５案,新竹縣,北埔鄉,外坪村,363,295,32,120,152,8,160
公投第１５案,新竹縣,寶山鄉,雙溪村,364,1158,206,403,609,53,662
公投第１５案,新竹縣,寶山鄉,雙溪村,365,1437,509,301,810,16,826
公投第１５案,新竹縣,寶山鄉,雙新村,366,1470,266,526,792,47,839
公投第１５案,新竹縣,寶山鄉,雙新村,367,1170,226,445,671,42,713
公投第１５案,新竹縣,寶山鄉,大崎村,368,1900,383,679,1062,41,1103
公投第１５案,新竹縣,寶山鄉,三峰村,369,1056,177,338,515,26,541
公投第１５案,新竹縣,寶山鄉,新城村,370,1205,188,502,690,62,752
公投第１５案,新竹縣,寶山鄉,寶斗村,371,766,125,284,409,31,440
公投第１５案,新竹縣,寶山鄉,深井村,372,846,144,345,489,30,519
公投第１５案,新竹縣,寶山鄉,寶山村,373,804,143,310,453,36,489
公投第１５案,新竹縣,寶山鄉,油田村,374,607,121,235,356,13,369
公投第１５案,新竹縣,寶山鄉,山湖村,375,554,120,223,343,13,356
公投第１５案,新竹縣,峨眉鄉,峨眉村,376,879,139,377,516,56,572
公投第１５案,新竹縣,峨眉鄉,中盛村,377,683,125,264,389,42,431
公投第１５案,新竹縣,峨眉鄉,石井村,378,604,102,232,334,33,367
公投第１５案,新竹縣,峨眉鄉,七星村,379,339,40,138,178,20,198
公投第１５案,新竹縣,峨眉鄉,七星村,380,276,21,92,113,5,118
公投第１５案,新竹縣,峨眉鄉,富興村,381,1406,187,590,777,81,858
公投第１５案,新竹縣,峨眉鄉,湖光村,382,462,61,199,260,29,289
公投第１５案,新竹縣,峨眉鄉,湖光村,383,419,67,147,214,13,227
公投第１５案,新竹縣,尖石鄉,嘉樂村,384,474,52,166,218,7,225
公投第１５案,新竹縣,尖石鄉,嘉樂村,385,357,50,132,182,5,187
公投第１５案,新竹縣,尖石鄉,義興村,386,225,19,73,92,19,111
公投第１５案,新竹縣,尖石鄉,義興村,387,374,37,142,179,9,188
公投第１５案,新竹縣,尖石鄉,新樂村,388,773,66,253,319,17,336
公投第１５案,新竹縣,尖石鄉,新樂村,389,490,37,223,260,17,277
公投第１５案,新竹縣,尖石鄉,錦屏村,390,531,42,183,225,5,230
公投第１５案,新竹縣,尖石鄉,錦屏村,391,660,53,295,348,12,360
公投第１５案,新竹縣,尖石鄉,梅花村,392,613,64,304,368,48,416
公投第１５案,新竹縣,尖石鄉,玉峰村,393,593,72,218,290,4,294
公投第１５案,新竹縣,尖石鄉,玉峰村,394,575,41,260,301,20,321
公投第１５案,新竹縣,尖石鄉,玉峰村,395,126,8,72,80,4,84
公投第１５案,新竹縣,尖石鄉,秀巒村,396,499,40,188,228,3,231
公投第１５案,新竹縣,尖石鄉,秀巒村,397,785,78,205,283,29,312
公投第１５案,新竹縣,尖石鄉,秀巒村,398,289,51,112,163,18,181
公投第１５案,新竹縣,五峰鄉,大隘村,399,672,70,300,370,27,397
公投第１５案,新竹縣,五峰鄉,大隘村,400,713,70,236,306,14,320
公投第１５案,新竹縣,五峰鄉,桃山村,401,594,52,186,238,3,241
公投第１５案,新竹縣,五峰鄉,桃山村,402,896,90,337,427,36,463
公投第１５案,新竹縣,五峰鄉,花園村,403,727,74,294,368,5,373
公投第１５案,新竹縣,五峰鄉,竹林村,404,395,31,134,165,9,174
公投第１５案,苗栗縣,苗栗市,中苗里,1,1087,189,413,602,28,630
公投第１５案,苗栗縣,苗栗市,青苗里,2,1018,166,378,544,21,565
公投第１５案,苗栗縣,苗栗市,維祥里,3,1156,183,447,630,16,646
公投第１５案,苗栗縣,苗栗市,維祥里,4,1118,164,387,551,31,582
公投第１５案,苗栗縣,苗栗市,維祥里,5,1084,189,409,598,43,641
公投第１５案,苗栗縣,苗栗市,維新里,6,1203,219,478,697,30,727
公投第１５案,苗栗縣,苗栗市,維新里,7,1306,207,531,738,40,778
公投第１５案,苗栗縣,苗栗市,維新里,8,1193,208,370,578,41,619
公投第１５案,苗栗縣,苗栗市,玉清里,9,1115,177,456,633,27,660
公投第１５案,苗栗縣,苗栗市,玉清里,10,1119,177,482,659,31,690
公投第１５案,苗栗縣,苗栗市,玉華里,11,1132,216,445,661,36,697
公投第１５案,苗栗縣,苗栗市,玉華里,12,1289,205,496,701,38,739
公投第１５案,苗栗縣,苗栗市,玉華里,13,1264,241,480,721,35,756
公投第１５案,苗栗縣,苗栗市,綠苗里,14,870,118,354,472,20,492
公投第１５案,苗栗縣,苗栗市,高苗里,15,1008,147,333,480,37,517
公投第１５案,苗栗縣,苗栗市,高苗里,16,1078,166,384,550,23,573
公投第１５案,苗栗縣,苗栗市,高苗里,17,1077,191,430,621,29,650
公投第１５案,苗栗縣,苗栗市,新苗里,18,880,143,342,485,25,510
公投第１５案,苗栗縣,苗栗市,玉苗里,19,894,137,324,461,41,502
公投第１５案,苗栗縣,苗栗市,大同里,20,522,77,206,283,23,306
公投第１５案,苗栗縣,苗栗市,恭敬里,21,1376,274,544,818,52,870
公投第１５案,苗栗縣,苗栗市,水源里,22,1391,224,507,731,29,760
公投第１５案,苗栗縣,苗栗市,水源里,23,1081,182,427,609,39,648
公投第１５案,苗栗縣,苗栗市,勝利里,24,1272,218,456,674,36,710
公投第１５案,苗栗縣,苗栗市,勝利里,25,1112,190,467,657,50,707
公投第１５案,苗栗縣,苗栗市,勝利里,26,813,167,366,533,13,546
公投第１５案,苗栗縣,苗栗市,勝利里,27,767,119,294,413,25,438
公投第１５案,苗栗縣,苗栗市,清華里,28,1010,168,396,564,18,582
公投第１５案,苗栗縣,苗栗市,清華里,29,1182,200,453,653,15,668
公投第１５案,苗栗縣,苗栗市,清華里,30,965,156,385,541,13,554
公投第１５案,苗栗縣,苗栗市,上苗里,31,607,111,242,353,14,367
公投第１５案,苗栗縣,苗栗市,上苗里,32,990,209,381,590,25,615
公投第１５案,苗栗縣,苗栗市,北苗里,33,1230,182,418,600,74,674
公投第１５案,苗栗縣,苗栗市,北苗里,34,1372,232,534,766,30,796
公投第１５案,苗栗縣,苗栗市,北苗里,35,1213,224,454,678,31,709
公投第１５案,苗栗縣,苗栗市,北苗里,36,1272,228,467,695,30,725
公投第１５案,苗栗縣,苗栗市,嘉盛里,37,1221,185,540,725,25,750
公投第１５案,苗栗縣,苗栗市,嘉盛里,38,1104,194,414,608,42,650
公投第１５案,苗栗縣,苗栗市,嘉盛里,39,1171,190,420,610,17,627
公投第１５案,苗栗縣,苗栗市,福星里,40,1392,210,535,745,41,786
公投第１５案,苗栗縣,苗栗市,福星里,41,1356,221,564,785,14,799
公投第１５案,苗栗縣,苗栗市,福星里,42,1387,249,511,760,52,812
公投第１５案,苗栗縣,苗栗市,福安里,43,1206,218,421,639,35,674
公投第１５案,苗栗縣,苗栗市,福安里,44,1004,176,440,616,25,641
公投第１５案,苗栗縣,苗栗市,福安里,45,1202,209,441,650,24,674
公投第１５案,苗栗縣,苗栗市,嘉新里,46,1052,204,411,615,26,641
公投第１５案,苗栗縣,苗栗市,嘉新里,47,873,367,159,526,19,545
公投第１５案,苗栗縣,苗栗市,嘉新里,48,975,177,446,623,31,654
公投第１５案,苗栗縣,苗栗市,建功里,49,1003,156,453,609,32,641
公投第１５案,苗栗縣,苗栗市,建功里,50,1000,190,359,549,21,570
公投第１５案,苗栗縣,苗栗市,建功里,51,1047,163,400,563,29,592
公投第１５案,苗栗縣,苗栗市,建功里,52,1025,189,411,600,30,630
公投第１５案,苗栗縣,苗栗市,福麗里,53,1130,148,444,592,19,611
公投第１５案,苗栗縣,苗栗市,福麗里,54,1146,207,424,631,22,653
公投第１５案,苗栗縣,苗栗市,福麗里,55,1432,256,539,795,30,825
公投第１５案,苗栗縣,苗栗市,福麗里,56,1492,159,515,674,35,709
公投第１５案,苗栗縣,苗栗市,文山里,57,1125,197,472,669,21,690
公投第１５案,苗栗縣,苗栗市,文山里,58,1241,214,452,666,29,695
公投第１５案,苗栗縣,苗栗市,文山里,59,1278,243,480,723,30,753
公投第１５案,苗栗縣,苗栗市,文聖里,60,1293,209,498,707,18,725
公投第１５案,苗栗縣,苗栗市,文聖里,61,1342,209,474,683,29,712
公投第１５案,苗栗縣,苗栗市,文聖里,62,857,123,319,442,37,479
公投第１５案,苗栗縣,苗栗市,新川里,63,1180,168,447,615,33,648
公投第１５案,苗栗縣,苗栗市,南勢里,64,1072,202,410,612,24,636
公投第１５案,苗栗縣,苗栗市,南勢里,65,912,358,118,476,28,504
公投第１５案,苗栗縣,苗栗市,新英里,66,796,103,300,403,23,426
公投第１５案,苗栗縣,苗栗市,新英里,67,869,156,265,421,21,442
公投第１５案,苗栗縣,公館鄉,館中村,68,789,149,335,484,40,524
公投第１５案,苗栗縣,公館鄉,館中村,69,792,149,351,500,28,528
公投第１５案,苗栗縣,公館鄉,館東村,70,1117,180,478,658,61,719
公投第１５案,苗栗縣,公館鄉,館東村,71,1255,215,521,736,52,788
公投第１５案,苗栗縣,公館鄉,館南村,72,1141,185,456,641,43,684
公投第１５案,苗栗縣,公館鄉,館南村,73,1172,212,441,653,34,687
公投第１５案,苗栗縣,公館鄉,館南村,74,1100,188,479,667,28,695
公投第１５案,苗栗縣,公館鄉,中義村,75,1232,172,437,609,42,651
公投第１５案,苗栗縣,公館鄉,中義村,76,1081,159,358,517,53,570
公投第１５案,苗栗縣,公館鄉,玉泉村,77,1250,209,528,737,39,776
公投第１５案,苗栗縣,公館鄉,玉泉村,78,1081,178,411,589,42,631
公投第１５案,苗栗縣,公館鄉,大坑村,79,964,154,356,510,44,554
公投第１５案,苗栗縣,公館鄉,福基村,80,1038,164,405,569,61,630
公投第１５案,苗栗縣,公館鄉,福德村,81,360,66,143,209,17,226
公投第１５案,苗栗縣,公館鄉,福星村,82,865,126,323,449,49,498
公投第１５案,苗栗縣,公館鄉,福星村,83,1166,192,421,613,40,653
公投第１５案,苗栗縣,公館鄉,石墻村,84,719,111,293,404,26,430
公投第１５案,苗栗縣,公館鄉,石墻村,85,788,136,269,405,31,436
公投第１５案,苗栗縣,公館鄉,開礦村,86,303,53,121,174,29,203
公投第１５案,苗栗縣,公館鄉,五谷村,87,1322,230,526,756,40,796
公投第１５案,苗栗縣,公館鄉,五谷村,88,933,143,347,490,45,535
公投第１５案,苗栗縣,公館鄉,玉谷村,89,1455,211,514,725,66,791
公投第１５案,苗栗縣,公館鄉,鶴岡村,90,1615,288,633,921,77,998
公投第１５案,苗栗縣,公館鄉,鶴山村,91,1451,201,546,747,59,806
公投第１５案,苗栗縣,公館鄉,尖山村,92,1462,249,575,824,58,882
公投第１５案,苗栗縣,公館鄉,仁安村,93,1317,200,485,685,52,737
公投第１５案,苗栗縣,公館鄉,南河村,94,221,39,85,124,7,131
公投第１５案,苗栗縣,公館鄉,北河村,95,329,36,126,162,13,175
公投第１５案,苗栗縣,頭屋鄉,頭屋村,96,1335,222,619,841,52,893
公投第１５案,苗栗縣,頭屋鄉,頭屋村,97,1168,211,552,763,66,829
公投第１５案,苗栗縣,頭屋鄉,獅潭村,98,792,136,350,486,34,520
公投第１５案,苗栗縣,頭屋鄉,獅潭村,99,918,208,410,618,40,658
公投第１５案,苗栗縣,頭屋鄉,北坑村,100,725,105,330,435,29,464
公投第１５案,苗栗縣,頭屋鄉,曲洞村,101,899,145,391,536,19,555
公投第１５案,苗栗縣,頭屋鄉,飛鳳村,102,369,51,124,175,7,182
公投第１５案,苗栗縣,頭屋鄉,象山村,103,844,160,323,483,21,504
公投第１５案,苗栗縣,頭屋鄉,象山村,104,1007,204,397,601,22,623
公投第１５案,苗栗縣,頭屋鄉,明德村,105,794,149,329,478,24,502
公投第１５案,苗栗縣,頭屋鄉,明德村,106,211,44,99,143,13,156
公投第１５案,苗栗縣,頭屋鄉,鳴鳳村,107,328,56,163,219,19,238
公投第１５案,苗栗縣,銅鑼鄉,銅鑼村,108,887,139,379,518,30,548
公投第１５案,苗栗縣,銅鑼鄉,銅鑼村,109,1052,163,438,601,31,632
公投第１５案,苗栗縣,銅鑼鄉,銅鑼村,110,1347,250,536,786,39,825
公投第１５案,苗栗縣,銅鑼鄉,銅鑼村,111,1177,172,462,634,38,672
公投第１５案,苗栗縣,銅鑼鄉,樟樹村,112,1268,193,452,645,38,683
公投第１５案,苗栗縣,銅鑼鄉,九湖村,113,1185,189,362,551,32,583
公投第１５案,苗栗縣,銅鑼鄉,福興村,114,1029,140,426,566,31,597
公投第１５案,苗栗縣,銅鑼鄉,朝陽村,115,905,147,357,504,20,524
公投第１５案,苗栗縣,銅鑼鄉,朝陽村,116,750,139,306,445,23,468
公投第１５案,苗栗縣,銅鑼鄉,竹森村,117,1080,120,401,521,35,556
公投第１５案,苗栗縣,銅鑼鄉,中平村,118,1108,156,398,554,48,602
公投第１５案,苗栗縣,銅鑼鄉,中平村,119,862,145,283,428,28,456
公投第１５案,苗栗縣,銅鑼鄉,中平村,120,1216,183,428,611,35,646
公投第１５案,苗栗縣,銅鑼鄉,興隆村,121,588,69,208,277,27,304
公投第１５案,苗栗縣,銅鑼鄉,盛隆村,122,429,59,151,210,25,235
公投第１５案,苗栗縣,銅鑼鄉,新隆村,123,541,82,213,295,22,317
公投第１５案,苗栗縣,三義鄉,廣盛村,124,853,126,362,488,35,523
公投第１５案,苗栗縣,三義鄉,廣盛村,125,983,158,433,591,20,611
公投第１５案,苗栗縣,三義鄉,廣盛村,126,1080,170,440,610,37,647
公投第１５案,苗栗縣,三義鄉,廣盛村,127,1216,181,449,630,21,651
公投第１５案,苗栗縣,三義鄉,勝興村,128,1017,136,430,566,38,604
公投第１５案,苗栗縣,三義鄉,勝興村,129,1180,171,446,617,15,632
公投第１５案,苗栗縣,三義鄉,勝興村,130,1198,182,482,664,20,684
公投第１５案,苗栗縣,三義鄉,龍騰村,131,417,56,176,232,10,242
公投第１５案,苗栗縣,三義鄉,双湖村,132,991,146,348,494,30,524
公投第１５案,苗栗縣,三義鄉,双湖村,133,834,122,349,471,19,490
公投第１５案,苗栗縣,三義鄉,双潭村,134,622,105,234,339,28,367
公投第１５案,苗栗縣,三義鄉,双潭村,135,749,129,293,422,37,459
公投第１５案,苗栗縣,三義鄉,西湖村,136,692,128,309,437,23,460
公投第１５案,苗栗縣,三義鄉,西湖村,137,759,146,366,512,23,535
公投第１５案,苗栗縣,三義鄉,鯉魚潭村,138,629,95,216,311,25,336
公投第１５案,苗栗縣,三義鄉,鯉魚潭村,139,669,115,250,365,21,386
公投第１５案,苗栗縣,西湖鄉,高埔村,140,601,102,203,305,24,329
公投第１５案,苗栗縣,西湖鄉,下埔村,141,566,90,228,318,23,341
公投第１５案,苗栗縣,西湖鄉,五湖村,142,843,125,326,451,39,490
公投第１５案,苗栗縣,西湖鄉,四湖村,143,648,102,215,317,25,342
公投第１５案,苗栗縣,西湖鄉,三湖村,144,936,142,298,440,33,473
公投第１５案,苗栗縣,西湖鄉,龍洞村,145,461,82,153,235,13,248
公投第１５案,苗栗縣,西湖鄉,金獅村,146,515,74,200,274,20,294
公投第１５案,苗栗縣,西湖鄉,湖東村,147,1141,149,417,566,49,615
公投第１５案,苗栗縣,西湖鄉,二湖村,148,671,121,248,369,27,396
公投第１５案,苗栗縣,通霄鎮,通東里,149,1142,206,391,597,67,664
公投第１５案,苗栗縣,通霄鎮,通西里,150,884,192,334,526,53,579
公投第１５案,苗栗縣,通霄鎮,通西里,151,1068,167,385,552,52,604
公投第１５案,苗栗縣,通霄鎮,平元里,152,1009,182,370,552,38,590
公投第１５案,苗栗縣,通霄鎮,平元里,153,859,165,347,512,49,561
公投第１５案,苗栗縣,通霄鎮,平安里,154,1040,193,376,569,39,608
公投第１５案,苗栗縣,通霄鎮,平安里,155,1008,121,293,414,23,437
公投第１５案,苗栗縣,通霄鎮,圳頭里,156,686,115,237,352,56,408
公投第１５案,苗栗縣,通霄鎮,梅南里,157,761,145,330,475,37,512
公投第１５案,苗栗縣,通霄鎮,梅南里,158,790,113,264,377,25,402
公投第１５案,苗栗縣,通霄鎮,通南里,159,966,136,347,483,51,534
公投第１５案,苗栗縣,通霄鎮,通南里,160,972,135,308,443,61,504
公投第１５案,苗栗縣,通霄鎮,通南里,161,771,106,294,400,37,437
公投第１５案,苗栗縣,通霄鎮,內湖里,162,758,99,234,333,24,357
公投第１５案,苗栗縣,通霄鎮,內湖里,163,1078,162,369,531,53,584
公投第１５案,苗栗縣,通霄鎮,楓樹里,164,459,32,137,169,31,200
公投第１５案,苗栗縣,通霄鎮,烏眉里,165,894,111,295,406,43,449
公投第１５案,苗栗縣,通霄鎮,福龍里,166,402,50,101,151,8,159
公投第１５案,苗栗縣,通霄鎮,福源里,167,802,112,285,397,36,433
公投第１５案,苗栗縣,通霄鎮,城北里,168,684,114,222,336,14,350
公投第１５案,苗栗縣,通霄鎮,城南里,169,943,124,283,407,35,442
公投第１５案,苗栗縣,通霄鎮,南和里,170,790,123,314,437,43,480
公投第１５案,苗栗縣,通霄鎮,福興里,171,673,76,203,279,11,290
公投第１５案,苗栗縣,通霄鎮,坪頂里,172,1232,174,426,600,52,652
公投第１５案,苗栗縣,通霄鎮,五南里,173,1286,166,523,689,68,757
公投第１５案,苗栗縣,通霄鎮,五北里,174,649,106,250,356,29,385
公投第１５案,苗栗縣,通霄鎮,五北里,175,769,112,238,350,36,386
公投第１５案,苗栗縣,通霄鎮,通灣里,176,1148,192,373,565,66,631
公投第１５案,苗栗縣,通霄鎮,通灣里,177,1138,163,354,517,59,576
公投第１５案,苗栗縣,通霄鎮,新埔里,178,1121,164,359,523,43,566
公投第１５案,苗栗縣,通霄鎮,內島里,179,769,139,267,406,21,427
公投第１５案,苗栗縣,通霄鎮,白東里,180,616,102,183,285,16,301
公投第１５案,苗栗縣,通霄鎮,白東里,181,799,147,252,399,37,436
公投第１５案,苗栗縣,通霄鎮,白西里,182,743,112,234,346,33,379
公投第１５案,苗栗縣,苑裡鎮,苑東里,183,873,143,343,486,38,524
公投第１５案,苗栗縣,苑裡鎮,苑東里,184,1346,233,509,742,50,792
公投第１５案,苗栗縣,苑裡鎮,苑南里,185,951,184,405,589,41,630
公投第１５案,苗栗縣,苑裡鎮,苑南里,186,615,79,257,336,13,349
公投第１５案,苗栗縣,苑裡鎮,苑北里,187,878,139,343,482,62,544
公投第１５案,苗栗縣,苑裡鎮,西平里,188,767,147,300,447,27,474
公投第１５案,苗栗縣,苑裡鎮,西平里,189,776,130,283,413,31,444
公投第１５案,苗栗縣,苑裡鎮,苑港里,190,1231,187,415,602,57,659
公投第１５案,苗栗縣,苑裡鎮,西勢里,191,1145,202,446,648,36,684
公投第１５案,苗栗縣,苑裡鎮,西勢里,192,850,131,315,446,28,474
公投第１５案,苗栗縣,苑裡鎮,海岸里,193,1052,182,345,527,54,581
公投第１５案,苗栗縣,苑裡鎮,房裡里,194,1114,177,418,595,44,639
公投第１５案,苗栗縣,苑裡鎮,房裡里,195,1136,215,408,623,55,678
公投第１５案,苗栗縣,苑裡鎮,客庄里,196,1194,180,458,638,39,677
公投第１５案,苗栗縣,苑裡鎮,客庄里,197,1579,259,597,856,47,903
公投第１５案,苗栗縣,苑裡鎮,客庄里,198,1149,219,443,662,50,712
公投第１５案,苗栗縣,苑裡鎮,中正里,199,1057,193,392,585,57,642
公投第１５案,苗栗縣,苑裡鎮,中正里,200,1101,161,396,557,18,575
公投第１５案,苗栗縣,苑裡鎮,苑坑里,201,912,117,302,419,36,455
公投第１５案,苗栗縣,苑裡鎮,水坡里,202,652,100,238,338,29,367
公投第１５案,苗栗縣,苑裡鎮,新復里,203,1348,207,508,715,69,784
公投第１５案,苗栗縣,苑裡鎮,山脚里,204,733,122,229,351,18,369
公投第１５案,苗栗縣,苑裡鎮,山脚里,205,662,98,232,330,13,343
公投第１５案,苗栗縣,苑裡鎮,舊社里,206,893,144,337,481,35,516
公投第１５案,苗栗縣,苑裡鎮,舊社里,207,910,176,326,502,45,547
公投第１５案,苗栗縣,苑裡鎮,福田里,208,1270,191,452,643,57,700
公投第１５案,苗栗縣,苑裡鎮,石鎮里,209,545,74,192,266,28,294
公投第１５案,苗栗縣,苑裡鎮,蕉埔里,210,792,116,337,453,49,502
公投第１５案,苗栗縣,苑裡鎮,南勢里,211,726,132,264,396,22,418
公投第１５案,苗栗縣,苑裡鎮,泰田里,212,827,94,248,342,20,362
公投第１５案,苗栗縣,苑裡鎮,泰田里,213,782,132,290,422,47,469
公投第１５案,苗栗縣,苑裡鎮,上舘里,214,788,118,286,404,30,434
公投第１５案,苗栗縣,苑裡鎮,上舘里,215,846,118,310,428,36,464
公投第１５案,苗栗縣,苑裡鎮,玉田里,216,828,129,336,465,40,505
公投第１５案,苗栗縣,苑裡鎮,玉田里,217,943,125,374,499,52,551
公投第１５案,苗栗縣,苑裡鎮,社苓里,218,1082,160,460,620,25,645
公投第１５案,苗栗縣,苑裡鎮,社苓里,219,1234,203,487,690,58,748
公投第１５案,苗栗縣,苑裡鎮,山柑里,220,1434,211,533,744,43,787
公投第１５案,苗栗縣,苑裡鎮,田心里,221,987,156,376,532,39,571
公投第１５案,苗栗縣,苑裡鎮,田心里,222,882,161,358,519,45,564
公投第１５案,苗栗縣,後龍鎮,南龍里,223,590,110,210,320,23,343
公投第１５案,苗栗縣,後龍鎮,南龍里,224,883,184,336,520,41,561
公投第１５案,苗栗縣,後龍鎮,中龍里,225,793,151,309,460,35,495
公投第１５案,苗栗縣,後龍鎮,北龍里,226,732,287,127,414,27,441
公投第１５案,苗栗縣,後龍鎮,北龍里,227,592,98,235,333,28,361
公投第１５案,苗栗縣,後龍鎮,大庄里,228,1113,202,419,621,44,665
公投第１５案,苗栗縣,後龍鎮,大庄里,229,1195,202,431,633,44,677
公投第１５案,苗栗縣,後龍鎮,大庄里,230,997,191,394,585,39,624
公投第１５案,苗栗縣,後龍鎮,大庄里,231,913,132,302,434,17,451
公投第１５案,苗栗縣,後龍鎮,東明里,232,641,93,216,309,29,338
公投第１５案,苗栗縣,後龍鎮,東明里,233,848,146,275,421,31,452
公投第１５案,苗栗縣,後龍鎮,灣寶里,234,1264,212,415,627,73,700
公投第１５案,苗栗縣,後龍鎮,海寶里,235,965,142,317,459,46,505
公投第１５案,苗栗縣,後龍鎮,豐富里,236,1216,211,583,794,57,851
公投第１５案,苗栗縣,後龍鎮,校椅里,237,977,156,342,498,35,533
公投第１５案,苗栗縣,後龍鎮,埔頂里,238,943,145,297,442,35,477
公投第１５案,苗栗縣,後龍鎮,埔頂里,239,910,131,330,461,61,522
公投第１５案,苗栗縣,後龍鎮,埔頂里,240,851,124,315,439,34,473
公投第１５案,苗栗縣,後龍鎮,新民里,241,725,169,268,437,22,459
公投第１５案,苗栗縣,後龍鎮,新民里,242,650,119,231,350,38,388
公投第１５案,苗栗縣,後龍鎮,復興里,243,706,101,220,321,46,367
公投第１５案,苗栗縣,後龍鎮,大山里,244,748,120,279,399,37,436
公投第１５案,苗栗縣,後龍鎮,大山里,245,801,104,241,345,34,379
公投第１５案,苗栗縣,後龍鎮,溪洲里,246,1107,148,445,593,34,627
公投第１５案,苗栗縣,後龍鎮,溪洲里,247,1197,189,409,598,59,657
公投第１５案,苗栗縣,後龍鎮,外埔里,248,1036,122,361,483,45,528
公投第１５案,苗栗縣,後龍鎮,海埔里,249,913,116,281,397,28,425
公投第１５案,苗栗縣,後龍鎮,秀水里,250,719,114,286,400,40,440
公投第１５案,苗栗縣,後龍鎮,水尾里,251,1037,137,383,520,79,599
公投第１５案,苗栗縣,後龍鎮,龍津里,252,601,107,187,294,14,308
公投第１５案,苗栗縣,後龍鎮,龍坑里,253,1269,170,376,546,35,581
公投第１５案,苗栗縣,後龍鎮,福寧里,254,735,98,240,338,29,367
公投第１５案,苗栗縣,後龍鎮,中和里,255,422,39,92,131,14,145
公投第１５案,苗栗縣,後龍鎮,中和里,256,625,106,231,337,22,359
公投第１５案,苗栗縣,後龍鎮,南港里,257,1234,126,396,522,52,574
公投第１５案,苗栗縣,造橋鄉,造橋村,258,1171,207,510,717,49,766
公投第１５案,苗栗縣,造橋鄉,造橋村,259,889,117,383,500,28,528
公投第１５案,苗栗縣,造橋鄉,平興村,260,479,54,165,219,18,237
公投第１５案,苗栗縣,造橋鄉,豐湖村,261,1024,132,422,554,49,603
公投第１５案,苗栗縣,造橋鄉,大西村,262,1214,200,395,595,62,657
公投第１５案,苗栗縣,造橋鄉,大西村,263,1071,151,380,531,29,560
公投第１５案,苗栗縣,造橋鄉,大西村,264,1157,163,387,550,57,607
公投第１５案,苗栗縣,造橋鄉,錦水村,265,512,76,195,271,30,301
公投第１５案,苗栗縣,造橋鄉,大龍村,266,491,84,210,294,16,310
公投第１５案,苗栗縣,造橋鄉,朝陽村,267,1272,211,502,713,53,766
公投第１５案,苗栗縣,造橋鄉,談文村,268,785,115,304,419,32,451
公投第１５案,苗栗縣,造橋鄉,龍昇村,269,962,186,371,557,76,633
公投第１５案,苗栗縣,竹南鎮,竹南里,270,1086,244,389,633,21,654
公投第１５案,苗栗縣,竹南鎮,竹南里,271,826,129,335,464,26,490
公投第１５案,苗栗縣,竹南鎮,照南里,272,1051,223,304,527,30,557
公投第１５案,苗栗縣,竹南鎮,照南里,273,1235,214,481,695,36,731
公投第１５案,苗栗縣,竹南鎮,照南里,274,1016,196,369,565,51,616
公投第１５案,苗栗縣,竹南鎮,正南里,275,1472,268,486,754,43,797
公投第１５案,苗栗縣,竹南鎮,正南里,276,1301,217,404,621,16,637
公投第１５案,苗栗縣,竹南鎮,新南里,277,1544,258,490,748,34,782
公投第１５案,苗栗縣,竹南鎮,新南里,278,1512,262,538,800,31,831
公投第１５案,苗栗縣,竹南鎮,新南里,279,1463,248,490,738,43,781
公投第１５案,苗栗縣,竹南鎮,大厝里,280,1073,179,360,539,29,568
公投第１５案,苗栗縣,竹南鎮,大厝里,281,1453,270,532,802,32,834
公投第１５案,苗栗縣,竹南鎮,大厝里,282,1245,231,507,738,18,756
公投第１５案,苗栗縣,竹南鎮,大厝里,283,1487,250,616,866,23,889
公投第１５案,苗栗縣,竹南鎮,營盤里,284,1018,186,385,571,37,608
公投第１５案,苗栗縣,竹南鎮,營盤里,285,1105,218,415,633,22,655
公投第１５案,苗栗縣,竹南鎮,營盤里,286,1322,219,446,665,35,700
公投第１５案,苗栗縣,竹南鎮,聖福里,287,1140,184,461,645,16,661
公投第１５案,苗栗縣,竹南鎮,聖福里,288,1067,185,440,625,30,655
公投第１５案,苗栗縣,竹南鎮,聖福里,289,1136,221,462,683,34,717
公投第１５案,苗栗縣,竹南鎮,竹興里,290,1253,194,423,617,36,653
公投第１５案,苗栗縣,竹南鎮,竹興里,291,963,151,326,477,37,514
公投第１５案,苗栗縣,竹南鎮,竹興里,292,1021,179,347,526,31,557
公投第１５案,苗栗縣,竹南鎮,龍山里,293,1154,220,441,661,36,697
公投第１５案,苗栗縣,竹南鎮,龍山里,294,1042,192,379,571,25,596
公投第１５案,苗栗縣,竹南鎮,天文里,295,1293,213,498,711,33,744
公投第１５案,苗栗縣,竹南鎮,天文里,296,816,135,343,478,12,490
公投第１５案,苗栗縣,竹南鎮,龍鳳里,297,989,156,361,517,46,563
公投第１５案,苗栗縣,竹南鎮,龍鳳里,298,1122,168,479,647,33,680
公投第１５案,苗栗縣,竹南鎮,山佳里,299,1111,176,335,511,30,541
公投第１５案,苗栗縣,竹南鎮,山佳里,300,1036,172,409,581,34,615
公投第１５案,苗栗縣,竹南鎮,山佳里,301,1112,148,393,541,19,560
公投第１５案,苗栗縣,竹南鎮,山佳里,302,1348,211,472,683,22,705
公投第１５案,苗栗縣,竹南鎮,佳興里,303,1114,214,413,627,32,659
公投第１５案,苗栗縣,竹南鎮,佳興里,304,1119,205,427,632,42,674
公投第１５案,苗栗縣,竹南鎮,佳興里,305,878,127,347,474,24,498
公投第１５案,苗栗縣,竹南鎮,中港里,306,1059,210,402,612,39,651
公投第１５案,苗栗縣,竹南鎮,中華里,307,869,156,332,488,30,518
公投第１５案,苗栗縣,竹南鎮,中華里,308,800,125,289,414,32,446
公投第１５案,苗栗縣,竹南鎮,中華里,309,1165,244,438,682,31,713
公投第１５案,苗栗縣,竹南鎮,中英里,310,791,136,293,429,33,462
公投第１５案,苗栗縣,竹南鎮,中英里,311,677,111,254,365,18,383
公投第１５案,苗栗縣,竹南鎮,中美里,312,797,159,317,476,41,517
公投第１５案,苗栗縣,竹南鎮,中美里,313,1191,175,456,631,26,657
公投第１５案,苗栗縣,竹南鎮,開元里,314,1027,183,344,527,16,543
公投第１５案,苗栗縣,竹南鎮,海口里,315,1341,230,514,744,46,790
公投第１５案,苗栗縣,竹南鎮,海口里,316,1378,215,440,655,48,703
公投第１５案,苗栗縣,竹南鎮,海口里,317,1216,207,449,656,27,683
公投第１５案,苗栗縣,竹南鎮,港墘里,318,1570,227,580,807,29,836
公投第１５案,苗栗縣,竹南鎮,港墘里,319,538,98,192,290,40,330
公投第１５案,苗栗縣,竹南鎮,公舘里,320,1166,142,376,518,31,549
公投第１５案,苗栗縣,竹南鎮,大埔里,321,1488,276,485,761,22,783
公投第１５案,苗栗縣,竹南鎮,大埔里,322,1449,211,497,708,24,732
公投第１５案,苗栗縣,竹南鎮,大埔里,323,1182,179,430,609,54,663
公投第１５案,苗栗縣,竹南鎮,頂埔里,324,1175,196,400,596,72,668
公投第１５案,苗栗縣,竹南鎮,頂埔里,325,983,160,376,536,31,567
公投第１５案,苗栗縣,竹南鎮,崎頂里,326,492,70,219,289,20,309
公投第１５案,苗栗縣,竹南鎮,崎頂里,327,1074,181,408,589,33,622
公投第１５案,苗栗縣,竹南鎮,崎頂里,328,852,149,283,432,38,470
公投第１５案,苗栗縣,竹南鎮,崎頂里,329,1297,226,433,659,33,692
公投第１５案,苗栗縣,竹南鎮,公義里,330,1028,168,337,505,54,559
公投第１５案,苗栗縣,頭份市,流東里,331,915,117,327,444,56,500
公投第１５案,苗栗縣,頭份市,流東里,332,1292,175,511,686,49,735
公投第１５案,苗栗縣,頭份市,珊湖里,333,928,133,386,519,34,553
公投第１５案,苗栗縣,頭份市,珊湖里,334,835,115,303,418,12,430
公投第１５案,苗栗縣,頭份市,斗煥里,335,1070,153,403,556,33,589
公投第１５案,苗栗縣,頭份市,斗煥里,336,879,117,318,435,22,457
公投第１５案,苗栗縣,頭份市,斗煥里,337,1039,179,324,503,36,539
公投第１５案,苗栗縣,頭份市,新華里,338,1129,170,453,623,36,659
公投第１５案,苗栗縣,頭份市,新華里,339,1041,159,376,535,37,572
公投第１５案,苗栗縣,頭份市,新華里,340,1546,183,561,744,50,794
公投第１５案,苗栗縣,頭份市,興隆里,341,935,165,394,559,29,588
公投第１５案,苗栗縣,頭份市,興隆里,342,1180,174,414,588,29,617
公投第１５案,苗栗縣,頭份市,興隆里,343,1499,212,529,741,27,768
公投第１５案,苗栗縣,頭份市,興隆里,344,747,144,245,389,16,405
公投第１５案,苗栗縣,頭份市,上埔里,345,1406,204,525,729,31,760
公投第１５案,苗栗縣,頭份市,上埔里,346,1193,171,458,629,45,674
公投第１５案,苗栗縣,頭份市,土牛里,347,948,160,356,516,41,557
公投第１５案,苗栗縣,頭份市,頭份里,348,869,118,339,457,12,469
公投第１５案,苗栗縣,頭份市,頭份里,349,1142,197,441,638,27,665
公投第１５案,苗栗縣,頭份市,頭份里,350,1286,230,464,694,17,711
公投第１５案,苗栗縣,頭份市,忠孝里,351,903,152,356,508,31,539
公投第１５案,苗栗縣,頭份市,忠孝里,352,1186,199,497,696,39,735
公投第１５案,苗栗縣,頭份市,忠孝里,353,1016,178,405,583,16,599
公投第１５案,苗栗縣,頭份市,自強里,354,985,164,370,534,25,559
公投第１５案,苗栗縣,頭份市,自強里,355,1037,159,383,542,23,565
公投第１５案,苗栗縣,頭份市,信義里,356,947,128,317,445,19,464
公投第１５案,苗栗縣,頭份市,仁愛里,357,890,154,344,498,20,518
公投第１５案,苗栗縣,頭份市,仁愛里,358,646,131,255,386,22,408
公投第１５案,苗栗縣,頭份市,上興里,359,975,155,386,541,41,582
公投第１５案,苗栗縣,頭份市,上興里,360,1015,101,284,385,12,397
公投第１５案,苗栗縣,頭份市,下興里,361,1399,227,584,811,50,861
公投第１５案,苗栗縣,頭份市,下興里,362,1143,186,465,651,37,688
公投第１５案,苗栗縣,頭份市,和平里,363,1030,173,462,635,35,670
公投第１５案,苗栗縣,頭份市,山下里,364,1338,241,505,746,34,780
公投第１５案,苗栗縣,頭份市,山下里,365,1450,234,524,758,26,784
公投第１５案,苗栗縣,頭份市,山下里,366,1042,185,413,598,12,610
公投第１５案,苗栗縣,頭份市,後庄里,367,1326,247,520,767,30,797
公投第１５案,苗栗縣,頭份市,後庄里,368,1270,225,543,768,34,802
公投第１５案,苗栗縣,頭份市,後庄里,369,1288,225,471,696,31,727
公投第１５案,苗栗縣,頭份市,合興里,370,1243,219,498,717,27,744
公投第１５案,苗栗縣,頭份市,合興里,371,1280,198,540,738,18,756
公投第１５案,苗栗縣,頭份市,文化里,372,1618,275,595,870,45,915
公投第１５案,苗栗縣,頭份市,文化里,373,1759,289,625,914,33,947
公投第１５案,苗栗縣,頭份市,中興里,374,1264,224,502,726,27,753
公投第１５案,苗栗縣,頭份市,中興里,375,1326,238,510,748,20,768
公投第１５案,苗栗縣,頭份市,蟠桃里,376,1551,263,601,864,29,893
公投第１５案,苗栗縣,頭份市,蟠桃里,377,1574,245,537,782,31,813
公投第１５案,苗栗縣,頭份市,建國里,378,1262,219,477,696,34,730
公投第１５案,苗栗縣,頭份市,建國里,379,1171,210,439,649,39,688
公投第１５案,苗栗縣,頭份市,建國里,380,1074,199,461,660,35,695
公投第１５案,苗栗縣,頭份市,成功里,381,1141,195,472,667,22,689
公投第１５案,苗栗縣,頭份市,成功里,382,1259,191,510,701,33,734
公投第１５案,苗栗縣,頭份市,成功里,383,1186,206,425,631,27,658
公投第１５案,苗栗縣,頭份市,民族里,384,1121,153,410,563,20,583
公投第１５案,苗栗縣,頭份市,民族里,385,847,132,332,464,22,486
公投第１５案,苗栗縣,頭份市,民權里,386,993,198,382,580,19,599
公投第１５案,苗栗縣,頭份市,民權里,387,1055,171,375,546,26,572
公投第１５案,苗栗縣,頭份市,東庄里,388,1655,216,582,798,35,833
公投第１５案,苗栗縣,頭份市,東庄里,389,1799,261,669,930,59,989
公投第１５案,苗栗縣,頭份市,田寮里,390,1141,190,443,633,29,662
公投第１５案,苗栗縣,頭份市,田寮里,391,1431,238,508,746,35,781
公投第１５案,苗栗縣,頭份市,田寮里,392,1412,188,457,645,17,662
公投第１５案,苗栗縣,頭份市,民生里,393,1074,149,395,544,23,567
公投第１５案,苗栗縣,頭份市,民生里,394,1245,213,494,707,35,742
公投第１５案,苗栗縣,頭份市,蘆竹里,395,1344,244,517,761,50,811
公投第１５案,苗栗縣,頭份市,尖山里,396,1363,234,546,780,63,843
公投第１５案,苗栗縣,頭份市,廣興里,397,898,144,400,544,29,573
公投第１５案,苗栗縣,頭份市,尖下里,398,1182,195,467,662,52,714
公投第１５案,苗栗縣,頭份市,尖下里,399,1413,204,544,748,31,779
公投第１５案,苗栗縣,頭份市,濫坑里,400,991,181,402,583,33,616
公投第１５案,苗栗縣,頭份市,濫坑里,401,1180,195,457,652,44,696
公投第１５案,苗栗縣,三灣鄉,三灣村,402,996,152,417,569,27,596
公投第１５案,苗栗縣,三灣鄉,三灣村,403,1205,191,451,642,51,693
公投第１５案,苗栗縣,三灣鄉,內灣村,404,635,92,254,346,41,387
公投第１５案,苗栗縣,三灣鄉,銅鏡村,405,862,126,328,454,43,497
公投第１５案,苗栗縣,三灣鄉,頂寮村,406,238,26,80,106,12,118
公投第１５案,苗栗縣,三灣鄉,北埔村,407,541,76,190,266,28,294
公投第１５案,苗栗縣,三灣鄉,大河村,408,578,79,196,275,25,300
公投第１５案,苗栗縣,三灣鄉,大坪村,409,405,60,185,245,34,279
公投第１５案,苗栗縣,三灣鄉,永和村,410,392,53,152,205,19,224
公投第１５案,苗栗縣,南庄鄉,東村,411,1155,179,410,589,55,644
公投第１５案,苗栗縣,南庄鄉,西村,412,650,111,239,350,22,372
公投第１５案,苗栗縣,南庄鄉,南江村,413,1353,178,474,652,47,699
公投第１５案,苗栗縣,南庄鄉,田美村,414,813,99,231,330,25,355
公投第１５案,苗栗縣,南庄鄉,獅山村,415,837,82,244,326,33,359
公投第１５案,苗栗縣,南庄鄉,南富村,416,1093,157,386,543,29,572
公投第１５案,苗栗縣,南庄鄉,員林村,417,1048,170,376,546,27,573
公投第１５案,苗栗縣,南庄鄉,蓬萊村,418,872,126,297,423,22,445
公投第１５案,苗栗縣,南庄鄉,東河村,419,963,87,223,310,10,320
公投第１５案,苗栗縣,大湖鄉,大湖村,420,744,231,139,370,38,408
公投第１５案,苗栗縣,大湖鄉,大湖村,421,881,142,314,456,31,487
公投第１５案,苗栗縣,大湖鄉,明湖村,422,596,92,215,307,33,340
公投第１５案,苗栗縣,大湖鄉,大寮村,423,1260,191,411,602,52,654
公投第１５案,苗栗縣,大湖鄉,靜湖村,424,867,112,322,434,22,456
公投第１５案,苗栗縣,大湖鄉,靜湖村,425,923,140,350,490,24,514
公投第１５案,苗栗縣,大湖鄉,富興村,426,1395,179,473,652,84,736
公投第１５案,苗栗縣,大湖鄉,大南村,427,561,62,134,196,19,215
公投第１５案,苗栗縣,大湖鄉,南湖村,428,638,92,262,354,19,373
公投第１５案,苗栗縣,大湖鄉,東興村,429,754,120,245,365,34,399
公投第１５案,苗栗縣,大湖鄉,武榮村,430,501,57,176,233,15,248
公投第１５案,苗栗縣,大湖鄉,義和村,431,652,111,219,330,29,359
公投第１５案,苗栗縣,大湖鄉,義和村,432,843,108,281,389,27,416
公投第１５案,苗栗縣,大湖鄉,栗林村,433,1020,132,369,501,76,577
公投第１５案,苗栗縣,大湖鄉,新開村,434,1018,129,419,548,31,579
公投第１５案,苗栗縣,獅潭鄉,百壽村,435,328,23,100,123,7,130
公投第１５案,苗栗縣,獅潭鄉,永興村,436,565,56,167,223,28,251
公投第１５案,苗栗縣,獅潭鄉,新店村,437,911,139,331,470,52,522
公投第１５案,苗栗縣,獅潭鄉,和興村,438,568,77,172,249,19,268
公投第１５案,苗栗縣,獅潭鄉,豐林村,439,580,77,235,312,30,342
公投第１５案,苗栗縣,獅潭鄉,新豐村,440,333,41,122,163,7,170
公投第１５案,苗栗縣,獅潭鄉,竹木村,441,683,84,254,338,18,356
公投第１５案,苗栗縣,卓蘭鎮,老庄里,442,961,156,392,548,40,588
公投第１５案,苗栗縣,卓蘭鎮,老庄里,443,1017,169,355,524,54,578
公投第１５案,苗栗縣,卓蘭鎮,新榮里,444,1095,204,440,644,59,703
公投第１５案,苗栗縣,卓蘭鎮,中街里,445,745,121,313,434,25,459
公投第１５案,苗栗縣,卓蘭鎮,新厝里,446,783,101,303,404,27,431
公投第１５案,苗栗縣,卓蘭鎮,新厝里,447,745,120,243,363,12,375
公投第１５案,苗栗縣,卓蘭鎮,豐田里,448,999,143,366,509,19,528
公投第１５案,苗栗縣,卓蘭鎮,西坪里,449,671,110,275,385,33,418
公投第１５案,苗栗縣,卓蘭鎮,苗豐里,450,734,116,306,422,61,483
公投第１５案,苗栗縣,卓蘭鎮,上新里,451,865,131,366,497,39,536
公投第１５案,苗栗縣,卓蘭鎮,上新里,452,828,118,353,471,51,522
公投第１５案,苗栗縣,卓蘭鎮,上新里,453,386,66,156,222,21,243
公投第１５案,苗栗縣,卓蘭鎮,內灣里,454,688,132,273,405,39,444
公投第１５案,苗栗縣,卓蘭鎮,內灣里,455,792,156,300,456,36,492
公投第１５案,苗栗縣,卓蘭鎮,內灣里,456,729,117,291,408,26,434
公投第１５案,苗栗縣,卓蘭鎮,坪林里,457,1093,161,337,498,30,528
公投第１５案,苗栗縣,卓蘭鎮,坪林里,458,615,83,258,341,14,355
公投第１５案,苗栗縣,卓蘭鎮,西坪里,459,86,4,42,46,2,48
公投第１５案,苗栗縣,卓蘭鎮,景山里,460,940,133,373,506,16,522
公投第１５案,苗栗縣,泰安鄉,八卦村,461,325,41,108,149,6,155
公投第１５案,苗栗縣,泰安鄉,錦水村,462,484,67,205,272,16,288
公投第１５案,苗栗縣,泰安鄉,錦水村,463,666,110,348,458,32,490
公投第１５案,苗栗縣,泰安鄉,清安村,464,574,84,266,350,40,390
公投第１５案,苗栗縣,泰安鄉,清安村,465,333,42,124,166,9,175
公投第１５案,苗栗縣,泰安鄉,大興村,466,495,71,260,331,11,342
公投第１５案,苗栗縣,泰安鄉,中興村,467,544,117,249,366,27,393
公投第１５案,苗栗縣,泰安鄉,梅園村,468,500,60,216,276,20,296
公投第１５案,苗栗縣,泰安鄉,象鼻村,469,670,103,345,448,32,480
公投第１５案,苗栗縣,泰安鄉,士林村,470,589,82,369,451,6,457
公投第１５案,彰化縣,彰化市,桃源里,1,871,121,343,464,26,490
公投第１５案,彰化縣,彰化市,桃源里,2,751,109,228,337,29,366
公投第１５案,彰化縣,彰化市,桃源里,3,923,215,361,576,32,608
公投第１５案,彰化縣,彰化市,東興里,4,779,167,278,445,40,485
公投第１５案,彰化縣,彰化市,東興里,5,779,177,276,453,28,481
公投第１５案,彰化縣,彰化市,華北里,6,720,139,272,411,20,431
公投第１５案,彰化縣,彰化市,華北里,7,749,152,275,427,21,448
公投第１５案,彰化縣,彰化市,華陽里,8,767,143,330,473,29,502
公投第１５案,彰化縣,彰化市,華陽里,9,1047,189,422,611,49,660
公投第１５案,彰化縣,彰化市,大同里,10,1027,205,356,561,26,587
公投第１５案,彰化縣,彰化市,永生里,11,1249,211,452,663,49,712
公投第１５案,彰化縣,彰化市,建寶里,12,1136,217,439,656,24,680
公投第１５案,彰化縣,彰化市,建寶里,13,1169,206,479,685,41,726
公投第１５案,彰化縣,彰化市,光南里,14,766,157,305,462,19,481
公投第１５案,彰化縣,彰化市,光南里,15,643,100,267,367,21,388
公投第１５案,彰化縣,彰化市,介壽里,16,1251,209,495,704,39,743
公投第１５案,彰化縣,彰化市,介壽里,17,1301,169,322,491,21,512
公投第１５案,彰化縣,彰化市,延平里,18,1280,246,490,736,25,761
公投第１５案,彰化縣,彰化市,延平里,19,1179,213,486,699,30,729
公投第１５案,彰化縣,彰化市,延平里,20,1168,215,462,677,13,690
公投第１５案,彰化縣,彰化市,延平里,21,1218,177,509,686,32,718
公投第１５案,彰化縣,彰化市,延平里,22,1351,286,575,861,28,889
公投第１５案,彰化縣,彰化市,延平里,23,1204,251,440,691,25,716
公投第１５案,彰化縣,彰化市,延平里,24,1189,232,470,702,16,718
公投第１５案,彰化縣,彰化市,延和里,25,1207,213,439,652,41,693
公投第１５案,彰化縣,彰化市,延和里,26,1161,217,473,690,32,722
公投第１５案,彰化縣,彰化市,延和里,27,1166,249,391,640,25,665
公投第１５案,彰化縣,彰化市,延和里,28,1362,287,518,805,29,834
公投第１５案,彰化縣,彰化市,南興里,29,1236,274,455,729,40,769
公投第１５案,彰化縣,彰化市,南興里,30,1065,200,400,600,43,643
公投第１５案,彰化縣,彰化市,南興里,31,1199,274,419,693,30,723
公投第１５案,彰化縣,彰化市,南興里,32,1233,267,450,717,26,743
公投第１５案,彰化縣,彰化市,南興里,33,1245,230,368,598,23,621
公投第１５案,彰化縣,彰化市,南興里,34,1153,232,461,693,22,715
公投第１５案,彰化縣,彰化市,南瑤里,35,1045,189,372,561,32,593
公投第１５案,彰化縣,彰化市,南瑤里,36,1097,226,407,633,14,647
公投第１５案,彰化縣,彰化市,南瑤里,37,1190,228,432,660,33,693
公投第１５案,彰化縣,彰化市,南瑤里,38,1106,241,425,666,26,692
公投第１５案,彰化縣,彰化市,南瑤里,39,1097,193,450,643,20,663
公投第１５案,彰化縣,彰化市,南瑤里,40,1048,203,400,603,38,641
公投第１５案,彰化縣,彰化市,南瑤里,41,980,215,378,593,25,618
公投第１５案,彰化縣,彰化市,成功里,42,707,145,288,433,14,447
公投第１５案,彰化縣,彰化市,成功里,43,809,160,304,464,26,490
公投第１５案,彰化縣,彰化市,福安里,44,1008,217,378,595,37,632
公投第１５案,彰化縣,彰化市,西安里,45,901,160,316,476,41,517
公投第１５案,彰化縣,彰化市,西安里,46,951,182,338,520,30,550
公投第１５案,彰化縣,彰化市,西安里,47,1076,221,396,617,29,646
公投第１５案,彰化縣,彰化市,彰安里,48,1022,170,398,568,20,588
公投第１５案,彰化縣,彰化市,彰安里,49,894,181,332,513,34,547
公投第１５案,彰化縣,彰化市,彰安里,50,1016,199,400,599,34,633
公投第１５案,彰化縣,彰化市,中央里,51,771,162,303,465,34,499
公投第１５案,彰化縣,彰化市,富貴里,52,868,180,320,500,33,533
公投第１５案,彰化縣,彰化市,民權里,53,1135,218,422,640,48,688
公投第１５案,彰化縣,彰化市,萬壽里,54,910,179,327,506,56,562
公投第１５案,彰化縣,彰化市,長樂里,55,1004,212,394,606,24,630
公投第１５案,彰化縣,彰化市,西興里,56,1077,227,406,633,41,674
公投第１５案,彰化縣,彰化市,西興里,57,1258,256,528,784,43,827
公投第１５案,彰化縣,彰化市,西興里,58,1025,188,447,635,21,656
公投第１５案,彰化縣,彰化市,西勢里,59,1177,228,487,715,33,748
公投第１５案,彰化縣,彰化市,西勢里,60,1262,216,483,699,25,724
公投第１５案,彰化縣,彰化市,西勢里,61,1209,213,503,716,37,753
公投第１５案,彰化縣,彰化市,忠權里,62,1041,221,406,627,34,661
公投第１５案,彰化縣,彰化市,忠權里,63,1075,184,463,647,26,673
公投第１５案,彰化縣,彰化市,忠權里,64,1029,166,389,555,38,593
公投第１５案,彰化縣,彰化市,忠孝里,65,1203,215,441,656,48,704
公投第１５案,彰化縣,彰化市,五權里,66,1014,158,408,566,26,592
公投第１５案,彰化縣,彰化市,五權里,67,1069,198,424,622,25,647
公投第１５案,彰化縣,彰化市,五權里,68,969,157,347,504,20,524
公投第１５案,彰化縣,彰化市,五權里,69,1105,171,399,570,24,594
公投第１５案,彰化縣,彰化市,平和里,70,981,187,410,597,35,632
公投第１５案,彰化縣,彰化市,平和里,71,1095,217,421,638,54,692
公投第１５案,彰化縣,彰化市,平和里,72,1087,192,465,657,22,679
公投第１５案,彰化縣,彰化市,平和里,73,1050,219,397,616,25,641
公投第１５案,彰化縣,彰化市,崙平里,74,1252,43,693,736,35,771
公投第１５案,彰化縣,彰化市,崙平里,75,1113,190,414,604,28,632
公投第１５案,彰化縣,彰化市,崙平里,76,1009,213,405,618,21,639
公投第１５案,彰化縣,彰化市,崙平里,77,999,186,357,543,36,579
公投第１５案,彰化縣,彰化市,崙平里,78,997,195,373,568,21,589
公投第１５案,彰化縣,彰化市,向陽里,79,1145,261,460,721,25,746
公投第１５案,彰化縣,彰化市,向陽里,80,1227,232,484,716,19,735
公投第１５案,彰化縣,彰化市,向陽里,81,1208,252,479,731,19,750
公投第１５案,彰化縣,彰化市,向陽里,82,1598,286,622,908,21,929
公投第１５案,彰化縣,彰化市,莿桐里,83,890,148,376,524,25,549
公投第１５案,彰化縣,彰化市,莿桐里,84,1104,222,468,690,27,717
公投第１５案,彰化縣,彰化市,莿桐里,85,1097,203,411,614,19,633
公投第１５案,彰化縣,彰化市,南美里,86,799,136,306,442,29,471
公投第１５案,彰化縣,彰化市,南美里,87,1000,161,425,586,38,624
公投第１５案,彰化縣,彰化市,南安里,88,1153,176,455,631,55,686
公投第１５案,彰化縣,彰化市,南安里,89,977,162,390,552,47,599
公投第１５案,彰化縣,彰化市,東芳里,90,1201,234,427,661,37,698
公投第１５案,彰化縣,彰化市,東芳里,91,1057,232,392,624,40,664
公投第１５案,彰化縣,彰化市,東芳里,92,1238,212,462,674,56,730
公投第１５案,彰化縣,彰化市,磚磘里,93,1210,206,501,707,40,747
公投第１５案,彰化縣,彰化市,磚磘里,94,1026,186,422,608,28,636
公投第１５案,彰化縣,彰化市,磚磘里,95,1061,227,425,652,42,694
公投第１５案,彰化縣,彰化市,卦山里,96,1213,240,443,683,42,725
公投第１５案,彰化縣,彰化市,卦山里,97,1264,276,464,740,35,775
公投第１５案,彰化縣,彰化市,光復里,98,691,162,284,446,23,469
公投第１５案,彰化縣,彰化市,永福里,99,893,191,349,540,36,576
公投第１５案,彰化縣,彰化市,光華里,100,733,129,294,423,36,459
公投第１５案,彰化縣,彰化市,中正里,101,692,136,282,418,29,447
公投第１５案,彰化縣,彰化市,中正里,102,728,157,254,411,27,438
公投第１５案,彰化縣,彰化市,中山里,103,773,160,320,480,21,501
公投第１５案,彰化縣,彰化市,龍山里,104,975,153,359,512,21,533
公投第１５案,彰化縣,彰化市,龍山里,105,908,162,362,524,35,559
公投第１５案,彰化縣,彰化市,新興里,106,1156,216,475,691,6,697
公投第１５案,彰化縣,彰化市,新興里,107,1235,213,501,714,39,753
公投第１５案,彰化縣,彰化市,新興里,108,1376,248,498,746,37,783
公投第１５案,彰化縣,彰化市,新興里,109,1389,258,516,774,7,781
公投第１５案,彰化縣,彰化市,新華里,110,846,163,368,531,29,560
公投第１５案,彰化縣,彰化市,新華里,111,859,152,382,534,26,560
公投第１５案,彰化縣,彰化市,興北里,112,781,171,295,466,18,484
公投第１５案,彰化縣,彰化市,興北里,113,875,168,327,495,26,521
公投第１５案,彰化縣,彰化市,信義里,114,816,141,321,462,24,486
公投第１５案,彰化縣,彰化市,民生里,115,687,136,275,411,28,439
公投第１５案,彰化縣,彰化市,民生里,116,727,140,306,446,28,474
公投第１５案,彰化縣,彰化市,文化里,117,662,136,272,408,19,427
公投第１５案,彰化縣,彰化市,文化里,118,633,113,275,388,16,404
公投第１５案,彰化縣,彰化市,陽明里,119,906,187,371,558,33,591
公投第１５案,彰化縣,彰化市,陽明里,120,853,145,327,472,25,497
公投第１５案,彰化縣,彰化市,萬安里,121,1027,190,425,615,31,646
公投第１５案,彰化縣,彰化市,萬安里,122,993,186,420,606,32,638
公投第１５案,彰化縣,彰化市,萬安里,123,848,148,339,487,34,521
公投第１５案,彰化縣,彰化市,萬安里,124,1118,218,479,697,12,709
公投第１５案,彰化縣,彰化市,下廍里,125,1263,231,508,739,35,774
公投第１５案,彰化縣,彰化市,下廍里,126,1268,218,545,763,35,798
公投第１５案,彰化縣,彰化市,下廍里,127,1258,223,521,744,30,774
公投第１５案,彰化縣,彰化市,下廍里,128,1212,223,518,741,16,757
公投第１５案,彰化縣,彰化市,茄苳里,129,924,164,377,541,33,574
公投第１５案,彰化縣,彰化市,茄南里,130,939,181,394,575,23,598
公投第１５案,彰化縣,彰化市,茄南里,131,953,193,395,588,53,641
公投第１５案,彰化縣,彰化市,茄南里,132,981,181,439,620,29,649
公投第１５案,彰化縣,彰化市,寶廍里,133,1249,227,513,740,50,790
公投第１５案,彰化縣,彰化市,古夷里,134,817,139,327,466,43,509
公投第１５案,彰化縣,彰化市,古夷里,135,872,163,339,502,30,532
公投第１５案,彰化縣,彰化市,古夷里,136,689,125,262,387,20,407
公投第１５案,彰化縣,彰化市,阿夷里,137,1156,217,484,701,26,727
公投第１５案,彰化縣,彰化市,阿夷里,138,1291,231,489,720,23,743
公投第１５案,彰化縣,彰化市,阿夷里,139,1139,193,449,642,26,668
公投第１５案,彰化縣,彰化市,阿夷里,140,1125,212,457,669,28,697
公投第１５案,彰化縣,彰化市,阿夷里,141,1258,196,485,681,37,718
公投第１５案,彰化縣,彰化市,阿夷里,142,1123,192,445,637,30,667
公投第１５案,彰化縣,彰化市,阿夷里,143,1175,197,458,655,49,704
公投第１５案,彰化縣,彰化市,和調里,144,862,170,369,539,32,571
公投第１５案,彰化縣,彰化市,和調里,145,872,170,336,506,22,528
公投第１５案,彰化縣,彰化市,和調里,146,897,158,384,542,37,579
公投第１５案,彰化縣,彰化市,復興里,147,1003,170,405,575,20,595
公投第１５案,彰化縣,彰化市,復興里,148,915,157,350,507,19,526
公投第１５案,彰化縣,彰化市,復興里,149,1158,211,420,631,37,668
公投第１５案,彰化縣,彰化市,復興里,150,1084,210,441,651,33,684
公投第１５案,彰化縣,彰化市,中庄里,151,1372,239,487,726,51,777
公投第１５案,彰化縣,彰化市,中庄里,152,1113,163,484,647,30,677
公投第１５案,彰化縣,彰化市,竹中里,153,800,122,347,469,38,507
公投第１５案,彰化縣,彰化市,竹中里,154,885,155,342,497,40,537
公投第１５案,彰化縣,彰化市,香山里,155,1000,184,426,610,8,618
公投第１５案,彰化縣,彰化市,香山里,156,1159,203,419,622,28,650
公投第１５案,彰化縣,彰化市,香山里,157,1123,195,419,614,29,643
公投第１５案,彰化縣,彰化市,牛埔里,158,907,191,369,560,43,603
公投第１５案,彰化縣,彰化市,牛埔里,159,989,153,369,522,41,563
公投第１５案,彰化縣,彰化市,牛埔里,160,1012,191,408,599,44,643
公投第１５案,彰化縣,彰化市,台鳳里,161,1033,150,401,551,20,571
公投第１５案,彰化縣,彰化市,台鳳里,162,1116,210,440,650,35,685
公投第１５案,彰化縣,彰化市,台鳳里,163,1154,205,485,690,22,712
公投第１５案,彰化縣,彰化市,台鳳里,164,1064,199,421,620,37,657
公投第１５案,彰化縣,彰化市,國聖里,165,770,129,341,470,36,506
公投第１５案,彰化縣,彰化市,國聖里,166,889,194,334,528,29,557
公投第１５案,彰化縣,彰化市,國聖里,167,786,133,320,453,49,502
公投第１５案,彰化縣,彰化市,福山里,168,1120,175,407,582,37,619
公投第１５案,彰化縣,彰化市,福山里,169,1269,193,472,665,29,694
公投第１５案,彰化縣,彰化市,福山里,170,1159,192,477,669,37,706
公投第１５案,彰化縣,彰化市,福山里,171,1184,295,363,658,69,727
公投第１５案,彰化縣,彰化市,福山里,172,1089,191,405,596,38,634
公投第１５案,彰化縣,彰化市,福山里,173,968,171,388,559,45,604
公投第１５案,彰化縣,彰化市,安溪里,174,930,158,365,523,24,547
公投第１５案,彰化縣,彰化市,安溪里,175,973,157,389,546,22,568
公投第１５案,彰化縣,彰化市,三村里,176,1184,207,383,590,26,616
公投第１５案,彰化縣,彰化市,大竹里,177,1002,165,396,561,52,613
公投第１５案,彰化縣,彰化市,大竹里,178,1148,177,450,627,22,649
公投第１５案,彰化縣,彰化市,大竹里,179,1112,191,424,615,31,646
公投第１５案,彰化縣,彰化市,田中里,180,907,180,406,586,39,625
公投第１５案,彰化縣,彰化市,快官里,181,1112,183,444,627,54,681
公投第１５案,彰化縣,彰化市,竹巷里,182,823,124,294,418,32,450
公投第１５案,彰化縣,彰化市,福田里,183,1276,220,478,698,61,759
公投第１５案,彰化縣,彰化市,石牌里,184,1161,191,442,633,33,666
公投第１５案,彰化縣,花壇鄉,花壇村,185,901,139,360,499,48,547
公投第１５案,彰化縣,花壇鄉,花壇村,186,1042,199,421,620,30,650
公投第１５案,彰化縣,花壇鄉,花壇村,187,1314,220,488,708,11,719
公投第１５案,彰化縣,花壇鄉,金墩村,188,808,119,341,460,39,499
公投第１５案,彰化縣,花壇鄉,金墩村,189,1019,156,404,560,30,590
公投第１５案,彰化縣,花壇鄉,中庄村,190,1144,192,466,658,52,710
公投第１５案,彰化縣,花壇鄉,中庄村,191,1240,156,492,648,91,739
公投第１５案,彰化縣,花壇鄉,崙雅村,192,1425,192,635,827,54,881
公投第１５案,彰化縣,花壇鄉,劉厝村,193,1095,187,479,666,37,703
公投第１５案,彰化縣,花壇鄉,南口村,194,910,139,369,508,36,544
公投第１５案,彰化縣,花壇鄉,南口村,195,982,164,431,595,23,618
公投第１５案,彰化縣,花壇鄉,北口村,196,1070,201,411,612,14,626
公投第１５案,彰化縣,花壇鄉,北口村,197,700,136,223,359,24,383
公投第１５案,彰化縣,花壇鄉,中口村,198,764,145,329,474,31,505
公投第１５案,彰化縣,花壇鄉,文德村,199,953,164,411,575,32,607
公投第１５案,彰化縣,花壇鄉,文德村,200,974,160,376,536,21,557
公投第１５案,彰化縣,花壇鄉,文德村,201,1111,176,426,602,45,647
公投第１５案,彰化縣,花壇鄉,白沙村,202,1101,154,460,614,59,673
公投第１５案,彰化縣,花壇鄉,白沙村,203,1110,68,526,594,27,621
公投第１５案,彰化縣,花壇鄉,白沙村,204,1262,233,467,700,39,739
公投第１５案,彰化縣,花壇鄉,白沙村,205,1103,236,389,625,28,653
公投第１５案,彰化縣,花壇鄉,岩竹村,206,1347,198,457,655,51,706
公投第１５案,彰化縣,花壇鄉,長沙村,207,1169,168,430,598,37,635
公投第１５案,彰化縣,花壇鄉,長沙村,208,1274,211,511,722,46,768
公投第１５案,彰化縣,花壇鄉,長沙村,209,1280,202,569,771,21,792
公投第１５案,彰化縣,花壇鄉,長沙村,210,1244,177,515,692,37,729
公投第１５案,彰化縣,花壇鄉,橋頭村,211,1159,193,436,629,52,681
公投第１５案,彰化縣,花壇鄉,橋頭村,212,1042,211,417,628,30,658
公投第１５案,彰化縣,花壇鄉,橋頭村,213,1111,159,434,593,38,631
公投第１５案,彰化縣,花壇鄉,灣雅村,214,893,160,370,530,38,568
公投第１５案,彰化縣,花壇鄉,灣東村,215,953,155,371,526,45,571
公投第１５案,彰化縣,花壇鄉,三春村,216,987,167,339,506,27,533
公投第１５案,彰化縣,花壇鄉,三春村,217,925,172,394,566,37,603
公投第１５案,彰化縣,花壇鄉,永春村,218,951,139,384,523,25,548
公投第１５案,彰化縣,花壇鄉,永春村,219,955,149,371,520,25,545
公投第１５案,彰化縣,花壇鄉,長春村,220,895,120,367,487,29,516
公投第１５案,彰化縣,花壇鄉,長春村,221,711,107,293,400,20,420
公投第１５案,彰化縣,芬園鄉,舊社村,222,958,146,353,499,37,536
公投第１５案,彰化縣,芬園鄉,舊社村,223,794,119,296,415,42,457
公投第１５案,彰化縣,芬園鄉,大埔村,224,1415,214,452,666,81,747
公投第１５案,彰化縣,芬園鄉,竹林村,225,927,150,388,538,31,569
公投第１５案,彰化縣,芬園鄉,竹林村,226,831,118,327,445,29,474
公投第１５案,彰化縣,芬園鄉,楓坑村,227,570,89,224,313,19,332
公投第１５案,彰化縣,芬園鄉,社口村,228,1227,219,384,603,51,654
公投第１５案,彰化縣,芬園鄉,社口村,229,1238,176,442,618,65,683
公投第１５案,彰化縣,芬園鄉,茄荖村,230,1362,215,508,723,62,785
公投第１５案,彰化縣,芬園鄉,茄荖村,231,989,141,377,518,67,585
公投第１５案,彰化縣,芬園鄉,嘉興村,232,1054,176,445,621,50,671
公投第１５案,彰化縣,芬園鄉,嘉興村,233,607,110,260,370,32,402
公投第１５案,彰化縣,芬園鄉,芬園村,234,882,146,354,500,36,536
公投第１５案,彰化縣,芬園鄉,縣庄村,235,1143,141,380,521,37,558
公投第１５案,彰化縣,芬園鄉,圳墘村,236,661,89,219,308,12,320
公投第１５案,彰化縣,芬園鄉,溪頭村,237,838,109,302,411,7,418
公投第１５案,彰化縣,芬園鄉,溪頭村,238,847,126,292,418,28,446
公投第１５案,彰化縣,芬園鄉,進芬村,239,987,133,409,542,50,592
公投第１５案,彰化縣,芬園鄉,同安村,240,1217,167,413,580,62,642
公投第１５案,彰化縣,芬園鄉,中崙村,241,865,111,287,398,52,450
公投第１５案,彰化縣,芬園鄉,大竹村,242,996,150,330,480,35,515
公投第１５案,彰化縣,鹿港鎮,大有里,243,1140,212,458,670,44,714
公投第１５案,彰化縣,鹿港鎮,中興里,244,511,96,190,286,20,306
公投第１５案,彰化縣,鹿港鎮,洛津里,245,857,241,172,413,16,429
公投第１５案,彰化縣,鹿港鎮,順興里,246,946,169,392,561,50,611
公投第１５案,彰化縣,鹿港鎮,埔崙里,247,945,177,354,531,33,564
公投第１５案,彰化縣,鹿港鎮,埔崙里,248,1097,185,437,622,36,658
公投第１５案,彰化縣,鹿港鎮,埔崙里,249,1479,250,464,714,24,738
公投第１５案,彰化縣,鹿港鎮,埔崙里,250,1425,235,559,794,63,857
公投第１５案,彰化縣,鹿港鎮,新宮里,251,880,171,329,500,60,560
公投第１５案,彰化縣,鹿港鎮,玉順里,252,1183,195,423,618,52,670
公投第１５案,彰化縣,鹿港鎮,東石里,253,1047,189,409,598,49,647
公投第１５案,彰化縣,鹿港鎮,東石里,254,1097,282,300,582,23,605
公投第１５案,彰化縣,鹿港鎮,東石里,255,1030,152,387,539,54,593
公投第１５案,彰化縣,鹿港鎮,東石里,256,1161,199,435,634,37,671
公投第１５案,彰化縣,鹿港鎮,郭厝里,257,540,97,209,306,35,341
公投第１５案,彰化縣,鹿港鎮,永安里,258,1135,192,411,603,45,648
公投第１５案,彰化縣,鹿港鎮,永安里,259,1155,160,451,611,58,669
公投第１５案,彰化縣,鹿港鎮,永安里,260,1127,217,445,662,36,698
公投第１５案,彰化縣,鹿港鎮,永安里,261,1045,195,386,581,44,625
公投第１５案,彰化縣,鹿港鎮,景福里,262,1127,197,413,610,57,667
公投第１５案,彰化縣,鹿港鎮,泰興里,263,1178,211,508,719,38,757
公投第１５案,彰化縣,鹿港鎮,長興里,264,284,51,107,158,11,169
公投第１５案,彰化縣,鹿港鎮,興化里,265,584,112,212,324,23,347
公投第１５案,彰化縣,鹿港鎮,龍山里,266,659,104,295,399,36,435
公投第１５案,彰化縣,鹿港鎮,菜園里,267,915,177,339,516,21,537
公投第１５案,彰化縣,鹿港鎮,街尾里,268,1079,206,428,634,45,679
公投第１５案,彰化縣,鹿港鎮,街尾里,269,1129,209,467,676,56,732
公投第１５案,彰化縣,鹿港鎮,詔安里,270,1273,160,503,663,44,707
公投第１５案,彰化縣,鹿港鎮,詔安里,271,706,93,256,349,29,378
公投第１５案,彰化縣,鹿港鎮,海埔里,272,1137,190,354,544,87,631
公投第１５案,彰化縣,鹿港鎮,海埔里,273,1195,199,421,620,41,661
公投第１５案,彰化縣,鹿港鎮,海埔里,274,1225,178,437,615,47,662
公投第１５案,彰化縣,鹿港鎮,洋厝里,275,957,164,421,585,45,630
公投第１５案,彰化縣,鹿港鎮,洋厝里,276,758,101,253,354,53,407
公投第１５案,彰化縣,鹿港鎮,洋厝里,277,723,112,279,391,47,438
公投第１５案,彰化縣,鹿港鎮,草中里,278,984,142,382,524,21,545
公投第１５案,彰化縣,鹿港鎮,草中里,279,1018,148,467,615,27,642
公投第１５案,彰化縣,鹿港鎮,草中里,280,1165,181,424,605,40,645
公投第１５案,彰化縣,鹿港鎮,頭南里,281,1161,157,407,564,46,610
公投第１５案,彰化縣,鹿港鎮,頭南里,282,1020,152,365,517,45,562
公投第１５案,彰化縣,鹿港鎮,山崙里,283,1068,148,414,562,54,616
公投第１５案,彰化縣,鹿港鎮,山崙里,284,1024,139,456,595,28,623
公投第１５案,彰化縣,鹿港鎮,山崙里,285,974,170,369,539,62,601
公投第１５案,彰化縣,鹿港鎮,頂番里,286,1505,249,510,759,60,819
公投第１５案,彰化縣,鹿港鎮,頂番里,287,1092,186,374,560,44,604
公投第１５案,彰化縣,鹿港鎮,頂番里,288,1223,203,481,684,58,742
公投第１５案,彰化縣,鹿港鎮,頭崙里,289,1572,193,564,757,32,789
公投第１５案,彰化縣,鹿港鎮,頭崙里,290,1003,171,407,578,41,619
公投第１５案,彰化縣,鹿港鎮,溝墘里,291,933,136,394,530,29,559
公投第１５案,彰化縣,鹿港鎮,溝墘里,292,1093,168,447,615,48,663
公投第１５案,彰化縣,鹿港鎮,溝墘里,293,907,143,352,495,20,515
公投第１５案,彰化縣,鹿港鎮,溝墘里,294,1219,172,462,634,37,671
公投第１５案,彰化縣,鹿港鎮,廖厝里,295,1397,227,614,841,48,889
公投第１５案,彰化縣,鹿港鎮,廖厝里,296,1229,152,519,671,33,704
公投第１５案,彰化縣,鹿港鎮,廖厝里,297,1444,187,577,764,34,798
公投第１５案,彰化縣,鹿港鎮,東崎里,298,1227,191,503,694,40,734
公投第１５案,彰化縣,鹿港鎮,東崎里,299,1187,156,514,670,50,720
公投第１５案,彰化縣,鹿港鎮,東崎里,300,1296,187,496,683,26,709
公投第１５案,彰化縣,鹿港鎮,東崎里,301,1451,239,472,711,45,756
公投第１５案,彰化縣,鹿港鎮,頂厝里,302,1299,214,456,670,65,735
公投第１５案,彰化縣,鹿港鎮,頂厝里,303,1298,224,556,780,28,808
公投第１５案,彰化縣,鹿港鎮,頂厝里,304,1458,227,577,804,39,843
公投第１５案,彰化縣,鹿港鎮,頂厝里,305,1138,200,437,637,47,684
公投第１５案,彰化縣,鹿港鎮,頂厝里,306,1170,193,452,645,49,694
公投第１５案,彰化縣,鹿港鎮,頂厝里,307,1221,184,517,701,42,743
公投第１５案,彰化縣,福興鄉,三汴村,308,1363,254,422,676,50,726
公投第１５案,彰化縣,福興鄉,萬豐村,309,821,153,294,447,23,470
公投第１５案,彰化縣,福興鄉,元中村,310,1256,182,424,606,57,663
公投第１５案,彰化縣,福興鄉,外中村,311,1166,188,377,565,73,638
公投第１５案,彰化縣,福興鄉,外埔村,312,1464,203,509,712,52,764
公投第１５案,彰化縣,福興鄉,大崙村,313,1251,199,424,623,39,662
公投第１５案,彰化縣,福興鄉,番婆村,314,1465,227,504,731,48,779
公投第１５案,彰化縣,福興鄉,番婆村,315,960,140,319,459,21,480
公投第１５案,彰化縣,福興鄉,橋頭村,316,1323,238,424,662,56,718
公投第１５案,彰化縣,福興鄉,橋頭村,317,1365,233,485,718,38,756
公投第１５案,彰化縣,福興鄉,社尾村,318,1458,181,452,633,42,675
公投第１５案,彰化縣,福興鄉,番社村,319,1492,193,536,729,62,791
公投第１５案,彰化縣,福興鄉,西勢村,320,888,134,301,435,22,457
公投第１５案,彰化縣,福興鄉,西勢村,321,1054,186,394,580,54,634
公投第１５案,彰化縣,福興鄉,同安村,322,1043,134,340,474,46,520
公投第１５案,彰化縣,福興鄉,同安村,323,1340,190,489,679,61,740
公投第１５案,彰化縣,福興鄉,秀厝村,324,1085,202,332,534,38,572
公投第１５案,彰化縣,福興鄉,秀厝村,325,1392,186,515,701,38,739
公投第１５案,彰化縣,福興鄉,福興村,326,1316,216,499,715,59,774
公投第１５案,彰化縣,福興鄉,福興村,327,1255,193,523,716,39,755
公投第１５案,彰化縣,福興鄉,福興村,328,1101,460,184,644,31,675
公投第１５案,彰化縣,福興鄉,福南村,329,1167,157,439,596,62,658
公投第１５案,彰化縣,福興鄉,福南村,330,1393,289,380,669,66,735
公投第１５案,彰化縣,福興鄉,鎮平村,331,1216,178,474,652,45,697
公投第１５案,彰化縣,福興鄉,三和村,332,1063,142,400,542,33,575
公投第１５案,彰化縣,福興鄉,二港村,333,1306,195,467,662,42,704
公投第１５案,彰化縣,福興鄉,福寶村,334,1287,165,386,551,53,604
公投第１５案,彰化縣,福興鄉,頂粘村,335,994,137,394,531,28,559
公投第１５案,彰化縣,福興鄉,頂粘村,336,1311,187,497,684,60,744
公投第１５案,彰化縣,福興鄉,廈粘村,337,926,137,383,520,34,554
公投第１５案,彰化縣,福興鄉,廈粘村,338,995,159,330,489,32,521
公投第１５案,彰化縣,福興鄉,麥厝村,339,1079,169,432,601,69,670
公投第１５案,彰化縣,福興鄉,麥厝村,340,1150,161,386,547,60,607
公投第１５案,彰化縣,秀水鄉,秀水村,341,1066,171,416,587,82,669
公投第１５案,彰化縣,秀水鄉,秀水村,342,620,117,243,360,37,397
公投第１５案,彰化縣,秀水鄉,安溪村,343,876,145,288,433,14,447
公投第１５案,彰化縣,秀水鄉,安溪村,344,1196,234,469,703,33,736
公投第１５案,彰化縣,秀水鄉,莊雅村,345,1369,246,509,755,35,790
公投第１５案,彰化縣,秀水鄉,莊雅村,346,1273,207,498,705,51,756
公投第１５案,彰化縣,秀水鄉,陝西村,347,1433,127,639,766,40,806
公投第１５案,彰化縣,秀水鄉,金興村,348,967,176,371,547,29,576
公投第１５案,彰化縣,秀水鄉,金興村,349,921,170,354,524,20,544
公投第１５案,彰化縣,秀水鄉,安東村,350,689,130,280,410,24,434
公投第１５案,彰化縣,秀水鄉,安東村,351,688,116,266,382,39,421
公投第１５案,彰化縣,秀水鄉,安東村,352,1252,243,490,733,48,781
公投第１５案,彰化縣,秀水鄉,安東村,353,1281,220,457,677,32,709
公投第１５案,彰化縣,秀水鄉,鶴鳴村,354,754,112,292,404,23,427
公投第１５案,彰化縣,秀水鄉,鶴鳴村,355,1024,187,363,550,37,587
公投第１５案,彰化縣,秀水鄉,鶴鳴村,356,1433,222,541,763,20,783
公投第１５案,彰化縣,秀水鄉,馬興村,357,1366,254,579,833,50,883
公投第１５案,彰化縣,秀水鄉,馬興村,358,895,138,366,504,42,546
公投第１５案,彰化縣,秀水鄉,義興村,359,1386,225,467,692,54,746
公投第１５案,彰化縣,秀水鄉,福安村,360,896,146,338,484,60,544
公投第１５案,彰化縣,秀水鄉,福安村,361,804,156,343,499,36,535
公投第１５案,彰化縣,秀水鄉,福安村,362,827,137,354,491,29,520
公投第１５案,彰化縣,秀水鄉,福安村,363,996,178,373,551,43,594
公投第１５案,彰化縣,秀水鄉,福安村,364,931,175,398,573,45,618
公投第１５案,彰化縣,秀水鄉,埔崙村,365,715,127,260,387,20,407
公投第１５案,彰化縣,秀水鄉,埔崙村,366,1229,196,510,706,62,768
公投第１５案,彰化縣,秀水鄉,曾厝村,367,890,111,321,432,32,464
公投第１５案,彰化縣,秀水鄉,曾厝村,368,811,360,124,484,25,509
公投第１５案,彰化縣,秀水鄉,金陵村,369,786,124,331,455,32,487
公投第１５案,彰化縣,秀水鄉,金陵村,370,931,136,374,510,32,542
公投第１５案,彰化縣,秀水鄉,下崙村,371,1265,170,552,722,51,773
公投第１５案,彰化縣,秀水鄉,下崙村,372,824,122,295,417,48,465
公投第１５案,彰化縣,和美鎮,竹營里,373,1341,232,470,702,36,738
公投第１５案,彰化縣,和美鎮,竹營里,374,1480,232,492,724,47,771
公投第１５案,彰化縣,和美鎮,竹營里,375,1529,262,560,822,38,860
公投第１５案,彰化縣,和美鎮,竹營里,376,1711,290,583,873,9,882
公投第１５案,彰化縣,和美鎮,和東里,377,1057,217,372,589,27,616
公投第１５案,彰化縣,和美鎮,和東里,378,1032,219,362,581,37,618
公投第１５案,彰化縣,和美鎮,和東里,379,1015,162,423,585,38,623
公投第１５案,彰化縣,和美鎮,和東里,380,1209,231,467,698,38,736
公投第１５案,彰化縣,和美鎮,和南里,381,430,101,136,237,14,251
公投第１５案,彰化縣,和美鎮,和北里,382,856,153,315,468,16,484
公投第１５案,彰化縣,和美鎮,和北里,383,966,155,400,555,28,583
公投第１５案,彰化縣,和美鎮,和西里,384,1059,185,372,557,25,582
公投第１５案,彰化縣,和美鎮,和西里,385,1117,215,397,612,27,639
公投第１５案,彰化縣,和美鎮,和西里,386,1066,156,396,552,39,591
公投第１５案,彰化縣,和美鎮,四張里,387,1252,235,423,658,25,683
公投第１５案,彰化縣,和美鎮,四張里,388,1528,257,510,767,40,807
公投第１５案,彰化縣,和美鎮,頭前里,389,826,158,312,470,25,495
公投第１５案,彰化縣,和美鎮,頭前里,390,854,141,318,459,25,484
公投第１５案,彰化縣,和美鎮,面前里,391,1387,223,486,709,39,748
公投第１５案,彰化縣,和美鎮,面前里,392,765,120,344,464,15,479
公投第１５案,彰化縣,和美鎮,鎮平里,393,1438,207,502,709,45,754
公投第１５案,彰化縣,和美鎮,鎮平里,394,1396,235,553,788,43,831
公投第１５案,彰化縣,和美鎮,大霞里,395,658,96,275,371,16,387
公投第１５案,彰化縣,和美鎮,大霞里,396,809,143,346,489,26,515
公投第１５案,彰化縣,和美鎮,源埤里,397,932,155,334,489,5,494
公投第１５案,彰化縣,和美鎮,源埤里,398,888,132,322,454,32,486
公投第１５案,彰化縣,和美鎮,南佃里,399,1144,386,285,671,28,699
公投第１５案,彰化縣,和美鎮,南佃里,400,1077,169,411,580,35,615
公投第１５案,彰化縣,和美鎮,雅溝里,401,1349,207,452,659,52,711
公投第１５案,彰化縣,和美鎮,山犁里,402,1155,191,500,691,34,725
公投第１５案,彰化縣,和美鎮,山犁里,403,1253,189,472,661,37,698
公投第１５案,彰化縣,和美鎮,山犁里,404,1252,186,468,654,36,690
公投第１５案,彰化縣,和美鎮,山犁里,405,1474,270,500,770,27,797
公投第１５案,彰化縣,和美鎮,仁愛里,406,1396,223,465,688,29,717
公投第１５案,彰化縣,和美鎮,仁愛里,407,1348,212,483,695,30,725
公投第１５案,彰化縣,和美鎮,嘉犁里,408,999,163,427,590,31,621
公投第１５案,彰化縣,和美鎮,嘉犁里,409,911,165,348,513,34,547
公投第１５案,彰化縣,和美鎮,詔安里,410,1005,186,380,566,29,595
公投第１５案,彰化縣,和美鎮,詔安里,411,967,152,376,528,36,564
公投第１５案,彰化縣,和美鎮,鐵山里,412,1308,204,526,730,38,768
公投第１５案,彰化縣,和美鎮,鐵山里,413,1324,213,501,714,37,751
公投第１５案,彰化縣,和美鎮,柑井里,414,1102,205,410,615,43,658
公投第１５案,彰化縣,和美鎮,柑井里,415,1124,179,389,568,45,613
公投第１５案,彰化縣,和美鎮,柑井里,416,1211,200,455,655,50,705
公投第１５案,彰化縣,和美鎮,竹園里,417,884,154,400,554,39,593
公投第１５案,彰化縣,和美鎮,新庄里,418,1119,184,407,591,61,652
公投第１５案,彰化縣,和美鎮,新庄里,419,1300,223,475,698,37,735
公投第１５案,彰化縣,和美鎮,犁盛里,420,1104,183,397,580,26,606
公投第１５案,彰化縣,和美鎮,犁盛里,421,1213,216,481,697,42,739
公投第１５案,彰化縣,和美鎮,中寮里,422,1127,186,369,555,37,592
公投第１５案,彰化縣,和美鎮,中圍里,423,919,158,329,487,39,526
公投第１５案,彰化縣,和美鎮,中圍里,424,987,170,392,562,34,596
公投第１５案,彰化縣,和美鎮,中圍里,425,958,160,399,559,34,593
公投第１５案,彰化縣,和美鎮,糖友里,426,1362,220,541,761,33,794
公投第１５案,彰化縣,和美鎮,糖友里,427,1461,263,525,788,23,811
公投第１５案,彰化縣,和美鎮,糖友里,428,1405,258,534,792,20,812
公投第１５案,彰化縣,和美鎮,還社里,429,860,161,339,500,20,520
公投第１５案,彰化縣,和美鎮,塗厝里,430,875,128,344,472,22,494
公投第１５案,彰化縣,和美鎮,塗厝里,431,871,157,305,462,44,506
公投第１５案,彰化縣,和美鎮,地潭里,432,883,151,368,519,33,552
公投第１５案,彰化縣,和美鎮,湖內里,433,1224,226,407,633,56,689
公投第１５案,彰化縣,和美鎮,嘉寶里,434,1075,178,384,562,40,602
公投第１５案,彰化縣,和美鎮,嘉寶里,435,956,170,343,513,31,544
公投第１５案,彰化縣,和美鎮,月眉里,436,1037,184,360,544,36,580
公投第１５案,彰化縣,和美鎮,月眉里,437,1011,181,372,553,22,575
公投第１５案,彰化縣,和美鎮,月眉里,438,1023,179,361,540,39,579
公投第１５案,彰化縣,和美鎮,好修里,439,719,105,268,373,22,395
公投第１５案,彰化縣,和美鎮,好修里,440,913,144,333,477,39,516
公投第１５案,彰化縣,伸港鄉,大同村,441,1182,178,373,551,53,604
公投第１５案,彰化縣,伸港鄉,大同村,442,1166,185,501,686,33,719
公投第１５案,彰化縣,伸港鄉,海尾村,443,966,155,374,529,33,562
公投第１５案,彰化縣,伸港鄉,海尾村,444,873,154,303,457,33,490
公投第１５案,彰化縣,伸港鄉,全興村,445,812,125,328,453,38,491
公投第１５案,彰化縣,伸港鄉,全興村,446,875,123,328,451,40,491
公投第１５案,彰化縣,伸港鄉,溪底村,447,904,148,317,465,47,512
公投第１５案,彰化縣,伸港鄉,溪底村,448,1008,164,359,523,37,560
公投第１５案,彰化縣,伸港鄉,定興村,449,1154,200,437,637,44,681
公投第１５案,彰化縣,伸港鄉,定興村,450,1486,219,497,716,66,782
公投第１５案,彰化縣,伸港鄉,什股村,451,1095,159,415,574,36,610
公投第１５案,彰化縣,伸港鄉,什股村,452,1087,139,401,540,18,558
公投第１５案,彰化縣,伸港鄉,泉州村,453,1085,184,407,591,57,648
公投第１５案,彰化縣,伸港鄉,泉州村,454,908,162,355,517,26,543
公投第１５案,彰化縣,伸港鄉,泉厝村,455,1264,201,520,721,41,762
公投第１５案,彰化縣,伸港鄉,曾家村,456,854,145,285,430,46,476
公投第１５案,彰化縣,伸港鄉,曾家村,457,846,112,291,403,24,427
公投第１５案,彰化縣,伸港鄉,蚵寮村,458,1143,178,351,529,81,610
公投第１５案,彰化縣,伸港鄉,新港村,459,1357,240,492,732,28,760
公投第１５案,彰化縣,伸港鄉,新港村,460,1349,221,489,710,47,757
公投第１５案,彰化縣,伸港鄉,新港村,461,1154,191,446,637,42,679
公投第１５案,彰化縣,伸港鄉,新港村,462,1279,227,433,660,32,692
公投第１５案,彰化縣,伸港鄉,埤墘村,463,1317,240,479,719,55,774
公投第１５案,彰化縣,伸港鄉,七嘉村,464,990,151,413,564,43,607
公投第１５案,彰化縣,伸港鄉,七嘉村,465,852,182,296,478,30,508
公投第１５案,彰化縣,伸港鄉,七嘉村,466,1178,212,449,661,25,686
公投第１５案,彰化縣,伸港鄉,汴頭村,467,1088,151,404,555,64,619
公投第１５案,彰化縣,伸港鄉,汴頭村,468,1135,212,398,610,40,650
公投第１５案,彰化縣,線西鄉,線西村,469,1071,183,415,598,19,617
公投第１５案,彰化縣,線西鄉,線西村,470,1166,210,465,675,26,701
公投第１５案,彰化縣,線西鄉,頂庄村,471,1269,197,496,693,63,756
公投第１５案,彰化縣,線西鄉,寓埔村,472,1138,168,445,613,38,651
公投第１５案,彰化縣,線西鄉,寓埔村,473,1128,186,475,661,62,723
公投第１５案,彰化縣,線西鄉,塭仔村,474,1275,199,514,713,56,769
公投第１５案,彰化縣,線西鄉,溝內村,475,1187,213,457,670,38,708
公投第１５案,彰化縣,線西鄉,下犁村,476,991,144,406,550,52,602
公投第１５案,彰化縣,線西鄉,下犁村,477,938,178,338,516,47,563
公投第１５案,彰化縣,線西鄉,頂犁村,478,1276,195,445,640,47,687
公投第１５案,彰化縣,線西鄉,頂犁村,479,1285,211,503,714,44,758
公投第１５案,彰化縣,線西鄉,德興村,480,1341,239,586,825,15,840
公投第１５案,彰化縣,員林市,崙雅里,481,1087,129,424,553,20,573
公投第１５案,彰化縣,員林市,崙雅里,482,1353,194,484,678,31,709
公投第１５案,彰化縣,員林市,振興里,483,1313,211,448,659,40,699
公投第１５案,彰化縣,員林市,振興里,484,1328,176,433,609,29,638
公投第１５案,彰化縣,員林市,林厝里,485,1055,181,393,574,26,600
公投第１５案,彰化縣,員林市,林厝里,486,959,154,340,494,36,530
公投第１５案,彰化縣,員林市,林厝里,487,772,133,284,417,34,451
公投第１５案,彰化縣,員林市,出水里,488,831,143,339,482,29,511
公投第１５案,彰化縣,員林市,出水里,489,854,108,257,365,11,376
公投第１５案,彰化縣,員林市,湖水里,490,1190,134,375,509,55,564
公投第１５案,彰化縣,員林市,大峯里,491,726,98,276,374,23,397
公投第１５案,彰化縣,員林市,鎮興里,492,1124,202,400,602,31,633
公投第１５案,彰化縣,員林市,鎮興里,493,860,156,264,420,33,453
公投第１５案,彰化縣,員林市,浮圳里,494,1122,202,451,653,31,684
公投第１５案,彰化縣,員林市,浮圳里,495,1075,180,413,593,46,639
公投第１５案,彰化縣,員林市,西東里,496,993,128,369,497,53,550
公投第１５案,彰化縣,員林市,西東里,497,967,124,366,490,35,525
公投第１５案,彰化縣,員林市,南東里,498,1008,164,389,553,33,586
公投第１５案,彰化縣,員林市,南東里,499,804,130,295,425,33,458
公投第１５案,彰化縣,員林市,中東里,500,867,158,304,462,23,485
公投第１５案,彰化縣,員林市,中東里,501,885,158,315,473,12,485
公投第１５案,彰化縣,員林市,東北里,502,1097,150,386,536,14,550
公投第１５案,彰化縣,員林市,東北里,503,1255,204,468,672,28,700
公投第１５案,彰化縣,員林市,東和里,504,1063,194,393,587,32,619
公投第１５案,彰化縣,員林市,民生里,505,925,389,110,499,20,519
公投第１５案,彰化縣,員林市,民生里,506,947,148,370,518,41,559
公投第１５案,彰化縣,員林市,民生里,507,916,138,380,518,27,545
公投第１５案,彰化縣,員林市,黎明里,508,862,146,308,454,24,478
公投第１５案,彰化縣,員林市,黎明里,509,987,179,369,548,17,565
公投第１５案,彰化縣,員林市,惠來里,510,1085,177,387,564,34,598
公投第１５案,彰化縣,員林市,惠來里,511,1110,188,426,614,23,637
公投第１５案,彰化縣,員林市,惠來里,512,1095,170,386,556,23,579
公投第１５案,彰化縣,員林市,惠來里,513,1278,251,503,754,31,785
公投第１５案,彰化縣,員林市,惠來里,514,1109,190,433,623,32,655
公投第１５案,彰化縣,員林市,中央里,515,1055,162,392,554,42,596
公投第１５案,彰化縣,員林市,中央里,516,876,177,310,487,24,511
公投第１５案,彰化縣,員林市,溝皂里,517,1115,168,360,528,28,556
公投第１５案,彰化縣,員林市,溝皂里,518,1186,201,460,661,28,689
公投第１５案,彰化縣,員林市,大饒里,519,995,154,406,560,42,602
公投第１５案,彰化縣,員林市,大饒里,520,999,0,536,536,15,551
公投第１５案,彰化縣,員林市,大饒里,521,1201,214,447,661,26,687
公投第１５案,彰化縣,員林市,大明里,522,1342,212,513,725,20,745
公投第１５案,彰化縣,員林市,大明里,523,1086,178,389,567,22,589
公投第１５案,彰化縣,員林市,萬年里,524,854,128,306,434,23,457
公投第１５案,彰化縣,員林市,萬年里,525,1064,167,418,585,22,607
公投第１５案,彰化縣,員林市,萬年里,526,879,167,346,513,14,527
公投第１５案,彰化縣,員林市,萬年里,527,827,175,363,538,25,563
公投第１５案,彰化縣,員林市,中正里,528,867,154,310,464,14,478
公投第１５案,彰化縣,員林市,中正里,529,1201,197,452,649,29,678
公投第１５案,彰化縣,員林市,中正里,530,1106,200,413,613,33,646
公投第１５案,彰化縣,員林市,仁美里,531,845,155,329,484,25,509
公投第１５案,彰化縣,員林市,仁美里,532,894,173,334,507,20,527
公投第１５案,彰化縣,員林市,仁美里,533,849,148,330,478,27,505
公投第１５案,彰化縣,員林市,新興里,534,747,162,278,440,34,474
公投第１５案,彰化縣,員林市,和平里,535,884,181,341,522,26,548
公投第１５案,彰化縣,員林市,和平里,536,900,138,312,450,27,477
公投第１５案,彰化縣,員林市,和平里,537,1040,146,377,523,23,546
公投第１５案,彰化縣,員林市,光明里,538,831,159,282,441,15,456
公投第１５案,彰化縣,員林市,中山里,539,591,125,233,358,30,388
公投第１５案,彰化縣,員林市,三條里,540,1330,228,465,693,28,721
公投第１５案,彰化縣,員林市,三條里,541,1295,232,481,713,24,737
公投第１５案,彰化縣,員林市,忠孝里,542,1283,221,431,652,64,716
公投第１５案,彰化縣,員林市,忠孝里,543,943,169,381,550,24,574
公投第１５案,彰化縣,員林市,仁愛里,544,1388,280,538,818,50,868
公投第１５案,彰化縣,員林市,三和里,545,1176,217,444,661,27,688
公投第１５案,彰化縣,員林市,三和里,546,867,132,302,434,7,441
公投第１５案,彰化縣,員林市,三和里,547,1121,217,377,594,27,621
公投第１５案,彰化縣,員林市,三和里,548,1190,191,415,606,23,629
公投第１５案,彰化縣,員林市,三和里,549,945,153,386,539,26,565
公投第１５案,彰化縣,員林市,三和里,550,906,154,366,520,25,545
公投第１５案,彰化縣,員林市,三橋里,551,978,189,374,563,34,597
公投第１５案,彰化縣,員林市,三橋里,552,949,133,442,575,30,605
公投第１５案,彰化縣,員林市,三橋里,553,949,147,405,552,16,568
公投第１５案,彰化縣,員林市,三愛里,554,1006,170,379,549,25,574
公投第１５案,彰化縣,員林市,三愛里,555,889,182,310,492,36,528
公投第１５案,彰化縣,員林市,三愛里,556,923,175,383,558,19,577
公投第１５案,彰化縣,員林市,三信里,557,1209,244,465,709,39,748
公投第１５案,彰化縣,員林市,三信里,558,1075,198,428,626,23,649
公投第１５案,彰化縣,員林市,三多里,559,1342,275,515,790,39,829
公投第１５案,彰化縣,員林市,三多里,560,1039,234,420,654,39,693
公投第１５案,彰化縣,員林市,三義里,561,1131,162,407,569,63,632
公投第１５案,彰化縣,員林市,三義里,562,1356,220,456,676,29,705
公投第１５案,彰化縣,員林市,新生里,563,1370,243,484,727,44,771
公投第１５案,彰化縣,員林市,新生里,564,1090,197,407,604,34,638
公投第１５案,彰化縣,員林市,新生里,565,821,174,338,512,21,533
公投第１５案,彰化縣,員林市,新生里,566,910,170,347,517,26,543
公投第１５案,彰化縣,員林市,南平里,567,1203,194,469,663,24,687
公投第１５案,彰化縣,員林市,南平里,568,1378,269,488,757,26,783
公投第１５案,彰化縣,員林市,南平里,569,1352,220,523,743,27,770
公投第１５案,彰化縣,員林市,南平里,570,1060,194,439,633,20,653
公投第１５案,彰化縣,員林市,南興里,571,1317,188,481,669,44,713
公投第１５案,彰化縣,員林市,南興里,572,1120,172,411,583,28,611
公投第１５案,彰化縣,員林市,南興里,573,1025,133,382,515,39,554
公投第１５案,彰化縣,員林市,南興里,574,1097,171,430,601,32,633
公投第１５案,彰化縣,員林市,源潭里,575,859,136,362,498,38,536
公投第１５案,彰化縣,員林市,源潭里,576,837,125,321,446,26,472
公投第１５案,彰化縣,員林市,大埔里,577,1090,210,439,649,35,684
公投第１５案,彰化縣,員林市,大埔里,578,1073,174,389,563,51,614
公投第１５案,彰化縣,大村鄉,大村村,579,1426,253,592,845,60,905
公投第１５案,彰化縣,大村鄉,大村村,580,1726,306,706,1012,67,1079
公投第１５案,彰化縣,大村鄉,茄苳村,581,797,139,318,457,47,504
公投第１５案,彰化縣,大村鄉,茄苳村,582,745,141,292,433,17,450
公投第１５案,彰化縣,大村鄉,田洋村,583,1125,168,480,648,47,695
公投第１５案,彰化縣,大村鄉,貢旗村,584,1486,236,560,796,69,865
公投第１５案,彰化縣,大村鄉,南勢村,585,1426,239,545,784,51,835
公投第１５案,彰化縣,大村鄉,大橋村,586,824,127,371,498,26,524
公投第１５案,彰化縣,大村鄉,大橋村,587,1177,190,394,584,35,619
公投第１５案,彰化縣,大村鄉,加錫村,588,1478,249,582,831,50,881
公投第１５案,彰化縣,大村鄉,大崙村,589,779,126,281,407,19,426
公投第１５案,彰化縣,大村鄉,大崙村,590,812,149,329,478,40,518
公投第１５案,彰化縣,大村鄉,新興村,591,1161,435,170,605,34,639
公投第１５案,彰化縣,大村鄉,擺塘村,592,1238,175,463,638,26,664
公投第１５案,彰化縣,大村鄉,擺塘村,593,1259,203,478,681,46,727
公投第１５案,彰化縣,大村鄉,過溝村,594,1412,253,519,772,49,821
公投第１５案,彰化縣,大村鄉,過溝村,595,1401,255,520,775,25,800
公投第１５案,彰化縣,大村鄉,村上村,596,1395,231,576,807,38,845
公投第１５案,彰化縣,大村鄉,美港村,597,996,175,391,566,31,597
公投第１５案,彰化縣,大村鄉,美港村,598,1047,181,405,586,26,612
公投第１５案,彰化縣,大村鄉,美港村,599,985,157,411,568,28,596
公投第１５案,彰化縣,大村鄉,黃厝村,600,1054,185,429,614,45,659
公投第１５案,彰化縣,大村鄉,黃厝村,601,1200,183,495,678,30,708
公投第１５案,彰化縣,大村鄉,福興村,602,1003,168,392,560,58,618
公投第１５案,彰化縣,大村鄉,福興村,603,1046,175,357,532,42,574
公投第１５案,彰化縣,大村鄉,平和村,604,1189,215,457,672,37,709
公投第１５案,彰化縣,大村鄉,平和村,605,1305,186,477,663,46,709
公投第１５案,彰化縣,永靖鄉,浮圳村,606,1255,173,433,606,58,664
公投第１５案,彰化縣,永靖鄉,東寧村,607,889,136,370,506,45,551
公投第１５案,彰化縣,永靖鄉,東寧村,608,1026,158,397,555,24,579
公投第１５案,彰化縣,永靖鄉,光雲村,609,724,119,289,408,42,450
公投第１５案,彰化縣,永靖鄉,光雲村,610,924,407,107,514,39,553
公投第１５案,彰化縣,永靖鄉,五汴村,611,659,132,260,392,28,420
公投第１５案,彰化縣,永靖鄉,五汴村,612,734,154,258,412,23,435
公投第１５案,彰化縣,永靖鄉,永興村,613,758,109,252,361,10,371
公投第１５案,彰化縣,永靖鄉,永興村,614,848,137,388,525,37,562
公投第１５案,彰化縣,永靖鄉,崙子村,615,1404,206,478,684,66,750
公投第１５案,彰化縣,永靖鄉,永東村,616,792,176,336,512,34,546
公投第１５案,彰化縣,永靖鄉,永西村,617,695,164,254,418,29,447
公投第１５案,彰化縣,永靖鄉,永西村,618,821,128,355,483,27,510
公投第１５案,彰化縣,永靖鄉,永南村,619,1064,196,431,627,43,670
公投第１５案,彰化縣,永靖鄉,永南村,620,840,163,297,460,29,489
公投第１５案,彰化縣,永靖鄉,永北村,621,1079,205,435,640,26,666
公投第１５案,彰化縣,永靖鄉,永北村,622,1048,214,395,609,45,654
公投第１５案,彰化縣,永靖鄉,港西村,623,960,167,414,581,34,615
公投第１５案,彰化縣,永靖鄉,港西村,624,798,164,298,462,27,489
公投第１５案,彰化縣,永靖鄉,五福村,625,796,145,334,479,50,529
公投第１５案,彰化縣,永靖鄉,五福村,626,662,113,245,358,28,386
公投第１５案,彰化縣,永靖鄉,湳港村,627,1040,173,402,575,33,608
公投第１５案,彰化縣,永靖鄉,新莊村,628,1025,158,393,551,36,587
公投第１５案,彰化縣,永靖鄉,瑚璉村,629,1357,236,600,836,40,876
公投第１５案,彰化縣,永靖鄉,瑚璉村,630,1236,208,496,704,49,753
公投第１５案,彰化縣,永靖鄉,獨鰲村,631,871,148,334,482,42,524
公投第１５案,彰化縣,永靖鄉,敦厚村,632,706,97,226,323,33,356
公投第１５案,彰化縣,永靖鄉,崙美村,633,770,137,330,467,33,500
公投第１５案,彰化縣,永靖鄉,同安村,634,669,181,242,423,18,441
公投第１５案,彰化縣,永靖鄉,同仁村,635,862,176,303,479,20,499
公投第１５案,彰化縣,永靖鄉,湳墘村,636,847,120,333,453,22,475
公投第１５案,彰化縣,永靖鄉,四芳村,637,668,116,269,385,43,428
公投第１５案,彰化縣,永靖鄉,福興村,638,1073,140,402,542,27,569
公投第１５案,彰化縣,永靖鄉,竹子村,639,1339,195,425,620,52,672
公投第１５案,彰化縣,溪湖鎮,光平里,640,1221,209,428,637,41,678
公投第１５案,彰化縣,溪湖鎮,平和里,641,638,124,261,385,24,409
公投第１５案,彰化縣,溪湖鎮,太平里,642,817,134,314,448,37,485
公投第１５案,彰化縣,溪湖鎮,太平里,643,968,160,398,558,27,585
公投第１５案,彰化縣,溪湖鎮,光華里,644,448,97,188,285,10,295
公投第１５案,彰化縣,溪湖鎮,湖東里,645,1123,157,440,597,18,615
公投第１５案,彰化縣,溪湖鎮,湖東里,646,1166,183,438,621,39,660
公投第１５案,彰化縣,溪湖鎮,湖東里,647,1151,176,437,613,26,639
公投第１５案,彰化縣,溪湖鎮,湖東里,648,1249,216,488,704,18,722
公投第１５案,彰化縣,溪湖鎮,中山里,649,1146,188,445,633,42,675
公投第１５案,彰化縣,溪湖鎮,中山里,650,1199,182,481,663,49,712
公投第１５案,彰化縣,溪湖鎮,西溪里,651,895,158,320,478,44,522
公投第１５案,彰化縣,溪湖鎮,西溪里,652,964,154,395,549,27,576
公投第１５案,彰化縣,溪湖鎮,中竹里,653,851,175,295,470,28,498
公投第１５案,彰化縣,溪湖鎮,東寮里,654,1072,170,418,588,25,613
公投第１５案,彰化縣,溪湖鎮,東寮里,655,1113,459,168,627,41,668
公投第１５案,彰化縣,溪湖鎮,東寮里,656,1090,199,417,616,36,652
公投第１５案,彰化縣,溪湖鎮,西寮里,657,1193,186,502,688,32,720
公投第１５案,彰化縣,溪湖鎮,西寮里,658,952,136,418,554,39,593
公投第１５案,彰化縣,溪湖鎮,大突里,659,1172,184,452,636,41,677
公投第１５案,彰化縣,溪湖鎮,大突里,660,1027,194,366,560,32,592
公投第１５案,彰化縣,溪湖鎮,大突里,661,1188,211,498,709,37,746
公投第１５案,彰化縣,溪湖鎮,北勢里,662,1403,221,488,709,49,758
公投第１５案,彰化縣,溪湖鎮,汴頭里,663,1397,190,448,638,60,698
公投第１５案,彰化縣,溪湖鎮,汴頭里,664,1636,289,603,892,44,936
公投第１５案,彰化縣,溪湖鎮,大竹里,665,1298,215,506,721,55,776
公投第１５案,彰化縣,溪湖鎮,大竹里,666,1214,177,485,662,53,715
公投第１５案,彰化縣,溪湖鎮,湖西里,667,1297,233,503,736,40,776
公投第１５案,彰化縣,溪湖鎮,湖西里,668,968,177,399,576,29,605
公投第１５案,彰化縣,溪湖鎮,田中里,669,839,152,324,476,30,506
公投第１５案,彰化縣,溪湖鎮,河東里,670,907,163,346,509,43,552
公投第１５案,彰化縣,溪湖鎮,河東里,671,898,135,325,460,17,477
公投第１５案,彰化縣,溪湖鎮,頂庄里,672,650,121,300,421,28,449
公投第１５案,彰化縣,溪湖鎮,忠覺里,673,1279,179,499,678,59,737
公投第１５案,彰化縣,溪湖鎮,湳底里,674,730,125,311,436,34,470
公投第１５案,彰化縣,溪湖鎮,大庭里,675,1407,209,567,776,42,818
公投第１５案,彰化縣,溪湖鎮,媽厝里,676,1273,177,412,589,58,647
公投第１５案,彰化縣,溪湖鎮,番婆里,677,988,151,366,517,25,542
公投第１５案,彰化縣,溪湖鎮,番婆里,678,754,142,305,447,34,481
公投第１５案,彰化縣,溪湖鎮,西勢里,679,1052,132,351,483,44,527
公投第１５案,彰化縣,溪湖鎮,西勢里,680,1149,175,408,583,37,620
公投第１５案,彰化縣,溪湖鎮,東溪里,681,1365,280,510,790,73,863
公投第１５案,彰化縣,埔鹽鄉,埔鹽村,682,958,137,419,556,37,593
公投第１５案,彰化縣,埔鹽鄉,埔鹽村,683,754,120,348,468,26,494
公投第１５案,彰化縣,埔鹽鄉,埔南村,684,757,146,331,477,24,501
公投第１５案,彰化縣,埔鹽鄉,埔南村,685,806,130,345,475,30,505
公投第１５案,彰化縣,埔鹽鄉,廍子村,686,1280,192,539,731,39,770
公投第１５案,彰化縣,埔鹽鄉,出水村,687,928,131,392,523,30,553
公投第１５案,彰化縣,埔鹽鄉,南港村,688,895,166,383,549,44,593
公投第１５案,彰化縣,埔鹽鄉,南港村,689,815,127,356,483,44,527
公投第１５案,彰化縣,埔鹽鄉,打廉村,690,957,156,376,532,28,560
公投第１５案,彰化縣,埔鹽鄉,豐澤村,691,1338,171,540,711,82,793
公投第１５案,彰化縣,埔鹽鄉,崑崙村,692,1106,165,429,594,46,640
公投第１５案,彰化縣,埔鹽鄉,角樹村,693,690,130,315,445,30,475
公投第１５案,彰化縣,埔鹽鄉,瓦磘村,694,1230,182,490,672,34,706
公投第１５案,彰化縣,埔鹽鄉,好修村,695,847,149,329,478,24,502
公投第１５案,彰化縣,埔鹽鄉,好修村,696,897,151,386,537,26,563
公投第１５案,彰化縣,埔鹽鄉,西湖村,697,882,149,337,486,46,532
公投第１５案,彰化縣,埔鹽鄉,西湖村,698,1180,166,505,671,44,715
公投第１５案,彰化縣,埔鹽鄉,大有村,699,1215,209,425,634,71,705
公投第１５案,彰化縣,埔鹽鄉,新興村,700,422,53,210,263,18,281
公投第１５案,彰化縣,埔鹽鄉,永平村,701,1106,146,428,574,45,619
公投第１５案,彰化縣,埔鹽鄉,永樂村,702,874,123,398,521,48,569
公投第１５案,彰化縣,埔鹽鄉,石埤村,703,1445,236,540,776,99,875
公投第１５案,彰化縣,埔鹽鄉,天盛村,704,875,100,390,490,46,536
公投第１５案,彰化縣,埔鹽鄉,太平村,705,837,109,302,411,37,448
公投第１５案,彰化縣,埔鹽鄉,太平村,706,685,92,288,380,32,412
公投第１５案,彰化縣,埔鹽鄉,新水村,707,733,137,302,439,31,470
公投第１５案,彰化縣,埔鹽鄉,新水村,708,798,121,335,456,43,499
公投第１５案,彰化縣,埔鹽鄉,三省村,709,1381,200,545,745,46,791
公投第１５案,彰化縣,埔鹽鄉,南新村,710,1335,178,495,673,41,714
公投第１５案,彰化縣,埔心鄉,東門村,711,1139,187,467,654,59,713
公投第１５案,彰化縣,埔心鄉,東門村,712,1217,168,500,668,48,716
公投第１５案,彰化縣,埔心鄉,東門村,713,1248,225,511,736,36,772
公投第１５案,彰化縣,埔心鄉,埔心村,714,1248,326,412,738,63,801
公投第１５案,彰化縣,埔心鄉,義民村,715,916,165,366,531,36,567
公投第１５案,彰化縣,埔心鄉,義民村,716,625,141,249,390,20,410
公投第１５案,彰化縣,埔心鄉,油車村,717,1271,204,465,669,63,732
公投第１５案,彰化縣,埔心鄉,瓦北村,718,608,91,270,361,31,392
公投第１５案,彰化縣,埔心鄉,瓦北村,719,1132,196,467,663,67,730
公投第１５案,彰化縣,埔心鄉,瓦中村,720,1027,173,425,598,46,644
公投第１５案,彰化縣,埔心鄉,瓦中村,721,926,158,386,544,43,587
公投第１５案,彰化縣,埔心鄉,瓦南村,722,778,140,290,430,52,482
公投第１５案,彰化縣,埔心鄉,瓦南村,723,660,104,298,402,31,433
公投第１５案,彰化縣,埔心鄉,經口村,724,1330,226,554,780,42,822
公投第１５案,彰化縣,埔心鄉,經口村,725,991,192,381,573,20,593
公投第１５案,彰化縣,埔心鄉,太平村,726,985,183,445,628,31,659
公投第１５案,彰化縣,埔心鄉,太平村,727,1034,192,367,559,32,591
公投第１５案,彰化縣,埔心鄉,大華村,728,612,107,248,355,43,398
公投第１５案,彰化縣,埔心鄉,仁里村,729,1236,209,526,735,60,795
公投第１５案,彰化縣,埔心鄉,舊舘村,730,775,132,322,454,40,494
公投第１５案,彰化縣,埔心鄉,舊舘村,731,738,137,327,464,30,494
公投第１５案,彰化縣,埔心鄉,南舘村,732,1036,219,384,603,37,640
公投第１５案,彰化縣,埔心鄉,新舘村,733,975,167,341,508,54,562
公投第１５案,彰化縣,埔心鄉,芎蕉村,734,885,146,352,498,43,541
公投第１５案,彰化縣,埔心鄉,芎蕉村,735,939,171,376,547,45,592
公投第１５案,彰化縣,埔心鄉,羅厝村,736,689,107,296,403,24,427
公投第１５案,彰化縣,埔心鄉,羅厝村,737,659,108,274,382,27,409
公投第１５案,彰化縣,埔心鄉,梧鳳村,738,910,147,319,466,32,498
公投第１５案,彰化縣,埔心鄉,二重村,739,1352,261,574,835,57,892
公投第１５案,彰化縣,埔心鄉,埤霞村,740,759,135,277,412,36,448
公投第１５案,彰化縣,埔心鄉,埤脚村,741,942,165,358,523,46,569
公投第１５案,彰化縣,田中鎮,香山里,742,854,128,297,425,55,480
公投第１５案,彰化縣,田中鎮,碧峰里,743,963,132,321,453,39,492
公投第１５案,彰化縣,田中鎮,碧峰里,744,175,11,31,42,3,45
公投第１５案,彰化縣,田中鎮,東源里,745,739,101,259,360,34,394
公投第１５案,彰化縣,田中鎮,復興里,746,826,119,302,421,25,446
公投第１５案,彰化縣,田中鎮,復興里,747,741,300,116,416,31,447
公投第１５案,彰化縣,田中鎮,平和里,748,506,67,166,233,9,242
公投第１５案,彰化縣,田中鎮,平和里,749,1001,146,330,476,49,525
公投第１５案,彰化縣,田中鎮,頂潭里,750,1281,188,492,680,65,745
公投第１５案,彰化縣,田中鎮,新庄里,751,1035,162,388,550,43,593
公投第１５案,彰化縣,田中鎮,新庄里,752,1327,261,480,741,41,782
公投第１５案,彰化縣,田中鎮,中潭里,753,844,146,346,492,30,522
公投第１５案,彰化縣,田中鎮,中潭里,754,913,132,368,500,35,535
公投第１５案,彰化縣,田中鎮,龍潭里,755,613,84,287,371,35,406
公投第１５案,彰化縣,田中鎮,北路里,756,1382,218,550,768,45,813
公投第１５案,彰化縣,田中鎮,北路里,757,1034,177,459,636,37,673
公投第１５案,彰化縣,田中鎮,北路里,758,935,162,418,580,37,617
公投第１５案,彰化縣,田中鎮,西路里,759,1301,216,397,613,40,653
公投第１５案,彰化縣,田中鎮,西路里,760,1100,174,458,632,33,665
公投第１５案,彰化縣,田中鎮,東路里,761,1071,204,413,617,35,652
公投第１５案,彰化縣,田中鎮,南路里,762,1163,200,494,694,39,733
公投第１５案,彰化縣,田中鎮,中路里,763,809,139,357,496,39,535
公投第１５案,彰化縣,田中鎮,中路里,764,1155,197,468,665,47,712
公投第１５案,彰化縣,田中鎮,梅州里,765,1270,209,470,679,57,736
公投第１５案,彰化縣,田中鎮,三安里,766,870,140,322,462,27,489
公投第１５案,彰化縣,田中鎮,三安里,767,736,112,263,375,51,426
公投第１５案,彰化縣,田中鎮,大崙里,768,1335,191,465,656,42,698
公投第１５案,彰化縣,田中鎮,沙崙里,769,876,131,339,470,33,503
公投第１５案,彰化縣,田中鎮,沙崙里,770,898,144,302,446,49,495
公投第１５案,彰化縣,田中鎮,新民里,771,1298,230,510,740,21,761
公投第１５案,彰化縣,田中鎮,新民里,772,1451,214,528,742,66,808
公投第１５案,彰化縣,田中鎮,新民里,773,1475,233,557,790,48,838
公投第１５案,彰化縣,田中鎮,三民里,774,766,108,259,367,35,402
公投第１５案,彰化縣,田中鎮,三民里,775,810,97,324,421,22,443
公投第１５案,彰化縣,田中鎮,三光里,776,953,166,352,518,49,567
公投第１５案,彰化縣,田中鎮,大社里,777,885,139,357,496,59,555
公投第１５案,彰化縣,社頭鄉,社頭村,778,791,144,292,436,31,467
公投第１５案,彰化縣,社頭鄉,社頭村,779,984,170,355,525,33,558
公投第１５案,彰化縣,社頭鄉,社頭村,780,990,153,358,511,24,535
公投第１５案,彰化縣,社頭鄉,廣興村,781,1016,180,420,600,32,632
公投第１５案,彰化縣,社頭鄉,廣興村,782,1091,188,432,620,39,659
公投第１５案,彰化縣,社頭鄉,廣興村,783,1236,226,463,689,54,743
公投第１５案,彰化縣,社頭鄉,廣興村,784,1203,196,447,643,29,672
公投第１５案,彰化縣,社頭鄉,東興村,785,753,124,274,398,29,427
公投第１５案,彰化縣,社頭鄉,東興村,786,725,100,254,354,32,386
公投第１５案,彰化縣,社頭鄉,松竹村,787,1023,176,396,572,52,624
公投第１５案,彰化縣,社頭鄉,舊社村,788,562,125,231,356,28,384
公投第１５案,彰化縣,社頭鄉,舊社村,789,1049,166,391,557,30,587
公投第１５案,彰化縣,社頭鄉,廣福村,790,933,141,394,535,25,560
公投第１５案,彰化縣,社頭鄉,橋頭村,791,990,178,381,559,46,605
公投第１５案,彰化縣,社頭鄉,橋頭村,792,1076,161,389,550,33,583
公投第１５案,彰化縣,社頭鄉,新厝村,793,742,135,305,440,14,454
公投第１５案,彰化縣,社頭鄉,新厝村,794,672,99,257,356,20,376
公投第１５案,彰化縣,社頭鄉,張厝村,795,1235,150,444,594,34,628
公投第１５案,彰化縣,社頭鄉,湳底村,796,750,142,276,418,35,453
公投第１５案,彰化縣,社頭鄉,湳底村,797,895,137,317,454,33,487
公投第１５案,彰化縣,社頭鄉,仁雅村,798,688,104,282,386,18,404
公投第１５案,彰化縣,社頭鄉,仁雅村,799,870,114,348,462,28,490
公投第１５案,彰化縣,社頭鄉,仁雅村,800,1140,203,451,654,27,681
公投第１５案,彰化縣,社頭鄉,里仁村,801,985,160,383,543,38,581
公投第１５案,彰化縣,社頭鄉,美雅村,802,1266,214,530,744,46,790
公投第１５案,彰化縣,社頭鄉,崙雅村,803,937,148,384,532,23,555
公投第１５案,彰化縣,社頭鄉,清水村,804,1219,182,476,658,32,690
公投第１５案,彰化縣,社頭鄉,山湖村,805,1165,198,433,631,43,674
公投第１５案,彰化縣,社頭鄉,埤斗村,806,986,169,380,549,41,590
公投第１５案,彰化縣,社頭鄉,仁和村,807,724,138,303,441,18,459
公投第１５案,彰化縣,社頭鄉,平和村,808,1015,140,419,559,32,591
公投第１５案,彰化縣,社頭鄉,協和村,809,1116,154,386,540,32,572
公投第１５案,彰化縣,社頭鄉,協和村,810,1061,155,385,540,32,572
公投第１５案,彰化縣,社頭鄉,泰安村,811,992,172,387,559,40,599
公投第１５案,彰化縣,社頭鄉,朝興村,812,1092,177,419,596,21,617
公投第１５案,彰化縣,社頭鄉,龍井村,813,828,144,330,474,36,510
公投第１５案,彰化縣,社頭鄉,湳雅村,814,787,134,244,378,46,424
公投第１５案,彰化縣,社頭鄉,湳雅村,815,719,111,233,344,18,362
公投第１５案,彰化縣,二水鄉,復興村,816,1028,164,384,548,60,608
公投第１５案,彰化縣,二水鄉,十五村,817,689,102,274,376,57,433
公投第１５案,彰化縣,二水鄉,合和村,818,871,119,300,419,54,473
公投第１５案,彰化縣,二水鄉,上豊村,819,953,136,379,515,50,565
公投第１５案,彰化縣,二水鄉,過圳村,820,624,82,221,303,38,341
公投第１５案,彰化縣,二水鄉,五伯村,821,645,140,251,391,39,430
公投第１５案,彰化縣,二水鄉,文化村,822,986,160,501,661,37,698
公投第１５案,彰化縣,二水鄉,光化村,823,943,193,383,576,48,624
公投第１５案,彰化縣,二水鄉,聖化村,824,455,80,196,276,9,285
公投第１５案,彰化縣,二水鄉,二水村,825,831,160,367,527,33,560
公投第１５案,彰化縣,二水鄉,惠民村,826,831,140,341,481,36,517
公投第１５案,彰化縣,二水鄉,裕民村,827,1013,143,398,541,31,572
公投第１５案,彰化縣,二水鄉,大園村,828,796,115,328,443,62,505
公投第１５案,彰化縣,二水鄉,修仁村,829,781,119,285,404,46,450
公投第１５案,彰化縣,二水鄉,合興村,830,692,107,230,337,20,357
公投第１５案,彰化縣,二水鄉,源泉村,831,635,104,246,350,23,373
公投第１５案,彰化縣,二水鄉,倡和村,832,566,88,211,299,29,328
公投第１５案,彰化縣,北斗鎮,中寮里,833,925,134,336,470,52,522
公投第１５案,彰化縣,北斗鎮,中寮里,834,869,156,327,483,46,529
公投第１５案,彰化縣,北斗鎮,中寮里,835,855,152,365,517,33,550
公投第１５案,彰化縣,北斗鎮,大道里,836,1065,198,443,641,33,674
公投第１５案,彰化縣,北斗鎮,大道里,837,828,127,331,458,48,506
公投第１５案,彰化縣,北斗鎮,西德里,838,1124,187,444,631,42,673
公投第１５案,彰化縣,北斗鎮,西德里,839,1096,206,427,633,41,674
公投第１５案,彰化縣,北斗鎮,西德里,840,1213,195,484,679,36,715
公投第１５案,彰化縣,北斗鎮,西德里,841,1164,167,423,590,57,647
公投第１５案,彰化縣,北斗鎮,西安里,842,730,117,272,389,24,413
公投第１５案,彰化縣,北斗鎮,西安里,843,878,424,44,468,24,492
公投第１５案,彰化縣,北斗鎮,光復里,844,833,126,351,477,34,511
公投第１５案,彰化縣,北斗鎮,光復里,845,957,173,370,543,26,569
公投第１５案,彰化縣,北斗鎮,新政里,846,783,115,281,396,27,423
公投第１５案,彰化縣,北斗鎮,重慶里,847,573,93,189,282,37,319
公投第１５案,彰化縣,北斗鎮,五權里,848,672,131,239,370,18,388
公投第１５案,彰化縣,北斗鎮,七星里,849,695,133,216,349,33,382
公投第１５案,彰化縣,北斗鎮,七星里,850,747,109,264,373,28,401
公投第１５案,彰化縣,北斗鎮,居仁里,851,643,116,280,396,17,413
公投第１５案,彰化縣,北斗鎮,居仁里,852,662,102,264,366,35,401
公投第１５案,彰化縣,北斗鎮,東光里,853,1085,190,449,639,50,689
公投第１５案,彰化縣,北斗鎮,東光里,854,1121,196,427,623,50,673
公投第１５案,彰化縣,北斗鎮,文昌里,855,830,139,339,478,32,510
公投第１５案,彰化縣,北斗鎮,文昌里,856,975,146,375,521,23,544
公投第１５案,彰化縣,北斗鎮,文昌里,857,1212,210,426,636,26,662
公投第１５案,彰化縣,北斗鎮,中和里,858,1302,223,508,731,49,780
公投第１５案,彰化縣,北斗鎮,新生里,859,1077,151,352,503,36,539
公投第１５案,彰化縣,北斗鎮,新生里,860,917,135,324,459,49,508
公投第１５案,彰化縣,北斗鎮,大新里,861,825,135,305,440,26,466
公投第１５案,彰化縣,北斗鎮,大新里,862,937,157,363,520,38,558
公投第１５案,彰化縣,田尾鄉,田尾村,863,1284,202,430,632,40,672
公投第１５案,彰化縣,田尾鄉,溪畔村,864,1187,177,499,676,49,725
公投第１５案,彰化縣,田尾鄉,打簾村,865,1033,167,422,589,34,623
公投第１５案,彰化縣,田尾鄉,打簾村,866,696,97,297,394,33,427
公投第１５案,彰化縣,田尾鄉,正義村,867,872,148,367,515,29,544
公投第１５案,彰化縣,田尾鄉,北曾村,868,680,107,247,354,15,369
公投第１５案,彰化縣,田尾鄉,北曾村,869,875,173,353,526,31,557
公投第１５案,彰化縣,田尾鄉,南曾村,870,1337,222,477,699,33,732
公投第１５案,彰化縣,田尾鄉,饒平村,871,1376,260,529,789,52,841
公投第１５案,彰化縣,田尾鄉,饒平村,872,1186,190,498,688,49,737
公投第１５案,彰化縣,田尾鄉,豐田村,873,874,154,417,571,36,607
公投第１５案,彰化縣,田尾鄉,仁里村,874,647,101,239,340,27,367
公投第１５案,彰化縣,田尾鄉,仁里村,875,959,127,425,552,21,573
公投第１５案,彰化縣,田尾鄉,新厝村,876,263,32,102,134,10,144
公投第１５案,彰化縣,田尾鄉,溪頂村,877,618,87,223,310,26,336
公投第１５案,彰化縣,田尾鄉,柳鳳村,878,938,199,375,574,20,594
公投第１５案,彰化縣,田尾鄉,陸豐村,879,880,154,360,514,49,563
公投第１５案,彰化縣,田尾鄉,海豐村,880,804,125,281,406,28,434
公投第１５案,彰化縣,田尾鄉,海豐村,881,592,115,194,309,21,330
公投第１５案,彰化縣,田尾鄉,睦宜村,882,1079,186,444,630,56,686
公投第１５案,彰化縣,田尾鄉,新生村,883,1336,230,501,731,49,780
公投第１５案,彰化縣,田尾鄉,北鎮村,884,1198,186,418,604,46,650
公投第１５案,彰化縣,田尾鄉,南鎮村,885,621,98,208,306,48,354
公投第１５案,彰化縣,田尾鄉,福田村,886,760,124,259,383,28,411
公投第１５案,彰化縣,田尾鄉,新興村,887,1084,206,432,638,63,701
公投第１５案,彰化縣,埤頭鄉,和豊村,888,1178,181,349,530,56,586
公投第１５案,彰化縣,埤頭鄉,和豊村,889,1290,182,468,650,47,697
公投第１５案,彰化縣,埤頭鄉,興農村,890,973,147,353,500,44,544
公投第１５案,彰化縣,埤頭鄉,興農村,891,783,112,277,389,29,418
公投第１５案,彰化縣,埤頭鄉,埤頭村,892,733,116,251,367,46,413
公投第１５案,彰化縣,埤頭鄉,埤頭村,893,899,156,303,459,69,528
公投第１５案,彰化縣,埤頭鄉,豊崙村,894,965,138,355,493,54,547
公投第１５案,彰化縣,埤頭鄉,豊崙村,895,1356,182,478,660,54,714
公投第１５案,彰化縣,埤頭鄉,崙子村,896,1265,206,430,636,54,690
公投第１５案,彰化縣,埤頭鄉,永豊村,897,877,153,341,494,47,541
公投第１５案,彰化縣,埤頭鄉,永豊村,898,705,118,227,345,37,382
公投第１５案,彰化縣,埤頭鄉,合興村,899,1062,170,443,613,32,645
公投第１５案,彰化縣,埤頭鄉,合興村,900,1300,206,508,714,28,742
公投第１５案,彰化縣,埤頭鄉,合興村,901,923,119,368,487,56,543
公投第１５案,彰化縣,埤頭鄉,平原村,902,1085,57,375,432,30,462
公投第１５案,彰化縣,埤頭鄉,平原村,903,1103,171,436,607,47,654
公投第１５案,彰化縣,埤頭鄉,崙腳村,904,735,98,252,350,31,381
公投第１５案,彰化縣,埤頭鄉,元埔村,905,574,98,177,275,41,316
公投第１５案,彰化縣,埤頭鄉,芙朝村,906,767,70,271,341,45,386
公投第１５案,彰化縣,埤頭鄉,芙朝村,907,737,98,275,373,37,410
公投第１５案,彰化縣,埤頭鄉,新庄村,908,1058,162,305,467,48,515
公投第１５案,彰化縣,埤頭鄉,陸嘉村,909,826,103,254,357,68,425
公投第１５案,彰化縣,埤頭鄉,竹圍村,910,1082,140,328,468,76,544
公投第１５案,彰化縣,埤頭鄉,中和村,911,737,285,112,397,49,446
公投第１５案,彰化縣,埤頭鄉,中和村,912,711,85,270,355,20,375
公投第１５案,彰化縣,埤頭鄉,庄內村,913,1043,194,343,537,53,590
公投第１５案,彰化縣,埤頭鄉,大湖村,914,910,124,316,440,23,463
公投第１５案,彰化縣,溪州鄉,溪厝村,915,778,115,281,396,35,431
公投第１５案,彰化縣,溪州鄉,溪厝村,916,1061,150,356,506,24,530
公投第１５案,彰化縣,溪州鄉,坑厝村,917,701,80,225,305,31,336
公投第１５案,彰化縣,溪州鄉,瓦厝村,918,879,151,346,497,38,535
公投第１５案,彰化縣,溪州鄉,溪州村,919,654,280,112,392,37,429
公投第１５案,彰化縣,溪州鄉,溪州村,920,878,132,338,470,35,505
公投第１５案,彰化縣,溪州鄉,尾厝村,921,942,141,402,543,42,585
公投第１５案,彰化縣,溪州鄉,尾厝村,922,871,152,303,455,29,484
公投第１５案,彰化縣,溪州鄉,東州村,923,1047,154,361,515,19,534
公投第１５案,彰化縣,溪州鄉,東州村,924,858,143,321,464,43,507
公投第１５案,彰化縣,溪州鄉,舊眉村,925,1409,175,410,585,65,650
公投第１５案,彰化縣,溪州鄉,圳寮村,926,792,111,288,399,19,418
公投第１５案,彰化縣,溪州鄉,圳寮村,927,714,110,234,344,43,387
公投第１５案,彰化縣,溪州鄉,西畔村,928,1109,121,362,483,57,540
公投第１５案,彰化縣,溪州鄉,西畔村,929,962,124,272,396,47,443
公投第１５案,彰化縣,溪州鄉,柑園村,930,1157,151,325,476,55,531
公投第１５案,彰化縣,溪州鄉,成功村,931,952,140,306,446,44,490
公投第１５案,彰化縣,溪州鄉,成功村,932,887,148,289,437,39,476
公投第１５案,彰化縣,溪州鄉,大庄村,933,866,109,224,333,47,380
公投第１５案,彰化縣,溪州鄉,大庄村,934,1010,119,315,434,56,490
公投第１５案,彰化縣,溪州鄉,榮光村,935,853,130,274,404,21,425
公投第１５案,彰化縣,溪州鄉,潮洋村,936,843,121,262,383,61,444
公投第１５案,彰化縣,溪州鄉,張厝村,937,711,83,176,259,9,268
公投第１５案,彰化縣,溪州鄉,菜公村,938,851,139,267,406,63,469
公投第１５案,彰化縣,溪州鄉,三條村,939,883,116,287,403,29,432
公投第１５案,彰化縣,溪州鄉,三圳村,940,1247,130,427,557,50,607
公投第１５案,彰化縣,溪州鄉,水尾村,941,1490,250,517,767,60,827
公投第１５案,彰化縣,二林鎮,豐田里,942,731,84,211,295,22,317
公投第１５案,彰化縣,二林鎮,豐田里,943,1025,146,405,551,39,590
公投第１５案,彰化縣,二林鎮,豐田里,944,784,130,299,429,24,453
公投第１５案,彰化縣,二林鎮,東和里,945,892,154,333,487,32,519
公投第１５案,彰化縣,二林鎮,東和里,946,1256,223,452,675,45,720
公投第１５案,彰化縣,二林鎮,南光里,947,1043,146,386,532,41,573
公投第１５案,彰化縣,二林鎮,南光里,948,1076,196,422,618,32,650
公投第１５案,彰化縣,二林鎮,南光里,949,1082,164,436,600,36,636
公投第１５案,彰化縣,二林鎮,西平里,950,1427,324,399,723,52,775
公投第１５案,彰化縣,二林鎮,北平里,951,1030,152,327,479,48,527
公投第１５案,彰化縣,二林鎮,北平里,952,1033,160,336,496,46,542
公投第１５案,彰化縣,二林鎮,北平里,953,977,161,344,505,40,545
公投第１５案,彰化縣,二林鎮,中西里,954,683,91,244,335,17,352
公投第１５案,彰化縣,二林鎮,中西里,955,975,108,329,437,75,512
公投第１５案,彰化縣,二林鎮,廣興里,956,1336,423,109,532,64,596
公投第１５案,彰化縣,二林鎮,香田里,957,1019,113,316,429,51,480
公投第１５案,彰化縣,二林鎮,外竹里,958,1003,132,273,405,40,445
公投第１５案,彰化縣,二林鎮,興華里,959,1151,155,450,605,44,649
公投第１５案,彰化縣,二林鎮,東興里,960,1598,251,568,819,90,909
公投第１５案,彰化縣,二林鎮,後厝里,961,1488,211,542,753,46,799
公投第１５案,彰化縣,二林鎮,後厝里,962,1771,303,666,969,48,1017
公投第１５案,彰化縣,二林鎮,頂厝里,963,1360,185,358,543,41,584
公投第１５案,彰化縣,二林鎮,趙甲里,964,1613,166,527,693,61,754
公投第１５案,彰化縣,二林鎮,振興里,965,1228,178,403,581,58,639
公投第１５案,彰化縣,二林鎮,萬興里,966,771,111,307,418,23,441
公投第１５案,彰化縣,二林鎮,永興里,967,858,134,339,473,32,505
公投第１５案,彰化縣,二林鎮,永興里,968,661,74,228,302,0,302
公投第１５案,彰化縣,二林鎮,西庄里,969,1268,164,386,550,83,633
公投第１５案,彰化縣,二林鎮,梅芳里,970,1081,128,388,516,24,540
公投第１５案,彰化縣,二林鎮,華崙里,971,1213,162,404,566,32,598
公投第１５案,彰化縣,二林鎮,華崙里,972,1328,197,506,703,38,741
公投第１５案,彰化縣,二林鎮,華崙里,973,1118,117,347,464,70,534
公投第１５案,彰化縣,二林鎮,萬合里,974,1157,140,352,492,42,534
公投第１５案,彰化縣,二林鎮,東勢里,975,972,118,328,446,33,479
公投第１５案,彰化縣,二林鎮,大永里,976,902,136,316,452,37,489
公投第１５案,彰化縣,二林鎮,原斗里,977,1273,175,582,757,49,806
公投第１５案,彰化縣,二林鎮,西斗里,978,1087,158,385,543,30,573
公投第１５案,彰化縣,二林鎮,東華里,979,987,144,380,524,67,591
公投第１５案,彰化縣,二林鎮,復豐里,980,719,102,210,312,26,338
公投第１５案,彰化縣,大城鄉,山腳村,981,1288,97,332,429,24,453
公投第１５案,彰化縣,大城鄉,潭墘村,982,1104,104,260,364,65,429
公投第１５案,彰化縣,大城鄉,大城村,983,964,131,349,480,57,537
公投第１５案,彰化縣,大城鄉,東城村,984,1312,162,400,562,45,607
公投第１５案,彰化縣,大城鄉,西城村,985,853,83,241,324,43,367
公投第１５案,彰化縣,大城鄉,上山村,986,518,30,141,171,12,183
公投第１５案,彰化縣,大城鄉,上山村,987,574,69,155,224,27,251
公投第１５案,彰化縣,大城鄉,永和村,988,702,55,178,233,37,270
公投第１５案,彰化縣,大城鄉,公館村,989,376,32,76,108,12,120
公投第１５案,彰化縣,大城鄉,公館村,990,693,39,156,195,20,215
公投第１５案,彰化縣,大城鄉,豐美村,991,877,102,247,349,37,386
公投第１５案,彰化縣,大城鄉,三豐村,992,655,47,147,194,15,209
公投第１５案,彰化縣,大城鄉,菜寮村,993,1103,90,307,397,19,416
公投第１５案,彰化縣,大城鄉,東港村,994,1192,117,275,392,24,416
公投第１５案,彰化縣,大城鄉,西港村,995,917,97,235,332,29,361
公投第１５案,彰化縣,大城鄉,頂庄村,996,686,58,147,205,24,229
公投第１５案,彰化縣,大城鄉,臺西村,997,899,68,203,271,25,296
公投第１５案,彰化縣,芳苑鄉,芳苑村,998,940,93,207,300,36,336
公投第１５案,彰化縣,芳苑鄉,芳中村,999,403,32,103,135,27,162
公投第１５案,彰化縣,芳苑鄉,仁愛村,1000,756,103,236,339,36,375
公投第１５案,彰化縣,芳苑鄉,信義村,1001,548,43,110,153,25,178
公投第１５案,彰化縣,芳苑鄉,後寮村,1002,997,121,360,481,41,522
公投第１５案,彰化縣,芳苑鄉,三合村,1003,1300,178,352,530,61,591
公投第１５案,彰化縣,芳苑鄉,三合村,1004,859,123,283,406,37,443
公投第１５案,彰化縣,芳苑鄉,永興村,1005,734,90,251,341,19,360
公投第１５案,彰化縣,芳苑鄉,永興村,1006,636,105,178,283,22,305
公投第１５案,彰化縣,芳苑鄉,新街村,1007,808,94,219,313,60,373
公投第１５案,彰化縣,芳苑鄉,路上村,1008,668,84,169,253,42,295
公投第１５案,彰化縣,芳苑鄉,路平村,1009,744,119,229,348,30,378
公投第１５案,彰化縣,芳苑鄉,三成村,1010,1026,128,294,422,78,500
公投第１５案,彰化縣,芳苑鄉,福榮村,1011,586,57,156,213,12,225
公投第１５案,彰化縣,芳苑鄉,頂廍村,1012,593,86,206,292,22,314
公投第１５案,彰化縣,芳苑鄉,王功村,1013,1071,121,374,495,79,574
公投第１５案,彰化縣,芳苑鄉,王功村,1014,1060,141,265,406,55,461
公投第１５案,彰化縣,芳苑鄉,博愛村,1015,708,78,260,338,21,359
公投第１５案,彰化縣,芳苑鄉,和平村,1016,735,87,225,312,49,361
公投第１５案,彰化縣,芳苑鄉,興仁村,1017,571,80,210,290,45,335
公投第１５案,彰化縣,芳苑鄉,興仁村,1018,729,84,209,293,26,319
公投第１５案,彰化縣,芳苑鄉,民生村,1019,674,95,209,304,48,352
公投第１５案,彰化縣,芳苑鄉,新寶村,1020,846,107,291,398,36,434
公投第１５案,彰化縣,芳苑鄉,新寶村,1021,806,104,324,428,41,469
公投第１５案,彰化縣,芳苑鄉,五俊村,1022,470,51,117,168,13,181
公投第１５案,彰化縣,芳苑鄉,草湖村,1023,1124,126,444,570,42,612
公投第１５案,彰化縣,芳苑鄉,草湖村,1024,317,41,99,140,12,152
公投第１５案,彰化縣,芳苑鄉,建平村,1025,1158,106,334,440,59,499
公投第１５案,彰化縣,芳苑鄉,建平村,1026,967,121,317,438,26,464
公投第１５案,彰化縣,芳苑鄉,崙腳村,1027,762,105,263,368,35,403
公投第１５案,彰化縣,芳苑鄉,文津村,1028,1086,118,320,438,42,480
公投第１５案,彰化縣,芳苑鄉,新生村,1029,747,96,245,341,27,368
公投第１５案,彰化縣,芳苑鄉,新生村,1030,653,68,176,244,22,266
公投第１５案,彰化縣,芳苑鄉,漢寶村,1031,872,117,361,478,36,514
公投第１５案,彰化縣,芳苑鄉,漢寶村,1032,1235,210,490,700,45,745
公投第１５案,彰化縣,芳苑鄉,漢寶村,1033,1102,162,391,553,43,596
公投第１５案,彰化縣,竹塘鄉,竹元村,1034,1168,162,447,609,63,672
公投第１５案,彰化縣,竹塘鄉,竹塘村,1035,965,152,390,542,27,569
公投第１５案,彰化縣,竹塘鄉,竹塘村,1036,960,150,411,561,39,600
公投第１５案,彰化縣,竹塘鄉,小西村,1037,743,120,304,424,57,481
公投第１５案,彰化縣,竹塘鄉,民靖村,1038,751,97,212,309,30,339
公投第１５案,彰化縣,竹塘鄉,五庄村,1039,792,94,241,335,40,375
公投第１５案,彰化縣,竹塘鄉,五庄村,1040,733,102,230,332,16,348
公投第１５案,彰化縣,竹塘鄉,樹腳村,1041,657,93,234,327,29,356
公投第１５案,彰化縣,竹塘鄉,田頭村,1042,1063,130,386,516,34,550
公投第１５案,彰化縣,竹塘鄉,新廣村,1043,1114,169,422,591,47,638
公投第１５案,彰化縣,竹塘鄉,溪墘村,1044,506,93,215,308,33,341
公投第１５案,彰化縣,竹塘鄉,竹林村,1045,823,122,268,390,35,425
公投第１５案,彰化縣,竹塘鄉,土庫村,1046,654,105,207,312,26,338
公投第１５案,彰化縣,竹塘鄉,內新村,1047,577,67,168,235,25,260
公投第１５案,彰化縣,竹塘鄉,長安村,1048,772,111,248,359,49,408
公投第１５案,彰化縣,竹塘鄉,永安村,1049,543,65,156,221,31,252
公投第１５案,南投縣,南投市,龍泉里,1,927,193,343,536,18,554
公投第１５案,南投縣,南投市,康壽里,2,667,131,299,430,24,454
公投第１５案,南投縣,南投市,康壽里,3,773,149,327,476,29,505
公投第１５案,南投縣,南投市,三民里,4,818,155,333,488,26,514
公投第１５案,南投縣,南投市,仁和里,5,525,117,225,342,15,357
公投第１５案,南投縣,南投市,南投里,6,575,103,261,364,23,387
公投第１５案,南投縣,南投市,彰仁里,7,368,80,165,245,9,254
公投第１５案,南投縣,南投市,崇文里,8,956,155,434,589,43,632
公投第１５案,南投縣,南投市,三興里,9,1245,199,458,657,19,676
公投第１５案,南投縣,南投市,三興里,10,1484,261,576,837,25,862
公投第１５案,南投縣,南投市,三興里,11,1191,213,536,749,35,784
公投第１５案,南投縣,南投市,三興里,12,1506,270,609,879,41,920
公投第１５案,南投縣,南投市,三和里,13,1070,222,427,649,30,679
公投第１５案,南投縣,南投市,三和里,14,670,123,285,408,19,427
公投第１５案,南投縣,南投市,三和里,15,1050,218,435,653,46,699
公投第１５案,南投縣,南投市,嘉興里,16,1122,188,411,599,36,635
公投第１５案,南投縣,南投市,嘉興里,17,984,170,356,526,32,558
公投第１５案,南投縣,南投市,嘉和里,18,1062,213,467,680,28,708
公投第１５案,南投縣,南投市,嘉和里,19,1053,170,436,606,38,644
公投第１５案,南投縣,南投市,嘉和里,20,1104,220,445,665,37,702
公投第１５案,南投縣,南投市,嘉和里,21,1192,223,439,662,32,694
公投第１５案,南投縣,南投市,平和里,22,960,147,378,525,28,553
公投第１５案,南投縣,南投市,平和里,23,906,146,377,523,36,559
公投第１５案,南投縣,南投市,平和里,24,957,188,381,569,28,597
公投第１５案,南投縣,南投市,平和里,25,997,174,437,611,41,652
公投第１５案,南投縣,南投市,平和里,26,1008,182,413,595,34,629
公投第１５案,南投縣,南投市,平和里,27,1164,225,438,663,21,684
公投第１５案,南投縣,南投市,振興里,28,587,87,240,327,21,348
公投第１５案,南投縣,南投市,振興里,29,734,115,269,384,31,415
公投第１５案,南投縣,南投市,振興里,30,724,128,265,393,34,427
公投第１５案,南投縣,南投市,千秋里,31,1003,147,423,570,31,601
公投第１５案,南投縣,南投市,軍功里,32,1356,239,518,757,34,791
公投第１５案,南投縣,南投市,軍功里,33,1373,243,477,720,39,759
公投第１５案,南投縣,南投市,軍功里,34,1452,221,554,775,40,815
公投第１５案,南投縣,南投市,軍功里,35,362,45,159,204,6,210
公投第１５案,南投縣,南投市,東山里,36,389,63,150,213,23,236
公投第１５案,南投縣,南投市,營南里,37,1276,253,535,788,42,830
公投第１５案,南投縣,南投市,營南里,38,1089,217,458,675,34,709
公投第１５案,南投縣,南投市,營北里,39,921,187,366,553,40,593
公投第１５案,南投縣,南投市,營北里,40,892,181,423,604,19,623
公投第１５案,南投縣,南投市,營北里,41,1050,195,471,666,27,693
公投第１５案,南投縣,南投市,營北里,42,1078,190,466,656,20,676
公投第１５案,南投縣,南投市,營北里,43,1078,179,470,649,19,668
公投第１５案,南投縣,南投市,營北里,44,861,193,399,592,31,623
公投第１５案,南投縣,南投市,內興里,45,1221,189,505,694,42,736
公投第１５案,南投縣,南投市,內興里,46,1105,186,449,635,21,656
公投第１５案,南投縣,南投市,內興里,47,1230,206,533,739,18,757
公投第１５案,南投縣,南投市,內興里,48,1092,179,478,657,18,675
公投第１５案,南投縣,南投市,內興里,49,1286,237,565,802,19,821
公投第１５案,南投縣,南投市,內興里,50,655,124,295,419,32,451
公投第１５案,南投縣,南投市,內新里,51,719,125,325,450,25,475
公投第１５案,南投縣,南投市,內新里,52,720,129,288,417,18,435
公投第１５案,南投縣,南投市,光輝里,53,509,82,251,333,13,346
公投第１５案,南投縣,南投市,光榮里,54,492,54,214,268,13,281
公投第１５案,南投縣,南投市,光榮里,55,616,73,291,364,11,375
公投第１５案,南投縣,南投市,光明里,56,1010,149,470,619,21,640
公投第１５案,南投縣,南投市,光華里,57,848,114,373,487,22,509
公投第１５案,南投縣,南投市,漳興里,58,1387,240,601,841,48,889
公投第１５案,南投縣,南投市,漳興里,59,1245,241,539,780,28,808
公投第１５案,南投縣,南投市,漳和里,60,1199,201,483,684,20,704
公投第１５案,南投縣,南投市,漳和里,61,1288,218,546,764,38,802
公投第１５案,南投縣,南投市,漳和里,62,1040,173,415,588,32,620
公投第１５案,南投縣,南投市,漳和里,63,1070,192,439,631,35,666
公投第１５案,南投縣,南投市,漳和里,64,1299,252,538,790,36,826
公投第１５案,南投縣,南投市,漳和里,65,1122,232,461,693,23,716
公投第１５案,南投縣,南投市,平山里,66,1414,240,565,805,33,838
公投第１５案,南投縣,南投市,平山里,67,1121,180,448,628,38,666
公投第１５案,南投縣,南投市,平山里,68,1434,159,551,710,18,728
公投第１５案,南投縣,南投市,平山里,69,1393,192,540,732,41,773
公投第１５案,南投縣,南投市,新興里,70,1059,156,442,598,17,615
公投第１５案,南投縣,南投市,新興里,71,1218,193,495,688,21,709
公投第１５案,南投縣,南投市,新興里,72,1293,224,470,694,23,717
公投第１５案,南投縣,南投市,新興里,73,1337,168,486,654,23,677
公投第１５案,南投縣,南投市,永豐里,74,876,160,371,531,34,565
公投第１５案,南投縣,南投市,永豐里,75,971,150,394,544,20,564
公投第１５案,南投縣,南投市,永豐里,76,1012,173,395,568,27,595
公投第１５案,南投縣,南投市,福興里,77,973,147,372,519,30,549
公投第１５案,南投縣,南投市,福興里,78,1002,185,415,600,26,626
公投第１５案,南投縣,南投市,福興里,79,1024,200,386,586,26,612
公投第１５案,南投縣,南投市,鳳山里,80,1122,171,343,514,78,592
公投第１５案,南投縣,南投市,永興里,81,790,112,257,369,31,400
公投第１５案,南投縣,南投市,鳳鳴里,82,647,79,208,287,13,300
公投第１５案,南投縣,南投市,福山里,83,950,143,346,489,43,532
公投第１５案,南投縣,南投市,福山里,84,980,145,353,498,24,522
公投第１５案,南投縣,埔里鎮,東門里,85,828,141,327,468,34,502
公投第１５案,南投縣,埔里鎮,東門里,86,786,138,320,458,36,494
公投第１５案,南投縣,埔里鎮,東門里,87,1062,145,435,580,33,613
公投第１５案,南投縣,埔里鎮,杷城里,88,1201,206,493,699,48,747
公投第１５案,南投縣,埔里鎮,杷城里,89,1415,200,555,755,31,786
公投第１５案,南投縣,埔里鎮,枇杷里,90,1282,197,503,700,25,725
公投第１５案,南投縣,埔里鎮,枇杷里,91,859,131,334,465,42,507
公投第１５案,南投縣,埔里鎮,枇杷里,92,1288,204,481,685,63,748
公投第１５案,南投縣,埔里鎮,枇杷里,93,1330,234,506,740,23,763
公投第１５案,南投縣,埔里鎮,枇杷里,94,1416,216,509,725,43,768
公投第１５案,南投縣,埔里鎮,枇杷里,95,1283,171,445,616,29,645
公投第１５案,南投縣,埔里鎮,水頭里,96,1151,117,519,636,62,698
公投第１５案,南投縣,埔里鎮,水頭里,97,1193,179,429,608,25,633
公投第１５案,南投縣,埔里鎮,水頭里,98,1471,245,552,797,55,852
公投第１５案,南投縣,埔里鎮,麒麟里,99,1044,122,338,460,73,533
公投第１５案,南投縣,埔里鎮,珠格里,100,1122,171,441,612,54,666
公投第１５案,南投縣,埔里鎮,溪南里,101,1129,176,512,688,39,727
公投第１５案,南投縣,埔里鎮,西門里,102,901,136,355,491,11,502
公投第１５案,南投縣,埔里鎮,西門里,103,997,125,350,475,54,529
公投第１５案,南投縣,埔里鎮,西門里,104,1209,212,438,650,30,680
公投第１５案,南投縣,埔里鎮,南門里,105,838,131,395,526,26,552
公投第１５案,南投縣,埔里鎮,北門里,106,1226,174,405,579,36,615
公投第１５案,南投縣,埔里鎮,北門里,107,1263,232,502,734,58,792
公投第１５案,南投縣,埔里鎮,北安里,108,1045,195,425,620,17,637
公投第１５案,南投縣,埔里鎮,北安里,109,1120,188,465,653,28,681
公投第１５案,南投縣,埔里鎮,北安里,110,1062,200,454,654,39,693
公投第１５案,南投縣,埔里鎮,北梅里,111,1022,168,399,567,32,599
公投第１５案,南投縣,埔里鎮,北梅里,112,1051,167,412,579,18,597
公投第１５案,南投縣,埔里鎮,北梅里,113,1106,178,423,601,26,627
公投第１５案,南投縣,埔里鎮,泰安里,114,1098,172,448,620,18,638
公投第１５案,南投縣,埔里鎮,泰安里,115,1067,164,450,614,27,641
公投第１５案,南投縣,埔里鎮,大湳里,116,725,265,122,387,40,427
公投第１５案,南投縣,埔里鎮,大湳里,117,905,157,357,514,23,537
公投第１５案,南投縣,埔里鎮,蜈蚣里,118,1179,176,418,594,42,636
公投第１５案,南投縣,埔里鎮,蜈蚣里,119,944,109,361,470,28,498
公投第１５案,南投縣,埔里鎮,蜈蚣里,120,465,73,162,235,33,268
公投第１５案,南投縣,埔里鎮,同聲里,121,1133,158,436,594,41,635
公投第１５案,南投縣,埔里鎮,同聲里,122,1100,153,414,567,37,604
公投第１５案,南投縣,埔里鎮,清新里,123,1155,182,445,627,52,679
公投第１５案,南投縣,埔里鎮,清新里,124,1254,202,379,581,41,622
公投第１５案,南投縣,埔里鎮,清新里,125,1296,200,441,641,44,685
公投第１５案,南投縣,埔里鎮,薰化里,126,1023,198,433,631,33,664
公投第１５案,南投縣,埔里鎮,大城里,127,964,102,369,471,20,491
公投第１５案,南投縣,埔里鎮,大城里,128,986,173,380,553,28,581
公投第１５案,南投縣,埔里鎮,大城里,129,1016,163,440,603,15,618
公投第１５案,南投縣,埔里鎮,大城里,130,898,134,371,505,31,536
公投第１５案,南投縣,埔里鎮,大城里,131,980,159,399,558,38,596
公投第１５案,南投縣,埔里鎮,大城里,132,933,145,404,549,15,564
公投第１５案,南投縣,埔里鎮,籃城里,133,929,195,415,610,41,651
公投第１５案,南投縣,埔里鎮,桃米里,134,1032,146,384,530,60,590
公投第１５案,南投縣,埔里鎮,成功里,135,315,37,119,156,9,165
公投第１５案,南投縣,埔里鎮,南村里,136,1363,189,491,680,64,744
公投第１５案,南投縣,埔里鎮,愛蘭里,137,725,130,282,412,29,441
公投第１５案,南投縣,埔里鎮,愛蘭里,138,705,101,310,411,16,427
公投第１５案,南投縣,埔里鎮,鐵山里,139,751,140,325,465,25,490
公投第１５案,南投縣,埔里鎮,鐵山里,140,932,130,374,504,30,534
公投第１５案,南投縣,埔里鎮,房里里,141,956,168,370,538,33,571
公投第１５案,南投縣,埔里鎮,房里里,142,376,50,149,199,15,214
公投第１５案,南投縣,埔里鎮,向善里,143,682,111,265,376,32,408
公投第１５案,南投縣,埔里鎮,一新里,144,990,83,520,603,42,645
公投第１５案,南投縣,埔里鎮,合成里,145,1324,172,500,672,0,672
公投第１５案,南投縣,埔里鎮,合成里,146,298,53,77,130,18,148
公投第１５案,南投縣,埔里鎮,廣成里,147,1170,142,451,593,58,651
公投第１５案,南投縣,埔里鎮,史港里,148,604,103,241,344,17,361
公投第１５案,南投縣,埔里鎮,福興里,149,999,147,373,520,31,551
公投第１５案,南投縣,埔里鎮,牛眠里,150,923,338,129,467,19,486
公投第１５案,南投縣,埔里鎮,牛眠里,151,887,139,365,504,33,537
公投第１５案,南投縣,埔里鎮,牛眠里,152,981,146,363,509,27,536
公投第１５案,南投縣,草屯鎮,玉峰里,153,998,200,399,599,25,624
公投第１５案,南投縣,草屯鎮,玉峰里,154,1127,186,416,602,26,628
公投第１５案,南投縣,草屯鎮,明正里,155,1401,220,509,729,25,754
公投第１５案,南投縣,草屯鎮,明正里,156,1110,184,411,595,28,623
公投第１５案,南投縣,草屯鎮,明正里,157,1285,522,205,727,38,765
公投第１５案,南投縣,草屯鎮,炎峰里,158,936,141,373,514,26,540
公投第１５案,南投縣,草屯鎮,炎峰里,159,1141,215,415,630,41,671
公投第１５案,南投縣,草屯鎮,中正里,160,705,135,285,420,25,445
公投第１５案,南投縣,草屯鎮,和平里,161,1121,211,477,688,12,700
公投第１５案,南投縣,草屯鎮,中山里,162,877,175,389,564,19,583
公投第１５案,南投縣,草屯鎮,中山里,163,1401,230,521,751,40,791
公投第１５案,南投縣,草屯鎮,敦和里,164,1267,186,472,658,38,696
公投第１５案,南投縣,草屯鎮,敦和里,165,1214,202,465,667,55,722
公投第１５案,南投縣,草屯鎮,敦和里,166,1259,210,495,705,47,752
公投第１５案,南投縣,草屯鎮,敦和里,167,1442,292,563,855,15,870
公投第１５案,南投縣,草屯鎮,敦和里,168,1273,212,521,733,30,763
公投第１５案,南投縣,草屯鎮,山腳里,169,1145,191,438,629,29,658
公投第１５案,南投縣,草屯鎮,山腳里,170,1279,202,490,692,21,713
公投第１５案,南投縣,草屯鎮,山腳里,171,1158,183,453,636,20,656
公投第１５案,南投縣,草屯鎮,山腳里,172,1335,247,589,836,37,873
公投第１５案,南投縣,草屯鎮,山腳里,173,1178,251,487,738,25,763
公投第１５案,南投縣,草屯鎮,山腳里,174,1327,264,482,746,36,782
公投第１５案,南投縣,草屯鎮,新厝里,175,1000,183,401,584,19,603
公投第１５案,南投縣,草屯鎮,新厝里,176,1257,202,498,700,24,724
公投第１５案,南投縣,草屯鎮,新厝里,177,883,155,394,549,24,573
公投第１５案,南投縣,草屯鎮,上林里,178,1121,124,479,603,23,626
公投第１５案,南投縣,草屯鎮,上林里,179,1043,177,417,594,26,620
公投第１５案,南投縣,草屯鎮,上林里,180,979,186,405,591,14,605
公投第１５案,南投縣,草屯鎮,碧峰里,181,1048,178,346,524,20,544
公投第１５案,南投縣,草屯鎮,碧峰里,182,1009,163,387,550,29,579
公投第１５案,南投縣,草屯鎮,碧峰里,183,1138,160,433,593,22,615
公投第１５案,南投縣,草屯鎮,碧峰里,184,1197,189,462,651,19,670
公投第１５案,南投縣,草屯鎮,碧洲里,185,1364,221,547,768,38,806
公投第１５案,南投縣,草屯鎮,碧洲里,186,1059,171,430,601,32,633
公投第１５案,南投縣,草屯鎮,復興里,187,1108,206,411,617,44,661
公投第１５案,南投縣,草屯鎮,復興里,188,879,144,331,475,29,504
公投第１５案,南投縣,草屯鎮,復興里,189,957,140,377,517,48,565
公投第１５案,南投縣,草屯鎮,御史里,190,1395,208,447,655,23,678
公投第１５案,南投縣,草屯鎮,御史里,191,1101,199,463,662,21,683
公投第１５案,南投縣,草屯鎮,御史里,192,1297,227,460,687,23,710
公投第１５案,南投縣,草屯鎮,御史里,193,877,135,256,391,24,415
公投第１５案,南投縣,草屯鎮,御史里,194,1376,199,432,631,52,683
公投第１５案,南投縣,草屯鎮,新豐里,195,1008,186,426,612,41,653
公投第１５案,南投縣,草屯鎮,新豐里,196,1080,185,450,635,32,667
公投第１５案,南投縣,草屯鎮,新豐里,197,1017,175,347,522,43,565
公投第１５案,南投縣,草屯鎮,新豐里,198,961,176,409,585,29,614
公投第１５案,南投縣,草屯鎮,新庄里,199,1160,227,436,663,47,710
公投第１５案,南投縣,草屯鎮,新庄里,200,1121,181,453,634,29,663
公投第１５案,南投縣,草屯鎮,新庄里,201,1243,186,495,681,37,718
公投第１５案,南投縣,草屯鎮,加老里,202,932,163,375,538,21,559
公投第１５案,南投縣,草屯鎮,加老里,203,1323,255,560,815,48,863
公投第１５案,南投縣,草屯鎮,石川里,204,1518,201,567,768,31,799
公投第１５案,南投縣,草屯鎮,北投里,205,923,187,363,550,34,584
公投第１５案,南投縣,草屯鎮,北投里,206,970,159,335,494,40,534
公投第１５案,南投縣,草屯鎮,北投里,207,1026,212,371,583,24,607
公投第１５案,南投縣,草屯鎮,富寮里,208,1466,250,530,780,51,831
公投第１５案,南投縣,草屯鎮,富寮里,209,1180,206,452,658,22,680
公投第１５案,南投縣,草屯鎮,富寮里,210,1006,189,411,600,15,615
公投第１５案,南投縣,草屯鎮,富寮里,211,1000,170,310,480,29,509
公投第１５案,南投縣,草屯鎮,富寮里,212,1128,221,448,669,22,691
公投第１５案,南投縣,草屯鎮,富寮里,213,623,106,235,341,17,358
公投第１５案,南投縣,草屯鎮,北勢里,214,707,132,246,378,42,420
公投第１５案,南投縣,草屯鎮,北勢里,215,719,111,255,366,26,392
公投第１５案,南投縣,草屯鎮,北勢里,216,527,72,171,243,15,258
公投第１５案,南投縣,草屯鎮,中原里,217,1183,216,447,663,48,711
公投第１５案,南投縣,草屯鎮,中原里,218,869,167,348,515,19,534
公投第１５案,南投縣,草屯鎮,南埔里,219,1132,201,350,551,23,574
公投第１５案,南投縣,草屯鎮,南埔里,220,949,165,362,527,38,565
公投第１５案,南投縣,草屯鎮,南埔里,221,965,178,381,559,26,585
公投第１５案,南投縣,草屯鎮,南埔里,222,1068,179,374,553,31,584
公投第１５案,南投縣,草屯鎮,坪頂里,223,1024,178,407,585,41,626
公投第１５案,南投縣,草屯鎮,土城里,224,642,78,252,330,24,354
公投第１５案,南投縣,草屯鎮,土城里,225,1017,140,367,507,30,537
公投第１５案,南投縣,草屯鎮,平林里,226,1092,168,440,608,24,632
公投第１５案,南投縣,草屯鎮,雙冬里,227,1170,178,446,624,39,663
公投第１５案,南投縣,草屯鎮,雙冬里,228,1106,172,456,628,35,663
公投第１５案,南投縣,竹山鎮,竹山里,229,1170,170,489,659,44,703
公投第１５案,南投縣,竹山鎮,竹山里,230,850,340,147,487,45,532
公投第１５案,南投縣,竹山鎮,中正里,231,621,95,222,317,25,342
公投第１５案,南投縣,竹山鎮,中山里,232,905,154,322,476,33,509
公投第１５案,南投縣,竹山鎮,中山里,233,1099,148,367,515,41,556
公投第１５案,南投縣,竹山鎮,中山里,234,1214,151,448,599,49,648
公投第１５案,南投縣,竹山鎮,中山里,235,1287,222,506,728,50,778
公投第１５案,南投縣,竹山鎮,雲林里,236,1191,173,450,623,51,674
公投第１５案,南投縣,竹山鎮,雲林里,237,1118,152,432,584,56,640
公投第１５案,南投縣,竹山鎮,雲林里,238,1278,216,487,703,32,735
公投第１５案,南投縣,竹山鎮,竹圍里,239,1153,202,430,632,43,675
公投第１５案,南投縣,竹山鎮,竹圍里,240,1243,410,207,617,45,662
公投第１５案,南投縣,竹山鎮,桂林里,241,1308,210,485,695,43,738
公投第１５案,南投縣,竹山鎮,桂林里,242,1358,194,486,680,37,717
公投第１５案,南投縣,竹山鎮,桂林里,243,1044,164,373,537,39,576
公投第１５案,南投縣,竹山鎮,下坪里,244,511,93,203,296,25,321
公投第１５案,南投縣,竹山鎮,下坪里,245,682,105,250,355,15,370
公投第１５案,南投縣,竹山鎮,中和里,246,989,140,327,467,24,491
公投第１５案,南投縣,竹山鎮,中崎里,247,1378,181,538,719,40,759
公投第１５案,南投縣,竹山鎮,秀林里,248,217,39,78,117,2,119
公投第１５案,南投縣,竹山鎮,秀林里,249,479,81,180,261,27,288
公投第１５案,南投縣,竹山鎮,大鞍里,250,430,40,156,196,14,210
公投第１５案,南投縣,竹山鎮,延和里,251,1437,227,534,761,49,810
公投第１５案,南投縣,竹山鎮,延和里,252,1286,228,508,736,40,776
公投第１５案,南投縣,竹山鎮,延和里,253,1080,184,437,621,35,656
公投第１５案,南投縣,竹山鎮,延和里,254,1070,175,378,553,44,597
公投第１５案,南投縣,竹山鎮,延祥里,255,1295,213,502,715,29,744
公投第１５案,南投縣,竹山鎮,延祥里,256,1047,160,405,565,34,599
公投第１５案,南投縣,竹山鎮,延祥里,257,1300,200,498,698,39,737
公投第１５案,南投縣,竹山鎮,延正里,258,908,118,290,408,25,433
公投第１５案,南投縣,竹山鎮,延正里,259,821,126,250,376,46,422
公投第１５案,南投縣,竹山鎮,延平里,260,1320,209,503,712,54,766
公投第１５案,南投縣,竹山鎮,延平里,261,967,153,341,494,25,519
公投第１５案,南投縣,竹山鎮,延平里,262,595,80,209,289,18,307
公投第１５案,南投縣,竹山鎮,延山里,263,859,129,289,418,59,477
公投第１５案,南投縣,竹山鎮,山崇里,264,1196,178,414,592,54,646
公投第１５案,南投縣,竹山鎮,山崇里,265,649,105,230,335,35,370
公投第１５案,南投縣,竹山鎮,社寮里,266,1341,223,486,709,50,759
公投第１５案,南投縣,竹山鎮,中央里,267,1222,155,412,567,61,628
公投第１５案,南投縣,竹山鎮,富州里,268,602,98,232,330,19,349
公投第１５案,南投縣,竹山鎮,田子里,269,617,100,223,323,23,346
公投第１５案,南投縣,竹山鎮,硘磘里,270,793,151,296,447,37,484
公投第１５案,南投縣,竹山鎮,硘磘里,271,922,149,356,505,19,524
公投第１５案,南投縣,竹山鎮,德興里,272,366,46,130,176,19,195
公投第１５案,南投縣,竹山鎮,德興里,273,509,46,186,232,13,245
公投第１５案,南投縣,竹山鎮,福興里,274,193,25,79,104,6,110
公投第１５案,南投縣,竹山鎮,福興里,275,406,73,161,234,18,252
公投第１５案,南投縣,竹山鎮,鯉魚里,276,495,63,162,225,27,252
公投第１５案,南投縣,竹山鎮,鯉魚里,277,307,26,78,104,13,117
公投第１５案,南投縣,竹山鎮,坪頂里,278,440,52,161,213,24,237
公投第１５案,南投縣,竹山鎮,瑞竹里,279,577,78,198,276,37,313
公投第１５案,南投縣,竹山鎮,桶頭里,280,486,56,107,163,36,199
公投第１５案,南投縣,竹山鎮,桶頭里,281,403,37,99,136,12,148
公投第１５案,南投縣,集集鎮,集集里,282,1070,173,454,627,28,655
公投第１５案,南投縣,集集鎮,和平里,283,918,146,385,531,30,561
公投第１５案,南投縣,集集鎮,林尾里,284,581,102,226,328,26,354
公投第１５案,南投縣,集集鎮,田寮里,285,1194,193,482,675,39,714
公投第１５案,南投縣,集集鎮,隘寮里,286,488,66,138,204,18,222
公投第１５案,南投縣,集集鎮,玉映里,287,504,88,202,290,24,314
公投第１５案,南投縣,集集鎮,吳厝里,288,910,142,341,483,82,565
公投第１５案,南投縣,集集鎮,八張里,289,773,128,322,450,34,484
公投第１５案,南投縣,集集鎮,八張里,290,709,131,250,381,21,402
公投第１５案,南投縣,集集鎮,永昌里,291,960,174,358,532,21,553
公投第１５案,南投縣,集集鎮,廣明里,292,503,77,172,249,27,276
公投第１５案,南投縣,集集鎮,廣明里,293,419,66,131,197,15,212
公投第１５案,南投縣,集集鎮,富山里,294,582,76,181,257,13,270
公投第１５案,南投縣,名間鄉,南雅村,295,1050,204,475,679,50,729
公投第１５案,南投縣,名間鄉,中正村,296,920,143,365,508,48,556
公投第１５案,南投縣,名間鄉,中正村,297,727,131,317,448,30,478
公投第１５案,南投縣,名間鄉,中正村,298,861,152,380,532,22,554
公投第１５案,南投縣,名間鄉,中正村,299,897,142,350,492,35,527
公投第１５案,南投縣,名間鄉,中山村,300,1055,215,400,615,34,649
公投第１５案,南投縣,名間鄉,中山村,301,1184,186,464,650,51,701
公投第１５案,南投縣,名間鄉,濁水村,302,783,119,290,409,37,446
公投第１５案,南投縣,名間鄉,濁水村,303,781,117,331,448,42,490
公投第１５案,南投縣,名間鄉,新民村,304,977,145,374,519,40,559
公投第１５案,南投縣,名間鄉,炭寮村,305,1015,155,368,523,47,570
公投第１５案,南投縣,名間鄉,新街村,306,914,162,376,538,25,563
公投第１５案,南投縣,名間鄉,新街村,307,1028,180,300,480,16,496
公投第１５案,南投縣,名間鄉,新街村,308,1018,153,430,583,34,617
公投第１５案,南投縣,名間鄉,新街村,309,1274,205,493,698,59,757
公投第１５案,南投縣,名間鄉,東湖村,310,755,125,299,424,32,456
公投第１５案,南投縣,名間鄉,東湖村,311,895,153,398,551,41,592
公投第１５案,南投縣,名間鄉,仁和村,312,892,134,371,505,22,527
公投第１５案,南投縣,名間鄉,萬丹村,313,951,149,353,502,50,552
公投第１５案,南投縣,名間鄉,田仔村,314,1261,185,498,683,43,726
公投第１５案,南投縣,名間鄉,大坑村,315,768,128,281,409,34,443
公投第１５案,南投縣,名間鄉,大庄村,316,962,160,372,532,52,584
公投第１５案,南投縣,名間鄉,大庄村,317,867,133,351,484,51,535
公投第１５案,南投縣,名間鄉,廍下村,318,930,161,343,504,65,569
公投第１５案,南投縣,名間鄉,赤水村,319,641,94,249,343,45,388
公投第１５案,南投縣,名間鄉,赤水村,320,530,61,197,258,23,281
公投第１５案,南投縣,名間鄉,竹圍村,321,931,180,326,506,52,558
公投第１５案,南投縣,名間鄉,三崙村,322,1127,180,440,620,50,670
公投第１５案,南投縣,名間鄉,三崙村,323,443,78,187,265,30,295
公投第１５案,南投縣,名間鄉,松山村,324,870,133,360,493,41,534
公投第１５案,南投縣,名間鄉,松山村,325,621,119,241,360,35,395
公投第１５案,南投縣,名間鄉,松柏村,326,1179,189,420,609,32,641
公投第１５案,南投縣,名間鄉,崁腳村,327,881,147,364,511,44,555
公投第１５案,南投縣,名間鄉,埔中村,328,876,133,426,559,37,596
公投第１５案,南投縣,名間鄉,新厝村,329,783,112,319,431,46,477
公投第１５案,南投縣,名間鄉,新光村,330,778,91,302,393,30,423
公投第１５案,南投縣,名間鄉,新光村,331,983,151,350,501,42,543
公投第１５案,南投縣,鹿谷鄉,鹿谷村,332,934,100,332,432,52,484
公投第１５案,南投縣,鹿谷鄉,鹿谷村,333,940,145,364,509,33,542
公投第１５案,南投縣,鹿谷鄉,彰雅村,334,852,138,294,432,25,457
公投第１５案,南投縣,鹿谷鄉,彰雅村,335,451,80,110,190,30,220
公投第１５案,南投縣,鹿谷鄉,廣興村,336,810,127,350,477,19,496
公投第１５案,南投縣,鹿谷鄉,廣興村,337,1142,172,504,676,36,712
公投第１５案,南投縣,鹿谷鄉,永隆村,338,766,106,253,359,19,378
公投第１５案,南投縣,鹿谷鄉,永隆村,339,884,120,359,479,39,518
公投第１５案,南投縣,鹿谷鄉,鳳凰村,340,811,146,283,429,31,460
公投第１５案,南投縣,鹿谷鄉,鳳凰村,341,581,70,184,254,22,276
公投第１５案,南投縣,鹿谷鄉,內湖村,342,578,85,194,279,17,296
公投第１５案,南投縣,鹿谷鄉,內湖村,343,467,78,179,257,22,279
公投第１５案,南投縣,鹿谷鄉,和雅村,344,622,69,249,318,28,346
公投第１５案,南投縣,鹿谷鄉,竹林村,345,740,100,264,364,19,383
公投第１５案,南投縣,鹿谷鄉,竹林村,346,767,93,305,398,35,433
公投第１５案,南投縣,鹿谷鄉,竹豐村,347,909,123,378,501,30,531
公投第１５案,南投縣,鹿谷鄉,初鄉村,348,713,114,239,353,20,373
公投第１５案,南投縣,鹿谷鄉,初鄉村,349,717,95,224,319,19,338
公投第１５案,南投縣,鹿谷鄉,秀峰村,350,794,119,265,384,24,408
公投第１５案,南投縣,鹿谷鄉,清水村,351,726,108,238,346,15,361
公投第１５案,南投縣,鹿谷鄉,瑞田村,352,737,88,210,298,31,329
公投第１５案,南投縣,中寮鄉,廣興村,353,822,128,340,468,37,505
公投第１５案,南投縣,中寮鄉,崁頂村,354,253,40,103,143,12,155
公投第１５案,南投縣,中寮鄉,崁頂村,355,221,25,66,91,4,95
公投第１５案,南投縣,中寮鄉,八仙村,356,353,52,110,162,4,166
公投第１５案,南投縣,中寮鄉,八仙村,357,427,64,155,219,17,236
公投第１５案,南投縣,中寮鄉,福盛村,358,406,48,169,217,15,232
公投第１５案,南投縣,中寮鄉,福盛村,359,307,35,108,143,18,161
公投第１５案,南投縣,中寮鄉,和興村,360,661,103,272,375,28,403
公投第１５案,南投縣,中寮鄉,復興村,361,290,47,133,180,12,192
公投第１５案,南投縣,中寮鄉,永平村,362,973,163,365,528,44,572
公投第１５案,南投縣,中寮鄉,永平村,363,754,123,312,435,21,456
公投第１５案,南投縣,中寮鄉,中寮村,364,662,86,254,340,28,368
公投第１５案,南投縣,中寮鄉,廣福村,365,490,53,173,226,10,236
公投第１５案,南投縣,中寮鄉,永福村,366,335,56,107,163,13,176
公投第１５案,南投縣,中寮鄉,永福村,367,990,153,389,542,34,576
公投第１５案,南投縣,中寮鄉,義和村,368,461,68,210,278,18,296
公投第１５案,南投縣,中寮鄉,義和村,369,614,101,257,358,23,381
公投第１５案,南投縣,中寮鄉,清水村,370,895,117,349,466,44,510
公投第１５案,南投縣,中寮鄉,內城村,371,465,61,177,238,27,265
公投第１５案,南投縣,中寮鄉,龍安村,372,682,121,230,351,51,402
公投第１５案,南投縣,中寮鄉,爽文村,373,490,74,198,272,31,303
公投第１５案,南投縣,中寮鄉,龍岩村,374,643,92,272,364,31,395
公投第１５案,南投縣,中寮鄉,永芳村,375,459,68,197,265,19,284
公投第１５案,南投縣,中寮鄉,永和村,376,528,65,185,250,15,265
公投第１５案,南投縣,魚池鄉,魚池村,377,922,155,341,496,35,531
公投第１５案,南投縣,魚池鄉,魚池村,378,1098,191,406,597,52,649
公投第１５案,南投縣,魚池鄉,東池村,379,720,129,229,358,29,387
公投第１５案,南投縣,魚池鄉,東池村,380,860,128,337,465,42,507
公投第１５案,南投縣,魚池鄉,大林村,381,514,58,181,239,24,263
公投第１５案,南投縣,魚池鄉,大林村,382,574,90,188,278,12,290
公投第１５案,南投縣,魚池鄉,東光村,383,1249,195,442,637,47,684
公投第１５案,南投縣,魚池鄉,共和村,384,293,55,133,188,6,194
公投第１５案,南投縣,魚池鄉,共和村,385,513,75,183,258,21,279
公投第１５案,南投縣,魚池鄉,共和村,386,186,43,53,96,7,103
公投第１５案,南投縣,魚池鄉,新城村,387,841,124,283,407,26,433
公投第１５案,南投縣,魚池鄉,新城村,388,270,49,107,156,14,170
公投第１５案,南投縣,魚池鄉,新城村,389,275,42,95,137,17,154
公投第１５案,南投縣,魚池鄉,大雁村,390,282,27,97,124,7,131
公投第１５案,南投縣,魚池鄉,大雁村,391,392,60,125,185,9,194
公投第１５案,南投縣,魚池鄉,五城村,392,556,72,201,273,33,306
公投第１５案,南投縣,魚池鄉,五城村,393,176,17,74,91,6,97
公投第１５案,南投縣,魚池鄉,中明村,394,578,80,166,246,26,272
公投第１５案,南投縣,魚池鄉,中明村,395,439,67,135,202,22,224
公投第１５案,南投縣,魚池鄉,水社村,396,844,130,335,465,24,489
公投第１５案,南投縣,魚池鄉,日月村,397,868,129,308,437,33,470
公投第１５案,南投縣,魚池鄉,頭社村,398,405,58,119,177,13,190
公投第１５案,南投縣,魚池鄉,頭社村,399,537,90,201,291,16,307
公投第１５案,南投縣,魚池鄉,武登村,400,335,43,127,170,13,183
公投第１５案,南投縣,魚池鄉,武登村,401,231,16,76,92,12,104
公投第１５案,南投縣,國姓鄉,國姓村,402,964,125,428,553,50,603
公投第１５案,南投縣,國姓鄉,國姓村,403,736,89,307,396,20,416
公投第１５案,南投縣,國姓鄉,石門村,404,801,100,325,425,52,477
公投第１５案,南投縣,國姓鄉,石門村,405,964,137,398,535,17,552
公投第１５案,南投縣,國姓鄉,大旗村,406,686,100,255,355,32,387
公投第１５案,南投縣,國姓鄉,長流村,407,661,91,251,342,20,362
公投第１５案,南投縣,國姓鄉,長流村,408,730,82,272,354,25,379
公投第１５案,南投縣,國姓鄉,長豐村,409,774,107,284,391,45,436
公投第１５案,南投縣,國姓鄉,長福村,410,706,119,283,402,18,420
公投第１５案,南投縣,國姓鄉,北港村,411,1012,127,418,545,32,577
公投第１５案,南投縣,國姓鄉,北港村,412,868,95,299,394,20,414
公投第１５案,南投縣,國姓鄉,福龜村,413,918,135,400,535,21,556
公投第１５案,南投縣,國姓鄉,福龜村,414,937,132,365,497,39,536
公投第１５案,南投縣,國姓鄉,乾溝村,415,815,125,290,415,35,450
公投第１５案,南投縣,國姓鄉,柑林村,416,1134,167,481,648,37,685
公投第１５案,南投縣,國姓鄉,大石村,417,714,117,256,373,24,397
公投第１５案,南投縣,國姓鄉,北山村,418,1095,174,432,606,42,648
公投第１５案,南投縣,國姓鄉,北山村,419,448,61,154,215,22,237
公投第１５案,南投縣,國姓鄉,南港村,420,1064,112,406,518,53,571
公投第１５案,南投縣,國姓鄉,南港村,421,570,73,206,279,21,300
公投第１５案,南投縣,水里鄉,水里村,422,757,110,287,397,25,422
公投第１５案,南投縣,水里鄉,新城村,423,554,84,195,279,34,313
公投第１５案,南投縣,水里鄉,新城村,424,999,161,378,539,40,579
公投第１５案,南投縣,水里鄉,中央村,425,616,85,236,321,16,337
公投第１５案,南投縣,水里鄉,城中村,426,875,146,357,503,22,525
公投第１５案,南投縣,水里鄉,農富村,427,480,82,204,286,8,294
公投第１５案,南投縣,水里鄉,車埕村,428,450,83,148,231,17,248
公投第１５案,南投縣,水里鄉,新興村,429,643,112,206,318,37,355
公投第１５案,南投縣,水里鄉,北埔村,430,1004,146,416,562,25,587
公投第１５案,南投縣,水里鄉,南光村,431,741,98,320,418,22,440
公投第１５案,南投縣,水里鄉,南光村,432,802,165,293,458,11,469
公投第１５案,南投縣,水里鄉,鉅工村,433,998,168,419,587,54,641
公投第１５案,南投縣,水里鄉,永豐村,434,800,115,285,400,42,442
公投第１５案,南投縣,水里鄉,永豐村,435,589,90,258,348,19,367
公投第１５案,南投縣,水里鄉,民和村,436,887,118,299,417,47,464
公投第１５案,南投縣,水里鄉,頂崁村,437,1217,158,444,602,35,637
公投第１５案,南投縣,水里鄉,新山村,438,205,26,54,80,1,81
公投第１５案,南投縣,水里鄉,郡坑村,439,330,50,135,185,24,209
公投第１５案,南投縣,水里鄉,上安村,440,1100,149,398,547,32,579
公投第１５案,南投縣,水里鄉,興隆村,441,275,22,75,97,8,105
公投第１５案,南投縣,水里鄉,永興村,442,318,57,80,137,2,139
公投第１５案,南投縣,水里鄉,玉峰村,443,818,101,297,398,48,446
公投第１５案,南投縣,信義鄉,明德村,444,1201,138,471,609,70,679
公投第１５案,南投縣,信義鄉,明德村,445,329,31,132,163,15,178
公投第１５案,南投縣,信義鄉,愛國村,446,516,75,169,244,27,271
公投第１５案,南投縣,信義鄉,自強村,447,424,44,141,185,17,202
公投第１５案,南投縣,信義鄉,自強村,448,321,42,123,165,4,169
公投第１５案,南投縣,信義鄉,豐丘村,449,648,84,310,394,22,416
公投第１５案,南投縣,信義鄉,新鄉村,450,584,58,348,406,33,439
公投第１５案,南投縣,信義鄉,羅娜村,451,1376,110,611,721,26,747
公投第１５案,南投縣,信義鄉,望美村,452,979,96,432,528,22,550
公投第１５案,南投縣,信義鄉,望美村,453,530,66,290,356,39,395
公投第１５案,南投縣,信義鄉,同富村,454,961,119,348,467,39,506
公投第１５案,南投縣,信義鄉,同富村,455,464,55,184,239,18,257
公投第１５案,南投縣,信義鄉,神木村,456,517,77,194,271,34,305
公投第１５案,南投縣,信義鄉,神木村,457,149,23,58,81,8,89
公投第１５案,南投縣,信義鄉,東埔村,458,1020,103,593,696,67,763
公投第１５案,南投縣,信義鄉,人和村,459,929,77,501,578,61,639
公投第１５案,南投縣,信義鄉,人和村,460,274,27,95,122,7,129
公投第１５案,南投縣,信義鄉,地利村,461,900,96,503,599,35,634
公投第１５案,南投縣,信義鄉,雙龍村,462,617,73,346,419,32,451
公投第１５案,南投縣,信義鄉,潭南村,463,560,67,284,351,26,377
公投第１５案,南投縣,仁愛鄉,南豐村,464,973,395,136,531,20,551
公投第１５案,南投縣,仁愛鄉,南豐村,465,296,43,97,140,10,150
公投第１５案,南投縣,仁愛鄉,大同村,466,900,115,324,439,14,453
公投第１５案,南投縣,仁愛鄉,大同村,467,460,75,202,277,20,297
公投第１５案,南投縣,仁愛鄉,大同村,468,305,45,128,173,10,183
公投第１５案,南投縣,仁愛鄉,榮興村,469,58,1,17,18,2,20
公投第１５案,南投縣,仁愛鄉,春陽村,470,952,96,406,502,9,511
公投第１５案,南投縣,仁愛鄉,精英村,471,679,64,234,298,7,305
公投第１５案,南投縣,仁愛鄉,都達村,472,623,77,246,323,46,369
公投第１５案,南投縣,仁愛鄉,合作村,473,597,47,159,206,10,216
公投第１５案,南投縣,仁愛鄉,發祥村,474,384,28,194,222,27,249
公投第１５案,南投縣,仁愛鄉,發祥村,475,121,4,54,58,4,62
公投第１５案,南投縣,仁愛鄉,發祥村,476,264,31,138,169,2,171
公投第１５案,南投縣,仁愛鄉,力行村,477,509,54,312,366,16,382
公投第１５案,南投縣,仁愛鄉,翠華村,478,338,25,162,187,20,207
公投第１５案,南投縣,仁愛鄉,翠華村,479,169,23,60,83,1,84
公投第１５案,南投縣,仁愛鄉,親愛村,480,613,80,193,273,20,293
公投第１５案,南投縣,仁愛鄉,親愛村,481,404,52,126,178,12,190
公投第１５案,南投縣,仁愛鄉,親愛村,482,134,13,61,74,4,78
公投第１５案,南投縣,仁愛鄉,萬豐村,483,630,69,306,375,32,407
公投第１５案,南投縣,仁愛鄉,法治村,484,763,82,285,367,13,380
公投第１５案,南投縣,仁愛鄉,中正村,485,889,66,483,549,29,578
公投第１５案,南投縣,仁愛鄉,互助村,486,672,79,326,405,33,438
公投第１５案,南投縣,仁愛鄉,互助村,487,447,69,185,254,20,274
公投第１５案,南投縣,仁愛鄉,新生村,488,409,62,236,298,7,305
公投第１５案,雲林縣,麥寮鄉,麥豐村,1,1497,165,439,604,50,654
公投第１５案,雲林縣,麥寮鄉,麥豐村,2,1738,243,583,826,47,873
公投第１５案,雲林縣,麥寮鄉,麥豐村,3,1921,274,633,907,50,957
公投第１５案,雲林縣,麥寮鄉,麥豐村,4,1832,244,576,820,54,874
公投第１５案,雲林縣,麥寮鄉,麥津村,5,1340,180,376,556,55,611
公投第１５案,雲林縣,麥寮鄉,麥津村,6,1138,139,357,496,56,552
公投第１５案,雲林縣,麥寮鄉,麥津村,7,1551,190,523,713,50,763
公投第１５案,雲林縣,麥寮鄉,瓦磘村,8,715,82,207,289,23,312
公投第１５案,雲林縣,麥寮鄉,瓦磘村,9,1194,136,337,473,49,522
公投第１５案,雲林縣,麥寮鄉,興華村,10,1023,134,313,447,41,488
公投第１５案,雲林縣,麥寮鄉,興華村,11,1558,168,391,559,43,602
公投第１５案,雲林縣,麥寮鄉,海豐村,12,1187,146,308,454,24,478
公投第１５案,雲林縣,麥寮鄉,海豐村,13,983,116,278,394,28,422
公投第１５案,雲林縣,麥寮鄉,後安村,14,1363,161,438,599,61,660
公投第１５案,雲林縣,麥寮鄉,後安村,15,1596,197,430,627,66,693
公投第１５案,雲林縣,麥寮鄉,中興村,16,1469,239,552,791,71,862
公投第１５案,雲林縣,麥寮鄉,三盛村,17,964,139,251,390,42,432
公投第１５案,雲林縣,麥寮鄉,三盛村,18,1038,116,295,411,34,445
公投第１５案,雲林縣,麥寮鄉,崙後村,19,1230,147,418,565,55,620
公投第１５案,雲林縣,麥寮鄉,崙後村,20,1329,162,435,597,48,645
公投第１５案,雲林縣,麥寮鄉,橋頭村,21,1129,152,383,535,72,607
公投第１５案,雲林縣,麥寮鄉,橋頭村,22,1241,205,414,619,78,697
公投第１５案,雲林縣,麥寮鄉,橋頭村,23,1471,216,494,710,94,804
公投第１５案,雲林縣,麥寮鄉,新吉村,24,1107,181,389,570,69,639
公投第１５案,雲林縣,麥寮鄉,施厝村,25,1636,243,587,830,69,899
公投第１５案,雲林縣,麥寮鄉,施厝村,26,1755,228,584,812,47,859
公投第１５案,雲林縣,麥寮鄉,雷厝村,27,1158,169,417,586,31,617
公投第１５案,雲林縣,麥寮鄉,雷厝村,28,956,155,323,478,36,514
公投第１５案,雲林縣,臺西鄉,臺西村,29,1238,187,429,616,64,680
公投第１５案,雲林縣,臺西鄉,海南村,30,1091,268,222,490,30,520
公投第１５案,雲林縣,臺西鄉,海北村,31,1098,137,386,523,59,582
公投第１５案,雲林縣,臺西鄉,海口村,32,1048,120,304,424,30,454
公投第１５案,雲林縣,臺西鄉,海口村,33,1025,111,324,435,59,494
公投第１５案,雲林縣,臺西鄉,山寮村,34,850,110,288,398,33,431
公投第１５案,雲林縣,臺西鄉,溪頂村,35,1460,150,432,582,60,642
公投第１５案,雲林縣,臺西鄉,牛厝村,36,1180,108,259,367,69,436
公投第１５案,雲林縣,臺西鄉,牛厝村,37,710,37,171,208,30,238
公投第１５案,雲林縣,臺西鄉,泉州村,38,620,68,167,235,17,252
公投第１５案,雲林縣,臺西鄉,五榔村,39,449,62,123,185,28,213
公投第１５案,雲林縣,臺西鄉,光華村,40,687,71,160,231,46,277
公投第１５案,雲林縣,臺西鄉,五港村,41,1247,138,371,509,52,561
公投第１５案,雲林縣,臺西鄉,五港村,42,583,50,149,199,11,210
公投第１５案,雲林縣,臺西鄉,富琦村,43,1042,142,331,473,51,524
公投第１５案,雲林縣,臺西鄉,富琦村,44,472,65,136,201,18,219
公投第１５案,雲林縣,臺西鄉,永豐村,45,1409,133,433,566,31,597
公投第１５案,雲林縣,臺西鄉,和豐村,46,1061,145,351,496,66,562
公投第１５案,雲林縣,臺西鄉,和豐村,47,993,98,296,394,29,423
公投第１５案,雲林縣,臺西鄉,和豐村,48,1013,96,324,420,72,492
公投第１５案,雲林縣,臺西鄉,蚊港村,49,1233,155,412,567,35,602
公投第１５案,雲林縣,臺西鄉,蚊港村,50,616,73,169,242,22,264
公投第１５案,雲林縣,東勢鄉,月眉村,51,1207,153,331,484,56,540
公投第１５案,雲林縣,東勢鄉,復興村,52,540,87,218,305,25,330
公投第１５案,雲林縣,東勢鄉,嘉隆村,53,896,118,249,367,28,395
公投第１５案,雲林縣,東勢鄉,嘉隆村,54,728,113,240,353,41,394
公投第１５案,雲林縣,東勢鄉,東南村,55,1533,237,592,829,45,874
公投第１５案,雲林縣,東勢鄉,東北村,56,1203,194,456,650,69,719
公投第１５案,雲林縣,東勢鄉,龍潭村,57,817,98,245,343,50,393
公投第１５案,雲林縣,東勢鄉,程海村,58,546,96,207,303,22,325
公投第１５案,雲林縣,東勢鄉,昌南村,59,853,113,264,377,61,438
公投第１５案,雲林縣,東勢鄉,安南村,60,856,100,221,321,50,371
公投第１５案,雲林縣,東勢鄉,同安村,61,923,132,262,394,51,445
公投第１５案,雲林縣,東勢鄉,同安村,62,1022,130,339,469,44,513
公投第１５案,雲林縣,東勢鄉,四美村,63,634,46,171,217,24,241
公投第１５案,雲林縣,東勢鄉,四美村,64,394,50,108,158,16,174
公投第１５案,雲林縣,東勢鄉,新坤村,65,1087,94,297,391,43,434
公投第１５案,雲林縣,褒忠鄉,中民村,66,923,139,330,469,50,519
公投第１５案,雲林縣,褒忠鄉,中民村,67,993,200,361,561,23,584
公投第１５案,雲林縣,褒忠鄉,埔姜村,68,748,127,249,376,19,395
公投第１５案,雲林縣,褒忠鄉,埔姜村,69,702,101,244,345,12,357
公投第１５案,雲林縣,褒忠鄉,中勝村,70,752,112,250,362,18,380
公投第１５案,雲林縣,褒忠鄉,中勝村,71,756,141,247,388,19,407
公投第１５案,雲林縣,褒忠鄉,馬鳴村,72,490,75,167,242,15,257
公投第１５案,雲林縣,褒忠鄉,馬鳴村,73,1034,136,298,434,32,466
公投第１５案,雲林縣,褒忠鄉,新湖村,74,470,68,143,211,25,236
公投第１５案,雲林縣,褒忠鄉,新湖村,75,737,144,196,340,36,376
公投第１５案,雲林縣,褒忠鄉,有才村,76,878,119,284,403,33,436
公投第１５案,雲林縣,褒忠鄉,田洋村,77,778,104,247,351,39,390
公投第１５案,雲林縣,褒忠鄉,龍岩村,78,1224,207,384,591,40,631
公投第１５案,雲林縣,褒忠鄉,潮厝村,79,896,117,241,358,69,427
公投第１５案,雲林縣,土庫鎮,忠正里,80,809,143,322,465,50,515
公投第１５案,雲林縣,土庫鎮,順天里,81,896,161,378,539,41,580
公投第１５案,雲林縣,土庫鎮,宮北里,82,687,124,250,374,31,405
公投第１５案,雲林縣,土庫鎮,宮北里,83,702,150,295,445,27,472
公投第１５案,雲林縣,土庫鎮,越港里,84,1032,181,429,610,25,635
公投第１５案,雲林縣,土庫鎮,溪邊里,85,697,116,210,326,44,370
公投第１５案,雲林縣,土庫鎮,溪邊里,86,427,57,137,194,31,225
公投第１５案,雲林縣,土庫鎮,石廟里,87,1451,244,548,792,49,841
公投第１５案,雲林縣,土庫鎮,石廟里,88,1283,209,505,714,19,733
公投第１５案,雲林縣,土庫鎮,興新里,89,634,109,172,281,16,297
公投第１５案,雲林縣,土庫鎮,興新里,90,796,159,252,411,24,435
公投第１５案,雲林縣,土庫鎮,奮起里,91,745,100,189,289,42,331
公投第１５案,雲林縣,土庫鎮,奮起里,92,576,77,184,261,27,288
公投第１５案,雲林縣,土庫鎮,埤腳里,93,743,79,217,296,58,354
公投第１５案,雲林縣,土庫鎮,埤腳里,94,534,89,138,227,9,236
公投第１５案,雲林縣,土庫鎮,後埔里,95,1199,247,226,473,75,548
公投第１５案,雲林縣,土庫鎮,後埔里,96,1077,160,309,469,71,540
公投第１５案,雲林縣,土庫鎮,崙內里,97,819,103,227,330,25,355
公投第１５案,雲林縣,土庫鎮,崙內里,98,684,107,224,331,38,369
公投第１５案,雲林縣,土庫鎮,大荖里,99,843,116,300,416,48,464
公投第１５案,雲林縣,土庫鎮,東平里,100,916,121,305,426,63,489
公投第１５案,雲林縣,土庫鎮,東平里,101,948,135,301,436,42,478
公投第１５案,雲林縣,土庫鎮,南平里,102,914,141,316,457,31,488
公投第１５案,雲林縣,土庫鎮,南平里,103,860,128,282,410,64,474
公投第１５案,雲林縣,土庫鎮,西平里,104,929,145,280,425,47,472
公投第１５案,雲林縣,土庫鎮,西平里,105,875,123,249,372,53,425
公投第１５案,雲林縣,土庫鎮,北平里,106,896,115,231,346,38,384
公投第１５案,雲林縣,土庫鎮,新庄里,107,757,89,206,295,50,345
公投第１５案,雲林縣,土庫鎮,新庄里,108,683,96,209,305,28,333
公投第１５案,雲林縣,虎尾鎮,東仁里,109,1347,232,471,703,41,744
公投第１５案,雲林縣,虎尾鎮,東仁里,110,1258,239,469,708,33,741
公投第１５案,雲林縣,虎尾鎮,新興里,111,785,136,276,412,26,438
公投第１５案,雲林縣,虎尾鎮,新興里,112,890,130,277,407,31,438
公投第１５案,雲林縣,虎尾鎮,公安里,113,1413,270,525,795,44,839
公投第１５案,雲林縣,虎尾鎮,公安里,114,1431,254,578,832,38,870
公投第１５案,雲林縣,虎尾鎮,德興里,115,1224,190,420,610,51,661
公投第１５案,雲林縣,虎尾鎮,德興里,116,1325,187,428,615,34,649
公投第１５案,雲林縣,虎尾鎮,中山里,117,941,193,323,516,55,571
公投第１５案,雲林縣,虎尾鎮,西安里,118,1613,270,580,850,24,874
公投第１５案,雲林縣,虎尾鎮,西安里,119,1641,280,555,835,28,863
公投第１５案,雲林縣,虎尾鎮,立仁里,120,1200,224,439,663,44,707
公投第１５案,雲林縣,虎尾鎮,立仁里,121,1294,225,472,697,63,760
公投第１５案,雲林縣,虎尾鎮,立仁里,122,1273,218,481,699,23,722
公投第１５案,雲林縣,虎尾鎮,安慶里,123,1438,257,605,862,25,887
公投第１５案,雲林縣,虎尾鎮,平和里,124,1361,237,523,760,25,785
公投第１５案,雲林縣,虎尾鎮,平和里,125,1444,328,500,828,36,864
公投第１５案,雲林縣,虎尾鎮,平和里,126,1490,289,618,907,26,933
公投第１５案,雲林縣,虎尾鎮,興南里,127,1307,345,445,790,37,827
公投第１５案,雲林縣,虎尾鎮,興南里,128,967,163,300,463,28,491
公投第１５案,雲林縣,虎尾鎮,新吉里,129,1865,298,676,974,24,998
公投第１５案,雲林縣,虎尾鎮,新吉里,130,1880,338,676,1014,32,1046
公投第１５案,雲林縣,虎尾鎮,穎川里,131,1099,166,373,539,35,574
公投第１５案,雲林縣,虎尾鎮,穎川里,132,901,158,342,500,19,519
公投第１５案,雲林縣,虎尾鎮,延平里,133,1120,195,370,565,33,598
公投第１５案,雲林縣,虎尾鎮,建國里,134,545,84,168,252,8,260
公投第１５案,雲林縣,虎尾鎮,埒內里,135,1420,240,459,699,57,756
公投第１５案,雲林縣,虎尾鎮,埒內里,136,1248,204,402,606,24,630
公投第１５案,雲林縣,虎尾鎮,堀頭里,137,799,118,300,418,21,439
公投第１５案,雲林縣,虎尾鎮,安溪里,138,836,125,273,398,50,448
公投第１５案,雲林縣,虎尾鎮,安溪里,139,924,153,259,412,34,446
公投第１５案,雲林縣,虎尾鎮,興中里,140,1648,209,481,690,29,719
公投第１５案,雲林縣,虎尾鎮,廉使里,141,1616,244,444,688,85,773
公投第１５案,雲林縣,虎尾鎮,廉使里,142,1546,229,504,733,46,779
公投第１５案,雲林縣,虎尾鎮,惠來里,143,1283,171,459,630,33,663
公投第１５案,雲林縣,虎尾鎮,惠來里,144,1078,169,353,522,31,553
公投第１５案,雲林縣,虎尾鎮,頂溪里,145,1313,183,402,585,45,630
公投第１５案,雲林縣,虎尾鎮,頂溪里,146,1284,188,420,608,33,641
公投第１５案,雲林縣,虎尾鎮,中溪里,147,1356,205,450,655,73,728
公投第１５案,雲林縣,虎尾鎮,下溪里,148,1504,231,531,762,53,815
公投第１５案,雲林縣,虎尾鎮,東屯里,149,1224,181,381,562,27,589
公投第１５案,雲林縣,虎尾鎮,西屯里,150,1509,205,451,656,53,709
公投第１５案,雲林縣,虎尾鎮,芳草里,151,855,128,193,321,47,368
公投第１５案,雲林縣,虎尾鎮,墾地里,152,1549,222,432,654,66,720
公投第１５案,雲林縣,虎尾鎮,北溪里,153,851,121,260,381,21,402
公投第１５案,雲林縣,虎尾鎮,三合里,154,1272,164,411,575,62,637
公投第１５案,雲林縣,四湖鄉,四湖村,155,1082,127,305,432,51,483
公投第１５案,雲林縣,四湖鄉,四湖村,156,676,75,250,325,41,366
公投第１５案,雲林縣,四湖鄉,湖西村,157,862,114,291,405,26,431
公投第１５案,雲林縣,四湖鄉,湖西村,158,477,45,111,156,22,178
公投第１５案,雲林縣,四湖鄉,湖西村,159,952,137,362,499,33,532
公投第１５案,雲林縣,四湖鄉,新庄村,160,650,61,168,229,18,247
公投第１５案,雲林縣,四湖鄉,溪底村,161,969,124,278,402,21,423
公投第１５案,雲林縣,四湖鄉,鹿場村,162,925,113,211,324,51,375
公投第１５案,雲林縣,四湖鄉,蔡厝村,163,914,103,270,373,30,403
公投第１５案,雲林縣,四湖鄉,湖寮村,164,759,81,118,199,45,244
公投第１５案,雲林縣,四湖鄉,施湖村,165,1219,122,319,441,37,478
公投第１５案,雲林縣,四湖鄉,羊調村,166,937,87,200,287,37,324
公投第１５案,雲林縣,四湖鄉,內湖村,167,773,64,155,219,13,232
公投第１５案,雲林縣,四湖鄉,飛東村,168,555,55,135,190,35,225
公投第１５案,雲林縣,四湖鄉,飛沙村,169,876,96,179,275,22,297
公投第１５案,雲林縣,四湖鄉,三姓村,170,360,38,83,121,18,139
公投第１５案,雲林縣,四湖鄉,崙北村,171,885,74,148,222,41,263
公投第１５案,雲林縣,四湖鄉,崙北村,172,833,79,172,251,35,286
公投第１５案,雲林縣,四湖鄉,崙南村,173,785,90,195,285,35,320
公投第１５案,雲林縣,四湖鄉,廣溝村,174,705,71,238,309,26,335
公投第１５案,雲林縣,四湖鄉,箔子村,175,927,93,179,272,29,301
公投第１５案,雲林縣,四湖鄉,箔東村,176,1058,102,210,312,67,379
公投第１５案,雲林縣,四湖鄉,林厝村,177,1071,94,271,365,51,416
公投第１５案,雲林縣,四湖鄉,林東村,178,1022,74,199,273,18,291
公投第１５案,雲林縣,四湖鄉,溪尾村,179,711,73,204,277,27,304
公投第１５案,雲林縣,元長鄉,長南村,180,915,124,309,433,32,465
公投第１５案,雲林縣,元長鄉,長南村,181,1284,173,411,584,24,608
公投第１５案,雲林縣,元長鄉,長南村,182,1150,168,327,495,46,541
公投第１５案,雲林縣,元長鄉,長北村,183,744,89,201,290,42,332
公投第１５案,雲林縣,元長鄉,長北村,184,790,105,245,350,43,393
公投第１５案,雲林縣,元長鄉,子茂村,185,1356,134,353,487,73,560
公投第１５案,雲林縣,元長鄉,後湖村,186,739,90,212,302,56,358
公投第１５案,雲林縣,元長鄉,山內村,187,965,100,250,350,36,386
公投第１５案,雲林縣,元長鄉,合和村,188,1080,125,283,408,56,464
公投第１５案,雲林縣,元長鄉,五塊村,189,948,101,236,337,43,380
公投第１５案,雲林縣,元長鄉,潭西村,190,762,69,143,212,30,242
公投第１５案,雲林縣,元長鄉,潭東村,191,582,72,174,246,26,272
公投第１５案,雲林縣,元長鄉,客厝村,192,865,85,225,310,16,326
公投第１５案,雲林縣,元長鄉,卓運村,193,362,23,54,77,5,82
公投第１５案,雲林縣,元長鄉,頂寮村,194,1162,130,283,413,31,444
公投第１５案,雲林縣,元長鄉,下寮村,195,1527,183,443,626,37,663
公投第１５案,雲林縣,元長鄉,龍岩村,196,1006,137,285,422,65,487
公投第１５案,雲林縣,元長鄉,西莊村,197,855,105,232,337,24,361
公投第１５案,雲林縣,元長鄉,鹿北村,198,1181,149,336,485,72,557
公投第１５案,雲林縣,元長鄉,鹿南村,199,864,107,218,325,33,358
公投第１５案,雲林縣,元長鄉,瓦磘村,200,667,78,159,237,30,267
公投第１５案,雲林縣,元長鄉,瓦磘村,201,878,102,212,314,37,351
公投第１５案,雲林縣,元長鄉,內寮村,202,610,53,130,183,8,191
公投第１５案,雲林縣,元長鄉,崙仔村,203,837,101,243,344,53,397
公投第１５案,雲林縣,元長鄉,新吉村,204,701,114,213,327,27,354
公投第１５案,雲林縣,口湖鄉,口湖村,205,1134,168,364,532,60,592
公投第１５案,雲林縣,口湖鄉,湖東村,206,1225,167,410,577,89,666
公投第１５案,雲林縣,口湖鄉,頂湖村,207,647,58,181,239,38,277
公投第１５案,雲林縣,口湖鄉,埔南村,208,709,97,226,323,26,349
公投第１５案,雲林縣,口湖鄉,埔北村,209,900,133,230,363,67,430
公投第１５案,雲林縣,口湖鄉,謝厝村,210,1011,132,299,431,65,496
公投第１５案,雲林縣,口湖鄉,蚵寮村,211,1437,146,383,529,39,568
公投第１５案,雲林縣,口湖鄉,下崙村,212,848,88,175,263,13,276
公投第１５案,雲林縣,口湖鄉,下崙村,213,1193,122,330,452,27,479
公投第１５案,雲林縣,口湖鄉,崙中村,214,759,78,167,245,43,288
公投第１５案,雲林縣,口湖鄉,崙中村,215,815,91,234,325,43,368
公投第１５案,雲林縣,口湖鄉,崙東村,216,1460,200,438,638,82,720
公投第１５案,雲林縣,口湖鄉,青蚶村,217,556,68,105,173,7,180
公投第１５案,雲林縣,口湖鄉,港東村,218,1532,182,463,645,56,701
公投第１５案,雲林縣,口湖鄉,港西村,219,847,96,273,369,14,383
公投第１５案,雲林縣,口湖鄉,台子村,220,374,52,108,160,22,182
公投第１５案,雲林縣,口湖鄉,台子村,221,1508,191,482,673,161,834
公投第１５案,雲林縣,口湖鄉,成龍村,222,951,119,344,463,67,530
公投第１５案,雲林縣,口湖鄉,梧南村,223,910,134,322,456,68,524
公投第１５案,雲林縣,口湖鄉,梧南村,224,879,144,333,477,39,516
公投第１５案,雲林縣,口湖鄉,梧北村,225,1213,146,335,481,109,590
公投第１５案,雲林縣,口湖鄉,水井村,226,952,110,316,426,51,477
公投第１５案,雲林縣,口湖鄉,後厝村,227,720,104,238,342,46,388
公投第１５案,雲林縣,口湖鄉,湖口村,228,1006,120,252,372,34,406
公投第１５案,雲林縣,口湖鄉,過港村,229,607,44,187,231,14,245
公投第１５案,雲林縣,水林鄉,水北村,230,1355,190,380,570,59,629
公投第１５案,雲林縣,水林鄉,水北村,231,887,144,278,422,16,438
公投第１５案,雲林縣,水林鄉,水南村,232,1234,188,437,625,40,665
公投第１５案,雲林縣,水林鄉,水南村,233,763,114,238,352,18,370
公投第１５案,雲林縣,水林鄉,萬興村,234,721,104,153,257,48,305
公投第１５案,雲林縣,水林鄉,尖山村,235,647,69,162,231,8,239
公投第１５案,雲林縣,水林鄉,大溝村,236,989,120,256,376,64,440
公投第１５案,雲林縣,水林鄉,順興村,237,837,86,202,288,33,321
公投第１５案,雲林縣,水林鄉,大山村,238,1081,109,279,388,16,404
公投第１５案,雲林縣,水林鄉,後寮村,239,704,93,186,279,39,318
公投第１５案,雲林縣,水林鄉,春埔村,240,1006,142,272,414,81,495
公投第１５案,雲林縣,水林鄉,西井村,241,651,68,181,249,14,263
公投第１５案,雲林縣,水林鄉,車港村,242,607,66,164,230,19,249
公投第１５案,雲林縣,水林鄉,蘇秦村,243,1033,125,238,363,67,430
公投第１５案,雲林縣,水林鄉,灣東村,244,631,51,140,191,15,206
公投第１５案,雲林縣,水林鄉,灣西村,245,961,95,299,394,15,409
公投第１５案,雲林縣,水林鄉,蕃薯村,246,951,108,243,351,72,423
公投第１５案,雲林縣,水林鄉,山腳村,247,838,98,226,324,40,364
公投第１５案,雲林縣,水林鄉,松北村,248,1055,112,287,399,100,499
公投第１５案,雲林縣,水林鄉,松中村,249,512,37,110,147,30,177
公投第１５案,雲林縣,水林鄉,松西村,250,671,81,148,229,16,245
公投第１５案,雲林縣,水林鄉,欍埔村,251,693,64,123,187,37,224
公投第１５案,雲林縣,水林鄉,塭底村,252,689,62,136,198,41,239
公投第１５案,雲林縣,水林鄉,海埔村,253,1022,141,281,422,74,496
公投第１５案,雲林縣,水林鄉,土厝村,254,1191,124,331,455,41,496
公投第１５案,雲林縣,水林鄉,溪墘村,255,779,98,284,382,37,419
公投第１５案,雲林縣,北港鎮,東陽里,256,724,106,266,372,56,428
公投第１５案,雲林縣,北港鎮,光民里,257,688,149,232,381,48,429
公投第１５案,雲林縣,北港鎮,東華里,258,452,61,166,227,38,265
公投第１５案,雲林縣,北港鎮,南安里,259,866,146,305,451,57,508
公投第１５案,雲林縣,北港鎮,中和里,260,336,58,103,161,17,178
公投第１５案,雲林縣,北港鎮,義民里,261,395,44,151,195,21,216
公投第１５案,雲林縣,北港鎮,共榮里,262,376,54,158,212,26,238
公投第１５案,雲林縣,北港鎮,西勢里,263,950,168,340,508,38,546
公投第１５案,雲林縣,北港鎮,仁和里,264,512,101,185,286,40,326
公投第１５案,雲林縣,北港鎮,賜福里,265,324,55,114,169,29,198
公投第１５案,雲林縣,北港鎮,公舘里,266,546,84,178,262,39,301
公投第１５案,雲林縣,北港鎮,大同里,267,433,79,165,244,20,264
公投第１５案,雲林縣,北港鎮,大同里,268,751,106,273,379,53,432
公投第１５案,雲林縣,北港鎮,仁安里,269,442,58,191,249,24,273
公投第１５案,雲林縣,北港鎮,華勝里,270,1151,195,410,605,63,668
公投第１５案,雲林縣,北港鎮,華勝里,271,1224,208,463,671,46,717
公投第１５案,雲林縣,北港鎮,華勝里,272,1211,200,426,626,45,671
公投第１５案,雲林縣,北港鎮,華勝里,273,1326,233,452,685,74,759
公投第１５案,雲林縣,北港鎮,光復里,274,744,135,311,446,35,481
公投第１５案,雲林縣,北港鎮,光復里,275,977,179,406,585,38,623
公投第１５案,雲林縣,北港鎮,扶朝里,276,960,174,308,482,57,539
公投第１５案,雲林縣,北港鎮,水埔里,277,494,56,127,183,10,193
公投第１５案,雲林縣,北港鎮,新街里,278,1364,244,498,742,47,789
公投第１５案,雲林縣,北港鎮,新街里,279,1123,199,394,593,62,655
公投第１５案,雲林縣,北港鎮,新街里,280,1451,268,521,789,40,829
公投第１５案,雲林縣,北港鎮,新街里,281,1162,228,420,648,51,699
公投第１５案,雲林縣,北港鎮,新街里,282,1130,171,371,542,47,589
公投第１５案,雲林縣,北港鎮,劉厝里,283,1149,165,399,564,31,595
公投第１５案,雲林縣,北港鎮,後溝里,284,533,56,157,213,27,240
公投第１５案,雲林縣,北港鎮,後溝里,285,433,202,78,280,12,292
公投第１５案,雲林縣,北港鎮,新厝里,286,377,39,134,173,12,185
公投第１５案,雲林縣,北港鎮,府番里,287,809,91,242,333,20,353
公投第１５案,雲林縣,北港鎮,草湖里,288,1397,182,400,582,86,668
公投第１５案,雲林縣,北港鎮,溝皂里,289,1145,129,326,455,74,529
公投第１５案,雲林縣,北港鎮,番溝里,290,828,82,174,256,58,314
公投第１５案,雲林縣,北港鎮,大北里,291,557,61,153,214,11,225
公投第１５案,雲林縣,北港鎮,好收里,292,1060,163,303,466,43,509
公投第１５案,雲林縣,北港鎮,好收里,293,577,76,166,242,37,279
公投第１５案,雲林縣,北港鎮,樹腳里,294,931,144,197,341,70,411
公投第１５案,雲林縣,北港鎮,樹腳里,295,1018,153,364,517,32,549
公投第１５案,雲林縣,北港鎮,樹腳里,296,1032,184,377,561,30,591
公投第１５案,雲林縣,崙背鄉,東明村,297,1176,190,409,599,57,656
公投第１５案,雲林縣,崙背鄉,西榮村,298,1439,222,456,678,46,724
公投第１５案,雲林縣,崙背鄉,南陽村,299,1027,163,404,567,46,613
公投第１５案,雲林縣,崙背鄉,南陽村,300,1259,201,456,657,44,701
公投第１５案,雲林縣,崙背鄉,崙前村,301,1058,146,352,498,15,513
公投第１５案,雲林縣,崙背鄉,崙前村,302,998,127,297,424,34,458
公投第１５案,雲林縣,崙背鄉,羅厝村,303,968,157,275,432,30,462
公投第１５案,雲林縣,崙背鄉,羅厝村,304,1055,171,332,503,50,553
公投第１５案,雲林縣,崙背鄉,港尾村,305,1315,186,365,551,77,628
公投第１５案,雲林縣,崙背鄉,阿勸村,306,1027,90,210,300,34,334
公投第１５案,雲林縣,崙背鄉,阿勸村,307,997,146,359,505,86,591
公投第１５案,雲林縣,崙背鄉,五魁村,308,807,101,286,387,37,424
公投第１５案,雲林縣,崙背鄉,大有村,309,698,85,172,257,30,287
公投第１５案,雲林縣,崙背鄉,大有村,310,804,107,229,336,42,378
公投第１５案,雲林縣,崙背鄉,豐榮村,311,867,118,271,389,32,421
公投第１５案,雲林縣,崙背鄉,豐榮村,312,886,100,236,336,31,367
公投第１５案,雲林縣,崙背鄉,草湖村,313,1476,159,362,521,93,614
公投第１５案,雲林縣,崙背鄉,舊庄村,314,1159,103,267,370,29,399
公投第１５案,雲林縣,崙背鄉,水尾村,315,1220,165,462,627,73,700
公投第１５案,雲林縣,崙背鄉,枋南村,316,814,143,138,281,41,322
公投第１５案,雲林縣,二崙鄉,崙東村,317,1463,213,475,688,36,724
公投第１５案,雲林縣,二崙鄉,崙西村,318,1738,250,475,725,68,793
公投第１５案,雲林縣,二崙鄉,來惠村,319,625,81,171,252,44,296
公投第１５案,雲林縣,二崙鄉,來惠村,320,1018,150,288,438,67,505
公投第１５案,雲林縣,二崙鄉,三和村,321,448,47,117,164,6,170
公投第１５案,雲林縣,二崙鄉,三和村,322,1048,118,241,359,49,408
公投第１５案,雲林縣,二崙鄉,湳仔村,323,1161,194,377,571,63,634
公投第１５案,雲林縣,二崙鄉,田尾村,324,991,157,315,472,43,515
公投第１５案,雲林縣,二崙鄉,田尾村,325,849,135,313,448,54,502
公投第１５案,雲林縣,二崙鄉,定安村,326,890,128,275,403,47,450
公投第１５案,雲林縣,二崙鄉,永定村,327,1427,224,433,657,76,733
公投第１５案,雲林縣,二崙鄉,大華村,328,891,120,294,414,21,435
公投第１５案,雲林縣,二崙鄉,義庄村,329,757,85,226,311,22,333
公投第１５案,雲林縣,二崙鄉,楊賢村,330,1497,216,402,618,115,733
公投第１５案,雲林縣,二崙鄉,港後村,331,1171,180,315,495,61,556
公投第１５案,雲林縣,二崙鄉,港後村,332,686,110,240,350,54,404
公投第１５案,雲林縣,二崙鄉,大義村,333,864,116,200,316,71,387
公投第１５案,雲林縣,二崙鄉,油車村,334,1073,171,369,540,25,565
公投第１５案,雲林縣,二崙鄉,油車村,335,696,99,162,261,29,290
公投第１５案,雲林縣,二崙鄉,大庄村,336,1271,127,287,414,61,475
公投第１５案,雲林縣,二崙鄉,庄西村,337,912,121,242,363,44,407
公投第１５案,雲林縣,二崙鄉,大同村,338,861,115,236,351,35,386
公投第１５案,雲林縣,二崙鄉,復興村,339,1030,118,285,403,55,458
公投第１５案,雲林縣,西螺鎮,振興里,340,1590,274,489,763,61,824
公投第１５案,雲林縣,西螺鎮,大園里,341,1741,301,600,901,52,953
公投第１５案,雲林縣,西螺鎮,廣福里,342,1080,220,439,659,44,703
公投第１５案,雲林縣,西螺鎮,廣福里,343,1040,213,398,611,44,655
公投第１５案,雲林縣,西螺鎮,正興里,344,1346,214,511,725,36,761
公投第１５案,雲林縣,西螺鎮,正興里,345,1625,256,598,854,36,890
公投第１５案,雲林縣,西螺鎮,永安里,346,354,67,152,219,9,228
公投第１５案,雲林縣,西螺鎮,中和里,347,580,101,195,296,25,321
公投第１５案,雲林縣,西螺鎮,福興里,348,591,120,236,356,19,375
公投第１５案,雲林縣,西螺鎮,光華里,349,1050,204,366,570,51,621
公投第１５案,雲林縣,西螺鎮,中興里,350,1147,214,435,649,60,709
公投第１５案,雲林縣,西螺鎮,中興里,351,1602,265,528,793,68,861
公投第１５案,雲林縣,西螺鎮,漢光里,352,1452,238,497,735,41,776
公投第１５案,雲林縣,西螺鎮,漢光里,353,1578,255,553,808,68,876
公投第１５案,雲林縣,西螺鎮,漢光里,354,1305,195,444,639,28,667
公投第１５案,雲林縣,西螺鎮,新安里,355,1327,182,371,553,51,604
公投第１５案,雲林縣,西螺鎮,新豐里,356,1516,248,493,741,56,797
公投第１５案,雲林縣,西螺鎮,大新里,357,828,122,205,327,26,353
公投第１５案,雲林縣,西螺鎮,大新里,358,788,101,203,304,17,321
公投第１５案,雲林縣,西螺鎮,埤頭里,359,863,131,258,389,58,447
公投第１５案,雲林縣,西螺鎮,東興里,360,984,156,281,437,87,524
公投第１５案,雲林縣,西螺鎮,鹿場里,361,1514,212,466,678,223,901
公投第１５案,雲林縣,西螺鎮,廣興里,362,870,130,288,418,53,471
公投第１５案,雲林縣,西螺鎮,頂湳里,363,971,172,292,464,53,517
公投第１５案,雲林縣,西螺鎮,吳厝里,364,1304,191,360,551,51,602
公投第１５案,雲林縣,西螺鎮,九隆里,365,726,125,200,325,28,353
公投第１５案,雲林縣,西螺鎮,下湳里,366,823,104,302,406,39,445
公投第１５案,雲林縣,西螺鎮,七座里,367,886,97,246,343,21,364
公投第１５案,雲林縣,西螺鎮,公舘里,368,1373,218,382,600,86,686
公投第１５案,雲林縣,西螺鎮,詔安里,369,983,176,297,473,67,540
公投第１５案,雲林縣,西螺鎮,河南里,370,1014,165,326,491,55,546
公投第１５案,雲林縣,西螺鎮,安定里,371,939,143,256,399,77,476
公投第１５案,雲林縣,西螺鎮,安定里,372,866,121,277,398,44,442
公投第１５案,雲林縣,西螺鎮,福田里,373,1486,197,440,637,85,722
公投第１５案,雲林縣,莿桐鄉,莿桐村,374,1507,243,539,782,67,849
公投第１５案,雲林縣,莿桐鄉,莿桐村,375,1300,216,459,675,35,710
公投第１５案,雲林縣,莿桐鄉,莿桐村,376,1272,209,453,662,98,760
公投第１５案,雲林縣,莿桐鄉,甘厝村,377,861,161,242,403,58,461
公投第１５案,雲林縣,莿桐鄉,甘西村,378,1565,256,430,686,64,750
公投第１５案,雲林縣,莿桐鄉,興桐村,379,577,94,184,278,19,297
公投第１５案,雲林縣,莿桐鄉,興桐村,380,636,95,170,265,34,299
公投第１５案,雲林縣,莿桐鄉,義和村,381,1110,199,309,508,73,581
公投第１５案,雲林縣,莿桐鄉,埔子村,382,973,184,345,529,56,585
公投第１５案,雲林縣,莿桐鄉,埔子村,383,985,195,296,491,59,550
公投第１５案,雲林縣,莿桐鄉,大美村,384,1707,283,638,921,94,1015
公投第１５案,雲林縣,莿桐鄉,大美村,385,1284,199,445,644,75,719
公投第１５案,雲林縣,莿桐鄉,埔尾村,386,1293,217,461,678,58,736
公投第１５案,雲林縣,莿桐鄉,興貴村,387,900,133,333,466,44,510
公投第１５案,雲林縣,莿桐鄉,興貴村,388,1040,171,365,536,85,621
公投第１５案,雲林縣,莿桐鄉,饒平村,389,1165,183,380,563,31,594
公投第１５案,雲林縣,莿桐鄉,四合村,390,871,158,280,438,58,496
公投第１５案,雲林縣,莿桐鄉,四合村,391,885,146,349,495,48,543
公投第１５案,雲林縣,莿桐鄉,麻園村,392,1489,204,487,691,69,760
公投第１５案,雲林縣,莿桐鄉,五華村,393,1347,183,431,614,64,678
公投第１５案,雲林縣,莿桐鄉,六合村,394,1150,191,411,602,64,666
公投第１５案,雲林縣,莿桐鄉,六合村,395,653,107,245,352,38,390
公投第１５案,雲林縣,林內鄉,林南村,396,1036,174,431,605,52,657
公投第１５案,雲林縣,林內鄉,林中村,397,1490,249,525,774,64,838
公投第１５案,雲林縣,林內鄉,林中村,398,1491,210,523,733,69,802
公投第１５案,雲林縣,林內鄉,林中村,399,671,73,239,312,45,357
公投第１５案,雲林縣,林內鄉,林北村,400,1436,236,523,759,106,865
公投第１５案,雲林縣,林內鄉,林北村,401,751,133,260,393,51,444
公投第１５案,雲林縣,林內鄉,坪頂村,402,535,96,178,274,22,296
公投第１５案,雲林縣,林內鄉,林茂村,403,811,150,184,334,51,385
公投第１５案,雲林縣,林內鄉,九芎村,404,1339,240,444,684,86,770
公投第１５案,雲林縣,林內鄉,九芎村,405,1286,176,446,622,81,703
公投第１５案,雲林縣,林內鄉,湖本村,406,646,115,212,327,32,359
公投第１５案,雲林縣,林內鄉,烏塗村,407,1158,168,422,590,55,645
公投第１５案,雲林縣,林內鄉,烏麻村,408,1090,195,369,564,56,620
公投第１５案,雲林縣,林內鄉,重興村,409,950,167,347,514,69,583
公投第１５案,雲林縣,林內鄉,重興村,410,861,157,283,440,38,478
公投第１５案,雲林縣,斗六市,信義里,411,644,127,217,344,15,359
公投第１５案,雲林縣,斗六市,四維里,412,617,104,220,324,21,345
公投第１５案,雲林縣,斗六市,太平里,413,764,174,320,494,28,522
公投第１５案,雲林縣,斗六市,中和里,414,784,153,312,465,25,490
公投第１５案,雲林縣,斗六市,光興里,415,760,138,259,397,47,444
公投第１５案,雲林縣,斗六市,鎮西里,416,1881,345,747,1092,49,1141
公投第１５案,雲林縣,斗六市,鎮西里,417,1829,302,655,957,53,1010
公投第１５案,雲林縣,斗六市,鎮東里,418,1255,242,539,781,28,809
公投第１５案,雲林縣,斗六市,鎮東里,419,1090,227,456,683,20,703
公投第１５案,雲林縣,斗六市,文化里,420,1103,213,430,643,29,672
公投第１５案,雲林縣,斗六市,文化里,421,1176,202,469,671,38,709
公投第１５案,雲林縣,斗六市,三平里,422,1529,261,595,856,17,873
公投第１５案,雲林縣,斗六市,三平里,423,1335,209,537,746,43,789
公投第１５案,雲林縣,斗六市,三平里,424,1770,297,703,1000,46,1046
公投第１５案,雲林縣,斗六市,明德里,425,1308,238,478,716,36,752
公投第１５案,雲林縣,斗六市,明德里,426,2171,349,758,1107,68,1175
公投第１５案,雲林縣,斗六市,鎮北里,427,1193,211,485,696,31,727
公投第１５案,雲林縣,斗六市,鎮北里,428,1572,288,651,939,40,979
公投第１５案,雲林縣,斗六市,公誠里,429,1009,181,374,555,18,573
公投第１５案,雲林縣,斗六市,公誠里,430,1195,226,470,696,40,736
公投第１５案,雲林縣,斗六市,忠孝里,431,1415,260,565,825,52,877
公投第１５案,雲林縣,斗六市,仁愛里,432,1101,196,442,638,37,675
公投第１５案,雲林縣,斗六市,八德里,433,1648,276,601,877,45,922
公投第１５案,雲林縣,斗六市,八德里,434,1588,247,550,797,21,818
公投第１５案,雲林縣,斗六市,公正里,435,1392,284,522,806,21,827
公投第１５案,雲林縣,斗六市,公正里,436,1422,274,537,811,22,833
公投第１５案,雲林縣,斗六市,重光里,437,1187,155,409,564,31,595
公投第１５案,雲林縣,斗六市,重光里,438,1142,208,366,574,37,611
公投第１５案,雲林縣,斗六市,林頭里,439,1421,264,583,847,33,880
公投第１５案,雲林縣,斗六市,林頭里,440,1261,202,492,694,32,726
公投第１５案,雲林縣,斗六市,林頭里,441,1506,249,528,777,26,803
公投第１５案,雲林縣,斗六市,成功里,442,1214,257,445,702,28,730
公投第１５案,雲林縣,斗六市,成功里,443,1362,242,574,816,55,871
公投第１５案,雲林縣,斗六市,鎮南里,444,1097,207,389,596,22,618
公投第１５案,雲林縣,斗六市,鎮南里,445,1262,211,490,701,29,730
公投第１５案,雲林縣,斗六市,鎮南里,446,1154,200,407,607,27,634
公投第１５案,雲林縣,斗六市,社口里,447,847,149,328,477,32,509
公投第１５案,雲林縣,斗六市,社口里,448,1439,260,552,812,24,836
公投第１５案,雲林縣,斗六市,龍潭里,449,1747,352,664,1016,49,1065
公投第１５案,雲林縣,斗六市,嘉東里,450,1418,282,488,770,39,809
公投第１５案,雲林縣,斗六市,崙峰里,451,1112,165,436,601,32,633
公投第１５案,雲林縣,斗六市,崙峰里,452,1302,242,483,725,31,756
公投第１５案,雲林縣,斗六市,溝埧里,453,669,129,284,413,20,433
公投第１５案,雲林縣,斗六市,江厝里,454,752,141,258,399,31,430
公投第１５案,雲林縣,斗六市,江厝里,455,1450,258,508,766,25,791
公投第１５案,雲林縣,斗六市,三光里,456,555,91,197,288,34,322
公投第１５案,雲林縣,斗六市,久安里,457,1470,240,490,730,39,769
公投第１５案,雲林縣,斗六市,久安里,458,927,165,371,536,22,558
公投第１５案,雲林縣,斗六市,虎溪里,459,1893,360,702,1062,45,1107
公投第１５案,雲林縣,斗六市,虎溪里,460,1708,264,630,894,80,974
公投第１５案,雲林縣,斗六市,虎溪里,461,1773,247,590,837,56,893
公投第１５案,雲林縣,斗六市,保庄里,462,1412,265,550,815,25,840
公投第１５案,雲林縣,斗六市,保庄里,463,1354,257,552,809,28,837
公投第１５案,雲林縣,斗六市,保庄里,464,1267,253,449,702,20,722
公投第１５案,雲林縣,斗六市,保庄里,465,1273,224,448,672,21,693
公投第１５案,雲林縣,斗六市,長平里,466,1748,131,600,731,77,808
公投第１５案,雲林縣,斗六市,榴中里,467,1238,200,469,669,64,733
公投第１５案,雲林縣,斗六市,榴中里,468,1648,239,613,852,39,891
公投第１５案,雲林縣,斗六市,榴中里,469,1520,272,595,867,51,918
公投第１５案,雲林縣,斗六市,榴北里,470,1087,144,418,562,21,583
公投第１５案,雲林縣,斗六市,榴南里,471,1904,313,703,1016,68,1084
公投第１５案,雲林縣,斗六市,梅林里,472,702,121,285,406,28,434
公投第１５案,雲林縣,斗六市,梅林里,473,1111,204,398,602,56,658
公投第１５案,雲林縣,斗六市,湖山里,474,1123,131,389,520,34,554
公投第１５案,雲林縣,斗六市,長安里,475,1146,164,424,588,32,620
公投第１５案,雲林縣,斗六市,長安里,476,1786,309,611,920,36,956
公投第１５案,雲林縣,斗六市,溪洲里,477,1023,171,364,535,53,588
公投第１５案,雲林縣,斗六市,溪洲里,478,2072,340,731,1071,72,1143
公投第１５案,雲林縣,斗六市,十三里,479,1128,195,382,577,34,611
公投第１５案,雲林縣,大埤鄉,北和村,480,750,125,237,362,38,400
公投第１５案,雲林縣,大埤鄉,吉田村,481,719,123,220,343,26,369
公投第１５案,雲林縣,大埤鄉,豐岡村,482,603,70,223,293,25,318
公投第１５案,雲林縣,大埤鄉,聯美村,483,1106,161,320,481,47,528
公投第１５案,雲林縣,大埤鄉,南和村,484,1495,270,468,738,45,783
公投第１５案,雲林縣,大埤鄉,南和村,485,600,108,224,332,26,358
公投第１５案,雲林縣,大埤鄉,大德村,486,1004,177,365,542,51,593
公投第１５案,雲林縣,大埤鄉,松竹村,487,948,134,232,366,23,389
公投第１５案,雲林縣,大埤鄉,豐田村,488,1539,226,558,784,47,831
公投第１５案,雲林縣,大埤鄉,尚義村,489,1430,196,436,632,56,688
公投第１５案,雲林縣,大埤鄉,尚義村,490,465,54,162,216,23,239
公投第１５案,雲林縣,大埤鄉,嘉興村,491,1307,168,432,600,46,646
公投第１５案,雲林縣,大埤鄉,嘉興村,492,474,89,140,229,20,249
公投第１５案,雲林縣,大埤鄉,三結村,493,1220,233,418,651,79,730
公投第１５案,雲林縣,大埤鄉,怡然村,494,733,102,248,350,21,371
公投第１５案,雲林縣,大埤鄉,北鎮村,495,681,99,253,352,25,377
公投第１５案,雲林縣,大埤鄉,興安村,496,712,99,179,278,22,300
公投第１５案,雲林縣,大埤鄉,西鎮村,497,723,104,195,299,51,350
公投第１５案,雲林縣,斗南鎮,東仁里,498,1166,202,458,660,42,702
公投第１５案,雲林縣,斗南鎮,西岐里,499,1135,211,454,665,34,699
公投第１５案,雲林縣,斗南鎮,西岐里,500,975,195,385,580,27,607
公投第１５案,雲林縣,斗南鎮,大同里,501,1459,291,539,830,39,869
公投第１５案,雲林縣,斗南鎮,大同里,502,1351,260,496,756,42,798
公投第１５案,雲林縣,斗南鎮,南昌里,503,1321,220,485,705,41,746
公投第１５案,雲林縣,斗南鎮,南昌里,504,907,139,316,455,44,499
公投第１５案,雲林縣,斗南鎮,北銘里,505,1473,234,633,867,55,922
公投第１５案,雲林縣,斗南鎮,中天里,506,1277,241,506,747,55,802
公投第１５案,雲林縣,斗南鎮,林子里,507,1333,214,474,688,67,755
公投第１５案,雲林縣,斗南鎮,石龜里,508,777,123,268,391,33,424
公投第１５案,雲林縣,斗南鎮,石溪里,509,877,153,301,454,28,482
公投第１５案,雲林縣,斗南鎮,靖興里,510,899,123,328,451,43,494
公投第１５案,雲林縣,斗南鎮,新南里,511,688,89,195,284,37,321
公投第１５案,雲林縣,斗南鎮,阿丹里,512,1147,168,381,549,27,576
公投第１５案,雲林縣,斗南鎮,將軍里,513,1709,296,583,879,69,948
公投第１５案,雲林縣,斗南鎮,舊社里,514,1042,194,405,599,39,638
公投第１５案,雲林縣,斗南鎮,舊社里,515,1631,383,460,843,45,888
公投第１５案,雲林縣,斗南鎮,明昌里,516,1702,311,653,964,65,1029
公投第１５案,雲林縣,斗南鎮,明昌里,517,1564,278,586,864,57,921
公投第１５案,雲林縣,斗南鎮,僑真里,518,910,112,290,402,25,427
公投第１５案,雲林縣,斗南鎮,僑真里,519,1276,245,516,761,41,802
公投第１５案,雲林縣,斗南鎮,大東里,520,897,120,279,399,17,416
公投第１５案,雲林縣,斗南鎮,埤麻里,521,803,140,274,414,24,438
公投第１５案,雲林縣,斗南鎮,西伯里,522,866,135,327,462,43,505
公投第１５案,雲林縣,斗南鎮,新崙里,523,852,146,304,450,53,503
公投第１５案,雲林縣,斗南鎮,新崙里,524,671,95,243,338,42,380
公投第１５案,雲林縣,斗南鎮,東明里,525,981,173,332,505,24,529
公投第１５案,雲林縣,斗南鎮,新光里,526,1129,176,333,509,29,538
公投第１５案,雲林縣,斗南鎮,新光里,527,1586,287,580,867,71,938
公投第１５案,雲林縣,斗南鎮,田頭里,528,1243,247,474,721,52,773
公投第１５案,雲林縣,斗南鎮,田頭里,529,984,131,322,453,27,480
公投第１５案,雲林縣,斗南鎮,小東里,530,1507,251,533,784,68,852
公投第１５案,雲林縣,古坑鄉,棋盤村,531,1126,176,394,570,55,625
公投第１５案,雲林縣,古坑鄉,棋盤村,532,994,161,313,474,52,526
公投第１５案,雲林縣,古坑鄉,新庄村,533,1517,277,461,738,67,805
公投第１５案,雲林縣,古坑鄉,東和村,534,1302,187,487,674,41,715
公投第１５案,雲林縣,古坑鄉,東和村,535,1772,263,578,841,54,895
公投第１５案,雲林縣,古坑鄉,荷苞村,536,1122,155,416,571,75,646
公投第１５案,雲林縣,古坑鄉,荷苞村,537,304,24,83,107,3,110
公投第１５案,雲林縣,古坑鄉,高林村,538,1169,165,446,611,73,684
公投第１５案,雲林縣,古坑鄉,水碓村,539,1255,198,396,594,58,652
公投第１５案,雲林縣,古坑鄉,田心村,540,1078,211,406,617,36,653
公投第１５案,雲林縣,古坑鄉,古坑村,541,943,134,302,436,26,462
公投第１５案,雲林縣,古坑鄉,古坑村,542,1300,206,400,606,63,669
公投第１５案,雲林縣,古坑鄉,朝陽村,543,964,121,336,457,41,498
公投第１５案,雲林縣,古坑鄉,朝陽村,544,1144,174,401,575,45,620
公投第１５案,雲林縣,古坑鄉,西平村,545,1482,239,495,734,58,792
公投第１５案,雲林縣,古坑鄉,湳仔村,546,688,113,239,352,35,387
公投第１５案,雲林縣,古坑鄉,永光村,547,998,152,315,467,39,506
公投第１５案,雲林縣,古坑鄉,永光村,548,1140,186,424,610,42,652
公投第１５案,雲林縣,古坑鄉,永昌村,549,1102,186,363,549,43,592
公投第１５案,雲林縣,古坑鄉,永昌村,550,956,141,335,476,27,503
公投第１５案,雲林縣,古坑鄉,麻園村,551,695,114,231,345,32,377
公投第１５案,雲林縣,古坑鄉,崁腳村,552,1233,180,406,586,33,619
公投第１５案,雲林縣,古坑鄉,華南村,553,285,30,79,109,11,120
公投第１５案,雲林縣,古坑鄉,華山村,554,734,78,200,278,16,294
公投第１５案,雲林縣,古坑鄉,桂林村,555,1150,182,384,566,70,636
公投第１５案,雲林縣,古坑鄉,樟湖村,556,453,58,168,226,18,244
公投第１５案,雲林縣,古坑鄉,草嶺村,557,571,53,202,255,23,278
公投第１５案,嘉義縣,太保市,太保里,1,1210,200,425,625,54,679
公投第１５案,嘉義縣,太保市,太保里,2,1076,180,381,561,31,592
公投第１５案,嘉義縣,太保市,後庄里,3,488,86,135,221,20,241
公投第１５案,嘉義縣,太保市,前潭里,4,1475,225,421,646,80,726
公投第１５案,嘉義縣,太保市,後潭里,5,790,117,219,336,30,366
公投第１５案,嘉義縣,太保市,後潭里,6,883,120,289,409,34,443
公投第１５案,嘉義縣,太保市,梅埔里,7,758,105,247,352,47,399
公投第１５案,嘉義縣,太保市,梅埔里,8,389,37,112,149,10,159
公投第１５案,嘉義縣,太保市,春珠里,9,1101,160,303,463,50,513
公投第１５案,嘉義縣,太保市,崙頂里,10,853,122,308,430,13,443
公投第１５案,嘉義縣,太保市,安仁里,11,224,40,43,83,9,92
公投第１５案,嘉義縣,太保市,安仁里,12,662,93,183,276,46,322
公投第１５案,嘉義縣,太保市,安仁里,13,1630,269,671,940,32,972
公投第１５案,嘉義縣,太保市,東勢里,14,913,114,291,405,29,434
公投第１５案,嘉義縣,太保市,東勢里,15,779,161,262,423,11,434
公投第１５案,嘉義縣,太保市,新埤里,16,1278,228,374,602,107,709
公投第１５案,嘉義縣,太保市,舊埤里,17,819,122,240,362,32,394
公投第１５案,嘉義縣,太保市,舊埤里,18,1573,248,506,754,32,786
公投第１５案,嘉義縣,太保市,田尾里,19,481,71,158,229,33,262
公投第１５案,嘉義縣,太保市,田尾里,20,245,45,98,143,5,148
公投第１５案,嘉義縣,太保市,港尾里,21,317,107,57,164,14,178
公投第１５案,嘉義縣,太保市,港尾里,22,258,46,80,126,7,133
公投第１５案,嘉義縣,太保市,過溝里,23,611,85,199,284,49,333
公投第１５案,嘉義縣,太保市,過溝里,24,1526,260,590,850,41,891
公投第１５案,嘉義縣,太保市,過溝里,25,1196,242,413,655,21,676
公投第１５案,嘉義縣,太保市,麻寮里,26,1536,265,491,756,93,849
公投第１５案,嘉義縣,太保市,麻寮里,27,1481,262,500,762,61,823
公投第１５案,嘉義縣,太保市,麻寮里,28,1450,241,512,753,41,794
公投第１５案,嘉義縣,太保市,南新里,29,840,135,259,394,25,419
公投第１５案,嘉義縣,太保市,南新里,30,989,201,311,512,30,542
公投第１５案,嘉義縣,太保市,北新里,31,1529,237,596,833,65,898
公投第１５案,嘉義縣,太保市,北新里,32,1511,284,518,802,49,851
公投第１５案,嘉義縣,太保市,埤鄉里,33,697,109,193,302,35,337
公投第１５案,嘉義縣,鹿草鄉,後寮村,34,522,84,126,210,31,241
公投第１５案,嘉義縣,鹿草鄉,鹿東村,35,563,112,151,263,41,304
公投第１５案,嘉義縣,鹿草鄉,鹿草村,36,1304,191,381,572,73,645
公投第１５案,嘉義縣,鹿草鄉,西井村,37,1312,198,409,607,53,660
公投第１５案,嘉義縣,鹿草鄉,豊稠村,38,320,44,95,139,7,146
公投第１５案,嘉義縣,鹿草鄉,豊稠村,39,418,32,75,107,3,110
公投第１５案,嘉義縣,鹿草鄉,重寮村,40,1025,128,258,386,59,445
公投第１５案,嘉義縣,鹿草鄉,施家村,41,451,65,101,166,20,186
公投第１５案,嘉義縣,鹿草鄉,下潭村,42,830,95,256,351,94,445
公投第１５案,嘉義縣,鹿草鄉,光潭村,43,1050,145,276,421,69,490
公投第１５案,嘉義縣,鹿草鄉,碧潭村,44,972,108,218,326,72,398
公投第１５案,嘉義縣,鹿草鄉,松竹村,45,962,140,252,392,54,446
公投第１５案,嘉義縣,鹿草鄉,竹山村,46,678,124,169,293,53,346
公投第１５案,嘉義縣,鹿草鄉,竹山村,47,262,27,90,117,20,137
公投第１５案,嘉義縣,鹿草鄉,後堀村,48,906,124,219,343,48,391
公投第１５案,嘉義縣,鹿草鄉,後堀村,49,306,29,69,98,10,108
公投第１５案,嘉義縣,鹿草鄉,三角村,50,1062,149,323,472,72,544
公投第１５案,嘉義縣,鹿草鄉,三角村,51,373,52,122,174,23,197
公投第１５案,嘉義縣,鹿草鄉,下麻村,52,324,49,103,152,23,175
公投第１５案,嘉義縣,鹿草鄉,下麻村,53,297,100,33,133,16,149
公投第１５案,嘉義縣,水上鄉,水上村,54,1024,154,332,486,29,515
公投第１５案,嘉義縣,水上鄉,水上村,55,1015,190,369,559,56,615
公投第１５案,嘉義縣,水上鄉,水上村,56,1932,280,596,876,70,946
公投第１５案,嘉義縣,水上鄉,水頭村,57,1170,214,434,648,35,683
公投第１５案,嘉義縣,水上鄉,水頭村,58,1305,203,490,693,73,766
公投第１５案,嘉義縣,水上鄉,粗溪村,59,1242,190,377,567,52,619
公投第１５案,嘉義縣,水上鄉,粗溪村,60,324,52,89,141,18,159
公投第１５案,嘉義縣,水上鄉,下寮村,61,622,89,211,300,25,325
公投第１５案,嘉義縣,水上鄉,下寮村,62,1216,185,398,583,61,644
公投第１５案,嘉義縣,水上鄉,三和村,63,1020,161,368,529,29,558
公投第１５案,嘉義縣,水上鄉,三和村,64,771,159,290,449,32,481
公投第１５案,嘉義縣,水上鄉,回歸村,65,441,66,189,255,22,277
公投第１５案,嘉義縣,水上鄉,大堀村,66,626,133,224,357,56,413
公投第１５案,嘉義縣,水上鄉,大堀村,67,570,118,190,308,31,339
公投第１５案,嘉義縣,水上鄉,大堀村,68,368,49,120,169,23,192
公投第１５案,嘉義縣,水上鄉,大崙村,69,1037,160,284,444,92,536
公投第１５案,嘉義縣,水上鄉,大崙村,70,1065,189,330,519,61,580
公投第１５案,嘉義縣,水上鄉,塗溝村,71,802,144,294,438,72,510
公投第１５案,嘉義縣,水上鄉,龍德村,72,1948,332,595,927,46,973
公投第１５案,嘉義縣,水上鄉,溪洲村,73,1028,149,315,464,65,529
公投第１５案,嘉義縣,水上鄉,三鎮村,74,641,109,232,341,32,373
公投第１５案,嘉義縣,水上鄉,靖和村,75,408,68,156,224,16,240
公投第１５案,嘉義縣,水上鄉,南和村,76,794,146,263,409,49,458
公投第１５案,嘉義縣,水上鄉,南和村,77,569,77,176,253,19,272
公投第１５案,嘉義縣,水上鄉,柳新村,78,806,120,294,414,37,451
公投第１５案,嘉義縣,水上鄉,柳新村,79,960,130,343,473,80,553
公投第１５案,嘉義縣,水上鄉,柳林村,80,2035,349,690,1039,75,1114
公投第１５案,嘉義縣,水上鄉,柳鄉村,81,1987,314,655,969,90,1059
公投第１５案,嘉義縣,水上鄉,內溪村,82,1154,186,402,588,36,624
公投第１５案,嘉義縣,水上鄉,寬士村,83,2208,280,752,1032,81,1113
公投第１５案,嘉義縣,水上鄉,寬士村,84,2102,261,611,872,65,937
公投第１５案,嘉義縣,水上鄉,民生村,85,1309,163,437,600,57,657
公投第１５案,嘉義縣,水上鄉,民生村,86,1671,274,573,847,60,907
公投第１５案,嘉義縣,水上鄉,義興村,87,822,121,280,401,46,447
公投第１５案,嘉義縣,水上鄉,中庄村,88,1772,240,591,831,62,893
公投第１５案,嘉義縣,水上鄉,忠和村,89,1919,266,651,917,87,1004
公投第１５案,嘉義縣,水上鄉,南鄉村,90,912,93,299,392,21,413
公投第１５案,嘉義縣,水上鄉,三界村,91,992,132,351,483,22,505
公投第１５案,嘉義縣,水上鄉,國姓村,92,1270,166,358,524,45,569
公投第１５案,嘉義縣,民雄鄉,東榮村,93,1267,237,442,679,54,733
公投第１５案,嘉義縣,民雄鄉,東榮村,94,1030,159,336,495,30,525
公投第１５案,嘉義縣,民雄鄉,中樂村,95,1590,274,586,860,89,949
公投第１５案,嘉義縣,民雄鄉,西安村,96,1673,548,283,831,26,857
公投第１５案,嘉義縣,民雄鄉,西安村,97,1718,334,586,920,66,986
公投第１５案,嘉義縣,民雄鄉,寮頂村,98,1040,191,376,567,47,614
公投第１５案,嘉義縣,民雄鄉,寮頂村,99,1100,189,340,529,52,581
公投第１５案,嘉義縣,民雄鄉,福權村,100,1559,238,483,721,76,797
公投第１５案,嘉義縣,民雄鄉,東湖村,101,1862,294,573,867,79,946
公投第１５案,嘉義縣,民雄鄉,頂崙村,102,1435,264,472,736,73,809
公投第１５案,嘉義縣,民雄鄉,菁埔村,103,1751,277,507,784,168,952
公投第１５案,嘉義縣,民雄鄉,中和村,104,933,142,330,472,60,532
公投第１５案,嘉義縣,民雄鄉,平和村,105,827,161,312,473,44,517
公投第１５案,嘉義縣,民雄鄉,西昌村,106,843,120,228,348,55,403
公投第１５案,嘉義縣,民雄鄉,豊收村,107,1774,279,588,867,69,936
公投第１５案,嘉義縣,民雄鄉,豊收村,108,385,54,112,166,16,182
公投第１５案,嘉義縣,民雄鄉,三興村,109,1306,250,476,726,33,759
公投第１５案,嘉義縣,民雄鄉,東興村,110,535,83,196,279,41,320
公投第１５案,嘉義縣,民雄鄉,鎮北村,111,1055,187,358,545,72,617
公投第１５案,嘉義縣,民雄鄉,北斗村,112,1476,225,528,753,46,799
公投第１５案,嘉義縣,民雄鄉,北斗村,113,1583,212,534,746,49,795
公投第１５案,嘉義縣,民雄鄉,北斗村,114,758,111,215,326,28,354
公投第１５案,嘉義縣,民雄鄉,北斗村,115,1354,210,421,631,44,675
公投第１５案,嘉義縣,民雄鄉,双福村,116,1202,182,409,591,101,692
公投第１５案,嘉義縣,民雄鄉,双福村,117,1175,206,397,603,44,647
公投第１５案,嘉義縣,民雄鄉,福樂村,118,1423,238,441,679,45,724
公投第１５案,嘉義縣,民雄鄉,福樂村,119,1612,240,573,813,37,850
公投第１５案,嘉義縣,民雄鄉,福樂村,120,1695,286,615,901,34,935
公投第１５案,嘉義縣,民雄鄉,福樂村,121,1665,238,495,733,54,787
公投第１５案,嘉義縣,民雄鄉,大崎村,122,1019,121,318,439,57,496
公投第１５案,嘉義縣,民雄鄉,大崎村,123,1352,190,447,637,63,700
公投第１５案,嘉義縣,民雄鄉,秀林村,124,1620,297,523,820,77,897
公投第１５案,嘉義縣,民雄鄉,秀林村,125,943,150,281,431,43,474
公投第１５案,嘉義縣,民雄鄉,松山村,126,1720,215,522,737,60,797
公投第１５案,嘉義縣,民雄鄉,興中村,127,1875,235,643,878,82,960
公投第１５案,嘉義縣,民雄鄉,興南村,128,1305,230,456,686,45,731
公投第１５案,嘉義縣,民雄鄉,興南村,129,1441,255,436,691,61,752
公投第１５案,嘉義縣,民雄鄉,金興村,130,1413,228,492,720,63,783
公投第１５案,嘉義縣,民雄鄉,金興村,131,1560,244,519,763,69,832
公投第１５案,嘉義縣,民雄鄉,福興村,132,2004,334,671,1005,101,1106
公投第１５案,嘉義縣,民雄鄉,文隆村,133,1354,246,485,731,67,798
公投第１５案,嘉義縣,民雄鄉,文隆村,134,1076,180,388,568,29,597
公投第１５案,嘉義縣,民雄鄉,山中村,135,1629,234,553,787,128,915
公投第１５案,嘉義縣,民雄鄉,山中村,136,1977,285,643,928,76,1004
公投第１５案,嘉義縣,民雄鄉,中央村,137,1295,206,395,601,71,672
公投第１５案,嘉義縣,新港鄉,宮前村,138,1087,176,371,547,35,582
公投第１５案,嘉義縣,新港鄉,宮前村,139,1116,228,449,677,62,739
公投第１５案,嘉義縣,新港鄉,宮後村,140,740,115,244,359,53,412
公投第１５案,嘉義縣,新港鄉,宮後村,141,827,141,234,375,65,440
公投第１５案,嘉義縣,新港鄉,大興村,142,704,122,255,377,55,432
公投第１５案,嘉義縣,新港鄉,大興村,143,768,161,263,424,52,476
公投第１５案,嘉義縣,新港鄉,福德村,144,761,155,254,409,47,456
公投第１５案,嘉義縣,新港鄉,福德村,145,850,127,257,384,62,446
公投第１５案,嘉義縣,新港鄉,古民村,146,1327,198,440,638,63,701
公投第１５案,嘉義縣,新港鄉,中庄村,147,756,124,234,358,61,419
公投第１５案,嘉義縣,新港鄉,中庄村,148,816,136,236,372,92,464
公投第１５案,嘉義縣,新港鄉,大潭村,149,667,99,185,284,26,310
公投第１５案,嘉義縣,新港鄉,大潭村,150,942,151,293,444,58,502
公投第１５案,嘉義縣,新港鄉,西庄村,151,918,109,262,371,71,442
公投第１５案,嘉義縣,新港鄉,埤子村,152,554,60,161,221,18,239
公投第１５案,嘉義縣,新港鄉,南崙村,153,929,39,270,309,46,355
公投第１５案,嘉義縣,新港鄉,北崙村,154,487,70,91,161,44,205
公投第１５案,嘉義縣,新港鄉,海瀛村,155,487,64,161,225,45,270
公投第１５案,嘉義縣,新港鄉,月眉村,156,836,143,233,376,47,423
公投第１５案,嘉義縣,新港鄉,月眉村,157,845,149,267,416,53,469
公投第１５案,嘉義縣,新港鄉,月潭村,158,834,168,248,416,46,462
公投第１５案,嘉義縣,新港鄉,月潭村,159,753,143,234,377,48,425
公投第１５案,嘉義縣,新港鄉,溪北村,160,1328,207,409,616,87,703
公投第１５案,嘉義縣,新港鄉,菜公村,161,969,177,333,510,46,556
公投第１５案,嘉義縣,新港鄉,中洋村,162,1043,187,366,553,67,620
公投第１５案,嘉義縣,新港鄉,三間村,163,1400,244,547,791,56,847
公投第１５案,嘉義縣,新港鄉,安和村,164,1017,112,223,335,30,365
公投第１５案,嘉義縣,新港鄉,潭大村,165,1132,152,315,467,52,519
公投第１５案,嘉義縣,新港鄉,南港村,166,1037,161,306,467,73,540
公投第１５案,嘉義縣,新港鄉,板頭村,167,563,82,188,270,63,333
公投第１５案,嘉義縣,新港鄉,共和村,168,849,130,268,398,25,423
公投第１５案,嘉義縣,大林鎮,東林里,169,483,80,160,240,28,268
公投第１５案,嘉義縣,大林鎮,西林里,170,1823,312,639,951,67,1018
公投第１５案,嘉義縣,大林鎮,吉林里,171,955,152,363,515,20,535
公投第１５案,嘉義縣,大林鎮,平林里,172,1436,243,467,710,37,747
公投第１５案,嘉義縣,大林鎮,平林里,173,1390,260,435,695,70,765
公投第１５案,嘉義縣,大林鎮,平林里,174,1512,274,498,772,73,845
公投第１５案,嘉義縣,大林鎮,平林里,175,1536,292,532,824,51,875
公投第１５案,嘉義縣,大林鎮,明華里,176,1165,159,360,519,40,559
公投第１５案,嘉義縣,大林鎮,明和里,177,1730,275,685,960,58,1018
公投第１５案,嘉義縣,大林鎮,排路里,178,602,66,173,239,21,260
公投第１５案,嘉義縣,大林鎮,西結里,179,716,121,188,309,49,358
公投第１５案,嘉義縣,大林鎮,湖北里,180,625,71,165,236,9,245
公投第１５案,嘉義縣,大林鎮,大糖里,181,193,26,43,69,5,74
公投第１５案,嘉義縣,大林鎮,大美里,182,1642,219,458,677,77,754
公投第１５案,嘉義縣,大林鎮,過溪里,183,1465,206,496,702,61,763
公投第１５案,嘉義縣,大林鎮,中坑里,184,928,110,255,365,46,411
公投第１５案,嘉義縣,大林鎮,中坑里,185,361,36,98,134,26,160
公投第１５案,嘉義縣,大林鎮,上林里,186,814,108,264,372,19,391
公投第１５案,嘉義縣,大林鎮,中林里,187,1579,237,466,703,49,752
公投第１５案,嘉義縣,大林鎮,三和里,188,2041,389,559,948,100,1048
公投第１５案,嘉義縣,大林鎮,溝背里,189,931,119,293,412,62,474
公投第１５案,嘉義縣,大林鎮,義和里,190,675,109,195,304,43,347
公投第１５案,嘉義縣,大林鎮,內林里,191,655,76,225,301,24,325
公投第１５案,嘉義縣,大林鎮,三角里,192,833,113,261,374,36,410
公投第１５案,嘉義縣,大林鎮,三村里,193,832,138,316,454,46,500
公投第１５案,嘉義縣,溪口鄉,溪東村,194,1318,221,433,654,99,753
公投第１５案,嘉義縣,溪口鄉,溪西村,195,677,128,219,347,48,395
公投第１５案,嘉義縣,溪口鄉,溪北村,196,417,60,134,194,17,211
公投第１５案,嘉義縣,溪口鄉,溪北村,197,273,45,90,135,18,153
公投第１５案,嘉義縣,溪口鄉,柳溝村,198,908,154,310,464,66,530
公投第１５案,嘉義縣,溪口鄉,柳溝村,199,386,69,95,164,10,174
公投第１５案,嘉義縣,溪口鄉,疊溪村,200,1039,192,327,519,57,576
公投第１５案,嘉義縣,溪口鄉,妙崙村,201,708,102,181,283,48,331
公投第１５案,嘉義縣,溪口鄉,坪頂村,202,909,137,259,396,22,418
公投第１５案,嘉義縣,溪口鄉,柴林村,203,786,132,257,389,44,433
公投第１５案,嘉義縣,溪口鄉,林腳村,204,807,119,223,342,44,386
公投第１５案,嘉義縣,溪口鄉,美南村,205,1168,144,286,430,24,454
公投第１５案,嘉義縣,溪口鄉,美北村,206,1052,176,313,489,99,588
公投第１５案,嘉義縣,溪口鄉,本厝村,207,565,87,157,244,41,285
公投第１５案,嘉義縣,溪口鄉,本厝村,208,388,52,128,180,29,209
公投第１５案,嘉義縣,溪口鄉,游西村,209,701,97,176,273,23,296
公投第１５案,嘉義縣,溪口鄉,游東村,210,1003,109,282,391,37,428
公投第１５案,嘉義縣,梅山鄉,梅東村,211,1041,170,336,506,29,535
公投第１５案,嘉義縣,梅山鄉,梅東村,212,1245,220,430,650,92,742
公投第１５案,嘉義縣,梅山鄉,梅南村,213,917,176,331,507,63,570
公投第１５案,嘉義縣,梅山鄉,梅北村,214,1189,190,406,596,43,639
公投第１５案,嘉義縣,梅山鄉,梅北村,215,1388,223,483,706,62,768
公投第１５案,嘉義縣,梅山鄉,梅北村,216,1827,295,623,918,54,972
公投第１５案,嘉義縣,梅山鄉,過山村,217,545,116,180,296,48,344
公投第１５案,嘉義縣,梅山鄉,圳南村,218,407,58,95,153,30,183
公投第１５案,嘉義縣,梅山鄉,圳北村,219,636,89,239,328,32,360
公投第１５案,嘉義縣,梅山鄉,双溪村,220,576,94,192,286,48,334
公投第１５案,嘉義縣,梅山鄉,大南村,221,1674,251,587,838,87,925
公投第１５案,嘉義縣,梅山鄉,安靖村,222,858,100,268,368,16,384
公投第１５案,嘉義縣,梅山鄉,永興村,223,526,79,226,305,22,327
公投第１５案,嘉義縣,梅山鄉,半天村,224,372,48,102,150,30,180
公投第１５案,嘉義縣,梅山鄉,太平村,225,506,76,155,231,22,253
公投第１５案,嘉義縣,梅山鄉,太興村,226,433,70,199,269,39,308
公投第１５案,嘉義縣,梅山鄉,龍眼村,227,404,41,114,155,9,164
公投第１５案,嘉義縣,梅山鄉,碧湖村,228,293,45,93,138,10,148
公投第１５案,嘉義縣,梅山鄉,瑞峯村,229,712,97,292,389,62,451
公投第１５案,嘉義縣,梅山鄉,瑞里村,230,602,76,259,335,38,373
公投第１５案,嘉義縣,梅山鄉,太和村,231,515,58,164,222,29,251
公投第１５案,嘉義縣,梅山鄉,太和村,232,417,40,114,154,10,164
公投第１５案,嘉義縣,朴子市,安福里,233,1183,232,375,607,33,640
公投第１５案,嘉義縣,朴子市,安福里,234,755,117,259,376,38,414
公投第１５案,嘉義縣,朴子市,平和里,235,1253,220,427,647,33,680
公投第１５案,嘉義縣,朴子市,平和里,236,1078,207,395,602,48,650
公投第１５案,嘉義縣,朴子市,內厝里,237,1117,229,392,621,64,685
公投第１５案,嘉義縣,朴子市,開元里,238,387,84,128,212,19,231
公投第１５案,嘉義縣,朴子市,順天里,239,633,96,220,316,43,359
公投第１５案,嘉義縣,朴子市,中正里,240,650,126,219,345,23,368
公投第１５案,嘉義縣,朴子市,博厚里,241,825,141,347,488,34,522
公投第１５案,嘉義縣,朴子市,文化里,242,810,145,262,407,39,446
公投第１５案,嘉義縣,朴子市,文化里,243,940,145,361,506,45,551
公投第１５案,嘉義縣,朴子市,永和里,244,905,132,301,433,54,487
公投第１５案,嘉義縣,朴子市,永和里,245,1605,248,477,725,37,762
公投第１５案,嘉義縣,朴子市,竹圍里,246,1479,288,523,811,38,849
公投第１５案,嘉義縣,朴子市,竹圍里,247,1218,218,443,661,41,702
公投第１５案,嘉義縣,朴子市,竹圍里,248,1496,250,549,799,56,855
公投第１５案,嘉義縣,朴子市,新寮里,249,667,99,243,342,22,364
公投第１５案,嘉義縣,朴子市,双溪里,250,627,71,167,238,16,254
公投第１５案,嘉義縣,朴子市,溪口里,251,791,90,261,351,44,395
公投第１５案,嘉義縣,朴子市,德興里,252,1034,153,328,481,92,573
公投第１５案,嘉義縣,朴子市,仁和里,253,1710,297,513,810,26,836
公投第１５案,嘉義縣,朴子市,大鄉里,254,1671,226,528,754,39,793
公投第１５案,嘉義縣,朴子市,大鄉里,255,1547,187,439,626,42,668
公投第１５案,嘉義縣,朴子市,大葛里,256,1602,180,422,602,54,656
公投第１５案,嘉義縣,朴子市,大葛里,257,1302,223,497,720,21,741
公投第１５案,嘉義縣,朴子市,佳禾里,258,740,91,243,334,42,376
公投第１５案,嘉義縣,朴子市,竹村里,259,1054,171,389,560,61,621
公投第１５案,嘉義縣,朴子市,崁前里,260,907,96,251,347,20,367
公投第１５案,嘉義縣,朴子市,崁後里,261,720,102,180,282,30,312
公投第１５案,嘉義縣,朴子市,順安里,262,251,40,76,116,30,146
公投第１５案,嘉義縣,朴子市,德家里,263,767,103,181,284,51,335
公投第１５案,嘉義縣,朴子市,新庄里,264,702,105,235,340,50,390
公投第１５案,嘉義縣,朴子市,梅華里,265,1038,127,297,424,65,489
公投第１５案,嘉義縣,朴子市,松華里,266,1228,127,254,381,28,409
公投第１５案,嘉義縣,朴子市,南竹里,267,499,60,147,207,50,257
公投第１５案,嘉義縣,六腳鄉,蒜頭村,268,1165,146,331,477,35,512
公投第１５案,嘉義縣,六腳鄉,蒜東村,269,825,76,187,263,21,284
公投第１５案,嘉義縣,六腳鄉,蒜南村,270,850,120,235,355,30,385
公投第１５案,嘉義縣,六腳鄉,工廠村,271,222,38,76,114,18,132
公投第１５案,嘉義縣,六腳鄉,灣南村,272,1216,200,337,537,57,594
公投第１５案,嘉義縣,六腳鄉,灣北村,273,1200,141,280,421,44,465
公投第１５案,嘉義縣,六腳鄉,雙涵村,274,877,122,247,369,41,410
公投第１５案,嘉義縣,六腳鄉,塗師村,275,644,93,143,236,37,273
公投第１５案,嘉義縣,六腳鄉,三義村,276,594,69,129,198,16,214
公投第１５案,嘉義縣,六腳鄉,三義村,277,167,10,28,38,2,40
公投第１５案,嘉義縣,六腳鄉,正義村,278,204,28,42,70,2,72
公投第１５案,嘉義縣,六腳鄉,正義村,279,234,38,48,86,3,89
公投第１５案,嘉義縣,六腳鄉,正義村,280,361,35,106,141,4,145
公投第１５案,嘉義縣,六腳鄉,正義村,281,592,91,196,287,46,333
公投第１５案,嘉義縣,六腳鄉,溪厝村,282,619,86,191,277,35,312
公投第１５案,嘉義縣,六腳鄉,港美村,283,714,75,158,233,47,280
公投第１５案,嘉義縣,六腳鄉,豐美村,284,1051,138,311,449,65,514
公投第１５案,嘉義縣,六腳鄉,六斗村,285,934,142,281,423,61,484
公投第１５案,嘉義縣,六腳鄉,崙陽村,286,1044,147,310,457,57,514
公投第１５案,嘉義縣,六腳鄉,蘇厝村,287,1476,187,404,591,38,629
公投第１５案,嘉義縣,六腳鄉,竹本村,288,618,69,134,203,21,224
公投第１５案,嘉義縣,六腳鄉,永賢村,289,478,42,82,124,38,162
公投第１５案,嘉義縣,六腳鄉,魚寮村,290,642,61,131,192,44,236
公投第１５案,嘉義縣,六腳鄉,潭墘村,291,883,91,186,277,9,286
公投第１５案,嘉義縣,六腳鄉,六腳村,292,739,59,170,229,11,240
公投第１５案,嘉義縣,六腳鄉,六南村,293,554,72,120,192,26,218
公投第１５案,嘉義縣,六腳鄉,崩山村,294,649,59,135,194,25,219
公投第１５案,嘉義縣,六腳鄉,古林村,295,689,75,148,223,21,244
公投第１５案,嘉義縣,六腳鄉,更寮村,296,455,46,113,159,17,176
公投第１５案,嘉義縣,六腳鄉,更寮村,297,125,12,23,35,2,37
公投第１５案,嘉義縣,東石鄉,東石村,298,1915,212,600,812,68,880
公投第１５案,嘉義縣,東石鄉,猿樹村,299,938,107,221,328,50,378
公投第１５案,嘉義縣,東石鄉,型厝村,300,1366,112,259,371,30,401
公投第１５案,嘉義縣,東石鄉,塭港村,301,1676,146,486,632,5,637
公投第１５案,嘉義縣,東石鄉,三家村,302,1151,119,280,399,75,474
公投第１５案,嘉義縣,東石鄉,永屯村,303,716,74,189,263,58,321
公投第１５案,嘉義縣,東石鄉,海埔村,304,387,19,95,114,17,131
公投第１５案,嘉義縣,東石鄉,龍港村,305,864,58,174,232,16,248
公投第１５案,嘉義縣,東石鄉,副瀨村,306,910,86,191,277,20,297
公投第１５案,嘉義縣,東石鄉,下揖村,307,760,64,186,250,15,265
公投第１５案,嘉義縣,東石鄉,頂揖村,308,166,14,59,73,14,87
公投第１５案,嘉義縣,東石鄉,頂揖村,309,212,17,51,68,12,80
公投第１５案,嘉義縣,東石鄉,溪下村,310,993,80,212,292,39,331
公投第１５案,嘉義縣,東石鄉,港口村,311,306,26,80,106,13,119
公投第１５案,嘉義縣,東石鄉,鰲鼓村,312,1046,99,252,351,60,411
公投第１５案,嘉義縣,東石鄉,鰲鼓村,313,235,16,58,74,16,90
公投第１５案,嘉義縣,東石鄉,港墘村,314,1226,140,342,482,74,556
公投第１５案,嘉義縣,東石鄉,蔦松村,315,843,101,204,305,62,367
公投第１５案,嘉義縣,東石鄉,圍潭村,316,693,81,178,259,30,289
公投第１５案,嘉義縣,東石鄉,洲仔村,317,839,95,272,367,45,412
公投第１５案,嘉義縣,東石鄉,東崙村,318,363,38,111,149,14,163
公投第１５案,嘉義縣,東石鄉,東崙村,319,321,34,66,100,12,112
公投第１５案,嘉義縣,東石鄉,西崙村,320,1083,132,373,505,91,596
公投第１５案,嘉義縣,東石鄉,塭仔村,321,901,118,248,366,50,416
公投第１５案,嘉義縣,東石鄉,網寮村,322,1216,91,275,366,40,406
公投第１５案,嘉義縣,東石鄉,掌潭村,323,418,60,142,202,47,249
公投第１５案,嘉義縣,東石鄉,掌潭村,324,371,40,103,143,12,155
公投第１５案,嘉義縣,布袋鎮,岱江里,325,614,81,196,277,22,299
公投第１５案,嘉義縣,布袋鎮,九龍里,326,372,37,109,146,23,169
公投第１５案,嘉義縣,布袋鎮,岑海里,327,914,139,300,439,72,511
公投第１５案,嘉義縣,布袋鎮,岑海里,328,1198,171,390,561,75,636
公投第１５案,嘉義縣,布袋鎮,興中里,329,1113,120,343,463,60,523
公投第１５案,嘉義縣,布袋鎮,光復里,330,992,150,307,457,58,515
公投第１５案,嘉義縣,布袋鎮,光復里,331,689,82,247,329,12,341
公投第１５案,嘉義縣,布袋鎮,見龍里,332,882,124,282,406,54,460
公投第１５案,嘉義縣,布袋鎮,新厝里,333,731,95,242,337,44,381
公投第１５案,嘉義縣,布袋鎮,龍江里,334,779,94,293,387,35,422
公投第１５案,嘉義縣,布袋鎮,振寮里,335,762,90,215,305,35,340
公投第１５案,嘉義縣,布袋鎮,西安里,336,1184,142,334,476,57,533
公投第１５案,嘉義縣,布袋鎮,中安里,337,1423,136,361,497,73,570
公投第１５案,嘉義縣,布袋鎮,東安里,338,1351,170,322,492,60,552
公投第１５案,嘉義縣,布袋鎮,樹林里,339,275,27,88,115,5,120
公投第１５案,嘉義縣,布袋鎮,樹林里,340,243,34,67,101,14,115
公投第１５案,嘉義縣,布袋鎮,貴舍里,341,661,89,184,273,90,363
公投第１５案,嘉義縣,布袋鎮,永安里,342,1145,138,354,492,45,537
公投第１５案,嘉義縣,布袋鎮,東港里,343,936,119,284,403,35,438
公投第１５案,嘉義縣,布袋鎮,東港里,344,958,141,272,413,41,454
公投第１５案,嘉義縣,布袋鎮,江山里,345,298,42,80,122,13,135
公投第１５案,嘉義縣,布袋鎮,菜舖里,346,428,63,146,209,39,248
公投第１５案,嘉義縣,布袋鎮,考試里,347,121,15,38,53,1,54
公投第１５案,嘉義縣,布袋鎮,考試里,348,174,6,39,45,6,51
公投第１５案,嘉義縣,布袋鎮,新岑里,349,953,120,290,410,43,453
公投第１５案,嘉義縣,布袋鎮,新民里,350,1292,175,460,635,55,690
公投第１５案,嘉義縣,布袋鎮,復興里,351,1127,142,414,556,51,607
公投第１５案,嘉義縣,布袋鎮,復興里,352,1244,157,406,563,39,602
公投第１５案,嘉義縣,布袋鎮,好美里,353,1106,149,332,481,23,504
公投第１５案,嘉義縣,義竹鄉,岸腳村,354,482,65,141,206,25,231
公投第１５案,嘉義縣,義竹鄉,岸腳村,355,223,33,78,111,19,130
公投第１５案,嘉義縣,義竹鄉,義竹村,356,1529,256,467,723,101,824
公投第１５案,嘉義縣,義竹鄉,六桂村,357,1175,194,395,589,70,659
公投第１５案,嘉義縣,義竹鄉,仁里村,358,886,150,344,494,53,547
公投第１５案,嘉義縣,義竹鄉,傳芳村,359,743,99,204,303,32,335
公投第１５案,嘉義縣,義竹鄉,頭竹村,360,1236,203,387,590,90,680
公投第１５案,嘉義縣,義竹鄉,五厝村,361,377,58,115,173,21,194
公投第１５案,嘉義縣,義竹鄉,中平村,362,338,44,85,129,25,154
公投第１５案,嘉義縣,義竹鄉,中平村,363,102,15,40,55,4,59
公投第１５案,嘉義縣,義竹鄉,埤前村,364,763,112,201,313,22,335
公投第１５案,嘉義縣,義竹鄉,平溪村,365,429,69,147,216,31,247
公投第１５案,嘉義縣,義竹鄉,後鎮村,366,427,55,136,191,21,212
公投第１５案,嘉義縣,義竹鄉,北華村,367,607,96,189,285,46,331
公投第１５案,嘉義縣,義竹鄉,新店村,368,1486,206,432,638,45,683
公投第１５案,嘉義縣,義竹鄉,東過村,369,835,129,289,418,62,480
公投第１５案,嘉義縣,義竹鄉,西過村,370,816,106,188,294,60,354
公投第１５案,嘉義縣,義竹鄉,官和村,371,833,124,199,323,61,384
公投第１５案,嘉義縣,義竹鄉,官順村,372,433,50,150,200,14,214
公投第１５案,嘉義縣,義竹鄉,新富村,373,558,87,152,239,6,245
公投第１５案,嘉義縣,義竹鄉,東光村,374,602,94,177,271,42,313
公投第１５案,嘉義縣,義竹鄉,東光村,375,140,10,41,51,1,52
公投第１５案,嘉義縣,義竹鄉,東榮村,376,393,58,100,158,21,179
公投第１５案,嘉義縣,義竹鄉,龍蛟村,377,585,77,190,267,24,291
公投第１５案,嘉義縣,義竹鄉,溪洲村,378,526,48,127,175,7,182
公投第１５案,嘉義縣,義竹鄉,溪洲村,379,123,20,47,67,7,74
公投第１５案,嘉義縣,中埔鄉,富收村,380,1046,125,280,405,18,423
公投第１５案,嘉義縣,中埔鄉,富收村,381,1788,267,502,769,77,846
公投第１５案,嘉義縣,中埔鄉,和睦村,382,1730,252,493,745,42,787
公投第１５案,嘉義縣,中埔鄉,和睦村,383,1581,248,470,718,57,775
公投第１５案,嘉義縣,中埔鄉,和美村,384,1594,193,432,625,54,679
公投第１５案,嘉義縣,中埔鄉,和美村,385,1801,268,611,879,37,916
公投第１５案,嘉義縣,中埔鄉,和美村,386,1862,231,632,863,62,925
公投第１５案,嘉義縣,中埔鄉,和美村,387,1803,249,542,791,38,829
公投第１５案,嘉義縣,中埔鄉,和興村,388,1481,211,514,725,46,771
公投第１５案,嘉義縣,中埔鄉,和興村,389,1366,223,445,668,56,724
公投第１５案,嘉義縣,中埔鄉,和興村,390,1599,191,444,635,80,715
公投第１５案,嘉義縣,中埔鄉,和興村,391,1196,186,381,567,35,602
公投第１５案,嘉義縣,中埔鄉,中埔村,392,1809,245,492,737,91,828
公投第１５案,嘉義縣,中埔鄉,塩舘村,393,953,144,292,436,23,459
公投第１５案,嘉義縣,中埔鄉,金蘭村,394,1441,178,421,599,68,667
公投第１５案,嘉義縣,中埔鄉,隆興村,395,1882,230,562,792,75,867
公投第１５案,嘉義縣,中埔鄉,義仁村,396,1470,164,368,532,17,549
公投第１５案,嘉義縣,中埔鄉,社口村,397,1699,195,486,681,75,756
公投第１５案,嘉義縣,中埔鄉,社口村,398,422,51,108,159,16,175
公投第１５案,嘉義縣,中埔鄉,灣潭村,399,1030,152,291,443,69,512
公投第１５案,嘉義縣,中埔鄉,裕民村,400,879,126,264,390,32,422
公投第１５案,嘉義縣,中埔鄉,龍門村,401,828,92,245,337,19,356
公投第１５案,嘉義縣,中埔鄉,石硦村,402,881,133,315,448,55,503
公投第１５案,嘉義縣,中埔鄉,石硦村,403,296,47,85,132,16,148
公投第１５案,嘉義縣,中埔鄉,頂埔村,404,979,116,287,403,76,479
公投第１５案,嘉義縣,中埔鄉,同仁村,405,1268,164,350,514,44,558
公投第１５案,嘉義縣,中埔鄉,同仁村,406,670,69,132,201,7,208
公投第１５案,嘉義縣,中埔鄉,深坑村,407,754,119,245,364,67,431
公投第１５案,嘉義縣,中埔鄉,三層村,408,648,124,192,316,39,355
公投第１５案,嘉義縣,中埔鄉,瑞豐村,409,741,110,164,274,23,297
公投第１５案,嘉義縣,中埔鄉,沄水村,410,518,70,153,223,9,232
公投第１５案,嘉義縣,中埔鄉,沄水村,411,482,66,151,217,25,242
公投第１５案,嘉義縣,中埔鄉,東興村,412,348,50,89,139,8,147
公投第１５案,嘉義縣,中埔鄉,中崙村,413,294,39,99,138,10,148
公投第１５案,嘉義縣,竹崎鄉,竹崎村,414,1312,221,424,645,40,685
公投第１５案,嘉義縣,竹崎鄉,竹崎村,415,1210,196,433,629,26,655
公投第１５案,嘉義縣,竹崎鄉,和平村,416,991,142,369,511,42,553
公投第１５案,嘉義縣,竹崎鄉,和平村,417,1207,171,423,594,35,629
公投第１５案,嘉義縣,竹崎鄉,坑頭村,418,752,128,193,321,15,336
公投第１５案,嘉義縣,竹崎鄉,沙坑村,419,833,140,279,419,66,485
公投第１５案,嘉義縣,竹崎鄉,獅埜村,420,1220,174,445,619,75,694
公投第１５案,嘉義縣,竹崎鄉,義和村,421,616,111,226,337,17,354
公投第１５案,嘉義縣,竹崎鄉,義仁村,422,1031,125,353,478,50,528
公投第１５案,嘉義縣,竹崎鄉,灣橋村,423,1292,160,448,608,61,669
公投第１５案,嘉義縣,竹崎鄉,灣橋村,424,1995,315,722,1037,65,1102
公投第１５案,嘉義縣,竹崎鄉,灣橋村,425,1996,271,636,907,25,932
公投第１５案,嘉義縣,竹崎鄉,鹿滿村,426,1449,212,470,682,72,754
公投第１５案,嘉義縣,竹崎鄉,紫雲村,427,1420,190,500,690,41,731
公投第１５案,嘉義縣,竹崎鄉,內埔村,428,1590,235,575,810,57,867
公投第１５案,嘉義縣,竹崎鄉,昇平村,429,771,102,263,365,32,397
公投第１５案,嘉義縣,竹崎鄉,昇平村,430,1014,144,286,430,50,480
公投第１５案,嘉義縣,竹崎鄉,桃源村,431,327,34,78,112,8,120
公投第１５案,嘉義縣,竹崎鄉,桃源村,432,687,78,262,340,24,364
公投第１５案,嘉義縣,竹崎鄉,白杞村,433,641,83,215,298,18,316
公投第１５案,嘉義縣,竹崎鄉,塘興村,434,474,71,180,251,8,259
公投第１５案,嘉義縣,竹崎鄉,塘興村,435,383,49,132,181,14,195
公投第１５案,嘉義縣,竹崎鄉,義隆村,436,619,90,250,340,37,377
公投第１５案,嘉義縣,竹崎鄉,龍山村,437,214,30,64,94,6,100
公投第１５案,嘉義縣,竹崎鄉,龍山村,438,1568,225,490,715,90,805
公投第１５案,嘉義縣,竹崎鄉,文峯村,439,658,73,200,273,29,302
公投第１５案,嘉義縣,竹崎鄉,金獅村,440,434,73,153,226,28,254
公投第１５案,嘉義縣,竹崎鄉,復金村,441,917,137,309,446,54,500
公投第１５案,嘉義縣,竹崎鄉,復金村,442,981,134,297,431,46,477
公投第１５案,嘉義縣,竹崎鄉,緞繻村,443,789,88,260,348,20,368
公投第１５案,嘉義縣,竹崎鄉,緞繻村,444,108,8,19,27,3,30
公投第１５案,嘉義縣,竹崎鄉,仁壽村,445,235,23,37,60,2,62
公投第１５案,嘉義縣,竹崎鄉,中和村,446,331,48,97,145,4,149
公投第１５案,嘉義縣,竹崎鄉,中和村,447,450,86,177,263,11,274
公投第１５案,嘉義縣,竹崎鄉,光華村,448,462,46,139,185,5,190
公投第１５案,嘉義縣,竹崎鄉,光華村,449,251,19,69,88,18,106
公投第１５案,嘉義縣,番路鄉,江西村,450,1174,196,446,642,67,709
公投第１５案,嘉義縣,番路鄉,內甕村,451,449,79,185,264,9,273
公投第１５案,嘉義縣,番路鄉,新福村,452,753,108,308,416,36,452
公投第１５案,嘉義縣,番路鄉,新福村,453,551,68,162,230,34,264
公投第１５案,嘉義縣,番路鄉,下坑村,454,1791,296,633,929,77,1006
公投第１５案,嘉義縣,番路鄉,番路村,455,849,147,337,484,54,538
公投第１５案,嘉義縣,番路鄉,民和村,456,866,140,323,463,37,500
公投第１５案,嘉義縣,番路鄉,觸口村,457,800,91,315,406,33,439
公投第１５案,嘉義縣,番路鄉,觸口村,458,444,77,156,233,24,257
公投第１５案,嘉義縣,番路鄉,大湖村,459,635,60,190,250,13,263
公投第１５案,嘉義縣,番路鄉,公田村,460,319,29,105,134,13,147
公投第１５案,嘉義縣,番路鄉,公田村,461,642,73,281,354,24,378
公投第１５案,嘉義縣,番路鄉,公興村,462,509,45,164,209,22,231
公投第１５案,嘉義縣,番路鄉,草山村,463,162,10,78,88,1,89
公投第１５案,嘉義縣,番路鄉,草山村,464,212,17,95,112,9,121
公投第１５案,嘉義縣,大埔鄉,大埔村,465,1468,249,484,733,78,811
公投第１５案,嘉義縣,大埔鄉,和平村,466,320,37,84,121,5,126
公投第１５案,嘉義縣,大埔鄉,和平村,467,304,50,114,164,10,174
公投第１５案,嘉義縣,大埔鄉,永樂村,468,184,23,69,92,1,93
公投第１５案,嘉義縣,大埔鄉,永樂村,469,234,45,102,147,12,159
公投第１５案,嘉義縣,大埔鄉,茄苳村,470,495,70,169,239,13,252
公投第１５案,嘉義縣,大埔鄉,茄苳村,471,199,37,74,111,4,115
公投第１５案,嘉義縣,大埔鄉,茄苳村,472,226,38,67,105,6,111
公投第１５案,嘉義縣,大埔鄉,西興村,473,569,85,234,319,28,347
公投第１５案,嘉義縣,阿里山鄉,中山村,474,371,48,128,176,9,185
公投第１５案,嘉義縣,阿里山鄉,中正村,475,197,19,63,82,5,87
公投第１５案,嘉義縣,阿里山鄉,香林村,476,152,15,50,65,4,69
公投第１５案,嘉義縣,阿里山鄉,十字村,477,231,17,55,72,7,79
公投第１５案,嘉義縣,阿里山鄉,十字村,478,72,4,17,21,0,21
公投第１５案,嘉義縣,阿里山鄉,豐山村,479,311,31,103,134,2,136
公投第１５案,嘉義縣,阿里山鄉,來吉村,480,306,26,124,150,13,163
公投第１５案,嘉義縣,阿里山鄉,樂野村,481,970,110,334,444,12,456
公投第１５案,嘉義縣,阿里山鄉,達邦村,482,827,66,344,410,44,454
公投第１５案,嘉義縣,阿里山鄉,里佳村,483,238,23,93,116,4,120
公投第１５案,嘉義縣,阿里山鄉,山美村,484,479,21,105,126,9,135
公投第１５案,嘉義縣,阿里山鄉,新美村,485,291,24,81,105,6,111
公投第１５案,嘉義縣,阿里山鄉,茶山村,486,246,26,113,139,19,158
公投第１５案,屏東縣,屏東市,端正里,1,237,47,75,122,6,128
公投第１５案,屏東縣,屏東市,武廟里,2,294,56,88,144,22,166
公投第１５案,屏東縣,屏東市,大同里,3,582,138,169,307,11,318
公投第１５案,屏東縣,屏東市,光榮里,4,713,135,249,384,23,407
公投第１５案,屏東縣,屏東市,民權里,5,572,118,175,293,25,318
公投第１５案,屏東縣,屏東市,泰安里,6,455,95,177,272,10,282
公投第１５案,屏東縣,屏東市,文明里,7,249,65,80,145,0,145
公投第１５案,屏東縣,屏東市,維新里,8,1315,192,407,599,22,621
公投第１５案,屏東縣,屏東市,維新里,9,1373,231,387,618,43,661
公投第１５案,屏東縣,屏東市,大埔里,10,713,159,249,408,28,436
公投第１５案,屏東縣,屏東市,必信里,11,573,133,203,336,32,368
公投第１５案,屏東縣,屏東市,崇禮里,12,297,76,113,189,13,202
公投第１５案,屏東縣,屏東市,崇智里,13,409,82,184,266,17,283
公投第１５案,屏東縣,屏東市,慶春里,14,286,47,99,146,14,160
公投第１５案,屏東縣,屏東市,楠樹里,15,421,90,152,242,9,251
公投第１５案,屏東縣,屏東市,扶風里,16,569,113,197,310,12,322
公投第１５案,屏東縣,屏東市,安樂里,17,459,109,125,234,15,249
公投第１５案,屏東縣,屏東市,平和里,18,672,158,250,408,23,431
公投第１５案,屏東縣,屏東市,金泉里,19,668,156,226,382,43,425
公投第１５案,屏東縣,屏東市,勝豐里,20,411,89,136,225,10,235
公投第１５案,屏東縣,屏東市,橋南里,21,768,139,277,416,25,441
公投第１５案,屏東縣,屏東市,橋南里,22,786,141,270,411,26,437
公投第１５案,屏東縣,屏東市,橋北里,23,890,169,323,492,31,523
公投第１５案,屏東縣,屏東市,大連里,24,1353,209,512,721,40,761
公投第１５案,屏東縣,屏東市,大連里,25,1386,232,489,721,19,740
公投第１５案,屏東縣,屏東市,大連里,26,1413,243,471,714,23,737
公投第１５案,屏東縣,屏東市,大連里,27,1272,194,466,660,31,691
公投第１５案,屏東縣,屏東市,大連里,28,1287,247,427,674,26,700
公投第１５案,屏東縣,屏東市,大連里,29,1311,267,464,731,30,761
公投第１５案,屏東縣,屏東市,大連里,30,1285,238,467,705,15,720
公投第１５案,屏東縣,屏東市,豐田里,31,1297,254,452,706,40,746
公投第１５案,屏東縣,屏東市,豐田里,32,1361,238,479,717,13,730
公投第１５案,屏東縣,屏東市,豐田里,33,1381,207,470,677,37,714
公投第１５案,屏東縣,屏東市,豐榮里,34,1258,238,453,691,46,737
公投第１５案,屏東縣,屏東市,豐榮里,35,1259,219,451,670,41,711
公投第１５案,屏東縣,屏東市,豐源里,36,1076,189,375,564,28,592
公投第１５案,屏東縣,屏東市,豐源里,37,1162,222,421,643,26,669
公投第１５案,屏東縣,屏東市,豐源里,38,1318,272,458,730,24,754
公投第１５案,屏東縣,屏東市,長春里,39,939,169,321,490,35,525
公投第１５案,屏東縣,屏東市,長春里,40,972,199,345,544,19,563
公投第１５案,屏東縣,屏東市,瑞光里,41,1535,281,586,867,31,898
公投第１５案,屏東縣,屏東市,瑞光里,42,1419,210,446,656,31,687
公投第１５案,屏東縣,屏東市,瑞光里,43,1398,197,470,667,18,685
公投第１５案,屏東縣,屏東市,瑞光里,44,1405,251,463,714,34,748
公投第１５案,屏東縣,屏東市,瑞光里,45,1486,271,514,785,33,818
公投第１５案,屏東縣,屏東市,湖南里,46,1061,230,310,540,51,591
公投第１５案,屏東縣,屏東市,湖西里,47,1540,253,428,681,75,756
公投第１５案,屏東縣,屏東市,歸心里,48,1141,189,331,520,18,538
公投第１５案,屏東縣,屏東市,清溪里,49,1247,218,373,591,31,622
公投第１５案,屏東縣,屏東市,清溪里,50,1446,261,444,705,29,734
公投第１５案,屏東縣,屏東市,清溪里,51,1303,217,486,703,36,739
公投第１５案,屏東縣,屏東市,大武里,52,1253,211,446,657,33,690
公投第１５案,屏東縣,屏東市,大武里,53,1315,229,450,679,35,714
公投第１５案,屏東縣,屏東市,大武里,54,1425,255,440,695,33,728
公投第１５案,屏東縣,屏東市,大武里,55,1423,249,466,715,18,733
公投第１５案,屏東縣,屏東市,大武里,56,1400,237,520,757,38,795
公投第１５案,屏東縣,屏東市,大武里,57,1359,260,489,749,37,786
公投第１５案,屏東縣,屏東市,崇武里,58,1328,172,526,698,20,718
公投第１５案,屏東縣,屏東市,崇武里,59,1539,204,585,789,26,815
公投第１５案,屏東縣,屏東市,凌雲里,60,391,41,99,140,3,143
公投第１５案,屏東縣,屏東市,永昌里,61,200,38,67,105,12,117
公投第１５案,屏東縣,屏東市,永順里,62,328,53,90,143,24,167
公投第１５案,屏東縣,屏東市,鵬程里,63,231,32,85,117,4,121
公投第１５案,屏東縣,屏東市,安鎮里,64,945,181,322,503,43,546
公投第１５案,屏東縣,屏東市,安鎮里,65,1053,198,310,508,40,548
公投第１５案,屏東縣,屏東市,永光里,66,1043,156,330,486,52,538
公投第１５案,屏東縣,屏東市,長安里,67,1061,174,327,501,54,555
公投第１５案,屏東縣,屏東市,長安里,68,876,150,264,414,39,453
公投第１５案,屏東縣,屏東市,前進里,69,1468,186,501,687,89,776
公投第１５案,屏東縣,屏東市,前進里,70,1454,218,453,671,52,723
公投第１５案,屏東縣,屏東市,大洲里,71,1205,235,408,643,21,664
公投第１５案,屏東縣,屏東市,新興里,72,1284,221,411,632,29,661
公投第１５案,屏東縣,屏東市,新興里,73,1219,180,402,582,33,615
公投第１５案,屏東縣,屏東市,公館里,74,1544,259,532,791,82,873
公投第１５案,屏東縣,屏東市,新生里,75,1485,233,506,739,70,809
公投第１５案,屏東縣,屏東市,新生里,76,1387,241,487,728,39,767
公投第１５案,屏東縣,屏東市,新生里,77,953,157,321,478,18,496
公投第１５案,屏東縣,屏東市,新生里,78,1603,310,532,842,33,875
公投第１５案,屏東縣,屏東市,頂宅里,79,535,97,174,271,24,295
公投第１５案,屏東縣,屏東市,頂柳里,80,1119,184,371,555,34,589
公投第１５案,屏東縣,屏東市,大湖里,81,847,137,303,440,37,477
公投第１５案,屏東縣,屏東市,大湖里,82,923,191,300,491,59,550
公投第１５案,屏東縣,屏東市,龍華里,83,1227,217,389,606,36,642
公投第１５案,屏東縣,屏東市,龍華里,84,1039,153,380,533,37,570
公投第１５案,屏東縣,屏東市,玉成里,85,1485,224,482,706,87,793
公投第１５案,屏東縣,屏東市,擇仁里,86,867,126,293,419,41,460
公投第１５案,屏東縣,屏東市,建國里,87,918,151,337,488,31,519
公投第１５案,屏東縣,屏東市,萬年里,88,663,103,211,314,30,344
公投第１５案,屏東縣,屏東市,厚生里,89,1215,199,349,548,24,572
公投第１５案,屏東縣,屏東市,厚生里,90,1628,286,457,743,57,800
公投第１５案,屏東縣,屏東市,一心里,91,1209,237,399,636,39,675
公投第１５案,屏東縣,屏東市,義勇里,92,1110,440,242,682,18,700
公投第１５案,屏東縣,屏東市,光華里,93,684,90,219,309,15,324
公投第１５案,屏東縣,屏東市,永安里,94,1349,196,383,579,28,607
公投第１５案,屏東縣,屏東市,永安里,95,1457,222,443,665,55,720
公投第１５案,屏東縣,屏東市,永安里,96,1447,246,466,712,36,748
公投第１５案,屏東縣,屏東市,永安里,97,1354,254,403,657,23,680
公投第１５案,屏東縣,屏東市,永安里,98,1583,275,557,832,52,884
公投第１５案,屏東縣,屏東市,崇蘭里,99,1707,249,613,862,24,886
公投第１５案,屏東縣,屏東市,崇蘭里,100,1637,234,552,786,18,804
公投第１５案,屏東縣,屏東市,崇蘭里,101,1459,205,496,701,34,735
公投第１５案,屏東縣,屏東市,崇蘭里,102,1759,277,645,922,27,949
公投第１５案,屏東縣,屏東市,崇蘭里,103,1950,294,676,970,32,1002
公投第１５案,屏東縣,屏東市,崇蘭里,104,1729,259,643,902,33,935
公投第１５案,屏東縣,屏東市,崇蘭里,105,1592,248,534,782,27,809
公投第１５案,屏東縣,屏東市,潭墘里,106,1437,218,481,699,27,726
公投第１５案,屏東縣,屏東市,潭墘里,107,1204,166,428,594,19,613
公投第１５案,屏東縣,屏東市,潭墘里,108,1340,189,517,706,26,732
公投第１５案,屏東縣,屏東市,潭墘里,109,1322,218,465,683,34,717
公投第１５案,屏東縣,屏東市,潭墘里,110,1462,225,494,719,23,742
公投第１５案,屏東縣,屏東市,潭墘里,111,3241,480,1064,1544,40,1584
公投第１５案,屏東縣,屏東市,潭墘里,112,1477,221,491,712,12,724
公投第１５案,屏東縣,屏東市,永城里,113,821,110,276,386,15,401
公投第１５案,屏東縣,屏東市,永城里,114,1099,246,229,475,22,497
公投第１５案,屏東縣,屏東市,空翔里,115,1688,629,209,838,36,874
公投第１５案,屏東縣,屏東市,廣興里,116,1167,192,371,563,33,596
公投第１５案,屏東縣,屏東市,廣興里,117,915,148,302,450,40,490
公投第１５案,屏東縣,屏東市,勝利里,118,1683,171,334,505,24,529
公投第１５案,屏東縣,屏東市,勝利里,119,1497,232,508,740,17,757
公投第１５案,屏東縣,屏東市,勝利里,120,1129,185,369,554,30,584
公投第１５案,屏東縣,屏東市,勝利里,121,1232,182,457,639,29,668
公投第１５案,屏東縣,屏東市,斯文里,122,853,147,291,438,22,460
公投第１５案,屏東縣,屏東市,斯文里,123,869,154,333,487,21,508
公投第１５案,屏東縣,屏東市,華山里,124,1169,196,437,633,37,670
公投第１５案,屏東縣,屏東市,華山里,125,1058,175,348,523,70,593
公投第１５案,屏東縣,屏東市,華山里,126,1344,217,429,646,23,669
公投第１５案,屏東縣,屏東市,華山里,127,1299,280,449,729,23,752
公投第１５案,屏東縣,屏東市,溝美里,128,1204,202,373,575,38,613
公投第１５案,屏東縣,屏東市,溝美里,129,1123,190,374,564,30,594
公投第１５案,屏東縣,屏東市,三山里,130,1318,203,384,587,31,618
公投第１５案,屏東縣,屏東市,海豐里,131,865,179,294,473,43,516
公投第１５案,屏東縣,屏東市,仁義里,132,1100,162,321,483,27,510
公投第１５案,屏東縣,屏東市,北興里,133,1215,187,384,571,22,593
公投第１５案,屏東縣,屏東市,北興里,134,1370,190,501,691,36,727
公投第１５案,屏東縣,屏東市,北興里,135,1240,189,456,645,13,658
公投第１５案,屏東縣,屏東市,北興里,136,1168,225,421,646,26,672
公投第１５案,屏東縣,屏東市,北興里,137,1079,178,381,559,31,590
公投第１５案,屏東縣,屏東市,北勢里,138,1289,240,456,696,47,743
公投第１５案,屏東縣,屏東市,北勢里,139,1115,200,368,568,19,587
公投第１５案,屏東縣,屏東市,中正里,140,1491,281,507,788,42,830
公投第１５案,屏東縣,屏東市,中正里,141,1411,207,463,670,12,682
公投第１５案,屏東縣,屏東市,中正里,142,1803,306,593,899,16,915
公投第１５案,屏東縣,屏東市,興樂里,143,744,138,268,406,21,427
公投第１５案,屏東縣,屏東市,明正里,144,678,119,228,347,24,371
公投第１５案,屏東縣,屏東市,太平里,145,681,126,259,385,15,400
公投第１５案,屏東縣,屏東市,信和里,146,1535,238,431,669,33,702
公投第１５案,屏東縣,屏東市,和興里,147,954,160,324,484,60,544
公投第１５案,屏東縣,屏東市,仁愛里,148,1018,202,371,573,42,615
公投第１５案,屏東縣,屏東市,仁愛里,149,1154,231,404,635,21,656
公投第１５案,屏東縣,潮州鎮,潮州里,150,504,96,179,275,30,305
公投第１５案,屏東縣,潮州鎮,光華里,151,1711,271,504,775,43,818
公投第１５案,屏東縣,潮州鎮,光華里,152,1634,259,557,816,21,837
公投第１５案,屏東縣,潮州鎮,光華里,153,1414,192,439,631,23,654
公投第１５案,屏東縣,潮州鎮,同榮里,154,603,117,220,337,42,379
公投第１５案,屏東縣,潮州鎮,彭城里,155,896,132,304,436,54,490
公投第１５案,屏東縣,潮州鎮,三星里,156,1285,206,412,618,52,670
公投第１５案,屏東縣,潮州鎮,三星里,157,1744,258,572,830,39,869
公投第１５案,屏東縣,潮州鎮,三星里,158,1071,195,382,577,40,617
公投第１５案,屏東縣,潮州鎮,三星里,159,1209,204,456,660,53,713
公投第１５案,屏東縣,潮州鎮,三共里,160,1159,205,379,584,34,618
公投第１５案,屏東縣,潮州鎮,三共里,161,1296,196,445,641,46,687
公投第１５案,屏東縣,潮州鎮,三共里,162,1466,224,521,745,38,783
公投第１５案,屏東縣,潮州鎮,三共里,163,1130,180,426,606,46,652
公投第１５案,屏東縣,潮州鎮,三共里,164,1439,240,488,728,41,769
公投第１５案,屏東縣,潮州鎮,三和里,165,897,134,345,479,46,525
公投第１５案,屏東縣,潮州鎮,三和里,166,1225,189,475,664,32,696
公投第１５案,屏東縣,潮州鎮,九塊里,167,1158,195,338,533,52,585
公投第１５案,屏東縣,潮州鎮,九塊里,168,481,63,120,183,34,217
公投第１５案,屏東縣,潮州鎮,新生里,169,972,177,336,513,36,549
公投第１５案,屏東縣,潮州鎮,新榮里,170,1245,201,476,677,47,724
公投第１５案,屏東縣,潮州鎮,五魁里,171,1415,162,545,707,45,752
公投第１５案,屏東縣,潮州鎮,蓬萊里,172,1255,215,358,573,15,588
公投第１５案,屏東縣,潮州鎮,蓬萊里,173,1058,193,209,402,24,426
公投第１５案,屏東縣,潮州鎮,八爺里,174,1187,190,386,576,36,612
公投第１５案,屏東縣,潮州鎮,八爺里,175,1083,160,388,548,57,605
公投第１５案,屏東縣,潮州鎮,永春里,176,1590,233,495,728,32,760
公投第１５案,屏東縣,潮州鎮,永春里,177,1543,232,565,797,49,846
公投第１５案,屏東縣,潮州鎮,永春里,178,1631,258,509,767,45,812
公投第１５案,屏東縣,潮州鎮,永春里,179,1159,173,433,606,24,630
公投第１５案,屏東縣,潮州鎮,永春里,180,1099,190,401,591,26,617
公投第１５案,屏東縣,潮州鎮,富春里,181,1200,170,377,547,45,592
公投第１５案,屏東縣,潮州鎮,光春里,182,1391,171,475,646,58,704
公投第１５案,屏東縣,潮州鎮,興美里,183,881,144,314,458,46,504
公投第１５案,屏東縣,潮州鎮,檨子里,184,454,51,139,190,20,210
公投第１５案,屏東縣,潮州鎮,泗林里,185,1658,240,577,817,73,890
公投第１５案,屏東縣,潮州鎮,四春里,186,822,136,234,370,31,401
公投第１５案,屏東縣,潮州鎮,四春里,187,948,149,248,397,25,422
公投第１５案,屏東縣,潮州鎮,崙東里,188,1194,145,320,465,32,497
公投第１５案,屏東縣,潮州鎮,崙東里,189,337,51,113,164,27,191
公投第１５案,屏東縣,東港鎮,新勝里,190,981,160,381,541,47,588
公投第１５案,屏東縣,東港鎮,新勝里,191,1070,182,394,576,58,634
公投第１５案,屏東縣,東港鎮,頂新里,192,527,90,220,310,36,346
公投第１５案,屏東縣,東港鎮,頂中里,193,395,72,149,221,19,240
公投第１５案,屏東縣,東港鎮,東和里,194,659,99,213,312,26,338
公投第１５案,屏東縣,東港鎮,興台里,195,513,79,171,250,25,275
公投第１５案,屏東縣,東港鎮,興東里,196,1732,271,568,839,51,890
公投第１５案,屏東縣,東港鎮,興東里,197,1779,276,631,907,45,952
公投第１５案,屏東縣,東港鎮,興東里,198,1270,202,411,613,31,644
公投第１５案,屏東縣,東港鎮,興東里,199,1327,199,446,645,52,697
公投第１５案,屏東縣,東港鎮,興東里,200,1242,215,422,637,57,694
公投第１５案,屏東縣,東港鎮,興東里,201,1607,266,558,824,61,885
公投第１５案,屏東縣,東港鎮,興農里,202,1305,213,384,597,42,639
公投第１５案,屏東縣,東港鎮,中興里,203,695,119,245,364,27,391
公投第１５案,屏東縣,東港鎮,朝安里,204,1076,199,388,587,73,660
公投第１５案,屏東縣,東港鎮,朝安里,205,567,40,219,259,31,290
公投第１５案,屏東縣,東港鎮,八德里,206,806,129,265,394,33,427
公投第１５案,屏東縣,東港鎮,東隆里,207,1227,200,427,627,57,684
公投第１５案,屏東縣,東港鎮,豐漁里,208,599,79,199,278,47,325
公投第１５案,屏東縣,東港鎮,盛漁里,209,1354,160,373,533,40,573
公投第１５案,屏東縣,東港鎮,興漁里,210,734,101,244,345,46,391
公投第１５案,屏東縣,東港鎮,興漁里,211,1107,184,350,534,101,635
公投第１５案,屏東縣,東港鎮,鎮海里,212,1198,180,353,533,72,605
公投第１５案,屏東縣,東港鎮,鎮海里,213,1614,247,491,738,83,821
公投第１５案,屏東縣,東港鎮,嘉蓮里,214,826,118,260,378,45,423
公投第１５案,屏東縣,東港鎮,嘉蓮里,215,912,148,322,470,50,520
公投第１５案,屏東縣,東港鎮,南平里,216,432,62,136,198,30,228
公投第１５案,屏東縣,東港鎮,南平里,217,1204,183,423,606,84,690
公投第１５案,屏東縣,東港鎮,船頭里,218,1304,202,465,667,55,722
公投第１５案,屏東縣,東港鎮,船頭里,219,1317,196,468,664,61,725
公投第１５案,屏東縣,東港鎮,船頭里,220,1387,202,474,676,33,709
公投第１５案,屏東縣,東港鎮,船頭里,221,1310,161,412,573,32,605
公投第１５案,屏東縣,東港鎮,下廍里,222,1228,203,341,544,51,595
公投第１５案,屏東縣,東港鎮,下廍里,223,766,113,207,320,53,373
公投第１５案,屏東縣,東港鎮,大潭里,224,823,157,263,420,61,481
公投第１５案,屏東縣,東港鎮,大潭里,225,755,80,190,270,19,289
公投第１５案,屏東縣,東港鎮,興和里,226,1094,186,357,543,83,626
公投第１５案,屏東縣,東港鎮,共和里,227,753,89,258,347,25,372
公投第１５案,屏東縣,恆春鎮,城南里,228,902,108,295,403,37,440
公投第１５案,屏東縣,恆春鎮,城北里,229,969,180,338,518,36,554
公投第１５案,屏東縣,恆春鎮,城北里,230,1280,212,380,592,38,630
公投第１５案,屏東縣,恆春鎮,城西里,231,1133,187,395,582,28,610
公投第１５案,屏東縣,恆春鎮,網紗里,232,1552,219,422,641,15,656
公投第１５案,屏東縣,恆春鎮,網紗里,233,1485,197,373,570,50,620
公投第１５案,屏東縣,恆春鎮,仁壽里,234,896,142,306,448,33,481
公投第１５案,屏東縣,恆春鎮,茄湖里,235,531,78,147,225,25,250
公投第１５案,屏東縣,恆春鎮,頭溝里,236,478,72,138,210,11,221
公投第１５案,屏東縣,恆春鎮,四溝里,237,1020,156,289,445,44,489
公投第１５案,屏東縣,恆春鎮,德和里,238,924,159,270,429,17,446
公投第１５案,屏東縣,恆春鎮,龍水里,239,1079,139,305,444,29,473
公投第１５案,屏東縣,恆春鎮,山海里,240,775,88,214,302,16,318
公投第１５案,屏東縣,恆春鎮,山海里,241,813,88,322,410,42,452
公投第１５案,屏東縣,恆春鎮,大光里,242,1104,143,330,473,50,523
公投第１５案,屏東縣,恆春鎮,大光里,243,1110,147,303,450,45,495
公投第１５案,屏東縣,恆春鎮,水泉里,244,692,93,147,240,57,297
公投第１５案,屏東縣,恆春鎮,水泉里,245,708,79,172,251,11,262
公投第１５案,屏東縣,恆春鎮,山腳里,246,1505,232,465,697,29,726
公投第１５案,屏東縣,恆春鎮,山腳里,247,1111,145,329,474,46,520
公投第１５案,屏東縣,恆春鎮,山腳里,248,1543,195,480,675,40,715
公投第１５案,屏東縣,恆春鎮,南灣里,249,828,114,203,317,14,331
公投第１５案,屏東縣,恆春鎮,南灣里,250,844,137,273,410,34,444
公投第１５案,屏東縣,恆春鎮,墾丁里,251,1253,207,367,574,37,611
公投第１５案,屏東縣,恆春鎮,鵝鑾里,252,1126,151,324,475,38,513
公投第１５案,屏東縣,萬丹鄉,香社村,253,1527,193,431,624,45,669
公投第１５案,屏東縣,萬丹鄉,新庄村,254,1147,178,329,507,60,567
公投第１５案,屏東縣,萬丹鄉,新庄村,255,949,143,278,421,43,464
公投第１５案,屏東縣,萬丹鄉,新鐘村,256,990,158,291,449,30,479
公投第１５案,屏東縣,萬丹鄉,新鐘村,257,1022,133,351,484,10,494
公投第１５案,屏東縣,萬丹鄉,水仙村,258,545,97,223,320,48,368
公投第１５案,屏東縣,萬丹鄉,興全村,259,1159,170,422,592,91,683
公投第１５案,屏東縣,萬丹鄉,興安村,260,837,150,280,430,60,490
公投第１５案,屏東縣,萬丹鄉,甘棠村,261,392,64,120,184,13,197
公投第１５案,屏東縣,萬丹鄉,萬惠村,262,847,149,303,452,34,486
公投第１５案,屏東縣,萬丹鄉,萬全村,263,1149,166,383,549,38,587
公投第１５案,屏東縣,萬丹鄉,萬全村,264,1131,182,378,560,47,607
公投第１５案,屏東縣,萬丹鄉,萬全村,265,1178,184,368,552,58,610
公投第１５案,屏東縣,萬丹鄉,萬後村,266,711,131,266,397,28,425
公投第１５案,屏東縣,萬丹鄉,萬安村,267,595,136,211,347,16,363
公投第１５案,屏東縣,萬丹鄉,萬生村,268,1403,503,248,751,56,807
公投第１５案,屏東縣,萬丹鄉,寶厝村,269,1094,156,362,518,28,546
公投第１５案,屏東縣,萬丹鄉,寶厝村,270,1158,202,415,617,33,650
公投第１５案,屏東縣,萬丹鄉,四維村,271,963,184,353,537,60,597
公投第１５案,屏東縣,萬丹鄉,四維村,272,1062,172,368,540,42,582
公投第１５案,屏東縣,萬丹鄉,竹林村,273,1684,264,545,809,83,892
公投第１５案,屏東縣,萬丹鄉,水泉村,274,1702,293,507,800,26,826
公投第１５案,屏東縣,萬丹鄉,田厝村,275,976,173,328,501,36,537
公投第１５案,屏東縣,萬丹鄉,崙頂村,276,1013,158,338,496,62,558
公投第１５案,屏東縣,萬丹鄉,崙頂村,277,847,113,237,350,35,385
公投第１５案,屏東縣,萬丹鄉,厦北村,278,1570,257,530,787,125,912
公投第１５案,屏東縣,萬丹鄉,厦南村,279,1411,184,440,624,73,697
公投第１５案,屏東縣,萬丹鄉,後村村,280,1046,209,309,518,82,600
公投第１５案,屏東縣,萬丹鄉,灣內村,281,1385,217,435,652,36,688
公投第１５案,屏東縣,萬丹鄉,上村村,282,804,107,298,405,41,446
公投第１５案,屏東縣,萬丹鄉,加興村,283,1284,216,416,632,68,700
公投第１５案,屏東縣,萬丹鄉,社口村,284,1430,206,449,655,51,706
公投第１５案,屏東縣,萬丹鄉,磚寮村,285,960,186,355,541,59,600
公投第１５案,屏東縣,萬丹鄉,社皮村,286,786,135,298,433,46,479
公投第１５案,屏東縣,萬丹鄉,社皮村,287,1158,210,361,571,77,648
公投第１５案,屏東縣,萬丹鄉,社中村,288,1647,205,454,659,72,731
公投第１５案,屏東縣,萬丹鄉,社上村,289,1666,234,480,714,62,776
公投第１５案,屏東縣,萬丹鄉,廣安村,290,1023,185,381,566,62,628
公投第１５案,屏東縣,萬丹鄉,廣安村,291,1227,208,460,668,52,720
公投第１５案,屏東縣,長治鄉,進興村,292,1018,146,366,512,55,567
公投第１５案,屏東縣,長治鄉,進興村,293,1614,274,527,801,80,881
公投第１５案,屏東縣,長治鄉,新潭村,294,1848,547,451,998,68,1066
公投第１５案,屏東縣,長治鄉,新潭村,295,1707,258,598,856,68,924
公投第１５案,屏東縣,長治鄉,潭頭村,296,972,180,353,533,18,551
公投第１５案,屏東縣,長治鄉,潭頭村,297,989,172,360,532,40,572
公投第１５案,屏東縣,長治鄉,香楊村,298,735,131,278,409,36,445
公投第１５案,屏東縣,長治鄉,香楊村,299,1813,322,518,840,55,895
公投第１５案,屏東縣,長治鄉,長興村,300,1073,197,402,599,52,651
公投第１５案,屏東縣,長治鄉,崙上村,301,1654,264,550,814,69,883
公投第１５案,屏東縣,長治鄉,德榮村,302,1205,231,406,637,59,696
公投第１５案,屏東縣,長治鄉,德和村,303,758,140,267,407,26,433
公投第１５案,屏東縣,長治鄉,復興村,304,1492,237,486,723,88,811
公投第１５案,屏東縣,長治鄉,德成村,305,884,129,334,463,48,511
公投第１５案,屏東縣,長治鄉,德協村,306,1090,169,388,557,66,623
公投第１５案,屏東縣,長治鄉,繁榮村,307,1422,204,407,611,79,690
公投第１５案,屏東縣,長治鄉,繁昌村,308,845,132,278,410,55,465
公投第１５案,屏東縣,長治鄉,繁昌村,309,925,151,302,453,85,538
公投第１５案,屏東縣,長治鄉,繁隆村,310,1138,192,357,549,73,622
公投第１５案,屏東縣,長治鄉,繁華村,311,1242,199,412,611,88,699
公投第１５案,屏東縣,長治鄉,繁華村,312,1159,141,369,510,24,534
公投第１５案,屏東縣,長治鄉,榮華村,313,673,111,253,364,38,402
公投第１５案,屏東縣,麟洛鄉,新田村,314,788,144,270,414,33,447
公投第１５案,屏東縣,麟洛鄉,新田村,315,1386,256,549,805,27,832
公投第１５案,屏東縣,麟洛鄉,麟頂村,316,957,184,367,551,37,588
公投第１５案,屏東縣,麟洛鄉,麟蹄村,317,731,130,276,406,43,449
公投第１５案,屏東縣,麟洛鄉,麟蹄村,318,806,282,173,455,49,504
公投第１５案,屏東縣,麟洛鄉,麟趾村,319,1207,208,371,579,19,598
公投第１５案,屏東縣,麟洛鄉,麟趾村,320,1340,267,473,740,74,814
公投第１５案,屏東縣,麟洛鄉,田中村,321,1221,270,398,668,53,721
公投第１５案,屏東縣,麟洛鄉,田心村,322,851,164,273,437,17,454
公投第１５案,屏東縣,麟洛鄉,田道村,323,683,116,231,347,10,357
公投第１５案,屏東縣,九如鄉,九清村,324,1491,256,501,757,77,834
公投第１５案,屏東縣,九如鄉,九塊村,325,1375,235,450,685,55,740
公投第１５案,屏東縣,九如鄉,九明村,326,1678,235,547,782,48,830
公投第１５案,屏東縣,九如鄉,大坵村,327,1166,195,427,622,63,685
公投第１５案,屏東縣,九如鄉,玉水村,328,1276,196,333,529,45,574
公投第１５案,屏東縣,九如鄉,玉泉村,329,1033,175,338,513,70,583
公投第１５案,屏東縣,九如鄉,玉泉村,330,577,109,256,365,32,397
公投第１５案,屏東縣,九如鄉,東寧村,331,649,110,237,347,52,399
公投第１５案,屏東縣,九如鄉,東寧村,332,1999,218,742,960,133,1093
公投第１５案,屏東縣,九如鄉,東寧村,333,1766,274,555,829,89,918
公投第１５案,屏東縣,九如鄉,三塊村,334,1600,269,477,746,89,835
公投第１５案,屏東縣,九如鄉,耆老村,335,1248,183,409,592,88,680
公投第１５案,屏東縣,九如鄉,後庄村,336,1792,276,609,885,153,1038
公投第１５案,屏東縣,九如鄉,洽興村,337,1482,219,516,735,81,816
公投第１５案,屏東縣,里港鄉,玉田村,338,1552,269,565,834,81,915
公投第１５案,屏東縣,里港鄉,玉田村,339,1480,263,465,728,60,788
公投第１５案,屏東縣,里港鄉,塔樓村,340,1534,209,428,637,54,691
公投第１５案,屏東縣,里港鄉,潮厝村,341,1578,273,496,769,86,855
公投第１５案,屏東縣,里港鄉,大平村,342,1127,215,411,626,46,672
公投第１５案,屏東縣,里港鄉,永春村,343,845,153,300,453,46,499
公投第１５案,屏東縣,里港鄉,春林村,344,1282,202,415,617,59,676
公投第１５案,屏東縣,里港鄉,過江村,345,981,167,337,504,62,566
公投第１５案,屏東縣,里港鄉,過江村,346,1031,180,357,537,59,596
公投第１５案,屏東縣,里港鄉,鐵店村,347,1423,182,445,627,73,700
公投第１５案,屏東縣,里港鄉,茄苳村,348,363,53,92,145,21,166
公投第１５案,屏東縣,里港鄉,茄苳村,349,1203,219,377,596,105,701
公投第１５案,屏東縣,里港鄉,載興村,350,1027,166,393,559,79,638
公投第１５案,屏東縣,里港鄉,載興村,351,1384,223,416,639,58,697
公投第１５案,屏東縣,里港鄉,土庫村,352,1512,237,464,701,86,787
公投第１５案,屏東縣,里港鄉,土庫村,353,522,65,230,295,13,308
公投第１５案,屏東縣,里港鄉,三廍村,354,822,121,268,389,68,457
公投第１５案,屏東縣,里港鄉,三廍村,355,1007,158,292,450,79,529
公投第１５案,屏東縣,里港鄉,中和村,356,956,169,303,472,65,537
公投第１５案,屏東縣,里港鄉,瀰力村,357,499,92,172,264,18,282
公投第１５案,屏東縣,鹽埔鄉,鹽北村,358,951,139,331,470,26,496
公投第１５案,屏東縣,鹽埔鄉,鹽北村,359,899,131,293,424,19,443
公投第１５案,屏東縣,鹽埔鄉,鹽中村,360,1116,160,313,473,24,497
公投第１５案,屏東縣,鹽埔鄉,鹽中村,361,1241,177,413,590,35,625
公投第１５案,屏東縣,鹽埔鄉,鹽南村,362,770,119,249,368,35,403
公投第１５案,屏東縣,鹽埔鄉,鹽南村,363,962,165,307,472,39,511
公投第１５案,屏東縣,鹽埔鄉,仕絨村,364,1041,177,397,574,57,631
公投第１５案,屏東縣,鹽埔鄉,高朗村,365,1367,231,414,645,62,707
公投第１５案,屏東縣,鹽埔鄉,高朗村,366,1465,178,434,612,67,679
公投第１５案,屏東縣,鹽埔鄉,振興村,367,894,140,243,383,43,426
公投第１５案,屏東縣,鹽埔鄉,振興村,368,958,135,278,413,2,415
公投第１５案,屏東縣,鹽埔鄉,久愛村,369,924,132,293,425,72,497
公投第１５案,屏東縣,鹽埔鄉,新圍村,370,1598,218,483,701,34,735
公投第１５案,屏東縣,鹽埔鄉,新圍村,371,1550,260,483,743,87,830
公投第１５案,屏東縣,鹽埔鄉,新二村,372,1127,179,366,545,60,605
公投第１５案,屏東縣,鹽埔鄉,新二村,373,1150,184,419,603,67,670
公投第１５案,屏東縣,鹽埔鄉,新二村,374,1233,211,421,632,43,675
公投第１５案,屏東縣,鹽埔鄉,彭厝村,375,984,119,404,523,69,592
公投第１５案,屏東縣,鹽埔鄉,洛陽村,376,1619,289,550,839,39,878
公投第１５案,屏東縣,鹽埔鄉,永隆村,377,553,86,193,279,28,307
公投第１５案,屏東縣,高樹鄉,高樹村,378,883,176,303,479,72,551
公投第１５案,屏東縣,高樹鄉,高樹村,379,1255,163,284,447,23,470
公投第１５案,屏東縣,高樹鄉,長榮村,380,1278,201,411,612,33,645
公投第１５案,屏東縣,高樹鄉,東興村,381,738,84,229,313,22,335
公投第１５案,屏東縣,高樹鄉,東振村,382,585,91,158,249,16,265
公投第１５案,屏東縣,高樹鄉,源泉村,383,1012,186,300,486,110,596
公投第１５案,屏東縣,高樹鄉,建興村,384,1148,179,316,495,78,573
公投第１５案,屏東縣,高樹鄉,大埔村,385,591,92,174,266,34,300
公投第１５案,屏東縣,高樹鄉,菜寮村,386,786,117,198,315,47,362
公投第１５案,屏東縣,高樹鄉,司馬村,387,649,78,184,262,18,280
公投第１５案,屏東縣,高樹鄉,舊寮村,388,1229,135,314,449,66,515
公投第１５案,屏東縣,高樹鄉,新豐村,389,1446,173,406,579,53,632
公投第１５案,屏東縣,高樹鄉,泰山村,390,899,159,185,344,15,359
公投第１５案,屏東縣,高樹鄉,泰山村,391,922,146,284,430,46,476
公投第１５案,屏東縣,高樹鄉,南華村,392,1259,184,341,525,72,597
公投第１５案,屏東縣,高樹鄉,廣福村,393,1056,121,270,391,24,415
公投第１５案,屏東縣,高樹鄉,廣興村,394,1116,156,369,525,72,597
公投第１５案,屏東縣,高樹鄉,舊庄村,395,1020,179,334,513,60,573
公投第１５案,屏東縣,高樹鄉,田子村,396,1055,167,325,492,82,574
公投第１５案,屏東縣,高樹鄉,鹽樹村,397,738,136,260,396,45,441
公投第１５案,屏東縣,高樹鄉,鹽樹村,398,493,66,141,207,30,237
公投第１５案,屏東縣,高樹鄉,新南村,399,1539,257,510,767,103,870
公投第１５案,屏東縣,萬巒鄉,萬巒村,400,1239,205,361,566,40,606
公投第１５案,屏東縣,萬巒鄉,萬全村,401,759,155,231,386,55,441
公投第１５案,屏東縣,萬巒鄉,萬和村,402,932,158,313,471,86,557
公投第１５案,屏東縣,萬巒鄉,萬和村,403,769,155,257,412,52,464
公投第１５案,屏東縣,萬巒鄉,鹿寮村,404,920,154,271,425,81,506
公投第１５案,屏東縣,萬巒鄉,硫黃村,405,560,116,176,292,35,327
公投第１５案,屏東縣,萬巒鄉,泗溝村,406,1120,148,336,484,31,515
公投第１５案,屏東縣,萬巒鄉,五溝村,407,1048,143,341,484,25,509
公投第１５案,屏東縣,萬巒鄉,成德村,408,1438,188,404,592,50,642
公投第１５案,屏東縣,萬巒鄉,赤山村,409,834,125,227,352,63,415
公投第１５案,屏東縣,萬巒鄉,赤山村,410,813,116,244,360,65,425
公投第１５案,屏東縣,萬巒鄉,萬金村,411,1020,116,327,443,31,474
公投第１５案,屏東縣,萬巒鄉,萬金村,412,1007,206,318,524,68,592
公投第１５案,屏東縣,萬巒鄉,佳佐村,413,1648,229,426,655,74,729
公投第１５案,屏東縣,萬巒鄉,佳和村,414,1437,234,424,658,64,722
公投第１５案,屏東縣,萬巒鄉,新厝村,415,1228,200,322,522,24,546
公投第１５案,屏東縣,萬巒鄉,新置村,416,597,76,246,322,40,362
公投第１５案,屏東縣,萬巒鄉,新置村,417,576,89,193,282,36,318
公投第１５案,屏東縣,內埔鄉,內埔村,418,1305,160,407,567,36,603
公投第１５案,屏東縣,內埔鄉,內埔村,419,1287,166,409,575,37,612
公投第１５案,屏東縣,內埔鄉,內埔村,420,1387,198,424,622,19,641
公投第１５案,屏東縣,內埔鄉,內田村,421,1540,236,458,694,33,727
公投第１５案,屏東縣,內埔鄉,內田村,422,1605,262,475,737,51,788
公投第１５案,屏東縣,內埔鄉,興南村,423,1326,198,410,608,57,665
公投第１５案,屏東縣,內埔鄉,義亭村,424,591,98,193,291,43,334
公投第１５案,屏東縣,內埔鄉,美和村,425,1123,174,325,499,40,539
公投第１５案,屏東縣,內埔鄉,美和村,426,1079,149,361,510,14,524
公投第１５案,屏東縣,內埔鄉,和興村,427,1485,223,485,708,58,766
公投第１５案,屏東縣,內埔鄉,和興村,428,1248,201,472,673,34,707
公投第１５案,屏東縣,內埔鄉,東寧村,429,1569,278,475,753,44,797
公投第１５案,屏東縣,內埔鄉,東寧村,430,1493,213,435,648,71,719
公投第１５案,屏東縣,內埔鄉,東寧村,431,1420,223,421,644,9,653
公投第１５案,屏東縣,內埔鄉,豐田村,432,1334,186,437,623,70,693
公投第１５案,屏東縣,內埔鄉,豐田村,433,1519,229,440,669,70,739
公投第１５案,屏東縣,內埔鄉,振豐村,434,784,135,248,383,38,421
公投第１５案,屏東縣,內埔鄉,振豐村,435,888,148,300,448,53,501
公投第１５案,屏東縣,內埔鄉,富田村,436,747,98,173,271,18,289
公投第１５案,屏東縣,內埔鄉,富田村,437,1168,155,302,457,30,487
公投第１５案,屏東縣,內埔鄉,竹圍村,438,546,104,176,280,32,312
公投第１５案,屏東縣,內埔鄉,竹圍村,439,1278,195,394,589,44,633
公投第１５案,屏東縣,內埔鄉,東勢村,440,1348,193,355,548,48,596
公投第１５案,屏東縣,內埔鄉,東勢村,441,1550,199,374,573,81,654
公投第１５案,屏東縣,內埔鄉,東片村,442,947,158,356,514,59,573
公投第１５案,屏東縣,內埔鄉,上樹村,443,1097,176,311,487,77,564
公投第１５案,屏東縣,內埔鄉,老埤村,444,1128,169,251,420,58,478
公投第１５案,屏東縣,內埔鄉,老埤村,445,1253,141,284,425,19,444
公投第１５案,屏東縣,內埔鄉,中林村,446,1525,174,403,577,27,604
公投第１５案,屏東縣,內埔鄉,龍泉村,447,1215,174,397,571,69,640
公投第１５案,屏東縣,內埔鄉,龍泉村,448,1216,136,347,483,30,513
公投第１５案,屏東縣,內埔鄉,龍潭村,449,1353,164,416,580,36,616
公投第１５案,屏東縣,內埔鄉,龍潭村,450,1026,138,344,482,31,513
公投第１５案,屏東縣,內埔鄉,建興村,451,862,119,252,371,30,401
公投第１５案,屏東縣,內埔鄉,大新村,452,921,113,224,337,32,369
公投第１５案,屏東縣,內埔鄉,大新村,453,854,139,269,408,18,426
公投第１５案,屏東縣,內埔鄉,黎明村,454,1230,147,355,502,43,545
公投第１５案,屏東縣,內埔鄉,黎明村,455,1204,141,380,521,16,537
公投第１５案,屏東縣,內埔鄉,隘寮村,456,1301,163,401,564,32,596
公投第１５案,屏東縣,內埔鄉,水門村,457,806,102,309,411,42,453
公投第１５案,屏東縣,竹田鄉,竹田村,458,1503,214,548,762,80,842
公投第１５案,屏東縣,竹田鄉,竹南村,459,899,176,336,512,40,552
公投第１５案,屏東縣,竹田鄉,糶糴村,460,716,143,268,411,42,453
公投第１５案,屏東縣,竹田鄉,履豐村,461,581,133,212,345,38,383
公投第１５案,屏東縣,竹田鄉,頭崙村,462,1327,520,126,646,93,739
公投第１５案,屏東縣,竹田鄉,二崙村,463,997,182,371,553,69,622
公投第１５案,屏東縣,竹田鄉,美崙村,464,649,120,202,322,30,352
公投第１５案,屏東縣,竹田鄉,南勢村,465,476,110,218,328,19,347
公投第１５案,屏東縣,竹田鄉,西勢村,466,1259,461,215,676,63,739
公投第１５案,屏東縣,竹田鄉,西勢村,467,1227,195,386,581,62,643
公投第１５案,屏東縣,竹田鄉,福田村,468,504,101,190,291,31,322
公投第１５案,屏東縣,竹田鄉,永豐村,469,860,122,290,412,51,463
公投第１５案,屏東縣,竹田鄉,六巷村,470,800,136,265,401,23,424
公投第１５案,屏東縣,竹田鄉,泗洲村,471,1134,190,395,585,71,656
公投第１５案,屏東縣,竹田鄉,大湖村,472,1229,190,425,615,49,664
公投第１５案,屏東縣,竹田鄉,鳳明村,473,1192,169,409,578,51,629
公投第１５案,屏東縣,新埤鄉,新埤村,474,1712,263,506,769,42,811
公投第１５案,屏東縣,新埤鄉,新埤村,475,314,41,101,142,33,175
公投第１５案,屏東縣,新埤鄉,建功村,476,752,129,250,379,28,407
公投第１５案,屏東縣,新埤鄉,建功村,477,334,45,116,161,23,184
公投第１５案,屏東縣,新埤鄉,打鐵村,478,957,135,349,484,58,542
公投第１５案,屏東縣,新埤鄉,南豐村,479,764,133,259,392,59,451
公投第１５案,屏東縣,新埤鄉,萬隆村,480,373,60,132,192,22,214
公投第１５案,屏東縣,新埤鄉,萬隆村,481,678,92,196,288,29,317
公投第１５案,屏東縣,新埤鄉,萬隆村,482,701,99,204,303,26,329
公投第１５案,屏東縣,新埤鄉,餉潭村,483,1323,148,326,474,71,545
公投第１５案,屏東縣,新埤鄉,箕湖村,484,541,85,195,280,32,312
公投第１５案,屏東縣,新埤鄉,箕湖村,485,584,71,178,249,22,271
公投第１５案,屏東縣,枋寮鄉,枋寮村,486,1213,191,431,622,59,681
公投第１５案,屏東縣,枋寮鄉,新龍村,487,891,147,321,468,51,519
公投第１５案,屏東縣,枋寮鄉,保生村,488,970,120,303,423,73,496
公投第１５案,屏東縣,枋寮鄉,中寮村,489,629,95,212,307,30,337
公投第１５案,屏東縣,枋寮鄉,安樂村,490,840,165,274,439,47,486
公投第１５案,屏東縣,枋寮鄉,安樂村,491,774,111,301,412,38,450
公投第１５案,屏東縣,枋寮鄉,隆山村,492,1379,284,370,654,61,715
公投第１５案,屏東縣,枋寮鄉,隆山村,493,1502,150,523,673,57,730
公投第１５案,屏東縣,枋寮鄉,隆山村,494,1276,165,329,494,71,565
公投第１５案,屏東縣,枋寮鄉,天時村,495,964,153,305,458,59,517
公投第１５案,屏東縣,枋寮鄉,天時村,496,1005,158,370,528,83,611
公投第１５案,屏東縣,枋寮鄉,地利村,497,734,96,252,348,21,369
公投第１５案,屏東縣,枋寮鄉,地利村,498,725,109,256,365,43,408
公投第１５案,屏東縣,枋寮鄉,人和村,499,1046,165,309,474,53,527
公投第１５案,屏東縣,枋寮鄉,人和村,500,1067,165,371,536,75,611
公投第１５案,屏東縣,枋寮鄉,內寮村,501,718,68,157,225,52,277
公投第１５案,屏東縣,枋寮鄉,新開村,502,903,114,255,369,49,418
公投第１５案,屏東縣,枋寮鄉,東海村,503,1387,195,411,606,88,694
公投第１５案,屏東縣,枋寮鄉,東海村,504,1367,219,448,667,89,756
公投第１５案,屏東縣,枋寮鄉,大庄村,505,618,127,209,336,53,389
公投第１５案,屏東縣,枋寮鄉,太源村,506,959,128,229,357,34,391
公投第１５案,屏東縣,枋寮鄉,玉泉村,507,427,71,137,208,28,236
公投第１５案,屏東縣,新園鄉,瓦磘村,508,820,154,281,435,37,472
公投第１５案,屏東縣,新園鄉,瓦磘村,509,843,165,300,465,43,508
公投第１５案,屏東縣,新園鄉,仙吉村,510,1242,195,405,600,43,643
公投第１５案,屏東縣,新園鄉,仙吉村,511,1290,220,469,689,53,742
公投第１５案,屏東縣,新園鄉,田洋村,512,1073,183,344,527,37,564
公投第１５案,屏東縣,新園鄉,田洋村,513,1088,168,385,553,92,645
公投第１５案,屏東縣,新園鄉,港墘村,514,845,120,261,381,36,417
公投第１５案,屏東縣,新園鄉,內庄村,515,862,160,262,422,49,471
公投第１５案,屏東縣,新園鄉,新東村,516,1183,167,346,513,75,588
公投第１５案,屏東縣,新園鄉,新東村,517,1109,155,370,525,83,608
公投第１５案,屏東縣,新園鄉,新園村,518,1119,163,337,500,12,512
公投第１５案,屏東縣,新園鄉,新園村,519,1152,181,356,537,36,573
公投第１５案,屏東縣,新園鄉,港西村,520,1030,152,373,525,44,569
公投第１５案,屏東縣,新園鄉,港西村,521,1104,177,332,509,79,588
公投第１５案,屏東縣,新園鄉,烏龍村,522,1240,212,299,511,35,546
公投第１５案,屏東縣,新園鄉,興龍村,523,1120,153,278,431,22,453
公投第１５案,屏東縣,新園鄉,興龍村,524,1074,182,372,554,70,624
公投第１５案,屏東縣,新園鄉,中洲村,525,849,134,228,362,35,397
公投第１５案,屏東縣,新園鄉,中洲村,526,749,122,240,362,49,411
公投第１５案,屏東縣,新園鄉,南龍村,527,1416,210,429,639,81,720
公投第１５案,屏東縣,新園鄉,五房村,528,895,130,299,429,53,482
公投第１５案,屏東縣,新園鄉,五房村,529,933,142,314,456,63,519
公投第１５案,屏東縣,新園鄉,五房村,530,972,139,341,480,42,522
公投第１５案,屏東縣,新園鄉,鹽埔村,531,1454,192,407,599,63,662
公投第１５案,屏東縣,新園鄉,鹽埔村,532,1653,229,646,875,90,965
公投第１５案,屏東縣,新園鄉,鹽埔村,533,1270,149,422,571,69,640
公投第１５案,屏東縣,新園鄉,共和村,534,1123,268,319,587,94,681
公投第１５案,屏東縣,新園鄉,共和村,535,1198,165,384,549,74,623
公投第１５案,屏東縣,崁頂鄉,崁頂村,536,1190,175,365,540,53,593
公投第１５案,屏東縣,崁頂鄉,崁頂村,537,1044,188,346,534,63,597
公投第１５案,屏東縣,崁頂鄉,園寮村,538,818,151,252,403,49,452
公投第１５案,屏東縣,崁頂鄉,園寮村,539,1214,174,413,587,43,630
公投第１５案,屏東縣,崁頂鄉,力社村,540,1325,191,417,608,26,634
公投第１５案,屏東縣,崁頂鄉,圍內村,541,1253,232,426,658,51,709
公投第１５案,屏東縣,崁頂鄉,洲子村,542,1039,186,300,486,43,529
公投第１５案,屏東縣,崁頂鄉,北勢村,543,813,118,227,345,47,392
公投第１５案,屏東縣,崁頂鄉,北勢村,544,736,117,228,345,21,366
公投第１５案,屏東縣,崁頂鄉,越溪村,545,934,172,309,481,45,526
公投第１５案,屏東縣,崁頂鄉,港東村,546,900,147,262,409,64,473
公投第１５案,屏東縣,崁頂鄉,港東村,547,1004,163,320,483,48,531
公投第１５案,屏東縣,林邊鄉,林邊村,548,1458,231,539,770,88,858
公投第１５案,屏東縣,林邊鄉,光林村,549,891,156,329,485,44,529
公投第１５案,屏東縣,林邊鄉,光林村,550,695,122,268,390,33,423
公投第１５案,屏東縣,林邊鄉,永樂村,551,1015,180,368,548,57,605
公投第１５案,屏東縣,林邊鄉,永樂村,552,1171,224,406,630,46,676
公投第１５案,屏東縣,林邊鄉,永樂村,553,1003,157,335,492,48,540
公投第１５案,屏東縣,林邊鄉,中林村,554,725,157,265,422,38,460
公投第１５案,屏東縣,林邊鄉,仁和村,555,841,158,285,443,56,499
公投第１５案,屏東縣,林邊鄉,仁和村,556,793,144,288,432,42,474
公投第１５案,屏東縣,林邊鄉,田厝村,557,919,343,152,495,52,547
公投第１５案,屏東縣,林邊鄉,崎峯村,558,1283,207,394,601,65,666
公投第１５案,屏東縣,林邊鄉,水利村,559,783,123,215,338,44,382
公投第１５案,屏東縣,林邊鄉,水利村,560,1033,127,296,423,49,472
公投第１５案,屏東縣,林邊鄉,竹林村,561,1186,171,381,552,87,639
公投第１５案,屏東縣,林邊鄉,竹林村,562,773,115,249,364,56,420
公投第１５案,屏東縣,林邊鄉,鎮安村,563,1122,148,339,487,44,531
公投第１５案,屏東縣,南州鄉,溪洲村,564,872,128,269,397,62,459
公投第１５案,屏東縣,南州鄉,溪洲村,565,794,142,261,403,35,438
公投第１５案,屏東縣,南州鄉,溪南村,566,962,178,332,510,48,558
公投第１５案,屏東縣,南州鄉,七塊村,567,1033,193,324,517,64,581
公投第１５案,屏東縣,南州鄉,萬華村,568,1007,178,286,464,52,516
公投第１５案,屏東縣,南州鄉,仁里村,569,466,81,173,254,23,277
公投第１５案,屏東縣,南州鄉,溪北村,570,708,128,254,382,25,407
公投第１５案,屏東縣,南州鄉,米崙村,571,1044,168,348,516,75,591
公投第１５案,屏東縣,南州鄉,壽元村,572,1071,160,257,417,34,451
公投第１５案,屏東縣,南州鄉,同安村,573,979,183,245,428,34,462
公投第１５案,屏東縣,南州鄉,南安村,574,543,79,172,251,24,275
公投第１５案,屏東縣,佳冬鄉,佳冬村,575,1472,231,380,611,76,687
公投第１５案,屏東縣,佳冬鄉,六根村,576,1360,169,365,534,67,601
公投第１５案,屏東縣,佳冬鄉,賴家村,577,804,130,263,393,72,465
公投第１５案,屏東縣,佳冬鄉,萬建村,578,925,156,264,420,64,484
公投第１５案,屏東縣,佳冬鄉,萬建村,579,855,123,245,368,17,385
公投第１５案,屏東縣,佳冬鄉,石光村,580,981,155,265,420,59,479
公投第１５案,屏東縣,佳冬鄉,石光村,581,1007,172,273,445,53,498
公投第１５案,屏東縣,佳冬鄉,玉光村,582,872,134,233,367,53,420
公投第１５案,屏東縣,佳冬鄉,玉光村,583,1255,178,321,499,79,578
公投第１５案,屏東縣,佳冬鄉,昌隆村,584,995,146,295,441,106,547
公投第１５案,屏東縣,佳冬鄉,豐隆村,585,734,83,185,268,25,293
公投第１５案,屏東縣,佳冬鄉,大同村,586,1178,160,314,474,35,509
公投第１５案,屏東縣,佳冬鄉,羌園村,587,1095,191,275,466,59,525
公投第１５案,屏東縣,佳冬鄉,燄溫村,588,1097,144,398,542,101,643
公投第１５案,屏東縣,佳冬鄉,塭豐村,589,1273,171,424,595,63,658
公投第１５案,屏東縣,佳冬鄉,塭豐村,590,1160,177,418,595,59,654
公投第１５案,屏東縣,琉球鄉,本福村,591,1111,130,313,443,23,466
公投第１５案,屏東縣,琉球鄉,本福村,592,972,96,301,397,36,433
公投第１５案,屏東縣,琉球鄉,中福村,593,1278,142,497,639,41,680
公投第１５案,屏東縣,琉球鄉,漁福村,594,976,109,342,451,44,495
公投第１５案,屏東縣,琉球鄉,大福村,595,1658,157,572,729,58,787
公投第１５案,屏東縣,琉球鄉,南福村,596,1146,117,292,409,32,441
公投第１５案,屏東縣,琉球鄉,天福村,597,1079,40,349,389,31,420
公投第１５案,屏東縣,琉球鄉,上福村,598,1613,128,436,564,25,589
公投第１５案,屏東縣,琉球鄉,杉福村,599,873,122,285,407,37,444
公投第１５案,屏東縣,車城鄉,海口村,600,737,109,162,271,38,309
公投第１５案,屏東縣,車城鄉,田中村,601,647,78,132,210,31,241
公投第１５案,屏東縣,車城鄉,福興村,602,491,85,120,205,20,225
公投第１５案,屏東縣,車城鄉,福興村,603,856,116,263,379,27,406
公投第１５案,屏東縣,車城鄉,福安村,604,554,81,143,224,8,232
公投第１５案,屏東縣,車城鄉,統埔村,605,388,48,93,141,2,143
公投第１５案,屏東縣,車城鄉,溫泉村,606,922,136,204,340,44,384
公投第１５案,屏東縣,車城鄉,保力村,607,597,78,107,185,11,196
公投第１５案,屏東縣,車城鄉,保力村,608,623,60,132,192,10,202
公投第１５案,屏東縣,車城鄉,新街村,609,425,62,109,171,24,195
公投第１５案,屏東縣,車城鄉,埔墘村,610,428,50,148,198,21,219
公投第１５案,屏東縣,車城鄉,射寮村,611,504,56,109,165,7,172
公投第１５案,屏東縣,車城鄉,後灣村,612,423,61,122,183,26,209
公投第１５案,屏東縣,滿州鄉,滿州村,613,1575,270,419,689,40,729
公投第１５案,屏東縣,滿州鄉,里德村,614,420,65,122,187,10,197
公投第１５案,屏東縣,滿州鄉,响林村,615,602,83,241,324,26,350
公投第１５案,屏東縣,滿州鄉,永靖村,616,1302,130,349,479,25,504
公投第１５案,屏東縣,滿州鄉,港口村,617,1314,197,359,556,48,604
公投第１５案,屏東縣,滿州鄉,長樂村,618,1308,130,243,373,19,392
公投第１５案,屏東縣,滿州鄉,九棚村,619,367,53,72,125,14,139
公投第１５案,屏東縣,滿州鄉,港仔村,620,318,43,108,151,15,166
公投第１５案,屏東縣,枋山鄉,枋山村,621,604,101,231,332,34,366
公投第１５案,屏東縣,枋山鄉,枋山村,622,428,62,172,234,26,260
公投第１５案,屏東縣,枋山鄉,加祿村,623,928,166,358,524,49,573
公投第１５案,屏東縣,枋山鄉,加祿村,624,972,134,334,468,20,488
公投第１５案,屏東縣,枋山鄉,楓港村,625,1041,136,276,412,68,480
公投第１５案,屏東縣,枋山鄉,善餘村,626,883,108,192,300,23,323
公投第１５案,屏東縣,三地門鄉,大社村,627,616,59,232,291,17,308
公投第１５案,屏東縣,三地門鄉,德文村,628,572,78,206,284,70,354
公投第１５案,屏東縣,三地門鄉,達來村,629,323,34,116,150,12,162
公投第１５案,屏東縣,三地門鄉,三地村,630,1448,282,554,836,53,889
公投第１５案,屏東縣,三地門鄉,賽嘉村,631,726,71,177,248,9,257
公投第１５案,屏東縣,三地門鄉,口社村,632,554,84,183,267,27,294
公投第１５案,屏東縣,三地門鄉,馬兒村,633,346,67,135,202,12,214
公投第１５案,屏東縣,三地門鄉,安坡村,634,458,56,178,234,4,238
公投第１５案,屏東縣,三地門鄉,青山村,635,692,126,283,409,18,427
公投第１５案,屏東縣,三地門鄉,青葉村,636,638,128,317,445,27,472
公投第１５案,屏東縣,霧臺鄉,霧台村,637,346,65,180,245,23,268
公投第１５案,屏東縣,霧臺鄉,霧台村,638,677,92,286,378,10,388
公投第１５案,屏東縣,霧臺鄉,霧台村,639,162,18,41,59,0,59
公投第１５案,屏東縣,霧臺鄉,吉露村,640,189,21,71,92,5,97
公投第１５案,屏東縣,霧臺鄉,阿禮村,641,296,40,142,182,29,211
公投第１５案,屏東縣,霧臺鄉,好茶村,642,483,78,236,314,13,327
公投第１５案,屏東縣,霧臺鄉,佳暮村,643,347,50,146,196,5,201
公投第１５案,屏東縣,霧臺鄉,大武村,644,450,69,166,235,23,258
公投第１５案,屏東縣,瑪家鄉,瑪家村,645,455,78,165,243,3,246
公投第１５案,屏東縣,瑪家鄉,北葉村,646,821,143,370,513,32,545
公投第１５案,屏東縣,瑪家鄉,三和村,647,635,121,298,419,46,465
公投第１５案,屏東縣,瑪家鄉,三和村,648,695,99,401,500,23,523
公投第１５案,屏東縣,瑪家鄉,三和村,649,671,112,321,433,21,454
公投第１５案,屏東縣,瑪家鄉,凉山村,650,1057,144,398,542,25,567
公投第１５案,屏東縣,瑪家鄉,佳義村,651,900,133,370,503,21,524
公投第１５案,屏東縣,瑪家鄉,排灣村,652,429,50,182,232,7,239
公投第１５案,屏東縣,泰武鄉,佳平村,653,669,134,252,386,16,402
公投第１５案,屏東縣,泰武鄉,佳平村,654,190,25,71,96,6,102
公投第１５案,屏東縣,泰武鄉,武潭村,655,922,162,394,556,51,607
公投第１５案,屏東縣,泰武鄉,平和村,656,598,109,307,416,36,452
公投第１５案,屏東縣,泰武鄉,萬安村,657,771,107,361,468,35,503
公投第１５案,屏東縣,泰武鄉,佳興村,658,414,51,225,276,27,303
公投第１５案,屏東縣,泰武鄉,泰武村,659,780,111,305,416,24,440
公投第１５案,屏東縣,來義鄉,來義村,660,917,107,427,534,80,614
公投第１５案,屏東縣,來義鄉,義林村,661,361,60,143,203,8,211
公投第１５案,屏東縣,來義鄉,義林村,662,216,23,96,119,2,121
公投第１５案,屏東縣,來義鄉,丹林村,663,445,59,252,311,25,336
公投第１５案,屏東縣,來義鄉,丹林村,664,280,31,141,172,10,182
公投第１５案,屏東縣,來義鄉,古樓村,665,1097,117,482,599,49,648
公投第１５案,屏東縣,來義鄉,文樂村,666,840,101,432,533,31,564
公投第１５案,屏東縣,來義鄉,望嘉村,667,889,134,307,441,21,462
公投第１５案,屏東縣,來義鄉,南和村,668,1212,190,359,549,45,594
公投第１５案,屏東縣,春日鄉,春日村,669,909,99,185,284,4,288
公投第１５案,屏東縣,春日鄉,古華村,670,663,96,139,235,12,247
公投第１５案,屏東縣,春日鄉,士文村,671,304,20,62,82,3,85
公投第１５案,屏東縣,春日鄉,七佳村,672,928,110,277,387,14,401
公投第１５案,屏東縣,春日鄉,歸崇村,673,641,62,123,185,8,193
公投第１５案,屏東縣,春日鄉,力里村,674,478,53,91,144,2,146
公投第１５案,屏東縣,獅子鄉,楓林村,675,751,74,306,380,9,389
公投第１５案,屏東縣,獅子鄉,丹路村,676,776,107,317,424,27,451
公投第１５案,屏東縣,獅子鄉,草埔村,677,711,62,259,321,6,327
公投第１５案,屏東縣,獅子鄉,內文村,678,243,45,118,163,25,188
公投第１５案,屏東縣,獅子鄉,竹坑村,679,325,50,139,189,6,195
公投第１５案,屏東縣,獅子鄉,獅子村,680,476,63,129,192,4,196
公投第１５案,屏東縣,獅子鄉,內獅村,681,602,81,272,353,10,363
公投第１５案,屏東縣,獅子鄉,南世村,682,346,43,115,158,6,164
公投第１５案,屏東縣,牡丹鄉,石門村,683,342,40,99,139,4,143
公投第１５案,屏東縣,牡丹鄉,石門村,684,1306,210,407,617,46,663
公投第１５案,屏東縣,牡丹鄉,牡丹村,685,693,59,108,167,5,172
公投第１５案,屏東縣,牡丹鄉,東源村,686,437,45,121,166,10,176
公投第１５案,屏東縣,牡丹鄉,旭海村,687,392,57,134,191,5,196
公投第１５案,屏東縣,牡丹鄉,高士村,688,593,119,179,298,9,307
公投第１５案,屏東縣,牡丹鄉,四林村,689,551,40,89,129,5,134
公投第１５案,臺東縣,臺東市,文化里,1,874,119,298,417,17,434
公投第１５案,臺東縣,臺東市,民族里,2,1469,256,583,839,57,896
公投第１５案,臺東縣,臺東市,自強里,3,1259,192,472,664,40,704
公投第１５案,臺東縣,臺東市,自強里,4,1399,232,509,741,38,779
公投第１５案,臺東縣,臺東市,自強里,5,1363,264,544,808,34,842
公投第１５案,臺東縣,臺東市,民生里,6,1651,232,635,867,38,905
公投第１５案,臺東縣,臺東市,民生里,7,1490,233,656,889,40,929
公投第１５案,臺東縣,臺東市,寶桑里,8,859,128,300,428,31,459
公投第１５案,臺東縣,臺東市,民權里,9,890,170,337,507,37,544
公投第１５案,臺東縣,臺東市,四維里,10,651,89,249,338,38,376
公投第１５案,臺東縣,臺東市,中華里,11,1650,337,414,751,63,814
公投第１５案,臺東縣,臺東市,仁愛里,12,724,131,292,423,28,451
公投第１５案,臺東縣,臺東市,強國里,13,632,116,235,351,32,383
公投第１５案,臺東縣,臺東市,大同里,14,771,122,303,425,37,462
公投第１５案,臺東縣,臺東市,成功里,15,798,128,258,386,24,410
公投第１５案,臺東縣,臺東市,建國里,16,1299,173,467,640,80,720
公投第１５案,臺東縣,臺東市,中正里,17,811,134,319,453,32,485
公投第１５案,臺東縣,臺東市,中山里,18,764,140,319,459,32,491
公投第１５案,臺東縣,臺東市,興國里,19,784,144,247,391,19,410
公投第１５案,臺東縣,臺東市,鐵花里,20,427,64,143,207,11,218
公投第１５案,臺東縣,臺東市,東海里,21,1292,210,436,646,27,673
公投第１５案,臺東縣,臺東市,東海里,22,1501,257,597,854,10,864
公投第１５案,臺東縣,臺東市,復國里,23,601,83,205,288,14,302
公投第１５案,臺東縣,臺東市,復興里,24,417,71,133,204,9,213
公投第１５案,臺東縣,臺東市,新興里,25,1001,142,387,529,37,566
公投第１５案,臺東縣,臺東市,新生里,26,1638,255,651,906,48,954
公投第１５案,臺東縣,臺東市,新生里,27,1576,229,598,827,45,872
公投第１５案,臺東縣,臺東市,新生里,28,1595,246,689,935,59,994
公投第１５案,臺東縣,臺東市,新生里,29,1734,270,656,926,40,966
公投第１５案,臺東縣,臺東市,中心里,30,1476,238,563,801,51,852
公投第１５案,臺東縣,臺東市,中心里,31,1545,283,614,897,34,931
公投第１５案,臺東縣,臺東市,馬蘭里,32,1313,162,562,724,41,765
公投第１５案,臺東縣,臺東市,馬蘭里,33,1338,190,597,787,38,825
公投第１５案,臺東縣,臺東市,光明里,34,1312,192,506,698,32,730
公投第１５案,臺東縣,臺東市,光明里,35,1265,220,478,698,40,738
公投第１５案,臺東縣,臺東市,豐年里,36,1407,198,413,611,68,679
公投第１５案,臺東縣,臺東市,豐年里,37,1552,189,520,709,49,758
公投第１５案,臺東縣,臺東市,豐樂里,38,1445,194,535,729,82,811
公投第１５案,臺東縣,臺東市,永樂里,39,2098,352,776,1128,68,1196
公投第１５案,臺東縣,臺東市,康樂里,40,1324,186,525,711,80,791
公投第１５案,臺東縣,臺東市,豐榮里,41,1598,197,644,841,31,872
公投第１５案,臺東縣,臺東市,豐榮里,42,1513,207,567,774,33,807
公投第１５案,臺東縣,臺東市,豐榮里,43,1679,235,585,820,37,857
公投第１５案,臺東縣,臺東市,豐榮里,44,1414,218,479,697,49,746
公投第１５案,臺東縣,臺東市,豐榮里,45,1798,265,649,914,51,965
公投第１５案,臺東縣,臺東市,豐谷里,46,1749,229,533,762,57,819
公投第１５案,臺東縣,臺東市,豐谷里,47,1709,226,634,860,81,941
公投第１５案,臺東縣,臺東市,豐谷里,48,1629,216,596,812,50,862
公投第１５案,臺東縣,臺東市,豐里里,49,1116,149,384,533,63,596
公投第１５案,臺東縣,臺東市,豐里里,50,1259,123,405,528,41,569
公投第１５案,臺東縣,臺東市,豐原里,51,1232,161,369,530,48,578
公投第１５案,臺東縣,臺東市,富岡里,52,1505,145,517,662,112,774
公投第１５案,臺東縣,臺東市,富豐里,53,836,104,245,349,55,404
公投第１５案,臺東縣,臺東市,南榮里,54,1294,194,498,692,44,736
公投第１５案,臺東縣,臺東市,南榮里,55,1350,181,455,636,85,721
公投第１５案,臺東縣,臺東市,岩灣里,56,2162,304,806,1110,86,1196
公投第１５案,臺東縣,臺東市,卑南里,57,1627,313,609,922,41,963
公投第１５案,臺東縣,臺東市,卑南里,58,1140,173,455,628,34,662
公投第１５案,臺東縣,臺東市,南王里,59,1359,183,503,686,40,726
公投第１５案,臺東縣,臺東市,南王里,60,1329,213,479,692,47,739
公投第１５案,臺東縣,臺東市,豐田里,61,990,117,368,485,30,515
公投第１５案,臺東縣,臺東市,豐田里,62,1038,135,407,542,49,591
公投第１５案,臺東縣,臺東市,新園里,63,1597,207,562,769,81,850
公投第１５案,臺東縣,臺東市,建和里,64,1385,222,431,653,89,742
公投第１５案,臺東縣,臺東市,建興里,65,939,143,270,413,18,431
公投第１５案,臺東縣,臺東市,建業里,66,1258,146,364,510,55,565
公投第１５案,臺東縣,臺東市,知本里,67,1350,221,427,648,8,656
公投第１５案,臺東縣,臺東市,建農里,68,1058,112,336,448,49,497
公投第１５案,臺東縣,臺東市,建農里,69,895,82,283,365,36,401
公投第１５案,臺東縣,成功鎮,信義里,70,516,47,159,206,53,259
公投第１５案,臺東縣,成功鎮,信義里,71,960,115,335,450,95,545
公投第１５案,臺東縣,成功鎮,信義里,72,365,21,95,116,18,134
公投第１５案,臺東縣,成功鎮,和平里,73,747,61,211,272,73,345
公投第１５案,臺東縣,成功鎮,忠仁里,74,339,27,109,136,24,160
公投第１５案,臺東縣,成功鎮,忠仁里,75,995,119,333,452,24,476
公投第１５案,臺東縣,成功鎮,忠仁里,76,863,106,315,421,61,482
公投第１５案,臺東縣,成功鎮,忠智里,77,931,108,368,476,34,510
公投第１５案,臺東縣,成功鎮,忠智里,78,970,107,356,463,32,495
公投第１５案,臺東縣,成功鎮,三民里,79,1365,127,481,608,90,698
公投第１５案,臺東縣,成功鎮,三民里,80,1366,129,521,650,76,726
公投第１５案,臺東縣,成功鎮,三仙里,81,516,40,172,212,49,261
公投第１５案,臺東縣,成功鎮,三仙里,82,887,88,235,323,87,410
公投第１５案,臺東縣,成功鎮,忠孝里,83,488,38,140,178,41,219
公投第１５案,臺東縣,成功鎮,忠孝里,84,481,43,120,163,32,195
公投第１５案,臺東縣,成功鎮,博愛里,85,373,12,73,85,2,87
公投第１５案,臺東縣,成功鎮,博愛里,86,264,29,87,116,27,143
公投第１５案,臺東縣,關山鎮,里壠里,87,909,147,366,513,27,540
公投第１５案,臺東縣,關山鎮,里壠里,88,790,105,212,317,24,341
公投第１５案,臺東縣,關山鎮,中福里,89,828,137,329,466,35,501
公投第１５案,臺東縣,關山鎮,新福里,90,887,108,260,368,24,392
公投第１５案,臺東縣,關山鎮,豐泉里,91,1137,170,419,589,37,626
公投第１５案,臺東縣,關山鎮,月眉里,92,732,81,241,322,34,356
公投第１５案,臺東縣,關山鎮,德高里,93,912,123,300,423,48,471
公投第１５案,臺東縣,關山鎮,德高里,94,779,93,202,295,18,313
公投第１５案,臺東縣,關山鎮,電光里,95,535,68,113,181,23,204
公投第１５案,臺東縣,卑南鄉,賓朗村,96,1041,159,382,541,58,599
公投第１５案,臺東縣,卑南鄉,賓朗村,97,1165,170,387,557,22,579
公投第１５案,臺東縣,卑南鄉,美農村,98,219,30,45,75,22,97
公投第１５案,臺東縣,卑南鄉,美農村,99,460,65,121,186,36,222
公投第１５案,臺東縣,卑南鄉,美農村,100,387,39,98,137,18,155
公投第１５案,臺東縣,卑南鄉,初鹿村,101,767,104,224,328,15,343
公投第１５案,臺東縣,卑南鄉,初鹿村,102,503,62,177,239,33,272
公投第１５案,臺東縣,卑南鄉,明峰村,103,727,97,203,300,51,351
公投第１５案,臺東縣,卑南鄉,明峰村,104,436,50,143,193,36,229
公投第１５案,臺東縣,卑南鄉,嘉豐村,105,261,29,53,82,14,96
公投第１５案,臺東縣,卑南鄉,嘉豐村,106,215,27,78,105,13,118
公投第１５案,臺東縣,卑南鄉,太平村,107,1442,224,526,750,61,811
公投第１５案,臺東縣,卑南鄉,太平村,108,527,70,180,250,13,263
公投第１５案,臺東縣,卑南鄉,太平村,109,1046,146,385,531,51,582
公投第１５案,臺東縣,卑南鄉,泰安村,110,1110,174,362,536,69,605
公投第１５案,臺東縣,卑南鄉,利嘉村,111,1105,180,395,575,54,629
公投第１５案,臺東縣,卑南鄉,東興村,112,1167,166,439,605,122,727
公投第１５案,臺東縣,卑南鄉,溫泉村,113,968,136,286,422,48,470
公投第１５案,臺東縣,卑南鄉,溫泉村,114,159,25,35,60,3,63
公投第１５案,臺東縣,卑南鄉,富山村,115,488,50,148,198,20,218
公投第１５案,臺東縣,卑南鄉,富源村,116,347,55,127,182,20,202
公投第１５案,臺東縣,卑南鄉,利吉村,117,436,54,158,212,24,236
公投第１５案,臺東縣,鹿野鄉,鹿野村,118,522,52,136,188,8,196
公投第１５案,臺東縣,鹿野鄉,鹿野村,119,574,83,202,285,21,306
公投第１５案,臺東縣,鹿野鄉,龍田村,120,1055,147,239,386,28,414
公投第１５案,臺東縣,鹿野鄉,永安村,121,1104,155,320,475,38,513
公投第１５案,臺東縣,鹿野鄉,永安村,122,342,31,115,146,9,155
公投第１５案,臺東縣,鹿野鄉,瑞隆村,123,895,99,287,386,39,425
公投第１５案,臺東縣,鹿野鄉,瑞源村,124,864,119,265,384,39,423
公投第１５案,臺東縣,鹿野鄉,瑞和村,125,675,81,165,246,42,288
公投第１５案,臺東縣,鹿野鄉,瑞豐村,126,435,65,133,198,17,215
公投第１５案,臺東縣,鹿野鄉,瑞豐村,127,470,64,103,167,18,185
公投第１５案,臺東縣,池上鄉,福原村,128,992,143,307,450,30,480
公投第１５案,臺東縣,池上鄉,福原村,129,929,150,328,478,34,512
公投第１５案,臺東縣,池上鄉,福文村,130,434,57,127,184,27,211
公投第１５案,臺東縣,池上鄉,福文村,131,703,86,190,276,32,308
公投第１５案,臺東縣,池上鄉,慶豐村,132,654,72,190,262,24,286
公投第１５案,臺東縣,池上鄉,大坡村,133,324,33,75,108,21,129
公投第１５案,臺東縣,池上鄉,大埔村,134,794,95,224,319,40,359
公投第１５案,臺東縣,池上鄉,新興村,135,856,101,252,353,59,412
公投第１５案,臺東縣,池上鄉,錦園村,136,344,34,93,127,15,142
公投第１５案,臺東縣,池上鄉,萬安村,137,311,47,109,156,21,177
公投第１５案,臺東縣,池上鄉,富興村,138,386,36,87,123,14,137
公投第１５案,臺東縣,池上鄉,振興村,139,435,40,93,133,19,152
公投第１５案,臺東縣,東河鄉,都蘭村,140,290,36,65,101,23,124
公投第１５案,臺東縣,東河鄉,都蘭村,141,620,108,201,309,41,350
公投第１５案,臺東縣,東河鄉,都蘭村,142,1196,186,435,621,113,734
公投第１５案,臺東縣,東河鄉,興昌村,143,918,113,241,354,82,436
公投第１５案,臺東縣,東河鄉,隆昌村,144,555,59,166,225,34,259
公投第１５案,臺東縣,東河鄉,東河村,145,977,108,287,395,28,423
公投第１５案,臺東縣,東河鄉,泰源村,146,1197,77,269,346,22,368
公投第１５案,臺東縣,東河鄉,北源村,147,867,34,155,189,22,211
公投第１５案,臺東縣,東河鄉,北源村,148,345,42,87,129,19,148
公投第１５案,臺東縣,東河鄉,北源村,149,408,37,110,147,25,172
公投第１５案,臺東縣,東河鄉,尚德村,150,262,31,72,103,11,114
公投第１５案,臺東縣,長濱鄉,寧埔村,151,536,83,175,258,51,309
公投第１５案,臺東縣,長濱鄉,寧埔村,152,689,49,155,204,28,232
公投第１５案,臺東縣,長濱鄉,竹湖村,153,913,103,285,388,103,491
公投第１５案,臺東縣,長濱鄉,長濱村,154,1268,109,325,434,26,460
公投第１５案,臺東縣,長濱鄉,長濱村,155,725,66,215,281,60,341
公投第１５案,臺東縣,長濱鄉,忠勇村,156,532,41,93,134,13,147
公投第１５案,臺東縣,長濱鄉,三間村,157,660,61,155,216,63,279
公投第１５案,臺東縣,長濱鄉,三間村,158,336,15,87,102,5,107
公投第１５案,臺東縣,長濱鄉,三間村,159,195,11,39,50,14,64
公投第１５案,臺東縣,長濱鄉,樟原村,160,25,4,7,11,2,13
公投第１５案,臺東縣,長濱鄉,樟原村,161,605,51,181,232,36,268
公投第１５案,臺東縣,太麻里鄉,美和村,162,722,95,247,342,42,384
公投第１５案,臺東縣,太麻里鄉,美和村,163,575,64,207,271,23,294
公投第１５案,臺東縣,太麻里鄉,三和村,164,623,91,196,287,26,313
公投第１５案,臺東縣,太麻里鄉,華源村,165,622,67,202,269,35,304
公投第１５案,臺東縣,太麻里鄉,北里村,166,560,58,154,212,15,227
公投第１５案,臺東縣,太麻里鄉,大王村,167,957,104,354,458,82,540
公投第１５案,臺東縣,太麻里鄉,大王村,168,809,103,240,343,43,386
公投第１５案,臺東縣,太麻里鄉,泰和村,169,673,129,248,377,38,415
公投第１５案,臺東縣,太麻里鄉,泰和村,170,737,89,253,342,38,380
公投第１５案,臺東縣,太麻里鄉,香蘭村,171,424,56,159,215,26,241
公投第１５案,臺東縣,太麻里鄉,香蘭村,172,374,51,98,149,30,179
公投第１５案,臺東縣,太麻里鄉,金崙村,173,829,80,233,313,15,328
公投第１５案,臺東縣,太麻里鄉,金崙村,174,869,63,276,339,8,347
公投第１５案,臺東縣,太麻里鄉,多良村,175,223,16,52,68,5,73
公投第１５案,臺東縣,太麻里鄉,多良村,176,669,81,229,310,54,364
公投第１５案,臺東縣,大武鄉,南興村,177,568,60,242,302,41,343
公投第１５案,臺東縣,大武鄉,尚武村,178,1474,179,436,615,115,730
公投第１５案,臺東縣,大武鄉,大武村,179,1327,177,444,621,87,708
公投第１５案,臺東縣,大武鄉,大鳥村,180,1134,150,306,456,76,532
公投第１５案,臺東縣,大武鄉,大竹村,181,386,36,117,153,60,213
公投第１５案,臺東縣,大武鄉,大竹村,182,377,34,125,159,20,179
公投第１５案,臺東縣,綠島鄉,南寮村,183,1474,176,423,599,26,625
公投第１５案,臺東縣,綠島鄉,中寮村,184,1082,140,306,446,27,473
公投第１５案,臺東縣,綠島鄉,公舘村,185,813,121,242,363,18,381
公投第１５案,臺東縣,綠島鄉,公舘村,186,210,30,68,98,2,100
公投第１５案,臺東縣,海端鄉,加拿村,187,497,54,183,237,26,263
公投第１５案,臺東縣,海端鄉,崁頂村,188,569,56,259,315,15,330
公投第１５案,臺東縣,海端鄉,海端村,189,971,124,310,434,47,481
公投第１５案,臺東縣,海端鄉,廣原村,190,728,67,288,355,38,393
公投第１５案,臺東縣,海端鄉,霧鹿村,191,259,41,90,131,16,147
公投第１５案,臺東縣,海端鄉,利稻村,192,254,31,96,127,13,140
公投第１５案,臺東縣,延平鄉,桃源村,193,1014,130,381,511,32,543
公投第１５案,臺東縣,延平鄉,紅葉村,194,426,52,195,247,50,297
公投第１５案,臺東縣,延平鄉,永康村,195,315,36,151,187,22,209
公投第１５案,臺東縣,延平鄉,武陵村,196,579,58,196,254,21,275
公投第１５案,臺東縣,延平鄉,鸞山村,197,596,59,195,254,21,275
公投第１５案,臺東縣,金峰鄉,嘉蘭村,198,1241,149,405,554,45,599
公投第１５案,臺東縣,金峰鄉,正興村,199,601,104,260,364,32,396
公投第１５案,臺東縣,金峰鄉,新興村,200,520,109,244,353,40,393
公投第１５案,臺東縣,金峰鄉,賓茂村,201,336,44,123,167,22,189
公投第１５案,臺東縣,金峰鄉,歷坵村,202,330,48,144,192,31,223
公投第１５案,臺東縣,達仁鄉,安朔村,203,246,30,115,145,9,154
公投第１５案,臺東縣,達仁鄉,安朔村,204,340,25,168,193,25,218
公投第１５案,臺東縣,達仁鄉,南田村,205,296,43,135,178,17,195
公投第１５案,臺東縣,達仁鄉,森永村,206,429,57,204,261,20,281
公投第１５案,臺東縣,達仁鄉,新化村,207,331,33,154,187,29,216
公投第１５案,臺東縣,達仁鄉,台坂村,208,628,74,191,265,19,284
公投第１５案,臺東縣,達仁鄉,土坂村,209,867,120,294,414,69,483
公投第１５案,臺東縣,蘭嶼鄉,椰油村,210,943,83,275,358,27,385
公投第１５案,臺東縣,蘭嶼鄉,紅頭村,211,1238,146,342,488,41,529
公投第１５案,臺東縣,蘭嶼鄉,東清村,212,1240,122,266,388,20,408
公投第１５案,臺東縣,蘭嶼鄉,朗島村,213,760,101,149,250,29,279
公投第１５案,花蓮縣,花蓮市,民德里,1,1522,279,564,843,25,868
公投第１５案,花蓮縣,花蓮市,民勤里,2,1114,192,439,631,20,651
公投第１５案,花蓮縣,花蓮市,民勤里,3,670,119,240,359,17,376
公投第１５案,花蓮縣,花蓮市,民勤里,4,1397,225,495,720,18,738
公投第１５案,花蓮縣,花蓮市,民意里,5,470,68,152,220,19,239
公投第１５案,花蓮縣,花蓮市,民意里,6,838,105,300,405,27,432
公投第１５案,花蓮縣,花蓮市,民意里,7,721,69,223,292,16,308
公投第１５案,花蓮縣,花蓮市,民心里,8,918,155,345,500,32,532
公投第１５案,花蓮縣,花蓮市,民享里,9,1539,260,521,781,29,810
公投第１５案,花蓮縣,花蓮市,民享里,10,1403,211,500,711,36,747
公投第１５案,花蓮縣,花蓮市,民孝里,11,1068,149,395,544,22,566
公投第１５案,花蓮縣,花蓮市,民孝里,12,1167,177,450,627,19,646
公投第１５案,花蓮縣,花蓮市,民孝里,13,1259,211,502,713,40,753
公投第１５案,花蓮縣,花蓮市,民運里,14,1071,155,384,539,57,596
公投第１５案,花蓮縣,花蓮市,民運里,15,925,155,350,505,24,529
公投第１５案,花蓮縣,花蓮市,民政里,16,1141,191,478,669,44,713
公投第１５案,花蓮縣,花蓮市,民政里,17,1163,176,425,601,15,616
公投第１５案,花蓮縣,花蓮市,民政里,18,1279,213,503,716,31,747
公投第１５案,花蓮縣,花蓮市,民立里,19,1512,231,496,727,18,745
公投第１５案,花蓮縣,花蓮市,民樂里,20,615,111,203,314,20,334
公投第１５案,花蓮縣,花蓮市,民有里,21,606,114,230,344,14,358
公投第１５案,花蓮縣,花蓮市,民主里,22,559,75,199,274,10,284
公投第１５案,花蓮縣,花蓮市,民族里,23,442,62,173,235,13,248
公投第１５案,花蓮縣,花蓮市,民生里,24,1114,153,393,546,26,572
公投第１５案,花蓮縣,花蓮市,民權里,25,416,61,167,228,12,240
公投第１５案,花蓮縣,花蓮市,主商里,26,577,105,235,340,15,355
公投第１５案,花蓮縣,花蓮市,主勤里,27,810,155,316,471,24,495
公投第１５案,花蓮縣,花蓮市,主工里,28,538,89,203,292,17,309
公投第１５案,花蓮縣,花蓮市,主信里,29,566,85,201,286,24,310
公投第１５案,花蓮縣,花蓮市,主義里,30,469,76,176,252,9,261
公投第１５案,花蓮縣,花蓮市,主睦里,31,565,100,206,306,17,323
公投第１５案,花蓮縣,花蓮市,主計里,32,816,107,275,382,24,406
公投第１５案,花蓮縣,花蓮市,主和里,33,911,141,301,442,39,481
公投第１５案,花蓮縣,花蓮市,主和里,34,1029,129,376,505,34,539
公投第１５案,花蓮縣,花蓮市,主和里,35,1043,180,401,581,35,616
公投第１５案,花蓮縣,花蓮市,主學里,36,856,151,324,475,19,494
公投第１５案,花蓮縣,花蓮市,主學里,37,979,168,358,526,15,541
公投第１５案,花蓮縣,花蓮市,主農里,38,1331,213,491,704,46,750
公投第１５案,花蓮縣,花蓮市,主農里,39,1228,303,367,670,27,697
公投第１５案,花蓮縣,花蓮市,主農里,40,955,145,381,526,21,547
公投第１５案,花蓮縣,花蓮市,主安里,41,1268,191,425,616,27,643
公投第１５案,花蓮縣,花蓮市,主安里,42,1230,185,432,617,26,643
公投第１５案,花蓮縣,花蓮市,主權里,43,1369,213,528,741,34,775
公投第１５案,花蓮縣,花蓮市,主權里,44,1435,202,442,644,22,666
公投第１５案,花蓮縣,花蓮市,主權里,45,1164,173,443,616,23,639
公投第１５案,花蓮縣,花蓮市,主權里,46,1249,201,501,702,36,738
公投第１５案,花蓮縣,花蓮市,主力里,47,1184,196,413,609,47,656
公投第１５案,花蓮縣,花蓮市,主力里,48,1490,150,613,763,19,782
公投第１５案,花蓮縣,花蓮市,國風里,49,1022,177,431,608,36,644
公投第１５案,花蓮縣,花蓮市,國風里,50,1135,179,426,605,33,638
公投第１５案,花蓮縣,花蓮市,國風里,51,1084,143,442,585,25,610
公投第１５案,花蓮縣,花蓮市,國威里,52,1339,150,330,480,19,499
公投第１５案,花蓮縣,花蓮市,國威里,53,501,89,195,284,18,302
公投第１５案,花蓮縣,花蓮市,國治里,54,904,145,340,485,19,504
公投第１５案,花蓮縣,花蓮市,國安里,55,490,95,195,290,14,304
公投第１５案,花蓮縣,花蓮市,國光里,56,1192,152,394,546,28,574
公投第１５案,花蓮縣,花蓮市,國防里,57,869,126,286,412,25,437
公投第１５案,花蓮縣,花蓮市,國華里,58,1267,201,449,650,26,676
公投第１５案,花蓮縣,花蓮市,國華里,59,959,161,367,528,29,557
公投第１５案,花蓮縣,花蓮市,國魂里,60,993,152,365,517,27,544
公投第１５案,花蓮縣,花蓮市,國魂里,61,982,149,366,515,37,552
公投第１５案,花蓮縣,花蓮市,國聯里,62,1311,201,427,628,14,642
公投第１５案,花蓮縣,花蓮市,國聯里,63,1455,217,493,710,38,748
公投第１５案,花蓮縣,花蓮市,國盛里,64,1151,124,385,509,27,536
公投第１５案,花蓮縣,花蓮市,國盛里,65,1237,171,420,591,22,613
公投第１５案,花蓮縣,花蓮市,國盛里,66,1339,226,399,625,21,646
公投第１５案,花蓮縣,花蓮市,國強里,67,715,124,271,395,20,415
公投第１５案,花蓮縣,花蓮市,國強里,68,1000,163,369,532,27,559
公投第１５案,花蓮縣,花蓮市,國富里,69,1410,179,475,654,45,699
公投第１５案,花蓮縣,花蓮市,國富里,70,1303,177,493,670,13,683
公投第１５案,花蓮縣,花蓮市,國富里,71,1256,195,452,647,25,672
公投第１５案,花蓮縣,花蓮市,國富里,72,1105,144,459,603,33,636
公投第１５案,花蓮縣,花蓮市,國裕里,73,1089,168,367,535,22,557
公投第１５案,花蓮縣,花蓮市,國裕里,74,1043,139,371,510,22,532
公投第１５案,花蓮縣,花蓮市,國裕里,75,1080,147,444,591,31,622
公投第１５案,花蓮縣,花蓮市,國裕里,76,971,146,377,523,23,546
公投第１５案,花蓮縣,花蓮市,國慶里,77,1068,195,398,593,19,612
公投第１５案,花蓮縣,花蓮市,國興里,78,1379,198,472,670,24,694
公投第１５案,花蓮縣,花蓮市,國興里,79,1362,241,445,686,31,717
公投第１５案,花蓮縣,花蓮市,國興里,80,1323,242,493,735,21,756
公投第１５案,花蓮縣,花蓮市,國福里,81,1482,181,465,646,36,682
公投第１５案,花蓮縣,新城鄉,新城村,82,367,73,121,194,18,212
公投第１５案,花蓮縣,新城鄉,新城村,83,929,116,334,450,18,468
公投第１５案,花蓮縣,新城鄉,順安村,84,590,112,193,305,50,355
公投第１５案,花蓮縣,新城鄉,順安村,85,307,52,99,151,22,173
公投第１５案,花蓮縣,新城鄉,康樂村,86,260,36,111,147,13,160
公投第１５案,花蓮縣,新城鄉,康樂村,87,1283,221,439,660,59,719
公投第１５案,花蓮縣,新城鄉,康樂村,88,885,95,332,427,22,449
公投第１５案,花蓮縣,新城鄉,大漢村,89,770,109,307,416,30,446
公投第１５案,花蓮縣,新城鄉,大漢村,90,1363,167,523,690,54,744
公投第１５案,花蓮縣,新城鄉,大漢村,91,366,63,123,186,12,198
公投第１５案,花蓮縣,新城鄉,北埔村,92,1163,151,395,546,48,594
公投第１５案,花蓮縣,新城鄉,北埔村,93,1605,220,590,810,37,847
公投第１５案,花蓮縣,新城鄉,北埔村,94,1194,176,446,622,35,657
公投第１５案,花蓮縣,新城鄉,佳林村,95,979,151,371,522,30,552
公投第１５案,花蓮縣,新城鄉,嘉里村,96,1485,205,585,790,40,830
公投第１５案,花蓮縣,新城鄉,嘉里村,97,1070,157,380,537,23,560
公投第１５案,花蓮縣,新城鄉,嘉里村,98,1164,189,421,610,24,634
公投第１５案,花蓮縣,新城鄉,嘉新村,99,880,119,306,425,43,468
公投第１５案,花蓮縣,新城鄉,嘉新村,100,369,61,117,178,8,186
公投第１５案,花蓮縣,秀林鄉,和平村,101,867,100,327,427,23,450
公投第１５案,花蓮縣,秀林鄉,和平村,102,575,88,187,275,24,299
公投第１５案,花蓮縣,秀林鄉,崇德村,103,1373,127,418,545,31,576
公投第１５案,花蓮縣,秀林鄉,富世村,104,1644,177,549,726,65,791
公投第１５案,花蓮縣,秀林鄉,富世村,105,162,19,67,86,4,90
公投第１５案,花蓮縣,秀林鄉,秀林村,106,384,50,127,177,17,194
公投第１５案,花蓮縣,秀林鄉,秀林村,107,1382,186,427,613,39,652
公投第１５案,花蓮縣,秀林鄉,景美村,108,1125,166,349,515,37,552
公投第１５案,花蓮縣,秀林鄉,景美村,109,627,106,186,292,13,305
公投第１５案,花蓮縣,秀林鄉,佳民村,110,987,154,409,563,38,601
公投第１５案,花蓮縣,秀林鄉,水源村,111,1139,182,437,619,82,701
公投第１５案,花蓮縣,秀林鄉,銅門村,112,1213,186,459,645,13,658
公投第１５案,花蓮縣,秀林鄉,文蘭村,113,754,113,273,386,21,407
公投第１５案,花蓮縣,秀林鄉,文蘭村,114,330,40,111,151,8,159
公投第１５案,花蓮縣,吉安鄉,永安村,115,1059,158,376,534,26,560
公投第１５案,花蓮縣,吉安鄉,永安村,116,983,150,369,519,29,548
公投第１５案,花蓮縣,吉安鄉,永安村,117,1031,150,391,541,23,564
公投第１５案,花蓮縣,吉安鄉,永安村,118,1105,164,383,547,24,571
公投第１５案,花蓮縣,吉安鄉,太昌村,119,1107,179,374,553,26,579
公投第１５案,花蓮縣,吉安鄉,太昌村,120,1179,179,385,564,26,590
公投第１５案,花蓮縣,吉安鄉,太昌村,121,1453,192,423,615,50,665
公投第１５案,花蓮縣,吉安鄉,慶豐村,122,1432,243,562,805,36,841
公投第１５案,花蓮縣,吉安鄉,慶豐村,123,1320,209,496,705,22,727
公投第１５案,花蓮縣,吉安鄉,慶豐村,124,1356,200,479,679,21,700
公投第１５案,花蓮縣,吉安鄉,慶豐村,125,1295,173,481,654,23,677
公投第１５案,花蓮縣,吉安鄉,慶豐村,126,1467,226,525,751,47,798
公投第１５案,花蓮縣,吉安鄉,吉安村,127,1515,226,541,767,25,792
公投第１５案,花蓮縣,吉安鄉,吉安村,128,1063,183,412,595,35,630
公投第１５案,花蓮縣,吉安鄉,吉安村,129,1284,172,389,561,13,574
公投第１５案,花蓮縣,吉安鄉,吉安村,130,1380,224,527,751,22,773
公投第１５案,花蓮縣,吉安鄉,福興村,131,1297,197,487,684,50,734
公投第１５案,花蓮縣,吉安鄉,福興村,132,1662,242,555,797,65,862
公投第１５案,花蓮縣,吉安鄉,南華村,133,1563,181,513,694,60,754
公投第１５案,花蓮縣,吉安鄉,干城村,134,1288,145,441,586,36,622
公投第１５案,花蓮縣,吉安鄉,永興村,135,907,149,338,487,27,514
公投第１５案,花蓮縣,吉安鄉,永興村,136,917,126,321,447,26,473
公投第１５案,花蓮縣,吉安鄉,永興村,137,1021,157,347,504,21,525
公投第１５案,花蓮縣,吉安鄉,稻香村,138,1033,172,414,586,28,614
公投第１５案,花蓮縣,吉安鄉,稻香村,139,966,156,355,511,41,552
公投第１５案,花蓮縣,吉安鄉,稻香村,140,1188,155,428,583,42,625
公投第１５案,花蓮縣,吉安鄉,南昌村,141,1480,189,557,746,27,773
公投第１５案,花蓮縣,吉安鄉,南昌村,142,1393,164,482,646,29,675
公投第１５案,花蓮縣,吉安鄉,南昌村,143,1193,174,412,586,27,613
公投第１５案,花蓮縣,吉安鄉,宜昌村,144,1445,180,493,673,29,702
公投第１５案,花蓮縣,吉安鄉,宜昌村,145,1301,190,454,644,70,714
公投第１５案,花蓮縣,吉安鄉,宜昌村,146,1215,193,450,643,48,691
公投第１５案,花蓮縣,吉安鄉,北昌村,147,1135,180,400,580,30,610
公投第１５案,花蓮縣,吉安鄉,北昌村,148,1223,171,495,666,25,691
公投第１５案,花蓮縣,吉安鄉,北昌村,149,1274,161,513,674,23,697
公投第１５案,花蓮縣,吉安鄉,北昌村,150,1124,161,404,565,29,594
公投第１５案,花蓮縣,吉安鄉,北昌村,151,1158,199,427,626,25,651
公投第１５案,花蓮縣,吉安鄉,北昌村,152,1157,196,434,630,17,647
公投第１５案,花蓮縣,吉安鄉,勝安村,153,1258,196,478,674,21,695
公投第１５案,花蓮縣,吉安鄉,勝安村,154,1257,187,453,640,32,672
公投第１５案,花蓮縣,吉安鄉,勝安村,155,1245,183,448,631,21,652
公投第１５案,花蓮縣,吉安鄉,勝安村,156,1166,195,447,642,8,650
公投第１５案,花蓮縣,吉安鄉,仁里村,157,1358,191,470,661,50,711
公投第１５案,花蓮縣,吉安鄉,仁里村,158,1214,137,465,602,26,628
公投第１５案,花蓮縣,吉安鄉,仁里村,159,1151,169,414,583,38,621
公投第１５案,花蓮縣,吉安鄉,仁里村,160,1157,166,446,612,28,640
公投第１５案,花蓮縣,吉安鄉,仁里村,161,1161,189,441,630,24,654
公投第１５案,花蓮縣,吉安鄉,東昌村,162,1304,207,497,704,33,737
公投第１５案,花蓮縣,吉安鄉,東昌村,163,1367,184,492,676,43,719
公投第１５案,花蓮縣,吉安鄉,東昌村,164,1411,169,469,638,28,666
公投第１５案,花蓮縣,吉安鄉,東昌村,165,1409,145,480,625,41,666
公投第１５案,花蓮縣,吉安鄉,仁安村,166,1125,139,369,508,30,538
公投第１５案,花蓮縣,吉安鄉,仁安村,167,1213,164,453,617,48,665
公投第１５案,花蓮縣,吉安鄉,仁和村,168,1141,134,461,595,31,626
公投第１５案,花蓮縣,吉安鄉,仁和村,169,1156,134,384,518,20,538
公投第１５案,花蓮縣,吉安鄉,仁和村,170,1092,116,425,541,30,571
公投第１５案,花蓮縣,吉安鄉,仁和村,171,1026,115,324,439,28,467
公投第１５案,花蓮縣,吉安鄉,光華村,172,804,99,317,416,13,429
公投第１５案,花蓮縣,吉安鄉,光華村,173,1132,147,449,596,31,627
公投第１５案,花蓮縣,壽豐鄉,溪口村,174,1052,133,349,482,34,516
公投第１５案,花蓮縣,壽豐鄉,樹湖村,175,357,51,139,190,28,218
公投第１５案,花蓮縣,壽豐鄉,豐山村,176,1022,140,325,465,50,515
公投第１５案,花蓮縣,壽豐鄉,豐山村,177,875,143,372,515,33,548
公投第１５案,花蓮縣,壽豐鄉,豐裡村,178,691,121,276,397,27,424
公投第１５案,花蓮縣,壽豐鄉,豐裡村,179,708,80,244,324,21,345
公投第１５案,花蓮縣,壽豐鄉,豐坪村,180,894,132,301,433,41,474
公投第１５案,花蓮縣,壽豐鄉,壽豐村,181,746,137,250,387,23,410
公投第１５案,花蓮縣,壽豐鄉,壽豐村,182,881,126,306,432,37,469
公投第１５案,花蓮縣,壽豐鄉,共和村,183,695,121,287,408,28,436
公投第１５案,花蓮縣,壽豐鄉,光榮村,184,816,120,331,451,70,521
公投第１５案,花蓮縣,壽豐鄉,池南村,185,773,100,253,353,42,395
公投第１５案,花蓮縣,壽豐鄉,平和村,186,1029,171,372,543,46,589
公投第１５案,花蓮縣,壽豐鄉,平和村,187,407,54,182,236,22,258
公投第１５案,花蓮縣,壽豐鄉,志學村,188,1139,173,429,602,48,650
公投第１５案,花蓮縣,壽豐鄉,志學村,189,996,215,325,540,33,573
公投第１５案,花蓮縣,壽豐鄉,志學村,190,414,57,117,174,14,188
公投第１５案,花蓮縣,壽豐鄉,米棧村,191,270,39,107,146,11,157
公投第１５案,花蓮縣,壽豐鄉,月眉村,192,836,98,338,436,53,489
公投第１５案,花蓮縣,壽豐鄉,鹽寮村,193,507,79,202,281,28,309
公投第１５案,花蓮縣,壽豐鄉,水璉村,194,739,73,198,271,45,316
公投第１５案,花蓮縣,鳳林鎮,鳳仁里,195,1192,175,506,681,55,736
公投第１５案,花蓮縣,鳳林鎮,鳳義里,196,639,74,231,305,20,325
公投第１５案,花蓮縣,鳳林鎮,鳳禮里,197,601,91,272,363,38,401
公投第１５案,花蓮縣,鳳林鎮,鳳智里,198,1137,189,500,689,39,728
公投第１５案,花蓮縣,鳳林鎮,鳳信里,199,742,106,267,373,45,418
公投第１５案,花蓮縣,鳳林鎮,鳳信里,200,610,78,257,335,16,351
公投第１５案,花蓮縣,鳳林鎮,山興里,201,295,52,104,156,36,192
公投第１５案,花蓮縣,鳳林鎮,山興里,202,218,12,52,64,3,67
公投第１５案,花蓮縣,鳳林鎮,大榮里,203,720,87,205,292,19,311
公投第１５案,花蓮縣,鳳林鎮,大榮里,204,528,81,181,262,27,289
公投第１５案,花蓮縣,鳳林鎮,北林里,205,560,89,183,272,18,290
公投第１５案,花蓮縣,鳳林鎮,南平里,206,541,68,181,249,42,291
公投第１５案,花蓮縣,鳳林鎮,林榮里,207,818,99,312,411,53,464
公投第１５案,花蓮縣,鳳林鎮,長橋里,208,984,112,272,384,44,428
公投第１５案,花蓮縣,鳳林鎮,森榮里,209,91,14,24,38,11,49
公投第１５案,花蓮縣,光復鄉,大華村,210,1295,178,479,657,74,731
公投第１５案,花蓮縣,光復鄉,大安村,211,859,119,349,468,32,500
公投第１５案,花蓮縣,光復鄉,大平村,212,958,120,345,465,106,571
公投第１５案,花蓮縣,光復鄉,大馬村,213,1011,108,403,511,88,599
公投第１５案,花蓮縣,光復鄉,大同村,214,1041,142,396,538,64,602
公投第１５案,花蓮縣,光復鄉,東富村,215,821,98,274,372,79,451
公投第１５案,花蓮縣,光復鄉,東富村,216,188,10,31,41,4,45
公投第１５案,花蓮縣,光復鄉,西富村,217,514,59,187,246,35,281
公投第１５案,花蓮縣,光復鄉,西富村,218,446,34,128,162,10,172
公投第１５案,花蓮縣,光復鄉,南富村,219,851,86,290,376,56,432
公投第１５案,花蓮縣,光復鄉,北富村,220,932,106,222,328,20,348
公投第１５案,花蓮縣,光復鄉,大進村,221,471,62,185,247,22,269
公投第１５案,花蓮縣,光復鄉,大全村,222,640,96,224,320,35,355
公投第１５案,花蓮縣,光復鄉,大全村,223,116,6,32,38,7,45
公投第１５案,花蓮縣,光復鄉,大興村,224,496,42,115,157,5,162
公投第１５案,花蓮縣,光復鄉,大富村,225,324,43,90,133,13,146
公投第１５案,花蓮縣,光復鄉,大豐村,226,454,36,121,157,24,181
公投第１５案,花蓮縣,豐濱鄉,靜浦村,227,717,67,200,267,75,342
公投第１５案,花蓮縣,豐濱鄉,港口村,228,751,92,166,258,52,310
公投第１５案,花蓮縣,豐濱鄉,豐濱村,229,613,81,169,250,42,292
公投第１５案,花蓮縣,豐濱鄉,豐濱村,230,809,107,283,390,20,410
公投第１５案,花蓮縣,豐濱鄉,豐濱村,231,357,24,62,86,5,91
公投第１５案,花蓮縣,豐濱鄉,新社村,232,669,85,190,275,66,341
公投第１５案,花蓮縣,豐濱鄉,磯崎村,233,479,64,137,201,11,212
公投第１５案,花蓮縣,萬榮鄉,西林村,234,1072,152,379,531,67,598
公投第１５案,花蓮縣,萬榮鄉,見晴村,235,560,75,179,254,6,260
公投第１５案,花蓮縣,萬榮鄉,萬榮村,236,773,119,326,445,28,473
公投第１５案,花蓮縣,萬榮鄉,明利村,237,661,68,188,256,15,271
公投第１５案,花蓮縣,萬榮鄉,馬遠村,238,442,35,193,228,11,239
公投第１５案,花蓮縣,萬榮鄉,馬遠村,239,675,53,245,298,51,349
公投第１５案,花蓮縣,萬榮鄉,紅葉村,240,1086,166,476,642,101,743
公投第１５案,花蓮縣,瑞穗鄉,瑞穗村,241,813,112,335,447,27,474
公投第１５案,花蓮縣,瑞穗鄉,瑞穗村,242,1091,132,431,563,49,612
公投第１５案,花蓮縣,瑞穗鄉,瑞美村,243,839,113,321,434,43,477
公投第１５案,花蓮縣,瑞穗鄉,瑞美村,244,975,113,383,496,61,557
公投第１５案,花蓮縣,瑞穗鄉,瑞良村,245,546,56,180,236,24,260
公投第１５案,花蓮縣,瑞穗鄉,瑞祥村,246,1002,136,363,499,71,570
公投第１５案,花蓮縣,瑞穗鄉,瑞北村,247,593,70,187,257,23,280
公投第１５案,花蓮縣,瑞穗鄉,舞鶴村,248,965,137,336,473,83,556
公投第１５案,花蓮縣,瑞穗鄉,鶴岡村,249,863,98,316,414,63,477
公投第１５案,花蓮縣,瑞穗鄉,奇美村,250,340,15,61,76,7,83
公投第１５案,花蓮縣,瑞穗鄉,富源村,251,764,78,242,320,34,354
公投第１５案,花蓮縣,瑞穗鄉,富民村,252,868,39,151,190,10,200
公投第１５案,花蓮縣,瑞穗鄉,富興村,253,620,36,145,181,14,195
公投第１５案,花蓮縣,玉里鎮,中城里,254,1008,146,365,511,30,541
公投第１５案,花蓮縣,玉里鎮,中城里,255,939,129,392,521,37,558
公投第１５案,花蓮縣,玉里鎮,中城里,256,1256,168,429,597,61,658
公投第１５案,花蓮縣,玉里鎮,中城里,257,929,139,332,471,34,505
公投第１５案,花蓮縣,玉里鎮,中城里,258,979,140,362,502,32,534
公投第１５案,花蓮縣,玉里鎮,國武里,259,1244,98,601,699,31,730
公投第１５案,花蓮縣,玉里鎮,啟模里,260,847,97,283,380,38,418
公投第１５案,花蓮縣,玉里鎮,啟模里,261,772,100,241,341,39,380
公投第１５案,花蓮縣,玉里鎮,泰昌里,262,558,78,179,257,21,278
公投第１５案,花蓮縣,玉里鎮,泰昌里,263,800,66,172,238,22,260
公投第１５案,花蓮縣,玉里鎮,永昌里,264,1286,122,410,532,64,596
公投第１５案,花蓮縣,玉里鎮,源城里,265,1246,186,373,559,39,598
公投第１５案,花蓮縣,玉里鎮,長良里,266,647,88,203,291,59,350
公投第１５案,花蓮縣,玉里鎮,樂合里,267,990,65,163,228,14,242
公投第１５案,花蓮縣,玉里鎮,東豐里,268,530,64,141,205,57,262
公投第１５案,花蓮縣,玉里鎮,觀音里,269,979,90,244,334,36,370
公投第１５案,花蓮縣,玉里鎮,觀音里,270,557,62,183,245,75,320
公投第１５案,花蓮縣,玉里鎮,松浦里,271,434,38,119,157,20,177
公投第１５案,花蓮縣,玉里鎮,松浦里,272,1065,99,210,309,72,381
公投第１５案,花蓮縣,玉里鎮,春日里,273,866,99,281,380,90,470
公投第１５案,花蓮縣,玉里鎮,德武里,274,769,77,206,283,52,335
公投第１５案,花蓮縣,玉里鎮,三民里,275,869,123,218,341,31,372
公投第１５案,花蓮縣,玉里鎮,大禹里,276,1080,128,275,403,43,446
公投第１５案,花蓮縣,富里鄉,吳江村,277,467,40,140,180,18,198
公投第１５案,花蓮縣,富里鄉,東里村,278,1032,111,252,363,49,412
公投第１５案,花蓮縣,富里鄉,萬寧村,279,638,48,202,250,28,278
公投第１５案,花蓮縣,富里鄉,新興村,280,591,68,186,254,66,320
公投第１５案,花蓮縣,富里鄉,竹田村,281,1087,134,407,541,53,594
公投第１５案,花蓮縣,富里鄉,羅山村,282,431,69,137,206,18,224
公投第１５案,花蓮縣,富里鄉,石牌村,283,893,128,275,403,33,436
公投第１５案,花蓮縣,富里鄉,明里村,284,361,36,97,133,16,149
公投第１５案,花蓮縣,富里鄉,富里村,285,1362,150,358,508,39,547
公投第１５案,花蓮縣,富里鄉,永豐村,286,458,59,157,216,23,239
公投第１５案,花蓮縣,富里鄉,豐南村,287,621,46,132,178,29,207
公投第１５案,花蓮縣,富里鄉,富南村,288,493,68,156,224,20,244
公投第１５案,花蓮縣,富里鄉,學田村,289,631,77,194,271,32,303
公投第１５案,花蓮縣,卓溪鄉,崙山村,290,533,66,214,280,23,303
公投第１５案,花蓮縣,卓溪鄉,立山村,291,522,78,213,291,41,332
公投第１５案,花蓮縣,卓溪鄉,立山村,292,493,83,182,265,13,278
公投第１５案,花蓮縣,卓溪鄉,太平村,293,701,68,327,395,46,441
公投第１５案,花蓮縣,卓溪鄉,卓溪村,294,746,82,321,403,40,443
公投第１５案,花蓮縣,卓溪鄉,卓清村,295,616,68,273,341,49,390
公投第１５案,花蓮縣,卓溪鄉,卓清村,296,405,38,103,141,10,151
公投第１５案,花蓮縣,卓溪鄉,古風村,297,329,41,125,166,13,179
公投第１５案,花蓮縣,卓溪鄉,古風村,298,428,42,174,216,14,230
公投第１５案,花蓮縣,卓溪鄉,古風村,299,174,19,70,89,9,98
公投第１５案,澎湖縣,馬公市,復興里,1,481,68,147,215,10,225
公投第１５案,澎湖縣,馬公市,長安里,2,558,70,203,273,18,291
公投第１５案,澎湖縣,馬公市,中央里,3,533,60,165,225,38,263
公投第１５案,澎湖縣,馬公市,啟明里,4,922,137,298,435,32,467
公投第１５案,澎湖縣,馬公市,重慶里,5,1021,191,328,519,30,549
公投第１５案,澎湖縣,馬公市,中興里,6,793,131,247,378,29,407
公投第１５案,澎湖縣,馬公市,光復里,7,954,149,322,471,40,511
公投第１５案,澎湖縣,馬公市,光復里,8,1001,147,332,479,26,505
公投第１５案,澎湖縣,馬公市,光明里,9,1192,165,338,503,32,535
公投第１５案,澎湖縣,馬公市,光榮里,10,1402,163,450,613,50,663
公投第１５案,澎湖縣,馬公市,光榮里,11,1389,207,481,688,25,713
公投第１５案,澎湖縣,馬公市,光榮里,12,1339,193,465,658,37,695
公投第１５案,澎湖縣,馬公市,朝陽里,13,1254,152,409,561,37,598
公投第１５案,澎湖縣,馬公市,朝陽里,14,1194,166,392,558,43,601
公投第１５案,澎湖縣,馬公市,朝陽里,15,1393,180,452,632,40,672
公投第１５案,澎湖縣,馬公市,朝陽里,16,1440,235,494,729,25,754
公投第１５案,澎湖縣,馬公市,陽明里,17,1215,173,376,549,47,596
公投第１５案,澎湖縣,馬公市,陽明里,18,1284,161,423,584,48,632
公投第１５案,澎湖縣,馬公市,重光里,19,1512,196,492,688,58,746
公投第１５案,澎湖縣,馬公市,西衛里,20,1181,156,365,521,46,567
公投第１５案,澎湖縣,馬公市,西衛里,21,1348,191,447,638,41,679
公投第１５案,澎湖縣,馬公市,西衛里,22,1391,233,464,697,22,719
公投第１５案,澎湖縣,馬公市,西衛里,23,2124,688,246,934,15,949
公投第１５案,澎湖縣,馬公市,西文里,24,1500,202,502,704,43,747
公投第１５案,澎湖縣,馬公市,西文里,25,1582,199,544,743,36,779
公投第１５案,澎湖縣,馬公市,東文里,26,1638,211,560,771,27,798
公投第１５案,澎湖縣,馬公市,東文里,27,1554,214,553,767,43,810
公投第１５案,澎湖縣,馬公市,案山里,28,980,102,264,366,17,383
公投第１５案,澎湖縣,馬公市,案山里,29,892,131,299,430,23,453
公投第１５案,澎湖縣,馬公市,光華里,30,778,107,202,309,13,322
公投第１５案,澎湖縣,馬公市,前寮里,31,930,133,314,447,26,473
公投第１５案,澎湖縣,馬公市,石泉里,32,1481,228,599,827,32,859
公投第１５案,澎湖縣,馬公市,石泉里,33,1128,144,438,582,17,599
公投第１５案,澎湖縣,馬公市,菜園里,34,415,46,157,203,21,224
公投第１５案,澎湖縣,馬公市,東衛里,35,1120,142,375,517,41,558
公投第１５案,澎湖縣,馬公市,東衛里,36,950,126,370,496,19,515
公投第１５案,澎湖縣,馬公市,安宅里,37,627,72,189,261,21,282
公投第１５案,澎湖縣,馬公市,興仁里,38,1055,137,381,518,20,538
公投第１５案,澎湖縣,馬公市,烏崁里,39,989,118,358,476,42,518
公投第１５案,澎湖縣,馬公市,鐵線里,40,591,89,208,297,33,330
公投第１５案,澎湖縣,馬公市,鎖港里,41,1387,190,413,603,53,656
公投第１５案,澎湖縣,馬公市,鎖港里,42,1079,123,290,413,54,467
公投第１５案,澎湖縣,馬公市,山水里,43,797,86,276,362,38,400
公投第１５案,澎湖縣,馬公市,山水里,44,903,105,290,395,18,413
公投第１５案,澎湖縣,馬公市,五德里,45,376,62,100,162,15,177
公投第１５案,澎湖縣,馬公市,井垵里,46,371,50,129,179,16,195
公投第１５案,澎湖縣,馬公市,嵵裡里,47,1173,99,337,436,19,455
公投第１５案,澎湖縣,馬公市,風櫃里,48,1389,140,325,465,19,484
公投第１５案,澎湖縣,馬公市,虎井里,49,761,53,100,153,60,213
公投第１５案,澎湖縣,馬公市,桶盤里,50,288,51,109,160,16,176
公投第１５案,澎湖縣,湖西鄉,湖西村,51,1120,136,400,536,52,588
公投第１５案,澎湖縣,湖西鄉,湖東村,52,332,37,98,135,7,142
公投第１５案,澎湖縣,湖西鄉,青螺村,53,242,28,61,89,6,95
公投第１５案,澎湖縣,湖西鄉,白坑村,54,293,27,70,97,5,102
公投第１５案,澎湖縣,湖西鄉,南寮村,55,666,57,179,236,38,274
公投第１５案,澎湖縣,湖西鄉,北寮村,56,326,33,113,146,16,162
公投第１５案,澎湖縣,湖西鄉,紅羅村,57,732,83,198,281,16,297
公投第１５案,澎湖縣,湖西鄉,西溪村,58,651,73,198,271,29,300
公投第１５案,澎湖縣,湖西鄉,成功村,59,744,96,217,313,12,325
公投第１５案,澎湖縣,湖西鄉,東石村,60,134,18,52,70,3,73
公投第１５案,澎湖縣,湖西鄉,沙港村,61,794,91,160,251,24,275
公投第１５案,澎湖縣,湖西鄉,中西村,62,216,23,52,75,3,78
公投第１５案,澎湖縣,湖西鄉,鼎灣村,63,664,51,139,190,9,199
公投第１５案,澎湖縣,湖西鄉,潭邊村,64,279,39,86,125,7,132
公投第１５案,澎湖縣,湖西鄉,許家村,65,296,32,113,145,5,150
公投第１５案,澎湖縣,湖西鄉,城北村,66,257,39,79,118,4,122
公投第１５案,澎湖縣,湖西鄉,太武村,67,89,4,23,27,2,29
公投第１５案,澎湖縣,湖西鄉,隘門村,68,815,128,235,363,27,390
公投第１５案,澎湖縣,湖西鄉,林投村,69,975,100,271,371,19,390
公投第１５案,澎湖縣,湖西鄉,尖山村,70,648,84,202,286,29,315
公投第１５案,澎湖縣,湖西鄉,龍門村,71,893,104,242,346,28,374
公投第１５案,澎湖縣,湖西鄉,龍門村,72,846,113,271,384,54,438
公投第１５案,澎湖縣,湖西鄉,菓葉村,73,729,77,181,258,12,270
公投第１５案,澎湖縣,白沙鄉,中屯村,74,514,77,161,238,17,255
公投第１５案,澎湖縣,白沙鄉,講美村,75,657,86,239,325,15,340
公投第１５案,澎湖縣,白沙鄉,城前村,76,109,13,55,68,4,72
公投第１５案,澎湖縣,白沙鄉,鎮海村,77,156,16,47,63,3,66
公投第１５案,澎湖縣,白沙鄉,港子村,78,293,36,80,116,5,121
公投第１５案,澎湖縣,白沙鄉,岐頭村,79,231,22,50,72,0,72
公投第１５案,澎湖縣,白沙鄉,小赤村,80,161,29,52,81,6,87
公投第１５案,澎湖縣,白沙鄉,赤崁村,81,1705,200,537,737,48,785
公投第１５案,澎湖縣,白沙鄉,瓦硐村,82,285,30,88,118,7,125
公投第１５案,澎湖縣,白沙鄉,後寮村,83,723,67,140,207,16,223
公投第１５案,澎湖縣,白沙鄉,通梁村,84,774,86,170,256,30,286
公投第１５案,澎湖縣,白沙鄉,吉貝村,85,1429,138,276,414,87,501
公投第１５案,澎湖縣,白沙鄉,鳥嶼村,86,1084,71,380,451,49,500
公投第１５案,澎湖縣,白沙鄉,員貝村,87,251,41,77,118,8,126
公投第１５案,澎湖縣,白沙鄉,大倉村,88,253,35,43,78,14,92
公投第１５案,澎湖縣,西嶼鄉,橫礁村,89,283,11,34,45,1,46
公投第１５案,澎湖縣,西嶼鄉,合界村,90,424,48,62,110,14,124
公投第１５案,澎湖縣,西嶼鄉,竹灣村,91,826,88,148,236,49,285
公投第１５案,澎湖縣,西嶼鄉,小門村,92,282,22,77,99,10,109
公投第１５案,澎湖縣,西嶼鄉,大池村,93,661,73,145,218,43,261
公投第１５案,澎湖縣,西嶼鄉,二崁村,94,141,9,17,26,3,29
公投第１５案,澎湖縣,西嶼鄉,池東村,95,635,45,142,187,10,197
公投第１５案,澎湖縣,西嶼鄉,池西村,96,216,15,55,70,3,73
公投第１５案,澎湖縣,西嶼鄉,赤馬村,97,572,39,81,120,20,140
公投第１５案,澎湖縣,西嶼鄉,內垵村,98,1267,115,354,469,49,518
公投第１５案,澎湖縣,西嶼鄉,外垵村,99,942,84,214,298,28,326
公投第１５案,澎湖縣,西嶼鄉,外垵村,100,1133,135,269,404,46,450
公投第１５案,澎湖縣,望安鄉,東安村,101,734,99,203,302,30,332
公投第１５案,澎湖縣,望安鄉,西安村,102,454,35,141,176,14,190
公投第１５案,澎湖縣,望安鄉,中社村,103,300,27,71,98,7,105
公投第１５案,澎湖縣,望安鄉,水垵村,104,471,60,145,205,34,239
公投第１５案,澎湖縣,望安鄉,將軍村,105,672,64,138,202,18,220
公投第１５案,澎湖縣,望安鄉,將軍村,106,742,69,195,264,38,302
公投第１５案,澎湖縣,望安鄉,東吉村,107,264,26,68,94,15,109
公投第１５案,澎湖縣,望安鄉,東坪村,108,476,58,137,195,1,196
公投第１５案,澎湖縣,望安鄉,西坪村,109,208,24,29,53,3,56
公投第１５案,澎湖縣,望安鄉,花嶼村,110,307,25,59,84,7,91
公投第１５案,澎湖縣,七美鄉,東湖村,111,248,29,33,62,4,66
公投第１５案,澎湖縣,七美鄉,西湖村,112,581,61,122,183,21,204
公投第１５案,澎湖縣,七美鄉,中和村,113,641,78,119,197,29,226
公投第１５案,澎湖縣,七美鄉,平和村,114,382,31,85,116,2,118
公投第１５案,澎湖縣,七美鄉,海豐村,115,351,24,55,79,6,85
公投第１５案,澎湖縣,七美鄉,南港村,116,1171,103,200,303,16,319
公投第１５案,基隆市,中正區,長潭里,1,466,85,159,244,14,258
公投第１５案,基隆市,中正區,砂子里,2,1262,175,341,516,24,540
公投第１５案,基隆市,中正區,砂子里,3,1171,160,355,515,41,556
公投第１５案,基隆市,中正區,砂子里,4,2823,332,711,1043,18,1061
公投第１５案,基隆市,中正區,八斗里,5,1474,195,388,583,49,632
公投第１５案,基隆市,中正區,碧砂里,6,1271,192,312,504,50,554
公投第１５案,基隆市,中正區,新富里,7,2707,364,742,1106,61,1167
公投第１５案,基隆市,中正區,新富里,8,1545,202,472,674,76,750
公投第１５案,基隆市,中正區,新富里,9,761,85,204,289,16,305
公投第１５案,基隆市,中正區,新豐里,10,1352,228,405,633,22,655
公投第１５案,基隆市,中正區,新豐里,11,1413,184,458,642,15,657
公投第１５案,基隆市,中正區,新豐里,12,2665,360,756,1116,36,1152
公投第１５案,基隆市,中正區,平寮里,13,1261,168,351,519,59,578
公投第１５案,基隆市,中正區,社寮里,14,1753,466,331,797,82,879
公投第１５案,基隆市,中正區,和憲里,15,984,116,275,391,53,444
公投第１５案,基隆市,中正區,海濱里,16,1166,137,388,525,29,554
公投第１５案,基隆市,中正區,正濱里,17,973,157,288,445,25,470
公投第１５案,基隆市,中正區,中正里,18,1694,262,354,616,23,639
公投第１５案,基隆市,中正區,中濱里,19,1270,217,391,608,30,638
公投第１５案,基隆市,中正區,建國里,20,1090,164,372,536,42,578
公投第１５案,基隆市,中正區,建國里,21,870,140,303,443,16,459
公投第１５案,基隆市,中正區,砂灣里,22,1138,191,344,535,38,573
公投第１５案,基隆市,中正區,砂灣里,23,862,129,249,378,44,422
公投第１５案,基隆市,中正區,真砂里,24,1341,245,439,684,54,738
公投第１５案,基隆市,中正區,正砂里,25,859,135,295,430,35,465
公投第１５案,基隆市,中正區,正砂里,26,1457,214,436,650,23,673
公投第１５案,基隆市,中正區,中砂里,27,1594,222,392,614,37,651
公投第１５案,基隆市,中正區,入船里,28,802,147,247,394,35,429
公投第１５案,基隆市,中正區,正船里,29,1267,182,407,589,34,623
公投第１５案,基隆市,中正區,中船里,30,1175,213,362,575,49,624
公投第１５案,基隆市,中正區,港通里,31,1210,217,422,639,45,684
公投第１５案,基隆市,中正區,義重里,32,1037,181,321,502,45,547
公投第１５案,基隆市,中正區,正義里,33,1219,211,385,596,43,639
公投第１５案,基隆市,中正區,信義里,34,904,160,266,426,26,452
公投第１５案,基隆市,中正區,德義里,35,709,147,260,407,35,442
公投第１５案,基隆市,信義區,仁壽里,36,1096,217,366,583,33,616
公投第１５案,基隆市,信義區,仁義里,37,1232,258,435,693,37,730
公投第１５案,基隆市,信義區,義昭里,38,1184,244,394,638,20,658
公投第１５案,基隆市,信義區,義幸里,39,1133,189,424,613,52,665
公投第１５案,基隆市,信義區,義幸里,40,1188,215,426,641,25,666
公投第１５案,基隆市,信義區,義民里,41,725,138,259,397,28,425
公投第１５案,基隆市,信義區,義和里,42,1524,211,475,686,38,724
公投第１５案,基隆市,信義區,智慧里,43,736,142,248,390,26,416
公投第１５案,基隆市,信義區,智誠里,44,611,103,199,302,21,323
公投第１５案,基隆市,信義區,智誠里,45,951,129,304,433,16,449
公投第１５案,基隆市,信義區,禮儀里,46,1616,264,552,816,34,850
公投第１５案,基隆市,信義區,禮東里,47,1516,276,511,787,35,822
公投第１５案,基隆市,信義區,信綠里,48,1049,184,330,514,27,541
公投第１５案,基隆市,信義區,信綠里,49,1069,195,337,532,25,557
公投第１５案,基隆市,信義區,東信里,50,727,141,262,403,19,422
公投第１５案,基隆市,信義區,東信里,51,929,194,333,527,23,550
公投第１５案,基隆市,信義區,東信里,52,1118,246,417,663,26,689
公投第１５案,基隆市,信義區,東信里,53,1339,281,438,719,32,751
公投第１５案,基隆市,信義區,東光里,54,999,169,332,501,22,523
公投第１５案,基隆市,信義區,東光里,55,764,135,248,383,10,393
公投第１５案,基隆市,信義區,東明里,56,1555,240,466,706,44,750
公投第１５案,基隆市,信義區,東明里,57,2015,336,625,961,24,985
公投第１５案,基隆市,信義區,東安里,58,1268,244,435,679,42,721
公投第１５案,基隆市,信義區,東安里,59,1569,262,532,794,40,834
公投第１５案,基隆市,信義區,孝賢里,60,1985,321,596,917,37,954
公投第１５案,基隆市,信義區,孝賢里,61,1476,213,579,792,21,813
公投第１５案,基隆市,信義區,孝忠里,62,1493,305,509,814,26,840
公投第１５案,基隆市,信義區,孝忠里,63,1249,271,473,744,14,758
公投第１５案,基隆市,信義區,孝忠里,64,1559,260,498,758,21,779
公投第１５案,基隆市,信義區,孝忠里,65,1168,201,355,556,13,569
公投第１５案,基隆市,信義區,孝忠里,66,1602,234,570,804,24,828
公投第１５案,基隆市,信義區,孝德里,67,1485,193,457,650,35,685
公投第１５案,基隆市,信義區,孝德里,68,1009,153,343,496,26,522
公投第１５案,基隆市,信義區,孝深里,69,2016,262,567,829,43,872
公投第１５案,基隆市,信義區,孝深里,70,1764,227,500,727,23,750
公投第１５案,基隆市,信義區,孝岡里,71,1295,216,456,672,30,702
公投第１５案,基隆市,仁愛區,林泉里,72,1782,246,489,735,88,823
公投第１５案,基隆市,仁愛區,花崗里,73,1055,186,369,555,43,598
公投第１５案,基隆市,仁愛區,虹橋里,74,1558,230,474,704,29,733
公投第１５案,基隆市,仁愛區,水錦里,75,1736,273,571,844,50,894
公投第１５案,基隆市,仁愛區,智仁里,76,1243,208,488,696,37,733
公投第１５案,基隆市,仁愛區,智仁里,77,1109,175,415,590,32,622
公投第１５案,基隆市,仁愛區,和明里,78,1684,288,638,926,36,962
公投第１５案,基隆市,仁愛區,忠勇里,79,919,185,287,472,36,508
公投第１５案,基隆市,仁愛區,玉田里,80,991,198,289,487,17,504
公投第１５案,基隆市,仁愛區,仁德里,81,876,153,294,447,25,472
公投第１５案,基隆市,仁愛區,博愛里,82,1046,188,394,582,29,611
公投第１５案,基隆市,仁愛區,博愛里,83,434,79,162,241,22,263
公投第１５案,基隆市,仁愛區,福仁里,84,764,141,258,399,47,446
公投第１５案,基隆市,仁愛區,誠仁里,85,968,181,300,481,20,501
公投第１５案,基隆市,仁愛區,吉仁里,86,1326,217,425,642,44,686
公投第１５案,基隆市,仁愛區,吉仁里,87,1315,189,346,535,38,573
公投第１５案,基隆市,仁愛區,育仁里,88,775,134,280,414,35,449
公投第１５案,基隆市,仁愛區,英仁里,89,652,120,206,326,48,374
公投第１５案,基隆市,仁愛區,英仁里,90,674,139,210,349,28,377
公投第１５案,基隆市,仁愛區,龍門里,91,789,144,239,383,27,410
公投第１５案,基隆市,仁愛區,德厚里,92,1715,280,555,835,68,903
公投第１５案,基隆市,仁愛區,曲水里,93,849,176,242,418,41,459
公投第１５案,基隆市,仁愛區,崇文里,94,875,146,207,353,18,371
公投第１５案,基隆市,仁愛區,文安里,95,851,159,243,402,34,436
公投第１５案,基隆市,仁愛區,兆連里,96,735,150,245,395,32,427
公投第１５案,基隆市,仁愛區,獅球里,97,1009,163,316,479,58,537
公投第１５案,基隆市,仁愛區,書院里,98,1082,163,316,479,53,532
公投第１５案,基隆市,仁愛區,朝棟里,99,1278,213,384,597,64,661
公投第１５案,基隆市,仁愛區,朝棟里,100,1519,293,543,836,31,867
公投第１５案,基隆市,仁愛區,光華里,101,1336,225,342,567,34,601
公投第１５案,基隆市,仁愛區,光華里,102,1178,216,415,631,41,672
公投第１５案,基隆市,仁愛區,明德里,103,708,129,218,347,35,382
公投第１５案,基隆市,仁愛區,同風里,104,567,122,203,325,30,355
公投第１５案,基隆市,仁愛區,文昌里,105,751,154,222,376,38,414
公投第１５案,基隆市,仁愛區,新店里,106,589,127,208,335,18,353
公投第１５案,基隆市,中山區,新建里,107,796,137,248,385,25,410
公投第１５案,基隆市,中山區,安民里,108,1036,193,405,598,42,640
公投第１５案,基隆市,中山區,安平里,109,756,133,259,392,44,436
公投第１５案,基隆市,中山區,中山里,110,957,174,241,415,18,433
公投第１５案,基隆市,中山區,民治里,111,802,149,276,425,8,433
公投第１５案,基隆市,中山區,中興里,112,1263,222,416,638,37,675
公投第１５案,基隆市,中山區,仁正里,113,778,124,305,429,20,449
公投第１５案,基隆市,中山區,健民里,114,1180,212,371,583,72,655
公投第１５案,基隆市,中山區,通化里,115,990,150,299,449,27,476
公投第１５案,基隆市,中山區,居仁里,116,1332,185,346,531,17,548
公投第１５案,基隆市,中山區,通明里,117,848,146,240,386,23,409
公投第１５案,基隆市,中山區,通明里,118,922,139,300,439,20,459
公投第１５案,基隆市,中山區,和平里,119,459,77,182,259,13,272
公投第１５案,基隆市,中山區,仙洞里,120,574,81,180,261,23,284
公投第１５案,基隆市,中山區,太白里,121,877,148,273,421,34,455
公投第１５案,基隆市,中山區,協和里,122,1584,238,446,684,33,717
公投第１５案,基隆市,中山區,文化里,123,1319,130,323,453,29,482
公投第１５案,基隆市,中山區,德安里,124,1938,321,599,920,65,985
公投第１５案,基隆市,中山區,德安里,125,1877,344,531,875,29,904
公投第１５案,基隆市,中山區,德和里,126,2088,357,734,1091,28,1119
公投第１５案,基隆市,中山區,德和里,127,1946,354,676,1030,16,1046
公投第１５案,基隆市,中山區,德和里,128,1353,236,486,722,47,769
公投第１５案,基隆市,中山區,中和里,129,1317,206,429,635,48,683
公投第１５案,基隆市,中山區,中和里,130,870,162,312,474,22,496
公投第１５案,基隆市,中山區,中和里,131,1322,221,481,702,21,723
公投第１５案,基隆市,中山區,中和里,132,1295,198,384,582,22,604
公投第１５案,基隆市,中山區,中和里,133,756,137,299,436,24,460
公投第１５案,基隆市,中山區,和慶里,134,1602,240,458,698,29,727
公投第１５案,基隆市,中山區,和慶里,135,1568,231,480,711,38,749
公投第１５案,基隆市,中山區,和慶里,136,1404,244,457,701,37,738
公投第１５案,基隆市,中山區,和慶里,137,1909,292,587,879,24,903
公投第１５案,基隆市,中山區,西康里,138,1642,249,548,797,63,860
公投第１５案,基隆市,中山區,西定里,139,932,152,275,427,21,448
公投第１５案,基隆市,中山區,西華里,140,849,173,299,472,43,515
公投第１５案,基隆市,中山區,西榮里,141,715,174,217,391,35,426
公投第１５案,基隆市,安樂區,新西里,142,1361,194,421,615,50,665
公投第１５案,基隆市,安樂區,西川里,143,1213,177,383,560,30,590
公投第１５案,基隆市,安樂區,定國里,144,1026,135,315,450,17,467
公投第１５案,基隆市,安樂區,定邦里,145,1038,169,385,554,73,627
公投第１５案,基隆市,安樂區,慈仁里,146,897,187,277,464,51,515
公投第１５案,基隆市,安樂區,干城里,147,1401,227,453,680,65,745
公投第１５案,基隆市,安樂區,干城里,148,641,76,150,226,11,237
公投第１５案,基隆市,安樂區,永康里,149,1472,234,463,697,45,742
公投第１５案,基隆市,安樂區,永康里,150,472,84,163,247,16,263
公投第１５案,基隆市,安樂區,安和里,151,841,161,315,476,25,501
公投第１５案,基隆市,安樂區,樂一里,152,571,108,169,277,26,303
公投第１５案,基隆市,安樂區,嘉仁里,153,1901,312,568,880,46,926
公投第１５案,基隆市,安樂區,嘉仁里,154,1349,236,419,655,44,699
公投第１５案,基隆市,安樂區,三民里,155,1225,178,413,591,37,628
公投第１５案,基隆市,安樂區,三民里,156,1351,253,444,697,51,748
公投第１５案,基隆市,安樂區,壯觀里,157,1601,318,564,882,25,907
公投第１５案,基隆市,安樂區,壯觀里,158,2513,676,584,1260,29,1289
公投第１５案,基隆市,安樂區,四維里,159,1613,287,547,834,38,872
公投第１５案,基隆市,安樂區,四維里,160,1731,302,606,908,36,944
公投第１５案,基隆市,安樂區,四維里,161,1424,306,515,821,27,848
公投第１５案,基隆市,安樂區,五福里,162,1806,279,601,880,49,929
公投第１５案,基隆市,安樂區,五福里,163,1679,296,588,884,51,935
公投第１５案,基隆市,安樂區,六合里,164,1902,360,621,981,42,1023
公投第１５案,基隆市,安樂區,六合里,165,2040,361,641,1002,36,1038
公投第１５案,基隆市,安樂區,七賢里,166,1313,240,432,672,38,710
公投第１５案,基隆市,安樂區,七賢里,167,1243,197,392,589,34,623
公投第１５案,基隆市,安樂區,長樂里,168,1759,327,545,872,31,903
公投第１５案,基隆市,安樂區,長樂里,169,694,154,266,420,18,438
公投第１５案,基隆市,安樂區,長樂里,170,866,214,317,531,20,551
公投第１５案,基隆市,安樂區,鶯歌里,171,1557,221,430,651,25,676
公投第１５案,基隆市,安樂區,鶯歌里,172,1411,240,461,701,18,719
公投第１５案,基隆市,安樂區,鶯安里,173,1568,302,565,867,23,890
公投第１５案,基隆市,安樂區,鶯安里,174,1400,243,449,692,31,723
公投第１５案,基隆市,安樂區,鶯安里,175,1531,257,519,776,12,788
公投第１５案,基隆市,安樂區,興寮里,176,1673,257,542,799,23,822
公投第１５案,基隆市,安樂區,興寮里,177,1054,167,363,530,30,560
公投第１５案,基隆市,安樂區,興寮里,178,1923,282,508,790,29,819
公投第１５案,基隆市,安樂區,外寮里,179,1960,333,669,1002,49,1051
公投第１５案,基隆市,安樂區,外寮里,180,1962,298,607,905,43,948
公投第１５案,基隆市,安樂區,新崙里,181,2117,349,688,1037,62,1099
公投第１５案,基隆市,安樂區,新崙里,182,1829,306,546,852,38,890
公投第１５案,基隆市,安樂區,武崙里,183,1529,250,467,717,21,738
公投第１５案,基隆市,安樂區,武崙里,184,1869,304,629,933,20,953
公投第１５案,基隆市,安樂區,武崙里,185,1140,205,424,629,9,638
公投第１５案,基隆市,安樂區,中崙里,186,1641,304,508,812,32,844
公投第１５案,基隆市,安樂區,內寮里,187,1279,203,423,626,35,661
公投第１５案,基隆市,安樂區,內寮里,188,1360,243,432,675,23,698
公投第１５案,基隆市,安樂區,內寮里,189,1399,277,461,738,26,764
公投第１５案,基隆市,安樂區,內寮里,190,1251,223,378,601,23,624
公投第１５案,基隆市,暖暖區,八西里,191,1431,222,449,671,34,705
公投第１５案,基隆市,暖暖區,八中里,192,456,68,146,214,6,220
公投第１５案,基隆市,暖暖區,八堵里,193,637,122,216,338,20,358
公投第１５案,基隆市,暖暖區,八南里,194,735,136,271,407,24,431
公投第１５案,基隆市,暖暖區,過港里,195,1078,163,325,488,28,516
公投第１５案,基隆市,暖暖區,過港里,196,1238,216,400,616,35,651
公投第１５案,基隆市,暖暖區,過港里,197,1325,228,426,654,25,679
公投第１５案,基隆市,暖暖區,暖暖里,198,1475,291,461,752,25,777
公投第１５案,基隆市,暖暖區,暖暖里,199,1179,110,421,531,28,559
公投第１５案,基隆市,暖暖區,暖同里,200,1110,223,404,627,29,656
公投第１５案,基隆市,暖暖區,暖同里,201,1443,223,429,652,17,669
公投第１５案,基隆市,暖暖區,暖東里,202,415,64,144,208,16,224
公投第１５案,基隆市,暖暖區,暖西里,203,1378,255,407,662,20,682
公投第１５案,基隆市,暖暖區,暖西里,204,1570,293,511,804,26,830
公投第１５案,基隆市,暖暖區,暖西里,205,1603,306,574,880,55,935
公投第１５案,基隆市,暖暖區,碇內里,206,1267,227,472,699,30,729
公投第１５案,基隆市,暖暖區,碇內里,207,1359,225,458,683,31,714
公投第１５案,基隆市,暖暖區,碇和里,208,970,155,394,549,20,569
公投第１５案,基隆市,暖暖區,碇和里,209,1002,176,340,516,17,533
公投第１５案,基隆市,暖暖區,碇和里,210,944,170,288,458,23,481
公投第１５案,基隆市,暖暖區,碇祥里,211,1500,373,447,820,23,843
公投第１５案,基隆市,暖暖區,碇祥里,212,1442,188,385,573,20,593
公投第１５案,基隆市,暖暖區,碇祥里,213,1165,216,400,616,15,631
公投第１５案,基隆市,暖暖區,碇祥里,214,1610,266,531,797,22,819
公投第１５案,基隆市,暖暖區,碇安里,215,1328,254,448,702,27,729
公投第１５案,基隆市,暖暖區,碇安里,216,1173,216,384,600,16,616
公投第１５案,基隆市,暖暖區,碇安里,217,1019,221,354,575,27,602
公投第１５案,基隆市,暖暖區,碇安里,218,1373,262,463,725,20,745
公投第１５案,基隆市,七堵區,長興里,219,1258,209,436,645,63,708
公投第１５案,基隆市,七堵區,長興里,220,1237,214,433,647,42,689
公投第１５案,基隆市,七堵區,長興里,221,1259,239,384,623,26,649
公投第１５案,基隆市,七堵區,正光里,222,1120,178,337,515,52,567
公投第１５案,基隆市,七堵區,正光里,223,1344,202,398,600,43,643
公投第１５案,基隆市,七堵區,正明里,224,1011,203,378,581,38,619
公投第１５案,基隆市,七堵區,正明里,225,925,172,295,467,13,480
公投第１５案,基隆市,七堵區,富民里,226,1735,270,649,919,53,972
公投第１５案,基隆市,七堵區,富民里,227,1833,343,656,999,37,1036
公投第１５案,基隆市,七堵區,永平里,228,938,172,325,497,18,515
公投第１５案,基隆市,七堵區,永平里,229,962,173,351,524,48,572
公投第１５案,基隆市,七堵區,永安里,230,1191,209,439,648,27,675
公投第１５案,基隆市,七堵區,永安里,231,999,143,381,524,44,568
公投第１５案,基隆市,七堵區,八德里,232,282,45,81,126,12,138
公投第１５案,基隆市,七堵區,八德里,233,1243,223,376,599,41,640
公投第１５案,基隆市,七堵區,自強里,234,1092,176,352,528,43,571
公投第１５案,基隆市,七堵區,泰安里,235,1246,212,423,635,38,673
公投第１５案,基隆市,七堵區,泰安里,236,1722,326,512,838,29,867
公投第１５案,基隆市,七堵區,泰安里,237,1318,212,467,679,32,711
公投第１５案,基隆市,七堵區,六堵里,238,975,146,298,444,19,463
公投第１５案,基隆市,七堵區,六堵里,239,1285,225,421,646,29,675
公投第１５案,基隆市,七堵區,堵南里,240,1077,165,321,486,37,523
公投第１５案,基隆市,七堵區,堵南里,241,989,179,266,445,25,470
公投第１５案,基隆市,七堵區,長安里,242,1193,197,371,568,30,598
公投第１５案,基隆市,七堵區,長安里,243,1273,213,424,637,32,669
公投第１５案,基隆市,七堵區,堵北里,244,1774,307,575,882,68,950
公投第１５案,基隆市,七堵區,堵北里,245,1689,314,526,840,64,904
公投第１５案,基隆市,七堵區,百福里,246,1355,234,406,640,49,689
公投第１５案,基隆市,七堵區,百福里,247,1512,288,439,727,40,767
公投第１５案,基隆市,七堵區,百福里,248,1486,246,461,707,18,725
公投第１５案,基隆市,七堵區,百福里,249,1706,314,512,826,33,859
公投第１５案,基隆市,七堵區,實踐里,250,1384,230,480,710,48,758
公投第１５案,基隆市,七堵區,實踐里,251,1045,219,369,588,39,627
公投第１５案,基隆市,七堵區,實踐里,252,1374,255,448,703,30,733
公投第１５案,基隆市,七堵區,瑪南里,253,428,83,133,216,12,228
公投第１５案,基隆市,七堵區,瑪東里,254,326,50,118,168,29,197
公投第１５案,基隆市,七堵區,瑪西里,255,351,77,157,234,16,250
公投第１５案,基隆市,七堵區,友一里,256,1871,298,566,864,30,894
公投第１５案,基隆市,七堵區,友二里,257,448,56,143,199,9,208
公投第１５案,新竹市,東區,育賢里,1,1512,191,310,501,10,511
公投第１５案,新竹市,東區,親仁里,2,953,222,352,574,12,586
公投第１５案,新竹市,東區,親仁里,3,729,143,262,405,18,423
公投第１５案,新竹市,東區,東門里,4,566,118,210,328,25,353
公投第１５案,新竹市,東區,成功里,5,640,128,233,361,14,375
公投第１５案,新竹市,東區,榮光里,6,305,60,98,158,15,173
公投第１５案,新竹市,東區,中正里,7,563,108,218,326,20,346
公投第１５案,新竹市,東區,錦華里,8,741,151,262,413,8,421
公投第１５案,新竹市,東區,錦華里,9,1041,234,348,582,17,599
公投第１５案,新竹市,東區,文華里,10,1615,291,553,844,30,874
公投第１５案,新竹市,東區,文華里,11,1287,259,449,708,39,747
公投第１５案,新竹市,東區,文華里,12,1554,190,677,867,26,893
公投第１５案,新竹市,東區,復中里,13,1388,293,514,807,13,820
公投第１５案,新竹市,東區,復中里,14,1419,290,526,816,24,840
公投第１５案,新竹市,東區,復中里,15,1355,277,439,716,39,755
公投第１５案,新竹市,東區,復興里,16,1490,279,526,805,38,843
公投第１５案,新竹市,東區,復興里,17,1615,310,577,887,31,918
公投第１５案,新竹市,東區,復興里,18,1672,329,605,934,33,967
公投第１５案,新竹市,東區,三民里,19,1062,234,360,594,26,620
公投第１５案,新竹市,東區,三民里,20,1315,277,447,724,29,753
公投第１５案,新竹市,東區,三民里,21,1000,175,361,536,59,595
公投第１５案,新竹市,東區,三民里,22,1337,266,493,759,37,796
公投第１５案,新竹市,東區,東園里,23,1747,380,546,926,26,952
公投第１５案,新竹市,東區,東園里,24,1600,392,548,940,20,960
公投第１５案,新竹市,東區,東園里,25,1158,223,395,618,38,656
公投第１５案,新竹市,東區,東園里,26,828,192,326,518,23,541
公投第１５案,新竹市,東區,公園里,27,1573,330,508,838,35,873
公投第１５案,新竹市,東區,公園里,28,1550,283,570,853,36,889
公投第１５案,新竹市,東區,建華里,29,1317,258,465,723,28,751
公投第１５案,新竹市,東區,建華里,30,1040,253,358,611,36,647
公投第１５案,新竹市,東區,東山里,31,935,174,371,545,18,563
公投第１５案,新竹市,東區,東山里,32,1074,218,372,590,23,613
公投第１５案,新竹市,東區,東山里,33,1133,231,422,653,41,694
公投第１５案,新竹市,東區,綠水里,34,1262,261,459,720,36,756
公投第１５案,新竹市,東區,綠水里,35,1199,226,450,676,15,691
公投第１５案,新竹市,東區,綠水里,36,1226,267,473,740,22,762
公投第１５案,新竹市,東區,綠水里,37,1377,321,538,859,28,887
公投第１５案,新竹市,東區,綠水里,38,991,234,384,618,17,635
公投第１５案,新竹市,東區,東勢里,39,1271,262,445,707,57,764
公投第１５案,新竹市,東區,東勢里,40,1012,231,400,631,20,651
公投第１５案,新竹市,東區,光復里,41,1001,188,352,540,48,588
公投第１５案,新竹市,東區,光復里,42,1603,316,490,806,51,857
公投第１５案,新竹市,東區,前溪里,43,1236,218,446,664,32,696
公投第１５案,新竹市,東區,前溪里,44,1532,201,500,701,39,740
公投第１５案,新竹市,東區,水源里,45,1306,216,492,708,27,735
公投第１５案,新竹市,東區,水源里,46,1073,203,381,584,45,629
公投第１５案,新竹市,東區,水源里,47,952,202,318,520,16,536
公投第１５案,新竹市,東區,千甲里,48,1298,192,407,599,46,645
公投第１５案,新竹市,東區,千甲里,49,778,125,293,418,18,436
公投第１５案,新竹市,東區,豐功里,50,1195,278,394,672,34,706
公投第１５案,新竹市,東區,豐功里,51,1569,280,537,817,51,868
公投第１５案,新竹市,東區,豐功里,52,1533,384,557,941,23,964
公投第１５案,新竹市,東區,武功里,53,1336,187,589,776,38,814
公投第１５案,新竹市,東區,武功里,54,1367,243,535,778,27,805
公投第１５案,新竹市,東區,武功里,55,1289,296,475,771,17,788
公投第１５案,新竹市,東區,軍功里,56,960,173,345,518,22,540
公投第１５案,新竹市,東區,軍功里,57,843,195,335,530,9,539
公投第１５案,新竹市,東區,軍功里,58,948,175,350,525,43,568
公投第１５案,新竹市,東區,立功里,59,915,139,354,493,27,520
公投第１５案,新竹市,東區,建功里,60,1801,294,723,1017,30,1047
公投第１５案,新竹市,東區,建功里,61,1079,189,406,595,29,624
公投第１５案,新竹市,東區,建功里,62,676,136,279,415,10,425
公投第１５案,新竹市,東區,光明里,63,1132,236,404,640,37,677
公投第１５案,新竹市,東區,光明里,64,251,68,75,143,9,152
公投第１５案,新竹市,東區,光明里,65,1620,342,560,902,33,935
公投第１５案,新竹市,東區,龍山里,66,1479,338,436,774,27,801
公投第１５案,新竹市,東區,龍山里,67,1402,316,417,733,23,756
公投第１５案,新竹市,東區,龍山里,68,1280,273,419,692,32,724
公投第１５案,新竹市,東區,龍山里,69,1228,338,381,719,13,732
公投第１５案,新竹市,東區,龍山里,70,1157,331,302,633,2,635
公投第１５案,新竹市,東區,龍山里,71,1354,264,479,743,26,769
公投第１５案,新竹市,東區,科園里,72,1334,352,504,856,26,882
公投第１５案,新竹市,東區,科園里,73,1234,248,479,727,20,747
公投第１５案,新竹市,東區,科園里,74,1398,309,558,867,25,892
公投第１５案,新竹市,東區,科園里,75,928,232,323,555,17,572
公投第１５案,新竹市,東區,科園里,76,1368,302,535,837,27,864
公投第１５案,新竹市,東區,埔頂里,77,1215,228,429,657,18,675
公投第１５案,新竹市,東區,埔頂里,78,1067,165,357,522,31,553
公投第１５案,新竹市,東區,埔頂里,79,1194,330,315,645,15,660
公投第１５案,新竹市,東區,埔頂里,80,1193,311,314,625,19,644
公投第１５案,新竹市,東區,新莊里,81,1388,291,461,752,53,805
公投第１５案,新竹市,東區,新莊里,82,1267,258,467,725,26,751
公投第１５案,新竹市,東區,新莊里,83,1299,259,462,721,22,743
公投第１５案,新竹市,東區,新莊里,84,1288,300,419,719,21,740
公投第１５案,新竹市,東區,關新里,85,1228,349,385,734,17,751
公投第１５案,新竹市,東區,關新里,86,1135,311,369,680,11,691
公投第１５案,新竹市,東區,關新里,87,1237,358,411,769,19,788
公投第１５案,新竹市,東區,關東里,88,1135,209,367,576,32,608
公投第１５案,新竹市,東區,關東里,89,1165,187,397,584,25,609
公投第１５案,新竹市,東區,關東里,90,1124,207,402,609,21,630
公投第１５案,新竹市,東區,關東里,91,1210,240,446,686,27,713
公投第１５案,新竹市,東區,金山里,92,1323,233,454,687,28,715
公投第１５案,新竹市,東區,金山里,93,1207,181,449,630,20,650
公投第１５案,新竹市,東區,金山里,94,1264,223,384,607,25,632
公投第１５案,新竹市,東區,金山里,95,1248,277,394,671,14,685
公投第１５案,新竹市,東區,仙水里,96,1400,308,526,834,33,867
公投第１５案,新竹市,東區,仙水里,97,1473,346,519,865,18,883
公投第１５案,新竹市,東區,仙水里,98,1367,294,439,733,35,768
公投第１５案,新竹市,東區,仙宮里,99,1233,265,444,709,15,724
公投第１５案,新竹市,東區,關帝里,100,507,91,173,264,9,273
公投第１５案,新竹市,東區,南門里,101,714,147,250,397,24,421
公投第１５案,新竹市,東區,南市里,102,875,162,320,482,37,519
公投第１５案,新竹市,東區,福德里,103,1396,248,511,759,40,799
公投第１５案,新竹市,東區,振興里,104,1232,239,396,635,29,664
公投第１５案,新竹市,東區,振興里,105,1323,284,399,683,38,721
公投第１５案,新竹市,東區,振興里,106,1516,271,434,705,18,723
公投第１５案,新竹市,東區,振興里,107,1453,300,416,716,29,745
公投第１５案,新竹市,東區,新興里,108,880,61,421,482,35,517
公投第１５案,新竹市,東區,新興里,109,1058,171,381,552,26,578
公投第１５案,新竹市,東區,新興里,110,1061,193,380,573,26,599
公投第１５案,新竹市,東區,寺前里,111,710,117,259,376,32,408
公投第１５案,新竹市,東區,竹蓮里,112,752,141,275,416,39,455
公投第１５案,新竹市,東區,下竹里,113,475,85,202,287,15,302
公投第１５案,新竹市,東區,頂竹里,114,880,178,274,452,29,481
公投第１５案,新竹市,東區,頂竹里,115,989,217,337,554,26,580
公投第１５案,新竹市,東區,頂竹里,116,1059,208,369,577,35,612
公投第１５案,新竹市,東區,南大里,117,607,135,207,342,30,372
公投第１５案,新竹市,東區,南大里,118,815,177,264,441,35,476
公投第１５案,新竹市,東區,新光里,119,777,141,304,445,37,482
公投第１５案,新竹市,東區,新光里,120,1399,225,448,673,27,700
公投第１５案,新竹市,東區,新光里,121,1216,242,407,649,27,676
公投第１５案,新竹市,東區,光鎮里,122,1062,175,341,516,38,554
公投第１５案,新竹市,東區,光鎮里,123,1046,208,381,589,21,610
公投第１５案,新竹市,東區,光鎮里,124,1332,226,448,674,17,691
公投第１５案,新竹市,東區,高峰里,125,1350,253,489,742,40,782
公投第１５案,新竹市,東區,高峰里,126,1438,244,489,733,23,756
公投第１５案,新竹市,東區,高峰里,127,1414,216,495,711,31,742
公投第１５案,新竹市,東區,高峰里,128,1476,315,520,835,24,859
公投第１５案,新竹市,東區,湖濱里,129,1326,259,520,779,40,819
公投第１５案,新竹市,東區,湖濱里,130,927,238,342,580,16,596
公投第１５案,新竹市,東區,湖濱里,131,1273,258,456,714,16,730
公投第１５案,新竹市,東區,柴橋里,132,1315,238,432,670,29,699
公投第１５案,新竹市,東區,柴橋里,133,1413,301,487,788,27,815
公投第１５案,新竹市,東區,柴橋里,134,1064,216,368,584,26,610
公投第１５案,新竹市,東區,柴橋里,135,1244,297,473,770,16,786
公投第１５案,新竹市,東區,明湖里,136,1160,192,407,599,8,607
公投第１５案,新竹市,東區,明湖里,137,1398,236,434,670,12,682
公投第１５案,新竹市,東區,明湖里,138,1384,208,345,553,18,571
公投第１５案,新竹市,東區,明湖里,139,874,170,346,516,25,541
公投第１５案,新竹市,北區,中央里,140,477,107,142,249,10,259
公投第１５案,新竹市,北區,西門里,141,535,111,196,307,15,322
公投第１５案,新竹市,北區,潛園里,142,746,149,261,410,34,444
公投第１５案,新竹市,北區,石坊里,143,546,104,178,282,16,298
公投第１５案,新竹市,北區,仁德里,144,711,144,273,417,26,443
公投第１５案,新竹市,北區,崇禮里,145,1143,192,369,561,29,590
公投第１５案,新竹市,北區,興南里,146,1370,243,443,686,33,719
公投第１５案,新竹市,北區,育英里,147,1390,246,472,718,36,754
公投第１５案,新竹市,北區,育英里,148,962,195,342,537,17,554
公投第１５案,新竹市,北區,育英里,149,1237,276,397,673,16,689
公投第１５案,新竹市,北區,台溪里,150,1604,279,455,734,62,796
公投第１５案,新竹市,北區,曲溪里,151,758,116,252,368,13,381
公投第１５案,新竹市,北區,曲溪里,152,1320,226,439,665,20,685
公投第１５案,新竹市,北區,曲溪里,153,1519,247,463,710,58,768
公投第１５案,新竹市,北區,曲溪里,154,347,47,83,130,3,133
公投第１５案,新竹市,北區,曲溪里,155,1212,210,460,670,30,700
公投第１５案,新竹市,北區,西雅里,156,1484,274,493,767,27,794
公投第１５案,新竹市,北區,西雅里,157,1428,272,456,728,57,785
公投第１５案,新竹市,北區,客雅里,158,1128,181,440,621,24,645
公投第１５案,新竹市,北區,客雅里,159,638,60,283,343,18,361
公投第１５案,新竹市,北區,中雅里,160,1222,182,487,669,46,715
公投第１５案,新竹市,北區,中雅里,161,1076,215,351,566,26,592
公投第１５案,新竹市,北區,中雅里,162,937,197,386,583,21,604
公投第１５案,新竹市,北區,南勢里,163,1394,232,505,737,29,766
公投第１５案,新竹市,北區,南勢里,164,1568,271,495,766,35,801
公投第１５案,新竹市,北區,南勢里,165,1159,251,420,671,35,706
公投第１５案,新竹市,北區,大鵬里,166,252,34,70,104,1,105
公投第１５案,新竹市,北區,大同里,167,761,169,290,459,21,480
公投第１５案,新竹市,北區,中山里,168,788,167,269,436,33,469
公投第１５案,新竹市,北區,中興里,169,561,125,208,333,30,363
公投第１５案,新竹市,北區,新民里,170,1558,277,482,759,68,827
公投第１５案,新竹市,北區,長和里,171,1398,260,407,667,33,700
公投第１５案,新竹市,北區,北門里,172,957,164,332,496,40,536
公投第１５案,新竹市,北區,民富里,173,1195,212,442,654,31,685
公投第１５案,新竹市,北區,民富里,174,1236,235,351,586,28,614
公投第１５案,新竹市,北區,民富里,175,1255,206,416,622,46,668
公投第１５案,新竹市,北區,民富里,176,1114,225,400,625,16,641
公投第１５案,新竹市,北區,磐石里,177,1396,263,489,752,27,779
公投第１５案,新竹市,北區,磐石里,178,1456,270,527,797,42,839
公投第１５案,新竹市,北區,磐石里,179,1374,268,453,721,24,745
公投第１５案,新竹市,北區,磐石里,180,1070,186,354,540,31,571
公投第１５案,新竹市,北區,新雅里,181,1142,172,427,599,42,641
公投第１５案,新竹市,北區,新雅里,182,1103,202,366,568,18,586
公投第１５案,新竹市,北區,新雅里,183,1190,198,425,623,58,681
公投第１５案,新竹市,北區,新雅里,184,1089,192,464,656,20,676
公投第１５案,新竹市,北區,文雅里,185,1272,205,393,598,20,618
公投第１５案,新竹市,北區,文雅里,186,1306,235,447,682,44,726
公投第１５案,新竹市,北區,文雅里,187,1328,261,445,706,36,742
公投第１５案,新竹市,北區,水田里,188,1457,274,466,740,26,766
公投第１５案,新竹市,北區,水田里,189,1492,301,496,797,34,831
公投第１５案,新竹市,北區,光田里,190,1160,229,429,658,44,702
公投第１５案,新竹市,北區,光田里,191,971,164,339,503,71,574
公投第１５案,新竹市,北區,光華里,192,1401,158,289,447,13,460
公投第１５案,新竹市,北區,光華里,193,1340,288,459,747,28,775
公投第１５案,新竹市,北區,光華里,194,1371,278,500,778,30,808
公投第１５案,新竹市,北區,金華里,195,1267,258,315,573,26,599
公投第１５案,新竹市,北區,金華里,196,1073,247,411,658,22,680
公投第１５案,新竹市,北區,金華里,197,1159,228,429,657,22,679
公投第１５案,新竹市,北區,金華里,198,1294,278,426,704,19,723
公投第１５案,新竹市,北區,湳雅里,199,1442,275,499,774,31,805
公投第１５案,新竹市,北區,湳雅里,200,1270,265,450,715,28,743
公投第１５案,新竹市,北區,金雅里,201,1179,255,461,716,39,755
公投第１５案,新竹市,北區,金雅里,202,949,190,379,569,29,598
公投第１５案,新竹市,北區,湳中里,203,1163,228,420,648,29,677
公投第１５案,新竹市,北區,湳中里,204,1334,290,433,723,14,737
公投第１５案,新竹市,北區,湳中里,205,1415,329,441,770,26,796
公投第１５案,新竹市,北區,湳中里,206,1305,326,454,780,16,796
公投第１５案,新竹市,北區,湳中里,207,1200,245,414,659,23,682
公投第１５案,新竹市,北區,舊社里,208,1106,240,379,619,15,634
公投第１５案,新竹市,北區,舊社里,209,1044,323,286,609,21,630
公投第１５案,新竹市,北區,舊社里,210,1061,233,373,606,24,630
公投第１５案,新竹市,北區,舊社里,211,1518,315,529,844,52,896
公投第１５案,新竹市,北區,舊社里,212,1220,256,473,729,29,758
公投第１５案,新竹市,北區,金竹里,213,1475,315,524,839,15,854
公投第１５案,新竹市,北區,金竹里,214,1373,221,490,711,38,749
公投第１５案,新竹市,北區,金竹里,215,1450,262,549,811,25,836
公投第１５案,新竹市,北區,金竹里,216,1423,274,532,806,23,829
公投第１５案,新竹市,北區,武陵里,217,1059,162,434,596,17,613
公投第１５案,新竹市,北區,武陵里,218,1130,189,468,657,29,686
公投第１５案,新竹市,北區,武陵里,219,1208,222,528,750,31,781
公投第１５案,新竹市,北區,武陵里,220,1226,172,569,741,22,763
公投第１５案,新竹市,北區,福林里,221,1175,247,400,647,30,677
公投第１５案,新竹市,北區,福林里,222,1371,277,496,773,21,794
公投第１５案,新竹市,北區,福林里,223,1306,225,448,673,51,724
公投第１５案,新竹市,北區,境福里,224,1340,213,485,698,21,719
公投第１５案,新竹市,北區,境福里,225,1111,242,404,646,38,684
公投第１５案,新竹市,北區,境福里,226,1197,244,496,740,27,767
公投第１５案,新竹市,北區,境福里,227,1008,144,407,551,28,579
公投第１５案,新竹市,北區,士林里,228,946,171,327,498,23,521
公投第１５案,新竹市,北區,士林里,229,705,124,271,395,29,424
公投第１５案,新竹市,北區,古賢里,230,848,145,287,432,73,505
公投第１５案,新竹市,北區,南寮里,231,1295,233,439,672,21,693
公投第１５案,新竹市,北區,南寮里,232,1467,215,519,734,23,757
公投第１５案,新竹市,北區,南寮里,233,1659,256,482,738,38,776
公投第１５案,新竹市,北區,南寮里,234,1297,231,439,670,32,702
公投第１５案,新竹市,北區,康樂里,235,1374,254,483,737,54,791
公投第１５案,新竹市,北區,康樂里,236,1457,283,506,789,58,847
公投第１５案,新竹市,北區,中寮里,237,1072,187,420,607,26,633
公投第１５案,新竹市,北區,中寮里,238,1350,231,459,690,35,725
公投第１５案,新竹市,北區,中寮里,239,971,195,401,596,17,613
公投第１５案,新竹市,北區,海濱里,240,1450,247,546,793,59,852
公投第１５案,新竹市,北區,海濱里,241,895,150,336,486,27,513
公投第１５案,新竹市,北區,海濱里,242,1378,238,489,727,31,758
公投第１５案,新竹市,北區,港北里,243,1609,226,510,736,70,806
公投第１５案,新竹市,北區,舊港里,244,594,104,208,312,35,347
公投第１５案,新竹市,香山區,頂埔里,245,1443,240,496,736,48,784
公投第１５案,新竹市,香山區,頂埔里,246,1241,244,411,655,30,685
公投第１５案,新竹市,香山區,頂埔里,247,1194,224,422,646,15,661
公投第１５案,新竹市,香山區,頂埔里,248,1081,222,372,594,11,605
公投第１５案,新竹市,香山區,頂福里,249,807,146,307,453,22,475
公投第１５案,新竹市,香山區,頂福里,250,1760,314,596,910,50,960
公投第１５案,新竹市,香山區,頂福里,251,1635,295,581,876,37,913
公投第１５案,新竹市,香山區,中埔里,252,1473,282,532,814,41,855
公投第１５案,新竹市,香山區,中埔里,253,1408,253,521,774,26,800
公投第１５案,新竹市,香山區,牛埔里,254,1318,201,420,621,20,641
公投第１５案,新竹市,香山區,牛埔里,255,1337,233,480,713,41,754
公投第１５案,新竹市,香山區,牛埔里,256,1862,317,610,927,27,954
公投第１５案,新竹市,香山區,埔前里,257,1067,210,364,574,22,596
公投第１５案,新竹市,香山區,埔前里,258,863,173,325,498,31,529
公投第１５案,新竹市,香山區,埔前里,259,1198,249,438,687,53,740
公投第１５案,新竹市,香山區,樹下里,260,1138,313,330,643,50,693
公投第１５案,新竹市,香山區,樹下里,261,957,190,378,568,54,622
公投第１５案,新竹市,香山區,浸水里,262,1348,238,507,745,55,800
公投第１５案,新竹市,香山區,浸水里,263,1023,231,403,634,56,690
公投第１５案,新竹市,香山區,虎林里,264,970,140,381,521,32,553
公投第１５案,新竹市,香山區,虎林里,265,1318,250,476,726,39,765
公投第１５案,新竹市,香山區,虎山里,266,1088,177,384,561,47,608
公投第１５案,新竹市,香山區,虎山里,267,903,157,283,440,19,459
公投第１５案,新竹市,香山區,虎山里,268,1012,175,380,555,36,591
公投第１５案,新竹市,香山區,虎山里,269,1014,146,396,542,41,583
公投第１５案,新竹市,香山區,虎山里,270,1238,211,480,691,23,714
公投第１５案,新竹市,香山區,港南里,271,1182,187,409,596,60,656
公投第１５案,新竹市,香山區,港南里,272,1331,238,560,798,57,855
公投第１５案,新竹市,香山區,東香里,273,976,253,366,619,14,633
公投第１５案,新竹市,香山區,東香里,274,834,146,291,437,18,455
公投第１５案,新竹市,香山區,東香里,275,919,155,342,497,33,530
公投第１５案,新竹市,香山區,東香里,276,1188,273,400,673,30,703
公投第１５案,新竹市,香山區,香村里,277,1086,183,404,587,43,630
公投第１５案,新竹市,香山區,香村里,278,1144,246,431,677,37,714
公投第１５案,新竹市,香山區,香村里,279,1112,211,416,627,32,659
公投第１５案,新竹市,香山區,香山里,280,1476,274,536,810,45,855
公投第１５案,新竹市,香山區,香山里,281,1291,226,469,695,24,719
公投第１５案,新竹市,香山區,香山里,282,1464,260,602,862,42,904
公投第１５案,新竹市,香山區,大庄里,283,1427,222,563,785,60,845
公投第１５案,新竹市,香山區,大庄里,284,1336,231,479,710,15,725
公投第１５案,新竹市,香山區,美山里,285,1131,179,357,536,32,568
公投第１５案,新竹市,香山區,朝山里,286,1070,190,409,599,50,649
公投第１５案,新竹市,香山區,朝山里,287,1006,170,381,551,69,620
公投第１５案,新竹市,香山區,海山里,288,1223,157,385,542,35,577
公投第１５案,新竹市,香山區,海山里,289,1119,198,415,613,23,636
公投第１５案,新竹市,香山區,鹽水里,290,1400,228,438,666,37,703
公投第１５案,新竹市,香山區,內湖里,291,1627,251,489,740,36,776
公投第１５案,新竹市,香山區,內湖里,292,1289,209,399,608,41,649
公投第１５案,新竹市,香山區,內湖里,293,1409,210,459,669,46,715
公投第１５案,新竹市,香山區,南港里,294,814,129,262,391,30,421
公投第１５案,新竹市,香山區,中隘里,295,719,111,267,378,24,402
公投第１５案,新竹市,香山區,中隘里,296,1065,170,336,506,16,522
公投第１５案,新竹市,香山區,南隘里,297,776,121,266,387,50,437
公投第１５案,新竹市,香山區,大湖里,298,890,156,331,487,29,516
公投第１５案,新竹市,香山區,茄苳里,299,896,138,305,443,21,464
公投第１５案,嘉義市,東區,短竹里,1,1025,201,366,567,24,591
公投第１５案,嘉義市,東區,短竹里,2,1276,241,418,659,22,681
公投第１５案,嘉義市,東區,蘭潭里,3,974,156,313,469,28,497
公投第１５案,嘉義市,東區,蘭潭里,4,1175,241,456,697,26,723
公投第１５案,嘉義市,東區,東川里,5,702,153,267,420,18,438
公投第１５案,嘉義市,東區,東川里,6,1092,198,379,577,27,604
公投第１５案,嘉義市,東區,鹿寮里,7,1023,149,312,461,20,481
公投第１５案,嘉義市,東區,盧厝里,8,1816,297,605,902,37,939
公投第１５案,嘉義市,東區,文雅里,9,1936,404,636,1040,30,1070
公投第１５案,嘉義市,東區,文雅里,10,1698,388,559,947,13,960
公投第１５案,嘉義市,東區,王田里,11,1221,271,434,705,14,719
公投第１５案,嘉義市,東區,王田里,12,1113,228,382,610,17,627
公投第１５案,嘉義市,東區,長竹里,13,1452,285,519,804,27,831
公投第１５案,嘉義市,東區,長竹里,14,1395,302,533,835,25,860
公投第１５案,嘉義市,東區,後庄里,15,1453,256,455,711,31,742
公投第１５案,嘉義市,東區,後庄里,16,1094,178,394,572,14,586
公投第１５案,嘉義市,東區,後庄里,17,1420,262,520,782,26,808
公投第１５案,嘉義市,東區,新店里,18,1552,299,576,875,40,915
公投第１５案,嘉義市,東區,新店里,19,1558,316,528,844,46,890
公投第１５案,嘉義市,東區,新店里,20,1062,406,188,594,30,624
公投第１５案,嘉義市,東區,圳頭里,21,1199,195,423,618,37,655
公投第１５案,嘉義市,東區,圳頭里,22,1236,184,488,672,20,692
公投第１５案,嘉義市,東區,圳頭里,23,890,162,308,470,21,491
公投第１５案,嘉義市,東區,圳頭里,24,880,169,332,501,34,535
公投第１５案,嘉義市,東區,中山里,25,1189,239,405,644,14,658
公投第１５案,嘉義市,東區,中山里,26,669,135,250,385,13,398
公投第１５案,嘉義市,東區,太平里,27,1435,276,483,759,29,788
公投第１５案,嘉義市,東區,太平里,28,1349,192,598,790,24,814
公投第１５案,嘉義市,東區,太平里,29,1455,251,490,741,29,770
公投第１５案,嘉義市,東區,東興里,30,915,182,327,509,24,533
公投第１５案,嘉義市,東區,東興里,31,952,191,320,511,22,533
公投第１５案,嘉義市,東區,華南里,32,941,175,316,491,40,531
公投第１５案,嘉義市,東區,華南里,33,1080,204,346,550,25,575
公投第１５案,嘉義市,東區,中央里,34,1157,183,373,556,24,580
公投第１５案,嘉義市,東區,中央里,35,1053,222,357,579,31,610
公投第１５案,嘉義市,東區,朝陽里,36,967,171,290,461,27,488
公投第１５案,嘉義市,東區,朝陽里,37,1091,205,356,561,25,586
公投第１５案,嘉義市,東區,民族里,38,961,172,365,537,41,578
公投第１５案,嘉義市,東區,民族里,39,863,119,212,331,24,355
公投第１５案,嘉義市,東區,過溝里,40,1023,200,371,571,44,615
公投第１５案,嘉義市,東區,過溝里,41,1078,175,403,578,64,642
公投第１５案,嘉義市,東區,新開里,42,938,167,325,492,14,506
公投第１５案,嘉義市,東區,新開里,43,1049,204,356,560,22,582
公投第１５案,嘉義市,東區,宣信里,44,1360,228,428,656,55,711
公投第１５案,嘉義市,東區,興南里,45,1615,169,143,312,76,388
公投第１５案,嘉義市,東區,豐年里,46,1267,244,406,650,31,681
公投第１５案,嘉義市,東區,芳草里,47,1579,230,481,711,53,764
公投第１５案,嘉義市,東區,芳草里,48,1831,323,559,882,62,944
公投第１５案,嘉義市,東區,芳安里,49,977,173,374,547,25,572
公投第１５案,嘉義市,東區,芳安里,50,1169,230,357,587,4,591
公投第１５案,嘉義市,東區,頂寮里,51,1238,249,418,667,71,738
公投第１５案,嘉義市,東區,頂寮里,52,1266,233,457,690,19,709
公投第１５案,嘉義市,東區,安寮里,53,1429,180,459,639,40,679
公投第１５案,嘉義市,東區,安寮里,54,1288,237,441,678,25,703
公投第１５案,嘉義市,東區,安業里,55,980,202,303,505,36,541
公投第１５案,嘉義市,東區,安業里,56,922,156,306,462,18,480
公投第１５案,嘉義市,東區,興村里,57,1133,199,431,630,33,663
公投第１５案,嘉義市,東區,興村里,58,1235,229,433,662,34,696
公投第１５案,嘉義市,東區,興村里,59,1525,293,491,784,20,804
公投第１５案,嘉義市,東區,興安里,60,1170,198,378,576,32,608
公投第１５案,嘉義市,東區,興安里,61,1177,251,446,697,45,742
公投第１５案,嘉義市,東區,興仁里,62,1207,215,425,640,46,686
公投第１５案,嘉義市,東區,興仁里,63,1272,219,463,682,37,719
公投第１５案,嘉義市,東區,興仁里,64,1188,201,393,594,80,674
公投第１５案,嘉義市,東區,北門里,65,1172,198,376,574,19,593
公投第１５案,嘉義市,東區,北門里,66,1020,205,363,568,34,602
公投第１５案,嘉義市,東區,林森里,67,1332,279,446,725,41,766
公投第１５案,嘉義市,東區,林森里,68,1011,229,363,592,31,623
公投第１５案,嘉義市,東區,中庄里,69,1682,280,540,820,62,882
公投第１５案,嘉義市,東區,中庄里,70,1567,245,565,810,52,862
公投第１５案,嘉義市,東區,頂庄里,71,1207,238,430,668,18,686
公投第１５案,嘉義市,東區,頂庄里,72,981,200,369,569,21,590
公投第１５案,嘉義市,東區,義教里,73,1395,261,449,710,39,749
公投第１５案,嘉義市,東區,義教里,74,1434,245,426,671,18,689
公投第１５案,嘉義市,東區,仁義里,75,1404,237,388,625,20,645
公投第１５案,嘉義市,東區,仁義里,76,1428,270,502,772,26,798
公投第１５案,嘉義市,東區,後湖里,77,1823,272,491,763,19,782
公投第１５案,嘉義市,東區,後湖里,78,1570,264,481,745,33,778
公投第１５案,嘉義市,東區,荖藤里,79,1282,214,424,638,49,687
公投第１５案,嘉義市,東區,荖藤里,80,1571,279,605,884,47,931
公投第１５案,嘉義市,東區,荖藤里,81,1533,295,475,770,26,796
公投第１５案,嘉義市,西區,書院里,82,885,151,320,471,12,483
公投第１５案,嘉義市,西區,書院里,83,1109,196,357,553,50,603
公投第１５案,嘉義市,西區,永和里,84,1020,168,317,485,46,531
公投第１５案,嘉義市,西區,永和里,85,925,168,377,545,38,583
公投第１５案,嘉義市,西區,新富里,86,1671,291,449,740,30,770
公投第１５案,嘉義市,西區,文化里,87,1215,250,415,665,13,678
公投第１５案,嘉義市,西區,文化里,88,1036,193,342,535,25,560
公投第１５案,嘉義市,西區,西榮里,89,1129,193,359,552,28,580
公投第１５案,嘉義市,西區,西榮里,90,1127,196,385,581,27,608
公投第１５案,嘉義市,西區,番社里,91,1415,269,488,757,39,796
公投第１５案,嘉義市,西區,國華里,92,1366,201,486,687,21,708
公投第１５案,嘉義市,西區,大溪里,93,1053,192,404,596,49,645
公投第１５案,嘉義市,西區,大溪里,94,1067,165,403,568,21,589
公投第１５案,嘉義市,西區,磚磘里,95,1575,253,483,736,23,759
公投第１５案,嘉義市,西區,磚磘里,96,1865,325,617,942,36,978
公投第１５案,嘉義市,西區,福全里,97,1196,217,372,589,33,622
公投第１５案,嘉義市,西區,福全里,98,1280,394,221,615,21,636
公投第１５案,嘉義市,西區,福全里,99,1629,287,544,831,47,878
公投第１５案,嘉義市,西區,福安里,100,1393,243,501,744,55,799
公投第１５案,嘉義市,西區,福安里,101,1077,214,396,610,35,645
公投第１５案,嘉義市,西區,福安里,102,1694,306,483,789,12,801
公投第１５案,嘉義市,西區,新西里,103,841,178,270,448,78,526
公投第１５案,嘉義市,西區,新西里,104,1183,100,480,580,4,584
公投第１５案,嘉義市,西區,港坪里,105,1000,209,405,614,18,632
公投第１５案,嘉義市,西區,港坪里,106,1095,214,420,634,21,655
公投第１５案,嘉義市,西區,港坪里,107,1256,40,676,716,32,748
公投第１５案,嘉義市,西區,頭港里,108,962,172,349,521,40,561
公投第１５案,嘉義市,西區,頭港里,109,865,198,336,534,22,556
公投第１５案,嘉義市,西區,西平里,110,1396,217,453,670,49,719
公投第１５案,嘉義市,西區,西平里,111,1799,338,603,941,47,988
公投第１５案,嘉義市,西區,劉厝里,112,1505,225,516,741,19,760
公投第１５案,嘉義市,西區,劉厝里,113,1698,275,577,852,48,900
公投第１５案,嘉義市,西區,劉厝里,114,1854,313,672,985,20,1005
公投第１５案,嘉義市,西區,劉厝里,115,1537,236,444,680,8,688
公投第１５案,嘉義市,西區,自強里,116,1604,292,489,781,42,823
公投第１５案,嘉義市,西區,美源里,117,944,194,342,536,59,595
公投第１５案,嘉義市,西區,美源里,118,1627,256,624,880,52,932
公投第１５案,嘉義市,西區,美源里,119,1144,215,431,646,33,679
公投第１５案,嘉義市,西區,湖內里,120,1362,225,481,706,41,747
公投第１５案,嘉義市,西區,湖內里,121,1279,249,463,712,28,740
公投第１５案,嘉義市,西區,湖內里,122,1702,280,597,877,67,944
公投第１５案,嘉義市,西區,獅子里,123,1358,269,493,762,40,802
公投第１５案,嘉義市,西區,獅子里,124,1360,264,512,776,56,832
公投第１５案,嘉義市,西區,紅瓦里,125,1589,249,610,859,52,911
公投第１５案,嘉義市,西區,光路里,126,1280,235,503,738,27,765
公投第１５案,嘉義市,西區,光路里,127,1220,201,379,580,29,609
公投第１５案,嘉義市,西區,光路里,128,1172,214,457,671,21,692
公投第１５案,嘉義市,西區,光路里,129,1320,249,460,709,33,742
公投第１５案,嘉義市,西區,福民里,130,1185,235,502,737,28,765
公投第１５案,嘉義市,西區,福民里,131,1278,247,504,751,35,786
公投第１５案,嘉義市,西區,福民里,132,1394,238,374,612,18,630
公投第１５案,嘉義市,西區,福民里,133,1540,284,562,846,34,880
公投第１５案,嘉義市,西區,車店里,134,1548,278,540,818,55,873
公投第１５案,嘉義市,西區,車店里,135,1295,230,437,667,30,697
公投第１５案,嘉義市,西區,車店里,136,1318,249,503,752,45,797
公投第１５案,嘉義市,西區,車店里,137,1545,271,549,820,40,860
公投第１５案,嘉義市,西區,垂楊里,138,736,144,208,352,26,378
公投第１５案,嘉義市,西區,垂楊里,139,1168,180,414,594,24,618
公投第１５案,嘉義市,西區,培元里,140,756,148,308,456,29,485
公投第１５案,嘉義市,西區,培元里,141,869,123,357,480,12,492
公投第１５案,嘉義市,西區,育英里,142,983,187,363,550,37,587
公投第１５案,嘉義市,西區,育英里,143,828,140,307,447,32,479
公投第１５案,嘉義市,西區,致遠里,144,1775,243,699,942,34,976
公投第１５案,嘉義市,西區,翠岱里,145,1419,192,550,742,16,758
公投第１５案,嘉義市,西區,導明里,146,779,139,263,402,13,415
公投第１５案,嘉義市,西區,導明里,147,855,134,296,430,15,445
公投第１５案,嘉義市,西區,北榮里,148,1146,220,404,624,49,673
公投第１５案,嘉義市,西區,北榮里,149,1111,204,406,610,23,633
公投第１５案,嘉義市,西區,慶安里,150,767,133,329,462,34,496
公投第１５案,嘉義市,西區,慶安里,151,817,138,259,397,17,414
公投第１５案,嘉義市,西區,香湖里,152,770,147,274,421,30,451
公投第１５案,嘉義市,西區,重興里,153,1135,166,338,504,17,521
公投第１５案,嘉義市,西區,重興里,154,835,153,239,392,64,456
公投第１５案,嘉義市,西區,後驛里,155,1182,177,368,545,32,577
公投第１５案,嘉義市,西區,後驛里,156,944,145,293,438,30,468
公投第１５案,嘉義市,西區,湖邊里,157,997,172,325,497,30,527
公投第１５案,嘉義市,西區,湖邊里,158,1074,204,372,576,22,598
公投第１５案,嘉義市,西區,竹圍里,159,1460,233,408,641,20,661
公投第１５案,嘉義市,西區,竹圍里,160,1352,228,450,678,39,717
公投第１５案,嘉義市,西區,竹圍里,161,1499,281,480,761,36,797
公投第１５案,嘉義市,西區,保生里,162,1262,233,419,652,62,714
公投第１５案,嘉義市,西區,保生里,163,1299,229,446,675,26,701
公投第１５案,嘉義市,西區,保生里,164,1734,276,576,852,44,896
公投第１５案,嘉義市,西區,保安里,165,1674,244,550,794,29,823
公投第１５案,嘉義市,西區,保安里,166,1540,182,590,772,24,796
公投第１５案,嘉義市,西區,北新里,167,1056,205,401,606,24,630
公投第１５案,嘉義市,西區,新厝里,168,1467,272,522,794,64,858
公投第１５案,嘉義市,西區,新厝里,169,1431,242,453,695,51,746
公投第１５案,嘉義市,西區,新厝里,170,1234,243,478,721,52,773
公投第１５案,嘉義市,西區,保福里,171,1266,226,440,666,12,678
公投第１５案,嘉義市,西區,保福里,172,1211,233,435,668,20,688
公投第１５案,嘉義市,西區,保福里,173,1121,207,425,632,12,644
公投第１５案,嘉義市,西區,竹村里,174,1155,180,392,572,17,589
公投第１５案,嘉義市,西區,北湖里,175,1546,287,533,820,75,895
公投第１５案,嘉義市,西區,北湖里,176,1322,208,467,675,23,698
公投第１５案,嘉義市,西區,下埤里,177,1549,266,558,824,73,897
公投第１５案,臺北市,北投區,建民里,1,1313,462,286,748,55,803
公投第１５案,臺北市,北投區,建民里,2,1403,319,506,825,45,870
公投第１５案,臺北市,北投區,建民里,3,1081,274,352,626,34,660
公投第１５案,臺北市,北投區,文林里,4,1209,292,389,681,48,729
公投第１５案,臺北市,北投區,文林里,5,1326,303,441,744,38,782
公投第１５案,臺北市,北投區,文林里,6,1263,296,430,726,42,768
公投第１５案,臺北市,北投區,石牌里,7,1580,370,531,901,62,963
公投第１５案,臺北市,北投區,石牌里,8,1577,330,557,887,44,931
公投第１５案,臺北市,北投區,石牌里,9,1483,331,504,835,58,893
公投第１５案,臺北市,北投區,福興里,10,1461,310,475,785,38,823
公投第１５案,臺北市,北投區,福興里,11,1466,321,455,776,51,827
公投第１５案,臺北市,北投區,福興里,12,1620,320,600,920,48,968
公投第１５案,臺北市,北投區,福興里,13,1543,280,528,808,30,838
公投第１５案,臺北市,北投區,榮光里,14,1513,282,490,772,55,827
公投第１５案,臺北市,北投區,榮光里,15,1534,300,548,848,40,888
公投第１５案,臺北市,北投區,榮光里,16,1650,337,588,925,59,984
公投第１５案,臺北市,北投區,榮光里,17,1533,331,526,857,40,897
公投第１５案,臺北市,北投區,榮華里,18,1702,367,549,916,30,946
公投第１５案,臺北市,北投區,榮華里,19,1721,438,508,946,33,979
公投第１５案,臺北市,北投區,榮華里,20,1575,415,504,919,45,964
公投第１５案,臺北市,北投區,榮華里,21,1530,353,487,840,57,897
公投第１５案,臺北市,北投區,裕民里,22,1728,361,600,961,47,1008
公投第１５案,臺北市,北投區,裕民里,23,1702,350,587,937,44,981
公投第１５案,臺北市,北投區,裕民里,24,1696,363,544,907,55,962
公投第１５案,臺北市,北投區,裕民里,25,1684,291,481,772,30,802
公投第１５案,臺北市,北投區,振華里,26,1717,384,604,988,44,1032
公投第１５案,臺北市,北投區,振華里,27,1605,350,570,920,25,945
公投第１５案,臺北市,北投區,振華里,28,1723,320,612,932,59,991
公投第１５案,臺北市,北投區,振華里,29,1597,362,591,953,40,993
公投第１５案,臺北市,北投區,永和里,30,1700,350,595,945,33,978
公投第１５案,臺北市,北投區,永和里,31,1544,434,337,771,32,803
公投第１５案,臺北市,北投區,永和里,32,1635,329,525,854,37,891
公投第１５案,臺北市,北投區,永和里,33,1495,327,523,850,27,877
公投第１５案,臺北市,北投區,永和里,34,1619,354,546,900,41,941
公投第１５案,臺北市,北投區,永欣里,35,1683,35,511,546,38,584
公投第１５案,臺北市,北投區,永欣里,36,1662,330,495,825,45,870
公投第１５案,臺北市,北投區,永欣里,37,1850,340,548,888,21,909
公投第１５案,臺北市,北投區,永欣里,38,1674,373,485,858,20,878
公投第１５案,臺北市,北投區,永明里,39,1511,298,562,860,60,920
公投第１５案,臺北市,北投區,永明里,40,1393,279,496,775,26,801
公投第１５案,臺北市,北投區,永明里,41,1279,289,473,762,47,809
公投第１５案,臺北市,北投區,東華里,42,1122,254,352,606,28,634
公投第１５案,臺北市,北投區,東華里,43,1238,312,519,831,48,879
公投第１５案,臺北市,北投區,東華里,44,1477,334,540,874,45,919
公投第１５案,臺北市,北投區,吉利里,45,1495,327,545,872,45,917
公投第１５案,臺北市,北投區,吉利里,46,1469,318,580,898,32,930
公投第１５案,臺北市,北投區,吉利里,47,1462,273,540,813,45,858
公投第１５案,臺北市,北投區,吉利里,48,1431,279,525,804,45,849
公投第１５案,臺北市,北投區,吉慶里,49,1486,348,483,831,37,868
公投第１５案,臺北市,北投區,吉慶里,50,1449,328,513,841,44,885
公投第１５案,臺北市,北投區,吉慶里,51,1456,350,478,828,32,860
公投第１５案,臺北市,北投區,尊賢里,52,1311,277,455,732,31,763
公投第１５案,臺北市,北投區,尊賢里,53,1356,293,473,766,46,812
公投第１５案,臺北市,北投區,尊賢里,54,1338,281,463,744,37,781
公投第１５案,臺北市,北投區,立賢里,55,1525,324,535,859,31,890
公投第１５案,臺北市,北投區,立賢里,56,1620,344,503,847,44,891
公投第１５案,臺北市,北投區,立賢里,57,1499,290,496,786,21,807
公投第１５案,臺北市,北投區,立農里,58,1497,300,567,867,28,895
公投第１５案,臺北市,北投區,立農里,59,1624,362,521,883,43,926
公投第１５案,臺北市,北投區,立農里,60,1536,294,484,778,62,840
公投第１５案,臺北市,北投區,立農里,61,1469,330,508,838,58,896
公投第１５案,臺北市,北投區,立農里,62,1598,335,509,844,48,892
公投第１５案,臺北市,北投區,八仙里,63,1690,370,531,901,27,928
公投第１５案,臺北市,北投區,八仙里,64,1599,291,527,818,92,910
公投第１５案,臺北市,北投區,八仙里,65,1634,370,510,880,42,922
公投第１５案,臺北市,北投區,洲美里,66,1660,346,505,851,34,885
公投第１５案,臺北市,北投區,奇岩里,67,1900,378,564,942,58,1000
公投第１５案,臺北市,北投區,奇岩里,68,1797,402,568,970,50,1020
公投第１５案,臺北市,北投區,奇岩里,69,1832,413,612,1025,42,1067
公投第１５案,臺北市,北投區,奇岩里,70,1784,363,634,997,49,1046
公投第１５案,臺北市,北投區,奇岩里,71,1732,366,592,958,50,1008
公投第１５案,臺北市,北投區,清江里,72,2035,220,295,515,46,561
公投第１５案,臺北市,北投區,清江里,73,1504,333,469,802,57,859
公投第１５案,臺北市,北投區,清江里,74,1683,333,633,966,55,1021
公投第１５案,臺北市,北投區,清江里,75,1635,315,527,842,62,904
公投第１５案,臺北市,北投區,清江里,76,1613,329,520,849,60,909
公投第１５案,臺北市,北投區,中央里,77,1483,322,465,787,29,816
公投第１５案,臺北市,北投區,中央里,78,1500,331,484,815,43,858
公投第１５案,臺北市,北投區,中央里,79,1483,327,493,820,53,873
公投第１５案,臺北市,北投區,中央里,80,1544,321,495,816,57,873
公投第１５案,臺北市,北投區,中央里,81,1532,282,431,713,59,772
公投第１５案,臺北市,北投區,長安里,82,1819,367,606,973,49,1022
公投第１５案,臺北市,北投區,長安里,83,1863,389,502,891,62,953
公投第１５案,臺北市,北投區,長安里,84,1872,375,537,912,22,934
公投第１５案,臺北市,北投區,大同里,85,1627,320,541,861,41,902
公投第１５案,臺北市,北投區,大同里,86,1696,333,528,861,39,900
公投第１５案,臺北市,北投區,大同里,87,1841,424,541,965,39,1004
公投第１５案,臺北市,北投區,溫泉里,88,1324,305,410,715,38,753
公投第１５案,臺北市,北投區,溫泉里,89,1504,292,495,787,34,821
公投第１５案,臺北市,北投區,溫泉里,90,1511,305,509,814,38,852
公投第１５案,臺北市,北投區,溫泉里,91,1615,380,535,915,39,954
公投第１５案,臺北市,北投區,林泉里,92,1270,241,400,641,30,671
公投第１５案,臺北市,北投區,林泉里,93,1492,305,415,720,27,747
公投第１５案,臺北市,北投區,中心里,94,1429,331,416,747,30,777
公投第１５案,臺北市,北投區,中心里,95,1567,339,461,800,16,816
公投第１５案,臺北市,北投區,中心里,96,1388,303,451,754,33,787
公投第１５案,臺北市,北投區,中心里,97,1448,298,444,742,20,762
公投第１５案,臺北市,北投區,中庸里,98,1356,267,417,684,41,725
公投第１５案,臺北市,北投區,中庸里,99,1308,269,429,698,38,736
公投第１５案,臺北市,北投區,中庸里,100,1165,256,415,671,43,714
公投第１５案,臺北市,北投區,開明里,101,1429,297,507,804,54,858
公投第１５案,臺北市,北投區,開明里,102,1472,269,515,784,22,806
公投第１５案,臺北市,北投區,開明里,103,1508,348,550,898,49,947
公投第１５案,臺北市,北投區,開明里,104,1480,285,524,809,43,852
公投第１５案,臺北市,北投區,中和里,105,1142,255,350,605,31,636
公投第１５案,臺北市,北投區,中和里,106,1554,300,494,794,28,822
公投第１５案,臺北市,北投區,中和里,107,1669,351,588,939,64,1003
公投第１５案,臺北市,北投區,智仁里,108,1823,334,634,968,49,1017
公投第１５案,臺北市,北投區,智仁里,109,1739,343,559,902,52,954
公投第１５案,臺北市,北投區,智仁里,110,1771,313,578,891,57,948
公投第１５案,臺北市,北投區,秀山里,111,1468,246,478,724,53,777
公投第１５案,臺北市,北投區,秀山里,112,1469,292,501,793,31,824
公投第１５案,臺北市,北投區,文化里,113,1094,236,446,682,28,710
公投第１５案,臺北市,北投區,文化里,114,1101,197,466,663,44,707
公投第１５案,臺北市,北投區,文化里,115,1422,323,497,820,46,866
公投第１５案,臺北市,北投區,豐年里,116,1390,229,503,732,48,780
公投第１５案,臺北市,北投區,豐年里,117,1307,263,477,740,44,784
公投第１５案,臺北市,北投區,豐年里,118,1215,290,426,716,55,771
公投第１５案,臺北市,北投區,稻香里,119,1642,326,531,857,45,902
公投第１５案,臺北市,北投區,稻香里,120,1623,292,539,831,32,863
公投第１５案,臺北市,北投區,稻香里,121,1621,326,516,842,56,898
公投第１５案,臺北市,北投區,桃源里,122,1367,310,423,733,23,756
公投第１５案,臺北市,北投區,桃源里,123,1309,293,397,690,37,727
公投第１５案,臺北市,北投區,桃源里,124,1356,309,450,759,33,792
公投第１５案,臺北市,北投區,桃源里,125,1365,281,446,727,41,768
公投第１５案,臺北市,北投區,一德里,126,1613,353,488,841,34,875
公投第１５案,臺北市,北投區,一德里,127,1590,311,441,752,30,782
公投第１５案,臺北市,北投區,一德里,128,1662,343,564,907,57,964
公投第１５案,臺北市,北投區,一德里,129,1622,386,503,889,50,939
公投第１５案,臺北市,北投區,關渡里,130,1820,417,549,966,29,995
公投第１５案,臺北市,北投區,關渡里,131,1615,339,550,889,56,945
公投第１５案,臺北市,北投區,關渡里,132,1612,252,442,694,60,754
公投第１５案,臺北市,北投區,關渡里,133,1652,338,515,853,62,915
公投第１５案,臺北市,北投區,關渡里,134,1666,352,566,918,26,944
公投第１５案,臺北市,北投區,關渡里,135,1641,316,532,848,51,899
公投第１５案,臺北市,北投區,泉源里,136,528,132,163,295,27,322
公投第１５案,臺北市,北投區,泉源里,137,1642,285,435,720,67,787
公投第１５案,臺北市,北投區,湖山里,138,829,162,273,435,36,471
公投第１５案,臺北市,北投區,湖山里,139,690,110,243,353,29,382
公投第１５案,臺北市,北投區,大屯里,140,1067,190,343,533,51,584
公投第１５案,臺北市,北投區,湖田里,141,892,170,277,447,60,507
公投第１５案,臺北市,士林區,仁勇里,142,1695,350,549,899,63,962
公投第１５案,臺北市,士林區,仁勇里,143,1720,378,563,941,87,1028
公投第１５案,臺北市,士林區,義信里,144,1288,259,418,677,66,743
公投第１５案,臺北市,士林區,義信里,145,1546,326,495,821,47,868
公投第１５案,臺北市,士林區,福林里,146,652,162,227,389,22,411
公投第１５案,臺北市,士林區,福林里,147,870,166,282,448,30,478
公投第１５案,臺北市,士林區,福林里,148,1137,266,405,671,43,714
公投第１５案,臺北市,士林區,福德里,149,1050,235,385,620,41,661
公投第１５案,臺北市,士林區,福德里,150,1031,222,378,600,42,642
公投第１５案,臺北市,士林區,福德里,151,1075,241,388,629,13,642
公投第１５案,臺北市,士林區,福德里,152,2175,197,283,480,41,521
公投第１５案,臺北市,士林區,福志里,153,1775,322,548,870,76,946
公投第１５案,臺北市,士林區,福志里,154,1669,348,593,941,36,977
公投第１５案,臺北市,士林區,福志里,155,1665,405,551,956,56,1012
公投第１５案,臺北市,士林區,福志里,156,1648,382,592,974,52,1026
公投第１５案,臺北市,士林區,舊佳里,157,1246,246,458,704,21,725
公投第１５案,臺北市,士林區,舊佳里,158,1419,320,444,764,55,819
公投第１５案,臺北市,士林區,舊佳里,159,1327,294,420,714,68,782
公投第１５案,臺北市,士林區,舊佳里,160,1573,378,545,923,53,976
公投第１５案,臺北市,士林區,福佳里,161,1470,300,516,816,58,874
公投第１５案,臺北市,士林區,福佳里,162,1775,357,631,988,32,1020
公投第１５案,臺北市,士林區,福佳里,163,1692,340,612,952,35,987
公投第１５案,臺北市,士林區,福佳里,164,1842,392,638,1030,45,1075
公投第１５案,臺北市,士林區,後港里,165,1166,254,426,680,38,718
公投第１５案,臺北市,士林區,後港里,166,1687,319,501,820,66,886
公投第１５案,臺北市,士林區,後港里,167,1624,371,513,884,51,935
公投第１５案,臺北市,士林區,後港里,168,1477,330,532,862,68,930
公投第１５案,臺北市,士林區,後港里,169,1250,287,450,737,36,773
公投第１５案,臺北市,士林區,福中里,170,1434,325,470,795,57,852
公投第１５案,臺北市,士林區,福中里,171,1452,336,485,821,54,875
公投第１５案,臺北市,士林區,福中里,172,1533,347,568,915,48,963
公投第１５案,臺北市,士林區,福中里,173,1515,332,539,871,61,932
公投第１５案,臺北市,士林區,前港里,174,1203,295,401,696,37,733
公投第１５案,臺北市,士林區,前港里,175,1487,355,513,868,59,927
公投第１５案,臺北市,士林區,前港里,176,1252,262,435,697,28,725
公投第１５案,臺北市,士林區,百齡里,177,1536,318,527,845,40,885
公投第１５案,臺北市,士林區,百齡里,178,1556,324,573,897,49,946
公投第１５案,臺北市,士林區,百齡里,179,1511,338,509,847,49,896
公投第１５案,臺北市,士林區,百齡里,180,1572,379,536,915,48,963
公投第１５案,臺北市,士林區,承德里,181,1668,325,584,909,63,972
公投第１５案,臺北市,士林區,承德里,182,1685,358,642,1000,90,1090
公投第１５案,臺北市,士林區,承德里,183,1568,356,500,856,48,904
公投第１５案,臺北市,士林區,福華里,184,1327,272,415,687,45,732
公投第１５案,臺北市,士林區,福華里,185,1338,250,442,692,62,754
公投第１５案,臺北市,士林區,福華里,186,1515,292,450,742,54,796
公投第１５案,臺北市,士林區,福華里,187,1452,330,472,802,51,853
公投第１５案,臺北市,士林區,明勝里,188,1448,320,490,810,37,847
公投第１５案,臺北市,士林區,明勝里,189,1521,419,442,861,50,911
公投第１５案,臺北市,士林區,明勝里,190,1461,334,471,805,36,841
公投第１５案,臺北市,士林區,福順里,191,1541,330,445,775,65,840
公投第１５案,臺北市,士林區,福順里,192,1611,303,418,721,36,757
公投第１５案,臺北市,士林區,福順里,193,1595,321,523,844,57,901
公投第１５案,臺北市,士林區,富光里,194,1685,321,517,838,45,883
公投第１５案,臺北市,士林區,富光里,195,1816,350,573,923,61,984
公投第１５案,臺北市,士林區,富光里,196,1687,330,554,884,80,964
公投第１５案,臺北市,士林區,葫蘆里,197,1646,314,552,866,71,937
公投第１５案,臺北市,士林區,葫蘆里,198,1643,302,544,846,44,890
公投第１５案,臺北市,士林區,葫蘆里,199,1687,321,598,919,51,970
公投第１５案,臺北市,士林區,葫蘆里,200,1655,339,587,926,53,979
公投第１５案,臺北市,士林區,葫東里,201,1779,369,549,918,36,954
公投第１５案,臺北市,士林區,葫東里,202,1855,419,623,1042,44,1086
公投第１５案,臺北市,士林區,社子里,203,1350,298,448,746,41,787
公投第１５案,臺北市,士林區,社子里,204,1455,252,474,726,34,760
公投第１５案,臺北市,士林區,社子里,205,1497,280,391,671,53,724
公投第１５案,臺北市,士林區,社子里,206,1398,390,246,636,39,675
公投第１５案,臺北市,士林區,社新里,207,1747,358,606,964,63,1027
公投第１５案,臺北市,士林區,社新里,208,1465,304,452,756,70,826
公投第１５案,臺北市,士林區,社新里,209,1530,287,505,792,64,856
公投第１５案,臺北市,士林區,社新里,210,1855,350,557,907,65,972
公投第１５案,臺北市,士林區,社新里,211,1444,306,459,765,70,835
公投第１５案,臺北市,士林區,社園里,212,1563,317,459,776,54,830
公投第１５案,臺北市,士林區,社園里,213,1482,296,500,796,59,855
公投第１５案,臺北市,士林區,社園里,214,1552,339,470,809,74,883
公投第１５案,臺北市,士林區,社園里,215,1790,355,596,951,62,1013
公投第１５案,臺北市,士林區,永倫里,216,1628,289,505,794,68,862
公投第１５案,臺北市,士林區,永倫里,217,1337,282,434,716,53,769
公投第１５案,臺北市,士林區,永倫里,218,1750,361,560,921,73,994
公投第１５案,臺北市,士林區,永倫里,219,1668,310,503,813,87,900
公投第１５案,臺北市,士林區,福安里,220,1403,221,384,605,60,665
公投第１５案,臺北市,士林區,福安里,221,1468,263,397,660,40,700
公投第１５案,臺北市,士林區,福安里,222,1471,243,437,680,46,726
公投第１５案,臺北市,士林區,富洲里,223,1666,281,523,804,66,870
公投第１５案,臺北市,士林區,富洲里,224,1587,308,463,771,64,835
公投第１５案,臺北市,士林區,富洲里,225,1987,327,560,887,63,950
公投第１５案,臺北市,士林區,岩山里,226,1271,252,384,636,20,656
公投第１５案,臺北市,士林區,岩山里,227,1728,387,603,990,47,1037
公投第１５案,臺北市,士林區,名山里,228,1630,360,562,922,57,979
公投第１５案,臺北市,士林區,名山里,229,1619,355,568,923,40,963
公投第１５案,臺北市,士林區,名山里,230,1425,300,493,793,42,835
公投第１５案,臺北市,士林區,名山里,231,1623,390,575,965,45,1010
公投第１５案,臺北市,士林區,聖山里,232,1564,350,524,874,56,930
公投第１５案,臺北市,士林區,聖山里,233,1376,366,490,856,36,892
公投第１５案,臺北市,士林區,聖山里,234,1517,320,593,913,27,940
公投第１５案,臺北市,士林區,芝山里,235,1729,358,526,884,39,923
公投第１５案,臺北市,士林區,芝山里,236,1511,344,550,894,35,929
公投第１５案,臺北市,士林區,芝山里,237,1811,413,641,1054,36,1090
公投第１５案,臺北市,士林區,芝山里,238,1533,361,517,878,30,908
公投第１５案,臺北市,士林區,東山里,239,1657,415,615,1030,43,1073
公投第１５案,臺北市,士林區,東山里,240,1499,329,501,830,25,855
公投第１５案,臺北市,士林區,東山里,241,1402,235,529,764,49,813
公投第１５案,臺北市,士林區,德行里,242,1273,321,449,770,60,830
公投第１５案,臺北市,士林區,德行里,243,1273,282,448,730,39,769
公投第１５案,臺北市,士林區,德行里,244,1316,300,443,743,41,784
公投第１５案,臺北市,士林區,德華里,245,1659,354,545,899,65,964
公投第１５案,臺北市,士林區,德華里,246,1749,423,527,950,41,991
公投第１５案,臺北市,士林區,德華里,247,1552,338,495,833,53,886
公投第１５案,臺北市,士林區,忠誠里,248,1529,294,573,867,45,912
公投第１５案,臺北市,士林區,忠誠里,249,1644,289,587,876,39,915
公投第１５案,臺北市,士林區,忠誠里,250,1779,376,584,960,50,1010
公投第１５案,臺北市,士林區,蘭雅里,251,1597,353,522,875,38,913
公投第１５案,臺北市,士林區,蘭雅里,252,1454,326,471,797,40,837
公投第１５案,臺北市,士林區,蘭雅里,253,1582,390,524,914,52,966
公投第１５案,臺北市,士林區,蘭雅里,254,1518,358,495,853,44,897
公投第１５案,臺北市,士林區,蘭雅里,255,1501,318,462,780,19,799
公投第１５案,臺北市,士林區,蘭興里,256,1420,335,487,822,38,860
公投第１５案,臺北市,士林區,蘭興里,257,1494,335,498,833,51,884
公投第１５案,臺北市,士林區,蘭興里,258,1568,398,551,949,37,986
公投第１５案,臺北市,士林區,蘭興里,259,1208,320,410,730,39,769
公投第１５案,臺北市,士林區,三玉里,260,1826,367,615,982,58,1040
公投第１５案,臺北市,士林區,三玉里,261,1647,370,533,903,39,942
公投第１５案,臺北市,士林區,三玉里,262,1654,362,531,893,51,944
公投第１５案,臺北市,士林區,天福里,263,1550,368,532,900,37,937
公投第１５案,臺北市,士林區,天福里,264,1298,365,427,792,27,819
公投第１５案,臺北市,士林區,天福里,265,1297,312,452,764,49,813
公投第１５案,臺北市,士林區,天福里,266,1352,312,408,720,49,769
公投第１５案,臺北市,士林區,天祿里,267,1522,317,520,837,40,877
公投第１５案,臺北市,士林區,天祿里,268,1602,389,463,852,58,910
公投第１５案,臺北市,士林區,天祿里,269,1441,332,472,804,38,842
公投第１５案,臺北市,士林區,天壽里,270,1325,320,390,710,15,725
公投第１５案,臺北市,士林區,天壽里,271,1567,352,506,858,48,906
公投第１５案,臺北市,士林區,天壽里,272,1518,447,375,822,27,849
公投第１５案,臺北市,士林區,天和里,273,1549,357,554,911,36,947
公投第１５案,臺北市,士林區,天和里,274,1652,403,509,912,25,937
公投第１５案,臺北市,士林區,天和里,275,1766,406,599,1005,59,1064
公投第１５案,臺北市,士林區,天和里,276,1638,360,525,885,24,909
公投第１５案,臺北市,士林區,天山里,277,1491,312,556,868,36,904
公投第１５案,臺北市,士林區,天山里,278,1521,336,531,867,24,891
公投第１５案,臺北市,士林區,天山里,279,1351,294,488,782,45,827
公投第１５案,臺北市,士林區,天山里,280,1742,361,546,907,27,934
公投第１５案,臺北市,士林區,天玉里,281,1585,370,477,847,39,886
公投第１５案,臺北市,士林區,天玉里,282,1521,318,545,863,31,894
公投第１５案,臺北市,士林區,天玉里,283,1543,360,484,844,22,866
公投第１５案,臺北市,士林區,天玉里,284,1404,295,513,808,29,837
公投第１５案,臺北市,士林區,天玉里,285,1541,487,358,845,48,893
公投第１５案,臺北市,士林區,天母里,286,1584,323,527,850,30,880
公投第１５案,臺北市,士林區,天母里,287,1519,341,528,869,41,910
公投第１５案,臺北市,士林區,天母里,288,1482,304,458,762,24,786
公投第１５案,臺北市,士林區,天母里,289,1243,271,397,668,40,708
公投第１５案,臺北市,士林區,永福里,290,1156,229,387,616,47,663
公投第１５案,臺北市,士林區,公館里,291,1262,241,366,607,76,683
公投第１５案,臺北市,士林區,新安里,292,889,179,319,498,35,533
公投第１５案,臺北市,士林區,新安里,293,858,205,293,498,29,527
公投第１５案,臺北市,士林區,陽明里,294,945,199,279,478,51,529
公投第１５案,臺北市,士林區,陽明里,295,960,185,303,488,47,535
公投第１５案,臺北市,士林區,陽明里,296,876,161,295,456,39,495
公投第１５案,臺北市,士林區,菁山里,297,556,137,194,331,33,364
公投第１５案,臺北市,士林區,菁山里,298,919,171,347,518,56,574
公投第１５案,臺北市,士林區,平等里,299,1360,309,505,814,88,902
公投第１５案,臺北市,士林區,溪山里,300,1355,274,498,772,61,833
公投第１５案,臺北市,士林區,翠山里,301,1252,273,441,714,26,740
公投第１５案,臺北市,士林區,翠山里,302,1182,276,427,703,37,740
公投第１５案,臺北市,士林區,臨溪里,303,1431,262,412,674,31,705
公投第１５案,臺北市,士林區,臨溪里,304,1240,248,398,646,34,680
公投第１５案,臺北市,內湖區,西湖里,305,1661,323,529,852,18,870
公投第１５案,臺北市,內湖區,西湖里,306,1602,342,499,841,52,893
公投第１５案,臺北市,內湖區,西湖里,307,1655,342,596,938,71,1009
公投第１５案,臺北市,內湖區,西湖里,308,1582,387,542,929,31,960
公投第１５案,臺北市,內湖區,西康里,309,1688,383,532,915,24,939
公投第１５案,臺北市,內湖區,西康里,310,1737,423,534,957,52,1009
公投第１５案,臺北市,內湖區,西康里,311,1809,429,594,1023,44,1067
公投第１５案,臺北市,內湖區,西康里,312,1376,288,477,765,22,787
公投第１５案,臺北市,內湖區,西康里,313,1747,357,635,992,67,1059
公投第１５案,臺北市,內湖區,西安里,314,1389,310,512,822,23,845
公投第１５案,臺北市,內湖區,西安里,315,1454,380,501,881,31,912
公投第１５案,臺北市,內湖區,西安里,316,1468,365,536,901,34,935
公投第１５案,臺北市,內湖區,西安里,317,1603,375,595,970,39,1009
公投第１５案,臺北市,內湖區,港墘里,318,1795,373,603,976,28,1004
公投第１５案,臺北市,內湖區,港墘里,319,1737,432,618,1050,39,1089
公投第１５案,臺北市,內湖區,港墘里,320,1744,394,609,1003,50,1053
公投第１５案,臺北市,內湖區,港都里,321,1661,355,570,925,41,966
公投第１５案,臺北市,內湖區,港都里,322,1577,382,507,889,31,920
公投第１５案,臺北市,內湖區,港都里,323,1494,365,547,912,26,938
公投第１５案,臺北市,內湖區,港富里,324,1626,332,603,935,33,968
公投第１５案,臺北市,內湖區,港富里,325,1641,328,596,924,55,979
公投第１５案,臺北市,內湖區,港富里,326,1554,357,532,889,30,919
公投第１５案,臺北市,內湖區,港富里,327,1728,412,582,994,59,1053
公投第１５案,臺北市,內湖區,港富里,328,1736,355,600,955,41,996
公投第１５案,臺北市,內湖區,港華里,329,1461,344,555,899,39,938
公投第１５案,臺北市,內湖區,港華里,330,1509,319,564,883,22,905
公投第１５案,臺北市,內湖區,港華里,331,1358,319,438,757,24,781
公投第１５案,臺北市,內湖區,港華里,332,1761,393,593,986,31,1017
公投第１５案,臺北市,內湖區,港華里,333,1651,384,550,934,33,967
公投第１５案,臺北市,內湖區,內湖里,334,1809,396,636,1032,53,1085
公投第１５案,臺北市,內湖區,內湖里,335,1773,384,611,995,42,1037
公投第１５案,臺北市,內湖區,內湖里,336,1890,289,612,901,29,930
公投第１５案,臺北市,內湖區,湖濱里,337,1760,436,640,1076,43,1119
公投第１５案,臺北市,內湖區,湖濱里,338,1645,345,594,939,37,976
公投第１５案,臺北市,內湖區,湖濱里,339,1324,321,472,793,22,815
公投第１５案,臺北市,內湖區,湖濱里,340,1072,213,428,641,27,668
公投第１５案,臺北市,內湖區,湖濱里,341,1509,309,523,832,29,861
公投第１５案,臺北市,內湖區,紫星里,342,1715,374,566,940,68,1008
公投第１５案,臺北市,內湖區,紫星里,343,1774,280,738,1018,32,1050
公投第１５案,臺北市,內湖區,紫星里,344,1796,422,699,1121,32,1153
公投第１５案,臺北市,內湖區,紫星里,345,1784,356,629,985,31,1016
公投第１５案,臺北市,內湖區,大湖里,346,1417,344,489,833,50,883
公投第１５案,臺北市,內湖區,大湖里,347,1699,435,524,959,21,980
公投第１５案,臺北市,內湖區,大湖里,348,1719,448,599,1047,34,1081
公投第１５案,臺北市,內湖區,金龍里,349,1715,400,576,976,38,1014
公投第１５案,臺北市,內湖區,金龍里,350,1634,347,496,843,23,866
公投第１５案,臺北市,內湖區,金龍里,351,1435,276,493,769,43,812
公投第１５案,臺北市,內湖區,金瑞里,352,1440,324,483,807,30,837
公投第１５案,臺北市,內湖區,金瑞里,353,1446,355,520,875,24,899
公投第１５案,臺北市,內湖區,金瑞里,354,1657,346,515,861,43,904
公投第１５案,臺北市,內湖區,金瑞里,355,1261,281,450,731,52,783
公投第１５案,臺北市,內湖區,碧山里,356,456,83,128,211,27,238
公投第１５案,臺北市,內湖區,碧山里,357,1433,367,555,922,23,945
公投第１５案,臺北市,內湖區,碧山里,358,1485,333,533,866,25,891
公投第１５案,臺北市,內湖區,碧山里,359,1590,362,516,878,31,909
公投第１５案,臺北市,內湖區,碧山里,360,1219,293,448,741,51,792
公投第１５案,臺北市,內湖區,紫雲里,361,1732,326,600,926,49,975
公投第１５案,臺北市,內湖區,紫雲里,362,1727,367,627,994,32,1026
公投第１５案,臺北市,內湖區,紫雲里,363,1637,330,597,927,45,972
公投第１５案,臺北市,內湖區,清白里,364,1453,307,494,801,31,832
公投第１５案,臺北市,內湖區,清白里,365,1617,331,558,889,28,917
公投第１５案,臺北市,內湖區,清白里,366,1604,356,525,881,30,911
公投第１５案,臺北市,內湖區,清白里,367,1406,362,513,875,22,897
公投第１５案,臺北市,內湖區,清白里,368,1353,345,455,800,31,831
公投第１５案,臺北市,內湖區,葫洲里,369,1724,641,376,1017,32,1049
公投第１５案,臺北市,內湖區,葫洲里,370,1378,322,484,806,29,835
公投第１５案,臺北市,內湖區,葫洲里,371,1403,327,512,839,22,861
公投第１５案,臺北市,內湖區,葫洲里,372,1547,321,527,848,30,878
公投第１５案,臺北市,內湖區,紫陽里,373,1718,410,590,1000,38,1038
公投第１５案,臺北市,內湖區,紫陽里,374,1813,406,593,999,44,1043
公投第１５案,臺北市,內湖區,紫陽里,375,1791,404,676,1080,46,1126
公投第１５案,臺北市,內湖區,紫陽里,376,1855,435,663,1098,39,1137
公投第１５案,臺北市,內湖區,瑞陽里,377,1731,356,635,991,23,1014
公投第１５案,臺北市,內湖區,瑞陽里,378,1593,412,569,981,42,1023
公投第１５案,臺北市,內湖區,瑞陽里,379,1869,347,659,1006,42,1048
公投第１５案,臺北市,內湖區,瑞陽里,380,1687,388,587,975,46,1021
公投第１５案,臺北市,內湖區,瑞光里,381,1530,359,542,901,15,916
公投第１５案,臺北市,內湖區,瑞光里,382,1300,283,477,760,43,803
公投第１５案,臺北市,內湖區,瑞光里,383,1314,254,554,808,37,845
公投第１５案,臺北市,內湖區,五分里,384,1433,309,430,739,19,758
公投第１５案,臺北市,內湖區,五分里,385,1450,317,455,772,25,797
公投第１５案,臺北市,內湖區,五分里,386,1608,344,529,873,49,922
公投第１５案,臺北市,內湖區,五分里,387,1414,336,477,813,32,845
公投第１５案,臺北市,內湖區,五分里,388,1492,359,103,462,23,485
公投第１５案,臺北市,內湖區,五分里,389,1528,305,498,803,25,828
公投第１５案,臺北市,內湖區,東湖里,390,1692,365,586,951,30,981
公投第１５案,臺北市,內湖區,東湖里,391,1556,356,523,879,39,918
公投第１５案,臺北市,內湖區,東湖里,392,1637,343,542,885,31,916
公投第１５案,臺北市,內湖區,東湖里,393,1749,403,532,935,30,965
公投第１５案,臺北市,內湖區,樂康里,394,1220,238,419,657,28,685
公投第１５案,臺北市,內湖區,樂康里,395,1600,330,543,873,51,924
公投第１５案,臺北市,內湖區,樂康里,396,1473,325,489,814,40,854
公投第１５案,臺北市,內湖區,樂康里,397,1498,328,478,806,51,857
公投第１５案,臺北市,內湖區,樂康里,398,1557,341,523,864,34,898
公投第１５案,臺北市,內湖區,內溝里,399,1674,337,534,871,28,899
公投第１５案,臺北市,內湖區,內溝里,400,1728,387,622,1009,33,1042
公投第１５案,臺北市,內湖區,內溝里,401,788,129,224,353,55,408
公投第１５案,臺北市,內湖區,週美里,402,1542,339,487,826,46,872
公投第１５案,臺北市,內湖區,週美里,403,1676,343,453,796,55,851
公投第１５案,臺北市,內湖區,週美里,404,1360,276,419,695,37,732
公投第１５案,臺北市,內湖區,週美里,405,1259,280,508,788,16,804
公投第１５案,臺北市,內湖區,週美里,406,1301,248,465,713,10,723
公投第１５案,臺北市,內湖區,行善里,407,1251,244,370,614,29,643
公投第１５案,臺北市,內湖區,行善里,408,1502,321,483,804,56,860
公投第１５案,臺北市,內湖區,行善里,409,1596,307,561,868,35,903
公投第１５案,臺北市,內湖區,行善里,410,1649,366,563,929,19,948
公投第１５案,臺北市,內湖區,石潭里,411,1774,375,569,944,37,981
公投第１５案,臺北市,內湖區,石潭里,412,1746,351,586,937,24,961
公投第１５案,臺北市,內湖區,湖興里,413,1473,301,506,807,23,830
公投第１５案,臺北市,內湖區,湖興里,414,2824,374,558,932,37,969
公投第１５案,臺北市,內湖區,湖興里,415,1849,409,523,932,31,963
公投第１５案,臺北市,內湖區,湖興里,416,1530,318,489,807,59,866
公投第１５案,臺北市,內湖區,湖元里,417,1656,372,537,909,40,949
公投第１５案,臺北市,內湖區,湖元里,418,1457,353,481,834,30,864
公投第１５案,臺北市,內湖區,湖元里,419,1695,351,632,983,36,1019
公投第１５案,臺北市,內湖區,安湖里,420,1663,382,577,959,27,986
公投第１５案,臺北市,內湖區,安湖里,421,1654,339,572,911,37,948
公投第１５案,臺北市,內湖區,安湖里,422,1642,394,556,950,36,986
公投第１５案,臺北市,內湖區,安湖里,423,1685,398,557,955,25,980
公投第１５案,臺北市,內湖區,秀湖里,424,1862,371,632,1003,46,1049
公投第１５案,臺北市,內湖區,秀湖里,425,1900,454,646,1100,40,1140
公投第１５案,臺北市,內湖區,秀湖里,426,1790,395,705,1100,46,1146
公投第１５案,臺北市,內湖區,安泰里,427,1417,304,473,777,41,818
公投第１５案,臺北市,內湖區,安泰里,428,1694,347,587,934,36,970
公投第１５案,臺北市,內湖區,安泰里,429,1676,307,555,862,59,921
公投第１５案,臺北市,內湖區,金湖里,430,1643,388,532,920,15,935
公投第１５案,臺北市,內湖區,金湖里,431,1588,364,540,904,36,940
公投第１５案,臺北市,內湖區,金湖里,432,1603,365,539,904,53,957
公投第１５案,臺北市,內湖區,金湖里,433,1629,371,550,921,31,952
公投第１５案,臺北市,內湖區,金湖里,434,1646,395,584,979,39,1018
公投第１５案,臺北市,內湖區,康寧里,435,1883,369,645,1014,30,1044
公投第１５案,臺北市,內湖區,康寧里,436,1434,318,494,812,27,839
公投第１５案,臺北市,內湖區,康寧里,437,1418,312,486,798,18,816
公投第１５案,臺北市,內湖區,康寧里,438,1373,296,488,784,40,824
公投第１５案,臺北市,內湖區,康寧里,439,1349,307,471,778,39,817
公投第１５案,臺北市,內湖區,明湖里,440,1511,341,555,896,36,932
公投第１５案,臺北市,內湖區,明湖里,441,1563,382,566,948,28,976
公投第１５案,臺北市,內湖區,明湖里,442,1550,345,523,868,31,899
公投第１５案,臺北市,內湖區,蘆洲里,443,1157,266,349,615,39,654
公投第１５案,臺北市,內湖區,麗山里,444,1768,429,576,1005,32,1037
公投第１５案,臺北市,內湖區,麗山里,445,1664,362,571,933,46,979
公投第１５案,臺北市,內湖區,麗山里,446,1743,422,560,982,46,1028
公投第１５案,臺北市,內湖區,寶湖里,447,1480,333,530,863,20,883
公投第１５案,臺北市,內湖區,寶湖里,448,1589,398,541,939,43,982
公投第１５案,臺北市,內湖區,寶湖里,449,1371,299,459,758,27,785
公投第１５案,臺北市,內湖區,寶湖里,450,1575,376,586,962,18,980
公投第１５案,臺北市,內湖區,寶湖里,451,1377,329,464,793,18,811
公投第１５案,臺北市,內湖區,南湖里,452,1469,402,524,926,44,970
公投第１５案,臺北市,內湖區,南湖里,453,1529,388,564,952,15,967
公投第１５案,臺北市,內湖區,南湖里,454,1649,434,547,981,30,1011
公投第１５案,臺北市,南港區,南港里,455,1280,254,420,674,24,698
公投第１５案,臺北市,南港區,南港里,456,1351,292,460,752,22,774
公投第１５案,臺北市,南港區,南港里,457,1345,300,450,750,42,792
公投第１５案,臺北市,南港區,南港里,458,1679,292,435,727,28,755
公投第１５案,臺北市,南港區,中南里,459,1680,357,510,867,36,903
公投第１５案,臺北市,南港區,中南里,460,1635,320,489,809,49,858
公投第１５案,臺北市,南港區,三重里,461,1459,277,495,772,43,815
公投第１５案,臺北市,南港區,三重里,462,1706,384,573,957,21,978
公投第１５案,臺北市,南港區,三重里,463,1674,305,546,851,47,898
公投第１５案,臺北市,南港區,三重里,464,1491,333,493,826,10,836
公投第１５案,臺北市,南港區,新富里,465,1086,256,420,676,24,700
公投第１５案,臺北市,南港區,新富里,466,1202,292,438,730,46,776
公投第１５案,臺北市,南港區,新富里,467,1198,293,388,681,39,720
公投第１５案,臺北市,南港區,中研里,468,1430,330,428,758,23,781
公投第１５案,臺北市,南港區,中研里,469,1275,334,413,747,39,786
公投第１５案,臺北市,南港區,中研里,470,1344,390,436,826,44,870
公投第１５案,臺北市,南港區,中研里,471,1391,373,435,808,31,839
公投第１５案,臺北市,南港區,中研里,472,1342,363,441,804,19,823
公投第１５案,臺北市,南港區,中研里,473,1389,315,416,731,31,762
公投第１５案,臺北市,南港區,九如里,474,1426,354,483,837,34,871
公投第１５案,臺北市,南港區,九如里,475,1359,237,547,784,29,813
公投第１５案,臺北市,南港區,九如里,476,1366,261,484,745,47,792
公投第１５案,臺北市,南港區,九如里,477,1441,324,511,835,19,854
公投第１５案,臺北市,南港區,舊莊里,478,1529,298,496,794,49,843
公投第１５案,臺北市,南港區,舊莊里,479,1618,344,481,825,39,864
公投第１５案,臺北市,南港區,舊莊里,480,1545,281,427,708,52,760
公投第１５案,臺北市,南港區,舊莊里,481,1569,312,557,869,35,904
公投第１５案,臺北市,南港區,舊莊里,482,1661,340,463,803,40,843
公投第１５案,臺北市,南港區,東新里,483,1518,323,434,757,47,804
公投第１５案,臺北市,南港區,東新里,484,1552,370,560,930,38,968
公投第１５案,臺北市,南港區,東新里,485,1658,332,555,887,23,910
公投第１５案,臺北市,南港區,東新里,486,1608,335,546,881,58,939
公投第１５案,臺北市,南港區,重陽里,487,1475,302,479,781,31,812
公投第１５案,臺北市,南港區,重陽里,488,1722,416,581,997,32,1029
公投第１５案,臺北市,南港區,重陽里,489,1383,336,542,878,21,899
公投第１５案,臺北市,南港區,東明里,490,1397,297,485,782,39,821
公投第１５案,臺北市,南港區,東明里,491,1352,276,503,779,43,822
公投第１５案,臺北市,南港區,東明里,492,1344,294,487,781,31,812
公投第１５案,臺北市,南港區,西新里,493,1385,314,424,738,22,760
公投第１５案,臺北市,南港區,西新里,494,1399,291,461,752,48,800
公投第１５案,臺北市,南港區,西新里,495,1381,306,430,736,28,764
公投第１５案,臺北市,南港區,玉成里,496,1548,312,513,825,36,861
公投第１５案,臺北市,南港區,玉成里,497,1190,268,384,652,19,671
公投第１５案,臺北市,南港區,玉成里,498,1490,357,492,849,29,878
公投第１５案,臺北市,南港區,合成里,499,1096,257,390,647,25,672
公投第１５案,臺北市,南港區,合成里,500,1238,289,459,748,29,777
公投第１５案,臺北市,南港區,合成里,501,1271,296,468,764,25,789
公投第１５案,臺北市,南港區,合成里,502,1146,227,400,627,41,668
公投第１５案,臺北市,南港區,合成里,503,1232,266,413,679,32,711
公投第１５案,臺北市,南港區,新光里,504,1649,322,483,805,28,833
公投第１５案,臺北市,南港區,新光里,505,1688,347,617,964,32,996
公投第１５案,臺北市,南港區,聯成里,506,1503,325,549,874,32,906
公投第１５案,臺北市,南港區,聯成里,507,1542,243,622,865,28,893
公投第１５案,臺北市,南港區,聯成里,508,1463,287,536,823,42,865
公投第１５案,臺北市,南港區,萬福里,509,1195,273,433,706,57,763
公投第１５案,臺北市,南港區,萬福里,510,1254,306,436,742,11,753
公投第１５案,臺北市,南港區,萬福里,511,1356,280,497,777,28,805
公投第１５案,臺北市,南港區,鴻福里,512,1363,295,460,755,78,833
公投第１５案,臺北市,南港區,鴻福里,513,1317,311,488,799,36,835
公投第１５案,臺北市,南港區,鴻福里,514,1331,316,452,768,22,790
公投第１５案,臺北市,南港區,百福里,515,1610,339,548,887,48,935
公投第１５案,臺北市,南港區,百福里,516,1542,318,520,838,25,863
公投第１５案,臺北市,南港區,百福里,517,1581,329,568,897,45,942
公投第１５案,臺北市,南港區,成福里,518,1225,269,479,748,27,775
公投第１５案,臺北市,南港區,成福里,519,1264,313,442,755,54,809
公投第１５案,臺北市,南港區,成福里,520,1649,384,576,960,61,1021
公投第１５案,臺北市,南港區,成福里,521,1267,299,440,739,25,764
公投第１５案,臺北市,南港區,成福里,522,1336,276,491,767,21,788
公投第１５案,臺北市,南港區,仁福里,523,1162,264,443,707,24,731
公投第１５案,臺北市,南港區,仁福里,524,1045,240,368,608,22,630
公投第１５案,臺北市,南港區,仁福里,525,1351,417,439,856,42,898
公投第１５案,臺北市,南港區,仁福里,526,1358,284,489,773,32,805
公投第１５案,臺北市,松山區,莊敬里,527,1583,491,421,912,42,954
公投第１５案,臺北市,松山區,莊敬里,528,1691,369,566,935,46,981
公投第１５案,臺北市,松山區,莊敬里,529,1386,239,507,746,46,792
公投第１５案,臺北市,松山區,東榮里,530,1362,299,475,774,50,824
公投第１５案,臺北市,松山區,東榮里,531,1399,318,485,803,42,845
公投第１５案,臺北市,松山區,東榮里,532,1324,312,463,775,40,815
公投第１５案,臺北市,松山區,東榮里,533,1296,317,476,793,38,831
公投第１５案,臺北市,松山區,東榮里,534,1386,316,508,824,31,855
公投第１５案,臺北市,松山區,三民里,535,1529,245,669,914,62,976
公投第１５案,臺北市,松山區,三民里,536,1416,295,495,790,36,826
公投第１５案,臺北市,松山區,三民里,537,1619,358,503,861,43,904
公投第１５案,臺北市,松山區,三民里,538,1386,357,453,810,30,840
公投第１５案,臺北市,松山區,新益里,539,1380,374,489,863,28,891
公投第１５案,臺北市,松山區,新益里,540,1357,310,472,782,40,822
公投第１５案,臺北市,松山區,新益里,541,1296,299,486,785,28,813
公投第１５案,臺北市,松山區,富錦里,542,1632,368,558,926,57,983
公投第１５案,臺北市,松山區,富錦里,543,1414,315,477,792,39,831
公投第１５案,臺北市,松山區,富錦里,544,1404,315,518,833,24,857
公投第１５案,臺北市,松山區,新東里,545,1365,266,527,793,58,851
公投第１５案,臺北市,松山區,新東里,546,1431,313,502,815,49,864
公投第１５案,臺北市,松山區,新東里,547,1483,345,530,875,32,907
公投第１５案,臺北市,松山區,富泰里,548,1293,309,463,772,43,815
公投第１５案,臺北市,松山區,富泰里,549,1410,306,469,775,32,807
公投第１５案,臺北市,松山區,富泰里,550,1307,269,489,758,35,793
公投第１５案,臺北市,松山區,介壽里,551,1242,304,455,759,32,791
公投第１５案,臺北市,松山區,介壽里,552,1192,272,446,718,20,738
公投第１５案,臺北市,松山區,介壽里,553,1276,276,494,770,36,806
公投第１５案,臺北市,松山區,精忠里,554,1201,151,545,696,16,712
公投第１５案,臺北市,松山區,精忠里,555,1318,289,479,768,31,799
公投第１５案,臺北市,松山區,精忠里,556,1157,300,400,700,27,727
公投第１５案,臺北市,松山區,東光里,557,1157,248,404,652,20,672
公投第１５案,臺北市,松山區,東光里,558,1357,303,507,810,30,840
公投第１５案,臺北市,松山區,東光里,559,1215,249,381,630,28,658
公投第１５案,臺北市,松山區,東光里,560,1345,279,470,749,35,784
公投第１５案,臺北市,松山區,東光里,561,1237,272,425,697,52,749
公投第１５案,臺北市,松山區,龍田里,562,1393,257,585,842,33,875
公投第１５案,臺北市,松山區,龍田里,563,1331,355,470,825,39,864
公投第１５案,臺北市,松山區,龍田里,564,1550,377,560,937,42,979
公投第１５案,臺北市,松山區,龍田里,565,1308,202,522,724,15,739
公投第１５案,臺北市,松山區,龍田里,566,1490,266,576,842,34,876
公投第１５案,臺北市,松山區,龍田里,567,1406,313,554,867,27,894
公投第１５案,臺北市,松山區,東昌里,568,1191,307,434,741,24,765
公投第１５案,臺北市,松山區,東昌里,569,1095,246,386,632,35,667
公投第１５案,臺北市,松山區,東勢里,570,1198,240,440,680,48,728
公投第１５案,臺北市,松山區,東勢里,571,1265,268,447,715,37,752
公投第１５案,臺北市,松山區,東勢里,572,1225,268,424,692,29,721
公投第１５案,臺北市,松山區,中華里,573,1698,387,611,998,55,1053
公投第１５案,臺北市,松山區,中華里,574,1819,316,671,987,30,1017
公投第１５案,臺北市,松山區,中華里,575,1754,400,607,1007,50,1057
公投第１５案,臺北市,松山區,民有里,576,1361,348,462,810,39,849
公投第１５案,臺北市,松山區,民有里,577,1189,278,444,722,23,745
公投第１５案,臺北市,松山區,民有里,578,1214,286,428,714,33,747
公投第１５案,臺北市,松山區,民有里,579,1284,317,424,741,31,772
公投第１５案,臺北市,松山區,民有里,580,1297,300,467,767,44,811
公投第１５案,臺北市,松山區,民有里,581,1330,302,458,760,30,790
公投第１５案,臺北市,松山區,民福里,582,1396,309,508,817,44,861
公投第１５案,臺北市,松山區,民福里,583,1480,276,543,819,27,846
公投第１５案,臺北市,松山區,民福里,584,1419,317,511,828,34,862
公投第１５案,臺北市,松山區,民福里,585,1390,314,492,806,42,848
公投第１５案,臺北市,松山區,松基里,586,1525,370,516,886,34,920
公投第１５案,臺北市,松山區,松基里,587,1633,348,510,858,46,904
公投第１５案,臺北市,松山區,慈祐里,588,2677,354,520,874,24,898
公投第１５案,臺北市,松山區,慈祐里,589,1281,316,415,731,49,780
公投第１５案,臺北市,松山區,慈祐里,590,1469,281,396,677,40,717
公投第１５案,臺北市,松山區,慈祐里,591,1700,455,467,922,63,985
公投第１５案,臺北市,松山區,安平里,592,1503,333,458,791,37,828
公投第１５案,臺北市,松山區,安平里,593,1309,317,413,730,33,763
公投第１５案,臺北市,松山區,安平里,594,1376,290,493,783,53,836
公投第１５案,臺北市,松山區,安平里,595,1654,356,584,940,27,967
公投第１５案,臺北市,松山區,安平里,596,1601,346,510,856,56,912
公投第１５案,臺北市,松山區,鵬程里,597,1496,331,529,860,25,885
公投第１５案,臺北市,松山區,鵬程里,598,1598,375,582,957,57,1014
公投第１５案,臺北市,松山區,鵬程里,599,1751,409,612,1021,39,1060
公投第１５案,臺北市,松山區,自強里,600,1557,324,606,930,40,970
公投第１５案,臺北市,松山區,自強里,601,1686,361,718,1079,27,1106
公投第１５案,臺北市,松山區,自強里,602,1707,267,743,1010,39,1049
公投第１５案,臺北市,松山區,自強里,603,1854,385,775,1160,36,1196
公投第１５案,臺北市,松山區,自強里,604,1740,366,597,963,33,996
公投第１５案,臺北市,松山區,吉祥里,605,1494,324,518,842,49,891
公投第１５案,臺北市,松山區,吉祥里,606,1453,328,508,836,41,877
公投第１５案,臺北市,松山區,吉祥里,607,1458,331,506,837,38,875
公投第１５案,臺北市,松山區,吉祥里,608,1536,378,487,865,35,900
公投第１５案,臺北市,松山區,吉祥里,609,1463,317,532,849,27,876
公投第１５案,臺北市,松山區,新聚里,610,1790,378,554,932,27,959
公投第１５案,臺北市,松山區,新聚里,611,1679,392,575,967,48,1015
公投第１５案,臺北市,松山區,新聚里,612,1785,337,554,891,43,934
公投第１５案,臺北市,松山區,新聚里,613,1793,391,581,972,46,1018
公投第１５案,臺北市,松山區,復盛里,614,1381,284,497,781,42,823
公投第１５案,臺北市,松山區,復盛里,615,1279,297,452,749,26,775
公投第１５案,臺北市,松山區,復盛里,616,1681,367,579,946,63,1009
公投第１５案,臺北市,松山區,復盛里,617,1232,305,437,742,37,779
公投第１５案,臺北市,松山區,中正里,618,1533,347,511,858,33,891
公投第１５案,臺北市,松山區,中正里,619,1540,365,547,912,38,950
公投第１５案,臺北市,松山區,中正里,620,1716,377,570,947,33,980
公投第１５案,臺北市,松山區,中正里,621,1664,375,517,892,30,922
公投第１５案,臺北市,松山區,中正里,622,1350,282,474,756,23,779
公投第１５案,臺北市,松山區,中崙里,623,1837,381,626,1007,37,1044
公投第１５案,臺北市,松山區,中崙里,624,1558,334,468,802,53,855
公投第１５案,臺北市,松山區,美仁里,625,1420,319,517,836,43,879
公投第１５案,臺北市,松山區,美仁里,626,1474,294,517,811,38,849
公投第１５案,臺北市,松山區,吉仁里,627,1591,326,529,855,58,913
公投第１５案,臺北市,松山區,吉仁里,628,1726,345,629,974,36,1010
公投第１５案,臺北市,松山區,敦化里,629,1452,349,465,814,23,837
公投第１５案,臺北市,松山區,敦化里,630,1482,338,481,819,29,848
公投第１５案,臺北市,松山區,敦化里,631,1460,329,512,841,31,872
公投第１５案,臺北市,松山區,敦化里,632,1398,464,297,761,48,809
公投第１５案,臺北市,松山區,復源里,633,1423,327,505,832,37,869
公投第１５案,臺北市,松山區,復源里,634,1226,261,454,715,23,738
公投第１５案,臺北市,松山區,復建里,635,1158,251,424,675,31,706
公投第１５案,臺北市,松山區,復建里,636,1426,332,460,792,32,824
公投第１５案,臺北市,松山區,復建里,637,1177,254,426,680,20,700
公投第１５案,臺北市,松山區,復勢里,638,1363,320,434,754,38,792
公投第１５案,臺北市,松山區,復勢里,639,1240,260,467,727,43,770
公投第１５案,臺北市,松山區,復勢里,640,1375,314,501,815,36,851
公投第１５案,臺北市,松山區,復勢里,641,1377,335,459,794,28,822
公投第１５案,臺北市,松山區,福成里,642,1225,251,412,663,26,689
公投第１５案,臺北市,松山區,福成里,643,1017,258,372,630,23,653
公投第１５案,臺北市,信義區,西村里,644,2476,281,492,773,32,805
公投第１５案,臺北市,信義區,西村里,645,1381,265,601,866,16,882
公投第１５案,臺北市,信義區,西村里,646,1294,275,505,780,37,817
公投第１５案,臺北市,信義區,正和里,647,1351,288,471,759,43,802
公投第１５案,臺北市,信義區,正和里,648,1296,267,486,753,23,776
公投第１５案,臺北市,信義區,正和里,649,1302,284,499,783,34,817
公投第１５案,臺北市,信義區,興隆里,650,1025,188,345,533,53,586
公投第１５案,臺北市,信義區,興隆里,651,1421,297,463,760,23,783
公投第１５案,臺北市,信義區,中興里,652,1501,315,505,820,36,856
公投第１５案,臺北市,信義區,中興里,653,1575,326,477,803,27,830
公投第１５案,臺北市,信義區,新仁里,654,1516,329,523,852,28,880
公投第１５案,臺北市,信義區,新仁里,655,1382,327,484,811,28,839
公投第１５案,臺北市,信義區,興雅里,656,1128,235,389,624,37,661
公投第１５案,臺北市,信義區,興雅里,657,1397,275,479,754,46,800
公投第１５案,臺北市,信義區,興雅里,658,1161,270,417,687,40,727
公投第１５案,臺北市,信義區,興雅里,659,1368,308,470,778,33,811
公投第１５案,臺北市,信義區,敦厚里,660,1049,233,384,617,15,632
公投第１５案,臺北市,信義區,敦厚里,661,1308,275,467,742,39,781
公投第１５案,臺北市,信義區,敦厚里,662,1154,281,412,693,38,731
公投第１５案,臺北市,信義區,敦厚里,663,1078,293,349,642,19,661
公投第１５案,臺北市,信義區,廣居里,664,1375,299,479,778,36,814
公投第１５案,臺北市,信義區,廣居里,665,1448,272,556,828,35,863
公投第１５案,臺北市,信義區,廣居里,666,1250,287,458,745,16,761
公投第１５案,臺北市,信義區,廣居里,667,1381,330,474,804,21,825
公投第１５案,臺北市,信義區,廣居里,668,1213,271,441,712,37,749
公投第１５案,臺北市,信義區,安康里,669,1373,304,547,851,34,885
公投第１５案,臺北市,信義區,安康里,670,1226,264,461,725,29,754
公投第１５案,臺北市,信義區,安康里,671,1117,259,403,662,16,678
公投第１５案,臺北市,信義區,安康里,672,1123,257,412,669,35,704
公投第１５案,臺北市,信義區,安康里,673,1200,243,457,700,27,727
公投第１５案,臺北市,信義區,安康里,674,1335,259,430,689,23,712
公投第１５案,臺北市,信義區,安康里,675,1332,251,463,714,21,735
公投第１５案,臺北市,信義區,六藝里,676,1648,33,593,626,57,683
公投第１５案,臺北市,信義區,六藝里,677,1542,316,508,824,65,889
公投第１５案,臺北市,信義區,雅祥里,678,1228,272,401,673,62,735
公投第１５案,臺北市,信義區,雅祥里,679,1731,371,591,962,36,998
公投第１５案,臺北市,信義區,雅祥里,680,1403,319,490,809,33,842
公投第１５案,臺北市,信義區,五常里,681,1929,371,643,1014,60,1074
公投第１５案,臺北市,信義區,五常里,682,1300,302,461,763,36,799
公投第１５案,臺北市,信義區,五全里,683,1486,306,465,771,23,794
公投第１５案,臺北市,信義區,五全里,684,1532,308,437,745,42,787
公投第１５案,臺北市,信義區,五全里,685,1387,273,552,825,45,870
公投第１５案,臺北市,信義區,永吉里,686,1195,223,393,616,44,660
公投第１５案,臺北市,信義區,永吉里,687,1068,228,339,567,39,606
公投第１５案,臺北市,信義區,永吉里,688,1273,250,411,661,35,696
公投第１５案,臺北市,信義區,長春里,689,1329,319,478,797,44,841
公投第１５案,臺北市,信義區,長春里,690,1311,285,414,699,40,739
公投第１５案,臺北市,信義區,長春里,691,1258,252,410,662,44,706
公投第１５案,臺北市,信義區,四育里,692,1277,311,407,718,56,774
公投第１５案,臺北市,信義區,四育里,693,1285,292,471,763,53,816
公投第１５案,臺北市,信義區,四育里,694,1161,284,421,705,38,743
公投第１５案,臺北市,信義區,四育里,695,1299,313,396,709,39,748
公投第１５案,臺北市,信義區,四維里,696,1243,253,429,682,36,718
公投第１５案,臺北市,信義區,四維里,697,1197,257,408,665,24,689
公投第１５案,臺北市,信義區,四維里,698,1224,310,452,762,23,785
公投第１５案,臺北市,信義區,四維里,699,1147,239,390,629,25,654
公投第１５案,臺北市,信義區,永春里,700,1045,256,359,615,13,628
公投第１５案,臺北市,信義區,永春里,701,1096,235,425,660,29,689
公投第１５案,臺北市,信義區,永春里,702,1115,256,369,625,17,642
公投第１５案,臺北市,信義區,永春里,703,1117,228,382,610,38,648
公投第１５案,臺北市,信義區,富台里,704,1019,233,285,518,21,539
公投第１５案,臺北市,信義區,富台里,705,1346,283,473,756,42,798
公投第１５案,臺北市,信義區,富台里,706,1405,298,488,786,21,807
公投第１５案,臺北市,信義區,國業里,707,1356,288,479,767,34,801
公投第１５案,臺北市,信義區,國業里,708,1250,299,483,782,26,808
公投第１５案,臺北市,信義區,國業里,709,1254,484,261,745,31,776
公投第１５案,臺北市,信義區,國業里,710,1317,304,439,743,24,767
公投第１５案,臺北市,信義區,國業里,711,1271,285,483,768,45,813
公投第１５案,臺北市,信義區,松隆里,712,979,203,324,527,33,560
公投第１５案,臺北市,信義區,松隆里,713,1025,208,332,540,35,575
公投第１５案,臺北市,信義區,松友里,714,1512,296,452,748,23,771
公投第１５案,臺北市,信義區,松友里,715,1483,348,511,859,32,891
公投第１５案,臺北市,信義區,松友里,716,1359,321,489,810,26,836
公投第１５案,臺北市,信義區,松友里,717,1387,302,534,836,14,850
公投第１５案,臺北市,信義區,松光里,718,1455,306,486,792,24,816
公投第１５案,臺北市,信義區,松光里,719,1461,330,498,828,26,854
公投第１５案,臺北市,信義區,松光里,720,1532,335,538,873,42,915
公投第１５案,臺北市,信義區,中坡里,721,1043,274,362,636,36,672
公投第１５案,臺北市,信義區,中坡里,722,875,206,317,523,32,555
公投第１５案,臺北市,信義區,中坡里,723,927,198,322,520,17,537
公投第１５案,臺北市,信義區,中坡里,724,1119,247,392,639,48,687
公投第１５案,臺北市,信義區,中行里,725,1463,307,495,802,52,854
公投第１５案,臺北市,信義區,中行里,726,1293,325,464,789,43,832
公投第１５案,臺北市,信義區,中行里,727,1553,327,514,841,43,884
公投第１５案,臺北市,信義區,中行里,728,1360,321,423,744,25,769
公投第１５案,臺北市,信義區,中行里,729,1392,329,466,795,38,833
公投第１５案,臺北市,信義區,大道里,730,1377,293,503,796,14,810
公投第１５案,臺北市,信義區,大道里,731,1377,329,461,790,18,808
公投第１５案,臺北市,信義區,大道里,732,1269,246,407,653,30,683
公投第１５案,臺北市,信義區,大道里,733,1407,277,511,788,65,853
公投第１５案,臺北市,信義區,大仁里,734,1172,248,404,652,40,692
公投第１５案,臺北市,信義區,大仁里,735,1182,246,429,675,25,700
公投第１５案,臺北市,信義區,大仁里,736,1255,273,445,718,39,757
公投第１５案,臺北市,信義區,景新里,737,1689,333,547,880,32,912
公投第１５案,臺北市,信義區,景新里,738,1605,318,547,865,23,888
公投第１５案,臺北市,信義區,景新里,739,1143,187,444,631,25,656
公投第１５案,臺北市,信義區,惠安里,740,1440,289,457,746,35,781
公投第１５案,臺北市,信義區,惠安里,741,1495,294,524,818,41,859
公投第１５案,臺北市,信義區,惠安里,742,1514,280,585,865,50,915
公投第１５案,臺北市,信義區,惠安里,743,1449,286,495,781,33,814
公投第１５案,臺北市,信義區,三張里,744,1401,311,502,813,45,858
公投第１５案,臺北市,信義區,三張里,745,1181,249,393,642,16,658
公投第１５案,臺北市,信義區,三張里,746,1376,317,539,856,15,871
公投第１５案,臺北市,信義區,三張里,747,1422,269,562,831,44,875
公投第１５案,臺北市,信義區,三張里,748,1267,254,460,714,24,738
公投第１５案,臺北市,信義區,三張里,749,1220,275,382,657,13,670
公投第１５案,臺北市,信義區,三犁里,750,1562,283,515,798,27,825
公投第１５案,臺北市,信義區,三犁里,751,1455,340,470,810,22,832
公投第１５案,臺北市,信義區,三犁里,752,1605,324,534,858,33,891
公投第１５案,臺北市,信義區,六合里,753,1626,354,636,990,25,1015
公投第１５案,臺北市,信義區,六合里,754,1561,377,529,906,35,941
公投第１５案,臺北市,信義區,六合里,755,1547,275,467,742,24,766
公投第１５案,臺北市,信義區,六合里,756,1336,286,454,740,28,768
公投第１５案,臺北市,信義區,泰和里,757,1314,251,392,643,42,685
公投第１５案,臺北市,信義區,泰和里,758,1297,259,431,690,27,717
公投第１５案,臺北市,信義區,泰和里,759,1366,251,473,724,43,767
公投第１５案,臺北市,信義區,泰和里,760,1472,314,482,796,57,853
公投第１５案,臺北市,信義區,泰和里,761,1450,287,516,803,41,844
公投第１５案,臺北市,信義區,景聯里,762,1328,280,445,725,49,774
公投第１５案,臺北市,信義區,景聯里,763,1399,308,503,811,46,857
公投第１５案,臺北市,信義區,景聯里,764,1373,308,487,795,53,848
公投第１５案,臺北市,信義區,景勤里,765,1099,196,406,602,13,615
公投第１５案,臺北市,信義區,景勤里,766,1226,266,409,675,37,712
公投第１５案,臺北市,信義區,景勤里,767,1267,251,428,679,21,700
公投第１５案,臺北市,信義區,雙和里,768,1531,249,576,825,48,873
公投第１５案,臺北市,信義區,雙和里,769,1438,275,560,835,40,875
公投第１５案,臺北市,信義區,雙和里,770,1657,342,557,899,20,919
公投第１５案,臺北市,信義區,雙和里,771,1621,346,574,920,43,963
公投第１５案,臺北市,信義區,嘉興里,772,1508,343,512,855,24,879
公投第１５案,臺北市,信義區,嘉興里,773,1334,309,468,777,31,808
公投第１５案,臺北市,信義區,黎順里,774,1246,205,357,562,32,594
公投第１５案,臺北市,信義區,黎順里,775,1196,295,439,734,29,763
公投第１５案,臺北市,信義區,黎順里,776,1220,286,429,715,23,738
公投第１５案,臺北市,信義區,黎平里,777,1538,311,528,839,25,864
公投第１５案,臺北市,信義區,黎平里,778,1565,338,547,885,54,939
公投第１５案,臺北市,信義區,黎平里,779,1621,313,505,818,62,880
公投第１５案,臺北市,信義區,黎平里,780,1486,307,487,794,45,839
公投第１５案,臺北市,信義區,黎忠里,781,1507,306,479,785,33,818
公投第１５案,臺北市,信義區,黎忠里,782,1516,330,531,861,40,901
公投第１５案,臺北市,信義區,黎忠里,783,1287,258,496,754,50,804
公投第１５案,臺北市,信義區,黎安里,784,1050,189,332,521,41,562
公投第１５案,臺北市,信義區,黎安里,785,801,122,345,467,31,498
公投第１５案,臺北市,中山區,正守里,786,1522,351,501,852,33,885
公投第１５案,臺北市,中山區,正守里,787,1332,297,522,819,26,845
公投第１５案,臺北市,中山區,正義里,788,1656,341,457,798,40,838
公投第１５案,臺北市,中山區,正義里,789,1367,280,394,674,35,709
公投第１５案,臺北市,中山區,正義里,790,1732,351,503,854,36,890
公投第１５案,臺北市,中山區,正得里,791,1634,359,533,892,44,936
公投第１５案,臺北市,中山區,正得里,792,1650,355,495,850,45,895
公投第１５案,臺北市,中山區,民安里,793,1392,312,479,791,33,824
公投第１５案,臺北市,中山區,民安里,794,1177,300,401,701,29,730
公投第１５案,臺北市,中山區,民安里,795,1477,357,489,846,41,887
公投第１５案,臺北市,中山區,康樂里,796,1063,234,308,542,39,581
公投第１５案,臺北市,中山區,康樂里,797,1296,243,445,688,31,719
公投第１５案,臺北市,中山區,中山里,798,1330,271,409,680,35,715
公投第１５案,臺北市,中山區,中山里,799,1483,290,465,755,49,804
公投第１５案,臺北市,中山區,中山里,800,1542,342,453,795,27,822
公投第１５案,臺北市,中山區,中山里,801,1710,348,492,840,50,890
公投第１５案,臺北市,中山區,聚盛里,802,1315,261,405,666,22,688
公投第１５案,臺北市,中山區,聚盛里,803,1245,246,405,651,50,701
公投第１５案,臺北市,中山區,聚盛里,804,1262,216,425,641,38,679
公投第１５案,臺北市,中山區,集英里,805,1518,352,480,832,53,885
公投第１５案,臺北市,中山區,集英里,806,1522,325,499,824,56,880
公投第１５案,臺北市,中山區,集英里,807,1580,311,478,789,42,831
公投第１５案,臺北市,中山區,集英里,808,1529,390,498,888,30,918
公投第１５案,臺北市,中山區,聚葉里,809,1221,279,375,654,34,688
公投第１５案,臺北市,中山區,聚葉里,810,1221,291,412,703,26,729
公投第１５案,臺北市,中山區,聚葉里,811,1139,217,332,549,27,576
公投第１５案,臺北市,中山區,恆安里,812,1407,284,461,745,59,804
公投第１５案,臺北市,中山區,恆安里,813,1321,322,406,728,30,758
公投第１５案,臺北市,中山區,恆安里,814,1578,295,476,771,24,795
公投第１５案,臺北市,中山區,晴光里,815,1739,312,537,849,40,889
公投第１５案,臺北市,中山區,晴光里,816,1637,325,496,821,38,859
公投第１５案,臺北市,中山區,晴光里,817,1541,327,465,792,49,841
公投第１５案,臺北市,中山區,圓山里,818,1210,269,415,684,36,720
公投第１５案,臺北市,中山區,圓山里,819,1331,299,405,704,33,737
公投第１５案,臺北市,中山區,圓山里,820,1224,256,354,610,41,651
公投第１５案,臺北市,中山區,新庄里,821,1585,312,556,868,43,911
公投第１５案,臺北市,中山區,新庄里,822,1523,336,553,889,61,950
公投第１５案,臺北市,中山區,新庄里,823,1368,313,479,792,36,828
公投第１５案,臺北市,中山區,劍潭里,824,1805,287,703,990,53,1043
公投第１５案,臺北市,中山區,劍潭里,825,1404,238,569,807,23,830
公投第１５案,臺北市,中山區,大直里,826,1708,432,591,1023,39,1062
公投第１５案,臺北市,中山區,大直里,827,1451,360,518,878,37,915
公投第１５案,臺北市,中山區,大直里,828,1684,380,604,984,59,1043
公投第１５案,臺北市,中山區,大直里,829,1585,306,567,873,20,893
公投第１５案,臺北市,中山區,大直里,830,1391,297,471,768,73,841
公投第１５案,臺北市,中山區,成功里,831,1375,328,539,867,49,916
公投第１５案,臺北市,中山區,成功里,832,1472,359,526,885,16,901
公投第１５案,臺北市,中山區,成功里,833,1327,282,435,717,22,739
公投第１５案,臺北市,中山區,成功里,834,1401,321,488,809,20,829
公投第１５案,臺北市,中山區,永安里,835,1423,301,511,812,34,846
公投第１５案,臺北市,中山區,永安里,836,1569,367,537,904,25,929
公投第１５案,臺北市,中山區,永安里,837,1651,361,557,918,19,937
公投第１５案,臺北市,中山區,永安里,838,1624,487,394,881,26,907
公投第１５案,臺北市,中山區,永安里,839,1713,432,575,1007,44,1051
公投第１５案,臺北市,中山區,金泰里,840,1647,366,583,949,41,990
公投第１５案,臺北市,中山區,金泰里,841,1762,363,565,928,30,958
公投第１５案,臺北市,中山區,金泰里,842,1399,370,462,832,33,865
公投第１５案,臺北市,中山區,金泰里,843,1489,337,558,895,32,927
公投第１５案,臺北市,中山區,北安里,844,1269,286,477,763,23,786
公投第１５案,臺北市,中山區,北安里,845,998,188,408,596,27,623
公投第１５案,臺北市,中山區,新喜里,846,1472,322,463,785,44,829
公投第１５案,臺北市,中山區,新喜里,847,1517,335,433,768,53,821
公投第１５案,臺北市,中山區,新喜里,848,1704,357,621,978,50,1028
公投第１５案,臺北市,中山區,新福里,849,1603,380,523,903,41,944
公投第１５案,臺北市,中山區,新福里,850,1432,272,459,731,64,795
公投第１５案,臺北市,中山區,新福里,851,1500,349,494,843,66,909
公投第１５案,臺北市,中山區,松江里,852,1332,302,478,780,33,813
公投第１５案,臺北市,中山區,松江里,853,1450,330,516,846,44,890
公投第１５案,臺北市,中山區,松江里,854,1434,358,483,841,35,876
公投第１５案,臺北市,中山區,松江里,855,1419,276,481,757,33,790
公投第１５案,臺北市,中山區,新生里,856,1292,278,423,701,31,732
公投第１５案,臺北市,中山區,新生里,857,1526,344,466,810,39,849
公投第１５案,臺北市,中山區,新生里,858,1582,313,429,742,40,782
公投第１５案,臺北市,中山區,中庄里,859,1588,333,455,788,44,832
公投第１５案,臺北市,中山區,中庄里,860,1463,290,506,796,59,855
公投第１５案,臺北市,中山區,中庄里,861,1533,326,429,755,45,800
公投第１５案,臺北市,中山區,大佳里,862,944,117,390,507,36,543
公投第１５案,臺北市,中山區,行政里,863,1745,394,643,1037,50,1087
公投第１５案,臺北市,中山區,行政里,864,1679,355,453,808,37,845
公投第１５案,臺北市,中山區,行政里,865,3419,326,453,779,35,814
公投第１５案,臺北市,中山區,行仁里,866,1387,337,449,786,50,836
公投第１５案,臺北市,中山區,行仁里,867,1672,380,596,976,49,1025
公投第１５案,臺北市,中山區,行仁里,868,1319,290,437,727,48,775
公投第１５案,臺北市,中山區,行仁里,869,1364,292,434,726,46,772
公投第１５案,臺北市,中山區,行仁里,870,1461,330,436,766,51,817
公投第１５案,臺北市,中山區,行孝里,871,1173,274,382,656,38,694
公投第１５案,臺北市,中山區,行孝里,872,1171,252,366,618,41,659
公投第１５案,臺北市,中山區,行孝里,873,1310,304,412,716,39,755
公投第１５案,臺北市,中山區,下埤里,874,1373,311,491,802,31,833
公投第１５案,臺北市,中山區,下埤里,875,1290,289,482,771,26,797
公投第１５案,臺北市,中山區,下埤里,876,1346,323,469,792,38,830
公投第１５案,臺北市,中山區,下埤里,877,1468,380,470,850,43,893
公投第１５案,臺北市,中山區,下埤里,878,1178,274,410,684,22,706
公投第１５案,臺北市,中山區,江寧里,879,1654,386,566,952,37,989
公投第１５案,臺北市,中山區,江寧里,880,1464,336,482,818,43,861
公投第１５案,臺北市,中山區,江寧里,881,1450,310,473,783,37,820
公投第１５案,臺北市,中山區,江寧里,882,1534,340,505,845,40,885
公投第１５案,臺北市,中山區,江山里,883,1703,381,560,941,33,974
公投第１５案,臺北市,中山區,江山里,884,1610,354,541,895,60,955
公投第１５案,臺北市,中山區,江山里,885,1653,345,518,863,51,914
公投第１５案,臺北市,中山區,江山里,886,1694,407,566,973,56,1029
公投第１５案,臺北市,中山區,中吉里,887,1623,361,502,863,37,900
公投第１５案,臺北市,中山區,中吉里,888,1618,387,510,897,46,943
公投第１５案,臺北市,中山區,中吉里,889,1583,350,505,855,41,896
公投第１５案,臺北市,中山區,中原里,890,1605,408,513,921,49,970
公投第１５案,臺北市,中山區,中原里,891,1398,365,469,834,50,884
公投第１５案,臺北市,中山區,中原里,892,1526,390,563,953,55,1008
公投第１５案,臺北市,中山區,興亞里,893,1555,357,511,868,47,915
公投第１５案,臺北市,中山區,興亞里,894,1597,335,523,858,34,892
公投第１５案,臺北市,中山區,興亞里,895,1587,373,501,874,62,936
公投第１５案,臺北市,中山區,中央里,896,1587,385,537,922,42,964
公投第１５案,臺北市,中山區,中央里,897,1546,368,535,903,47,950
公投第１５案,臺北市,中山區,朱馥里,898,1322,255,466,721,40,761
公投第１５案,臺北市,中山區,朱馥里,899,1267,288,425,713,28,741
公投第１５案,臺北市,中山區,朱馥里,900,1210,267,399,666,22,688
公投第１５案,臺北市,中山區,朱馥里,901,1295,252,456,708,42,750
公投第１５案,臺北市,中山區,龍洲里,902,1467,322,517,839,47,886
公投第１５案,臺北市,中山區,龍洲里,903,1491,272,623,895,33,928
公投第１５案,臺北市,中山區,龍洲里,904,1516,324,625,949,42,991
公投第１５案,臺北市,中山區,朱園里,905,1384,306,419,725,27,752
公投第１５案,臺北市,中山區,朱園里,906,1138,308,376,684,44,728
公投第１５案,臺北市,中山區,朱園里,907,1513,322,465,787,26,813
公投第１５案,臺北市,中山區,埤頭里,908,1559,358,521,879,48,927
公投第１５案,臺北市,中山區,埤頭里,909,1429,322,513,835,56,891
公投第１５案,臺北市,中山區,朱崙里,910,1245,308,437,745,26,771
公投第１５案,臺北市,中山區,朱崙里,911,1214,274,455,729,42,771
公投第１５案,臺北市,中山區,力行里,912,1394,332,475,807,25,832
公投第１５案,臺北市,中山區,力行里,913,1336,272,431,703,14,717
公投第１５案,臺北市,中山區,力行里,914,1227,287,388,675,32,707
公投第１５案,臺北市,中山區,力行里,915,1382,296,487,783,37,820
公投第１５案,臺北市,中山區,復華里,916,1436,287,498,785,43,828
公投第１５案,臺北市,中山區,復華里,917,1405,303,398,701,38,739
公投第１５案,臺北市,中山區,復華里,918,1259,275,436,711,25,736
公投第１５案,臺北市,大同區,玉泉里,919,1261,308,397,705,48,753
公投第１５案,臺北市,大同區,玉泉里,920,1352,333,457,790,46,836
公投第１５案,臺北市,大同區,建明里,921,1462,328,479,807,37,844
公投第１５案,臺北市,大同區,建明里,922,1510,299,494,793,43,836
公投第１５案,臺北市,大同區,建功里,923,1496,329,436,765,34,799
公投第１５案,臺北市,大同區,建功里,924,1329,271,434,705,46,751
公投第１５案,臺北市,大同區,建功里,925,1307,289,408,697,73,770
公投第１５案,臺北市,大同區,建泰里,926,1065,247,344,591,42,633
公投第１５案,臺北市,大同區,建泰里,927,1085,265,347,612,20,632
公投第１５案,臺北市,大同區,建泰里,928,1047,271,350,621,42,663
公投第１５案,臺北市,大同區,永樂里,929,1215,294,325,619,28,647
公投第１５案,臺北市,大同區,永樂里,930,1117,292,381,673,27,700
公投第１５案,臺北市,大同區,永樂里,931,1186,313,393,706,36,742
公投第１５案,臺北市,大同區,永樂里,932,1185,273,408,681,47,728
公投第１５案,臺北市,大同區,朝陽里,933,1359,292,459,751,38,789
公投第１５案,臺北市,大同區,朝陽里,934,1273,271,446,717,23,740
公投第１５案,臺北市,大同區,朝陽里,935,1291,348,419,767,36,803
公投第１５案,臺北市,大同區,星明里,936,1288,282,404,686,31,717
公投第１５案,臺北市,大同區,星明里,937,1245,276,472,748,31,779
公投第１５案,臺北市,大同區,星明里,938,1261,326,428,754,40,794
公投第１５案,臺北市,大同區,星明里,939,1348,297,424,721,26,747
公投第１５案,臺北市,大同區,光能里,940,1676,392,523,915,69,984
公投第１５案,臺北市,大同區,光能里,941,1311,290,480,770,36,806
公投第１５案,臺北市,大同區,光能里,942,1316,316,429,745,53,798
公投第１５案,臺北市,大同區,大有里,943,1409,318,452,770,61,831
公投第１５案,臺北市,大同區,大有里,944,1436,354,472,826,45,871
公投第１５案,臺北市,大同區,大有里,945,1408,325,462,787,53,840
公投第１５案,臺北市,大同區,延平里,946,1276,274,423,697,36,733
公投第１５案,臺北市,大同區,延平里,947,1110,238,362,600,19,619
公投第１５案,臺北市,大同區,延平里,948,1324,319,441,760,22,782
公投第１５案,臺北市,大同區,雙連里,949,1016,218,341,559,40,599
公投第１５案,臺北市,大同區,雙連里,950,1028,240,369,609,35,644
公投第１５案,臺北市,大同區,雙連里,951,1158,220,444,664,40,704
公投第１５案,臺北市,大同區,雙連里,952,1138,242,426,668,37,705
公投第１５案,臺北市,大同區,雙連里,953,1214,262,436,698,34,732
公投第１５案,臺北市,大同區,雙連里,954,1090,220,400,620,22,642
公投第１５案,臺北市,大同區,雙連里,955,1305,330,458,788,46,834
公投第１５案,臺北市,大同區,南芳里,956,1167,259,372,631,27,658
公投第１５案,臺北市,大同區,南芳里,957,1148,249,376,625,45,670
公投第１５案,臺北市,大同區,南芳里,958,1203,282,432,714,34,748
公投第１５案,臺北市,大同區,民權里,959,1441,310,460,770,38,808
公投第１５案,臺北市,大同區,民權里,960,1315,298,475,773,48,821
公投第１５案,臺北市,大同區,民權里,961,1393,335,427,762,40,802
公投第１５案,臺北市,大同區,民權里,962,1278,303,427,730,42,772
公投第１５案,臺北市,大同區,景星里,963,1246,285,368,653,35,688
公投第１５案,臺北市,大同區,景星里,964,1142,256,350,606,61,667
公投第１５案,臺北市,大同區,隆和里,965,1336,308,482,790,53,843
公投第１５案,臺北市,大同區,隆和里,966,1363,326,468,794,43,837
公投第１５案,臺北市,大同區,蓬萊里,967,1476,320,517,837,23,860
公投第１５案,臺北市,大同區,蓬萊里,968,1418,343,446,789,51,840
公投第１５案,臺北市,大同區,蓬萊里,969,1460,294,500,794,33,827
公投第１５案,臺北市,大同區,國順里,970,1222,250,349,599,41,640
公投第１５案,臺北市,大同區,國順里,971,1246,230,346,576,75,651
公投第１５案,臺北市,大同區,國慶里,972,1256,285,447,732,52,784
公投第１５案,臺北市,大同區,國慶里,973,1289,299,427,726,29,755
公投第１５案,臺北市,大同區,國慶里,974,1340,298,419,717,20,737
公投第１５案,臺北市,大同區,揚雅里,975,1555,348,429,777,47,824
公投第１５案,臺北市,大同區,揚雅里,976,2459,262,504,766,66,832
公投第１５案,臺北市,大同區,斯文里,977,1108,192,298,490,55,545
公投第１５案,臺北市,大同區,斯文里,978,867,188,268,456,38,494
公投第１５案,臺北市,大同區,斯文里,979,1329,311,461,772,54,826
公投第１５案,臺北市,大同區,斯文里,980,1162,291,353,644,35,679
公投第１５案,臺北市,大同區,鄰江里,981,1434,290,442,732,62,794
公投第１５案,臺北市,大同區,鄰江里,982,1351,321,420,741,54,795
公投第１５案,臺北市,大同區,鄰江里,983,1531,326,408,734,43,777
公投第１５案,臺北市,大同區,鄰江里,984,1507,325,410,735,34,769
公投第１５案,臺北市,大同區,至聖里,985,1488,356,423,779,53,832
公投第１５案,臺北市,大同區,至聖里,986,1384,321,469,790,62,852
公投第１５案,臺北市,大同區,至聖里,987,1460,290,519,809,51,860
公投第１５案,臺北市,大同區,至聖里,988,1371,313,479,792,52,844
公投第１５案,臺北市,大同區,至聖里,989,1439,343,440,783,17,800
公投第１５案,臺北市,大同區,老師里,990,1376,357,426,783,49,832
公投第１５案,臺北市,大同區,老師里,991,1366,288,428,716,68,784
公投第１５案,臺北市,大同區,老師里,992,1218,296,433,729,58,787
公投第１５案,臺北市,大同區,老師里,993,1235,265,421,686,45,731
公投第１５案,臺北市,大同區,重慶里,994,1364,248,477,725,19,744
公投第１５案,臺北市,大同區,重慶里,995,1408,350,495,845,53,898
公投第１５案,臺北市,大同區,重慶里,996,1450,309,486,795,52,847
公投第１５案,臺北市,大同區,重慶里,997,1429,327,497,824,61,885
公投第１５案,臺北市,大同區,保安里,998,1170,284,378,662,57,719
公投第１５案,臺北市,大同區,保安里,999,1245,288,392,680,58,738
公投第１５案,臺北市,大同區,保安里,1000,1215,313,418,731,62,793
公投第１５案,臺北市,中正區,水源里,1001,1308,302,453,755,28,783
公投第１５案,臺北市,中正區,水源里,1002,1317,280,421,701,39,740
公投第１５案,臺北市,中正區,富水里,1003,1069,223,409,632,32,664
公投第１５案,臺北市,中正區,富水里,1004,1128,221,384,605,30,635
公投第１５案,臺北市,中正區,文盛里,1005,1053,247,366,613,35,648
公投第１５案,臺北市,中正區,文盛里,1006,1048,233,279,512,10,522
公投第１５案,臺北市,中正區,林興里,1007,1297,241,453,694,40,734
公投第１５案,臺北市,中正區,林興里,1008,1193,258,444,702,21,723
公投第１５案,臺北市,中正區,林興里,1009,1500,354,591,945,33,978
公投第１５案,臺北市,中正區,河堤里,1010,1346,288,442,730,30,760
公投第１５案,臺北市,中正區,河堤里,1011,1283,275,429,704,25,729
公投第１５案,臺北市,中正區,河堤里,1012,1450,349,446,795,33,828
公投第１５案,臺北市,中正區,頂東里,1013,1433,341,478,819,36,855
公投第１５案,臺北市,中正區,頂東里,1014,1309,350,475,825,36,861
公投第１５案,臺北市,中正區,頂東里,1015,1386,308,512,820,12,832
公投第１５案,臺北市,中正區,頂東里,1016,1201,265,421,686,44,730
公投第１５案,臺北市,中正區,網溪里,1017,1336,313,478,791,34,825
公投第１５案,臺北市,中正區,網溪里,1018,1358,325,474,799,36,835
公投第１５案,臺北市,中正區,網溪里,1019,1177,267,419,686,33,719
公投第１５案,臺北市,中正區,網溪里,1020,1236,296,472,768,28,796
公投第１５案,臺北市,中正區,板溪里,1021,1478,302,517,819,42,861
公投第１５案,臺北市,中正區,板溪里,1022,1474,326,514,840,32,872
公投第１５案,臺北市,中正區,螢圃里,1023,1172,262,399,661,32,693
公投第１５案,臺北市,中正區,螢圃里,1024,1310,282,448,730,41,771
公投第１５案,臺北市,中正區,螢圃里,1025,1263,268,467,735,31,766
公投第１５案,臺北市,中正區,螢圃里,1026,1169,246,423,669,36,705
公投第１５案,臺北市,中正區,螢雪里,1027,1391,299,500,799,22,821
公投第１５案,臺北市,中正區,螢雪里,1028,1201,236,424,660,22,682
公投第１５案,臺北市,中正區,螢雪里,1029,1324,270,479,749,41,790
公投第１５案,臺北市,中正區,永功里,1030,1216,238,407,645,47,692
公投第１５案,臺北市,中正區,永功里,1031,1183,269,382,651,35,686
公投第１５案,臺北市,中正區,永功里,1032,1469,339,503,842,55,897
公投第１５案,臺北市,中正區,永功里,1033,1411,336,459,795,36,831
公投第１５案,臺北市,中正區,永昌里,1034,1398,312,466,778,67,845
公投第１５案,臺北市,中正區,永昌里,1035,1479,289,494,783,64,847
公投第１５案,臺北市,中正區,永昌里,1036,1620,337,527,864,50,914
公投第１５案,臺北市,中正區,龍興里,1037,1041,228,367,595,16,611
公投第１５案,臺北市,中正區,龍興里,1038,1056,246,352,598,17,615
公投第１５案,臺北市,中正區,龍興里,1039,1063,250,423,673,29,702
公投第１５案,臺北市,中正區,忠勤里,1040,1591,266,450,716,43,759
公投第１５案,臺北市,中正區,忠勤里,1041,1502,225,431,656,48,704
公投第１５案,臺北市,中正區,忠勤里,1042,1331,241,434,675,41,716
公投第１５案,臺北市,中正區,忠勤里,1043,1441,275,495,770,48,818
公投第１５案,臺北市,中正區,廈安里,1044,1273,315,456,771,23,794
公投第１５案,臺北市,中正區,廈安里,1045,1133,250,422,672,25,697
公投第１５案,臺北市,中正區,廈安里,1046,1156,215,451,666,23,689
公投第１５案,臺北市,中正區,愛國里,1047,1377,300,460,760,42,802
公投第１５案,臺北市,中正區,愛國里,1048,1266,270,468,738,45,783
公投第１５案,臺北市,中正區,南門里,1049,1111,244,437,681,33,714
公投第１５案,臺北市,中正區,南門里,1050,1124,278,376,654,30,684
公投第１５案,臺北市,中正區,龍光里,1051,1373,319,507,826,24,850
公投第１５案,臺北市,中正區,龍光里,1052,1351,302,513,815,23,838
公投第１５案,臺北市,中正區,南福里,1053,1495,334,533,867,23,890
公投第１５案,臺北市,中正區,南福里,1054,1436,352,532,884,32,916
公投第１５案,臺北市,中正區,南福里,1055,1516,331,527,858,15,873
公投第１５案,臺北市,中正區,南福里,1056,1374,286,490,776,31,807
公投第１５案,臺北市,中正區,南福里,1057,1522,279,533,812,27,839
公投第１５案,臺北市,中正區,南福里,1058,1336,294,482,776,25,801
公投第１５案,臺北市,中正區,龍福里,1059,1551,343,542,885,33,918
公投第１５案,臺北市,中正區,龍福里,1060,1594,355,556,911,46,957
公投第１５案,臺北市,中正區,龍福里,1061,1503,325,514,839,36,875
公投第１５案,臺北市,中正區,新營里,1062,1455,295,552,847,20,867
公投第１５案,臺北市,中正區,新營里,1063,1439,304,552,856,12,868
公投第１５案,臺北市,中正區,新營里,1064,1469,309,526,835,36,871
公投第１５案,臺北市,中正區,新營里,1065,1430,259,581,840,33,873
公投第１５案,臺北市,中正區,新營里,1066,1444,328,540,868,21,889
公投第１５案,臺北市,中正區,建國里,1067,1254,267,456,723,10,733
公投第１５案,臺北市,中正區,光復里,1068,932,200,334,534,40,574
公投第１５案,臺北市,中正區,光復里,1069,1055,256,356,612,33,645
公投第１５案,臺北市,中正區,光復里,1070,1226,260,438,698,24,722
公投第１５案,臺北市,中正區,黎明里,1071,1390,257,447,704,35,739
公投第１５案,臺北市,中正區,黎明里,1072,1336,307,460,767,26,793
公投第１５案,臺北市,中正區,梅花里,1073,1419,285,442,727,30,757
公投第１５案,臺北市,中正區,梅花里,1074,1361,320,491,811,40,851
公投第１５案,臺北市,中正區,幸福里,1075,2520,318,548,866,33,899
公投第１５案,臺北市,中正區,幸福里,1076,1224,253,452,705,15,720
公投第１５案,臺北市,中正區,幸福里,1077,1272,266,403,669,6,675
公投第１５案,臺北市,中正區,幸市里,1078,1400,336,447,783,35,818
公投第１５案,臺北市,中正區,幸市里,1079,1319,277,442,719,30,749
公投第１５案,臺北市,中正區,幸市里,1080,1232,272,466,738,31,769
公投第１５案,臺北市,中正區,東門里,1081,1265,307,475,782,27,809
公投第１５案,臺北市,中正區,東門里,1082,1055,250,403,653,21,674
公投第１５案,臺北市,中正區,東門里,1083,954,196,346,542,24,566
公投第１５案,臺北市,中正區,文北里,1084,1018,208,382,590,30,620
公投第１５案,臺北市,中正區,文北里,1085,1431,308,485,793,18,811
公投第１５案,臺北市,中正區,文北里,1086,1271,276,370,646,30,676
公投第１５案,臺北市,中正區,文北里,1087,983,232,352,584,32,616
公投第１５案,臺北市,中正區,文祥里,1088,1594,340,546,886,26,912
公投第１５案,臺北市,中正區,文祥里,1089,1565,355,566,921,39,960
公投第１５案,臺北市,中正區,文祥里,1090,1650,346,577,923,32,955
公投第１５案,臺北市,中正區,文祥里,1091,1600,339,518,857,28,885
公投第１５案,臺北市,中正區,三愛里,1092,1391,305,457,762,29,791
公投第１５案,臺北市,中正區,三愛里,1093,1769,370,594,964,32,996
公投第１５案,臺北市,中正區,三愛里,1094,1487,355,473,828,35,863
公投第１５案,臺北市,中正區,三愛里,1095,1291,303,452,755,41,796
公投第１５案,臺北市,中正區,三愛里,1096,1289,305,451,756,23,779
公投第１５案,臺北市,萬華區,福星里,1097,1305,315,428,743,45,788
公投第１５案,臺北市,萬華區,福星里,1098,1183,205,344,549,59,608
公投第１５案,臺北市,萬華區,福星里,1099,1176,244,385,629,25,654
公投第１５案,臺北市,萬華區,福星里,1100,1169,246,336,582,26,608
公投第１５案,臺北市,萬華區,萬壽里,1101,1457,235,472,707,34,741
公投第１５案,臺北市,萬華區,萬壽里,1102,1563,275,426,701,54,755
公投第１５案,臺北市,萬華區,西門里,1103,1771,341,505,846,22,868
公投第１５案,臺北市,萬華區,西門里,1104,1615,348,453,801,38,839
公投第１５案,臺北市,萬華區,新起里,1105,1478,318,445,763,69,832
公投第１５案,臺北市,萬華區,新起里,1106,1462,300,475,775,24,799
公投第１５案,臺北市,萬華區,新起里,1107,1507,243,437,680,55,735
公投第１５案,臺北市,萬華區,新起里,1108,1347,318,427,745,45,790
公投第１５案,臺北市,萬華區,菜園里,1109,1367,272,410,682,51,733
公投第１５案,臺北市,萬華區,菜園里,1110,1277,293,453,746,42,788
公投第１５案,臺北市,萬華區,菜園里,1111,1395,360,421,781,50,831
公投第１５案,臺北市,萬華區,菜園里,1112,1450,319,421,740,41,781
公投第１５案,臺北市,萬華區,青山里,1113,1340,255,409,664,34,698
公投第１５案,臺北市,萬華區,青山里,1114,1242,249,381,630,37,667
公投第１５案,臺北市,萬華區,青山里,1115,1286,264,388,652,62,714
公投第１５案,臺北市,萬華區,青山里,1116,1324,235,437,672,49,721
公投第１５案,臺北市,萬華區,富民里,1117,1619,330,473,803,59,862
公投第１５案,臺北市,萬華區,富民里,1118,1352,240,382,622,56,678
公投第１５案,臺北市,萬華區,富民里,1119,1440,284,451,735,43,778
公投第１５案,臺北市,萬華區,福音里,1120,1194,284,386,670,49,719
公投第１５案,臺北市,萬華區,福音里,1121,1083,235,409,644,48,692
公投第１５案,臺北市,萬華區,福音里,1122,1237,249,383,632,54,686
公投第１５案,臺北市,萬華區,仁德里,1123,1625,362,481,843,39,882
公投第１５案,臺北市,萬華區,仁德里,1124,1324,300,459,759,43,802
公投第１５案,臺北市,萬華區,仁德里,1125,1352,339,413,752,54,806
公投第１５案,臺北市,萬華區,富福里,1126,2630,282,421,703,47,750
公投第１５案,臺北市,萬華區,富福里,1127,1504,366,493,859,50,909
公投第１５案,臺北市,萬華區,富福里,1128,1425,325,430,755,38,793
公投第１５案,臺北市,萬華區,柳鄉里,1129,1591,312,446,758,62,820
公投第１５案,臺北市,萬華區,柳鄉里,1130,1474,317,445,762,51,813
公投第１５案,臺北市,萬華區,柳鄉里,1131,1612,333,453,786,66,852
公投第１５案,臺北市,萬華區,華江里,1132,1447,290,451,741,52,793
公投第１５案,臺北市,萬華區,華江里,1133,1491,306,518,824,42,866
公投第１５案,臺北市,萬華區,華江里,1134,1500,324,531,855,40,895
公投第１５案,臺北市,萬華區,華江里,1135,1582,438,531,969,45,1014
公投第１５案,臺北市,萬華區,華江里,1136,1623,325,482,807,42,849
公投第１５案,臺北市,萬華區,糖廍里,1137,1228,282,371,653,20,673
公投第１５案,臺北市,萬華區,糖廍里,1138,1268,251,422,673,48,721
公投第１５案,臺北市,萬華區,糖廍里,1139,1207,272,403,675,54,729
公投第１５案,臺北市,萬華區,糖廍里,1140,1188,287,390,677,39,716
公投第１５案,臺北市,萬華區,綠堤里,1141,1474,292,465,757,40,797
公投第１５案,臺北市,萬華區,綠堤里,1142,1304,197,412,609,26,635
公投第１５案,臺北市,萬華區,綠堤里,1143,1082,152,276,428,48,476
公投第１５案,臺北市,萬華區,頂碩里,1144,1052,213,316,529,34,563
公投第１５案,臺北市,萬華區,頂碩里,1145,1135,262,345,607,40,647
公投第１５案,臺北市,萬華區,頂碩里,1146,1225,245,392,637,54,691
公投第１５案,臺北市,萬華區,頂碩里,1147,1583,315,482,797,40,837
公投第１５案,臺北市,萬華區,頂碩里,1148,1403,324,404,728,54,782
公投第１５案,臺北市,萬華區,雙園里,1149,1406,307,459,766,48,814
公投第１５案,臺北市,萬華區,雙園里,1150,1401,271,495,766,48,814
公投第１５案,臺北市,萬華區,雙園里,1151,1188,287,376,663,48,711
公投第１５案,臺北市,萬華區,和平里,1152,1597,326,479,805,63,868
公投第１５案,臺北市,萬華區,和平里,1153,1290,272,464,736,61,797
公投第１５案,臺北市,萬華區,和平里,1154,1746,339,506,845,28,873
公投第１５案,臺北市,萬華區,和平里,1155,1595,286,448,734,29,763
公投第１５案,臺北市,萬華區,和德里,1156,1701,334,519,853,85,938
公投第１５案,臺北市,萬華區,和德里,1157,1339,235,365,600,65,665
公投第１５案,臺北市,萬華區,和德里,1158,1484,234,421,655,66,721
公投第１５案,臺北市,萬華區,和德里,1159,1604,317,522,839,72,911
公投第１５案,臺北市,萬華區,全德里,1160,1197,282,382,664,38,702
公投第１５案,臺北市,萬華區,全德里,1161,1347,283,391,674,73,747
公投第１５案,臺北市,萬華區,全德里,1162,1223,308,438,746,39,785
公投第１５案,臺北市,萬華區,日善里,1163,1036,248,353,601,29,630
公投第１５案,臺北市,萬華區,日善里,1164,1035,251,365,616,45,661
公投第１５案,臺北市,萬華區,日善里,1165,1141,285,386,671,39,710
公投第１５案,臺北市,萬華區,忠德里,1166,1271,269,444,713,37,750
公投第１５案,臺北市,萬華區,忠德里,1167,1328,299,441,740,69,809
公投第１５案,臺北市,萬華區,忠德里,1168,1286,303,421,724,39,763
公投第１５案,臺北市,萬華區,錦德里,1169,1679,346,549,895,67,962
公投第１５案,臺北市,萬華區,錦德里,1170,1619,353,494,847,64,911
公投第１５案,臺北市,萬華區,錦德里,1171,1625,283,491,774,44,818
公投第１５案,臺北市,萬華區,孝德里,1172,1623,322,586,908,49,957
公投第１５案,臺北市,萬華區,孝德里,1173,1280,223,441,664,60,724
公投第１５案,臺北市,萬華區,壽德里,1174,1608,339,500,839,63,902
公投第１５案,臺北市,萬華區,壽德里,1175,1453,324,473,797,54,851
公投第１５案,臺北市,萬華區,壽德里,1176,1472,340,532,872,40,912
公投第１５案,臺北市,萬華區,銘德里,1177,1373,316,446,762,37,799
公投第１５案,臺北市,萬華區,銘德里,1178,1394,279,445,724,54,778
公投第１５案,臺北市,萬華區,銘德里,1179,1427,283,455,738,29,767
公投第１５案,臺北市,萬華區,保德里,1180,1342,296,493,789,46,835
公投第１５案,臺北市,萬華區,保德里,1181,1569,289,573,862,72,934
公投第１５案,臺北市,萬華區,榮德里,1182,1514,243,471,714,45,759
公投第１５案,臺北市,萬華區,榮德里,1183,1720,312,492,804,39,843
公投第１５案,臺北市,萬華區,華中里,1184,1461,348,509,857,59,916
公投第１５案,臺北市,萬華區,華中里,1185,1264,261,408,669,34,703
公投第１５案,臺北市,萬華區,華中里,1186,1334,279,494,773,57,830
公投第１５案,臺北市,萬華區,華中里,1187,1446,415,344,759,61,820
公投第１５案,臺北市,萬華區,興德里,1188,1307,232,421,653,33,686
公投第１５案,臺北市,萬華區,興德里,1189,1420,284,495,779,60,839
公投第１５案,臺北市,萬華區,興德里,1190,1427,281,429,710,37,747
公投第１５案,臺北市,萬華區,日祥里,1191,956,177,339,516,30,546
公投第１５案,臺北市,萬華區,日祥里,1192,1352,245,490,735,56,791
公投第１５案,臺北市,萬華區,日祥里,1193,1370,244,500,744,37,781
公投第１５案,臺北市,萬華區,日祥里,1194,1222,219,486,705,27,732
公投第１５案,臺北市,萬華區,忠貞里,1195,1375,212,546,758,36,794
公投第１５案,臺北市,萬華區,忠貞里,1196,1463,252,571,823,37,860
公投第１５案,臺北市,萬華區,忠貞里,1197,1527,275,495,770,37,807
公投第１５案,臺北市,萬華區,新忠里,1198,1485,250,523,773,40,813
公投第１５案,臺北市,萬華區,新忠里,1199,1591,272,676,948,32,980
公投第１５案,臺北市,萬華區,新和里,1200,1394,286,575,861,36,897
公投第１５案,臺北市,萬華區,新和里,1201,1522,291,553,844,29,873
公投第１５案,臺北市,萬華區,新和里,1202,1661,306,673,979,24,1003
公投第１５案,臺北市,萬華區,新和里,1203,1561,300,618,918,33,951
公投第１５案,臺北市,萬華區,新和里,1204,1406,287,583,870,35,905
公投第１５案,臺北市,萬華區,新安里,1205,1498,248,419,667,39,706
公投第１５案,臺北市,萬華區,新安里,1206,1478,230,426,656,52,708
公投第１５案,臺北市,萬華區,新安里,1207,1170,226,383,609,47,656
公投第１５案,臺北市,萬華區,新安里,1208,1376,275,516,791,30,821
公投第１５案,臺北市,萬華區,凌霄里,1209,1093,236,372,608,16,624
公投第１５案,臺北市,萬華區,凌霄里,1210,1084,244,383,627,57,684
公投第１５案,臺北市,萬華區,凌霄里,1211,1119,231,398,629,45,674
公投第１５案,臺北市,萬華區,騰雲里,1212,1381,287,541,828,27,855
公投第１５案,臺北市,萬華區,騰雲里,1213,1396,293,494,787,36,823
公投第１５案,臺北市,大安區,德安里,1214,1184,241,388,629,23,652
公投第１５案,臺北市,大安區,德安里,1215,1197,222,407,629,31,660
公投第１５案,臺北市,大安區,德安里,1216,1221,264,429,693,20,713
公投第１５案,臺北市,大安區,德安里,1217,1246,267,455,722,24,746
公投第１５案,臺北市,大安區,仁慈里,1218,1478,362,487,849,29,878
公投第１５案,臺北市,大安區,仁慈里,1219,1314,319,390,709,49,758
公投第１５案,臺北市,大安區,仁慈里,1220,1594,370,554,924,37,961
公投第１５案,臺北市,大安區,和安里,1221,1429,340,489,829,28,857
公投第１５案,臺北市,大安區,和安里,1222,1452,313,545,858,27,885
公投第１５案,臺北市,大安區,和安里,1223,1551,377,505,882,22,904
公投第１５案,臺北市,大安區,和安里,1224,1335,288,492,780,32,812
公投第１５案,臺北市,大安區,民炤里,1225,1196,253,385,638,23,661
公投第１５案,臺北市,大安區,民炤里,1226,1339,283,427,710,24,734
公投第１５案,臺北市,大安區,民炤里,1227,1448,356,453,809,20,829
公投第１５案,臺北市,大安區,民炤里,1228,1373,286,482,768,28,796
公投第１５案,臺北市,大安區,民炤里,1229,1439,302,495,797,45,842
公投第１５案,臺北市,大安區,仁愛里,1230,1174,249,375,624,12,636
公投第１５案,臺北市,大安區,仁愛里,1231,1144,211,382,593,24,617
公投第１５案,臺北市,大安區,仁愛里,1232,1119,165,407,572,29,601
公投第１５案,臺北市,大安區,仁愛里,1233,1024,181,300,481,25,506
公投第１５案,臺北市,大安區,義村里,1234,1032,205,411,616,12,628
公投第１５案,臺北市,大安區,義村里,1235,1319,224,539,763,28,791
公投第１５案,臺北市,大安區,義村里,1236,1369,311,507,818,28,846
公投第１５案,臺北市,大安區,義村里,1237,1347,332,430,762,41,803
公投第１５案,臺北市,大安區,民輝里,1238,1655,361,483,844,24,868
公投第１５案,臺北市,大安區,民輝里,1239,1595,287,507,794,21,815
公投第１５案,臺北市,大安區,民輝里,1240,1429,296,462,758,28,786
公投第１５案,臺北市,大安區,民輝里,1241,1309,269,413,682,21,703
公投第１５案,臺北市,大安區,昌隆里,1242,1508,298,507,805,21,826
公投第１５案,臺北市,大安區,昌隆里,1243,1310,307,390,697,31,728
公投第１５案,臺北市,大安區,誠安里,1244,1233,245,387,632,25,657
公投第１５案,臺北市,大安區,誠安里,1245,1287,272,390,662,33,695
公投第１５案,臺北市,大安區,誠安里,1246,1147,231,355,586,29,615
公投第１５案,臺北市,大安區,光武里,1247,1260,241,416,657,22,679
公投第１５案,臺北市,大安區,光武里,1248,1377,257,470,727,31,758
公投第１５案,臺北市,大安區,光武里,1249,1284,281,391,672,44,716
公投第１５案,臺北市,大安區,光武里,1250,1314,256,415,671,27,698
公投第１５案,臺北市,大安區,光武里,1251,1273,258,392,650,28,678
公投第１５案,臺北市,大安區,龍坡里,1252,1146,288,372,660,19,679
公投第１５案,臺北市,大安區,龍坡里,1253,1285,294,454,748,18,766
公投第１５案,臺北市,大安區,龍坡里,1254,1297,333,443,776,20,796
公投第１５案,臺北市,大安區,龍坡里,1255,1101,259,398,657,21,678
公投第１５案,臺北市,大安區,龍泉里,1256,1310,305,411,716,43,759
公投第１５案,臺北市,大安區,龍泉里,1257,1365,320,478,798,44,842
公投第１５案,臺北市,大安區,龍泉里,1258,1372,310,453,763,28,791
公投第１５案,臺北市,大安區,古風里,1259,1189,294,410,704,27,731
公投第１５案,臺北市,大安區,古風里,1260,1256,296,439,735,25,760
公投第１５案,臺北市,大安區,古風里,1261,1151,275,380,655,40,695
公投第１５案,臺北市,大安區,古莊里,1262,1501,365,542,907,27,934
公投第１５案,臺北市,大安區,古莊里,1263,1520,382,519,901,23,924
公投第１５案,臺北市,大安區,古莊里,1264,1529,354,568,922,36,958
公投第１５案,臺北市,大安區,古莊里,1265,1579,383,544,927,30,957
公投第１５案,臺北市,大安區,龍安里,1266,2619,264,400,664,18,682
公投第１５案,臺北市,大安區,龍安里,1267,1290,283,450,733,23,756
公投第１５案,臺北市,大安區,龍安里,1268,1307,317,478,795,22,817
公投第１５案,臺北市,大安區,龍安里,1269,1489,375,512,887,29,916
公投第１５案,臺北市,大安區,錦安里,1270,1097,268,389,657,28,685
公投第１５案,臺北市,大安區,錦安里,1271,1328,322,434,756,24,780
公投第１５案,臺北市,大安區,錦安里,1272,1189,277,394,671,17,688
公投第１５案,臺北市,大安區,錦安里,1273,1270,302,436,738,15,753
公投第１５案,臺北市,大安區,福住里,1274,1349,339,433,772,16,788
公投第１５案,臺北市,大安區,福住里,1275,1292,295,414,709,24,733
公投第１５案,臺北市,大安區,福住里,1276,1314,309,468,777,35,812
公投第１５案,臺北市,大安區,福住里,1277,1200,289,414,703,31,734
公投第１５案,臺北市,大安區,永康里,1278,1558,346,518,864,40,904
公投第１５案,臺北市,大安區,永康里,1279,1561,338,532,870,28,898
公投第１５案,臺北市,大安區,光明里,1280,1446,314,509,823,39,862
公投第１５案,臺北市,大安區,光明里,1281,1499,344,525,869,25,894
公投第１５案,臺北市,大安區,錦泰里,1282,1467,300,539,839,25,864
公投第１５案,臺北市,大安區,錦泰里,1283,1511,314,513,827,29,856
公投第１５案,臺北市,大安區,錦華里,1284,1600,353,568,921,44,965
公投第１５案,臺北市,大安區,錦華里,1285,1573,345,571,916,25,941
公投第１５案,臺北市,大安區,錦華里,1286,1467,352,536,888,33,921
公投第１５案,臺北市,大安區,龍圖里,1287,1358,282,490,772,34,806
公投第１５案,臺北市,大安區,龍圖里,1288,1568,338,533,871,35,906
公投第１５案,臺北市,大安區,龍圖里,1289,1411,333,483,816,33,849
公投第１５案,臺北市,大安區,龍圖里,1290,1554,331,532,863,16,879
公投第１５案,臺北市,大安區,新龍里,1291,1345,308,485,793,34,827
公投第１５案,臺北市,大安區,新龍里,1292,1435,332,496,828,14,842
公投第１５案,臺北市,大安區,新龍里,1293,1481,327,579,906,22,928
公投第１５案,臺北市,大安區,新龍里,1294,1451,302,603,905,27,932
公投第１５案,臺北市,大安區,龍陣里,1295,1566,342,546,888,48,936
公投第１５案,臺北市,大安區,龍陣里,1296,1525,337,542,879,24,903
公投第１５案,臺北市,大安區,龍雲里,1297,1336,282,460,742,33,775
公投第１５案,臺北市,大安區,龍雲里,1298,1483,309,533,842,47,889
公投第１５案,臺北市,大安區,龍雲里,1299,1396,285,427,712,22,734
公投第１５案,臺北市,大安區,龍生里,1300,1406,350,476,826,41,867
公投第１５案,臺北市,大安區,龍生里,1301,1434,327,511,838,27,865
公投第１５案,臺北市,大安區,龍生里,1302,1288,270,450,720,35,755
公投第１５案,臺北市,大安區,龍生里,1303,1407,305,499,804,36,840
公投第１５案,臺北市,大安區,住安里,1304,1514,309,497,806,27,833
公投第１５案,臺北市,大安區,住安里,1305,1550,261,465,726,50,776
公投第１５案,臺北市,大安區,住安里,1306,1490,302,534,836,39,875
公投第１５案,臺北市,大安區,義安里,1307,1284,302,404,706,23,729
公投第１５案,臺北市,大安區,義安里,1308,1129,251,413,664,19,683
公投第１５案,臺北市,大安區,義安里,1309,1193,268,422,690,20,710
公投第１５案,臺北市,大安區,義安里,1310,1057,215,362,577,25,602
公投第１５案,臺北市,大安區,通化里,1311,1361,319,432,751,32,783
公投第１５案,臺北市,大安區,通化里,1312,1412,265,485,750,47,797
公投第１５案,臺北市,大安區,通化里,1313,1423,285,381,666,22,688
公投第１５案,臺北市,大安區,通化里,1314,1257,272,396,668,69,737
公投第１５案,臺北市,大安區,通安里,1315,1133,227,448,675,28,703
公投第１５案,臺北市,大安區,通安里,1316,1077,249,355,604,27,631
公投第１５案,臺北市,大安區,通安里,1317,1300,299,450,749,35,784
公投第１５案,臺北市,大安區,通安里,1318,1319,285,498,783,39,822
公投第１５案,臺北市,大安區,臨江里,1319,1265,255,438,693,61,754
公投第１５案,臺北市,大安區,臨江里,1320,1265,235,421,656,32,688
公投第１５案,臺北市,大安區,臨江里,1321,1103,245,394,639,29,668
公投第１５案,臺北市,大安區,法治里,1322,1341,312,472,784,26,810
公投第１５案,臺北市,大安區,法治里,1323,1357,281,510,791,36,827
公投第１５案,臺北市,大安區,法治里,1324,1260,284,435,719,32,751
公投第１５案,臺北市,大安區,全安里,1325,1295,315,427,742,31,773
公投第１５案,臺北市,大安區,全安里,1326,1399,302,429,731,23,754
公投第１５案,臺北市,大安區,全安里,1327,1150,246,389,635,30,665
公投第１５案,臺北市,大安區,群賢里,1328,1351,278,416,694,17,711
公投第１５案,臺北市,大安區,群賢里,1329,1341,313,442,755,39,794
公投第１５案,臺北市,大安區,群賢里,1330,1129,207,405,612,16,628
公投第１５案,臺北市,大安區,群賢里,1331,1328,252,471,723,39,762
公投第１５案,臺北市,大安區,群英里,1332,1557,307,655,962,28,990
公投第１５案,臺北市,大安區,群英里,1333,1461,322,572,894,32,926
公投第１５案,臺北市,大安區,群英里,1334,1589,300,500,800,25,825
公投第１５案,臺北市,大安區,群英里,1335,1473,280,531,811,21,832
公投第１５案,臺北市,大安區,虎嘯里,1336,1479,329,470,799,38,837
公投第１５案,臺北市,大安區,虎嘯里,1337,833,163,331,494,30,524
公投第１５案,臺北市,大安區,虎嘯里,1338,999,205,338,543,29,572
公投第１５案,臺北市,大安區,臥龍里,1339,1757,389,629,1018,31,1049
公投第１５案,臺北市,大安區,龍淵里,1340,1573,320,589,909,36,945
公投第１５案,臺北市,大安區,龍淵里,1341,1587,375,572,947,35,982
公投第１５案,臺北市,大安區,龍淵里,1342,1496,348,530,878,36,914
公投第１５案,臺北市,大安區,龍淵里,1343,1440,384,457,841,28,869
公投第１５案,臺北市,大安區,龍淵里,1344,1578,370,553,923,40,963
公投第１５案,臺北市,大安區,龍門里,1345,1223,301,413,714,15,729
公投第１５案,臺北市,大安區,龍門里,1346,1119,296,354,650,18,668
公投第１５案,臺北市,大安區,龍門里,1347,1252,307,450,757,15,772
公投第１５案,臺北市,大安區,大學里,1348,1576,377,536,913,34,947
公投第１５案,臺北市,大安區,大學里,1349,1425,307,489,796,29,825
公投第１５案,臺北市,大安區,大學里,1350,1450,317,464,781,17,798
公投第１５案,臺北市,大安區,大學里,1351,1444,200,516,716,31,747
公投第１５案,臺北市,大安區,大學里,1352,1337,344,474,818,30,848
公投第１５案,臺北市,大安區,芳和里,1353,1417,299,479,778,20,798
公投第１５案,臺北市,大安區,芳和里,1354,1250,258,432,690,41,731
公投第１５案,臺北市,大安區,芳和里,1355,1176,252,405,657,27,684
公投第１５案,臺北市,大安區,芳和里,1356,1257,274,476,750,36,786
公投第１５案,臺北市,大安區,黎元里,1357,1257,246,448,694,39,733
公投第１５案,臺北市,大安區,黎元里,1358,1148,267,390,657,28,685
公投第１５案,臺北市,大安區,黎元里,1359,1418,305,476,781,35,816
公投第１５案,臺北市,大安區,黎元里,1360,1028,226,345,571,23,594
公投第１５案,臺北市,大安區,黎孝里,1361,1445,356,484,840,29,869
公投第１５案,臺北市,大安區,黎孝里,1362,1361,321,458,779,36,815
公投第１５案,臺北市,大安區,黎孝里,1363,1343,268,527,795,33,828
公投第１５案,臺北市,大安區,黎孝里,1364,1267,287,430,717,39,756
公投第１５案,臺北市,大安區,黎孝里,1365,1380,300,441,741,24,765
公投第１５案,臺北市,大安區,黎和里,1366,1524,307,523,830,37,867
公投第１５案,臺北市,大安區,黎和里,1367,1470,319,531,850,29,879
公投第１５案,臺北市,大安區,黎和里,1368,1318,240,412,652,48,700
公投第１５案,臺北市,大安區,建安里,1369,1430,297,449,746,33,779
公投第１５案,臺北市,大安區,建安里,1370,1386,292,476,768,34,802
公投第１５案,臺北市,大安區,建安里,1371,1438,278,472,750,25,775
公投第１５案,臺北市,大安區,建倫里,1372,1270,236,412,648,22,670
公投第１５案,臺北市,大安區,建倫里,1373,1395,290,451,741,40,781
公投第１５案,臺北市,大安區,建倫里,1374,1292,253,469,722,23,745
公投第１５案,臺北市,大安區,建倫里,1375,1310,303,399,702,34,736
公投第１５案,臺北市,大安區,敦安里,1376,1319,270,456,726,32,758
公投第１５案,臺北市,大安區,敦安里,1377,1355,309,455,764,25,789
公投第１５案,臺北市,大安區,敦安里,1378,1312,261,432,693,18,711
公投第１５案,臺北市,大安區,敦安里,1379,1335,282,452,734,27,761
公投第１５案,臺北市,大安區,正聲里,1380,1489,296,471,767,29,796
公投第１５案,臺北市,大安區,正聲里,1381,1307,291,455,746,24,770
公投第１５案,臺北市,大安區,正聲里,1382,1328,251,430,681,21,702
公投第１５案,臺北市,大安區,敦煌里,1383,1277,269,418,687,7,694
公投第１５案,臺北市,大安區,敦煌里,1384,1314,296,433,729,32,761
公投第１５案,臺北市,大安區,敦煌里,1385,1270,291,446,737,31,768
公投第１５案,臺北市,大安區,敦煌里,1386,1308,302,420,722,39,761
公投第１５案,臺北市,大安區,華聲里,1387,1138,272,395,667,20,687
公投第１５案,臺北市,大安區,華聲里,1388,1333,268,446,714,31,745
公投第１５案,臺北市,大安區,華聲里,1389,1176,275,383,658,30,688
公投第１５案,臺北市,大安區,車層里,1390,1311,275,443,718,40,758
公投第１５案,臺北市,大安區,車層里,1391,1295,227,475,702,20,722
公投第１５案,臺北市,大安區,車層里,1392,1421,289,505,794,41,835
公投第１５案,臺北市,大安區,車層里,1393,1409,284,467,751,32,783
公投第１５案,臺北市,大安區,光信里,1394,1434,301,506,807,34,841
公投第１５案,臺北市,大安區,光信里,1395,1449,285,438,723,59,782
公投第１５案,臺北市,大安區,光信里,1396,1284,298,438,736,24,760
公投第１５案,臺北市,大安區,光信里,1397,1248,269,429,698,19,717
公投第１５案,臺北市,大安區,光信里,1398,1119,273,445,718,22,740
公投第１５案,臺北市,大安區,學府里,1399,883,196,315,511,27,538
公投第１５案,臺北市,大安區,學府里,1400,630,92,231,323,39,362
公投第１５案,臺北市,大安區,學府里,1401,814,183,267,450,34,484
公投第１５案,臺北市,文山區,景行里,1402,1539,328,508,836,35,871
公投第１５案,臺北市,文山區,景行里,1403,1548,289,530,819,22,841
公投第１５案,臺北市,文山區,景行里,1404,1493,314,535,849,57,906
公投第１５案,臺北市,文山區,景行里,1405,1648,360,598,958,41,999
公投第１５案,臺北市,文山區,景東里,1406,1544,321,538,859,40,899
公投第１５案,臺北市,文山區,景東里,1407,1557,298,575,873,36,909
公投第１５案,臺北市,文山區,景東里,1408,1514,314,517,831,34,865
公投第１５案,臺北市,文山區,景東里,1409,1540,339,607,946,43,989
公投第１５案,臺北市,文山區,景美里,1410,1466,325,552,877,30,907
公投第１５案,臺北市,文山區,景美里,1411,1444,327,531,858,39,897
公投第１５案,臺北市,文山區,景美里,1412,1455,303,532,835,51,886
公投第１５案,臺北市,文山區,景慶里,1413,1440,264,514,778,30,808
公投第１５案,臺北市,文山區,景慶里,1414,1398,276,551,827,35,862
公投第１５案,臺北市,文山區,景慶里,1415,1412,309,472,781,19,800
公投第１５案,臺北市,文山區,景慶里,1416,1426,292,499,791,43,834
公投第１５案,臺北市,文山區,景仁里,1417,1437,325,496,821,36,857
公投第１５案,臺北市,文山區,景仁里,1418,1340,284,494,778,31,809
公投第１５案,臺北市,文山區,景仁里,1419,1568,345,549,894,24,918
公投第１５案,臺北市,文山區,景華里,1420,1372,256,510,766,29,795
公投第１５案,臺北市,文山區,景華里,1421,1046,227,360,587,30,617
公投第１５案,臺北市,文山區,景華里,1422,1274,281,434,715,48,763
公投第１５案,臺北市,文山區,景華里,1423,1324,265,491,756,25,781
公投第１５案,臺北市,文山區,萬有里,1424,1722,336,603,939,43,982
公投第１５案,臺北市,文山區,萬有里,1425,1737,367,638,1005,43,1048
公投第１５案,臺北市,文山區,萬有里,1426,1370,323,511,834,24,858
公投第１５案,臺北市,文山區,萬祥里,1427,1495,341,498,839,43,882
公投第１５案,臺北市,文山區,萬祥里,1428,1328,297,475,772,35,807
公投第１５案,臺北市,文山區,萬祥里,1429,1138,257,442,699,35,734
公投第１５案,臺北市,文山區,萬隆里,1430,1471,306,561,867,30,897
公投第１５案,臺北市,文山區,萬隆里,1431,1144,260,437,697,22,719
公投第１５案,臺北市,文山區,萬隆里,1432,1176,271,444,715,39,754
公投第１５案,臺北市,文山區,萬隆里,1433,1212,265,466,731,36,767
公投第１５案,臺北市,文山區,萬隆里,1434,1214,271,474,745,32,777
公投第１５案,臺北市,文山區,萬年里,1435,1170,259,384,643,30,673
公投第１５案,臺北市,文山區,萬年里,1436,1308,296,474,770,33,803
公投第１５案,臺北市,文山區,萬年里,1437,1190,272,425,697,34,731
公投第１５案,臺北市,文山區,萬年里,1438,1110,235,400,635,28,663
公投第１５案,臺北市,文山區,萬和里,1439,1512,313,543,856,44,900
公投第１５案,臺北市,文山區,萬和里,1440,1387,256,567,823,38,861
公投第１５案,臺北市,文山區,萬盛里,1441,1355,297,469,766,44,810
公投第１５案,臺北市,文山區,萬盛里,1442,1370,318,462,780,47,827
公投第１５案,臺北市,文山區,萬盛里,1443,1484,304,543,847,32,879
公投第１５案,臺北市,文山區,興豐里,1444,1786,372,618,990,46,1036
公投第１５案,臺北市,文山區,興豐里,1445,1260,248,478,726,45,771
公投第１５案,臺北市,文山區,興豐里,1446,1194,310,452,762,22,784
公投第１５案,臺北市,文山區,興邦里,1447,1444,265,554,819,39,858
公投第１５案,臺北市,文山區,興邦里,1448,1495,317,546,863,34,897
公投第１５案,臺北市,文山區,興邦里,1449,1446,297,554,851,42,893
公投第１５案,臺北市,文山區,興光里,1450,1450,302,494,796,60,856
公投第１５案,臺北市,文山區,興光里,1451,1486,330,558,888,30,918
公投第１５案,臺北市,文山區,興家里,1452,1259,282,456,738,29,767
公投第１５案,臺北市,文山區,興家里,1453,1317,274,517,791,26,817
公投第１５案,臺北市,文山區,興家里,1454,1321,304,494,798,31,829
公投第１５案,臺北市,文山區,興家里,1455,1475,318,511,829,35,864
公投第１５案,臺北市,文山區,興家里,1456,1271,269,436,705,30,735
公投第１５案,臺北市,文山區,興得里,1457,1609,354,578,932,40,972
公投第１５案,臺北市,文山區,興得里,1458,1501,288,532,820,21,841
公投第１５案,臺北市,文山區,興得里,1459,997,198,327,525,29,554
公投第１５案,臺北市,文山區,興得里,1460,1052,254,391,645,38,683
公投第１５案,臺北市,文山區,興業里,1461,1247,266,475,741,26,767
公投第１５案,臺北市,文山區,興業里,1462,1167,264,432,696,36,732
公投第１５案,臺北市,文山區,興業里,1463,1280,264,507,771,25,796
公投第１５案,臺北市,文山區,興業里,1464,1153,244,434,678,38,716
公投第１５案,臺北市,文山區,興安里,1465,1557,360,555,915,41,956
公投第１５案,臺北市,文山區,興安里,1466,1444,248,567,815,48,863
公投第１５案,臺北市,文山區,興安里,1467,1459,344,569,913,34,947
公投第１５案,臺北市,文山區,興安里,1468,1357,282,557,839,28,867
公投第１５案,臺北市,文山區,興福里,1469,1194,281,479,760,26,786
公投第１５案,臺北市,文山區,興福里,1470,1184,270,349,619,45,664
公投第１５案,臺北市,文山區,興福里,1471,1119,269,428,697,22,719
公投第１５案,臺北市,文山區,興福里,1472,1350,304,534,838,41,879
公投第１５案,臺北市,文山區,興旺里,1473,1502,266,548,814,33,847
公投第１５案,臺北市,文山區,興旺里,1474,1511,308,571,879,35,914
公投第１５案,臺北市,文山區,興旺里,1475,1481,359,549,908,29,937
公投第１５案,臺北市,文山區,興旺里,1476,1477,321,600,921,21,942
公投第１５案,臺北市,文山區,興旺里,1477,1294,282,498,780,24,804
公投第１５案,臺北市,文山區,興泰里,1478,1040,239,445,684,25,709
公投第１５案,臺北市,文山區,興泰里,1479,1323,293,511,804,32,836
公投第１５案,臺北市,文山區,興泰里,1480,1153,279,401,680,42,722
公投第１５案,臺北市,文山區,興昌里,1481,1525,300,576,876,25,901
公投第１５案,臺北市,文山區,興昌里,1482,1412,258,499,757,35,792
公投第１５案,臺北市,文山區,興昌里,1483,1473,377,522,899,33,932
公投第１５案,臺北市,文山區,興昌里,1484,1486,400,473,873,28,901
公投第１５案,臺北市,文山區,試院里,1485,1616,353,621,974,41,1015
公投第１５案,臺北市,文山區,試院里,1486,1489,306,595,901,45,946
公投第１５案,臺北市,文山區,試院里,1487,1414,287,516,803,38,841
公投第１５案,臺北市,文山區,試院里,1488,1494,367,549,916,41,957
公投第１５案,臺北市,文山區,華興里,1489,1547,339,583,922,40,962
公投第１５案,臺北市,文山區,華興里,1490,1587,338,584,922,50,972
公投第１５案,臺北市,文山區,華興里,1491,1515,337,606,943,26,969
公投第１５案,臺北市,文山區,華興里,1492,1573,360,597,957,32,989
公投第１５案,臺北市,文山區,華興里,1493,1542,363,552,915,41,956
公投第１５案,臺北市,文山區,明義里,1494,1465,284,479,763,45,808
公投第１５案,臺北市,文山區,明義里,1495,699,132,174,306,38,344
公投第１５案,臺北市,文山區,明義里,1496,1372,263,400,663,52,715
公投第１５案,臺北市,文山區,明興里,1497,1448,283,424,707,40,747
公投第１５案,臺北市,文山區,明興里,1498,1548,293,573,866,43,909
公投第１５案,臺北市,文山區,明興里,1499,1501,342,531,873,28,901
公投第１５案,臺北市,文山區,明興里,1500,1560,361,562,923,45,968
公投第１５案,臺北市,文山區,木柵里,1501,1567,336,568,904,33,937
公投第１５案,臺北市,文山區,木柵里,1502,1554,367,525,892,26,918
公投第１５案,臺北市,文山區,木柵里,1503,1544,306,567,873,44,917
公投第１５案,臺北市,文山區,木柵里,1504,1528,335,574,909,43,952
公投第１５案,臺北市,文山區,木柵里,1505,1543,317,626,943,23,966
公投第１５案,臺北市,文山區,木新里,1506,2754,365,551,916,47,963
公投第１５案,臺北市,文山區,木新里,1507,1709,322,520,842,54,896
公投第１５案,臺北市,文山區,木新里,1508,1515,290,522,812,58,870
公投第１５案,臺北市,文山區,木新里,1509,1571,305,521,826,37,863
公投第１５案,臺北市,文山區,木新里,1510,1578,370,502,872,38,910
公投第１５案,臺北市,文山區,順興里,1511,1454,282,498,780,43,823
公投第１５案,臺北市,文山區,順興里,1512,1436,298,518,816,41,857
公投第１５案,臺北市,文山區,順興里,1513,1402,304,530,834,46,880
公投第１５案,臺北市,文山區,順興里,1514,1117,256,410,666,37,703
公投第１５案,臺北市,文山區,順興里,1515,1094,245,369,614,40,654
公投第１５案,臺北市,文山區,忠順里,1516,1070,225,423,648,41,689
公投第１５案,臺北市,文山區,忠順里,1517,1319,284,539,823,28,851
公投第１５案,臺北市,文山區,忠順里,1518,1226,266,481,747,31,778
公投第１５案,臺北市,文山區,樟林里,1519,1385,284,464,748,25,773
公投第１５案,臺北市,文山區,樟林里,1520,1416,330,483,813,41,854
公投第１５案,臺北市,文山區,樟林里,1521,1412,310,559,869,37,906
公投第１５案,臺北市,文山區,樟林里,1522,1535,299,512,811,59,870
公投第１５案,臺北市,文山區,樟林里,1523,1654,339,653,992,52,1044
公投第１５案,臺北市,文山區,樟新里,1524,1156,262,451,713,23,736
公投第１５案,臺北市,文山區,樟新里,1525,1231,297,462,759,24,783
公投第１５案,臺北市,文山區,樟新里,1526,1218,233,462,695,35,730
公投第１５案,臺北市,文山區,樟新里,1527,1176,289,446,735,25,760
公投第１５案,臺北市,文山區,樟文里,1528,1392,421,431,852,5,857
公投第１５案,臺北市,文山區,樟文里,1529,1323,287,424,711,73,784
公投第１５案,臺北市,文山區,樟文里,1530,1297,263,458,721,31,752
公投第１５案,臺北市,文山區,樟文里,1531,1296,298,475,773,40,813
公投第１５案,臺北市,文山區,樟腳里,1532,1613,300,580,880,37,917
公投第１５案,臺北市,文山區,樟腳里,1533,1697,373,610,983,49,1032
公投第１５案,臺北市,文山區,樟腳里,1534,1579,359,544,903,42,945
公投第１５案,臺北市,文山區,樟樹里,1535,1320,322,478,800,41,841
公投第１５案,臺北市,文山區,樟樹里,1536,1438,323,509,832,26,858
公投第１５案,臺北市,文山區,樟樹里,1537,1465,275,508,783,26,809
公投第１５案,臺北市,文山區,萬芳里,1538,1646,398,547,945,34,979
公投第１５案,臺北市,文山區,萬芳里,1539,1286,278,467,745,39,784
公投第１５案,臺北市,文山區,萬芳里,1540,1219,296,426,722,24,746
公投第１５案,臺北市,文山區,萬芳里,1541,1292,284,485,769,33,802
公投第１５案,臺北市,文山區,萬芳里,1542,1489,283,535,818,44,862
公投第１５案,臺北市,文山區,萬美里,1543,1611,429,526,955,34,989
公投第１５案,臺北市,文山區,萬美里,1544,1549,294,476,770,37,807
公投第１５案,臺北市,文山區,萬美里,1545,1678,333,585,918,37,955
公投第１５案,臺北市,文山區,萬美里,1546,1660,334,570,904,40,944
公投第１５案,臺北市,文山區,博嘉里,1547,1816,363,527,890,25,915
公投第１５案,臺北市,文山區,博嘉里,1548,985,220,322,542,22,564
公投第１５案,臺北市,文山區,博嘉里,1549,1314,303,492,795,19,814
公投第１５案,臺北市,文山區,博嘉里,1550,1018,395,241,636,28,664
公投第１５案,臺北市,文山區,萬興里,1551,1578,362,552,914,28,942
公投第１５案,臺北市,文山區,萬興里,1552,1457,328,500,828,26,854
公投第１５案,臺北市,文山區,萬興里,1553,1326,275,511,786,38,824
公投第１５案,臺北市,文山區,萬興里,1554,1393,306,524,830,33,863
公投第１５案,臺北市,文山區,萬興里,1555,1377,305,440,745,46,791
公投第１５案,臺北市,文山區,政大里,1556,1448,378,459,837,35,872
公投第１５案,臺北市,文山區,政大里,1557,1447,353,532,885,35,920
公投第１５案,臺北市,文山區,政大里,1558,1739,460,634,1094,42,1136
公投第１５案,臺北市,文山區,政大里,1559,1457,381,486,867,19,886
公投第１５案,臺北市,文山區,指南里,1560,1288,313,464,777,39,816
公投第１５案,臺北市,文山區,指南里,1561,1301,269,411,680,38,718
公投第１５案,臺北市,文山區,指南里,1562,865,158,277,435,44,479
公投第１５案,臺北市,文山區,老泉里,1563,789,144,268,412,29,441
公投第１５案,高雄市,桃源區,梅山里,1,264,41,73,114,2,116
公投第１５案,高雄市,桃源區,拉芙蘭里,2,233,26,133,159,13,172
公投第１５案,高雄市,桃源區,復興里,3,279,25,161,186,7,193
公投第１５案,高雄市,桃源區,勤和里,4,223,19,94,113,5,118
公投第１５案,高雄市,桃源區,桃源里,5,783,76,285,361,13,374
公投第１５案,高雄市,桃源區,高中里,6,632,64,218,282,7,289
公投第１５案,高雄市,桃源區,建山里,7,612,65,323,388,28,416
公投第１５案,高雄市,桃源區,寶山里,8,472,69,163,232,25,257
公投第１５案,高雄市,那瑪夏區,達卡努瓦里,9,741,94,273,367,31,398
公投第１５案,高雄市,那瑪夏區,達卡努瓦里,10,585,92,276,368,54,422
公投第１５案,高雄市,那瑪夏區,瑪雅里,11,609,65,377,442,30,472
公投第１５案,高雄市,那瑪夏區,南沙魯里,12,489,32,258,290,7,297
公投第１５案,高雄市,甲仙區,東安里,13,472,37,132,169,7,176
公投第１５案,高雄市,甲仙區,西安里,14,882,136,360,496,58,554
公投第１５案,高雄市,甲仙區,和安里,15,668,98,227,325,31,356
公投第１５案,高雄市,甲仙區,大田里,16,1581,211,478,689,106,795
公投第１５案,高雄市,甲仙區,寶隆里,17,673,65,161,226,15,241
公投第１５案,高雄市,甲仙區,關山里,18,607,69,183,252,41,293
公投第１５案,高雄市,甲仙區,小林里,19,534,90,161,251,21,272
公投第１５案,高雄市,六龜區,新威里,20,760,123,231,354,23,377
公投第１５案,高雄市,六龜區,新興里,21,666,79,190,269,38,307
公投第１５案,高雄市,六龜區,新寮里,22,704,118,235,353,51,404
公投第１５案,高雄市,六龜區,新發里,23,1003,138,314,452,58,510
公投第１５案,高雄市,六龜區,荖濃里,24,1382,145,414,559,108,667
公投第１５案,高雄市,六龜區,六龜里,25,986,111,244,355,63,418
公投第１５案,高雄市,六龜區,義寶里,26,1046,153,330,483,47,530
公投第１５案,高雄市,六龜區,興龍里,27,812,109,219,328,51,379
公投第１５案,高雄市,六龜區,中興里,28,1431,171,429,600,64,664
公投第１５案,高雄市,六龜區,寶來里,29,912,91,320,411,69,480
公投第１５案,高雄市,六龜區,文武里,30,1472,180,368,548,52,600
公投第１５案,高雄市,六龜區,大津里,31,327,33,92,125,18,143
公投第１５案,高雄市,杉林區,杉林里,32,640,64,191,255,63,318
公投第１５案,高雄市,杉林區,木梓里,33,696,63,225,288,27,315
公投第１５案,高雄市,杉林區,集來里,34,1284,119,318,437,47,484
公投第１５案,高雄市,杉林區,新庄里,35,1027,112,295,407,37,444
公投第１５案,高雄市,杉林區,新庄里,36,482,55,83,138,27,165
公投第１５案,高雄市,杉林區,上平里,37,1627,237,562,799,112,911
公投第１５案,高雄市,杉林區,月眉里,38,1630,183,511,694,31,725
公投第１５案,高雄市,杉林區,大愛里,39,973,110,231,341,21,362
公投第１５案,高雄市,杉林區,大愛里,40,987,105,280,385,19,404
公投第１５案,高雄市,杉林區,月美里,41,1261,389,202,591,76,667
公投第１５案,高雄市,內門區,溝坪里,42,969,91,312,403,56,459
公投第１５案,高雄市,內門區,金竹里,43,652,89,158,247,18,265
公投第１５案,高雄市,內門區,永富里,44,961,135,301,436,74,510
公投第１５案,高雄市,內門區,永吉里,45,426,37,131,168,9,177
公投第１５案,高雄市,內門區,永興里,46,398,42,125,167,18,185
公投第１５案,高雄市,內門區,石坑里,47,508,69,145,214,17,231
公投第１５案,高雄市,內門區,內門里,48,980,148,371,519,54,573
公投第１５案,高雄市,內門區,內豊里,49,1225,151,347,498,39,537
公投第１５案,高雄市,內門區,觀亭里,50,1722,279,532,811,144,955
公投第１５案,高雄市,內門區,中埔里,51,560,86,163,249,26,275
公投第１５案,高雄市,內門區,內東里,52,801,99,223,322,23,345
公投第１５案,高雄市,內門區,內南里,53,423,58,143,201,15,216
公投第１５案,高雄市,內門區,東埔里,54,497,73,136,209,27,236
公投第１５案,高雄市,內門區,三平里,55,677,84,220,304,25,329
公投第１５案,高雄市,內門區,木柵里,56,593,46,164,210,15,225
公投第１５案,高雄市,內門區,內興里,57,597,71,158,229,42,271
公投第１５案,高雄市,內門區,瑞山里,58,343,35,104,139,10,149
公投第１５案,高雄市,內門區,光興里,59,670,102,232,334,33,367
公投第１５案,高雄市,旗山區,太平里,60,1060,196,393,589,49,638
公投第１５案,高雄市,旗山區,太平里,61,1125,160,390,550,41,591
公投第１５案,高雄市,旗山區,大德里,62,1100,198,436,634,38,672
公投第１５案,高雄市,旗山區,大德里,63,1238,238,486,724,26,750
公投第１５案,高雄市,旗山區,湄洲里,64,933,163,368,531,22,553
公投第１５案,高雄市,旗山區,湄洲里,65,727,125,236,361,15,376
公投第１５案,高雄市,旗山區,圓富里,66,1071,180,375,555,51,606
公投第１５案,高雄市,旗山區,圓富里,67,744,130,231,361,30,391
公投第１５案,高雄市,旗山區,中正里,68,1100,156,353,509,29,538
公投第１５案,高雄市,旗山區,中正里,69,369,49,126,175,20,195
公投第１５案,高雄市,旗山區,大林里,70,888,105,283,388,11,399
公投第１５案,高雄市,旗山區,大林里,71,510,70,140,210,10,220
公投第１５案,高雄市,旗山區,上洲里,72,1042,167,394,561,89,650
公投第１５案,高雄市,旗山區,新光里,73,791,103,284,387,45,432
公投第１５案,高雄市,旗山區,南勝里,74,939,163,335,498,69,567
公投第１５案,高雄市,旗山區,南勝里,75,1218,200,375,575,50,625
公投第１５案,高雄市,旗山區,中寮里,76,178,21,57,78,20,98
公投第１５案,高雄市,旗山區,東平里,77,946,167,377,544,47,591
公投第１５案,高雄市,旗山區,東平里,78,1025,185,345,530,40,570
公投第１５案,高雄市,旗山區,東昌里,79,1040,479,98,577,123,700
公投第１５案,高雄市,旗山區,竹峰里,80,900,188,338,526,50,576
公投第１５案,高雄市,旗山區,竹峰里,81,663,114,212,326,22,348
公投第１５案,高雄市,旗山區,瑞吉里,82,954,157,335,492,48,540
公投第１５案,高雄市,旗山區,瑞吉里,83,1060,197,350,547,29,576
公投第１５案,高雄市,旗山區,永和里,84,1110,198,415,613,54,667
公投第１５案,高雄市,旗山區,永和里,85,1062,204,377,581,52,633
公投第１５案,高雄市,旗山區,永和里,86,1151,195,422,617,41,658
公投第１５案,高雄市,旗山區,三協里,87,266,42,103,145,21,166
公投第１５案,高雄市,旗山區,三協里,88,633,115,255,370,23,393
公投第１５案,高雄市,旗山區,三協里,89,1307,116,401,517,30,547
公投第１５案,高雄市,旗山區,鯤洲里,90,754,130,240,370,64,434
公投第１５案,高雄市,旗山區,大山里,91,1296,215,416,631,109,740
公投第１５案,高雄市,旗山區,中洲里,92,839,120,246,366,19,385
公投第１５案,高雄市,旗山區,南洲里,93,1329,207,485,692,66,758
公投第１５案,高雄市,旗山區,廣福里,94,628,201,142,343,30,373
公投第１５案,高雄市,美濃區,福安里,95,1175,186,429,615,79,694
公投第１５案,高雄市,美濃區,福安里,96,1438,189,496,685,29,714
公投第１５案,高雄市,美濃區,合和里,97,989,116,354,470,42,512
公投第１５案,高雄市,美濃區,合和里,98,1427,211,566,777,62,839
公投第１５案,高雄市,美濃區,祿興里,99,1309,195,483,678,56,734
公投第１５案,高雄市,美濃區,祿興里,100,1263,192,517,709,63,772
公投第１５案,高雄市,美濃區,中壇里,101,997,146,411,557,51,608
公投第１５案,高雄市,美濃區,中壇里,102,1064,157,390,547,67,614
公投第１５案,高雄市,美濃區,德興里,103,1498,211,558,769,65,834
公投第１５案,高雄市,美濃區,龍山里,104,1119,145,436,581,76,657
公投第１５案,高雄市,美濃區,龍山里,105,1031,128,409,537,65,602
公投第１５案,高雄市,美濃區,獅山里,106,1437,179,512,691,72,763
公投第１５案,高雄市,美濃區,獅山里,107,1071,174,391,565,43,608
公投第１５案,高雄市,美濃區,龍肚里,108,687,73,278,351,35,386
公投第１５案,高雄市,美濃區,龍肚里,109,775,77,239,316,25,341
公投第１５案,高雄市,美濃區,廣德里,110,1353,182,442,624,75,699
公投第１５案,高雄市,美濃區,興隆里,111,1191,172,372,544,48,592
公投第１５案,高雄市,美濃區,中圳里,112,906,114,289,403,41,444
公投第１５案,高雄市,美濃區,中圳里,113,1178,176,475,651,46,697
公投第１５案,高雄市,美濃區,東門里,114,1252,168,416,584,31,615
公投第１５案,高雄市,美濃區,泰安里,115,1549,229,597,826,49,875
公投第１５案,高雄市,美濃區,瀰濃里,116,1088,124,398,522,47,569
公投第１５案,高雄市,美濃區,瀰濃里,117,1116,170,433,603,32,635
公投第１５案,高雄市,美濃區,清水里,118,977,164,326,490,37,527
公投第１５案,高雄市,美濃區,清水里,119,816,148,309,457,55,512
公投第１５案,高雄市,美濃區,吉洋里,120,955,105,317,422,26,448
公投第１５案,高雄市,美濃區,吉洋里,121,943,142,350,492,59,551
公投第１５案,高雄市,美濃區,吉和里,122,1371,180,506,686,39,725
公投第１５案,高雄市,美濃區,吉東里,123,919,136,322,458,54,512
公投第１５案,高雄市,美濃區,吉東里,124,915,141,377,518,46,564
公投第１５案,高雄市,美濃區,廣林里,125,828,116,271,387,70,457
公投第１５案,高雄市,美濃區,廣林里,126,674,76,189,265,56,321
公投第１５案,高雄市,茂林區,多納里,127,507,76,259,335,21,356
公投第１５案,高雄市,茂林區,萬山里,128,382,70,184,254,14,268
公投第１５案,高雄市,茂林區,茂林里,129,726,100,369,469,17,486
公投第１５案,高雄市,茄萣區,福德里,130,976,156,301,457,19,476
公投第１５案,高雄市,茄萣區,萬福里,131,887,147,280,427,59,486
公投第１５案,高雄市,茄萣區,白雲里,132,1710,262,592,854,38,892
公投第１５案,高雄市,茄萣區,嘉賜里,133,1280,152,385,537,48,585
公投第１５案,高雄市,茄萣區,嘉賜里,134,1314,227,508,735,29,764
公投第１５案,高雄市,茄萣區,嘉賜里,135,1157,219,480,699,25,724
公投第１５案,高雄市,茄萣區,嘉安里,136,1785,615,288,903,87,990
公投第１５案,高雄市,茄萣區,嘉樂里,137,838,133,290,423,65,488
公投第１５案,高雄市,茄萣區,嘉樂里,138,1249,247,508,755,47,802
公投第１５案,高雄市,茄萣區,嘉泰里,139,1116,202,335,537,76,613
公投第１５案,高雄市,茄萣區,嘉福里,140,978,165,297,462,51,513
公投第１５案,高雄市,茄萣區,和協里,141,1125,157,333,490,35,525
公投第１５案,高雄市,茄萣區,嘉定里,142,1139,197,373,570,54,624
公投第１５案,高雄市,茄萣區,保定里,143,1363,219,461,680,86,766
公投第１５案,高雄市,茄萣區,保定里,144,1598,274,582,856,88,944
公投第１５案,高雄市,茄萣區,大定里,145,1111,167,377,544,52,596
公投第１５案,高雄市,茄萣區,光定里,146,925,114,280,394,43,437
公投第１５案,高雄市,茄萣區,吉定里,147,1148,186,388,574,52,626
公投第１５案,高雄市,茄萣區,崎漏里,148,1353,186,468,654,35,689
公投第１５案,高雄市,茄萣區,崎漏里,149,1331,200,471,671,60,731
公投第１５案,高雄市,茄萣區,崎漏里,150,1829,285,549,834,62,896
公投第１５案,高雄市,湖內區,海山里,151,1112,142,388,530,42,572
公投第１５案,高雄市,湖內區,劉家里,152,1017,160,351,511,77,588
公投第１５案,高雄市,湖內區,太爺里,153,796,153,249,402,25,427
公投第１５案,高雄市,湖內區,公舘里,154,1079,231,412,643,30,673
公投第１５案,高雄市,湖內區,公舘里,155,1115,199,398,597,34,631
公投第１５案,高雄市,湖內區,葉厝里,156,1311,100,575,675,38,713
公投第１５案,高雄市,湖內區,葉厝里,157,1319,223,438,661,30,691
公投第１５案,高雄市,湖內區,大湖里,158,1244,226,509,735,56,791
公投第１５案,高雄市,湖內區,大湖里,159,1227,214,522,736,42,778
公投第１５案,高雄市,湖內區,大湖里,160,1163,197,460,657,56,713
公投第１５案,高雄市,湖內區,田尾里,161,981,181,371,552,46,598
公投第１５案,高雄市,湖內區,湖內里,162,780,127,279,406,18,424
公投第１５案,高雄市,湖內區,湖內里,163,832,127,303,430,44,474
公投第１５案,高雄市,湖內區,湖內里,164,1017,200,405,605,37,642
公投第１５案,高雄市,湖內區,湖內里,165,1051,219,379,598,17,615
公投第１５案,高雄市,湖內區,海埔里,166,941,155,334,489,29,518
公投第１５案,高雄市,湖內區,海埔里,167,863,131,307,438,49,487
公投第１５案,高雄市,湖內區,文賢里,168,1160,223,354,577,53,630
公投第１５案,高雄市,湖內區,中賢里,169,1090,168,282,450,34,484
公投第１５案,高雄市,湖內區,中賢里,170,1122,213,376,589,57,646
公投第１５案,高雄市,湖內區,逸賢里,171,1123,182,341,523,28,551
公投第１５案,高雄市,湖內區,忠興里,172,684,115,240,355,28,383
公投第１５案,高雄市,湖內區,湖東里,173,1249,183,418,601,24,625
公投第１５案,高雄市,湖內區,湖東里,174,1453,220,457,677,48,725
公投第１５案,高雄市,路竹區,竹滬里,175,1026,172,350,522,25,547
公投第１５案,高雄市,路竹區,竹滬里,176,1069,187,382,569,62,631
公投第１５案,高雄市,路竹區,竹滬里,177,1127,204,427,631,60,691
公投第１５案,高雄市,路竹區,頂寮里,178,1179,157,462,619,57,676
公投第１５案,高雄市,路竹區,新達里,179,1237,213,411,624,78,702
公投第１５案,高雄市,路竹區,後鄉里,180,1096,211,403,614,47,661
公投第１５案,高雄市,路竹區,北嶺里,181,1272,240,499,739,65,804
公投第１５案,高雄市,路竹區,社西里,182,1182,183,456,639,58,697
公投第１５案,高雄市,路竹區,社西里,183,1127,183,416,599,56,655
公投第１５案,高雄市,路竹區,甲北里,184,956,187,339,526,49,575
公投第１５案,高雄市,路竹區,甲北里,185,1132,210,392,602,64,666
公投第１５案,高雄市,路竹區,甲南里,186,1025,193,377,570,86,656
公投第１５案,高雄市,路竹區,甲南里,187,1007,172,367,539,27,566
公投第１５案,高雄市,路竹區,甲南里,188,1301,214,425,639,60,699
公投第１５案,高雄市,路竹區,下坑里,189,885,141,333,474,39,513
公投第１５案,高雄市,路竹區,下坑里,190,837,139,255,394,18,412
公投第１５案,高雄市,路竹區,下坑里,191,930,184,334,518,47,565
公投第１５案,高雄市,路竹區,竹園里,192,781,130,237,367,40,407
公投第１５案,高雄市,路竹區,竹園里,193,1023,181,375,556,57,613
公投第１５案,高雄市,路竹區,竹東里,194,1763,335,648,983,73,1056
公投第１５案,高雄市,路竹區,竹東里,195,1637,294,586,880,52,932
公投第１５案,高雄市,路竹區,竹西里,196,1070,182,381,563,44,607
公投第１５案,高雄市,路竹區,竹西里,197,1177,208,460,668,59,727
公投第１５案,高雄市,路竹區,文北里,198,1007,188,363,551,43,594
公投第１５案,高雄市,路竹區,文北里,199,1026,199,357,556,41,597
公投第１５案,高雄市,路竹區,文北里,200,1017,171,388,559,39,598
公投第１５案,高雄市,路竹區,文南里,201,1264,250,450,700,37,737
公投第１５案,高雄市,路竹區,文南里,202,1089,197,422,619,50,669
公投第１５案,高雄市,路竹區,三爺里,203,851,157,304,461,36,497
公投第１５案,高雄市,路竹區,鴨寮里,204,1011,186,367,553,77,630
公投第１５案,高雄市,路竹區,鴨寮里,205,937,173,398,571,36,607
公投第１５案,高雄市,路竹區,社東里,206,820,127,283,410,16,426
公投第１５案,高雄市,路竹區,社東里,207,910,204,346,550,24,574
公投第１５案,高雄市,路竹區,社中里,208,867,163,281,444,50,494
公投第１５案,高雄市,路竹區,竹南里,209,937,171,347,518,31,549
公投第１５案,高雄市,路竹區,竹南里,210,900,191,296,487,36,523
公投第１５案,高雄市,路竹區,竹南里,211,900,152,357,509,49,558
公投第１５案,高雄市,路竹區,社南里,212,918,161,365,526,36,562
公投第１５案,高雄市,路竹區,社南里,213,870,180,343,523,40,563
公投第１５案,高雄市,路竹區,社南里,214,1150,233,445,678,46,724
公投第１５案,高雄市,路竹區,社南里,215,1537,285,645,930,54,984
公投第１５案,高雄市,阿蓮區,石安里,216,1299,372,222,594,37,631
公投第１５案,高雄市,阿蓮區,中路里,217,1107,178,396,574,28,602
公投第１５案,高雄市,阿蓮區,中路里,218,898,135,305,440,22,462
公投第１５案,高雄市,阿蓮區,峯山里,219,1259,212,407,619,69,688
公投第１５案,高雄市,阿蓮區,港後里,220,1579,280,517,797,42,839
公投第１５案,高雄市,阿蓮區,港後里,221,564,103,215,318,11,329
公投第１５案,高雄市,阿蓮區,崗山里,222,768,162,288,450,48,498
公投第１５案,高雄市,阿蓮區,阿蓮里,223,1092,205,375,580,57,637
公投第１５案,高雄市,阿蓮區,阿蓮里,224,1099,192,385,577,50,627
公投第１５案,高雄市,阿蓮區,阿蓮里,225,1134,200,417,617,25,642
公投第１５案,高雄市,阿蓮區,阿蓮里,226,1561,266,507,773,24,797
公投第１５案,高雄市,阿蓮區,清蓮里,227,1533,301,540,841,64,905
公投第１５案,高雄市,阿蓮區,清蓮里,228,1116,179,351,530,37,567
公投第１５案,高雄市,阿蓮區,和蓮里,229,1054,193,363,556,27,583
公投第１５案,高雄市,阿蓮區,和蓮里,230,1260,223,415,638,49,687
公投第１５案,高雄市,阿蓮區,青旗里,231,1504,234,505,739,60,799
公投第１５案,高雄市,阿蓮區,復安里,232,848,125,256,381,21,402
公投第１５案,高雄市,阿蓮區,復安里,233,823,124,294,418,18,436
公投第１５案,高雄市,阿蓮區,玉庫里,234,1021,161,391,552,34,586
公投第１５案,高雄市,阿蓮區,南蓮里,235,1715,311,545,856,25,881
公投第１５案,高雄市,阿蓮區,南蓮里,236,1300,197,445,642,44,686
公投第１５案,高雄市,田寮區,鹿埔里,237,369,42,114,156,8,164
公投第１５案,高雄市,田寮區,南安里,238,656,94,169,263,17,280
公投第１５案,高雄市,田寮區,南安里,239,406,36,74,110,15,125
公投第１５案,高雄市,田寮區,大同里,240,380,65,101,166,26,192
公投第１５案,高雄市,田寮區,田寮里,241,379,42,146,188,15,203
公投第１５案,高雄市,田寮區,七星里,242,625,78,221,299,55,354
公投第１５案,高雄市,田寮區,崇德里,243,946,154,295,449,18,467
公投第１５案,高雄市,田寮區,西德里,244,794,93,242,335,43,378
公投第１５案,高雄市,田寮區,三和里,245,382,42,106,148,21,169
公投第１５案,高雄市,田寮區,古亭里,246,513,60,97,157,43,200
公投第１５案,高雄市,田寮區,新興里,247,601,92,195,287,21,308
公投第１５案,高雄市,田寮區,新興里,248,620,99,222,321,43,364
公投第１５案,高雄市,永安區,永安里,249,756,146,320,466,39,505
公投第１５案,高雄市,永安區,永安里,250,818,150,321,471,52,523
公投第１５案,高雄市,永安區,永華里,251,866,262,308,570,31,601
公投第１５案,高雄市,永安區,永華里,252,951,153,407,560,54,614
公投第１５案,高雄市,永安區,新港里,253,992,184,397,581,50,631
公投第１５案,高雄市,永安區,新港里,254,682,123,193,316,15,331
公投第１５案,高雄市,永安區,新港里,255,665,108,273,381,22,403
公投第１５案,高雄市,永安區,鹽田里,256,371,69,119,188,15,203
公投第１５案,高雄市,永安區,保寧里,257,1114,219,452,671,61,732
公投第１５案,高雄市,永安區,保寧里,258,1418,255,588,843,40,883
公投第１５案,高雄市,永安區,維新里,259,1477,276,600,876,79,955
公投第１５案,高雄市,永安區,維新里,260,1891,378,745,1123,69,1192
公投第１５案,高雄市,岡山區,岡山里,261,1345,285,562,847,30,877
公投第１５案,高雄市,岡山區,岡山里,262,1045,161,319,480,18,498
公投第１５案,高雄市,岡山區,岡山里,263,1051,178,439,617,27,644
公投第１５案,高雄市,岡山區,岡山里,264,917,194,355,549,16,565
公投第１５案,高雄市,岡山區,壽天里,265,934,222,365,587,28,615
公投第１５案,高雄市,岡山區,壽天里,266,1097,168,486,654,41,695
公投第１５案,高雄市,岡山區,壽天里,267,1208,207,560,767,37,804
公投第１５案,高雄市,岡山區,平安里,268,1159,224,506,730,44,774
公投第１５案,高雄市,岡山區,維仁里,269,1018,204,383,587,39,626
公投第１５案,高雄市,岡山區,大遼里,270,1316,239,437,676,28,704
公投第１５案,高雄市,岡山區,程香里,271,1345,243,513,756,35,791
公投第１５案,高雄市,岡山區,程香里,272,1295,248,518,766,40,806
公投第１５案,高雄市,岡山區,程香里,273,1425,254,557,811,35,846
公投第１５案,高雄市,岡山區,後紅里,274,1328,229,513,742,30,772
公投第１５案,高雄市,岡山區,後紅里,275,1382,249,563,812,16,828
公投第１５案,高雄市,岡山區,後紅里,276,1381,263,570,833,15,848
公投第１５案,高雄市,岡山區,碧紅里,277,1282,248,468,716,60,776
公投第１５案,高雄市,岡山區,碧紅里,278,1240,222,479,701,15,716
公投第１５案,高雄市,岡山區,碧紅里,279,1327,239,523,762,39,801
公投第１５案,高雄市,岡山區,竹圍里,280,1736,330,604,934,36,970
公投第１５案,高雄市,岡山區,竹圍里,281,1566,294,610,904,45,949
公投第１５案,高雄市,岡山區,竹圍里,282,1779,177,590,767,53,820
公投第１５案,高雄市,岡山區,竹圍里,283,1593,267,630,897,65,962
公投第１５案,高雄市,岡山區,台上里,284,1480,258,604,862,63,925
公投第１５案,高雄市,岡山區,台上里,285,1364,215,583,798,28,826
公投第１５案,高雄市,岡山區,台上里,286,1410,239,585,824,43,867
公投第１５案,高雄市,岡山區,台上里,287,1148,213,536,749,45,794
公投第１５案,高雄市,岡山區,為隨里,288,625,126,245,371,40,411
公投第１５案,高雄市,岡山區,灣裡里,289,969,198,378,576,26,602
公投第１５案,高雄市,岡山區,灣裡里,290,861,177,350,527,21,548
公投第１５案,高雄市,岡山區,本洲里,291,823,143,289,432,21,453
公投第１５案,高雄市,岡山區,本洲里,292,889,193,357,550,48,598
公投第１５案,高雄市,岡山區,前峰里,293,1283,238,502,740,39,779
公投第１５案,高雄市,岡山區,前峰里,294,1512,250,575,825,31,856
公投第１５案,高雄市,岡山區,壽峰里,295,983,200,418,618,54,672
公投第１５案,高雄市,岡山區,壽峰里,296,1262,227,504,731,36,767
公投第１５案,高雄市,岡山區,仁壽里,297,1096,215,428,643,46,689
公投第１５案,高雄市,岡山區,仁壽里,298,1066,204,413,617,34,651
公投第１５案,高雄市,岡山區,仁壽里,299,1188,204,432,636,32,668
公投第１５案,高雄市,岡山區,後協里,300,1360,280,536,816,35,851
公投第１５案,高雄市,岡山區,後協里,301,1363,254,579,833,21,854
公投第１５案,高雄市,岡山區,後協里,302,1352,327,513,840,38,878
公投第１５案,高雄市,岡山區,後協里,303,1460,254,564,818,52,870
公投第１５案,高雄市,岡山區,協和里,304,1272,248,501,749,34,783
公投第１５案,高雄市,岡山區,協和里,305,1080,206,440,646,50,696
公投第１５案,高雄市,岡山區,協和里,306,1255,231,491,722,56,778
公投第１５案,高雄市,岡山區,協榮里,307,938,162,423,585,44,629
公投第１５案,高雄市,岡山區,協榮里,308,1237,230,519,749,43,792
公投第１５案,高雄市,岡山區,劉厝里,309,1413,239,515,754,32,786
公投第１５案,高雄市,岡山區,白米里,310,765,149,306,455,13,468
公投第１５案,高雄市,岡山區,白米里,311,1043,211,445,656,29,685
公投第１５案,高雄市,岡山區,石潭里,312,844,126,294,420,35,455
公投第１５案,高雄市,岡山區,石潭里,313,993,225,467,692,39,731
公投第１５案,高雄市,岡山區,福興里,314,1038,229,379,608,67,675
公投第１５案,高雄市,岡山區,嘉興里,315,1070,169,414,583,77,660
公投第１５案,高雄市,岡山區,嘉興里,316,1023,217,415,632,61,693
公投第１５案,高雄市,岡山區,嘉興里,317,1349,233,527,760,37,797
公投第１５案,高雄市,岡山區,嘉峰里,318,1452,130,522,652,46,698
公投第１５案,高雄市,岡山區,嘉峰里,319,301,70,120,190,14,204
公投第１５案,高雄市,岡山區,潭底里,320,756,144,291,435,81,516
公投第１５案,高雄市,岡山區,華崗里,321,733,106,275,381,23,404
公投第１５案,高雄市,岡山區,華崗里,322,854,172,360,532,67,599
公投第１５案,高雄市,岡山區,三和里,323,866,110,296,406,20,426
公投第１５案,高雄市,岡山區,大莊里,324,978,207,320,527,51,578
公投第１５案,高雄市,岡山區,忠孝里,325,1336,198,584,782,35,817
公投第１５案,高雄市,岡山區,忠孝里,326,1218,153,607,760,12,772
公投第１５案,高雄市,岡山區,忠孝里,327,341,94,155,249,10,259
公投第１５案,高雄市,岡山區,仁義里,328,955,140,545,685,31,716
公投第１５案,高雄市,岡山區,仁義里,329,940,132,509,641,12,653
公投第１５案,高雄市,岡山區,信義里,330,851,167,374,541,34,575
公投第１５案,高雄市,岡山區,信義里,331,762,155,369,524,12,536
公投第１５案,高雄市,岡山區,和平里,332,318,67,163,230,10,240
公投第１５案,高雄市,燕巢區,尖山里,333,1152,171,415,586,71,657
公投第１５案,高雄市,燕巢區,瓊林里,334,1120,198,412,610,35,645
公投第１５案,高雄市,燕巢區,瓊林里,335,974,170,426,596,51,647
公投第１５案,高雄市,燕巢區,安招里,336,1019,188,371,559,17,576
公投第１５案,高雄市,燕巢區,安招里,337,1058,216,330,546,56,602
公投第１５案,高雄市,燕巢區,安招里,338,1017,160,309,469,29,498
公投第１５案,高雄市,燕巢區,安招里,339,259,11,27,38,4,42
公投第１５案,高雄市,燕巢區,角宿里,340,926,155,406,561,52,613
公投第１５案,高雄市,燕巢區,角宿里,341,624,103,211,314,14,328
公投第１５案,高雄市,燕巢區,角宿里,342,1102,192,469,661,59,720
公投第１５案,高雄市,燕巢區,鳳雄里,343,1072,166,368,534,47,581
公投第１５案,高雄市,燕巢區,鳳雄里,344,1361,265,453,718,74,792
公投第１５案,高雄市,燕巢區,金山里,345,472,68,189,257,31,288
公投第１５案,高雄市,燕巢區,東燕里,346,1197,169,428,597,45,642
公投第１５案,高雄市,燕巢區,東燕里,347,1134,205,462,667,70,737
公投第１５案,高雄市,燕巢區,南燕里,348,1148,189,413,602,36,638
公投第１５案,高雄市,燕巢區,南燕里,349,1207,202,393,595,61,656
公投第１５案,高雄市,燕巢區,南燕里,350,1402,277,586,863,40,903
公投第１５案,高雄市,燕巢區,西燕里,351,1000,194,355,549,59,608
公投第１５案,高雄市,燕巢區,西燕里,352,1110,233,389,622,59,681
公投第１５案,高雄市,燕巢區,西燕里,353,1291,245,454,699,50,749
公投第１５案,高雄市,燕巢區,橫山里,354,797,130,288,418,72,490
公投第１５案,高雄市,燕巢區,橫山里,355,1098,158,372,530,46,576
公投第１５案,高雄市,燕巢區,深水里,356,1393,209,488,697,55,752
公投第１５案,高雄市,燕巢區,深水里,357,1079,124,341,465,26,491
公投第１５案,高雄市,彌陀區,光和里,358,1246,194,487,681,67,748
公投第１５案,高雄市,彌陀區,彌靖里,359,885,164,334,498,56,554
公投第１５案,高雄市,彌陀區,彌靖里,360,955,190,399,589,64,653
公投第１５案,高雄市,彌陀區,彌仁里,361,534,92,190,282,34,316
公投第１５案,高雄市,彌陀區,彌壽里,362,738,122,300,422,28,450
公投第１５案,高雄市,彌陀區,彌陀里,363,855,157,383,540,37,577
公投第１５案,高雄市,彌陀區,彌陀里,364,877,157,363,520,48,568
公投第１５案,高雄市,彌陀區,舊港里,365,781,143,308,451,55,506
公投第１５案,高雄市,彌陀區,舊港里,366,808,164,289,453,34,487
公投第１５案,高雄市,彌陀區,文安里,367,904,126,313,439,31,470
公投第１５案,高雄市,彌陀區,文安里,368,825,155,293,448,55,503
公投第１５案,高雄市,彌陀區,過港里,369,941,129,340,469,60,529
公投第１５案,高雄市,彌陀區,鹽埕里,370,1013,203,350,553,29,582
公投第１５案,高雄市,彌陀區,鹽埕里,371,1024,179,427,606,56,662
公投第１５案,高雄市,彌陀區,海尾里,372,861,135,305,440,17,457
公投第１５案,高雄市,彌陀區,漯底里,373,1163,215,433,648,82,730
公投第１５案,高雄市,彌陀區,南寮里,374,1216,208,525,733,67,800
公投第１５案,高雄市,彌陀區,南寮里,375,861,160,399,559,69,628
公投第１５案,高雄市,梓官區,梓信里,376,1061,159,457,616,68,684
公投第１５案,高雄市,梓官區,梓信里,377,1063,195,376,571,66,637
公投第１５案,高雄市,梓官區,梓義里,378,969,187,360,547,31,578
公投第１５案,高雄市,梓官區,梓義里,379,1078,183,349,532,29,561
公投第１５案,高雄市,梓官區,梓和里,380,838,165,297,462,62,524
公投第１５案,高雄市,梓官區,梓和里,381,611,104,248,352,39,391
公投第１５案,高雄市,梓官區,梓和里,382,782,148,199,347,20,367
公投第１５案,高雄市,梓官區,梓平里,383,1451,288,589,877,66,943
公投第１５案,高雄市,梓官區,中崙里,384,1144,217,395,612,23,635
公投第１５案,高雄市,梓官區,同安里,385,975,136,368,504,23,527
公投第１５案,高雄市,梓官區,大舍里,386,1317,209,506,715,45,760
公投第１５案,高雄市,梓官區,大舍里,387,1218,218,455,673,83,756
公投第１５案,高雄市,梓官區,大舍里,388,1073,184,411,595,37,632
公投第１５案,高雄市,梓官區,赤崁里,389,1112,264,386,650,31,681
公投第１５案,高雄市,梓官區,赤崁里,390,715,135,230,365,38,403
公投第１５案,高雄市,梓官區,赤東里,391,1311,194,470,664,58,722
公投第１５案,高雄市,梓官區,赤東里,392,939,162,361,523,33,556
公投第１５案,高雄市,梓官區,赤西里,393,824,136,357,493,23,516
公投第１５案,高雄市,梓官區,禮蚵里,394,1052,174,433,607,95,702
公投第１５案,高雄市,梓官區,禮蚵里,395,1020,179,393,572,78,650
公投第１５案,高雄市,梓官區,智蚵里,396,1260,195,454,649,41,690
公投第１５案,高雄市,梓官區,智蚵里,397,1595,260,580,840,32,872
公投第１５案,高雄市,梓官區,信蚵里,398,829,128,327,455,46,501
公投第１５案,高雄市,梓官區,信蚵里,399,1532,214,585,799,27,826
公投第１５案,高雄市,梓官區,茄苳里,400,1195,206,532,738,45,783
公投第１５案,高雄市,梓官區,茄苳里,401,1143,166,450,616,79,695
公投第１５案,高雄市,梓官區,典寶里,402,1186,193,495,688,48,736
公投第１５案,高雄市,梓官區,典寶里,403,1732,239,561,800,38,838
公投第１５案,高雄市,橋頭區,橋頭里,404,1005,233,378,611,69,680
公投第１５案,高雄市,橋頭區,橋頭里,405,1073,223,423,646,42,688
公投第１５案,高雄市,橋頭區,橋南里,406,1129,217,459,676,26,702
公投第１５案,高雄市,橋頭區,仕隆里,407,1244,244,469,713,73,786
公投第１５案,高雄市,橋頭區,仕隆里,408,1091,208,400,608,32,640
公投第１５案,高雄市,橋頭區,仕豐里,409,1329,281,544,825,52,877
公投第１５案,高雄市,橋頭區,仕豐里,410,1140,226,430,656,55,711
公投第１５案,高雄市,橋頭區,芋寮里,411,1220,224,467,691,68,759
公投第１５案,高雄市,橋頭區,東林里,412,1047,213,439,652,63,715
公投第１５案,高雄市,橋頭區,東林里,413,1315,250,454,704,88,792
公投第１５案,高雄市,橋頭區,西林里,414,691,131,248,379,32,411
公投第１５案,高雄市,橋頭區,西林里,415,720,141,279,420,60,480
公投第１５案,高雄市,橋頭區,白樹里,416,1192,255,398,653,90,743
公投第１５案,高雄市,橋頭區,白樹里,417,1318,266,501,767,83,850
公投第１５案,高雄市,橋頭區,白樹里,418,761,143,311,454,40,494
公投第１５案,高雄市,橋頭區,筆秀里,419,973,188,359,547,29,576
公投第１５案,高雄市,橋頭區,筆秀里,420,587,129,204,333,32,365
公投第１５案,高雄市,橋頭區,新莊里,421,812,170,321,491,40,531
公投第１５案,高雄市,橋頭區,新莊里,422,343,73,131,204,15,219
公投第１５案,高雄市,橋頭區,新莊里,423,1266,301,497,798,24,822
公投第１５案,高雄市,橋頭區,甲北里,424,1128,198,468,666,79,745
公投第１５案,高雄市,橋頭區,甲北里,425,884,152,370,522,43,565
公投第１５案,高雄市,橋頭區,甲南里,426,1187,195,430,625,70,695
公投第１５案,高雄市,橋頭區,甲南里,427,1259,218,501,719,63,782
公投第１５案,高雄市,橋頭區,頂鹽里,428,1361,218,472,690,65,755
公投第１５案,高雄市,橋頭區,中崎里,429,671,105,230,335,29,364
公投第１５案,高雄市,橋頭區,仕和里,430,1215,265,461,726,50,776
公投第１５案,高雄市,橋頭區,仕和里,431,1255,212,524,736,72,808
公投第１５案,高雄市,橋頭區,仕和里,432,1219,258,467,725,65,790
公投第１５案,高雄市,橋頭區,德松里,433,1372,253,507,760,37,797
公投第１５案,高雄市,橋頭區,三德里,434,758,131,203,334,8,342
公投第１５案,高雄市,楠梓區,清豐里,435,1309,269,528,797,39,836
公投第１５案,高雄市,楠梓區,清豐里,436,1408,285,549,834,28,862
公投第１５案,高雄市,楠梓區,清豐里,437,1851,350,699,1049,50,1099
公投第１５案,高雄市,楠梓區,清豐里,438,1578,308,624,932,51,983
公投第１５案,高雄市,楠梓區,清豐里,439,1715,330,618,948,27,975
公投第１５案,高雄市,楠梓區,清豐里,440,1611,286,598,884,19,903
公投第１５案,高雄市,楠梓區,清豐里,441,2024,321,724,1045,63,1108
公投第１５案,高雄市,楠梓區,清豐里,442,1890,341,631,972,34,1006
公投第１５案,高雄市,楠梓區,清豐里,443,1762,312,608,920,23,943
公投第１５案,高雄市,楠梓區,清豐里,444,1888,335,645,980,53,1033
公投第１５案,高雄市,楠梓區,清豐里,445,1822,346,623,969,63,1032
公投第１５案,高雄市,楠梓區,清豐里,446,1846,355,648,1003,43,1046
公投第１５案,高雄市,楠梓區,東寧里,447,1268,243,492,735,61,796
公投第１５案,高雄市,楠梓區,東寧里,448,1240,257,496,753,41,794
公投第１５案,高雄市,楠梓區,東寧里,449,1432,305,450,755,33,788
公投第１５案,高雄市,楠梓區,五常里,450,1490,314,535,849,44,893
公投第１５案,高雄市,楠梓區,五常里,451,1464,278,581,859,50,909
公投第１５案,高雄市,楠梓區,五常里,452,1435,255,500,755,65,820
公投第１５案,高雄市,楠梓區,五常里,453,1602,255,575,830,68,898
公投第１５案,高雄市,楠梓區,享平里,454,1500,278,528,806,50,856
公投第１５案,高雄市,楠梓區,享平里,455,1591,317,536,853,74,927
公投第１５案,高雄市,楠梓區,惠楠里,456,1669,227,391,618,44,662
公投第１５案,高雄市,楠梓區,惠楠里,457,1469,296,568,864,42,906
公投第１５案,高雄市,楠梓區,中陽里,458,1559,314,514,828,71,899
公投第１５案,高雄市,楠梓區,中陽里,459,1638,297,572,869,69,938
公投第１５案,高雄市,楠梓區,惠民里,460,1960,354,721,1075,82,1157
公投第１５案,高雄市,楠梓區,惠民里,461,1912,366,690,1056,95,1151
公投第１５案,高雄市,楠梓區,惠豐里,462,1559,264,585,849,52,901
公投第１５案,高雄市,楠梓區,惠豐里,463,1423,257,505,762,45,807
公投第１５案,高雄市,楠梓區,惠豐里,464,1696,305,660,965,30,995
公投第１５案,高雄市,楠梓區,錦屏里,465,1493,261,492,753,131,884
公投第１５案,高雄市,楠梓區,錦屏里,466,1527,280,546,826,97,923
公投第１５案,高雄市,楠梓區,玉屏里,467,1020,174,415,589,58,647
公投第１５案,高雄市,楠梓區,玉屏里,468,1197,237,411,648,71,719
公投第１５案,高雄市,楠梓區,金田里,469,1528,310,466,776,72,848
公投第１５案,高雄市,楠梓區,金田里,470,1918,319,603,922,75,997
公投第１５案,高雄市,楠梓區,稔田里,471,1458,259,512,771,78,849
公投第１５案,高雄市,楠梓區,瑞屏里,472,1790,335,689,1024,81,1105
公投第１５案,高雄市,楠梓區,瑞屏里,473,1845,348,718,1066,82,1148
公投第１５案,高雄市,楠梓區,翠屏里,474,2037,402,787,1189,55,1244
公投第１５案,高雄市,楠梓區,翠屏里,475,1964,351,706,1057,56,1113
公投第１５案,高雄市,楠梓區,翠屏里,476,2006,382,756,1138,28,1166
公投第１５案,高雄市,楠梓區,翠屏里,477,1951,367,698,1065,41,1106
公投第１５案,高雄市,楠梓區,翠屏里,478,1951,347,703,1050,60,1110
公投第１５案,高雄市,楠梓區,翠屏里,479,2008,352,790,1142,68,1210
公投第１５案,高雄市,楠梓區,翠屏里,480,1923,347,737,1084,81,1165
公投第１５案,高雄市,楠梓區,翠屏里,481,1921,366,732,1098,53,1151
公投第１５案,高雄市,楠梓區,宏南里,482,832,191,359,550,30,580
公投第１５案,高雄市,楠梓區,宏毅里,483,1156,216,424,640,52,692
公投第１５案,高雄市,楠梓區,宏毅里,484,1125,232,420,652,60,712
公投第１５案,高雄市,楠梓區,宏榮里,485,1060,210,422,632,53,685
公投第１５案,高雄市,楠梓區,宏榮里,486,1502,275,608,883,43,926
公投第１５案,高雄市,楠梓區,廣昌里,487,1404,274,506,780,78,858
公投第１５案,高雄市,楠梓區,廣昌里,488,1552,251,520,771,57,828
公投第１５案,高雄市,楠梓區,久昌里,489,1460,257,526,783,58,841
公投第１５案,高雄市,楠梓區,久昌里,490,1315,179,493,672,52,724
公投第１５案,高雄市,楠梓區,大昌里,491,1062,209,410,619,51,670
公投第１５案,高雄市,楠梓區,大昌里,492,1078,194,414,608,50,658
公投第１５案,高雄市,楠梓區,福昌里,493,914,186,351,537,75,612
公投第１５案,高雄市,楠梓區,福昌里,494,1064,221,421,642,71,713
公投第１５案,高雄市,楠梓區,盛昌里,495,1705,320,664,984,62,1046
公投第１５案,高雄市,楠梓區,盛昌里,496,1728,286,701,987,58,1045
公投第１５案,高雄市,楠梓區,盛昌里,497,1917,369,741,1110,41,1151
公投第１５案,高雄市,楠梓區,泰昌里,498,1439,194,564,758,67,825
公投第１５案,高雄市,楠梓區,興昌里,499,1287,231,528,759,63,822
公投第１５案,高雄市,楠梓區,興昌里,500,1504,268,635,903,65,968
公投第１５案,高雄市,楠梓區,興昌里,501,1405,256,614,870,53,923
公投第１５案,高雄市,楠梓區,建昌里,502,1287,243,473,716,75,791
公投第１５案,高雄市,楠梓區,建昌里,503,1295,275,530,805,42,847
公投第１５案,高雄市,楠梓區,宏昌里,504,1483,294,574,868,59,927
公投第１５案,高雄市,楠梓區,宏昌里,505,1649,338,729,1067,42,1109
公投第１５案,高雄市,楠梓區,和昌里,506,998,220,384,604,47,651
公投第１５案,高雄市,楠梓區,和昌里,507,1025,246,398,644,55,699
公投第１５案,高雄市,楠梓區,慶昌里,508,1671,330,740,1070,53,1123
公投第１５案,高雄市,楠梓區,慶昌里,509,1453,263,620,883,73,956
公投第１５案,高雄市,楠梓區,隆昌里,510,1673,302,629,931,72,1003
公投第１５案,高雄市,楠梓區,隆昌里,511,1653,272,648,920,50,970
公投第１５案,高雄市,楠梓區,秀昌里,512,1034,189,401,590,53,643
公投第１５案,高雄市,楠梓區,秀昌里,513,1127,259,469,728,49,777
公投第１５案,高雄市,楠梓區,裕昌里,514,1575,290,568,858,60,918
公投第１５案,高雄市,楠梓區,裕昌里,515,1559,276,626,902,47,949
公投第１５案,高雄市,楠梓區,裕昌里,516,1378,253,511,764,42,806
公投第１５案,高雄市,楠梓區,國昌里,517,1714,298,704,1002,57,1059
公投第１５案,高雄市,楠梓區,國昌里,518,1721,290,690,980,70,1050
公投第１５案,高雄市,楠梓區,加昌里,519,1628,272,660,932,75,1007
公投第１５案,高雄市,楠梓區,加昌里,520,1590,321,678,999,72,1071
公投第１５案,高雄市,楠梓區,加昌里,521,1628,290,634,924,71,995
公投第１５案,高雄市,楠梓區,加昌里,522,1739,361,754,1115,29,1144
公投第１５案,高雄市,楠梓區,加昌里,523,1642,330,686,1016,44,1060
公投第１５案,高雄市,楠梓區,仁昌里,524,1766,317,603,920,49,969
公投第１５案,高雄市,楠梓區,仁昌里,525,1482,275,540,815,48,863
公投第１５案,高雄市,楠梓區,仁昌里,526,1749,279,616,895,27,922
公投第１５案,高雄市,楠梓區,藍田里,527,1591,336,590,926,41,967
公投第１５案,高雄市,楠梓區,藍田里,528,1545,327,643,970,26,996
公投第１５案,高雄市,楠梓區,藍田里,529,1651,349,697,1046,31,1077
公投第１５案,高雄市,楠梓區,藍田里,530,1646,338,653,991,47,1038
公投第１５案,高雄市,楠梓區,中興里,531,1496,310,590,900,63,963
公投第１５案,高雄市,楠梓區,中和里,532,1403,223,520,743,72,815
公投第１５案,高雄市,楠梓區,中和里,533,1624,343,548,891,36,927
公投第１５案,高雄市,左營區,進學里,534,2604,260,577,837,58,895
公投第１５案,高雄市,左營區,尾西里,535,1037,190,383,573,72,645
公投第１５案,高雄市,左營區,頂北里,536,542,119,196,315,42,357
公投第１５案,高雄市,左營區,中北里,537,635,108,232,340,51,391
公投第１５案,高雄市,左營區,中南里,538,518,95,158,253,11,264
公投第１５案,高雄市,左營區,廟東里,539,813,152,257,409,51,460
公投第１５案,高雄市,左營區,廟北里,540,889,154,314,468,69,537
公投第１５案,高雄市,左營區,尾南里,541,731,147,258,405,66,471
公投第１５案,高雄市,左營區,尾北里,542,1592,267,508,775,43,818
公投第１５案,高雄市,左營區,尾北里,543,1709,329,648,977,38,1015
公投第１５案,高雄市,左營區,屏山里,544,1588,212,642,854,69,923
公投第１５案,高雄市,左營區,祥和里,545,358,48,144,192,10,202
公投第１５案,高雄市,左營區,永清里,546,666,77,365,442,15,457
公投第１５案,高雄市,左營區,莒光里,547,1748,283,666,949,61,1010
公投第１５案,高雄市,左營區,光輝里,548,1196,184,528,712,55,767
公投第１５案,高雄市,左營區,光輝里,549,1240,231,505,736,60,796
公投第１５案,高雄市,左營區,合群里,550,1402,175,670,845,34,879
公投第１５案,高雄市,左營區,合群里,551,1173,120,597,717,33,750
公投第１５案,高雄市,左營區,明建里,552,641,115,334,449,13,462
公投第１５案,高雄市,左營區,頂西里,553,951,191,317,508,40,548
公投第１５案,高雄市,左營區,聖后里,554,732,146,253,399,32,431
公投第１５案,高雄市,左營區,聖西里,555,339,56,118,174,12,186
公投第１５案,高雄市,左營區,聖南里,556,519,89,205,294,12,306
公投第１５案,高雄市,左營區,城南里,557,514,114,180,294,48,342
公投第１５案,高雄市,左營區,路東里,558,720,117,298,415,50,465
公投第１５案,高雄市,左營區,廍北里,559,411,80,151,231,38,269
公投第１５案,高雄市,左營區,廍南里,560,603,139,222,361,42,403
公投第１５案,高雄市,左營區,埤西里,561,904,188,316,504,64,568
公投第１５案,高雄市,左營區,埤北里,562,1318,161,502,663,39,702
公投第１５案,高雄市,左營區,埤東里,563,966,179,325,504,24,528
公投第１５案,高雄市,左營區,海勝里,564,1440,246,542,788,30,818
公投第１５案,高雄市,左營區,海勝里,565,1990,250,834,1084,37,1121
公投第１５案,高雄市,左營區,海勝里,566,1090,144,508,652,31,683
公投第１５案,高雄市,左營區,海勝里,567,1272,163,580,743,57,800
公投第１５案,高雄市,左營區,崇實里,568,1558,230,752,982,22,1004
公投第１５案,高雄市,左營區,崇實里,569,1501,344,603,947,21,968
公投第１５案,高雄市,左營區,自助里,570,360,79,163,242,7,249
公投第１５案,高雄市,左營區,果貿里,571,1335,145,616,761,25,786
公投第１５案,高雄市,左營區,果貿里,572,1359,197,596,793,17,810
公投第１５案,高雄市,左營區,果惠里,573,1487,243,651,894,41,935
公投第１５案,高雄市,左營區,果峰里,574,1637,195,714,909,49,958
公投第１５案,高雄市,左營區,新下里,575,1553,327,614,941,39,980
公投第１５案,高雄市,左營區,新下里,576,1564,351,610,961,50,1011
公投第１５案,高雄市,左營區,新下里,577,1788,387,743,1130,42,1172
公投第１５案,高雄市,左營區,新下里,578,2028,409,761,1170,74,1244
公投第１５案,高雄市,左營區,新下里,579,2037,443,715,1158,15,1173
公投第１５案,高雄市,左營區,新下里,580,2101,421,844,1265,44,1309
公投第１５案,高雄市,左營區,新下里,581,2018,408,797,1205,51,1256
公投第１５案,高雄市,左營區,新上里,582,1925,448,774,1222,58,1280
公投第１５案,高雄市,左營區,新上里,583,1989,411,700,1111,38,1149
公投第１５案,高雄市,左營區,新上里,584,1780,331,617,948,20,968
公投第１５案,高雄市,左營區,新上里,585,1778,375,689,1064,27,1091
公投第１５案,高雄市,左營區,新上里,586,1496,309,585,894,23,917
公投第１５案,高雄市,左營區,新上里,587,1538,325,613,938,37,975
公投第１５案,高雄市,左營區,新上里,588,2058,434,785,1219,41,1260
公投第１５案,高雄市,左營區,新上里,589,1992,437,752,1189,32,1221
公投第１５案,高雄市,左營區,新上里,590,2058,465,763,1228,57,1285
公投第１５案,高雄市,左營區,新上里,591,2090,444,796,1240,39,1279
公投第１５案,高雄市,左營區,新上里,592,2157,456,805,1261,37,1298
公投第１５案,高雄市,左營區,新上里,593,2096,441,834,1275,41,1316
公投第１５案,高雄市,左營區,新上里,594,2101,477,809,1286,56,1342
公投第１５案,高雄市,左營區,新中里,595,1649,295,627,922,73,995
公投第１５案,高雄市,左營區,新中里,596,1516,277,553,830,71,901
公投第１５案,高雄市,左營區,新中里,597,1678,414,683,1097,52,1149
公投第１５案,高雄市,左營區,新光里,598,1898,356,719,1075,76,1151
公投第１５案,高雄市,左營區,新光里,599,1837,345,741,1086,41,1127
公投第１５案,高雄市,左營區,新光里,600,1922,342,718,1060,28,1088
公投第１５案,高雄市,左營區,新光里,601,1785,368,708,1076,52,1128
公投第１５案,高雄市,左營區,新光里,602,1886,363,743,1106,18,1124
公投第１５案,高雄市,左營區,新光里,603,1895,384,765,1149,35,1184
公投第１５案,高雄市,左營區,新光里,604,1831,383,737,1120,28,1148
公投第１５案,高雄市,左營區,菜公里,605,2050,318,848,1166,37,1203
公投第１５案,高雄市,左營區,菜公里,606,2251,488,957,1445,36,1481
公投第１５案,高雄市,左營區,菜公里,607,2126,455,888,1343,30,1373
公投第１５案,高雄市,左營區,菜公里,608,1928,342,724,1066,27,1093
公投第１５案,高雄市,左營區,菜公里,609,2166,417,827,1244,32,1276
公投第１５案,高雄市,左營區,菜公里,610,2031,373,873,1246,42,1288
公投第１５案,高雄市,左營區,菜公里,611,1987,397,801,1198,37,1235
公投第１５案,高雄市,左營區,菜公里,612,2166,445,876,1321,32,1353
公投第１５案,高雄市,左營區,菜公里,613,1856,396,693,1089,58,1147
公投第１５案,高雄市,左營區,菜公里,614,2289,493,901,1394,29,1423
公投第１５案,高雄市,左營區,菜公里,615,1973,364,792,1156,36,1192
公投第１５案,高雄市,左營區,菜公里,616,1818,375,701,1076,52,1128
公投第１５案,高雄市,左營區,菜公里,617,1565,312,590,902,20,922
公投第１５案,高雄市,左營區,菜公里,618,1608,352,684,1036,24,1060
公投第１５案,高雄市,左營區,福山里,619,1812,405,737,1142,34,1176
公投第１５案,高雄市,左營區,福山里,620,1821,342,685,1027,20,1047
公投第１５案,高雄市,左營區,福山里,621,1907,413,769,1182,42,1224
公投第１５案,高雄市,左營區,福山里,622,1812,316,723,1039,34,1073
公投第１５案,高雄市,左營區,福山里,623,1833,371,761,1132,36,1168
公投第１５案,高雄市,左營區,福山里,624,1850,396,710,1106,40,1146
公投第１５案,高雄市,左營區,福山里,625,1738,319,671,990,50,1040
公投第１５案,高雄市,左營區,福山里,626,1864,382,805,1187,34,1221
公投第１５案,高雄市,左營區,福山里,627,1887,391,773,1164,33,1197
公投第１５案,高雄市,左營區,福山里,628,1870,328,706,1034,25,1059
公投第１５案,高雄市,左營區,福山里,629,1866,366,736,1102,21,1123
公投第１５案,高雄市,左營區,福山里,630,1862,366,719,1085,14,1099
公投第１５案,高雄市,左營區,福山里,631,1816,357,746,1103,21,1124
公投第１５案,高雄市,左營區,福山里,632,1833,337,771,1108,36,1144
公投第１５案,高雄市,左營區,福山里,633,1676,333,682,1015,44,1059
公投第１５案,高雄市,左營區,福山里,634,1843,327,777,1104,36,1140
公投第１５案,高雄市,左營區,福山里,635,1872,374,775,1149,27,1176
公投第１５案,高雄市,左營區,福山里,636,2259,367,937,1304,43,1347
公投第１５案,高雄市,大社區,嘉誠里,637,950,153,322,475,64,539
公投第１５案,高雄市,大社區,保社里,638,1306,321,340,661,27,688
公投第１５案,高雄市,大社區,保社里,639,1856,255,556,811,33,844
公投第１５案,高雄市,大社區,大社里,640,986,205,391,596,47,643
公投第１５案,高雄市,大社區,大社里,641,1116,194,337,531,42,573
公投第１５案,高雄市,大社區,大社里,642,1253,273,472,745,62,807
公投第１５案,高雄市,大社區,大社里,643,1613,296,620,916,39,955
公投第１５案,高雄市,大社區,保安里,644,1455,254,484,738,38,776
公投第１５案,高雄市,大社區,保安里,645,1674,316,637,953,47,1000
公投第１５案,高雄市,大社區,三奶里,646,1004,181,378,559,51,610
公投第１５案,高雄市,大社區,三奶里,647,879,160,323,483,41,524
公投第１５案,高雄市,大社區,三奶里,648,778,169,240,409,26,435
公投第１５案,高雄市,大社區,觀音里,649,1110,224,391,615,60,675
公投第１５案,高雄市,大社區,觀音里,650,1432,281,389,670,148,818
公投第１５案,高雄市,大社區,觀音里,651,1466,280,553,833,40,873
公投第１５案,高雄市,大社區,觀音里,652,1383,311,532,843,67,910
公投第１５案,高雄市,大社區,神農里,653,1645,325,592,917,69,986
公投第１５案,高雄市,大社區,神農里,654,1555,268,485,753,47,800
公投第１５案,高雄市,大社區,神農里,655,1750,373,601,974,56,1030
公投第１５案,高雄市,大社區,中里里,656,1111,214,398,612,52,664
公投第１５案,高雄市,大社區,中里里,657,1133,223,403,626,69,695
公投第１５案,高雄市,大社區,中里里,658,912,172,346,518,41,559
公投第１５案,高雄市,大社區,翠屏里,659,745,126,206,332,15,347
公投第１５案,高雄市,大社區,翠屏里,660,934,179,357,536,24,560
公投第１５案,高雄市,仁武區,大灣里,661,1777,335,791,1126,38,1164
公投第１５案,高雄市,仁武區,大灣里,662,2273,400,940,1340,59,1399
公投第１５案,高雄市,仁武區,灣內里,663,1384,268,574,842,76,918
公投第１５案,高雄市,仁武區,灣內里,664,1170,199,442,641,49,690
公投第１５案,高雄市,仁武區,灣內里,665,1216,269,497,766,53,819
公投第１５案,高雄市,仁武區,灣內里,666,1598,272,611,883,23,906
公投第１５案,高雄市,仁武區,灣內里,667,2143,405,920,1325,31,1356
公投第１５案,高雄市,仁武區,考潭里,668,1300,231,453,684,68,752
公投第１５案,高雄市,仁武區,考潭里,669,1338,249,506,755,67,822
公投第１５案,高雄市,仁武區,烏林里,670,1217,209,431,640,22,662
公投第１５案,高雄市,仁武區,烏林里,671,1202,151,404,555,62,617
公投第１５案,高雄市,仁武區,烏林里,672,1404,228,494,722,40,762
公投第１５案,高雄市,仁武區,仁福里,673,830,142,297,439,42,481
公投第１５案,高雄市,仁武區,仁武里,674,1802,228,536,764,45,809
公投第１５案,高雄市,仁武區,仁武里,675,1877,307,642,949,59,1008
公投第１５案,高雄市,仁武區,仁武里,676,1738,268,548,816,27,843
公投第１５案,高雄市,仁武區,文武里,677,1549,304,517,821,55,876
公投第１５案,高雄市,仁武區,文武里,678,1579,284,607,891,47,938
公投第１５案,高雄市,仁武區,文武里,679,1406,205,545,750,32,782
公投第１５案,高雄市,仁武區,文武里,680,1461,273,560,833,28,861
公投第１５案,高雄市,仁武區,文武里,681,1311,265,509,774,47,821
公投第１５案,高雄市,仁武區,文武里,682,1373,238,526,764,22,786
公投第１５案,高雄市,仁武區,竹後里,683,1035,202,324,526,13,539
公投第１５案,高雄市,仁武區,竹後里,684,1181,188,442,630,33,663
公投第１５案,高雄市,仁武區,八卦里,685,1670,344,554,898,37,935
公投第１５案,高雄市,仁武區,八卦里,686,1576,282,589,871,24,895
公投第１５案,高雄市,仁武區,八卦里,687,1576,304,629,933,46,979
公投第１５案,高雄市,仁武區,八卦里,688,1915,352,804,1156,31,1187
公投第１５案,高雄市,仁武區,八卦里,689,1758,289,674,963,31,994
公投第１５案,高雄市,仁武區,八卦里,690,1892,337,822,1159,45,1204
公投第１５案,高雄市,仁武區,八卦里,691,2025,369,804,1173,52,1225
公投第１５案,高雄市,仁武區,八卦里,692,2014,379,825,1204,48,1252
公投第１５案,高雄市,仁武區,八卦里,693,1473,316,644,960,35,995
公投第１５案,高雄市,仁武區,高楠里,694,979,172,344,516,29,545
公投第１５案,高雄市,仁武區,高楠里,695,944,174,364,538,19,557
公投第１５案,高雄市,仁武區,後安里,696,1153,212,423,635,66,701
公投第１５案,高雄市,仁武區,後安里,697,1328,209,498,707,35,742
公投第１５案,高雄市,仁武區,中華里,698,1657,299,635,934,66,1000
公投第１５案,高雄市,仁武區,五和里,699,1545,259,519,778,50,828
公投第１５案,高雄市,仁武區,五和里,700,1417,250,599,849,41,890
公投第１５案,高雄市,仁武區,五和里,701,1602,303,699,1002,31,1033
公投第１５案,高雄市,仁武區,仁和里,702,1823,343,779,1122,51,1173
公投第１５案,高雄市,仁武區,仁和里,703,1914,365,718,1083,31,1114
公投第１５案,高雄市,仁武區,赤山里,704,1992,349,765,1114,51,1165
公投第１５案,高雄市,仁武區,赤山里,705,2045,305,730,1035,41,1076
公投第１５案,高雄市,仁武區,赤山里,706,1982,378,800,1178,45,1223
公投第１５案,高雄市,仁武區,仁慈里,707,2167,358,760,1118,48,1166
公投第１５案,高雄市,鳥松區,鳥松里,708,1678,308,622,930,57,987
公投第１５案,高雄市,鳥松區,鳥松里,709,1682,284,571,855,61,916
公投第１５案,高雄市,鳥松區,鳥松里,710,1225,248,472,720,47,767
公投第１５案,高雄市,鳥松區,鳥松里,711,1322,236,449,685,49,734
公投第１５案,高雄市,鳥松區,鳥松里,712,1215,222,479,701,37,738
公投第１５案,高雄市,鳥松區,鳥松里,713,1779,313,615,928,47,975
公投第１５案,高雄市,鳥松區,鳥松里,714,1129,370,357,727,13,740
公投第１５案,高雄市,鳥松區,夢裡里,715,1374,274,539,813,46,859
公投第１５案,高雄市,鳥松區,夢裡里,716,1089,225,399,624,30,654
公投第１５案,高雄市,鳥松區,夢裡里,717,2219,484,835,1319,48,1367
公投第１５案,高雄市,鳥松區,大華里,718,1634,345,598,943,35,978
公投第１５案,高雄市,鳥松區,大華里,719,1553,304,631,935,52,987
公投第１５案,高雄市,鳥松區,大華里,720,1572,344,607,951,43,994
公投第１５案,高雄市,鳥松區,大華里,721,1688,375,655,1030,38,1068
公投第１５案,高雄市,鳥松區,大華里,722,1626,376,611,987,41,1028
公投第１５案,高雄市,鳥松區,大華里,723,1744,373,691,1064,64,1128
公投第１５案,高雄市,鳥松區,坔埔里,724,1230,193,458,651,43,694
公投第１５案,高雄市,鳥松區,坔埔里,725,1201,235,469,704,70,774
公投第１５案,高雄市,鳥松區,坔埔里,726,1117,205,479,684,42,726
公投第１５案,高雄市,鳥松區,仁美里,727,1255,180,499,679,60,739
公投第１５案,高雄市,鳥松區,仁美里,728,1432,227,510,737,33,770
公投第１５案,高雄市,鳥松區,仁美里,729,1370,500,198,698,31,729
公投第１５案,高雄市,鳥松區,仁美里,730,1364,222,557,779,77,856
公投第１５案,高雄市,鳥松區,仁美里,731,1041,162,448,610,53,663
公投第１５案,高雄市,鳥松區,大竹里,732,702,150,329,479,61,540
公投第１５案,高雄市,鳥松區,華美里,733,1212,215,471,686,50,736
公投第１５案,高雄市,鳥松區,華美里,734,1289,200,506,706,51,757
公投第１５案,高雄市,鳥松區,華美里,735,1449,307,606,913,26,939
公投第１５案,高雄市,大樹區,竹寮里,736,1386,245,493,738,30,768
公投第１５案,高雄市,大樹區,竹寮里,737,1315,243,573,816,29,845
公投第１５案,高雄市,大樹區,九曲里,738,2461,348,940,1288,56,1344
公投第１５案,高雄市,大樹區,九曲里,739,1274,211,478,689,27,716
公投第１５案,高雄市,大樹區,九曲里,740,1265,207,447,654,64,718
公投第１５案,高雄市,大樹區,久堂里,741,1504,254,524,778,64,842
公投第１５案,高雄市,大樹區,久堂里,742,1049,182,340,522,22,544
公投第１５案,高雄市,大樹區,久堂里,743,1573,289,523,812,46,858
公投第１５案,高雄市,大樹區,水安里,744,1121,163,365,528,29,557
公投第１５案,高雄市,大樹區,水安里,745,1207,188,488,676,46,722
公投第１５案,高雄市,大樹區,水寮里,746,1134,186,419,605,32,637
公投第１５案,高雄市,大樹區,水寮里,747,1124,212,441,653,35,688
公投第１５案,高雄市,大樹區,檨腳里,748,1259,199,423,622,86,708
公投第１５案,高雄市,大樹區,檨腳里,749,1105,226,408,634,62,696
公投第１５案,高雄市,大樹區,檨腳里,750,1128,200,390,590,68,658
公投第１５案,高雄市,大樹區,興山里,751,1079,161,359,520,77,597
公投第１５案,高雄市,大樹區,和山里,752,1025,276,241,517,31,548
公投第１５案,高雄市,大樹區,姑山里,753,950,160,321,481,52,533
公投第１５案,高雄市,大樹區,大坑里,754,1433,266,464,730,80,810
公投第１５案,高雄市,大樹區,井腳里,755,794,114,263,377,27,404
公投第１５案,高雄市,大樹區,井腳里,756,781,118,205,323,17,340
公投第１５案,高雄市,大樹區,小坪里,757,1318,208,424,632,21,653
公投第１５案,高雄市,大樹區,龍目里,758,736,127,242,369,40,409
公投第１５案,高雄市,大樹區,龍目里,759,1047,166,302,468,25,493
公投第１５案,高雄市,大樹區,大樹里,760,1271,231,459,690,62,752
公投第１５案,高雄市,大樹區,大樹里,761,1186,175,405,580,36,616
公投第１５案,高雄市,大樹區,三和里,762,1007,179,361,540,57,597
公投第１５案,高雄市,大樹區,溪埔里,763,859,158,307,465,55,520
公投第１５案,高雄市,大樹區,溪埔里,764,735,104,228,332,18,350
公投第１５案,高雄市,大樹區,興田里,765,1046,191,381,572,79,651
公投第１５案,高雄市,大樹區,興田里,766,880,109,512,621,31,652
公投第１５案,高雄市,大樹區,統嶺里,767,720,70,277,347,23,370
公投第１５案,高雄市,鼓山區,鼓峰里,768,959,154,332,486,27,513
公投第１５案,高雄市,鼓山區,鼓峰里,769,1000,232,394,626,42,668
公投第１５案,高雄市,鼓山區,雄峰里,770,910,144,376,520,11,531
公投第１５案,高雄市,鼓山區,雄峰里,771,1085,210,464,674,37,711
公投第１５案,高雄市,鼓山區,前峰里,772,1484,236,458,694,47,741
公投第１５案,高雄市,鼓山區,前峰里,773,1393,246,572,818,22,840
公投第１５案,高雄市,鼓山區,前峰里,774,1270,238,561,799,50,849
公投第１５案,高雄市,鼓山區,光榮里,775,1055,205,384,589,29,618
公投第１５案,高雄市,鼓山區,光榮里,776,1172,220,440,660,29,689
公投第１５案,高雄市,鼓山區,光榮里,777,1175,220,487,707,46,753
公投第１５案,高雄市,鼓山區,民族里,778,1274,256,468,724,36,760
公投第１５案,高雄市,鼓山區,內惟里,779,1085,191,350,541,37,578
公投第１５案,高雄市,鼓山區,建國里,780,1470,276,526,802,48,850
公投第１５案,高雄市,鼓山區,建國里,781,974,204,401,605,41,646
公投第１５案,高雄市,鼓山區,忠正里,782,1275,256,475,731,66,797
公投第１５案,高雄市,鼓山區,忠正里,783,1206,206,455,661,52,713
公投第１５案,高雄市,鼓山區,忠正里,784,1238,237,483,720,27,747
公投第１５案,高雄市,鼓山區,自強里,785,721,91,392,483,15,498
公投第１５案,高雄市,鼓山區,龍井里,786,1220,223,434,657,27,684
公投第１５案,高雄市,鼓山區,正德里,787,1966,323,618,941,41,982
公投第１５案,高雄市,鼓山區,平和里,788,1722,286,591,877,79,956
公投第１５案,高雄市,鼓山區,平和里,789,1720,313,590,903,27,930
公投第１５案,高雄市,鼓山區,民強里,790,1287,259,493,752,73,825
公投第１５案,高雄市,鼓山區,民強里,791,1369,128,478,606,29,635
公投第１５案,高雄市,鼓山區,厚生里,792,1222,231,554,785,22,807
公投第１５案,高雄市,鼓山區,厚生里,793,1770,323,630,953,42,995
公投第１５案,高雄市,鼓山區,龍子里,794,1860,371,675,1046,30,1076
公投第１５案,高雄市,鼓山區,龍子里,795,1857,376,654,1030,44,1074
公投第１５案,高雄市,鼓山區,龍子里,796,1841,378,704,1082,29,1111
公投第１５案,高雄市,鼓山區,龍子里,797,1830,384,701,1085,42,1127
公投第１５案,高雄市,鼓山區,龍子里,798,1809,366,666,1032,51,1083
公投第１５案,高雄市,鼓山區,龍子里,799,1894,413,713,1126,39,1165
公投第１５案,高雄市,鼓山區,龍子里,800,1882,385,758,1143,18,1161
公投第１５案,高雄市,鼓山區,龍子里,801,1894,418,763,1181,34,1215
公投第１５案,高雄市,鼓山區,龍水里,802,1745,302,670,972,38,1010
公投第１５案,高雄市,鼓山區,龍水里,803,1887,395,649,1044,18,1062
公投第１５案,高雄市,鼓山區,龍水里,804,1891,442,751,1193,35,1228
公投第１５案,高雄市,鼓山區,龍水里,805,1903,398,738,1136,35,1171
公投第１５案,高雄市,鼓山區,龍水里,806,1998,451,738,1189,30,1219
公投第１５案,高雄市,鼓山區,龍水里,807,1912,401,692,1093,35,1128
公投第１５案,高雄市,鼓山區,龍水里,808,1923,406,751,1157,50,1207
公投第１５案,高雄市,鼓山區,龍水里,809,1888,451,684,1135,26,1161
公投第１５案,高雄市,鼓山區,龍水里,810,1873,403,747,1150,24,1174
公投第１５案,高雄市,鼓山區,龍水里,811,1959,549,777,1326,23,1349
公投第１５案,高雄市,鼓山區,龍水里,812,1897,396,801,1197,42,1239
公投第１５案,高雄市,鼓山區,明誠里,813,2362,497,907,1404,35,1439
公投第１５案,高雄市,鼓山區,明誠里,814,1850,381,741,1122,26,1148
公投第１５案,高雄市,鼓山區,明誠里,815,1928,418,743,1161,30,1191
公投第１５案,高雄市,鼓山區,明誠里,816,1937,365,727,1092,29,1121
公投第１５案,高雄市,鼓山區,明誠里,817,2123,443,754,1197,50,1247
公投第１５案,高雄市,鼓山區,明誠里,818,1861,356,785,1141,19,1160
公投第１５案,高雄市,鼓山區,明誠里,819,1892,373,723,1096,25,1121
公投第１５案,高雄市,鼓山區,明誠里,820,2147,481,780,1261,37,1298
公投第１５案,高雄市,鼓山區,華豐里,821,1897,382,755,1137,32,1169
公投第１５案,高雄市,鼓山區,華豐里,822,2041,405,767,1172,41,1213
公投第１５案,高雄市,鼓山區,裕興里,823,1309,229,504,733,55,788
公投第１５案,高雄市,鼓山區,裕興里,824,1867,350,732,1082,44,1126
公投第１５案,高雄市,鼓山區,裕豐里,825,1152,236,524,760,23,783
公投第１５案,高雄市,鼓山區,裕豐里,826,1404,260,605,865,46,911
公投第１５案,高雄市,鼓山區,鼓岩里,827,1210,167,332,499,19,518
公投第１５案,高雄市,鼓山區,樹德里,828,1135,223,400,623,41,664
公投第１５案,高雄市,鼓山區,寶樹里,829,1831,212,388,600,72,672
公投第１５案,高雄市,鼓山區,興宗里,830,1288,231,476,707,59,766
公投第１５案,高雄市,鼓山區,光化里,831,1241,202,458,660,36,696
公投第１５案,高雄市,鼓山區,山下里,832,1342,273,493,766,55,821
公投第１５案,高雄市,鼓山區,河邊里,833,1422,258,519,777,104,881
公投第１５案,高雄市,鼓山區,綠川里,834,1453,265,564,829,92,921
公投第１５案,高雄市,鼓山區,登山里,835,616,117,248,365,40,405
公投第１５案,高雄市,鼓山區,峰南里,836,834,150,292,442,60,502
公投第１５案,高雄市,鼓山區,麗興里,837,969,171,347,518,59,577
公投第１５案,高雄市,鼓山區,新民里,838,978,187,324,511,74,585
公投第１５案,高雄市,鼓山區,延平里,839,760,166,284,450,52,502
公投第１５案,高雄市,鼓山區,維生里,840,1248,243,434,677,67,744
公投第１５案,高雄市,鼓山區,惠安里,841,1143,199,388,587,25,612
公投第１５案,高雄市,鼓山區,壽山里,842,1358,231,391,622,75,697
公投第１５案,高雄市,鼓山區,哨船頭里,843,1036,162,361,523,20,543
公投第１５案,高雄市,鼓山區,桃源里,844,580,95,215,310,10,320
公投第１５案,高雄市,鹽埕區,藍橋里,845,1304,283,487,770,48,818
公投第１５案,高雄市,鹽埕區,慈愛里,846,357,77,119,196,25,221
公投第１５案,高雄市,鹽埕區,博愛里,847,651,138,223,361,26,387
公投第１５案,高雄市,鹽埕區,壽星里,848,1322,219,423,642,28,670
公投第１５案,高雄市,鹽埕區,中山里,849,1056,439,174,613,23,636
公投第１５案,高雄市,鹽埕區,教仁里,850,904,220,333,553,11,564
公投第１５案,高雄市,鹽埕區,教仁里,851,1130,202,408,610,31,641
公投第１５案,高雄市,鹽埕區,新樂里,852,840,163,336,499,18,517
公投第１５案,高雄市,鹽埕區,中原里,853,616,166,246,412,27,439
公投第１５案,高雄市,鹽埕區,光明里,854,1397,294,410,704,36,740
公投第１５案,高雄市,鹽埕區,育仁里,855,766,159,272,431,16,447
公投第１５案,高雄市,鹽埕區,河濱里,856,839,198,282,480,35,515
公投第１５案,高雄市,鹽埕區,河濱里,857,805,160,327,487,20,507
公投第１５案,高雄市,鹽埕區,沙地里,858,750,144,253,397,15,412
公投第１５案,高雄市,鹽埕區,南端里,859,986,199,338,537,26,563
公投第１５案,高雄市,鹽埕區,港都里,860,1068,192,367,559,9,568
公投第１５案,高雄市,鹽埕區,江西里,861,1060,225,368,593,43,636
公投第１５案,高雄市,鹽埕區,新豐里,862,805,148,287,435,25,460
公投第１５案,高雄市,鹽埕區,府北里,863,1073,205,321,526,22,548
公投第１５案,高雄市,鹽埕區,府北里,864,921,177,278,455,25,480
公投第１５案,高雄市,鹽埕區,陸橋里,865,1171,238,389,627,18,645
公投第１５案,高雄市,鹽埕區,瀨南里,866,594,134,215,349,11,360
公投第１５案,高雄市,鹽埕區,新化里,867,592,120,228,348,19,367
公投第１５案,高雄市,鹽埕區,江南里,868,610,113,193,306,18,324
公投第１５案,高雄市,旗津區,旗下里,869,1177,232,423,655,90,745
公投第１５案,高雄市,旗津區,永安里,870,1109,163,370,533,54,587
公投第１５案,高雄市,旗津區,振興里,871,1642,286,480,766,20,786
公投第１５案,高雄市,旗津區,慈愛里,872,1209,184,408,592,77,669
公投第１５案,高雄市,旗津區,慈愛里,873,1112,180,329,509,50,559
公投第１５案,高雄市,旗津區,復興里,874,1483,240,541,781,85,866
公投第１５案,高雄市,旗津區,復興里,875,1460,202,442,644,30,674
公投第１５案,高雄市,旗津區,中華里,876,1572,327,539,866,121,987
公投第１５案,高雄市,旗津區,實踐里,877,1384,211,429,640,28,668
公投第１５案,高雄市,旗津區,北汕里,878,1390,202,451,653,36,689
公投第１５案,高雄市,旗津區,北汕里,879,1239,192,388,580,49,629
公投第１５案,高雄市,旗津區,南汕里,880,2045,343,656,999,96,1095
公投第１５案,高雄市,旗津區,上竹里,881,893,116,311,427,23,450
公投第１５案,高雄市,旗津區,上竹里,882,1866,301,626,927,87,1014
公投第１５案,高雄市,旗津區,中洲里,883,1874,258,477,735,43,778
公投第１５案,高雄市,旗津區,安順里,884,893,129,269,398,63,461
公投第１５案,高雄市,旗津區,中興里,885,1215,440,222,662,28,690
公投第１５案,高雄市,旗津區,中興里,886,1297,217,390,607,37,644
公投第１５案,高雄市,三民區,鼎金里,887,1893,362,696,1058,77,1135
公投第１５案,高雄市,三民區,鼎金里,888,1982,299,682,981,94,1075
公投第１５案,高雄市,三民區,鼎盛里,889,1661,285,612,897,77,974
公投第１５案,高雄市,三民區,鼎盛里,890,1894,376,676,1052,21,1073
公投第１５案,高雄市,三民區,鼎盛里,891,1839,327,684,1011,44,1055
公投第１５案,高雄市,三民區,鼎盛里,892,2014,371,702,1073,71,1144
公投第１５案,高雄市,三民區,鼎強里,893,1897,322,696,1018,109,1127
公投第１５案,高雄市,三民區,鼎強里,894,2016,379,645,1024,46,1070
公投第１５案,高雄市,三民區,鼎力里,895,1924,280,688,968,57,1025
公投第１５案,高雄市,三民區,鼎力里,896,1749,313,667,980,50,1030
公投第１５案,高雄市,三民區,鼎西里,897,1845,381,724,1105,66,1171
公投第１５案,高雄市,三民區,鼎西里,898,1724,327,594,921,40,961
公投第１５案,高雄市,三民區,鼎西里,899,1889,352,697,1049,42,1091
公投第１５案,高雄市,三民區,鼎西里,900,1622,338,582,920,50,970
公投第１５案,高雄市,三民區,鼎中里,901,1870,375,713,1088,33,1121
公投第１５案,高雄市,三民區,鼎中里,902,1523,299,605,904,61,965
公投第１５案,高雄市,三民區,鼎泰里,903,2006,323,687,1010,57,1067
公投第１５案,高雄市,三民區,鼎泰里,904,2076,477,780,1257,58,1315
公投第１５案,高雄市,三民區,鼎泰里,905,2073,452,716,1168,24,1192
公投第１５案,高雄市,三民區,鼎泰里,906,2045,399,770,1169,41,1210
公投第１５案,高雄市,三民區,鼎泰里,907,2070,360,640,1000,63,1063
公投第１５案,高雄市,三民區,鼎泰里,908,2035,370,723,1093,52,1145
公投第１５案,高雄市,三民區,鼎泰里,909,2075,488,756,1244,46,1290
公投第１５案,高雄市,三民區,鼎泰里,910,2053,406,771,1177,42,1219
公投第１５案,高雄市,三民區,鼎泰里,911,2063,465,803,1268,30,1298
公投第１５案,高雄市,三民區,鼎泰里,912,2143,442,863,1305,31,1336
公投第１５案,高雄市,三民區,本館里,913,1746,333,609,942,65,1007
公投第１５案,高雄市,三民區,本館里,914,1735,303,582,885,25,910
公投第１５案,高雄市,三民區,本館里,915,1655,311,548,859,55,914
公投第１５案,高雄市,三民區,本館里,916,1583,336,562,898,50,948
公投第１５案,高雄市,三民區,本館里,917,1800,366,619,985,40,1025
公投第１５案,高雄市,三民區,本和里,918,1730,334,688,1022,24,1046
公投第１５案,高雄市,三民區,本和里,919,1715,134,846,980,26,1006
公投第１５案,高雄市,三民區,本和里,920,1691,337,642,979,40,1019
公投第１５案,高雄市,三民區,本和里,921,1865,389,685,1074,41,1115
公投第１５案,高雄市,三民區,本文里,922,1073,242,427,669,28,697
公投第１５案,高雄市,三民區,本文里,923,917,186,392,578,63,641
公投第１５案,高雄市,三民區,本武里,924,1647,310,623,933,48,981
公投第１５案,高雄市,三民區,本元里,925,1654,334,621,955,66,1021
公投第１５案,高雄市,三民區,本元里,926,1639,335,640,975,45,1020
公投第１５案,高雄市,三民區,本元里,927,1833,357,711,1068,43,1111
公投第１５案,高雄市,三民區,本安里,928,1362,327,527,854,38,892
公投第１５案,高雄市,三民區,本安里,929,1557,325,212,537,55,592
公投第１５案,高雄市,三民區,本安里,930,1482,298,599,897,24,921
公投第１５案,高雄市,三民區,本上里,931,1563,325,624,949,40,989
公投第１５案,高雄市,三民區,本上里,932,1497,338,572,910,28,938
公投第１５案,高雄市,三民區,本上里,933,1523,343,613,956,21,977
公投第１５案,高雄市,三民區,本揚里,934,1293,281,551,832,40,872
公投第１５案,高雄市,三民區,本揚里,935,1662,387,623,1010,46,1056
公投第１５案,高雄市,三民區,本揚里,936,1441,274,552,826,44,870
公投第１５案,高雄市,三民區,本揚里,937,1326,284,585,869,33,902
公投第１５案,高雄市,三民區,本揚里,938,1476,320,624,944,27,971
公投第１５案,高雄市,三民區,寶獅里,939,1968,356,672,1028,34,1062
公投第１５案,高雄市,三民區,寶獅里,940,1618,290,548,838,26,864
公投第１５案,高雄市,三民區,寶德里,941,1873,495,551,1046,39,1085
公投第１５案,高雄市,三民區,寶德里,942,1487,295,548,843,56,899
公投第１５案,高雄市,三民區,寶德里,943,1640,298,628,926,28,954
公投第１５案,高雄市,三民區,寶泰里,944,1889,350,706,1056,25,1081
公投第１５案,高雄市,三民區,寶泰里,945,1969,384,683,1067,37,1104
公投第１５案,高雄市,三民區,寶興里,946,1466,279,523,802,92,894
公投第１５案,高雄市,三民區,寶興里,947,1697,338,651,989,55,1044
公投第１５案,高雄市,三民區,寶興里,948,1663,328,648,976,45,1021
公投第１５案,高雄市,三民區,寶興里,949,1649,336,587,923,46,969
公投第１５案,高雄市,三民區,寶中里,950,1486,274,565,839,32,871
公投第１５案,高雄市,三民區,寶中里,951,1495,279,541,820,23,843
公投第１５案,高雄市,三民區,寶華里,952,1548,360,604,964,28,992
公投第１５案,高雄市,三民區,寶華里,953,1493,324,532,856,33,889
公投第１５案,高雄市,三民區,寶國里,954,1445,293,593,886,25,911
公投第１５案,高雄市,三民區,寶國里,955,1529,295,574,869,30,899
公投第１５案,高雄市,三民區,寶國里,956,1506,282,573,855,31,886
公投第１５案,高雄市,三民區,寶國里,957,1549,349,599,948,31,979
公投第１５案,高雄市,三民區,寶國里,958,1620,389,589,978,54,1032
公投第１５案,高雄市,三民區,寶民里,959,1550,322,606,928,63,991
公投第１５案,高雄市,三民區,寶民里,960,1488,298,600,898,43,941
公投第１５案,高雄市,三民區,寶慶里,961,1335,280,515,795,44,839
公投第１５案,高雄市,三民區,寶慶里,962,1332,233,542,775,42,817
公投第１５案,高雄市,三民區,寶業里,963,1764,385,634,1019,69,1088
公投第１５案,高雄市,三民區,寶業里,964,1811,363,678,1041,35,1076
公投第１５案,高雄市,三民區,寶業里,965,1693,373,659,1032,50,1082
公投第１５案,高雄市,三民區,寶盛里,966,1684,366,668,1034,68,1102
公投第１５案,高雄市,三民區,寶盛里,967,1464,303,508,811,51,862
公投第１５案,高雄市,三民區,寶盛里,968,1719,386,702,1088,33,1121
公投第１５案,高雄市,三民區,寶安里,969,1749,362,639,1001,28,1029
公投第１５案,高雄市,三民區,寶安里,970,1908,377,666,1043,41,1084
公投第１５案,高雄市,三民區,寶安里,971,1573,308,602,910,62,972
公投第１５案,高雄市,三民區,寶安里,972,1628,315,592,907,36,943
公投第１５案,高雄市,三民區,寶龍里,973,1377,240,451,691,57,748
公投第１５案,高雄市,三民區,寶龍里,974,1530,320,613,933,43,976
公投第１５案,高雄市,三民區,寶龍里,975,1188,202,454,656,51,707
公投第１５案,高雄市,三民區,寶珠里,976,2791,264,547,811,37,848
公投第１５案,高雄市,三民區,寶珠里,977,1840,357,689,1046,54,1100
公投第１５案,高雄市,三民區,寶珠里,978,1671,347,626,973,69,1042
公投第１５案,高雄市,三民區,寶玉里,979,1624,340,595,935,48,983
公投第１５案,高雄市,三民區,寶玉里,980,1555,382,637,1019,44,1063
公投第１５案,高雄市,三民區,寶玉里,981,1489,344,592,936,48,984
公投第１５案,高雄市,三民區,寶玉里,982,1662,347,646,993,46,1039
公投第１５案,高雄市,三民區,寶玉里,983,1639,310,606,916,26,942
公投第１５案,高雄市,三民區,灣子里,984,1872,341,696,1037,63,1100
公投第１５案,高雄市,三民區,灣子里,985,1968,356,740,1096,46,1142
公投第１５案,高雄市,三民區,灣愛里,986,1471,218,482,700,86,786
公投第１５案,高雄市,三民區,灣愛里,987,1534,281,544,825,62,887
公投第１５案,高雄市,三民區,灣中里,988,1659,257,572,829,76,905
公投第１５案,高雄市,三民區,灣中里,989,1815,290,615,905,32,937
公投第１５案,高雄市,三民區,灣中里,990,1808,349,607,956,39,995
公投第１５案,高雄市,三民區,灣華里,991,1224,203,427,630,39,669
公投第１５案,高雄市,三民區,灣華里,992,1406,262,523,785,18,803
公投第１５案,高雄市,三民區,灣勝里,993,945,177,321,498,36,534
公投第１５案,高雄市,三民區,灣勝里,994,944,181,395,576,34,610
公投第１５案,高雄市,三民區,灣利里,995,1669,327,602,929,81,1010
公投第１５案,高雄市,三民區,灣利里,996,1473,270,593,863,64,927
公投第１５案,高雄市,三民區,灣復里,997,1876,329,576,905,52,957
公投第１５案,高雄市,三民區,灣復里,998,1682,214,410,624,46,670
公投第１５案,高雄市,三民區,正興里,999,1791,360,569,929,41,970
公投第１５案,高雄市,三民區,正興里,1000,1808,370,680,1050,46,1096
公投第１５案,高雄市,三民區,正興里,1001,1798,332,624,956,52,1008
公投第１５案,高雄市,三民區,正興里,1002,2030,447,712,1159,42,1201
公投第１５案,高雄市,三民區,正興里,1003,2034,407,771,1178,23,1201
公投第１５案,高雄市,三民區,正興里,1004,1998,403,755,1158,16,1174
公投第１５案,高雄市,三民區,正順里,1005,1914,360,659,1019,32,1051
公投第１５案,高雄市,三民區,正順里,1006,1965,440,637,1077,38,1115
公投第１５案,高雄市,三民區,灣興里,1007,1885,406,636,1042,58,1100
公投第１５案,高雄市,三民區,灣成里,1008,1220,265,501,766,12,778
公投第１５案,高雄市,三民區,灣成里,1009,1057,187,390,577,64,641
公投第１５案,高雄市,三民區,安康里,1010,1434,264,403,667,32,699
公投第１５案,高雄市,三民區,安康里,1011,1350,315,342,657,34,691
公投第１５案,高雄市,三民區,安寧里,1012,872,151,274,425,20,445
公投第１５案,高雄市,三民區,安寧里,1013,954,190,299,489,21,510
公投第１５案,高雄市,三民區,安吉里,1014,1689,359,637,996,20,1016
公投第１５案,高雄市,三民區,安吉里,1015,1390,295,498,793,15,808
公投第１５案,高雄市,三民區,安吉里,1016,1336,279,502,781,57,838
公投第１５案,高雄市,三民區,安發里,1017,1437,341,579,920,41,961
公投第１５案,高雄市,三民區,安發里,1018,1452,304,545,849,29,878
公投第１５案,高雄市,三民區,安發里,1019,1513,326,542,868,70,938
公投第１５案,高雄市,三民區,安東里,1020,1467,335,547,882,81,963
公投第１５案,高雄市,三民區,安東里,1021,1381,291,576,867,82,949
公投第１５案,高雄市,三民區,安和里,1022,1117,229,395,624,47,671
公投第１５案,高雄市,三民區,安和里,1023,1327,294,509,803,36,839
公投第１５案,高雄市,三民區,達德里,1024,1304,256,528,784,33,817
公投第１５案,高雄市,三民區,達明里,1025,1483,277,525,802,34,836
公投第１５案,高雄市,三民區,達仁里,1026,1473,307,584,891,34,925
公投第１５案,高雄市,三民區,達勇里,1027,980,198,371,569,37,606
公投第１５案,高雄市,三民區,同德里,1028,1409,354,466,820,58,878
公投第１５案,高雄市,三民區,同德里,1029,1230,260,461,721,39,760
公投第１５案,高雄市,三民區,德智里,1030,1024,224,404,628,56,684
公投第１５案,高雄市,三民區,德智里,1031,1130,231,436,667,47,714
公投第１５案,高雄市,三民區,德仁里,1032,1889,315,655,970,34,1004
公投第１５案,高雄市,三民區,安生里,1033,1427,265,538,803,34,837
公投第１５案,高雄市,三民區,德東里,1034,791,122,352,474,25,499
公投第１５案,高雄市,三民區,德行里,1035,1079,219,477,696,72,768
公投第１５案,高雄市,三民區,精華里,1036,1492,292,548,840,64,904
公投第１５案,高雄市,三民區,民享里,1037,1020,208,401,609,54,663
公投第１５案,高雄市,三民區,民享里,1038,1001,210,406,616,15,631
公投第１５案,高雄市,三民區,安宜里,1039,1581,302,609,911,42,953
公投第１５案,高雄市,三民區,安宜里,1040,1471,285,546,831,39,870
公投第１５案,高雄市,三民區,安泰里,1041,1151,243,465,708,17,725
公投第１５案,高雄市,三民區,安泰里,1042,1334,260,552,812,48,860
公投第１５案,高雄市,三民區,安泰里,1043,1275,225,501,726,47,773
公投第１５案,高雄市,三民區,安邦里,1044,1688,256,487,743,36,779
公投第１５案,高雄市,三民區,安邦里,1045,1214,250,449,699,37,736
公投第１５案,高雄市,三民區,安邦里,1046,1149,260,463,723,21,744
公投第１５案,高雄市,三民區,十全里,1047,1667,311,631,942,79,1021
公投第１５案,高雄市,三民區,十美里,1048,1786,360,575,935,31,966
公投第１５案,高雄市,三民區,德北里,1049,896,172,360,532,22,554
公投第１５案,高雄市,三民區,德北里,1050,925,178,352,530,49,579
公投第１５案,高雄市,三民區,立誠里,1051,684,141,279,420,53,473
公投第１５案,高雄市,三民區,立業里,1052,981,227,373,600,60,660
公投第１５案,高雄市,三民區,港東里,1053,1383,230,457,687,73,760
公投第１５案,高雄市,三民區,港新里,1054,1382,266,532,798,39,837
公投第１５案,高雄市,三民區,港西里,1055,808,163,284,447,26,473
公投第１５案,高雄市,三民區,博愛里,1056,1197,260,444,704,25,729
公投第１５案,高雄市,三民區,博惠里,1057,1344,220,525,745,43,788
公投第１５案,高雄市,三民區,博惠里,1058,1344,271,504,775,63,838
公投第１５案,高雄市,三民區,博惠里,1059,1359,270,533,803,23,826
公投第１５案,高雄市,三民區,長明里,1060,1073,209,421,630,55,685
公投第１５案,高雄市,三民區,建東里,1061,1186,214,423,637,43,680
公投第１５案,高雄市,三民區,興德里,1062,1749,335,619,954,72,1026
公投第１５案,高雄市,三民區,鳳南里,1063,877,149,314,463,18,481
公投第１５案,高雄市,三民區,鳳北里,1064,1402,276,563,839,87,926
公投第１５案,高雄市,三民區,德西里,1065,769,151,328,479,23,502
公投第１５案,高雄市,三民區,豐裕里,1066,1207,229,491,720,46,766
公投第１５案,高雄市,三民區,豐裕里,1067,1270,217,428,645,41,686
公投第１５案,高雄市,三民區,川東里,1068,1248,266,434,700,46,746
公投第１５案,高雄市,三民區,裕民里,1069,1263,267,480,747,53,800
公投第１５案,高雄市,三民區,力行里,1070,1101,197,444,641,33,674
公投第１５案,高雄市,三民區,千歲里,1071,1116,245,426,671,19,690
公投第１５案,高雄市,三民區,立德里,1072,1152,221,446,667,41,708
公投第１５案,高雄市,三民區,千北里,1073,1057,231,380,611,58,669
公投第１５案,高雄市,三民區,千秋里,1074,971,164,351,515,42,557
公投第１５案,高雄市,三民區,千秋里,1075,1062,197,400,597,21,618
公投第１５案,高雄市,前金區,三川里,1076,673,131,239,370,18,388
公投第１５案,高雄市,前金區,草江里,1077,1022,202,402,604,33,637
公投第１５案,高雄市,前金區,長城里,1078,1324,242,489,731,30,761
公投第１５案,高雄市,前金區,北金里,1079,839,166,312,478,34,512
公投第１５案,高雄市,前金區,東金里,1080,975,205,357,562,48,610
公投第１５案,高雄市,前金區,新生里,1081,1806,349,671,1020,52,1072
公投第１５案,高雄市,前金區,新生里,1082,1781,343,682,1025,42,1067
公投第１５案,高雄市,前金區,後金里,1083,717,148,286,434,24,458
公投第１５案,高雄市,前金區,長興里,1084,1097,219,405,624,12,636
公投第１５案,高雄市,前金區,青山里,1085,1633,341,591,932,25,957
公投第１５案,高雄市,前金區,民生里,1086,759,180,307,487,30,517
公投第１５案,高雄市,前金區,復元里,1087,948,206,374,580,37,617
公投第１５案,高雄市,前金區,林投里,1088,1009,167,317,484,76,560
公投第１５案,高雄市,前金區,國民里,1089,945,204,359,563,24,587
公投第１５案,高雄市,前金區,社東里,1090,772,167,288,455,14,469
公投第１５案,高雄市,前金區,社東里,1091,757,165,293,458,32,490
公投第１５案,高雄市,前金區,社西里,1092,1047,222,419,641,28,669
公投第１５案,高雄市,前金區,博孝里,1093,985,190,397,587,43,630
公投第１５案,高雄市,前金區,長生里,1094,1674,330,588,918,22,940
公投第１５案,高雄市,前金區,榮復里,1095,1088,186,413,599,43,642
公投第１５案,高雄市,前金區,文西里,1096,893,196,360,556,48,604
公投第１５案,高雄市,前金區,文東里,1097,1184,217,446,663,23,686
公投第１５案,高雄市,新興區,浩然里,1098,828,167,301,468,28,496
公投第１５案,高雄市,新興區,浩然里,1099,963,218,379,597,42,639
公投第１５案,高雄市,新興區,振成里,1100,1075,187,393,580,20,600
公投第１５案,高雄市,新興區,德生里,1101,1488,327,537,864,23,887
公投第１５案,高雄市,新興區,德生里,1102,1438,321,521,842,32,874
公投第１５案,高雄市,新興區,振華里,1103,1049,235,380,615,29,644
公投第１５案,高雄市,新興區,正氣里,1104,1378,292,557,849,73,922
公投第１５案,高雄市,新興區,德政里,1105,666,125,290,415,27,442
公投第１５案,高雄市,新興區,仁聲里,1106,981,218,365,583,16,599
公投第１５案,高雄市,新興區,德望里,1107,933,197,391,588,29,617
公投第１５案,高雄市,新興區,德望里,1108,987,175,387,562,22,584
公投第１５案,高雄市,新興區,華聲里,1109,988,206,390,596,30,626
公投第１５案,高雄市,新興區,蕉園里,1110,735,166,294,460,34,494
公投第１５案,高雄市,新興區,永寧里,1111,1317,289,472,761,32,793
公投第１５案,高雄市,新興區,玉衡里,1112,800,140,294,434,16,450
公投第１５案,高雄市,新興區,順昌里,1113,968,191,388,579,35,614
公投第１５案,高雄市,新興區,順昌里,1114,913,179,369,548,20,568
公投第１５案,高雄市,新興區,文昌里,1115,1389,340,529,869,16,885
公投第１５案,高雄市,新興區,文昌里,1116,1228,493,298,791,41,832
公投第１５案,高雄市,新興區,光耀里,1117,1211,257,461,718,55,773
公投第１５案,高雄市,新興區,光耀里,1118,1101,220,443,663,25,688
公投第１５案,高雄市,新興區,興昌里,1119,752,172,294,466,18,484
公投第１５案,高雄市,新興區,興昌里,1120,873,240,352,592,31,623
公投第１５案,高雄市,新興區,開平里,1121,1609,329,610,939,45,984
公投第１５案,高雄市,新興區,開平里,1122,1736,391,671,1062,43,1105
公投第１５案,高雄市,新興區,成功里,1123,1258,251,472,723,22,745
公投第１５案,高雄市,新興區,新江里,1124,1105,248,409,657,38,695
公投第１５案,高雄市,新興區,黎明里,1125,851,153,342,495,43,538
公投第１５案,高雄市,新興區,愛平里,1126,1011,214,389,603,43,646
公投第１５案,高雄市,新興區,南港里,1127,888,201,365,566,55,621
公投第１５案,高雄市,新興區,南港里,1128,1005,213,369,582,35,617
公投第１５案,高雄市,新興區,中東里,1129,1375,218,393,611,21,632
公投第１５案,高雄市,新興區,中東里,1130,1388,326,499,825,37,862
公投第１５案,高雄市,新興區,明莊里,1131,719,122,274,396,37,433
公投第１５案,高雄市,新興區,大明里,1132,1077,225,378,603,56,659
公投第１５案,高雄市,新興區,秋山里,1133,875,166,274,440,16,456
公投第１５案,高雄市,新興區,長驛里,1134,936,187,328,515,18,533
公投第１５案,高雄市,新興區,建興里,1135,944,186,314,500,64,564
公投第１５案,高雄市,新興區,建華里,1136,833,160,277,437,24,461
公投第１５案,高雄市,新興區,漢民里,1137,708,138,280,418,9,427
公投第１５案,高雄市,新興區,榮治里,1138,741,146,276,422,14,436
公投第１５案,高雄市,新興區,東坡里,1139,1235,216,423,639,22,661
公投第１５案,高雄市,苓雅區,博仁里,1140,718,170,261,431,20,451
公投第１５案,高雄市,苓雅區,苓洲里,1141,1492,263,562,825,40,865
公投第１５案,高雄市,苓雅區,苓昇里,1142,1210,235,468,703,46,749
公投第１５案,高雄市,苓雅區,苓中里,1143,1617,283,553,836,28,864
公投第１５案,高雄市,苓雅區,苓雅里,1144,1428,259,558,817,79,896
公投第１５案,高雄市,苓雅區,苓東里,1145,1444,265,480,745,35,780
公投第１５案,高雄市,苓雅區,城北里,1146,1452,252,538,790,59,849
公投第１５案,高雄市,苓雅區,城西里,1147,554,98,227,325,29,354
公投第１５案,高雄市,苓雅區,城東里,1148,950,184,354,538,15,553
公投第１５案,高雄市,苓雅區,城東里,1149,978,178,350,528,13,541
公投第１５案,高雄市,苓雅區,意誠里,1150,1673,283,576,859,41,900
公投第１５案,高雄市,苓雅區,意誠里,1151,2045,377,703,1080,40,1120
公投第１５案,高雄市,苓雅區,鼓中里,1152,939,177,369,546,52,598
公投第１５案,高雄市,苓雅區,田西里,1153,1284,263,408,671,38,709
公投第１５案,高雄市,苓雅區,人和里,1154,908,178,360,538,24,562
公投第１５案,高雄市,苓雅區,人和里,1155,838,183,280,463,17,480
公投第１５案,高雄市,苓雅區,仁政里,1156,1267,271,482,753,30,783
公投第１５案,高雄市,苓雅區,廣澤里,1157,994,204,395,599,53,652
公投第１５案,高雄市,苓雅區,廣澤里,1158,774,122,291,413,20,433
公投第１５案,高雄市,苓雅區,美田里,1159,1121,237,421,658,19,677
公投第１５案,高雄市,苓雅區,華堂里,1160,1474,302,541,843,43,886
公投第１５案,高雄市,苓雅區,華堂里,1161,1525,307,569,876,68,944
公投第１５案,高雄市,苓雅區,日中里,1162,1147,250,435,685,23,708
公投第１５案,高雄市,苓雅區,日中里,1163,1014,237,387,624,35,659
公投第１５案,高雄市,苓雅區,普照里,1164,1496,323,549,872,43,915
公投第１５案,高雄市,苓雅區,普照里,1165,1499,307,596,903,52,955
公投第１５案,高雄市,苓雅區,和煦里,1166,1138,239,448,687,27,714
公投第１５案,高雄市,苓雅區,和煦里,1167,839,181,367,548,34,582
公投第１５案,高雄市,苓雅區,晴朗里,1168,2088,252,459,711,31,742
公投第１５案,高雄市,苓雅區,普天里,1169,1648,358,626,984,27,1011
公投第１５案,高雄市,苓雅區,普天里,1170,1623,308,601,909,45,954
公投第１５案,高雄市,苓雅區,林富里,1171,1932,430,788,1218,46,1264
公投第１５案,高雄市,苓雅區,林圍里,1172,1127,236,533,769,17,786
公投第１５案,高雄市,苓雅區,林圍里,1173,1156,273,517,790,19,809
公投第１５案,高雄市,苓雅區,林安里,1174,1465,304,598,902,32,934
公投第１５案,高雄市,苓雅區,光華里,1175,690,119,236,355,22,377
公投第１５案,高雄市,苓雅區,林興里,1176,1283,122,571,693,77,770
公投第１５案,高雄市,苓雅區,林華里,1177,1432,280,536,816,63,879
公投第１５案,高雄市,苓雅區,林華里,1178,1313,250,530,780,32,812
公投第１５案,高雄市,苓雅區,林西里,1179,1579,295,564,859,34,893
公投第１５案,高雄市,苓雅區,林中里,1180,1385,291,513,804,60,864
公投第１５案,高雄市,苓雅區,林中里,1181,1449,267,604,871,41,912
公投第１５案,高雄市,苓雅區,林泉里,1182,1834,398,721,1119,48,1167
公投第１５案,高雄市,苓雅區,林南里,1183,1436,309,554,863,51,914
公投第１５案,高雄市,苓雅區,林南里,1184,1431,303,597,900,27,927
公投第１５案,高雄市,苓雅區,中正里,1185,1248,275,518,793,22,815
公投第１５案,高雄市,苓雅區,中正里,1186,1470,340,572,912,32,944
公投第１５案,高雄市,苓雅區,尚義里,1187,1540,311,658,969,54,1023
公投第１５案,高雄市,苓雅區,同慶里,1188,1374,313,546,859,24,883
公投第１５案,高雄市,苓雅區,同慶里,1189,839,193,359,552,9,561
公投第１５案,高雄市,苓雅區,凱旋里,1190,1022,249,427,676,20,696
公投第１５案,高雄市,苓雅區,凱旋里,1191,1062,202,473,675,13,688
公投第１５案,高雄市,苓雅區,安祥里,1192,1078,244,427,671,13,684
公投第１５案,高雄市,苓雅區,安祥里,1193,1117,255,450,705,17,722
公投第１５案,高雄市,苓雅區,奏捷里,1194,1516,278,624,902,48,950
公投第１５案,高雄市,苓雅區,福壽里,1195,1440,307,473,780,109,889
公投第１５案,高雄市,苓雅區,福南里,1196,839,183,300,483,34,517
公投第１５案,高雄市,苓雅區,福南里,1197,888,163,336,499,20,519
公投第１５案,高雄市,苓雅區,五權里,1198,1101,266,427,693,28,721
公投第１５案,高雄市,苓雅區,五權里,1199,1004,230,449,679,32,711
公投第１５案,高雄市,苓雅區,民主里,1200,1427,270,567,837,48,885
公投第１５案,高雄市,苓雅區,民主里,1201,1168,226,465,691,28,719
公投第１５案,高雄市,苓雅區,民主里,1202,1184,277,480,757,43,800
公投第１５案,高雄市,苓雅區,林德里,1203,974,218,379,597,29,626
公投第１５案,高雄市,苓雅區,林德里,1204,849,158,297,455,11,466
公投第１５案,高雄市,苓雅區,林貴里,1205,1821,366,718,1084,35,1119
公投第１５案,高雄市,苓雅區,林榮里,1206,1306,263,524,787,44,831
公投第１５案,高雄市,苓雅區,林榮里,1207,1185,250,496,746,19,765
公投第１５案,高雄市,苓雅區,林榮里,1208,1415,296,533,829,27,856
公投第１５案,高雄市,苓雅區,英明里,1209,962,320,277,597,44,641
公投第１５案,高雄市,苓雅區,英明里,1210,964,191,352,543,51,594
公投第１５案,高雄市,苓雅區,林靖里,1211,1524,328,573,901,24,925
公投第１５案,高雄市,苓雅區,朝陽里,1212,1455,318,559,877,23,900
公投第１５案,高雄市,苓雅區,福隆里,1213,1272,236,422,658,40,698
公投第１５案,高雄市,苓雅區,福隆里,1214,1256,261,446,707,15,722
公投第１５案,高雄市,苓雅區,福祥里,1215,1203,200,464,664,32,696
公投第１５案,高雄市,苓雅區,福海里,1216,1062,194,450,644,29,673
公投第１５案,高雄市,苓雅區,福康里,1217,850,196,332,528,46,574
公投第１５案,高雄市,苓雅區,福康里,1218,1010,224,408,632,66,698
公投第１５案,高雄市,苓雅區,福人里,1219,1118,109,471,580,27,607
公投第１５案,高雄市,苓雅區,福人里,1220,937,190,373,563,38,601
公投第１５案,高雄市,苓雅區,福地里,1221,1493,238,526,764,30,794
公投第１５案,高雄市,苓雅區,福地里,1222,1183,268,453,721,25,746
公投第１５案,高雄市,苓雅區,福居里,1223,1318,221,468,689,31,720
公投第１５案,高雄市,苓雅區,福居里,1224,1362,262,515,777,42,819
公投第１５案,高雄市,苓雅區,福東里,1225,1102,196,420,616,65,681
公投第１５案,高雄市,苓雅區,福東里,1226,1481,283,556,839,45,884
公投第１５案,高雄市,苓雅區,福西里,1227,878,193,352,545,39,584
公投第１５案,高雄市,苓雅區,福西里,1228,908,169,303,472,21,493
公投第１５案,高雄市,苓雅區,永康里,1229,1056,245,406,651,41,692
公投第１５案,高雄市,苓雅區,永康里,1230,1091,186,407,593,31,624
公投第１５案,高雄市,苓雅區,正文里,1231,976,214,383,597,24,621
公投第１５案,高雄市,苓雅區,正文里,1232,1063,248,440,688,27,715
公投第１５案,高雄市,苓雅區,正言里,1233,1484,300,577,877,51,928
公投第１５案,高雄市,苓雅區,正言里,1234,1290,284,485,769,28,797
公投第１５案,高雄市,苓雅區,正大里,1235,1740,355,659,1014,56,1070
公投第１５案,高雄市,苓雅區,正大里,1236,1594,288,624,912,47,959
公投第１５案,高雄市,苓雅區,正大里,1237,1648,342,609,951,20,971
公投第１５案,高雄市,苓雅區,五福里,1238,1236,242,529,771,42,813
公投第１５案,高雄市,苓雅區,五福里,1239,1211,240,475,715,35,750
公投第１５案,高雄市,苓雅區,五福里,1240,1283,237,514,751,19,770
公投第１５案,高雄市,苓雅區,正心里,1241,1804,362,625,987,59,1046
公投第１５案,高雄市,苓雅區,正心里,1242,1718,330,699,1029,50,1079
公投第１５案,高雄市,苓雅區,正道里,1243,1297,278,503,781,38,819
公投第１５案,高雄市,苓雅區,正道里,1244,1449,294,550,844,58,902
公投第１５案,高雄市,苓雅區,正道里,1245,1307,537,219,756,37,793
公投第１５案,高雄市,苓雅區,正義里,1246,1184,244,467,711,40,751
公投第１５案,高雄市,苓雅區,正義里,1247,1250,283,492,775,63,838
公投第１５案,高雄市,苓雅區,正仁里,1248,1248,253,456,709,26,735
公投第１５案,高雄市,苓雅區,正仁里,1249,1283,225,532,757,24,781
公投第１５案,高雄市,苓雅區,文昌里,1250,1121,200,481,681,30,711
公投第１５案,高雄市,苓雅區,文昌里,1251,1258,230,512,742,25,767
公投第１５案,高雄市,苓雅區,文昌里,1252,1339,370,413,783,26,809
公投第１５案,高雄市,苓雅區,建軍里,1253,1986,356,733,1089,57,1146
公投第１５案,高雄市,苓雅區,衛武里,1254,1028,190,379,569,27,596
公投第１５案,高雄市,苓雅區,衛武里,1255,948,214,361,575,15,590
公投第１５案,高雄市,鳳山區,鳳崗里,1256,1080,241,430,671,47,718
公投第１５案,高雄市,鳳山區,縣衙里,1257,819,162,318,480,33,513
公投第１５案,高雄市,鳳山區,曹公里,1258,851,158,328,486,51,537
公投第１５案,高雄市,鳳山區,曹公里,1259,1075,244,397,641,39,680
公投第１５案,高雄市,鳳山區,鎮西里,1260,1223,228,509,737,35,772
公投第１５案,高雄市,鳳山區,鎮西里,1261,1207,324,388,712,38,750
公投第１５案,高雄市,鳳山區,鎮西里,1262,1339,231,477,708,32,740
公投第１５案,高雄市,鳳山區,鎮西里,1263,1188,221,386,607,30,637
公投第１５案,高雄市,鳳山區,北門里,1264,1055,176,419,595,49,644
公投第１５案,高雄市,鳳山區,北門里,1265,1109,191,396,587,56,643
公投第１５案,高雄市,鳳山區,北門里,1266,756,151,336,487,33,520
公投第１５案,高雄市,鳳山區,北門里,1267,1182,202,441,643,34,677
公投第１５案,高雄市,鳳山區,鎮北里,1268,1496,260,562,822,77,899
公投第１５案,高雄市,鳳山區,鎮北里,1269,2094,360,634,994,54,1048
公投第１５案,高雄市,鳳山區,鎮北里,1270,1672,300,620,920,20,940
公投第１５案,高雄市,鳳山區,鎮北里,1271,1761,331,618,949,19,968
公投第１５案,高雄市,鳳山區,鎮北里,1272,1450,252,550,802,63,865
公投第１５案,高雄市,鳳山區,武松里,1273,1455,263,467,730,32,762
公投第１５案,高雄市,鳳山區,武松里,1274,1234,209,468,677,59,736
公投第１５案,高雄市,鳳山區,忠誠里,1275,1713,365,648,1013,57,1070
公投第１５案,高雄市,鳳山區,忠誠里,1276,1698,254,623,877,31,908
公投第１５案,高雄市,鳳山區,文英里,1277,1247,275,449,724,50,774
公投第１５案,高雄市,鳳山區,文英里,1278,1087,234,397,631,37,668
公投第１５案,高雄市,鳳山區,文英里,1279,1199,238,471,709,26,735
公投第１５案,高雄市,鳳山區,文華里,1280,1559,227,625,852,47,899
公投第１５案,高雄市,鳳山區,文華里,1281,1233,247,486,733,33,766
公投第１５案,高雄市,鳳山區,文華里,1282,1277,266,469,735,49,784
公投第１５案,高雄市,鳳山區,文華里,1283,1481,261,586,847,20,867
公投第１５案,高雄市,鳳山區,文華里,1284,1154,253,479,732,23,755
公投第１５案,高雄市,鳳山區,文華里,1285,1475,318,581,899,23,922
公投第１５案,高雄市,鳳山區,文山里,1286,1247,205,438,643,33,676
公投第１５案,高雄市,鳳山區,文山里,1287,1538,271,539,810,49,859
公投第１５案,高雄市,鳳山區,文山里,1288,1097,199,415,614,35,649
公投第１５案,高雄市,鳳山區,文山里,1289,1221,244,394,638,22,660
公投第１５案,高雄市,鳳山區,文山里,1290,1075,268,423,691,41,732
公投第１５案,高雄市,鳳山區,文德里,1291,1751,366,664,1030,43,1073
公投第１５案,高雄市,鳳山區,文德里,1292,1758,352,685,1037,38,1075
公投第１５案,高雄市,鳳山區,文德里,1293,1749,303,663,966,70,1036
公投第１５案,高雄市,鳳山區,文德里,1294,1746,309,646,955,23,978
公投第１５案,高雄市,鳳山區,文德里,1295,1712,322,642,964,24,988
公投第１５案,高雄市,鳳山區,文衡里,1296,1247,237,494,731,22,753
公投第１５案,高雄市,鳳山區,文衡里,1297,1409,304,528,832,39,871
公投第１５案,高雄市,鳳山區,文衡里,1298,1347,280,490,770,46,816
公投第１５案,高雄市,鳳山區,文福里,1299,1771,353,643,996,24,1020
公投第１５案,高雄市,鳳山區,文福里,1300,1537,336,576,912,15,927
公投第１５案,高雄市,鳳山區,文福里,1301,1605,312,646,958,21,979
公投第１５案,高雄市,鳳山區,文福里,1302,1375,248,551,799,39,838
公投第１５案,高雄市,鳳山區,文福里,1303,1393,273,567,840,41,881
公投第１５案,高雄市,鳳山區,文福里,1304,1584,307,555,862,21,883
公投第１５案,高雄市,鳳山區,成功里,1305,618,121,231,352,18,370
公投第１５案,高雄市,鳳山區,縣口里,1306,423,91,172,263,6,269
公投第１５案,高雄市,鳳山區,光明里,1307,1312,221,511,732,48,780
公投第１５案,高雄市,鳳山區,和德里,1308,769,166,278,444,24,468
公投第１５案,高雄市,鳳山區,和德里,1309,1213,262,506,768,20,788
公投第１５案,高雄市,鳳山區,和興里,1310,1107,204,494,698,38,736
公投第１５案,高雄市,鳳山區,和興里,1311,1188,211,480,691,34,725
公投第１５案,高雄市,鳳山區,和興里,1312,1183,279,446,725,22,747
公投第１５案,高雄市,鳳山區,和興里,1313,1264,240,495,735,51,786
公投第１５案,高雄市,鳳山區,南興里,1314,882,161,340,501,30,531
公投第１５案,高雄市,鳳山區,三民里,1315,1007,221,446,667,40,707
公投第１５案,高雄市,鳳山區,新興里,1316,853,166,305,471,64,535
公投第１５案,高雄市,鳳山區,新興里,1317,1660,142,301,443,35,478
公投第１５案,高雄市,鳳山區,興仁里,1318,1124,224,432,656,34,690
公投第１５案,高雄市,鳳山區,興仁里,1319,1112,238,396,634,61,695
公投第１５案,高雄市,鳳山區,興仁里,1320,1182,190,455,645,32,677
公投第１５案,高雄市,鳳山區,興中里,1321,875,209,370,579,44,623
公投第１５案,高雄市,鳳山區,協和里,1322,1040,224,379,603,43,646
公投第１５案,高雄市,鳳山區,協和里,1323,1094,250,434,684,20,704
公投第１５案,高雄市,鳳山區,協和里,1324,1217,257,458,715,46,761
公投第１５案,高雄市,鳳山區,忠義里,1325,974,216,419,635,30,665
公投第１５案,高雄市,鳳山區,忠義里,1326,987,191,383,574,30,604
公投第１５案,高雄市,鳳山區,忠義里,1327,1210,244,526,770,20,790
公投第１５案,高雄市,鳳山區,忠義里,1328,1391,284,497,781,48,829
公投第１５案,高雄市,鳳山區,忠孝里,1329,1241,218,406,624,19,643
公投第１５案,高雄市,鳳山區,忠孝里,1330,1000,217,401,618,37,655
公投第１５案,高雄市,鳳山區,忠孝里,1331,1092,213,440,653,30,683
公投第１５案,高雄市,鳳山區,忠孝里,1332,1308,252,530,782,37,819
公投第１５案,高雄市,鳳山區,忠孝里,1333,1031,191,403,594,53,647
公投第１５案,高雄市,鳳山區,中和里,1334,1159,264,464,728,49,777
公投第１５案,高雄市,鳳山區,中和里,1335,1127,180,450,630,43,673
公投第１５案,高雄市,鳳山區,中和里,1336,1109,249,508,757,39,796
公投第１５案,高雄市,鳳山區,誠義里,1337,1879,351,803,1154,49,1203
公投第１５案,高雄市,鳳山區,誠義里,1338,1803,656,502,1158,37,1195
公投第１５案,高雄市,鳳山區,生明里,1339,2045,309,744,1053,62,1115
公投第１５案,高雄市,鳳山區,鎮東里,1340,1432,232,540,772,46,818
公投第１５案,高雄市,鳳山區,鎮東里,1341,1033,162,401,563,14,577
公投第１５案,高雄市,鳳山區,瑞竹里,1342,1253,220,506,726,69,795
公投第１５案,高雄市,鳳山區,瑞竹里,1343,1217,235,470,705,23,728
公投第１５案,高雄市,鳳山區,瑞竹里,1344,1267,228,550,778,42,820
公投第１５案,高雄市,鳳山區,瑞竹里,1345,1251,231,451,682,41,723
公投第１５案,高雄市,鳳山區,瑞興里,1346,1563,251,615,866,70,936
公投第１５案,高雄市,鳳山區,瑞興里,1347,1888,400,779,1179,15,1194
公投第１５案,高雄市,鳳山區,瑞興里,1348,1368,278,518,796,40,836
公投第１５案,高雄市,鳳山區,東門里,1349,1588,283,559,842,22,864
公投第１５案,高雄市,鳳山區,東門里,1350,1255,173,580,753,48,801
公投第１５案,高雄市,鳳山區,東門里,1351,1264,243,456,699,63,762
公投第１５案,高雄市,鳳山區,東門里,1352,1291,210,505,715,65,780
公投第１５案,高雄市,鳳山區,誠德里,1353,1224,205,499,704,33,737
公投第１５案,高雄市,鳳山區,誠德里,1354,1296,231,505,736,26,762
公投第１５案,高雄市,鳳山區,誠信里,1355,826,175,348,523,35,558
公投第１５案,高雄市,鳳山區,誠信里,1356,1229,197,527,724,26,750
公投第１５案,高雄市,鳳山區,誠智里,1357,1467,267,601,868,36,904
公投第１５案,高雄市,鳳山區,誠智里,1358,1218,208,492,700,45,745
公投第１５案,高雄市,鳳山區,鳳東里,1359,2173,257,910,1167,62,1229
公投第１５案,高雄市,鳳山區,鳳東里,1360,2255,378,893,1271,51,1322
公投第１５案,高雄市,鳳山區,鳳東里,1361,1556,212,693,905,41,946
公投第１５案,高雄市,鳳山區,埤頂里,1362,1521,282,531,813,42,855
公投第１５案,高雄市,鳳山區,埤頂里,1363,1407,202,499,701,42,743
公投第１５案,高雄市,鳳山區,埤頂里,1364,1542,296,590,886,52,938
公投第１５案,高雄市,鳳山區,埤頂里,1365,1502,221,560,781,25,806
公投第１５案,高雄市,鳳山區,中正里,1366,1320,235,545,780,42,822
公投第１５案,高雄市,鳳山區,中正里,1367,1507,146,660,806,33,839
公投第１５案,高雄市,鳳山區,中正里,1368,1284,103,692,795,39,834
公投第１５案,高雄市,鳳山區,海光里,1369,1441,259,499,758,40,798
公投第１５案,高雄市,鳳山區,海光里,1370,1485,246,612,858,68,926
公投第１５案,高雄市,鳳山區,國泰里,1371,1205,177,475,652,62,714
公投第１５案,高雄市,鳳山區,國泰里,1372,1284,205,453,658,29,687
公投第１５案,高雄市,鳳山區,國泰里,1373,1326,279,500,779,55,834
公投第１５案,高雄市,鳳山區,國光里,1374,1096,222,403,625,31,656
公投第１５案,高雄市,鳳山區,國光里,1375,1182,268,442,710,60,770
公投第１５案,高雄市,鳳山區,國光里,1376,1017,204,439,643,52,695
公投第１５案,高雄市,鳳山區,國隆里,1377,1198,221,425,646,73,719
公投第１５案,高雄市,鳳山區,國隆里,1378,1281,219,457,676,26,702
公投第１５案,高雄市,鳳山區,國富里,1379,1358,286,554,840,30,870
公投第１５案,高雄市,鳳山區,國富里,1380,1226,272,505,777,41,818
公投第１５案,高雄市,鳳山區,武慶里,1381,1098,215,457,672,44,716
公投第１５案,高雄市,鳳山區,武慶里,1382,1200,242,466,708,31,739
公投第１５案,高雄市,鳳山區,武漢里,1383,942,182,350,532,42,574
公投第１５案,高雄市,鳳山區,武漢里,1384,1206,218,474,692,20,712
公投第１５案,高雄市,鳳山區,武漢里,1385,1159,258,467,725,26,751
公投第１５案,高雄市,鳳山區,武漢里,1386,1401,301,545,846,38,884
公投第１５案,高雄市,鳳山區,新甲里,1387,1525,301,535,836,20,856
公投第１５案,高雄市,鳳山區,新甲里,1388,1345,227,526,753,41,794
公投第１５案,高雄市,鳳山區,新武里,1389,1180,215,510,725,28,753
公投第１５案,高雄市,鳳山區,新武里,1390,1106,202,384,586,19,605
公投第１５案,高雄市,鳳山區,新泰里,1391,1442,304,560,864,57,921
公投第１５案,高雄市,鳳山區,新泰里,1392,1376,297,532,829,32,861
公投第１５案,高雄市,鳳山區,新泰里,1393,1243,259,471,730,27,757
公投第１５案,高雄市,鳳山區,新樂里,1394,1361,269,525,794,18,812
公投第１５案,高雄市,鳳山區,新樂里,1395,1416,299,541,840,49,889
公投第１５案,高雄市,鳳山區,新樂里,1396,1536,326,615,941,51,992
公投第１５案,高雄市,鳳山區,新強里,1397,1388,250,509,759,26,785
公投第１５案,高雄市,鳳山區,新強里,1398,1241,234,469,703,81,784
公投第１５案,高雄市,鳳山區,新強里,1399,1394,290,540,830,52,882
公投第１５案,高雄市,鳳山區,新強里,1400,1188,243,522,765,22,787
公投第１５案,高雄市,鳳山區,海洋里,1401,1112,213,452,665,33,698
公投第１５案,高雄市,鳳山區,海洋里,1402,1198,173,384,557,36,593
公投第１５案,高雄市,鳳山區,海洋里,1403,1475,302,526,828,29,857
公投第１５案,高雄市,鳳山區,新富里,1404,1216,231,410,641,31,672
公投第１５案,高雄市,鳳山區,新富里,1405,1318,253,431,684,36,720
公投第１５案,高雄市,鳳山區,新富里,1406,1465,292,544,836,18,854
公投第１５案,高雄市,鳳山區,老爺里,1407,1314,214,475,689,35,724
公投第１５案,高雄市,鳳山區,老爺里,1408,1649,258,567,825,27,852
公投第１５案,高雄市,鳳山區,老爺里,1409,1601,263,555,818,99,917
公投第１５案,高雄市,鳳山區,老爺里,1410,1155,241,406,647,18,665
公投第１５案,高雄市,鳳山區,老爺里,1411,1050,191,413,604,42,646
公投第１５案,高雄市,鳳山區,中民里,1412,1417,231,504,735,16,751
公投第１５案,高雄市,鳳山區,中民里,1413,1525,274,559,833,56,889
公投第１５案,高雄市,鳳山區,中民里,1414,1514,277,523,800,53,853
公投第１５案,高雄市,鳳山區,中崙里,1415,1190,242,426,668,37,705
公投第１５案,高雄市,鳳山區,中崙里,1416,1325,221,498,719,24,743
公投第１５案,高雄市,鳳山區,中榮里,1417,1049,180,433,613,48,661
公投第１５案,高雄市,鳳山區,中榮里,1418,1026,410,182,592,30,622
公投第１５案,高雄市,鳳山區,中榮里,1419,1152,219,455,674,50,724
公投第１５案,高雄市,鳳山區,中榮里,1420,1254,209,441,650,15,665
公投第１５案,高雄市,鳳山區,過埤里,1421,1688,249,635,884,30,914
公投第１５案,高雄市,鳳山區,過埤里,1422,1657,280,644,924,52,976
公投第１５案,高雄市,鳳山區,過埤里,1423,1729,277,597,874,46,920
公投第１５案,高雄市,鳳山區,過埤里,1424,1628,314,630,944,45,989
公投第１５案,高雄市,鳳山區,過埤里,1425,1891,302,639,941,17,958
公投第１５案,高雄市,鳳山區,過埤里,1426,1594,153,706,859,35,894
公投第１５案,高雄市,鳳山區,過埤里,1427,1342,245,603,848,18,866
公投第１５案,高雄市,鳳山區,過埤里,1428,1448,281,638,919,32,951
公投第１５案,高雄市,鳳山區,正義里,1429,1405,284,532,816,62,878
公投第１５案,高雄市,鳳山區,正義里,1430,1097,224,436,660,56,716
公投第１５案,高雄市,鳳山區,正義里,1431,1248,240,503,743,74,817
公投第１５案,高雄市,鳳山區,正義里,1432,1225,264,437,701,63,764
公投第１５案,高雄市,鳳山區,正義里,1433,1214,236,474,710,21,731
公投第１５案,高雄市,鳳山區,保安里,1434,2032,412,825,1237,22,1259
公投第１５案,高雄市,鳳山區,保安里,1435,1927,317,786,1103,53,1156
公投第１５案,高雄市,鳳山區,保安里,1436,2097,380,872,1252,50,1302
公投第１５案,高雄市,鳳山區,一甲里,1437,968,153,366,519,47,566
公投第１５案,高雄市,鳳山區,一甲里,1438,1200,203,425,628,55,683
公投第１５案,高雄市,鳳山區,一甲里,1439,1101,205,406,611,61,672
公投第１５案,高雄市,鳳山區,二甲里,1440,1369,125,600,725,41,766
公投第１５案,高雄市,鳳山區,二甲里,1441,1542,295,563,858,53,911
公投第１５案,高雄市,鳳山區,二甲里,1442,1536,264,635,899,53,952
公投第１５案,高雄市,鳳山區,龍成里,1443,1382,265,480,745,34,779
公投第１５案,高雄市,鳳山區,龍成里,1444,1452,275,532,807,77,884
公投第１５案,高雄市,鳳山區,鎮南里,1445,1058,170,431,601,39,640
公投第１５案,高雄市,鳳山區,鎮南里,1446,976,179,404,583,50,633
公投第１５案,高雄市,鳳山區,鎮南里,1447,1545,252,538,790,32,822
公投第１５案,高雄市,鳳山區,鎮南里,1448,1143,220,416,636,48,684
公投第１５案,高雄市,鳳山區,富甲里,1449,1301,112,121,233,17,250
公投第１５案,高雄市,鳳山區,富甲里,1450,1250,195,423,618,32,650
公投第１５案,高雄市,鳳山區,善美里,1451,1208,225,436,661,51,712
公投第１５案,高雄市,鳳山區,善美里,1452,1202,208,459,667,76,743
公投第１５案,高雄市,鳳山區,善美里,1453,1499,299,511,810,58,868
公投第１５案,高雄市,鳳山區,善美里,1454,1522,288,542,830,35,865
公投第１５案,高雄市,鳳山區,富榮里,1455,1125,220,463,683,51,734
公投第１５案,高雄市,鳳山區,富榮里,1456,1307,251,520,771,19,790
公投第１５案,高雄市,鳳山區,南和里,1457,1405,258,532,790,51,841
公投第１５案,高雄市,鳳山區,南和里,1458,1252,240,468,708,59,767
公投第１５案,高雄市,鳳山區,南成里,1459,1291,236,565,801,26,827
公投第１５案,高雄市,鳳山區,南成里,1460,938,198,355,553,50,603
公投第１５案,高雄市,鳳山區,南成里,1461,1783,303,727,1030,28,1058
公投第１５案,高雄市,鳳山區,南成里,1462,1105,218,438,656,33,689
公投第１５案,高雄市,鳳山區,南成里,1463,1392,241,514,755,79,834
公投第１５案,高雄市,鳳山區,南成里,1464,1244,254,545,799,36,835
公投第１５案,高雄市,鳳山區,天興里,1465,1154,217,403,620,47,667
公投第１５案,高雄市,鳳山區,天興里,1466,1153,225,426,651,53,704
公投第１５案,高雄市,鳳山區,天興里,1467,1148,185,392,577,23,600
公投第１５案,高雄市,鳳山區,大德里,1468,1432,236,484,720,107,827
公投第１５案,高雄市,鳳山區,大德里,1469,1429,222,394,616,23,639
公投第１５案,高雄市,鳳山區,大德里,1470,1479,247,567,814,19,833
公投第１５案,高雄市,鳳山區,五福里,1471,1026,192,432,624,33,657
公投第１５案,高雄市,鳳山區,五福里,1472,993,205,395,600,81,681
公投第１５案,高雄市,鳳山區,五福里,1473,947,193,368,561,58,619
公投第１５案,高雄市,鳳山區,福興里,1474,1042,185,404,589,45,634
公投第１５案,高雄市,鳳山區,福興里,1475,1098,198,408,606,57,663
公投第１５案,高雄市,鳳山區,福興里,1476,1284,214,446,660,29,689
公投第１５案,高雄市,鳳山區,福興里,1477,1242,225,423,648,43,691
公投第１５案,高雄市,鳳山區,福興里,1478,1093,204,424,628,59,687
公投第１５案,高雄市,鳳山區,福祥里,1479,1353,266,459,725,42,767
公投第１５案,高雄市,鳳山區,福祥里,1480,1353,246,477,723,20,743
公投第１５案,高雄市,鳳山區,福誠里,1481,1309,237,522,759,43,802
公投第１５案,高雄市,鳳山區,福誠里,1482,1627,338,574,912,49,961
公投第１５案,高雄市,鳳山區,福誠里,1483,1372,237,542,779,70,849
公投第１５案,高雄市,前鎮區,草衙里,1484,1809,284,605,889,112,1001
公投第１５案,高雄市,前鎮區,草衙里,1485,1835,298,626,924,79,1003
公投第１５案,高雄市,前鎮區,草衙里,1486,1890,282,501,783,61,844
公投第１５案,高雄市,前鎮區,草衙里,1487,2013,338,623,961,51,1012
公投第１５案,高雄市,前鎮區,草衙里,1488,1776,600,299,899,54,953
公投第１５案,高雄市,前鎮區,明孝里,1489,1705,285,469,754,80,834
公投第１５案,高雄市,前鎮區,明孝里,1490,672,132,216,348,73,421
公投第１５案,高雄市,前鎮區,明正里,1491,1726,264,502,766,88,854
公投第１５案,高雄市,前鎮區,明正里,1492,1597,330,542,872,37,909
公投第１５案,高雄市,前鎮區,明正里,1493,1690,332,585,917,88,1005
公投第１５案,高雄市,前鎮區,明義里,1494,1080,192,435,627,64,691
公投第１５案,高雄市,前鎮區,明義里,1495,1159,222,482,704,67,771
公投第１５案,高雄市,前鎮區,仁愛里,1496,1314,226,446,672,68,740
公投第１５案,高雄市,前鎮區,德昌里,1497,896,163,345,508,57,565
公投第１５案,高雄市,前鎮區,德昌里,1498,1002,198,365,563,33,596
公投第１５案,高雄市,前鎮區,平等里,1499,2765,341,645,986,91,1077
公投第１５案,高雄市,前鎮區,平昌里,1500,600,104,222,326,57,383
公投第１５案,高雄市,前鎮區,明禮里,1501,1466,172,348,520,34,554
公投第１５案,高雄市,前鎮區,信義里,1502,1449,254,504,758,52,810
公投第１５案,高雄市,前鎮區,信德里,1503,991,141,365,506,51,557
公投第１５案,高雄市,前鎮區,信德里,1504,1248,215,473,688,78,766
公投第１５案,高雄市,前鎮區,明道里,1505,1066,201,393,594,92,686
公投第１５案,高雄市,前鎮區,興化里,1506,706,133,229,362,31,393
公投第１５案,高雄市,前鎮區,興仁里,1507,713,103,248,351,37,388
公投第１５案,高雄市,前鎮區,前鎮里,1508,1344,240,444,684,46,730
公投第１５案,高雄市,前鎮區,鎮東里,1509,856,180,294,474,55,529
公投第１５案,高雄市,前鎮區,鎮東里,1510,873,151,286,437,48,485
公投第１５案,高雄市,前鎮區,鎮榮里,1511,1114,169,372,541,55,596
公投第１５案,高雄市,前鎮區,鎮榮里,1512,1112,204,353,557,16,573
公投第１５案,高雄市,前鎮區,鎮昌里,1513,1044,201,347,548,57,605
公投第１５案,高雄市,前鎮區,鎮昌里,1514,940,163,322,485,34,519
公投第１５案,高雄市,前鎮區,鎮海里,1515,1342,198,442,640,72,712
公投第１５案,高雄市,前鎮區,鎮海里,1516,1402,310,563,873,55,928
公投第１５案,高雄市,前鎮區,鎮海里,1517,1320,279,489,768,43,811
公投第１５案,高雄市,前鎮區,鎮陽里,1518,958,162,364,526,53,579
公投第１５案,高雄市,前鎮區,興邦里,1519,1276,281,563,844,31,875
公投第１５案,高雄市,前鎮區,興邦里,1520,1459,295,554,849,69,918
公投第１５案,高雄市,前鎮區,鎮中里,1521,761,119,254,373,19,392
公投第１５案,高雄市,前鎮區,鎮北里,1522,1093,216,362,578,26,604
公投第１５案,高雄市,前鎮區,忠純里,1523,1521,234,703,937,39,976
公投第１５案,高雄市,前鎮區,忠純里,1524,1557,252,695,947,24,971
公投第１５案,高雄市,前鎮區,忠純里,1525,1821,287,667,954,30,984
公投第１５案,高雄市,前鎮區,忠誠里,1526,1066,103,604,707,30,737
公投第１５案,高雄市,前鎮區,忠誠里,1527,1046,169,499,668,13,681
公投第１５案,高雄市,前鎮區,西山里,1528,1709,316,642,958,46,1004
公投第１５案,高雄市,前鎮區,西山里,1529,1723,317,665,982,82,1064
公投第１５案,高雄市,前鎮區,民權里,1530,1202,275,483,758,32,790
公投第１５案,高雄市,前鎮區,民權里,1531,1279,296,531,827,39,866
公投第１５案,高雄市,前鎮區,民權里,1532,1513,325,624,949,35,984
公投第１５案,高雄市,前鎮區,建隆里,1533,1260,238,502,740,21,761
公投第１５案,高雄市,前鎮區,振興里,1534,1139,245,442,687,69,756
公投第１５案,高雄市,前鎮區,振興里,1535,1140,259,469,728,38,766
公投第１５案,高雄市,前鎮區,良和里,1536,1462,317,535,852,72,924
公投第１５案,高雄市,前鎮區,良和里,1537,1359,276,536,812,36,848
公投第１５案,高雄市,前鎮區,西甲里,1538,2037,343,658,1001,72,1073
公投第１５案,高雄市,前鎮區,盛興里,1539,1410,271,522,793,12,805
公投第１５案,高雄市,前鎮區,盛興里,1540,1307,237,512,749,16,765
公投第１５案,高雄市,前鎮區,盛豐里,1541,1512,282,541,823,72,895
公投第１５案,高雄市,前鎮區,盛豐里,1542,1491,302,550,852,64,916
公投第１５案,高雄市,前鎮區,興中里,1543,1621,286,608,894,62,956
公投第１５案,高雄市,前鎮區,興中里,1544,1522,253,511,764,53,817
公投第１５案,高雄市,前鎮區,興東里,1545,1593,318,590,908,54,962
公投第１５案,高雄市,前鎮區,興東里,1546,1885,378,710,1088,71,1159
公投第１５案,高雄市,前鎮區,興東里,1547,1870,387,705,1092,76,1168
公投第１５案,高雄市,前鎮區,忠孝里,1548,1388,278,549,827,23,850
公投第１５案,高雄市,前鎮區,忠孝里,1549,1348,240,545,785,46,831
公投第１５案,高雄市,前鎮區,復國里,1550,1341,206,482,688,93,781
公投第１５案,高雄市,前鎮區,復國里,1551,1364,286,558,844,41,885
公投第１５案,高雄市,前鎮區,竹內里,1552,1367,254,518,772,63,835
公投第１５案,高雄市,前鎮區,竹內里,1553,1326,236,477,713,72,785
公投第１５案,高雄市,前鎮區,竹東里,1554,1059,194,390,584,37,621
公投第１５案,高雄市,前鎮區,竹東里,1555,1119,234,450,684,16,700
公投第１５案,高雄市,前鎮區,竹南里,1556,1565,298,543,841,38,879
公投第１５案,高雄市,前鎮區,竹南里,1557,1549,284,558,842,68,910
公投第１５案,高雄市,前鎮區,竹南里,1558,1691,379,701,1080,17,1097
公投第１５案,高雄市,前鎮區,竹南里,1559,1837,376,698,1074,25,1099
公投第１５案,高雄市,前鎮區,竹北里,1560,1092,237,447,684,17,701
公投第１５案,高雄市,前鎮區,竹北里,1561,1126,221,437,658,53,711
公投第１５案,高雄市,前鎮區,竹西里,1562,1215,216,422,638,69,707
公投第１５案,高雄市,前鎮區,竹西里,1563,1443,314,530,844,32,876
公投第１５案,高雄市,前鎮區,竹西里,1564,1448,329,634,963,23,986
公投第１５案,高雄市,前鎮區,竹中里,1565,1648,329,614,943,71,1014
公投第１５案,高雄市,前鎮區,竹中里,1566,1603,284,553,837,67,904
公投第１５案,高雄市,前鎮區,瑞竹里,1567,1596,285,501,786,31,817
公投第１５案,高雄市,前鎮區,瑞南里,1568,1450,219,526,745,27,772
公投第１５案,高雄市,前鎮區,瑞南里,1569,1510,272,502,774,75,849
公投第１５案,高雄市,前鎮區,瑞南里,1570,1647,328,642,970,73,1043
公投第１５案,高雄市,前鎮區,瑞豐里,1571,1342,242,484,726,55,781
公投第１５案,高雄市,前鎮區,瑞豐里,1572,1384,256,458,714,40,754
公投第１５案,高雄市,前鎮區,瑞祥里,1573,1479,260,530,790,57,847
公投第１５案,高雄市,前鎮區,瑞祥里,1574,1546,292,625,917,30,947
公投第１５案,高雄市,前鎮區,瑞祥里,1575,1595,362,566,928,45,973
公投第１５案,高雄市,前鎮區,瑞東里,1576,1201,216,479,695,56,751
公投第１５案,高雄市,前鎮區,瑞東里,1577,1082,183,389,572,26,598
公投第１５案,高雄市,前鎮區,瑞和里,1578,996,179,327,506,40,546
公投第１５案,高雄市,前鎮區,瑞和里,1579,932,135,370,505,79,584
公投第１５案,高雄市,前鎮區,瑞平里,1580,1146,201,460,661,37,698
公投第１５案,高雄市,前鎮區,瑞平里,1581,1096,230,408,638,29,667
公投第１５案,高雄市,前鎮區,瑞平里,1582,1332,298,535,833,20,853
公投第１５案,高雄市,前鎮區,瑞隆里,1583,1175,234,429,663,37,700
公投第１５案,高雄市,前鎮區,瑞隆里,1584,986,186,367,553,52,605
公投第１５案,高雄市,前鎮區,瑞隆里,1585,1316,270,499,769,56,825
公投第１５案,高雄市,前鎮區,瑞北里,1586,1559,285,480,765,62,827
公投第１５案,高雄市,前鎮區,瑞北里,1587,1622,331,628,959,71,1030
公投第１５案,高雄市,前鎮區,瑞西里,1588,1310,224,500,724,32,756
公投第１５案,高雄市,前鎮區,瑞西里,1589,1299,264,483,747,68,815
公投第１５案,高雄市,前鎮區,瑞崗里,1590,1191,234,502,736,63,799
公投第１５案,高雄市,前鎮區,瑞崗里,1591,1375,238,500,738,32,770
公投第１５案,高雄市,前鎮區,瑞興里,1592,1338,248,508,756,30,786
公投第１５案,高雄市,前鎮區,瑞興里,1593,1175,215,427,642,29,671
公投第１５案,高雄市,前鎮區,瑞誠里,1594,1357,248,485,733,33,766
公投第１５案,高雄市,前鎮區,瑞誠里,1595,1187,240,464,704,54,758
公投第１５案,高雄市,前鎮區,瑞文里,1596,1164,213,435,648,41,689
公投第１５案,高雄市,前鎮區,瑞文里,1597,1219,269,455,724,54,778
公投第１５案,高雄市,前鎮區,瑞華里,1598,1428,270,515,785,23,808
公投第１５案,高雄市,前鎮區,瑞華里,1599,1495,279,525,804,82,886
公投第１５案,高雄市,前鎮區,瑞華里,1600,1531,359,552,911,44,955
公投第１５案,高雄市,前鎮區,瑞昌里,1601,1509,302,544,846,57,903
公投第１５案,高雄市,前鎮區,瑞昌里,1602,1591,269,578,847,65,912
公投第１５案,高雄市,小港區,小港里,1603,1108,237,450,687,27,714
公投第１５案,高雄市,小港區,小港里,1604,1171,205,475,680,58,738
公投第１５案,高雄市,小港區,港口里,1605,1557,364,606,970,15,985
公投第１５案,高雄市,小港區,港口里,1606,1668,289,595,884,19,903
公投第１５案,高雄市,小港區,港正里,1607,1183,233,515,748,19,767
公投第１５案,高雄市,小港區,港正里,1608,1372,269,518,787,31,818
公投第１５案,高雄市,小港區,港墘里,1609,1737,340,678,1018,56,1074
公投第１５案,高雄市,小港區,港明里,1610,1586,316,525,841,67,908
公投第１５案,高雄市,小港區,港明里,1611,1558,234,561,795,43,838
公投第１５案,高雄市,小港區,港后里,1612,1284,258,534,792,62,854
公投第１５案,高雄市,小港區,港后里,1613,1249,233,503,736,45,781
公投第１５案,高雄市,小港區,港南里,1614,2400,371,689,1060,86,1146
公投第１５案,高雄市,小港區,港興里,1615,1181,243,459,702,31,733
公投第１５案,高雄市,小港區,港興里,1616,1079,207,390,597,30,627
公投第１５案,高雄市,小港區,鳳宮里,1617,1335,276,471,747,42,789
公投第１５案,高雄市,小港區,鳳宮里,1618,1241,232,484,716,52,768
公投第１５案,高雄市,小港區,店鎮里,1619,1513,160,651,811,43,854
公投第１５案,高雄市,小港區,店鎮里,1620,1349,249,539,788,55,843
公投第１５案,高雄市,小港區,店鎮里,1621,1483,253,552,805,46,851
公投第１５案,高雄市,小港區,店鎮里,1622,1451,306,533,839,23,862
公投第１５案,高雄市,小港區,大苓里,1623,1241,212,443,655,26,681
公投第１５案,高雄市,小港區,大苓里,1624,1262,275,522,797,55,852
公投第１５案,高雄市,小港區,二苓里,1625,1813,316,674,990,84,1074
公投第１５案,高雄市,小港區,二苓里,1626,1877,300,622,922,37,959
公投第１５案,高雄市,小港區,三苓里,1627,1391,527,258,785,29,814
公投第１５案,高雄市,小港區,三苓里,1628,1453,281,590,871,28,899
公投第１５案,高雄市,小港區,正苓里,1629,1374,252,527,779,38,817
公投第１５案,高雄市,小港區,正苓里,1630,1348,232,526,758,39,797
公投第１５案,高雄市,小港區,正苓里,1631,1334,351,439,790,47,837
公投第１５案,高雄市,小港區,順苓里,1632,1433,292,521,813,25,838
公投第１５案,高雄市,小港區,順苓里,1633,1448,282,477,759,17,776
公投第１５案,高雄市,小港區,順苓里,1634,1488,320,578,898,63,961
公投第１５案,高雄市,小港區,六苓里,1635,1278,242,493,735,57,792
公投第１５案,高雄市,小港區,六苓里,1636,1306,300,558,858,42,900
公投第１５案,高雄市,小港區,宏亮里,1637,1625,252,665,917,72,989
公投第１５案,高雄市,小港區,宏亮里,1638,1640,359,631,990,60,1050
公投第１５案,高雄市,小港區,山東里,1639,1506,256,588,844,42,886
公投第１５案,高雄市,小港區,山東里,1640,1438,232,520,752,50,802
公投第１５案,高雄市,小港區,青島里,1641,1105,215,506,721,32,753
公投第１５案,高雄市,小港區,青島里,1642,1167,189,448,637,22,659
公投第１５案,高雄市,小港區,濟南里,1643,1420,274,594,868,27,895
公投第１５案,高雄市,小港區,濟南里,1644,1380,303,559,862,40,902
公投第１５案,高雄市,小港區,濟南里,1645,1239,222,478,700,28,728
公投第１５案,高雄市,小港區,泰山里,1646,1563,627,300,927,37,964
公投第１５案,高雄市,小港區,泰山里,1647,1644,319,619,938,53,991
公投第１５案,高雄市,小港區,山明里,1648,1895,643,395,1038,62,1100
公投第１５案,高雄市,小港區,山明里,1649,1748,287,630,917,89,1006
公投第１５案,高雄市,小港區,山明里,1650,1579,309,613,922,54,976
公投第１５案,高雄市,小港區,山明里,1651,2135,408,734,1142,43,1185
公投第１５案,高雄市,小港區,山明里,1652,1728,221,740,961,56,1017
公投第１５案,高雄市,小港區,山明里,1653,2022,366,682,1048,39,1087
公投第１５案,高雄市,小港區,高松里,1654,1329,187,453,640,24,664
公投第１５案,高雄市,小港區,高松里,1655,1320,213,500,713,44,757
公投第１５案,高雄市,小港區,高松里,1656,1267,224,487,711,70,781
公投第１５案,高雄市,小港區,松金里,1657,1298,254,501,755,76,831
公投第１５案,高雄市,小港區,松金里,1658,1289,270,510,780,36,816
公投第１５案,高雄市,小港區,松山里,1659,1534,270,624,894,45,939
公投第１５案,高雄市,小港區,松山里,1660,1494,259,605,864,41,905
公投第１５案,高雄市,小港區,大坪里,1661,1377,213,546,759,77,836
公投第１５案,高雄市,小港區,大坪里,1662,1344,261,548,809,54,863
公投第１５案,高雄市,小港區,坪頂里,1663,1508,287,546,833,49,882
公投第１５案,高雄市,小港區,坪頂里,1664,1400,253,490,743,28,771
公投第１５案,高雄市,小港區,坪頂里,1665,1457,273,592,865,48,913
公投第１５案,高雄市,小港區,坪頂里,1666,1392,218,546,764,23,787
公投第１５案,高雄市,小港區,孔宅里,1667,1983,374,659,1033,61,1094
公投第１５案,高雄市,小港區,孔宅里,1668,1204,229,438,667,26,693
公投第１５案,高雄市,小港區,孔宅里,1669,1300,174,444,618,39,657
公投第１５案,高雄市,小港區,廈莊里,1670,1857,317,744,1061,96,1157
公投第１５案,高雄市,小港區,廈莊里,1671,1566,297,593,890,22,912
公投第１５案,高雄市,小港區,合作里,1672,1343,280,561,841,47,888
公投第１５案,高雄市,小港區,合作里,1673,1236,259,486,745,68,813
公投第１５案,高雄市,小港區,桂林里,1674,1564,311,608,919,81,1000
公投第１５案,高雄市,小港區,桂林里,1675,1484,289,553,842,33,875
公投第１５案,高雄市,小港區,桂林里,1676,1477,275,555,830,28,858
公投第１５案,高雄市,小港區,桂林里,1677,1482,367,541,908,28,936
公投第１５案,高雄市,小港區,桂林里,1678,1708,306,601,907,37,944
公投第１５案,高雄市,小港區,中厝里,1679,1867,318,681,999,69,1068
公投第１５案,高雄市,小港區,中厝里,1680,1709,348,578,926,22,948
公投第１５案,高雄市,小港區,鳳鳴里,1681,1425,239,486,725,60,785
公投第１５案,高雄市,小港區,鳳鳴里,1682,1696,229,553,782,45,827
公投第１５案,高雄市,小港區,龍鳳里,1683,1522,268,472,740,35,775
公投第１５案,高雄市,小港區,龍鳳里,1684,1531,273,558,831,73,904
公投第１５案,高雄市,小港區,鳳森里,1685,2215,357,732,1089,132,1221
公投第１５案,高雄市,小港區,鳳林里,1686,1515,272,526,798,45,843
公投第１５案,高雄市,小港區,鳳林里,1687,1535,287,493,780,39,819
公投第１５案,高雄市,小港區,鳳興里,1688,1276,224,463,687,26,713
公投第１５案,高雄市,小港區,鳳興里,1689,1217,217,391,608,33,641
公投第１５案,高雄市,小港區,鳳源里,1690,1707,250,544,794,61,855
公投第１５案,高雄市,小港區,鳳源里,1691,1920,300,638,938,90,1028
公投第１５案,高雄市,大寮區,拷潭里,1692,727,120,225,345,25,370
公投第１５案,高雄市,大寮區,拷潭里,1693,718,134,210,344,16,360
公投第１５案,高雄市,大寮區,內坑里,1694,1340,200,451,651,37,688
公投第１５案,高雄市,大寮區,內坑里,1695,1575,230,477,707,37,744
公投第１５案,高雄市,大寮區,內坑里,1696,444,66,179,245,18,263
公投第１５案,高雄市,大寮區,內坑里,1697,2374,288,740,1028,34,1062
公投第１５案,高雄市,大寮區,大寮里,1698,1291,213,445,658,69,727
公投第１５案,高雄市,大寮區,大寮里,1699,1400,234,506,740,73,813
公投第１５案,高雄市,大寮區,大寮里,1700,1390,224,508,732,29,761
公投第１５案,高雄市,大寮區,大寮里,1701,1401,230,496,726,56,782
公投第１５案,高雄市,大寮區,大寮里,1702,1199,201,398,599,34,633
公投第１５案,高雄市,大寮區,上寮里,1703,1210,201,381,582,25,607
公投第１５案,高雄市,大寮區,上寮里,1704,1195,197,435,632,44,676
公投第１５案,高雄市,大寮區,三隆里,1705,1166,192,402,594,29,623
公投第１５案,高雄市,大寮區,三隆里,1706,1353,243,478,721,42,763
公投第１５案,高雄市,大寮區,三隆里,1707,1052,217,384,601,59,660
公投第１５案,高雄市,大寮區,三隆里,1708,1024,168,297,465,24,489
公投第１５案,高雄市,大寮區,琉球里,1709,1189,200,460,660,22,682
公投第１５案,高雄市,大寮區,琉球里,1710,1512,260,572,832,85,917
公投第１５案,高雄市,大寮區,琉球里,1711,1633,251,567,818,61,879
公投第１５案,高雄市,大寮區,翁園里,1712,1214,222,465,687,61,748
公投第１５案,高雄市,大寮區,翁園里,1713,1258,256,497,753,67,820
公投第１５案,高雄市,大寮區,翁園里,1714,1323,251,511,762,34,796
公投第１５案,高雄市,大寮區,前庄里,1715,1253,225,502,727,37,764
公投第１５案,高雄市,大寮區,前庄里,1716,1035,185,414,599,57,656
公投第１５案,高雄市,大寮區,中庄里,1717,1106,182,421,603,33,636
公投第１５案,高雄市,大寮區,中庄里,1718,1195,192,453,645,41,686
公投第１５案,高雄市,大寮區,中庄里,1719,1051,201,410,611,17,628
公投第１５案,高雄市,大寮區,中庄里,1720,1425,288,506,794,62,856
公投第１５案,高雄市,大寮區,中庄里,1721,1635,279,577,856,58,914
公投第１５案,高雄市,大寮區,中庄里,1722,1359,243,513,756,59,815
公投第１５案,高雄市,大寮區,中庄里,1723,1361,236,517,753,59,812
公投第１５案,高雄市,大寮區,中庄里,1724,1629,274,626,900,27,927
公投第１５案,高雄市,大寮區,後庄里,1725,1518,229,606,835,42,877
公投第１５案,高雄市,大寮區,後庄里,1726,1620,272,559,831,64,895
公投第１５案,高雄市,大寮區,後庄里,1727,1648,273,570,843,18,861
公投第１５案,高雄市,大寮區,後庄里,1728,1385,236,520,756,55,811
公投第１５案,高雄市,大寮區,後庄里,1729,1435,245,513,758,32,790
公投第１５案,高雄市,大寮區,義仁里,1730,1046,169,397,566,22,588
公投第１５案,高雄市,大寮區,義仁里,1731,789,121,276,397,29,426
公投第１５案,高雄市,大寮區,新厝里,1732,909,167,293,460,33,493
公投第１５案,高雄市,大寮區,新厝里,1733,733,146,259,405,32,437
公投第１５案,高雄市,大寮區,過溪里,1734,1553,278,507,785,61,846
公投第１５案,高雄市,大寮區,過溪里,1735,922,162,327,489,27,516
公投第１５案,高雄市,大寮區,潮寮里,1736,1012,169,356,525,63,588
公投第１５案,高雄市,大寮區,潮寮里,1737,968,165,318,483,60,543
公投第１５案,高雄市,大寮區,潮寮里,1738,1021,200,361,561,35,596
公投第１５案,高雄市,大寮區,會結里,1739,1554,215,475,690,69,759
公投第１５案,高雄市,大寮區,會社里,1740,1120,206,434,640,46,686
公投第１５案,高雄市,大寮區,會社里,1741,1225,231,489,720,44,764
公投第１５案,高雄市,大寮區,會社里,1742,1320,156,334,490,22,512
公投第１５案,高雄市,大寮區,會社里,1743,1317,231,478,709,42,751
公投第１５案,高雄市,大寮區,會社里,1744,1119,213,397,610,14,624
公投第１５案,高雄市,大寮區,山頂里,1745,1190,217,459,676,51,727
公投第１５案,高雄市,大寮區,山頂里,1746,1229,215,493,708,47,755
公投第１５案,高雄市,大寮區,山頂里,1747,1178,213,497,710,43,753
公投第１５案,高雄市,大寮區,山頂里,1748,1272,245,520,765,27,792
公投第１５案,高雄市,大寮區,山頂里,1749,1413,268,503,771,24,795
公投第１５案,高雄市,大寮區,山頂里,1750,1185,206,483,689,54,743
公投第１５案,高雄市,大寮區,忠義里,1751,553,77,232,309,9,318
公投第１５案,高雄市,大寮區,永芳里,1752,1121,181,387,568,58,626
公投第１５案,高雄市,大寮區,永芳里,1753,1227,244,453,697,24,721
公投第１５案,高雄市,大寮區,永芳里,1754,1058,216,444,660,58,718
公投第１５案,高雄市,大寮區,永芳里,1755,1209,215,452,667,30,697
公投第１５案,高雄市,大寮區,永芳里,1756,1100,187,451,638,23,661
公投第１５案,高雄市,大寮區,永芳里,1757,1122,205,376,581,28,609
公投第１５案,高雄市,大寮區,義和里,1758,983,189,394,583,62,645
公投第１５案,高雄市,大寮區,義和里,1759,1192,156,443,599,22,621
公投第１５案,高雄市,大寮區,溪寮里,1760,719,112,266,378,26,404
公投第１５案,高雄市,大寮區,溪寮里,1761,829,130,366,496,26,522
公投第１５案,高雄市,大寮區,江山里,1762,771,132,340,472,60,532
公投第１５案,高雄市,大寮區,江山里,1763,1075,205,417,622,51,673
公投第１５案,高雄市,大寮區,昭明里,1764,1280,215,505,720,77,797
公投第１５案,高雄市,大寮區,昭明里,1765,1179,198,407,605,92,697
公投第１５案,高雄市,大寮區,昭明里,1766,1210,210,422,632,26,658
公投第１５案,高雄市,大寮區,光武里,1767,189,30,81,111,6,117
公投第１５案,高雄市,大寮區,中興里,1768,1228,198,504,702,50,752
公投第１５案,高雄市,大寮區,中興里,1769,1170,171,471,642,36,678
公投第１５案,高雄市,大寮區,中興里,1770,1416,244,582,826,48,874
公投第１５案,高雄市,大寮區,中興里,1771,1482,278,581,859,45,904
公投第１５案,高雄市,大寮區,中興里,1772,1478,244,530,774,47,821
公投第１５案,高雄市,林園區,東林里,1773,1262,242,464,706,61,767
公投第１５案,高雄市,林園區,東林里,1774,1562,257,542,799,52,851
公投第１５案,高雄市,林園區,林園里,1775,1078,205,395,600,24,624
公投第１５案,高雄市,林園區,林園里,1776,979,204,382,586,43,629
公投第１５案,高雄市,林園區,林園里,1777,1195,212,411,623,56,679
公投第１５案,高雄市,林園區,溪州里,1778,1380,223,467,690,66,756
公投第１５案,高雄市,林園區,溪州里,1779,1280,210,458,668,66,734
公投第１５案,高雄市,林園區,溪州里,1780,1269,214,439,653,29,682
公投第１５案,高雄市,林園區,潭頭里,1781,1568,228,428,656,27,683
公投第１５案,高雄市,林園區,潭頭里,1782,1226,201,495,696,44,740
公投第１５案,高雄市,林園區,中厝里,1783,1480,234,534,768,51,819
公投第１５案,高雄市,林園區,中厝里,1784,1459,237,572,809,55,864
公投第１５案,高雄市,林園區,中門里,1785,1593,267,531,798,52,850
公投第１５案,高雄市,林園區,中門里,1786,895,115,313,428,118,546
公投第１５案,高雄市,林園區,頂厝里,1787,1110,177,366,543,32,575
公投第１５案,高雄市,林園區,頂厝里,1788,1348,240,436,676,55,731
公投第１５案,高雄市,林園區,頂厝里,1789,912,178,316,494,55,549
公投第１５案,高雄市,林園區,頂厝里,1790,1085,209,434,643,60,703
公投第１５案,高雄市,林園區,港埔里,1791,955,164,353,517,24,541
公投第１５案,高雄市,林園區,港埔里,1792,879,141,359,500,47,547
公投第１５案,高雄市,林園區,西溪里,1793,1103,194,346,540,59,599
公投第１５案,高雄市,林園區,西溪里,1794,1054,206,417,623,62,685
公投第１５案,高雄市,林園區,西溪里,1795,1292,212,427,639,17,656
公投第１５案,高雄市,林園區,港嘴里,1796,1683,283,500,783,24,807
公投第１５案,高雄市,林園區,北汕里,1797,607,96,227,323,29,352
公投第１５案,高雄市,林園區,北汕里,1798,1012,171,360,531,64,595
公投第１５案,高雄市,林園區,林內里,1799,1046,177,392,569,50,619
公投第１５案,高雄市,林園區,林內里,1800,914,124,289,413,23,436
公投第１５案,高雄市,林園區,王公里,1801,1405,285,505,790,51,841
公投第１５案,高雄市,林園區,王公里,1802,1299,343,396,739,56,795
公投第１５案,高雄市,林園區,王公里,1803,1170,213,417,630,37,667
公投第１５案,高雄市,林園區,林家里,1804,1299,202,381,583,37,620
公投第１５案,高雄市,林園區,龔厝里,1805,1031,184,377,561,25,586
公投第１５案,高雄市,林園區,龔厝里,1806,849,143,292,435,23,458
公投第１５案,高雄市,林園區,鳳芸里,1807,838,148,251,399,57,456
公投第１５案,高雄市,林園區,鳳芸里,1808,938,164,348,512,27,539
公投第１５案,高雄市,林園區,中芸里,1809,1051,164,343,507,32,539
公投第１５案,高雄市,林園區,中芸里,1810,786,145,286,431,51,482
公投第１５案,高雄市,林園區,東汕里,1811,894,164,335,499,61,560
公投第１５案,高雄市,林園區,西汕里,1812,749,109,180,289,17,306
公投第１５案,高雄市,林園區,仁愛里,1813,1485,273,583,856,33,889
公投第１５案,高雄市,林園區,仁愛里,1814,1478,264,562,826,80,906
公投第１５案,高雄市,林園區,文賢里,1815,1345,278,520,798,58,856
公投第１５案,高雄市,林園區,文賢里,1816,1038,193,342,535,44,579
公投第１５案,高雄市,林園區,廣應里,1817,1203,229,434,663,24,687
公投第１５案,高雄市,林園區,廣應里,1818,1138,203,432,635,18,653
公投第１５案,高雄市,林園區,廣應里,1819,1025,155,355,510,10,520
公投第１５案,高雄市,林園區,五福里,1820,1341,218,479,697,83,780
公投第１５案,高雄市,林園區,五福里,1821,1218,168,394,562,19,581
公投第１５案,高雄市,林園區,中汕里,1822,1147,148,345,493,25,518
公投第１５案,高雄市,林園區,中汕里,1823,1176,160,350,510,21,531
公投第１５案,新北市,石門區,德茂里,1,1121,186,344,530,51,581
公投第１５案,新北市,石門區,富基里,2,1389,195,408,603,69,672
公投第１５案,新北市,石門區,老梅里,3,933,121,309,430,60,490
公投第１５案,新北市,石門區,老梅里,4,1244,182,372,554,66,620
公投第１５案,新北市,石門區,山溪里,5,883,123,279,402,83,485
公投第１５案,新北市,石門區,石門里,6,1564,252,529,781,58,839
公投第１５案,新北市,石門區,尖鹿里,7,1500,247,497,744,52,796
公投第１５案,新北市,石門區,乾華里,8,328,37,98,135,16,151
公投第１５案,新北市,石門區,茂林里,9,651,120,250,370,35,405
公投第１５案,新北市,石門區,草里里,10,915,116,245,361,51,412
公投第１５案,新北市,三芝區,八賢里,11,312,44,93,137,11,148
公投第１５案,新北市,三芝區,埔頭里,12,1421,248,421,669,33,702
公投第１５案,新北市,三芝區,埔頭里,13,1557,276,476,752,53,805
公投第１５案,新北市,三芝區,埔頭里,14,1828,311,562,873,61,934
公投第１５案,新北市,三芝區,古庄里,15,1060,168,329,497,43,540
公投第１５案,新北市,三芝區,新庄里,16,819,105,209,314,42,356
公投第１５案,新北市,三芝區,埔坪里,17,1701,244,437,681,39,720
公投第１５案,新北市,三芝區,埔坪里,18,1740,288,497,785,54,839
公投第１５案,新北市,三芝區,埔坪里,19,1451,211,422,633,43,676
公投第１５案,新北市,三芝區,埔坪里,20,1248,154,369,523,53,576
公投第１５案,新北市,三芝區,茂長里,21,629,115,201,316,18,334
公投第１５案,新北市,三芝區,橫山里,22,504,62,151,213,22,235
公投第１５案,新北市,三芝區,錫板里,23,698,106,191,297,23,320
公投第１５案,新北市,三芝區,後厝里,24,2069,314,608,922,55,977
公投第１５案,新北市,三芝區,福德里,25,784,150,226,376,41,417
公投第１５案,新北市,三芝區,圓山里,26,522,86,152,238,28,266
公投第１５案,新北市,三芝區,店子里,27,587,91,157,248,61,309
公投第１５案,新北市,三芝區,興華里,28,1189,213,336,549,61,610
公投第１５案,新北市,淡水區,中和里,29,544,97,172,269,23,292
公投第１５案,新北市,淡水區,屯山里,30,1044,176,353,529,52,581
公投第１５案,新北市,淡水區,賢孝里,31,1462,200,500,700,42,742
公投第１５案,新北市,淡水區,興仁里,32,1525,237,483,720,79,799
公投第１５案,新北市,淡水區,蕃薯里,33,986,149,284,433,40,473
公投第１５案,新北市,淡水區,忠山里,34,806,128,296,424,37,461
公投第１５案,新北市,淡水區,義山里,35,1173,171,413,584,73,657
公投第１５案,新北市,淡水區,義山里,36,1343,190,417,607,39,646
公投第１５案,新北市,淡水區,水源里,37,1153,177,324,501,13,514
公投第１５案,新北市,淡水區,水源里,38,874,136,276,412,35,447
公投第１５案,新北市,淡水區,忠寮里,39,1063,155,364,519,76,595
公投第１５案,新北市,淡水區,樹興里,40,1309,187,435,622,41,663
公投第１５案,新北市,淡水區,坪頂里,41,1290,219,423,642,51,693
公投第１５案,新北市,淡水區,福德里,42,1675,319,611,930,27,957
公投第１５案,新北市,淡水區,福德里,43,1589,308,518,826,48,874
公投第１５案,新北市,淡水區,福德里,44,1624,339,556,895,47,942
公投第１５案,新北市,淡水區,福德里,45,1241,253,374,627,34,661
公投第１５案,新北市,淡水區,竹圍里,46,1317,219,423,642,53,695
公投第１５案,新北市,淡水區,竹圍里,47,1225,237,432,669,26,695
公投第１５案,新北市,淡水區,竹圍里,48,1426,287,468,755,35,790
公投第１５案,新北市,淡水區,竹圍里,49,1610,350,546,896,39,935
公投第１５案,新北市,淡水區,民權里,50,1982,403,669,1072,35,1107
公投第１５案,新北市,淡水區,民權里,51,1924,313,542,855,50,905
公投第１５案,新北市,淡水區,民生里,52,1822,348,530,878,38,916
公投第１５案,新北市,淡水區,民生里,53,1232,280,383,663,74,737
公投第１５案,新北市,淡水區,民生里,54,1588,273,552,825,71,896
公投第１５案,新北市,淡水區,民生里,55,1784,360,515,875,30,905
公投第１５案,新北市,淡水區,八勢里,56,1762,334,540,874,54,928
公投第１５案,新北市,淡水區,八勢里,57,1546,311,483,794,28,822
公投第１５案,新北市,淡水區,八勢里,58,1897,386,601,987,36,1023
公投第１５案,新北市,淡水區,竿蓁里,59,1489,277,494,771,22,793
公投第１５案,新北市,淡水區,竿蓁里,60,1679,312,514,826,38,864
公投第１５案,新北市,淡水區,竿蓁里,61,1693,311,513,824,25,849
公投第１５案,新北市,淡水區,竿蓁里,62,1674,256,554,810,19,829
公投第１５案,新北市,淡水區,竿蓁里,63,1330,247,458,705,20,725
公投第１５案,新北市,淡水區,竿蓁里,64,1467,265,487,752,19,771
公投第１５案,新北市,淡水區,崁頂里,65,1837,317,631,948,29,977
公投第１５案,新北市,淡水區,崁頂里,66,1924,233,403,636,15,651
公投第１５案,新北市,淡水區,崁頂里,67,2340,390,755,1145,25,1170
公投第１５案,新北市,淡水區,崁頂里,68,1704,251,486,737,58,795
公投第１５案,新北市,淡水區,崁頂里,69,1363,257,427,684,36,720
公投第１５案,新北市,淡水區,崁頂里,70,3068,495,906,1401,23,1424
公投第１５案,新北市,淡水區,埤島里,71,1528,226,496,722,37,759
公投第１５案,新北市,淡水區,水碓里,72,1600,313,473,786,50,836
公投第１５案,新北市,淡水區,水碓里,73,1874,319,696,1015,56,1071
公投第１５案,新北市,淡水區,水碓里,74,1567,276,506,782,52,834
公投第１５案,新北市,淡水區,北新里,75,1245,323,358,681,21,702
公投第１５案,新北市,淡水區,北新里,76,1211,244,376,620,16,636
公投第１５案,新北市,淡水區,正德里,77,1992,416,643,1059,39,1098
公投第１５案,新北市,淡水區,正德里,78,2028,401,476,877,29,906
公投第１５案,新北市,淡水區,新興里,79,1373,220,512,732,49,781
公投第１５案,新北市,淡水區,新興里,80,1732,321,592,913,30,943
公投第１５案,新北市,淡水區,新興里,81,1519,267,453,720,43,763
公投第１５案,新北市,淡水區,新興里,82,1727,286,522,808,23,831
公投第１５案,新北市,淡水區,新義里,83,1297,235,459,694,33,727
公投第１５案,新北市,淡水區,新義里,84,1066,193,333,526,45,571
公投第１５案,新北市,淡水區,新義里,85,1387,247,483,730,48,778
公投第１５案,新北市,淡水區,新春里,86,1909,337,664,1001,40,1041
公投第１５案,新北市,淡水區,新春里,87,1770,328,595,923,34,957
公投第１５案,新北市,淡水區,新春里,88,2049,338,655,993,44,1037
公投第１５案,新北市,淡水區,新春里,89,1680,344,541,885,26,911
公投第１５案,新北市,淡水區,新民里,90,1433,302,500,802,46,848
公投第１５案,新北市,淡水區,新民里,91,1365,264,442,706,25,731
公投第１５案,新北市,淡水區,新民里,92,1452,284,493,777,36,813
公投第１５案,新北市,淡水區,北投里,93,1804,303,615,918,42,960
公投第１５案,新北市,淡水區,北投里,94,1322,251,445,696,40,736
公投第１５案,新北市,淡水區,北投里,95,2019,414,626,1040,31,1071
公投第１５案,新北市,淡水區,北投里,96,1696,323,620,943,37,980
公投第１５案,新北市,淡水區,北投里,97,1576,308,553,861,24,885
公投第１５案,新北市,淡水區,鄧公里,98,1781,363,596,959,33,992
公投第１５案,新北市,淡水區,鄧公里,99,1665,356,563,919,55,974
公投第１５案,新北市,淡水區,鄧公里,100,2013,375,659,1034,47,1081
公投第１５案,新北市,淡水區,幸福里,101,1108,212,341,553,41,594
公投第１５案,新北市,淡水區,幸福里,102,1305,250,436,686,40,726
公投第１５案,新北市,淡水區,幸福里,103,1199,216,416,632,21,653
公投第１５案,新北市,淡水區,學府里,104,2017,364,666,1030,38,1068
公投第１５案,新北市,淡水區,學府里,105,2125,386,611,997,43,1040
公投第１５案,新北市,淡水區,中興里,106,1289,199,378,577,27,604
公投第１５案,新北市,淡水區,中興里,107,1319,263,475,738,49,787
公投第１５案,新北市,淡水區,中興里,108,1051,195,380,575,28,603
公投第１５案,新北市,淡水區,長庚里,109,1348,231,470,701,35,736
公投第１５案,新北市,淡水區,清文里,110,1106,210,346,556,35,591
公投第１５案,新北市,淡水區,草東里,111,717,135,257,392,28,420
公投第１５案,新北市,淡水區,協元里,112,1385,268,436,704,33,737
公投第１５案,新北市,淡水區,永吉里,113,841,173,290,463,39,502
公投第１５案,新北市,淡水區,民安里,114,665,135,228,363,23,386
公投第１５案,新北市,淡水區,新生里,115,419,86,151,237,14,251
公投第１５案,新北市,淡水區,文化里,116,1599,306,570,876,25,901
公投第１５案,新北市,淡水區,油車里,117,1670,293,524,817,61,878
公投第１５案,新北市,淡水區,油車里,118,1683,321,586,907,52,959
公投第１５案,新北市,淡水區,油車里,119,1577,256,500,756,50,806
公投第１５案,新北市,淡水區,沙崙里,120,1618,275,500,775,38,813
公投第１５案,新北市,淡水區,沙崙里,121,2214,353,647,1000,37,1037
公投第１５案,新北市,淡水區,大庄里,122,1832,321,593,914,40,954
公投第１５案,新北市,淡水區,大庄里,123,2123,374,680,1054,61,1115
公投第１５案,新北市,淡水區,大庄里,124,2998,400,881,1281,18,1299
公投第１５案,新北市,八里區,龍源里,125,1498,251,442,693,51,744
公投第１５案,新北市,八里區,龍源里,126,1939,330,535,865,34,899
公投第１５案,新北市,八里區,龍源里,127,1516,239,509,748,61,809
公投第１５案,新北市,八里區,龍源里,128,1642,335,561,896,46,942
公投第１５案,新北市,八里區,米倉里,129,1927,348,520,868,74,942
公投第１５案,新北市,八里區,米倉里,130,1276,234,415,649,44,693
公投第１５案,新北市,八里區,大崁里,131,1349,247,502,749,40,789
公投第１５案,新北市,八里區,大崁里,132,1403,253,495,748,38,786
公投第１５案,新北市,八里區,埤頭里,133,1644,294,547,841,48,889
公投第１５案,新北市,八里區,埤頭里,134,1853,307,635,942,55,997
公投第１５案,新北市,八里區,頂罟里,135,1793,321,667,988,56,1044
公投第１５案,新北市,八里區,舊城里,136,1644,281,553,834,49,883
公投第１５案,新北市,八里區,舊城里,137,1846,330,589,919,44,963
公投第１５案,新北市,八里區,舊城里,138,1346,240,430,670,49,719
公投第１５案,新北市,八里區,舊城里,139,1621,307,510,817,51,868
公投第１５案,新北市,八里區,訊塘里,140,2110,255,630,885,58,943
公投第１５案,新北市,八里區,訊塘里,141,1967,314,629,943,64,1007
公投第１５案,新北市,八里區,荖阡里,142,1626,292,538,830,67,897
公投第１５案,新北市,八里區,長坑里,143,1514,256,518,774,60,834
公投第１５案,新北市,八里區,下罟里,144,1456,256,496,752,87,839
公投第１５案,新北市,林口區,東林里,145,1268,203,426,629,53,682
公投第１５案,新北市,林口區,東林里,146,1171,211,354,565,42,607
公投第１５案,新北市,林口區,東林里,147,1218,233,414,647,50,697
公投第１５案,新北市,林口區,林口里,148,1788,317,555,872,43,915
公投第１５案,新北市,林口區,林口里,149,1625,283,480,763,65,828
公投第１５案,新北市,林口區,林口里,150,1448,280,420,700,59,759
公投第１５案,新北市,林口區,西林里,151,1328,217,402,619,66,685
公投第１５案,新北市,林口區,西林里,152,1523,238,415,653,54,707
公投第１５案,新北市,林口區,西林里,153,1245,227,417,644,39,683
公投第１５案,新北市,林口區,西林里,154,1329,278,522,800,26,826
公投第１５案,新北市,林口區,西林里,155,1465,313,509,822,37,859
公投第１５案,新北市,林口區,西林里,156,1369,300,479,779,27,806
公投第１５案,新北市,林口區,菁湖里,157,1346,280,461,741,49,790
公投第１５案,新北市,林口區,菁湖里,158,1181,212,377,589,60,649
公投第１５案,新北市,林口區,菁湖里,159,1291,291,478,769,32,801
公投第１５案,新北市,林口區,中湖里,160,1213,210,413,623,51,674
公投第１５案,新北市,林口區,中湖里,161,1256,243,456,699,34,733
公投第１５案,新北市,林口區,中湖里,162,1185,207,393,600,47,647
公投第１５案,新北市,林口區,湖北里,163,1361,213,483,696,60,756
公投第１５案,新北市,林口區,湖南里,164,1756,292,585,877,22,899
公投第１５案,新北市,林口區,湖南里,165,1676,256,587,843,20,863
公投第１５案,新北市,林口區,湖南里,166,1540,304,553,857,15,872
公投第１５案,新北市,林口區,湖南里,167,1569,291,528,819,32,851
公投第１５案,新北市,林口區,湖南里,168,1514,286,525,811,27,838
公投第１５案,新北市,林口區,湖南里,169,1193,265,409,674,18,692
公投第１５案,新北市,林口區,湖南里,170,1610,332,556,888,23,911
公投第１５案,新北市,林口區,湖南里,171,1338,290,452,742,34,776
公投第１５案,新北市,林口區,湖南里,172,1141,217,432,649,27,676
公投第１５案,新北市,林口區,湖南里,173,1307,259,450,709,32,741
公投第１５案,新北市,林口區,湖南里,174,1327,272,468,740,24,764
公投第１５案,新北市,林口區,湖南里,175,1285,277,441,718,32,750
公投第１５案,新北市,林口區,南勢里,176,1481,339,466,805,40,845
公投第１５案,新北市,林口區,南勢里,177,1510,339,503,842,23,865
公投第１５案,新北市,林口區,南勢里,178,1785,341,564,905,40,945
公投第１５案,新北市,林口區,南勢里,179,1792,351,595,946,28,974
公投第１５案,新北市,林口區,南勢里,180,1517,315,517,832,28,860
公投第１５案,新北市,林口區,南勢里,181,1564,334,539,873,26,899
公投第１５案,新北市,林口區,南勢里,182,1560,286,586,872,23,895
公投第１５案,新北市,林口區,南勢里,183,1544,324,485,809,30,839
公投第１５案,新北市,林口區,南勢里,184,1593,301,534,835,27,862
公投第１５案,新北市,林口區,南勢里,185,1431,284,481,765,30,795
公投第１５案,新北市,林口區,仁愛里,186,1571,325,487,812,32,844
公投第１５案,新北市,林口區,仁愛里,187,1439,310,485,795,32,827
公投第１５案,新北市,林口區,仁愛里,188,1451,306,498,804,35,839
公投第１５案,新北市,林口區,仁愛里,189,1391,326,471,797,44,841
公投第１５案,新北市,林口區,麗林里,190,1461,277,492,769,45,814
公投第１５案,新北市,林口區,麗林里,191,1691,340,553,893,21,914
公投第１５案,新北市,林口區,麗林里,192,1524,304,500,804,43,847
公投第１５案,新北市,林口區,麗林里,193,1343,278,527,805,34,839
公投第１５案,新北市,林口區,麗林里,194,1398,317,493,810,31,841
公投第１５案,新北市,林口區,東勢里,195,1380,270,520,790,31,821
公投第１５案,新北市,林口區,東勢里,196,1367,258,463,721,49,770
公投第１５案,新北市,林口區,東勢里,197,1350,272,477,749,35,784
公投第１５案,新北市,林口區,東勢里,198,1194,254,403,657,45,702
公投第１５案,新北市,林口區,麗園里,199,1344,250,435,685,52,737
公投第１５案,新北市,林口區,麗園里,200,1154,215,398,613,39,652
公投第１５案,新北市,林口區,麗園里,201,1119,253,416,669,28,697
公投第１５案,新北市,林口區,頂福里,202,1026,160,295,455,49,504
公投第１５案,新北市,林口區,下福里,203,1210,226,383,609,64,673
公投第１５案,新北市,林口區,嘉寶里,204,912,166,284,450,67,517
公投第１５案,新北市,林口區,瑞平里,205,824,176,264,440,39,479
公投第１５案,新北市,林口區,太平里,206,1411,287,481,768,66,834
公投第１５案,新北市,五股區,興珍里,207,1456,277,424,701,96,797
公投第１５案,新北市,五股區,興珍里,208,1482,252,483,735,51,786
公投第１５案,新北市,五股區,興珍里,209,1287,256,426,682,43,725
公投第１５案,新北市,五股區,更寮里,210,1106,218,324,542,34,576
公投第１５案,新北市,五股區,觀音里,211,1283,199,407,606,75,681
公投第１５案,新北市,五股區,集福里,212,1833,345,563,908,51,959
公投第１５案,新北市,五股區,集福里,213,1141,230,381,611,45,656
公投第１５案,新北市,五股區,集福里,214,463,88,162,250,34,284
公投第１５案,新北市,五股區,集賢里,215,1786,324,604,928,50,978
公投第１５案,新北市,五股區,集賢里,216,1660,315,500,815,46,861
公投第１５案,新北市,五股區,成德里,217,1534,306,462,768,77,845
公投第１５案,新北市,五股區,成德里,218,1285,230,445,675,60,735
公投第１５案,新北市,五股區,成州里,219,1832,307,557,864,99,963
公投第１５案,新北市,五股區,成州里,220,1542,292,495,787,35,822
公投第１５案,新北市,五股區,成州里,221,1897,289,563,852,40,892
公投第１５案,新北市,五股區,成功里,222,1964,306,565,871,90,961
公投第１５案,新北市,五股區,成功里,223,1779,302,515,817,68,885
公投第１５案,新北市,五股區,成功里,224,1735,289,544,833,73,906
公投第１５案,新北市,五股區,成泰里,225,2299,421,661,1082,29,1111
公投第１５案,新北市,五股區,成泰里,226,1755,266,540,806,49,855
公投第１５案,新北市,五股區,成泰里,227,1674,282,592,874,52,926
公投第１５案,新北市,五股區,成泰里,228,1661,273,585,858,62,920
公投第１５案,新北市,五股區,五龍里,229,1281,257,326,583,36,619
公投第１５案,新北市,五股區,五福里,230,1566,263,526,789,59,848
公投第１５案,新北市,五股區,五福里,231,1560,238,492,730,27,757
公投第１５案,新北市,五股區,六福里,232,1622,182,661,843,39,882
公投第１５案,新北市,五股區,六福里,233,1779,289,631,920,36,956
公投第１５案,新北市,五股區,民義里,234,1487,235,484,719,57,776
公投第１５案,新北市,五股區,民義里,235,1567,321,495,816,43,859
公投第１５案,新北市,五股區,五股里,236,1333,199,304,503,29,532
公投第１５案,新北市,五股區,五股里,237,1263,280,433,713,52,765
公投第１５案,新北市,五股區,五股里,238,1314,219,482,701,76,777
公投第１５案,新北市,五股區,德音里,239,1513,271,477,748,36,784
公投第１５案,新北市,五股區,德音里,240,1517,261,566,827,31,858
公投第１５案,新北市,五股區,德音里,241,1613,308,504,812,62,874
公投第１５案,新北市,五股區,水碓里,242,1616,277,548,825,49,874
公投第１５案,新北市,五股區,水碓里,243,1616,296,517,813,53,866
公投第１５案,新北市,五股區,水碓里,244,1689,305,554,859,60,919
公投第１５案,新北市,五股區,水碓里,245,1894,342,604,946,35,981
公投第１５案,新北市,五股區,福德里,246,1210,248,466,714,49,763
公投第１５案,新北市,五股區,福德里,247,1643,523,292,815,48,863
公投第１５案,新北市,五股區,德泰里,248,1441,254,478,732,28,760
公投第１５案,新北市,五股區,德泰里,249,1305,249,480,729,26,755
公投第１５案,新北市,五股區,德泰里,250,1170,220,444,664,56,720
公投第１５案,新北市,五股區,貿商里,251,1397,243,552,795,58,853
公投第１５案,新北市,五股區,貿商里,252,1312,214,544,758,53,811
公投第１５案,新北市,五股區,陸一里,253,1127,154,387,541,30,571
公投第１５案,新北市,五股區,陸一里,254,1154,153,413,566,35,601
公投第１５案,新北市,泰山區,大科里,255,643,96,202,298,27,325
公投第１５案,新北市,泰山區,大科里,256,186,42,69,111,5,116
公投第１５案,新北市,泰山區,黎明里,257,1457,237,479,716,30,746
公投第１５案,新北市,泰山區,黎明里,258,1594,270,572,842,50,892
公投第１５案,新北市,泰山區,山腳里,259,1598,227,536,763,44,807
公投第１５案,新北市,泰山區,山腳里,260,1503,262,469,731,38,769
公投第１５案,新北市,泰山區,山腳里,261,1436,240,446,686,64,750
公投第１５案,新北市,泰山區,山腳里,262,1384,254,469,723,45,768
公投第１５案,新北市,泰山區,福泰里,263,1231,196,464,660,42,702
公投第１５案,新北市,泰山區,福泰里,264,1295,212,435,647,35,682
公投第１５案,新北市,泰山區,福興里,265,1563,318,521,839,60,899
公投第１５案,新北市,泰山區,福興里,266,1610,284,591,875,63,938
公投第１５案,新北市,泰山區,楓樹里,267,1253,213,430,643,33,676
公投第１５案,新北市,泰山區,楓樹里,268,1294,216,418,634,32,666
公投第１５案,新北市,泰山區,楓樹里,269,1354,276,470,746,43,789
公投第１５案,新北市,泰山區,同榮里,270,1259,211,452,663,27,690
公投第１５案,新北市,泰山區,同榮里,271,1252,268,432,700,22,722
公投第１５案,新北市,泰山區,同榮里,272,1094,203,350,553,33,586
公投第１５案,新北市,泰山區,同興里,273,1590,294,558,852,40,892
公投第１５案,新北市,泰山區,同興里,274,1634,302,544,846,66,912
公投第１５案,新北市,泰山區,全興里,275,1536,256,445,701,28,729
公投第１５案,新北市,泰山區,全興里,276,1534,305,555,860,28,888
公投第１５案,新北市,泰山區,全興里,277,1545,270,641,911,41,952
公投第１５案,新北市,泰山區,全興里,278,1399,255,488,743,41,784
公投第１５案,新北市,泰山區,全興里,279,1315,245,439,684,25,709
公投第１５案,新北市,泰山區,義學里,280,1201,263,431,694,40,734
公投第１５案,新北市,泰山區,義學里,281,1182,239,368,607,55,662
公投第１５案,新北市,泰山區,義學里,282,1665,283,538,821,60,881
公投第１５案,新北市,泰山區,義仁里,283,1855,319,626,945,65,1010
公投第１５案,新北市,泰山區,義仁里,284,1866,338,622,960,71,1031
公投第１５案,新北市,泰山區,義仁里,285,1935,387,605,992,43,1035
公投第１５案,新北市,泰山區,義仁里,286,1589,274,501,775,42,817
公投第１５案,新北市,泰山區,明志里,287,1152,202,378,580,32,612
公投第１５案,新北市,泰山區,明志里,288,1114,244,354,598,30,628
公投第１５案,新北市,泰山區,明志里,289,1040,212,394,606,43,649
公投第１５案,新北市,泰山區,泰友里,290,1003,199,357,556,42,598
公投第１５案,新北市,泰山區,泰友里,291,975,240,335,575,23,598
公投第１５案,新北市,泰山區,新明里,292,1440,283,454,737,50,787
公投第１５案,新北市,泰山區,新明里,293,1480,263,506,769,16,785
公投第１５案,新北市,泰山區,貴子里,294,1211,231,423,654,31,685
公投第１５案,新北市,泰山區,貴子里,295,1237,234,450,684,28,712
公投第１５案,新北市,泰山區,貴子里,296,1069,183,376,559,31,590
公投第１５案,新北市,泰山區,貴賢里,297,1680,344,599,943,55,998
公投第１５案,新北市,泰山區,貴賢里,298,1651,303,597,900,37,937
公投第１５案,新北市,泰山區,貴和里,299,1420,249,458,707,42,749
公投第１５案,新北市,泰山區,貴和里,300,1337,268,459,727,54,781
公投第１５案,新北市,泰山區,貴和里,301,1591,283,590,873,41,914
公投第１５案,新北市,新莊區,海山里,302,1123,243,368,611,52,663
公投第１５案,新北市,新莊區,海山里,303,1278,245,470,715,55,770
公投第１５案,新北市,新莊區,海山里,304,1163,244,451,695,43,738
公投第１５案,新北市,新莊區,海山里,305,1228,244,457,701,53,754
公投第１５案,新北市,新莊區,全安里,306,1211,231,422,653,56,709
公投第１５案,新北市,新莊區,全安里,307,1176,241,436,677,42,719
公投第１５案,新北市,新莊區,全安里,308,1536,332,556,888,50,938
公投第１５案,新北市,新莊區,全泰里,309,1486,342,538,880,51,931
公投第１５案,新北市,新莊區,全泰里,310,1513,343,563,906,68,974
公投第１５案,新北市,新莊區,全泰里,311,1395,326,507,833,55,888
公投第１５案,新北市,新莊區,忠孝里,312,1353,256,458,714,56,770
公投第１５案,新北市,新莊區,忠孝里,313,1409,279,530,809,60,869
公投第１５案,新北市,新莊區,忠孝里,314,1478,283,517,800,27,827
公投第１５案,新北市,新莊區,文衡里,315,921,204,330,534,45,579
公投第１５案,新北市,新莊區,文衡里,316,971,206,361,567,37,604
公投第１５案,新北市,新莊區,文聖里,317,1534,301,596,897,66,963
公投第１５案,新北市,新莊區,文聖里,318,1516,267,547,814,33,847
公投第１５案,新北市,新莊區,興漢里,319,697,150,236,386,26,412
公投第１５案,新北市,新莊區,興漢里,320,1235,251,442,693,26,719
公投第１５案,新北市,新莊區,興漢里,321,1138,237,392,629,32,661
公投第１５案,新北市,新莊區,榮和里,322,1063,196,357,553,19,572
公投第１５案,新北市,新莊區,榮和里,323,3399,326,485,811,37,848
公投第１５案,新北市,新莊區,文德里,324,1575,313,558,871,64,935
公投第１５案,新北市,新莊區,文明里,325,1615,392,572,964,52,1016
公投第１５案,新北市,新莊區,化成里,326,1612,297,491,788,61,849
公投第１５案,新北市,新莊區,化成里,327,1514,277,517,794,50,844
公投第１５案,新北市,新莊區,頭前里,328,1382,260,419,679,23,702
公投第１５案,新北市,新莊區,頭前里,329,1475,350,450,800,40,840
公投第１５案,新北市,新莊區,頭前里,330,1462,305,514,819,27,846
公投第１５案,新北市,新莊區,頭前里,331,1426,305,448,753,36,789
公投第１５案,新北市,新莊區,頭前里,332,1421,294,450,744,47,791
公投第１５案,新北市,新莊區,福基里,333,1536,307,522,829,37,866
公投第１５案,新北市,新莊區,福基里,334,1587,359,521,880,45,925
公投第１５案,新北市,新莊區,福基里,335,749,143,246,389,12,401
公投第１５案,新北市,新莊區,福興里,336,1276,239,479,718,43,761
公投第１５案,新北市,新莊區,福興里,337,1303,283,436,719,28,747
公投第１５案,新北市,新莊區,福興里,338,1259,256,463,719,49,768
公投第１５案,新北市,新莊區,福興里,339,1291,256,482,738,44,782
公投第１５案,新北市,新莊區,昌平里,340,1493,302,535,837,12,849
公投第１５案,新北市,新莊區,昌平里,341,1507,303,533,836,41,877
公投第１５案,新北市,新莊區,昌平里,342,1456,315,494,809,12,821
公投第１５案,新北市,新莊區,昌平里,343,1396,298,476,774,27,801
公投第１５案,新北市,新莊區,和平里,344,1351,251,400,651,53,704
公投第１５案,新北市,新莊區,和平里,345,1403,310,424,734,61,795
公投第１５案,新北市,新莊區,和平里,346,1497,292,486,778,58,836
公投第１５案,新北市,新莊區,幸福里,347,1272,244,460,704,70,774
公投第１５案,新北市,新莊區,幸福里,348,1269,228,397,625,29,654
公投第１５案,新北市,新莊區,幸福里,349,1335,283,440,723,72,795
公投第１５案,新北市,新莊區,昌隆里,350,1300,300,462,762,32,794
公投第１５案,新北市,新莊區,昌隆里,351,1286,265,465,730,49,779
公投第１５案,新北市,新莊區,昌隆里,352,1255,280,510,790,40,830
公投第１５案,新北市,新莊區,信義里,353,1558,288,531,819,76,895
公投第１５案,新北市,新莊區,信義里,354,1567,275,507,782,71,853
公投第１５案,新北市,新莊區,信義里,355,1603,298,580,878,72,950
公投第１５案,新北市,新莊區,昌信里,356,1538,324,511,835,25,860
公投第１５案,新北市,新莊區,昌信里,357,1671,353,575,928,38,966
公投第１５案,新北市,新莊區,昌明里,358,1698,315,553,868,39,907
公投第１５案,新北市,新莊區,昌明里,359,1545,371,526,897,41,938
公投第１５案,新北市,新莊區,仁義里,360,1696,347,588,935,90,1025
公投第１５案,新北市,新莊區,仁義里,361,1626,254,550,804,88,892
公投第１５案,新北市,新莊區,仁愛里,362,1170,210,365,575,58,633
公投第１５案,新北市,新莊區,仁愛里,363,1236,236,416,652,69,721
公投第１５案,新北市,新莊區,自信里,364,1071,192,364,556,54,610
公投第１５案,新北市,新莊區,自信里,365,1129,224,385,609,37,646
公投第１５案,新北市,新莊區,自立里,366,1586,326,597,923,33,956
公投第１５案,新北市,新莊區,自立里,367,1597,245,526,771,59,830
公投第１５案,新北市,新莊區,自立里,368,1573,242,493,735,87,822
公投第１５案,新北市,新莊區,自強里,369,1225,221,450,671,35,706
公投第１５案,新北市,新莊區,自強里,370,1217,186,419,605,32,637
公投第１５案,新北市,新莊區,思源里,371,1571,308,525,833,56,889
公投第１５案,新北市,新莊區,思源里,372,1594,299,512,811,53,864
公投第１５案,新北市,新莊區,思源里,373,1583,279,534,813,57,870
公投第１５案,新北市,新莊區,思賢里,374,1245,230,487,717,55,772
公投第１５案,新北市,新莊區,思賢里,375,1203,261,424,685,30,715
公投第１５案,新北市,新莊區,思賢里,376,1265,313,436,749,48,797
公投第１５案,新北市,新莊區,中華里,377,1255,236,459,695,63,758
公投第１５案,新北市,新莊區,中華里,378,1287,263,449,712,35,747
公投第１５案,新北市,新莊區,中美里,379,1167,243,426,669,63,732
公投第１５案,新北市,新莊區,中美里,380,1299,224,448,672,48,720
公投第１５案,新北市,新莊區,中美里,381,1207,244,423,667,38,705
公投第１５案,新北市,新莊區,中美里,382,1415,278,512,790,43,833
公投第１５案,新北市,新莊區,恆安里,383,1342,258,421,679,62,741
公投第１５案,新北市,新莊區,恆安里,384,1341,281,440,721,60,781
公投第１５案,新北市,新莊區,恆安里,385,1247,264,399,663,54,717
公投第１５案,新北市,新莊區,立人里,386,984,175,448,623,21,644
公投第１５案,新北市,新莊區,立人里,387,1043,215,384,599,40,639
公投第１５案,新北市,新莊區,立德里,388,1135,279,442,721,36,757
公投第１５案,新北市,新莊區,立德里,389,1185,270,406,676,27,703
公投第１５案,新北市,新莊區,中和里,390,1346,303,444,747,39,786
公投第１５案,新北市,新莊區,中和里,391,1372,248,512,760,69,829
公投第１５案,新北市,新莊區,中和里,392,1350,261,517,778,54,832
公投第１５案,新北市,新莊區,中泰里,393,1307,241,430,671,59,730
公投第１５案,新北市,新莊區,中泰里,394,1353,253,455,708,68,776
公投第１５案,新北市,新莊區,中泰里,395,1287,229,478,707,19,726
公投第１５案,新北市,新莊區,中宏里,396,1567,257,455,712,31,743
公投第１５案,新北市,新莊區,中宏里,397,1709,373,592,965,60,1025
公投第１５案,新北市,新莊區,中全里,398,1616,284,529,813,37,850
公投第１５案,新北市,新莊區,中全里,399,1628,324,470,794,51,845
公投第１５案,新北市,新莊區,立志里,400,1148,226,427,653,55,708
公投第１５案,新北市,新莊區,立志里,401,1201,245,432,677,4,681
公投第１５案,新北市,新莊區,立志里,402,1135,260,436,696,36,732
公投第１５案,新北市,新莊區,立廷里,403,1495,314,555,869,55,924
公投第１５案,新北市,新莊區,立廷里,404,1486,328,538,866,50,916
公投第１５案,新北市,新莊區,立廷里,405,1483,312,575,887,33,920
公投第１５案,新北市,新莊區,立廷里,406,1553,277,548,825,35,860
公投第１５案,新北市,新莊區,立廷里,407,1625,384,599,983,23,1006
公投第１５案,新北市,新莊區,立廷里,408,1671,346,588,934,27,961
公投第１５案,新北市,新莊區,立基里,409,1389,300,511,811,61,872
公投第１５案,新北市,新莊區,立基里,410,1272,258,439,697,40,737
公投第１５案,新北市,新莊區,立基里,411,1409,336,522,858,33,891
公投第１５案,新北市,新莊區,立基里,412,1372,314,502,816,28,844
公投第１５案,新北市,新莊區,中誠里,413,955,193,342,535,36,571
公投第１５案,新北市,新莊區,中誠里,414,952,170,307,477,64,541
公投第１５案,新北市,新莊區,中港里,415,1412,305,473,778,28,806
公投第１５案,新北市,新莊區,中港里,416,1415,268,500,768,56,824
公投第１５案,新北市,新莊區,中港里,417,1421,273,523,796,61,857
公投第１５案,新北市,新莊區,中港里,418,1293,297,469,766,43,809
公投第１５案,新北市,新莊區,中信里,419,1475,287,480,767,26,793
公投第１５案,新北市,新莊區,中信里,420,1429,277,487,764,57,821
公投第１５案,新北市,新莊區,中信里,421,1481,295,515,810,39,849
公投第１５案,新北市,新莊區,中信里,422,1472,267,561,828,63,891
公投第１５案,新北市,新莊區,中信里,423,1474,316,526,842,25,867
公投第１５案,新北市,新莊區,中平里,424,1462,333,526,859,14,873
公投第１５案,新北市,新莊區,中平里,425,1484,340,531,871,18,889
公投第１５案,新北市,新莊區,中平里,426,1461,282,528,810,30,840
公投第１５案,新北市,新莊區,中平里,427,1444,300,524,824,32,856
公投第１５案,新北市,新莊區,中平里,428,1437,306,525,831,24,855
公投第１５案,新北市,新莊區,中原里,429,1641,302,483,785,50,835
公投第１５案,新北市,新莊區,中原里,430,1633,339,486,825,42,867
公投第１５案,新北市,新莊區,中原里,431,1531,304,549,853,22,875
公投第１５案,新北市,新莊區,中原里,432,1517,317,534,851,52,903
公投第１５案,新北市,新莊區,中原里,433,1487,244,517,761,59,820
公投第１５案,新北市,新莊區,中原里,434,1560,317,538,855,35,890
公投第１５案,新北市,新莊區,中隆里,435,1584,304,549,853,48,901
公投第１５案,新北市,新莊區,中隆里,436,1602,296,542,838,33,871
公投第１５案,新北市,新莊區,中隆里,437,818,174,273,447,38,485
公投第１５案,新北市,新莊區,立功里,438,1633,268,485,753,49,802
公投第１５案,新北市,新莊區,立功里,439,1652,280,575,855,50,905
公投第１５案,新北市,新莊區,立泰里,440,1498,309,483,792,48,840
公投第１５案,新北市,新莊區,立泰里,441,1379,257,457,714,46,760
公投第１５案,新北市,新莊區,立泰里,442,1381,249,523,772,45,817
公投第１５案,新北市,新莊區,立言里,443,1535,290,543,833,73,906
公投第１５案,新北市,新莊區,立言里,444,1492,280,632,912,47,959
公投第１５案,新北市,新莊區,立言里,445,1450,307,540,847,69,916
公投第１５案,新北市,新莊區,豐年里,446,1107,229,379,608,52,660
公投第１５案,新北市,新莊區,豐年里,447,1063,228,412,640,33,673
公投第１５案,新北市,新莊區,豐年里,448,1143,218,427,645,45,690
公投第１５案,新北市,新莊區,國泰里,449,1341,251,417,668,81,749
公投第１５案,新北市,新莊區,泰豐里,450,1063,205,383,588,37,625
公投第１５案,新北市,新莊區,泰豐里,451,1096,222,399,621,40,661
公投第１５案,新北市,新莊區,瓊林里,452,1309,244,472,716,34,750
公投第１５案,新北市,新莊區,瓊林里,453,1216,247,447,694,43,737
公投第１５案,新北市,新莊區,瓊林里,454,1278,199,444,643,48,691
公投第１５案,新北市,新莊區,瓊林里,455,1352,292,418,710,65,775
公投第１５案,新北市,新莊區,福營里,456,1298,235,384,619,61,680
公投第１５案,新北市,新莊區,福營里,457,1042,199,369,568,44,612
公投第１５案,新北市,新莊區,營盤里,458,881,164,280,444,26,470
公投第１５案,新北市,新莊區,營盤里,459,1109,219,446,665,47,712
公投第１５案,新北市,新莊區,丹鳳里,460,1291,221,451,672,49,721
公投第１５案,新北市,新莊區,丹鳳里,461,1293,269,412,681,21,702
公投第１５案,新北市,新莊區,丹鳳里,462,1336,290,442,732,57,789
公投第１５案,新北市,新莊區,丹鳳里,463,1384,236,464,700,42,742
公投第１５案,新北市,新莊區,丹鳳里,464,1231,215,387,602,35,637
公投第１５案,新北市,新莊區,丹鳳里,465,940,163,346,509,24,533
公投第１５案,新北市,新莊區,合鳳里,466,1369,252,433,685,82,767
公投第１５案,新北市,新莊區,合鳳里,467,1384,220,488,708,67,775
公投第１５案,新北市,新莊區,合鳳里,468,1272,264,419,683,61,744
公投第１５案,新北市,新莊區,祥鳳里,469,1073,216,390,606,29,635
公投第１５案,新北市,新莊區,祥鳳里,470,1058,211,363,574,29,603
公投第１５案,新北市,新莊區,雙鳳里,471,1528,309,516,825,22,847
公投第１５案,新北市,新莊區,雙鳳里,472,1244,202,431,633,46,679
公投第１５案,新北市,新莊區,雙鳳里,473,1356,198,483,681,48,729
公投第１５案,新北市,新莊區,雙鳳里,474,1164,178,405,583,24,607
公投第１５案,新北市,新莊區,雙鳳里,475,1423,272,514,786,54,840
公投第１５案,新北市,新莊區,雙鳳里,476,1250,270,476,746,31,777
公投第１５案,新北市,新莊區,雙鳳里,477,1252,251,413,664,30,694
公投第１５案,新北市,新莊區,龍福里,478,1022,193,251,444,16,460
公投第１５案,新北市,新莊區,龍福里,479,959,185,337,522,44,566
公投第１５案,新北市,新莊區,龍鳳里,480,1646,352,559,911,42,953
公投第１５案,新北市,新莊區,龍鳳里,481,1551,345,467,812,54,866
公投第１５案,新北市,新莊區,龍鳳里,482,1526,310,556,866,42,908
公投第１５案,新北市,新莊區,龍鳳里,483,1518,337,506,843,24,867
公投第１５案,新北市,新莊區,龍鳳里,484,1547,345,526,871,31,902
公投第１５案,新北市,新莊區,裕民里,485,1505,263,495,758,67,825
公投第１５案,新北市,新莊區,裕民里,486,1527,267,487,754,70,824
公投第１５案,新北市,新莊區,裕民里,487,1482,263,479,742,38,780
公投第１５案,新北市,新莊區,裕民里,488,1586,271,491,762,67,829
公投第１５案,新北市,新莊區,龍安里,489,1065,197,356,553,68,621
公投第１５案,新北市,新莊區,龍安里,490,1040,216,421,637,39,676
公投第１５案,新北市,新莊區,富國里,491,1090,215,356,571,42,613
公投第１５案,新北市,新莊區,富國里,492,1071,206,378,584,46,630
公投第１５案,新北市,新莊區,富民里,493,1704,307,516,823,37,860
公投第１５案,新北市,新莊區,富民里,494,1698,311,512,823,30,853
公投第１５案,新北市,新莊區,後德里,495,1362,297,509,806,47,853
公投第１５案,新北市,新莊區,後德里,496,1350,323,452,775,38,813
公投第１５案,新北市,新莊區,萬安里,497,1689,313,568,881,82,963
公投第１５案,新北市,新莊區,萬安里,498,1612,315,549,864,74,938
公投第１５案,新北市,新莊區,建福里,499,1130,205,425,630,54,684
公投第１５案,新北市,新莊區,建福里,500,1111,233,416,649,49,698
公投第１５案,新北市,新莊區,後港里,501,1539,294,493,787,46,833
公投第１５案,新北市,新莊區,後港里,502,1586,342,521,863,38,901
公投第１５案,新北市,新莊區,後港里,503,1631,323,558,881,55,936
公投第１５案,新北市,新莊區,後港里,504,1540,336,488,824,33,857
公投第１５案,新北市,新莊區,四維里,505,1388,227,424,651,44,695
公投第１５案,新北市,新莊區,四維里,506,1388,240,404,644,73,717
公投第１５案,新北市,新莊區,四維里,507,1387,244,405,649,51,700
公投第１５案,新北市,新莊區,南港里,508,1181,217,370,587,33,620
公投第１５案,新北市,新莊區,南港里,509,1135,235,372,607,55,662
公投第１５案,新北市,新莊區,南港里,510,1173,254,391,645,30,675
公投第１５案,新北市,新莊區,南港里,511,1215,291,375,666,36,702
公投第１５案,新北市,新莊區,建安里,512,1488,318,502,820,48,868
公投第１５案,新北市,新莊區,建安里,513,1444,310,472,782,41,823
公投第１５案,新北市,新莊區,建安里,514,1499,308,500,808,29,837
公投第１５案,新北市,新莊區,建安里,515,1449,300,478,778,26,804
公投第１５案,新北市,新莊區,民全里,516,1640,332,540,872,55,927
公投第１５案,新北市,新莊區,民全里,517,1648,310,535,845,65,910
公投第１５案,新北市,新莊區,八德里,518,1371,250,414,664,58,722
公投第１５案,新北市,新莊區,八德里,519,1400,274,446,720,55,775
公投第１５案,新北市,新莊區,成德里,520,1457,260,489,749,73,822
公投第１５案,新北市,新莊區,成德里,521,1502,294,470,764,56,820
公投第１５案,新北市,新莊區,成德里,522,1412,269,455,724,61,785
公投第１５案,新北市,新莊區,民安里,523,1318,241,449,690,53,743
公投第１５案,新北市,新莊區,民安里,524,1411,212,470,682,54,736
公投第１５案,新北市,新莊區,民安里,525,1262,279,444,723,28,751
公投第１５案,新北市,新莊區,民安里,526,1228,254,471,725,18,743
公投第１５案,新北市,新莊區,民有里,527,1748,426,544,970,53,1023
公投第１５案,新北市,新莊區,民有里,528,1761,433,520,953,77,1030
公投第１５案,新北市,新莊區,民本里,529,1326,244,418,662,46,708
公投第１５案,新北市,新莊區,民本里,530,1344,201,430,631,42,673
公投第１５案,新北市,新莊區,光明里,531,1355,231,495,726,44,770
公投第１５案,新北市,新莊區,光明里,532,1306,227,470,697,65,762
公投第１５案,新北市,新莊區,光明里,533,1349,285,475,760,38,798
公投第１５案,新北市,新莊區,光正里,534,1265,253,436,689,38,727
公投第１５案,新北市,新莊區,光正里,535,1282,236,481,717,58,775
公投第１５案,新北市,新莊區,光正里,536,1237,243,468,711,39,750
公投第１５案,新北市,新莊區,光榮里,537,1301,241,459,700,29,729
公投第１５案,新北市,新莊區,光榮里,538,1262,232,445,677,50,727
公投第１５案,新北市,新莊區,光榮里,539,1270,235,454,689,37,726
公投第１５案,新北市,新莊區,光和里,540,1245,266,403,669,63,732
公投第１５案,新北市,新莊區,光和里,541,1220,213,309,522,65,587
公投第１５案,新北市,新莊區,光華里,542,1245,226,398,624,40,664
公投第１５案,新北市,新莊區,光華里,543,1212,207,409,616,40,656
公投第１５案,新北市,新莊區,光華里,544,1253,229,399,628,57,685
公投第１５案,新北市,新莊區,光華里,545,1272,214,424,638,39,677
公投第１５案,新北市,新莊區,光華里,546,1227,255,448,703,27,730
公投第１５案,新北市,新莊區,西盛里,547,1126,229,415,644,33,677
公投第１５案,新北市,新莊區,西盛里,548,1240,248,442,690,31,721
公投第１５案,新北市,新莊區,西盛里,549,1460,284,514,798,37,835
公投第１５案,新北市,新莊區,西盛里,550,1072,214,353,567,33,600
公投第１５案,新北市,新莊區,西盛里,551,1127,207,346,553,40,593
公投第１５案,新北市,新莊區,西盛里,552,1332,262,491,753,23,776
公投第１５案,新北市,新莊區,西盛里,553,1341,285,409,694,15,709
公投第１５案,新北市,新莊區,西盛里,554,1140,191,298,489,29,518
公投第１５案,新北市,蘆洲區,光華里,555,1600,325,507,832,78,910
公投第１５案,新北市,蘆洲區,光華里,556,1549,281,526,807,55,862
公投第１５案,新北市,蘆洲區,光華里,557,1516,287,517,804,70,874
公投第１５案,新北市,蘆洲區,光明里,558,1404,249,476,725,50,775
公投第１５案,新北市,蘆洲區,光明里,559,1381,235,449,684,74,758
公投第１５案,新北市,蘆洲區,光明里,560,1485,295,498,793,44,837
公投第１５案,新北市,蘆洲區,中路里,561,1779,232,410,642,52,694
公投第１５案,新北市,蘆洲區,中路里,562,1797,314,580,894,63,957
公投第１５案,新北市,蘆洲區,永安里,563,1364,262,456,718,71,789
公投第１５案,新北市,蘆洲區,永安里,564,1635,311,539,850,58,908
公投第１５案,新北市,蘆洲區,永安里,565,1567,264,451,715,39,754
公投第１５案,新北市,蘆洲區,九芎里,566,1524,270,496,766,49,815
公投第１５案,新北市,蘆洲區,九芎里,567,1612,262,516,778,57,835
公投第１５案,新北市,蘆洲區,九芎里,568,1674,297,541,838,39,877
公投第１５案,新北市,蘆洲區,延平里,569,1838,318,534,852,52,904
公投第１５案,新北市,蘆洲區,延平里,570,1814,307,484,791,36,827
公投第１５案,新北市,蘆洲區,中華里,571,1473,301,474,775,53,828
公投第１５案,新北市,蘆洲區,中華里,572,1465,276,472,748,48,796
公投第１５案,新北市,蘆洲區,中原里,573,1652,398,510,908,55,963
公投第１５案,新北市,蘆洲區,中原里,574,1650,300,546,846,67,913
公投第１５案,新北市,蘆洲區,中原里,575,1656,298,578,876,44,920
公投第１５案,新北市,蘆洲區,長安里,576,1571,271,492,763,57,820
公投第１５案,新北市,蘆洲區,長安里,577,1523,302,453,755,65,820
公投第１５案,新北市,蘆洲區,長安里,578,1475,281,465,746,48,794
公投第１５案,新北市,蘆洲區,忠義里,579,1367,265,412,677,50,727
公投第１５案,新北市,蘆洲區,忠義里,580,1514,289,522,811,45,856
公投第１５案,新北市,蘆洲區,正義里,581,1791,403,610,1013,47,1060
公投第１５案,新北市,蘆洲區,正義里,582,1714,352,633,985,58,1043
公投第１５案,新北市,蘆洲區,正義里,583,1780,373,609,982,37,1019
公投第１５案,新北市,蘆洲區,正義里,584,1713,354,581,935,38,973
公投第１５案,新北市,蘆洲區,正義里,585,1720,313,633,946,38,984
公投第１５案,新北市,蘆洲區,正義里,586,1766,340,610,950,44,994
公投第１５案,新北市,蘆洲區,南港里,587,1623,300,535,835,48,883
公投第１５案,新北市,蘆洲區,南港里,588,1740,273,641,914,36,950
公投第１５案,新北市,蘆洲區,南港里,589,1759,359,594,953,66,1019
公投第１５案,新北市,蘆洲區,永樂里,590,1775,379,581,960,69,1029
公投第１５案,新北市,蘆洲區,永樂里,591,1909,386,660,1046,43,1089
公投第１５案,新北市,蘆洲區,永樂里,592,1805,372,609,981,69,1050
公投第１５案,新北市,蘆洲區,成功里,593,1642,330,502,832,40,872
公投第１５案,新北市,蘆洲區,成功里,594,1713,327,540,867,52,919
公投第１５案,新北市,蘆洲區,成功里,595,1746,330,499,829,65,894
公投第１５案,新北市,蘆洲區,成功里,596,1596,319,497,816,62,878
公投第１５案,新北市,蘆洲區,永康里,597,1434,244,463,707,56,763
公投第１５案,新北市,蘆洲區,永康里,598,1450,301,453,754,55,809
公投第１５案,新北市,蘆洲區,永康里,599,1543,302,461,763,22,785
公投第１５案,新北市,蘆洲區,永康里,600,1525,302,481,783,44,827
公投第１５案,新北市,蘆洲區,永德里,601,1419,252,412,664,49,713
公投第１５案,新北市,蘆洲區,永德里,602,1298,292,408,700,40,740
公投第１５案,新北市,蘆洲區,永德里,603,1304,243,412,655,55,710
公投第１５案,新北市,蘆洲區,樓厝里,604,1806,348,566,914,50,964
公投第１５案,新北市,蘆洲區,樓厝里,605,1910,320,597,917,75,992
公投第１５案,新北市,蘆洲區,樓厝里,606,1873,300,526,826,50,876
公投第１５案,新北市,蘆洲區,信義里,607,1785,291,531,822,48,870
公投第１５案,新北市,蘆洲區,信義里,608,1760,292,536,828,60,888
公投第１５案,新北市,蘆洲區,玉清里,609,1841,345,624,969,56,1025
公投第１５案,新北市,蘆洲區,玉清里,610,1855,337,546,883,49,932
公投第１５案,新北市,蘆洲區,玉清里,611,1450,278,392,670,62,732
公投第１５案,新北市,蘆洲區,復興里,612,1585,287,470,757,77,834
公投第１５案,新北市,蘆洲區,復興里,613,1541,250,411,661,120,781
公投第１５案,新北市,蘆洲區,福安里,614,1626,306,511,817,55,872
公投第１５案,新北市,蘆洲區,福安里,615,1241,263,404,667,49,716
公投第１５案,新北市,蘆洲區,鷺江里,616,1634,305,533,838,54,892
公投第１５案,新北市,蘆洲區,鷺江里,617,1573,291,525,816,54,870
公投第１５案,新北市,蘆洲區,鷺江里,618,1619,336,541,877,31,908
公投第１５案,新北市,蘆洲區,恆德里,619,1878,341,585,926,79,1005
公投第１５案,新北市,蘆洲區,恆德里,620,1797,310,585,895,72,967
公投第１５案,新北市,蘆洲區,恆德里,621,1816,370,607,977,40,1017
公投第１５案,新北市,蘆洲區,溪墘里,622,1344,253,473,726,67,793
公投第１５案,新北市,蘆洲區,溪墘里,623,1492,284,502,786,61,847
公投第１５案,新北市,蘆洲區,仁復里,624,1959,323,623,946,101,1047
公投第１５案,新北市,蘆洲區,仁德里,625,1611,294,518,812,72,884
公投第１５案,新北市,蘆洲區,仁德里,626,1574,319,534,853,62,915
公投第１５案,新北市,蘆洲區,仁德里,627,1653,309,553,862,64,926
公投第１５案,新北市,蘆洲區,仁義里,628,3085,394,612,1006,53,1059
公投第１５案,新北市,蘆洲區,仁義里,629,1812,342,558,900,71,971
公投第１５案,新北市,蘆洲區,得勝里,630,1332,272,403,675,55,730
公投第１５案,新北市,蘆洲區,得勝里,631,1648,266,476,742,68,810
公投第１５案,新北市,蘆洲區,得仁里,632,1355,247,411,658,43,701
公投第１５案,新北市,蘆洲區,得仁里,633,1371,232,459,691,37,728
公投第１５案,新北市,蘆洲區,保和里,634,1111,229,239,468,172,640
公投第１５案,新北市,蘆洲區,保和里,635,1176,210,424,634,64,698
公投第１５案,新北市,蘆洲區,樹德里,636,1602,335,522,857,40,897
公投第１５案,新北市,蘆洲區,樹德里,637,1361,240,408,648,47,695
公投第１５案,新北市,蘆洲區,民和里,638,1530,250,519,769,56,825
公投第１５案,新北市,蘆洲區,民和里,639,925,163,290,453,74,527
公投第１５案,新北市,蘆洲區,水湳里,640,1851,344,627,971,59,1030
公投第１５案,新北市,蘆洲區,水湳里,641,1791,306,529,835,46,881
公投第１５案,新北市,蘆洲區,水湳里,642,1853,333,527,860,65,925
公投第１５案,新北市,蘆洲區,水湳里,643,1758,308,507,815,49,864
公投第１５案,新北市,蘆洲區,水湳里,644,1798,352,554,906,62,968
公投第１５案,新北市,蘆洲區,水河里,645,1645,320,532,852,54,906
公投第１５案,新北市,蘆洲區,水河里,646,1612,283,445,728,61,789
公投第１５案,新北市,蘆洲區,水河里,647,1784,332,472,804,61,865
公投第１５案,新北市,蘆洲區,水河里,648,1701,269,460,729,64,793
公投第１５案,新北市,蘆洲區,水河里,649,1581,267,508,775,39,814
公投第１５案,新北市,蘆洲區,仁愛里,650,1534,340,459,799,47,846
公投第１５案,新北市,蘆洲區,仁愛里,651,1620,346,525,871,60,931
公投第１５案,新北市,蘆洲區,仁愛里,652,1494,314,520,834,55,889
公投第１５案,新北市,蘆洲區,忠孝里,653,1183,273,348,621,37,658
公投第１５案,新北市,蘆洲區,忠孝里,654,985,212,315,527,41,568
公投第１５案,新北市,蘆洲區,保佑里,655,1673,292,504,796,79,875
公投第１５案,新北市,蘆洲區,保佑里,656,1688,340,533,873,73,946
公投第１５案,新北市,蘆洲區,保新里,657,1249,219,420,639,41,680
公投第１５案,新北市,蘆洲區,保新里,658,1476,273,444,717,58,775
公投第１５案,新北市,三重區,大有里,659,1509,296,468,764,45,809
公投第１５案,新北市,三重區,大有里,660,1591,305,557,862,58,920
公投第１５案,新北市,三重區,大有里,661,1653,353,554,907,56,963
公投第１５案,新北市,三重區,博愛里,662,1392,283,462,745,65,810
公投第１５案,新北市,三重區,博愛里,663,1451,271,542,813,70,883
公投第１５案,新北市,三重區,博愛里,664,1329,278,432,710,66,776
公投第１５案,新北市,三重區,二重里,665,1459,289,512,801,39,840
公投第１５案,新北市,三重區,頂崁里,666,1024,208,371,579,51,630
公投第１５案,新北市,三重區,頂崁里,667,1066,209,381,590,51,641
公投第１５案,新北市,三重區,谷王里,668,856,197,315,512,51,563
公投第１５案,新北市,三重區,五谷里,669,764,154,244,398,37,435
公投第１５案,新北市,三重區,五谷里,670,821,165,309,474,39,513
公投第１５案,新北市,三重區,中興里,671,1887,360,608,968,52,1020
公投第１５案,新北市,三重區,中興里,672,1646,347,481,828,47,875
公投第１５案,新北市,三重區,德厚里,673,358,86,114,200,18,218
公投第１５案,新北市,三重區,成功里,674,1039,215,360,575,51,626
公投第１５案,新北市,三重區,成功里,675,1114,268,379,647,29,676
公投第１５案,新北市,三重區,成功里,676,1588,347,554,901,30,931
公投第１５案,新北市,三重區,成功里,677,1702,295,585,880,30,910
公投第１５案,新北市,三重區,福祉里,678,1288,294,437,731,58,789
公投第１５案,新北市,三重區,福祉里,679,1629,356,568,924,62,986
公投第１５案,新北市,三重區,福祉里,680,1861,375,631,1006,44,1050
公投第１５案,新北市,三重區,福德里,681,1727,306,555,861,50,911
公投第１５案,新北市,三重區,福德里,682,1813,371,600,971,38,1009
公投第１５案,新北市,三重區,福民里,683,1595,295,538,833,67,900
公投第１５案,新北市,三重區,福民里,684,1513,305,509,814,70,884
公投第１５案,新北市,三重區,過田里,685,4433,413,365,778,48,826
公投第１５案,新北市,三重區,過田里,686,1283,230,471,701,45,746
公投第１５案,新北市,三重區,過田里,687,1430,297,521,818,54,872
公投第１５案,新北市,三重區,過田里,688,1357,299,491,790,24,814
公投第１５案,新北市,三重區,錦田里,689,963,201,336,537,35,572
公投第１５案,新北市,三重區,錦田里,690,883,190,292,482,45,527
公投第１５案,新北市,三重區,重明里,691,1494,397,350,747,75,822
公投第１５案,新北市,三重區,重明里,692,1616,356,534,890,62,952
公投第１５案,新北市,三重區,光田里,693,1329,293,414,707,50,757
公投第１５案,新北市,三重區,光田里,694,1289,287,476,763,44,807
公投第１５案,新北市,三重區,光田里,695,1380,276,473,749,59,808
公投第１５案,新北市,三重區,光陽里,696,1668,365,540,905,41,946
公投第１５案,新北市,三重區,光陽里,697,1226,272,440,712,64,776
公投第１５案,新北市,三重區,光陽里,698,1421,306,516,822,37,859
公投第１５案,新北市,三重區,光陽里,699,1364,273,486,759,51,810
公投第１５案,新北市,三重區,田心里,700,1232,244,434,678,52,730
公投第１５案,新北市,三重區,田心里,701,1248,260,456,716,57,773
公投第１５案,新北市,三重區,田心里,702,1256,265,435,700,54,754
公投第１５案,新北市,三重區,福田里,703,1506,342,545,887,46,933
公投第１５案,新北市,三重區,福田里,704,1669,368,575,943,47,990
公投第１５案,新北市,三重區,田中里,705,1308,254,443,697,68,765
公投第１５案,新北市,三重區,田中里,706,1263,303,479,782,46,828
公投第１５案,新北市,三重區,田中里,707,1471,299,469,768,70,838
公投第１５案,新北市,三重區,田中里,708,1447,306,476,782,90,872
公投第１５案,新北市,三重區,田安里,709,1693,295,484,779,55,834
公投第１５案,新北市,三重區,田安里,710,2015,411,635,1046,48,1094
公投第１５案,新北市,三重區,田安里,711,1812,279,612,891,66,957
公投第１５案,新北市,三重區,三民里,712,1509,306,452,758,32,790
公投第１５案,新北市,三重區,三民里,713,1439,373,407,780,54,834
公投第１５案,新北市,三重區,光明里,714,1437,284,489,773,47,820
公投第１５案,新北市,三重區,光明里,715,1697,357,506,863,62,925
公投第１５案,新北市,三重區,光明里,716,1793,346,565,911,32,943
公投第１５案,新北市,三重區,光明里,717,1603,347,581,928,35,963
公投第１５案,新北市,三重區,光正里,718,1166,249,362,611,24,635
公投第１５案,新北市,三重區,光正里,719,1126,240,387,627,40,667
公投第１５案,新北市,三重區,同安里,720,1291,192,405,597,51,648
公投第１５案,新北市,三重區,同慶里,721,1597,338,510,848,56,904
公投第１５案,新北市,三重區,菜寮里,722,1081,216,387,603,62,665
公投第１５案,新北市,三重區,菜寮里,723,911,184,361,545,43,588
公投第１５案,新北市,三重區,永春里,724,1719,309,513,822,35,857
公投第１５案,新北市,三重區,中正里,725,1289,254,409,663,65,728
公投第１５案,新北市,三重區,吉利里,726,1318,250,489,739,65,804
公投第１５案,新北市,三重區,大同里,727,1822,366,536,902,56,958
公投第１５案,新北市,三重區,中民里,728,1185,213,402,615,79,694
公投第１５案,新北市,三重區,平和里,729,1369,421,235,656,66,722
公投第１５案,新北市,三重區,大安里,730,1507,300,487,787,58,845
公投第１５案,新北市,三重區,仁德里,731,926,201,296,497,58,555
公投第１５案,新北市,三重區,仁德里,732,950,169,299,468,23,491
公投第１５案,新北市,三重區,忠孝里,733,1678,318,503,821,68,889
公投第１５案,新北市,三重區,仁義里,734,1117,212,355,567,71,638
公投第１５案,新北市,三重區,光榮里,735,1318,246,416,662,51,713
公投第１５案,新北市,三重區,光輝里,736,1388,298,467,765,31,796
公投第１５案,新北市,三重區,福星里,737,1026,234,315,549,50,599
公投第１５案,新北市,三重區,福利里,738,1096,248,385,633,48,681
公投第１５案,新北市,三重區,福利里,739,967,207,339,546,27,573
公投第１５案,新北市,三重區,清和里,740,1871,336,500,836,43,879
公投第１５案,新北市,三重區,清和里,741,1663,330,530,860,70,930
公投第１５案,新北市,三重區,永興里,742,1208,214,430,644,26,670
公投第１５案,新北市,三重區,中山里,743,1398,292,399,691,52,743
公投第１５案,新北市,三重區,中山里,744,1078,212,349,561,22,583
公投第１５案,新北市,三重區,大園里,745,1102,187,370,557,63,620
公投第１５案,新北市,三重區,大園里,746,1393,285,411,696,71,767
公投第１５案,新北市,三重區,國隆里,747,1251,237,442,679,61,740
公投第１５案,新北市,三重區,國隆里,748,1234,266,475,741,46,787
公投第１５案,新北市,三重區,重陽里,749,1661,373,524,897,63,960
公投第１５案,新北市,三重區,重陽里,750,1590,320,521,841,67,908
公投第１５案,新北市,三重區,民生里,751,1182,246,397,643,59,702
公投第１５案,新北市,三重區,民生里,752,1369,289,464,753,65,818
公投第１５案,新北市,三重區,民生里,753,1222,288,424,712,45,757
公投第１５案,新北市,三重區,重新里,754,1304,255,408,663,81,744
公投第１５案,新北市,三重區,正德里,755,1054,167,355,522,42,564
公投第１５案,新北市,三重區,正義里,756,1635,319,527,846,70,916
公投第１５案,新北市,三重區,正安里,757,1779,319,557,876,64,940
公投第１５案,新北市,三重區,自強里,758,1633,320,534,854,79,933
公投第１５案,新北市,三重區,文化里,759,1107,240,364,604,38,642
公投第１５案,新北市,三重區,文化里,760,1021,209,391,600,41,641
公投第１５案,新北市,三重區,中央里,761,1649,294,479,773,82,855
公投第１５案,新北市,三重區,雙園里,762,874,171,289,460,35,495
公投第１５案,新北市,三重區,錦通里,763,1402,275,449,724,100,824
公投第１５案,新北市,三重區,錦安里,764,1713,277,526,803,69,872
公投第１５案,新北市,三重區,長安里,765,973,177,274,451,39,490
公投第１５案,新北市,三重區,長安里,766,1038,214,359,573,44,617
公投第１５案,新北市,三重區,光華里,767,1833,287,510,797,124,921
公投第１５案,新北市,三重區,長生里,768,817,168,266,434,30,464
公投第１５案,新北市,三重區,開元里,769,1387,287,487,774,51,825
公投第１５案,新北市,三重區,大德里,770,784,169,279,448,27,475
公投第１５案,新北市,三重區,長元里,771,1096,217,331,548,33,581
公投第１５案,新北市,三重區,長元里,772,1163,252,379,631,56,687
公投第１５案,新北市,三重區,長江里,773,1868,337,578,915,64,979
公投第１５案,新北市,三重區,長泰里,774,1117,194,350,544,71,615
公投第１５案,新北市,三重區,長泰里,775,934,165,295,460,38,498
公投第１５案,新北市,三重區,長福里,776,1412,263,423,686,59,745
公投第１５案,新北市,三重區,介壽里,777,1062,215,416,631,46,677
公投第１５案,新北市,三重區,萬壽里,778,891,164,293,457,55,512
公投第１５案,新北市,三重區,萬壽里,779,936,211,361,572,70,642
公投第１５案,新北市,三重區,錦江里,780,1085,198,334,532,68,600
公投第１５案,新北市,三重區,錦江里,781,1065,207,312,519,14,533
公投第１５案,新北市,三重區,龍濱里,782,1398,314,425,739,64,803
公投第１５案,新北市,三重區,龍濱里,783,1550,289,545,834,41,875
公投第１５案,新北市,三重區,龍門里,784,1674,311,537,848,63,911
公投第１５案,新北市,三重區,秀江里,785,1215,232,424,656,55,711
公投第１５案,新北市,三重區,奕壽里,786,1606,311,513,824,59,883
公投第１５案,新北市,三重區,三安里,787,1182,242,378,620,45,665
公投第１５案,新北市,三重區,三安里,788,1238,234,433,667,64,731
公投第１５案,新北市,三重區,福安里,789,1342,293,454,747,56,803
公投第１５案,新北市,三重區,福安里,790,1408,292,485,777,43,820
公投第１５案,新北市,三重區,信安里,791,1770,328,569,897,83,980
公投第１５案,新北市,三重區,安慶里,792,940,208,299,507,47,554
公投第１５案,新北市,三重區,安慶里,793,975,185,323,508,28,536
公投第１５案,新北市,三重區,幸福里,794,1507,302,456,758,46,804
公投第１５案,新北市,三重區,幸福里,795,1419,274,478,752,61,813
公投第１５案,新北市,三重區,幸福里,796,1257,235,431,666,51,717
公投第１５案,新北市,三重區,六合里,797,1619,314,546,860,61,921
公投第１５案,新北市,三重區,六合里,798,1745,297,598,895,66,961
公投第１５案,新北市,三重區,六福里,799,1519,310,470,780,79,859
公投第１５案,新北市,三重區,六福里,800,1682,292,542,834,55,889
公投第１５案,新北市,三重區,六福里,801,1697,353,581,934,63,997
公投第１５案,新北市,三重區,順德里,802,1073,179,383,562,56,618
公投第１５案,新北市,三重區,順德里,803,924,151,318,469,43,512
公投第１５案,新北市,三重區,承德里,804,1613,229,508,737,51,788
公投第１５案,新北市,三重區,瑞德里,805,1034,173,336,509,45,554
公投第１５案,新北市,三重區,瑞德里,806,1118,200,399,599,56,655
公投第１５案,新北市,三重區,崇德里,807,1269,210,418,628,63,691
公投第１５案,新北市,三重區,崇德里,808,990,174,332,506,54,560
公投第１５案,新北市,三重區,崇德里,809,1336,252,461,713,50,763
公投第１５案,新北市,三重區,厚德里,810,1601,572,297,869,37,906
公投第１５案,新北市,三重區,厚德里,811,1581,311,584,895,65,960
公投第１５案,新北市,三重區,維德里,812,1345,260,465,725,56,781
公投第１５案,新北市,三重區,維德里,813,1226,248,463,711,47,758
公投第１５案,新北市,三重區,尚德里,814,1650,273,502,775,86,861
公投第１５案,新北市,三重區,尚德里,815,1140,213,398,611,44,655
公投第１５案,新北市,三重區,培德里,816,1639,294,526,820,38,858
公投第１５案,新北市,三重區,培德里,817,1699,323,574,897,59,956
公投第１５案,新北市,三重區,立德里,818,1501,318,603,921,73,994
公投第１５案,新北市,三重區,立德里,819,1538,291,517,808,62,870
公投第１５案,新北市,三重區,永德里,820,1540,284,490,774,70,844
公投第１５案,新北市,三重區,永德里,821,1276,215,453,668,51,719
公投第１５案,新北市,三重區,永德里,822,1539,264,513,777,51,828
公投第１５案,新北市,三重區,永煇里,823,1170,264,408,672,33,705
公投第１５案,新北市,三重區,永煇里,824,1120,235,363,598,43,641
公投第１５案,新北市,三重區,永發里,825,1789,351,449,800,63,863
公投第１５案,新北市,三重區,永發里,826,1520,312,436,748,75,823
公投第１５案,新北市,三重區,永發里,827,1821,361,588,949,70,1019
公投第１５案,新北市,三重區,永盛里,828,1407,200,538,738,70,808
公投第１５案,新北市,三重區,永盛里,829,1491,282,494,776,59,835
公投第１５案,新北市,三重區,永吉里,830,1381,290,481,771,52,823
公投第１５案,新北市,三重區,永吉里,831,1222,238,399,637,69,706
公投第１５案,新北市,三重區,永安里,832,1938,351,635,986,0,986
公投第１５案,新北市,三重區,永安里,833,1639,317,549,866,40,906
公投第１５案,新北市,三重區,永豐里,834,1614,317,518,835,72,907
公投第１５案,新北市,三重區,永豐里,835,1709,311,580,891,46,937
公投第１５案,新北市,三重區,永豐里,836,1753,273,578,851,61,912
公投第１５案,新北市,三重區,永福里,837,1398,290,466,756,62,818
公投第１５案,新北市,三重區,永福里,838,1706,346,519,865,63,928
公投第１５案,新北市,三重區,永福里,839,1614,310,554,864,63,927
公投第１５案,新北市,三重區,永清里,840,1591,323,513,836,100,936
公投第１５案,新北市,三重區,永清里,841,1627,339,520,859,45,904
公投第１５案,新北市,三重區,永清里,842,1505,307,500,807,63,870
公投第１５案,新北市,三重區,永順里,843,1331,263,439,702,57,759
公投第１５案,新北市,三重區,永順里,844,1678,280,494,774,53,827
公投第１５案,新北市,三重區,永順里,845,1498,312,492,804,45,849
公投第１５案,新北市,三重區,溪美里,846,1800,382,626,1008,54,1062
公投第１５案,新北市,三重區,溪美里,847,1703,321,460,781,44,825
公投第１５案,新北市,三重區,溪美里,848,1975,372,567,939,45,984
公投第１５案,新北市,三重區,溪美里,849,1894,308,627,935,42,977
公投第１５案,新北市,三重區,福隆里,850,1405,294,486,780,43,823
公投第１５案,新北市,三重區,福隆里,851,1293,249,470,719,32,751
公投第１５案,新北市,三重區,福隆里,852,1259,280,412,692,37,729
公投第１５案,新北市,三重區,五常里,853,1144,241,406,647,62,709
公投第１５案,新北市,三重區,五常里,854,1254,284,429,713,52,765
公投第１５案,新北市,三重區,五常里,855,1313,274,426,700,42,742
公投第１５案,新北市,三重區,五福里,856,1594,301,498,799,78,877
公投第１５案,新北市,三重區,五福里,857,1775,344,574,918,56,974
公投第１５案,新北市,三重區,仁忠里,858,1516,260,510,770,79,849
公投第１５案,新北市,三重區,仁忠里,859,1315,281,475,756,73,829
公投第１５案,新北市,三重區,慈福里,860,843,179,281,460,59,519
公投第１５案,新北市,三重區,慈福里,861,1160,181,378,559,55,614
公投第１５案,新北市,三重區,慈生里,862,1052,173,390,563,55,618
公投第１５案,新北市,三重區,慈生里,863,1054,232,386,618,56,674
公投第１５案,新北市,三重區,慈惠里,864,997,193,350,543,44,587
公投第１５案,新北市,三重區,慈惠里,865,936,179,301,480,34,514
公投第１５案,新北市,三重區,慈愛里,866,1658,294,536,830,78,908
公投第１５案,新北市,三重區,慈愛里,867,1496,276,488,764,57,821
公投第１５案,新北市,三重區,慈化里,868,1064,231,380,611,50,661
公投第１５案,新北市,三重區,慈化里,869,1152,223,435,658,46,704
公投第１５案,新北市,三重區,慈祐里,870,1532,291,489,780,41,821
公投第１５案,新北市,三重區,慈祐里,871,1338,222,410,632,33,665
公投第１５案,新北市,三重區,慈祐里,872,1303,263,435,698,54,752
公投第１５案,新北市,三重區,富華里,873,1369,251,483,734,87,821
公投第１５案,新北市,三重區,富華里,874,1491,272,497,769,69,838
公投第１５案,新北市,三重區,富貴里,875,1821,283,577,860,88,948
公投第１５案,新北市,三重區,富貴里,876,1906,329,596,925,43,968
公投第１５案,新北市,三重區,富貴里,877,1842,377,621,998,45,1043
公投第１５案,新北市,三重區,富福里,878,878,139,294,433,44,477
公投第１５案,新北市,三重區,富福里,879,963,231,341,572,45,617
公投第１５案,新北市,三重區,五華里,880,1381,232,419,651,29,680
公投第１５案,新北市,三重區,五華里,881,1681,298,482,780,71,851
公投第１５案,新北市,三重區,五華里,882,1548,298,482,780,30,810
公投第１５案,新北市,三重區,碧華里,883,1542,344,489,833,61,894
公投第１５案,新北市,三重區,碧華里,884,1557,326,483,809,62,871
公投第１５案,新北市,三重區,碧華里,885,1661,311,540,851,47,898
公投第１５案,新北市,三重區,碧華里,886,2024,391,684,1075,26,1101
公投第１５案,新北市,三重區,福樂里,887,1588,271,477,748,54,802
公投第１５案,新北市,三重區,福樂里,888,1706,272,578,850,92,942
公投第１５案,新北市,三重區,仁華里,889,1341,262,478,740,47,787
公投第１５案,新北市,三重區,仁華里,890,1025,185,346,531,35,566
公投第１５案,新北市,三重區,仁華里,891,1339,260,452,712,56,768
公投第１５案,新北市,三重區,五順里,892,1725,322,560,882,77,959
公投第１５案,新北市,三重區,五順里,893,1826,351,570,921,71,992
公投第１５案,新北市,板橋區,留侯里,894,1388,286,420,706,71,777
公投第１５案,新北市,板橋區,流芳里,895,1294,298,430,728,34,762
公投第１５案,新北市,板橋區,赤松里,896,667,170,222,392,13,405
公投第１５案,新北市,板橋區,黃石里,897,898,154,294,448,36,484
公投第１５案,新北市,板橋區,挹秀里,898,829,170,306,476,30,506
公投第１５案,新北市,板橋區,挹秀里,899,739,135,303,438,25,463
公投第１５案,新北市,板橋區,湳興里,900,1035,242,343,585,45,630
公投第１５案,新北市,板橋區,湳興里,901,1713,302,459,761,39,800
公投第１５案,新北市,板橋區,湳興里,902,658,114,213,327,12,339
公投第１５案,新北市,板橋區,湳興里,903,1312,234,422,656,81,737
公投第１５案,新北市,板橋區,新興里,904,1492,249,471,720,54,774
公投第１５案,新北市,板橋區,新興里,905,1393,235,438,673,56,729
公投第１５案,新北市,板橋區,社後里,906,4742,304,526,830,44,874
公投第１５案,新北市,板橋區,社後里,907,1439,273,465,738,45,783
公投第１５案,新北市,板橋區,社後里,908,1187,239,413,652,68,720
公投第１５案,新北市,板橋區,社後里,909,1122,218,375,593,38,631
公投第１５案,新北市,板橋區,香社里,910,1363,261,473,734,58,792
公投第１５案,新北市,板橋區,香社里,911,1093,220,376,596,51,647
公投第１５案,新北市,板橋區,香社里,912,1331,288,466,754,40,794
公投第１５案,新北市,板橋區,香雅里,913,1026,222,375,597,47,644
公投第１５案,新北市,板橋區,香雅里,914,1244,283,418,701,73,774
公投第１５案,新北市,板橋區,中正里,915,1268,235,381,616,75,691
公投第１５案,新北市,板橋區,中正里,916,1313,238,421,659,27,686
公投第１５案,新北市,板橋區,中正里,917,1196,277,421,698,34,732
公投第１５案,新北市,板橋區,自強里,918,1137,288,451,739,38,777
公投第１５案,新北市,板橋區,自強里,919,1269,305,468,773,38,811
公投第１５案,新北市,板橋區,自強里,920,1117,242,411,653,34,687
公投第１５案,新北市,板橋區,自強里,921,1042,208,416,624,38,662
公投第１５案,新北市,板橋區,自立里,922,1257,243,439,682,79,761
公投第１５案,新北市,板橋區,自立里,923,1216,225,445,670,56,726
公投第１５案,新北市,板橋區,光華里,924,1126,239,368,607,51,658
公投第１５案,新北市,板橋區,光華里,925,1290,300,492,792,55,847
公投第１５案,新北市,板橋區,光榮里,926,1215,231,390,621,13,634
公投第１５案,新北市,板橋區,光榮里,927,1099,205,369,574,26,600
公投第１５案,新北市,板橋區,國光里,928,1329,263,545,808,28,836
公投第１５案,新北市,板橋區,國光里,929,996,162,420,582,22,604
公投第１５案,新北市,板橋區,國光里,930,1047,210,394,604,28,632
公投第１５案,新北市,板橋區,港尾里,931,1272,260,494,754,58,812
公投第１５案,新北市,板橋區,港尾里,932,1252,252,459,711,41,752
公投第１５案,新北市,板橋區,新生里,933,1238,217,445,662,69,731
公投第１５案,新北市,板橋區,新生里,934,1389,319,496,815,65,880
公投第１５案,新北市,板橋區,新生里,935,1194,244,446,690,61,751
公投第１５案,新北市,板橋區,金華里,936,1093,192,341,533,54,587
公投第１５案,新北市,板橋區,金華里,937,1148,210,386,596,72,668
公投第１５案,新北市,板橋區,金華里,938,1268,265,453,718,51,769
公投第１５案,新北市,板橋區,港德里,939,1230,247,397,644,74,718
公投第１５案,新北市,板橋區,港德里,940,1012,178,361,539,39,578
公投第１５案,新北市,板橋區,港德里,941,811,164,281,445,44,489
公投第１５案,新北市,板橋區,港德里,942,1197,271,431,702,54,756
公投第１５案,新北市,板橋區,民權里,943,1142,202,415,617,30,647
公投第１５案,新北市,板橋區,民權里,944,1222,249,427,676,38,714
公投第１５案,新北市,板橋區,民安里,945,796,149,325,474,38,512
公投第１５案,新北市,板橋區,民安里,946,997,233,346,579,69,648
公投第１５案,新北市,板橋區,建國里,947,1011,230,348,578,36,614
公投第１５案,新北市,板橋區,建國里,948,1157,243,370,613,68,681
公投第１５案,新北市,板橋區,建國里,949,1040,209,370,579,57,636
公投第１５案,新北市,板橋區,漢生里,950,1173,248,434,682,32,714
公投第１５案,新北市,板橋區,漢生里,951,1193,218,408,626,29,655
公投第１５案,新北市,板橋區,漢生里,952,1255,252,463,715,39,754
公投第１５案,新北市,板橋區,公舘里,953,1306,297,450,747,32,779
公投第１５案,新北市,板橋區,公舘里,954,1050,224,384,608,18,626
公投第１５案,新北市,板橋區,公舘里,955,942,181,337,518,36,554
公投第１５案,新北市,板橋區,新民里,956,1133,227,454,681,37,718
公投第１５案,新北市,板橋區,新民里,957,1251,249,455,704,31,735
公投第１５案,新北市,板橋區,新民里,958,1293,264,473,737,41,778
公投第１５案,新北市,板橋區,幸福里,959,1208,220,381,601,55,656
公投第１５案,新北市,板橋區,幸福里,960,1223,244,417,661,53,714
公投第１５案,新北市,板橋區,幸福里,961,1061,211,341,552,52,604
公投第１５案,新北市,板橋區,文德里,962,1515,316,520,836,40,876
公投第１５案,新北市,板橋區,文德里,963,1225,231,460,691,64,755
公投第１５案,新北市,板橋區,忠誠里,964,1120,220,463,683,34,717
公投第１５案,新北市,板橋區,忠誠里,965,1091,230,426,656,39,695
公投第１５案,新北市,板橋區,忠誠里,966,1385,239,609,848,21,869
公投第１５案,新北市,板橋區,陽明里,967,1283,259,472,731,60,791
公投第１５案,新北市,板橋區,陽明里,968,1204,249,413,662,72,734
公投第１５案,新北市,板橋區,百壽里,969,1191,260,454,714,43,757
公投第１５案,新北市,板橋區,百壽里,970,1078,225,406,631,55,686
公投第１５案,新北市,板橋區,介壽里,971,1351,245,490,735,66,801
公投第１５案,新北市,板橋區,介壽里,972,1322,274,450,724,56,780
公投第１５案,新北市,板橋區,新埔里,973,868,168,213,381,49,430
公投第１５案,新北市,板橋區,新埔里,974,1029,227,407,634,56,690
公投第１５案,新北市,板橋區,華江里,975,1602,330,584,914,34,948
公投第１５案,新北市,板橋區,華江里,976,1362,269,499,768,57,825
公投第１５案,新北市,板橋區,華江里,977,1698,341,558,899,66,965
公投第１５案,新北市,板橋區,華江里,978,1495,319,500,819,33,852
公投第１５案,新北市,板橋區,江翠里,979,1522,330,444,774,78,852
公投第１５案,新北市,板橋區,江翠里,980,1279,254,443,697,60,757
公投第１５案,新北市,板橋區,江翠里,981,1559,251,452,703,54,757
公投第１５案,新北市,板橋區,純翠里,982,1537,281,461,742,85,827
公投第１５案,新北市,板橋區,純翠里,983,1531,292,456,748,57,805
公投第１５案,新北市,板橋區,純翠里,984,1720,352,522,874,29,903
公投第１５案,新北市,板橋區,溪頭里,985,1165,214,384,598,39,637
公投第１５案,新北市,板橋區,溪頭里,986,1857,382,633,1015,45,1060
公投第１５案,新北市,板橋區,溪頭里,987,1078,201,357,558,68,626
公投第１５案,新北市,板橋區,溪頭里,988,1177,226,380,606,26,632
公投第１５案,新北市,板橋區,聯翠里,989,1798,433,600,1033,6,1039
公投第１５案,新北市,板橋區,聯翠里,990,1455,300,506,806,79,885
公投第１５案,新北市,板橋區,文化里,991,1245,251,448,699,65,764
公投第１５案,新北市,板橋區,文化里,992,1704,345,511,856,82,938
公投第１５案,新北市,板橋區,宏翠里,993,1600,382,509,891,25,916
公投第１５案,新北市,板橋區,宏翠里,994,1409,238,448,686,47,733
公投第１５案,新北市,板橋區,宏翠里,995,1286,240,445,685,53,738
公投第１５案,新北市,板橋區,仁翠里,996,1359,192,387,579,96,675
公投第１５案,新北市,板橋區,仁翠里,997,1188,250,347,597,45,642
公投第１５案,新北市,板橋區,新翠里,998,1627,317,495,812,55,867
公投第１５案,新北市,板橋區,新翠里,999,1633,344,359,703,40,743
公投第１５案,新北市,板橋區,新翠里,1000,1814,407,633,1040,64,1104
公投第１５案,新北市,板橋區,新翠里,1001,1810,353,638,991,59,1050
公投第１５案,新北市,板橋區,朝陽里,1002,1133,216,385,601,59,660
公投第１５案,新北市,板橋區,朝陽里,1003,841,157,299,456,32,488
公投第１５案,新北市,板橋區,朝陽里,1004,1050,207,394,601,55,656
公投第１５案,新北市,板橋區,吉翠里,1005,1130,224,341,565,70,635
公投第１５案,新北市,板橋區,吉翠里,1006,1056,233,364,597,62,659
公投第１５案,新北市,板橋區,吉翠里,1007,1129,228,330,558,48,606
公投第１５案,新北市,板橋區,德翠里,1008,1713,305,567,872,100,972
公投第１５案,新北市,板橋區,德翠里,1009,1622,292,587,879,67,946
公投第１５案,新北市,板橋區,德翠里,1010,1427,323,530,853,46,899
公投第１５案,新北市,板橋區,德翠里,1011,1471,334,564,898,26,924
公投第１５案,新北市,板橋區,新海里,1012,1076,208,367,575,16,591
公投第１５案,新北市,板橋區,新海里,1013,979,189,293,482,22,504
公投第１５案,新北市,板橋區,新海里,1014,1079,213,445,658,28,686
公投第１５案,新北市,板橋區,滿翠里,1015,828,147,279,426,50,476
公投第１５案,新北市,板橋區,滿翠里,1016,820,163,301,464,55,519
公投第１５案,新北市,板橋區,滿翠里,1017,989,229,337,566,35,601
公投第１５案,新北市,板橋區,明翠里,1018,1023,203,337,540,58,598
公投第１５案,新北市,板橋區,明翠里,1019,1044,193,362,555,34,589
公投第１５案,新北市,板橋區,明翠里,1020,968,183,334,517,56,573
公投第１５案,新北市,板橋區,明翠里,1021,1222,268,415,683,33,716
公投第１５案,新北市,板橋區,松翠里,1022,1385,260,469,729,37,766
公投第１５案,新北市,板橋區,松翠里,1023,1585,321,507,828,45,873
公投第１５案,新北市,板橋區,柏翠里,1024,1840,347,612,959,60,1019
公投第１５案,新北市,板橋區,柏翠里,1025,1806,366,685,1051,73,1124
公投第１５案,新北市,板橋區,龍翠里,1026,1506,292,506,798,60,858
公投第１５案,新北市,板橋區,龍翠里,1027,1476,276,490,766,61,827
公投第１５案,新北市,板橋區,龍翠里,1028,1500,305,524,829,53,882
公投第１５案,新北市,板橋區,松柏里,1029,1096,219,405,624,70,694
公投第１５案,新北市,板橋區,松柏里,1030,963,197,351,548,55,603
公投第１５案,新北市,板橋區,華翠里,1031,1601,312,541,853,41,894
公投第１５案,新北市,板橋區,華翠里,1032,1507,346,529,875,65,940
公投第１５案,新北市,板橋區,莒光里,1033,1315,280,475,755,61,816
公投第１５案,新北市,板橋區,莒光里,1034,1178,233,409,642,24,666
公投第１５案,新北市,板橋區,忠翠里,1035,1822,389,643,1032,71,1103
公投第１５案,新北市,板橋區,忠翠里,1036,1605,334,613,947,57,1004
公投第１５案,新北市,板橋區,忠翠里,1037,1549,232,644,876,26,902
公投第１５案,新北市,板橋區,忠翠里,1038,1948,442,692,1134,27,1161
公投第１５案,新北市,板橋區,忠翠里,1039,1935,397,654,1051,28,1079
公投第１５案,新北市,板橋區,嵐翠里,1040,1097,204,336,540,49,589
公投第１５案,新北市,板橋區,嵐翠里,1041,1095,215,344,559,42,601
公投第１５案,新北市,板橋區,文聖里,1042,1678,291,548,839,83,922
公投第１５案,新北市,板橋區,文聖里,1043,1750,294,589,883,85,968
公投第１５案,新北市,板橋區,文翠里,1044,1187,221,389,610,54,664
公投第１５案,新北市,板橋區,文翠里,1045,1154,243,402,645,37,682
公投第１５案,新北市,板橋區,文翠里,1046,1262,281,448,729,36,765
公投第１５案,新北市,板橋區,青翠里,1047,1271,200,441,641,74,715
公投第１５案,新北市,板橋區,青翠里,1048,1410,269,626,895,60,955
公投第１５案,新北市,板橋區,懷翠里,1049,1745,324,519,843,72,915
公投第１５案,新北市,板橋區,懷翠里,1050,1867,323,630,953,94,1047
公投第１５案,新北市,板橋區,懷翠里,1051,1753,334,645,979,77,1056
公投第１５案,新北市,板橋區,福翠里,1052,1204,239,435,674,52,726
公投第１５案,新北市,板橋區,港嘴里,1053,1614,305,525,830,58,888
公投第１５案,新北市,板橋區,港嘴里,1054,1237,261,429,690,49,739
公投第１５案,新北市,板橋區,港嘴里,1055,1361,292,444,736,69,805
公投第１５案,新北市,板橋區,港嘴里,1056,1243,280,426,706,28,734
公投第１５案,新北市,板橋區,振興里,1057,1515,287,460,747,34,781
公投第１５案,新北市,板橋區,振興里,1058,1515,324,528,852,58,910
公投第１５案,新北市,板橋區,振興里,1059,949,173,356,529,56,585
公投第１５案,新北市,板橋區,振義里,1060,1629,298,532,830,72,902
公投第１５案,新北市,板橋區,振義里,1061,1238,252,430,682,45,727
公投第１５案,新北市,板橋區,振義里,1062,901,128,235,363,32,395
公投第１５案,新北市,板橋區,光復里,1063,1475,303,498,801,71,872
公投第１５案,新北市,板橋區,光復里,1064,1481,261,504,765,67,832
公投第１５案,新北市,板橋區,埔墘里,1065,1800,295,574,869,84,953
公投第１５案,新北市,板橋區,埔墘里,1066,1630,304,527,831,66,897
公投第１５案,新北市,板橋區,埔墘里,1067,1298,280,450,730,46,776
公投第１５案,新北市,板橋區,埔墘里,1068,874,198,295,493,32,525
公投第１５案,新北市,板橋區,富貴里,1069,992,190,365,555,16,571
公投第１５案,新北市,板橋區,富貴里,1070,1034,248,394,642,14,656
公投第１５案,新北市,板橋區,長壽里,1071,1451,335,456,791,75,866
公投第１５案,新北市,板橋區,長壽里,1072,1130,254,388,642,49,691
公投第１５案,新北市,板橋區,福壽里,1073,1440,265,533,798,49,847
公投第１５案,新北市,板橋區,福壽里,1074,1531,322,517,839,69,908
公投第１５案,新北市,板橋區,居仁里,1075,1349,313,488,801,59,860
公投第１５案,新北市,板橋區,居仁里,1076,1593,312,508,820,39,859
公投第１５案,新北市,板橋區,海山里,1077,1174,219,434,653,22,675
公投第１５案,新北市,板橋區,海山里,1078,1228,210,460,670,43,713
公投第１５案,新北市,板橋區,海山里,1079,1187,152,522,674,27,701
公投第１５案,新北市,板橋區,海山里,1080,870,159,329,488,51,539
公投第１５案,新北市,板橋區,海山里,1081,2033,437,745,1182,35,1217
公投第１５案,新北市,板橋區,九如里,1082,1418,287,430,717,51,768
公投第１５案,新北市,板橋區,九如里,1083,1075,200,384,584,37,621
公投第１５案,新北市,板橋區,正泰里,1084,1515,273,531,804,36,840
公投第１５案,新北市,板橋區,正泰里,1085,1182,258,466,724,33,757
公投第１５案,新北市,板橋區,玉光里,1086,1893,396,593,989,65,1054
公投第１５案,新北市,板橋區,玉光里,1087,1302,239,402,641,46,687
公投第１５案,新北市,板橋區,玉光里,1088,1366,253,433,686,43,729
公投第１５案,新北市,板橋區,光仁里,1089,1318,286,475,761,70,831
公投第１５案,新北市,板橋區,光仁里,1090,1200,238,405,643,44,687
公投第１５案,新北市,板橋區,埤墘里,1091,2028,464,636,1100,43,1143
公投第１５案,新北市,板橋區,埤墘里,1092,1746,321,604,925,100,1025
公投第１５案,新北市,板橋區,莊敬里,1093,1954,382,591,973,22,995
公投第１５案,新北市,板橋區,莊敬里,1094,1474,299,486,785,47,832
公投第１５案,新北市,板橋區,永安里,1095,1418,279,464,743,55,798
公投第１５案,新北市,板橋區,永安里,1096,1563,356,547,903,69,972
公投第１５案,新北市,板橋區,雙玉里,1097,1780,313,581,894,93,987
公投第１５案,新北市,板橋區,雙玉里,1098,1707,351,547,898,47,945
公投第１５案,新北市,板橋區,廣新里,1099,906,119,229,348,11,359
公投第１５案,新北市,板橋區,廣新里,1100,1030,192,344,536,56,592
公投第１５案,新北市,板橋區,廣新里,1101,1115,226,383,609,48,657
公投第１５案,新北市,板橋區,深丘里,1102,1836,344,623,967,34,1001
公投第１５案,新北市,板橋區,深丘里,1103,1881,392,565,957,79,1036
公投第１５案,新北市,板橋區,深丘里,1104,1688,337,559,896,33,929
公投第１５案,新北市,板橋區,深丘里,1105,1760,382,620,1002,38,1040
公投第１５案,新北市,板橋區,香丘里,1106,1044,209,386,595,58,653
公投第１５案,新北市,板橋區,香丘里,1107,1043,214,391,605,38,643
公投第１５案,新北市,板橋區,香丘里,1108,1099,227,400,627,64,691
公投第１５案,新北市,板橋區,西安里,1109,1260,239,428,667,52,719
公投第１５案,新北市,板橋區,西安里,1110,1131,201,421,622,45,667
公投第１５案,新北市,板橋區,東丘里,1111,1225,229,453,682,40,722
公投第１５案,新北市,板橋區,東丘里,1112,1455,323,546,869,37,906
公投第１５案,新北市,板橋區,東丘里,1113,1267,218,442,660,62,722
公投第１５案,新北市,板橋區,民生里,1114,972,206,341,547,47,594
公投第１５案,新北市,板橋區,民生里,1115,994,203,370,573,27,600
公投第１５案,新北市,板橋區,長安里,1116,1111,239,384,623,23,646
公投第１５案,新北市,板橋區,長安里,1117,1177,239,472,711,70,781
公投第１５案,新北市,板橋區,長安里,1118,1544,295,505,800,62,862
公投第１５案,新北市,板橋區,東安里,1119,1021,175,391,566,61,627
公投第１５案,新北市,板橋區,東安里,1120,1040,180,350,530,57,587
公投第１５案,新北市,板橋區,福丘里,1121,1504,307,488,795,32,827
公投第１５案,新北市,板橋區,福丘里,1122,1373,270,441,711,35,746
公投第１５案,新北市,板橋區,福丘里,1123,1210,264,337,601,25,626
公投第１５案,新北市,板橋區,福祿里,1124,1809,300,587,887,69,956
公投第１５案,新北市,板橋區,福祿里,1125,1551,275,568,843,67,910
公投第１５案,新北市,板橋區,民族里,1126,1408,302,514,816,19,835
公投第１５案,新北市,板橋區,民族里,1127,1285,283,452,735,33,768
公投第１５案,新北市,板橋區,民族里,1128,1102,241,417,658,42,700
公投第１５案,新北市,板橋區,國泰里,1129,1399,246,460,706,40,746
公投第１５案,新北市,板橋區,國泰里,1130,1692,327,560,887,79,966
公投第１５案,新北市,板橋區,後埔里,1131,1625,343,592,935,32,967
公投第１５案,新北市,板橋區,後埔里,1132,1712,329,596,925,73,998
公投第１５案,新北市,板橋區,福德里,1133,1246,253,437,690,34,724
公投第１５案,新北市,板橋區,福德里,1134,1471,315,497,812,48,860
公投第１５案,新北市,板橋區,福德里,1135,1761,311,646,957,65,1022
公投第１５案,新北市,板橋區,景星里,1136,1499,302,504,806,56,862
公投第１５案,新北市,板橋區,景星里,1137,1528,267,488,755,46,801
公投第１５案,新北市,板橋區,福星里,1138,1536,333,532,865,49,914
公投第１５案,新北市,板橋區,福星里,1139,1550,340,512,852,45,897
公投第１５案,新北市,板橋區,鄉雲里,1140,2050,396,703,1099,65,1164
公投第１５案,新北市,板橋區,鄉雲里,1141,1300,259,482,741,35,776
公投第１５案,新北市,板橋區,廣德里,1142,1537,258,582,840,48,888
公投第１５案,新北市,板橋區,廣德里,1143,1341,258,419,677,29,706
公投第１５案,新北市,板橋區,廣德里,1144,1606,327,530,857,61,918
公投第１５案,新北市,板橋區,廣德里,1145,1433,254,468,722,37,759
公投第１５案,新北市,板橋區,大豐里,1146,1685,293,554,847,40,887
公投第１５案,新北市,板橋區,大豐里,1147,1248,252,470,722,52,774
公投第１５案,新北市,板橋區,大豐里,1148,1172,210,400,610,45,655
公投第１５案,新北市,板橋區,重慶里,1149,1640,308,480,788,35,823
公投第１５案,新北市,板橋區,重慶里,1150,1428,270,471,741,42,783
公投第１５案,新北市,板橋區,重慶里,1151,1527,306,501,807,64,871
公投第１５案,新北市,板橋區,重慶里,1152,1350,267,506,773,22,795
公投第１５案,新北市,板橋區,重慶里,1153,1582,278,541,819,75,894
公投第１５案,新北市,板橋區,仁愛里,1154,919,171,397,568,32,600
公投第１５案,新北市,板橋區,仁愛里,1155,930,184,331,515,27,542
公投第１５案,新北市,板橋區,仁愛里,1156,974,184,403,587,28,615
公投第１５案,新北市,板橋區,和平里,1157,1732,342,630,972,40,1012
公投第１５案,新北市,板橋區,和平里,1158,1438,275,470,745,66,811
公投第１５案,新北市,板橋區,廣福里,1159,1777,338,567,905,71,976
公投第１５案,新北市,板橋區,廣福里,1160,1764,279,547,826,53,879
公投第１５案,新北市,板橋區,五權里,1161,1289,243,454,697,30,727
公投第１５案,新北市,板橋區,五權里,1162,1182,218,420,638,54,692
公投第１５案,新北市,板橋區,五權里,1163,1174,227,412,639,66,705
公投第１５案,新北市,板橋區,華興里,1164,1870,348,578,926,82,1008
公投第１５案,新北市,板橋區,華興里,1165,1842,403,627,1030,51,1081
公投第１５案,新北市,板橋區,華貴里,1166,1094,224,369,593,48,641
公投第１５案,新北市,板橋區,華貴里,1167,1228,207,416,623,51,674
公投第１５案,新北市,板橋區,華福里,1168,998,222,396,618,44,662
公投第１５案,新北市,板橋區,華福里,1169,862,223,313,536,37,573
公投第１５案,新北市,板橋區,華德里,1170,1622,309,492,801,46,847
公投第１５案,新北市,板橋區,華德里,1171,1205,204,464,668,58,726
公投第１５案,新北市,板橋區,華德里,1172,1787,309,552,861,50,911
公投第１５案,新北市,板橋區,華德里,1173,1610,336,551,887,34,921
公投第１５案,新北市,板橋區,華東里,1174,2216,491,779,1270,42,1312
公投第１５案,新北市,板橋區,華東里,1175,2294,478,756,1234,45,1279
公投第１５案,新北市,板橋區,華東里,1176,2090,393,677,1070,67,1137
公投第１５案,新北市,板橋區,信義里,1177,1356,225,429,654,28,682
公投第１５案,新北市,板橋區,信義里,1178,1067,216,386,602,31,633
公投第１５案,新北市,板橋區,信義里,1179,1319,257,480,737,46,783
公投第１５案,新北市,板橋區,浮洲里,1180,1316,246,440,686,42,728
公投第１５案,新北市,板橋區,浮洲里,1181,1195,210,382,592,58,650
公投第１５案,新北市,板橋區,浮洲里,1182,857,178,285,463,24,487
公投第１５案,新北市,板橋區,華中里,1183,1417,266,435,701,70,771
公投第１５案,新北市,板橋區,華中里,1184,1560,340,488,828,77,905
公投第１５案,新北市,板橋區,華中里,1185,1747,337,575,912,93,1005
公投第１５案,新北市,板橋區,僑中里,1186,1176,251,457,708,40,748
公投第１５案,新北市,板橋區,僑中里,1187,1101,241,381,622,27,649
公投第１５案,新北市,板橋區,僑中里,1188,1458,333,490,823,24,847
公投第１５案,新北市,板橋區,大觀里,1189,1630,380,393,773,49,822
公投第１５案,新北市,板橋區,大觀里,1190,1611,314,500,814,87,901
公投第１５案,新北市,板橋區,歡園里,1191,1139,189,416,605,38,643
公投第１５案,新北市,板橋區,中山里,1192,1120,240,355,595,31,626
公投第１５案,新北市,板橋區,中山里,1193,1022,192,378,570,83,653
公投第１５案,新北市,板橋區,中山里,1194,1049,197,372,569,72,641
公投第１５案,新北市,板橋區,中山里,1195,1007,189,388,577,15,592
公投第１５案,新北市,板橋區,中山里,1196,1393,244,520,764,26,790
公投第１５案,新北市,板橋區,復興里,1197,474,59,102,161,38,199
公投第１５案,新北市,板橋區,復興里,1198,500,104,165,269,30,299
公投第１５案,新北市,板橋區,大安里,1199,1177,236,401,637,44,681
公投第１５案,新北市,板橋區,大安里,1200,1186,197,439,636,29,665
公投第１５案,新北市,板橋區,大安里,1201,1139,229,416,645,56,701
公投第１５案,新北市,板橋區,福安里,1202,1750,274,639,913,60,973
公投第１５案,新北市,板橋區,福安里,1203,3451,413,753,1166,40,1206
公投第１５案,新北市,板橋區,聚安里,1204,1620,291,490,781,70,851
公投第１５案,新北市,板橋區,聚安里,1205,903,167,266,433,21,454
公投第１５案,新北市,板橋區,聚安里,1206,1232,236,449,685,39,724
公投第１５案,新北市,板橋區,聚安里,1207,975,185,284,469,23,492
公投第１５案,新北市,板橋區,龍安里,1208,1224,223,414,637,35,672
公投第１５案,新北市,板橋區,龍安里,1209,1291,235,454,689,42,731
公投第１５案,新北市,板橋區,崑崙里,1210,1828,334,537,871,47,918
公投第１５案,新北市,板橋區,崑崙里,1211,1725,320,502,822,58,880
公投第１５案,新北市,板橋區,崑崙里,1212,1085,178,329,507,26,533
公投第１５案,新北市,板橋區,崑崙里,1213,2357,417,744,1161,58,1219
公投第１５案,新北市,板橋區,崑崙里,1214,1560,311,492,803,37,840
公投第１５案,新北市,板橋區,成和里,1215,2201,350,606,956,32,988
公投第１５案,新北市,板橋區,成和里,1216,1626,306,512,818,48,866
公投第１５案,新北市,板橋區,成和里,1217,1786,269,530,799,31,830
公投第１５案,新北市,板橋區,溪洲里,1218,1763,300,597,897,52,949
公投第１５案,新北市,板橋區,溪洲里,1219,1744,322,533,855,27,882
公投第１５案,新北市,板橋區,溪洲里,1220,1645,290,538,828,51,879
公投第１５案,新北市,板橋區,溪福里,1221,1861,319,571,890,33,923
公投第１５案,新北市,板橋區,溪福里,1222,1596,255,519,774,34,808
公投第１５案,新北市,板橋區,溪福里,1223,1871,338,617,955,59,1014
公投第１５案,新北市,板橋區,溪福里,1224,1938,370,645,1015,48,1063
公投第１５案,新北市,板橋區,溪福里,1225,1827,367,607,974,42,1016
公投第１５案,新北市,板橋區,溪福里,1226,1359,242,447,689,34,723
公投第１５案,新北市,板橋區,溪福里,1227,1613,282,561,843,48,891
公投第１５案,新北市,板橋區,溪北里,1228,1566,287,533,820,68,888
公投第１５案,新北市,板橋區,溪北里,1229,1552,337,550,887,50,937
公投第１５案,新北市,板橋區,堂春里,1230,1885,391,580,971,29,1000
公投第１５案,新北市,板橋區,堂春里,1231,1893,329,596,925,79,1004
公投第１５案,新北市,中和區,中原里,1232,1630,292,489,781,63,844
公投第１５案,新北市,中和區,中原里,1233,1775,361,586,947,42,989
公投第１５案,新北市,中和區,中原里,1234,1844,317,587,904,30,934
公投第１５案,新北市,中和區,連和里,1235,1019,229,396,625,16,641
公投第１５案,新北市,中和區,連和里,1236,1138,220,457,677,18,695
公投第１５案,新北市,中和區,連城里,1237,1878,326,607,933,31,964
公投第１５案,新北市,中和區,連城里,1238,1980,290,793,1083,43,1126
公投第１５案,新北市,中和區,連城里,1239,1844,342,621,963,74,1037
公投第１５案,新北市,中和區,力行里,1240,2085,460,706,1166,31,1197
公投第１５案,新北市,中和區,力行里,1241,1498,253,537,790,43,833
公投第１５案,新北市,中和區,力行里,1242,1761,331,596,927,25,952
公投第１５案,新北市,中和區,正行里,1243,1254,273,385,658,36,694
公投第１５案,新北市,中和區,正行里,1244,1343,267,495,762,26,788
公投第１５案,新北市,中和區,德行里,1245,1789,376,589,965,34,999
公投第１５案,新北市,中和區,德行里,1246,2000,419,665,1084,30,1114
公投第１５案,新北市,中和區,德行里,1247,1953,367,558,925,34,959
公投第１５案,新北市,中和區,枋寮里,1248,1712,330,566,896,60,956
公投第１５案,新北市,中和區,枋寮里,1249,1582,269,615,884,43,927
公投第１５案,新北市,中和區,漳和里,1250,1742,323,592,915,42,957
公投第１５案,新北市,中和區,漳和里,1251,1493,318,566,884,41,925
公投第１５案,新北市,中和區,廟美里,1252,1352,257,437,694,34,728
公投第１５案,新北市,中和區,廟美里,1253,1244,207,490,697,42,739
公投第１５案,新北市,中和區,廟美里,1254,1394,230,533,763,47,810
公投第１５案,新北市,中和區,福真里,1255,1917,317,508,825,30,855
公投第１５案,新北市,中和區,福真里,1256,1830,316,566,882,71,953
公投第１５案,新北市,中和區,福善里,1257,1124,234,398,632,33,665
公投第１５案,新北市,中和區,福善里,1258,1412,260,429,689,31,720
公投第１５案,新北市,中和區,福善里,1259,1356,258,447,705,42,747
公投第１５案,新北市,中和區,福美里,1260,1425,225,499,724,28,752
公投第１５案,新北市,中和區,福美里,1261,1259,254,447,701,59,760
公投第１５案,新北市,中和區,福美里,1262,1256,238,440,678,57,735
公投第１５案,新北市,中和區,福祥里,1263,1423,266,495,761,39,800
公投第１５案,新北市,中和區,福祥里,1264,1221,214,425,639,52,691
公投第１５案,新北市,中和區,福祥里,1265,1858,321,572,893,50,943
公投第１５案,新北市,中和區,瓦磘里,1266,1804,325,574,899,46,945
公投第１５案,新北市,中和區,瓦磘里,1267,1669,356,583,939,30,969
公投第１５案,新北市,中和區,瓦磘里,1268,1485,282,518,800,37,837
公投第１５案,新北市,中和區,福和里,1269,1005,191,377,568,41,609
公投第１５案,新北市,中和區,福和里,1270,1175,267,429,696,59,755
公投第１５案,新北市,中和區,福和里,1271,1171,226,428,654,38,692
公投第１５案,新北市,中和區,佳和里,1272,1746,301,547,848,30,878
公投第１５案,新北市,中和區,佳和里,1273,1555,276,465,741,33,774
公投第１５案,新北市,中和區,佳和里,1274,1112,216,378,594,41,635
公投第１５案,新北市,中和區,新南里,1275,1780,379,633,1012,43,1055
公投第１５案,新北市,中和區,新南里,1276,1918,398,627,1025,31,1056
公投第１５案,新北市,中和區,新南里,1277,1689,257,480,737,27,764
公投第１５案,新北市,中和區,新南里,1278,1781,353,634,987,23,1010
公投第１５案,新北市,中和區,南山里,1279,1419,284,496,780,40,820
公投第１５案,新北市,中和區,南山里,1280,1344,247,447,694,31,725
公投第１５案,新北市,中和區,南山里,1281,1804,383,706,1089,33,1122
公投第１５案,新北市,中和區,平河里,1282,1788,353,545,898,63,961
公投第１５案,新北市,中和區,平河里,1283,1793,310,644,954,46,1000
公投第１５案,新北市,中和區,平河里,1284,1352,271,464,735,52,787
公投第１５案,新北市,中和區,平河里,1285,1813,354,638,992,50,1042
公投第１５案,新北市,中和區,平河里,1286,1288,265,525,790,30,820
公投第１５案,新北市,中和區,信和里,1287,1186,243,394,637,41,678
公投第１５案,新北市,中和區,信和里,1288,1237,194,438,632,8,640
公投第１５案,新北市,中和區,信和里,1289,1406,248,489,737,50,787
公投第１５案,新北市,中和區,仁和里,1290,1442,279,480,759,54,813
公投第１５案,新北市,中和區,仁和里,1291,1040,229,385,614,36,650
公投第１５案,新北市,中和區,仁和里,1292,1292,237,497,734,49,783
公投第１５案,新北市,中和區,中正里,1293,1811,317,618,935,51,986
公投第１５案,新北市,中和區,中正里,1294,1789,330,628,958,72,1030
公投第１５案,新北市,中和區,建和里,1295,859,157,373,530,30,560
公投第１５案,新北市,中和區,建和里,1296,972,168,432,600,27,627
公投第１５案,新北市,中和區,建和里,1297,1346,257,470,727,39,766
公投第１５案,新北市,中和區,中山里,1298,1034,206,371,577,37,614
公投第１５案,新北市,中和區,中山里,1299,1387,257,504,761,39,800
公投第１５案,新北市,中和區,碧河里,1300,2067,379,725,1104,70,1174
公投第１５案,新北市,中和區,碧河里,1301,1670,282,480,762,43,805
公投第１５案,新北市,中和區,正南里,1302,1166,222,401,623,41,664
公投第１５案,新北市,中和區,正南里,1303,963,173,363,536,37,573
公投第１５案,新北市,中和區,正南里,1304,1070,160,378,538,33,571
公投第１５案,新北市,中和區,頂南里,1305,1319,215,482,697,39,736
公投第１５案,新北市,中和區,頂南里,1306,1438,261,571,832,47,879
公投第１５案,新北市,中和區,華新里,1307,1808,299,596,895,36,931
公投第１５案,新北市,中和區,華新里,1308,1191,182,432,614,16,630
公投第１５案,新北市,中和區,華新里,1309,1632,280,556,836,63,899
公投第１５案,新北市,中和區,華新里,1310,1765,275,601,876,46,922
公投第１５案,新北市,中和區,東南里,1311,1168,193,484,677,22,699
公投第１５案,新北市,中和區,東南里,1312,1176,185,448,633,28,661
公投第１５案,新北市,中和區,東南里,1313,1565,273,668,941,51,992
公投第１５案,新北市,中和區,華南里,1314,1578,245,520,765,45,810
公投第１５案,新北市,中和區,華南里,1315,2029,402,668,1070,30,1100
公投第１５案,新北市,中和區,華南里,1316,905,170,318,488,33,521
公投第１５案,新北市,中和區,忠孝里,1317,839,128,282,410,32,442
公投第１５案,新北市,中和區,忠孝里,1318,762,129,292,421,23,444
公投第１５案,新北市,中和區,忠孝里,1319,1420,246,508,754,49,803
公投第１５案,新北市,中和區,忠孝里,1320,1272,216,436,652,46,698
公投第１５案,新北市,中和區,崇南里,1321,1976,354,637,991,58,1049
公投第１５案,新北市,中和區,崇南里,1322,1779,269,668,937,37,974
公投第１５案,新北市,中和區,興南里,1323,1454,231,439,670,48,718
公投第１５案,新北市,中和區,興南里,1324,1374,182,512,694,35,729
公投第１５案,新北市,中和區,景南里,1325,1369,225,428,653,43,696
公投第１５案,新北市,中和區,景南里,1326,1501,280,495,775,47,822
公投第１５案,新北市,中和區,景本里,1327,920,173,375,548,54,602
公投第１５案,新北市,中和區,景本里,1328,1050,205,405,610,47,657
公投第１５案,新北市,中和區,橫路里,1329,321,64,123,187,10,197
公投第１５案,新北市,中和區,內南里,1330,1474,240,480,720,58,778
公投第１５案,新北市,中和區,內南里,1331,1461,252,517,769,75,844
公投第１５案,新北市,中和區,內南里,1332,1621,275,550,825,37,862
公投第１５案,新北市,中和區,壽南里,1333,1327,242,522,764,58,822
公投第１５案,新北市,中和區,壽南里,1334,775,140,287,427,23,450
公投第１５案,新北市,中和區,福南里,1335,1916,317,602,919,47,966
公投第１５案,新北市,中和區,福南里,1336,1901,303,625,928,62,990
公投第１５案,新北市,中和區,外南里,1337,4411,259,502,761,29,790
公投第１５案,新北市,中和區,外南里,1338,1212,219,429,648,31,679
公投第１５案,新北市,中和區,外南里,1339,1126,208,414,622,29,651
公投第１５案,新北市,中和區,中興里,1340,1507,261,514,775,25,800
公投第１５案,新北市,中和區,中興里,1341,1519,287,524,811,20,831
公投第１５案,新北市,中和區,中興里,1342,1467,309,500,809,44,853
公投第１５案,新北市,中和區,中興里,1343,1453,257,574,831,56,887
公投第１５案,新北市,中和區,吉興里,1344,1364,278,513,791,39,830
公投第１５案,新北市,中和區,吉興里,1345,1302,244,453,697,38,735
公投第１５案,新北市,中和區,復興里,1346,1627,241,485,726,24,750
公投第１５案,新北市,中和區,復興里,1347,1503,249,524,773,25,798
公投第１５案,新北市,中和區,復興里,1348,1392,224,490,714,29,743
公投第１５案,新北市,中和區,和興里,1349,1067,215,394,609,29,638
公投第１５案,新北市,中和區,和興里,1350,1623,268,551,819,42,861
公投第１５案,新北市,中和區,和興里,1351,1208,255,433,688,22,710
公投第１５案,新北市,中和區,景平里,1352,1991,578,280,858,40,898
公投第１５案,新北市,中和區,景平里,1353,1932,308,573,881,30,911
公投第１５案,新北市,中和區,景平里,1354,947,221,410,631,15,646
公投第１５案,新北市,中和區,景新里,1355,1660,296,607,903,57,960
公投第１５案,新北市,中和區,景新里,1356,1574,247,482,729,57,786
公投第１５案,新北市,中和區,景福里,1357,2136,364,677,1041,44,1085
公投第１５案,新北市,中和區,景福里,1358,1462,258,467,725,56,781
公投第１５案,新北市,中和區,景福里,1359,1548,232,514,746,69,815
公投第１５案,新北市,中和區,景安里,1360,692,146,296,442,15,457
公投第１５案,新北市,中和區,景安里,1361,1221,231,493,724,44,768
公投第１５案,新北市,中和區,景安里,1362,1331,285,465,750,38,788
公投第１５案,新北市,中和區,景安里,1363,984,195,395,590,33,623
公投第１５案,新北市,中和區,景文里,1364,1871,315,598,913,37,950
公投第１５案,新北市,中和區,景文里,1365,1279,217,453,670,32,702
公投第１５案,新北市,中和區,錦和里,1366,1629,318,571,889,42,931
公投第１５案,新北市,中和區,錦和里,1367,1482,313,502,815,29,844
公投第１５案,新北市,中和區,錦和里,1368,1715,300,659,959,41,1000
公投第１５案,新北市,中和區,錦昌里,1369,1952,327,716,1043,60,1103
公投第１５案,新北市,中和區,灰磘里,1370,686,138,244,382,23,405
公投第１５案,新北市,中和區,積穗里,1371,1577,267,475,742,33,775
公投第１５案,新北市,中和區,積穗里,1372,1158,261,396,657,25,682
公投第１５案,新北市,中和區,積穗里,1373,1195,263,476,739,16,755
公投第１５案,新北市,中和區,積穗里,1374,1054,221,423,644,31,675
公投第１５案,新北市,中和區,積穗里,1375,612,133,245,378,18,396
公投第１５案,新北市,中和區,積穗里,1376,1668,327,603,930,30,960
公投第１５案,新北市,中和區,民享里,1377,1071,219,415,634,53,687
公投第１５案,新北市,中和區,民享里,1378,1169,285,472,757,49,806
公投第１５案,新北市,中和區,員山里,1379,1370,265,455,720,31,751
公投第１５案,新北市,中和區,員山里,1380,1574,285,587,872,75,947
公投第１５案,新北市,中和區,員山里,1381,2614,392,772,1164,26,1190
公投第１５案,新北市,中和區,嘉穗里,1382,1477,266,554,820,50,870
公投第１５案,新北市,中和區,嘉穗里,1383,1041,233,322,555,57,612
公投第１５案,新北市,中和區,文元里,1384,1538,260,489,749,62,811
公投第１５案,新北市,中和區,文元里,1385,1599,295,532,827,50,877
公投第１５案,新北市,中和區,文元里,1386,1586,292,565,857,75,932
公投第１５案,新北市,中和區,嘉新里,1387,1726,323,673,996,60,1056
公投第１５案,新北市,中和區,嘉新里,1388,1854,402,671,1073,65,1138
公投第１５案,新北市,中和區,民安里,1389,1472,295,552,847,48,895
公投第１５案,新北市,中和區,民安里,1390,1430,276,541,817,56,873
公投第１５案,新北市,中和區,民安里,1391,1488,302,551,853,48,901
公投第１５案,新北市,中和區,安穗里,1392,1251,252,411,663,32,695
公投第１５案,新北市,中和區,安穗里,1393,1487,275,549,824,38,862
公投第１５案,新北市,中和區,安穗里,1394,1328,247,422,669,75,744
公投第１５案,新北市,中和區,瑞穗里,1395,1128,246,420,666,34,700
公投第１５案,新北市,中和區,瑞穗里,1396,1008,199,433,632,28,660
公投第１５案,新北市,中和區,明穗里,1397,1786,358,630,988,41,1029
公投第１５案,新北市,中和區,明穗里,1398,2219,392,730,1122,60,1182
公投第１５案,新北市,中和區,清穗里,1399,1322,221,447,668,28,696
公投第１５案,新北市,中和區,清穗里,1400,1495,271,519,790,15,805
公投第１５案,新北市,中和區,自強里,1401,1414,246,490,736,50,786
公投第１５案,新北市,中和區,自強里,1402,1681,270,637,907,61,968
公投第１５案,新北市,中和區,自強里,1403,1361,262,461,723,50,773
公投第１５案,新北市,中和區,德穗里,1404,1442,240,519,759,44,803
公投第１５案,新北市,中和區,德穗里,1405,1383,455,256,711,27,738
公投第１５案,新北市,中和區,德穗里,1406,1264,228,462,690,37,727
公投第１５案,新北市,中和區,民生里,1407,1810,321,671,992,90,1082
公投第１５案,新北市,中和區,民生里,1408,1951,349,570,919,45,964
公投第１５案,新北市,中和區,國光里,1409,1582,276,487,763,41,804
公投第１５案,新北市,中和區,國光里,1410,1945,364,726,1090,62,1152
公投第１５案,新北市,中和區,壽德里,1411,1390,237,530,767,43,810
公投第１５案,新北市,中和區,壽德里,1412,1161,238,410,648,19,667
公投第１５案,新北市,中和區,壽德里,1413,1399,206,553,759,33,792
公投第１５案,新北市,中和區,明德里,1414,1070,182,393,575,34,609
公投第１５案,新北市,中和區,明德里,1415,1169,211,398,609,32,641
公投第１５案,新北市,中和區,明德里,1416,1214,224,496,720,49,769
公投第１５案,新北市,中和區,錦中里,1417,1398,278,505,783,48,831
公投第１５案,新北市,中和區,錦中里,1418,1049,205,377,582,32,614
公投第１５案,新北市,中和區,錦中里,1419,1324,285,503,788,40,828
公投第１５案,新北市,中和區,錦盛里,1420,1765,426,395,821,28,849
公投第１５案,新北市,中和區,錦盛里,1421,1709,271,547,818,51,869
公投第１５案,新北市,中和區,民有里,1422,1186,187,436,623,73,696
公投第１５案,新北市,中和區,民有里,1423,1318,234,499,733,49,782
公投第１５案,新北市,中和區,員富里,1424,1430,312,493,805,34,839
公投第１５案,新北市,中和區,員富里,1425,1637,265,422,687,43,730
公投第１５案,新北市,中和區,嘉慶里,1426,1283,263,426,689,51,740
公投第１５案,新北市,中和區,嘉慶里,1427,1310,259,451,710,44,754
公投第１５案,新北市,中和區,嘉慶里,1428,1301,267,451,718,47,765
公投第１５案,新北市,中和區,冠穗里,1429,1681,335,566,901,67,968
公投第１５案,新北市,中和區,冠穗里,1430,1384,279,509,788,27,815
公投第１５案,新北市,中和區,國華里,1431,1187,251,402,653,32,685
公投第１５案,新北市,中和區,國華里,1432,1779,293,495,788,7,795
公投第１５案,新北市,中和區,宜安里,1433,1712,302,622,924,46,970
公投第１５案,新北市,中和區,安樂里,1434,1462,285,475,760,37,797
公投第１５案,新北市,中和區,安樂里,1435,1824,347,598,945,27,972
公投第１５案,新北市,中和區,安和里,1436,1389,282,441,723,46,769
公投第１５案,新北市,中和區,安和里,1437,1434,290,521,811,37,848
公投第１５案,新北市,中和區,安順里,1438,1953,305,690,995,58,1053
公投第１５案,新北市,中和區,安順里,1439,2002,375,695,1070,54,1124
公投第１５案,新北市,中和區,安平里,1440,1858,309,669,978,25,1003
公投第１５案,新北市,中和區,安平里,1441,1801,331,612,943,20,963
公投第１５案,新北市,中和區,安平里,1442,1691,323,610,933,42,975
公投第１５案,新北市,中和區,中安里,1443,1363,290,497,787,31,818
公投第１５案,新北市,中和區,中安里,1444,1220,258,479,737,26,763
公投第１５案,新北市,中和區,中安里,1445,1365,289,549,838,25,863
公投第１５案,新北市,中和區,泰安里,1446,1178,225,433,658,25,683
公投第１５案,新北市,中和區,泰安里,1447,830,166,310,476,30,506
公投第１５案,新北市,中和區,泰安里,1448,1197,207,362,569,54,623
公投第１５案,新北市,中和區,秀山里,1449,1369,237,525,762,45,807
公投第１５案,新北市,中和區,秀山里,1450,1336,262,494,756,46,802
公投第１５案,新北市,中和區,秀山里,1451,1377,268,549,817,47,864
公投第１５案,新北市,中和區,秀成里,1452,1499,277,554,831,52,883
公投第１５案,新北市,中和區,秀成里,1453,1689,336,617,953,45,998
公投第１５案,新北市,中和區,秀義里,1454,1323,275,473,748,47,795
公投第１５案,新北市,中和區,秀義里,1455,1079,213,424,637,45,682
公投第１５案,新北市,中和區,秀福里,1456,1545,311,547,858,48,906
公投第１５案,新北市,中和區,秀福里,1457,1326,261,436,697,48,745
公投第１５案,新北市,中和區,秀福里,1458,1443,283,490,773,26,799
公投第１５案,新北市,中和區,秀景里,1459,1712,298,625,923,31,954
公投第１５案,新北市,中和區,秀景里,1460,1916,333,665,998,48,1046
公投第１５案,新北市,中和區,秀景里,1461,863,169,338,507,34,541
公投第１５案,新北市,中和區,秀景里,1462,1203,257,473,730,7,737
公投第１５案,新北市,中和區,秀明里,1463,1483,275,507,782,16,798
公投第１５案,新北市,中和區,秀明里,1464,1575,263,551,814,27,841
公投第１５案,新北市,中和區,秀明里,1465,1432,205,485,690,45,735
公投第１５案,新北市,中和區,秀峰里,1466,1441,259,498,757,52,809
公投第１５案,新北市,中和區,秀峰里,1467,1269,261,461,722,44,766
公投第１５案,新北市,中和區,秀峰里,1468,1363,279,506,785,27,812
公投第１５案,新北市,中和區,秀士里,1469,1089,169,444,613,23,636
公投第１５案,新北市,中和區,秀士里,1470,1171,231,366,597,28,625
公投第１５案,新北市,中和區,秀水里,1471,1150,201,436,637,37,674
公投第１５案,新北市,中和區,秀水里,1472,1154,239,450,689,29,718
公投第１５案,新北市,中和區,秀水里,1473,1067,172,453,625,36,661
公投第１５案,新北市,中和區,秀仁里,1474,1526,252,535,787,38,825
公投第１５案,新北市,中和區,秀仁里,1475,1447,286,524,810,39,849
公投第１５案,新北市,永和區,光復里,1476,1554,321,532,853,65,918
公投第１５案,新北市,永和區,網溪里,1477,1065,180,429,609,16,625
公投第１５案,新北市,永和區,復興里,1478,854,173,342,515,27,542
公投第１５案,新北市,永和區,復興里,1479,1253,233,473,706,45,751
公投第１５案,新北市,永和區,竹林里,1480,1733,375,572,947,36,983
公投第１５案,新北市,永和區,竹林里,1481,1581,304,544,848,46,894
公投第１５案,新北市,永和區,桂林里,1482,1735,296,608,904,57,961
公投第１５案,新北市,永和區,桂林里,1483,1563,269,555,824,25,849
公投第１５案,新北市,永和區,上林里,1484,1650,335,603,938,49,987
公投第１５案,新北市,永和區,上林里,1485,1454,279,526,805,28,833
公投第１５案,新北市,永和區,福林里,1486,1568,318,486,804,36,840
公投第１５案,新北市,永和區,福林里,1487,1444,256,492,748,38,786
公投第１５案,新北市,永和區,勵行里,1488,1140,240,361,601,39,640
公投第１５案,新北市,永和區,中興里,1489,1188,227,469,696,40,736
公投第１５案,新北市,永和區,中興里,1490,1516,269,520,789,60,849
公投第１５案,新北市,永和區,永興里,1491,1397,267,469,736,49,785
公投第１５案,新北市,永和區,永興里,1492,1438,286,504,790,24,814
公投第１５案,新北市,永和區,正興里,1493,1084,209,420,629,25,654
公投第１５案,新北市,永和區,正興里,1494,941,186,339,525,26,551
公投第１５案,新北市,永和區,豫溪里,1495,1598,288,555,843,30,873
公投第１５案,新北市,永和區,豫溪里,1496,2842,319,523,842,29,871
公投第１５案,新北市,永和區,光明里,1497,1261,269,483,752,39,791
公投第１５案,新北市,永和區,光明里,1498,1449,344,554,898,30,928
公投第１５案,新北市,永和區,福和里,1499,1511,287,559,846,43,889
公投第１５案,新北市,永和區,福和里,1500,1470,305,583,888,37,925
公投第１５案,新北市,永和區,福和里,1501,1580,288,586,874,38,912
公投第１５案,新北市,永和區,得和里,1502,1438,304,577,881,27,908
公投第１５案,新北市,永和區,得和里,1503,1305,276,512,788,35,823
公投第１５案,新北市,永和區,得和里,1504,1046,211,416,627,24,651
公投第１５案,新北市,永和區,永貞里,1505,1566,342,559,901,19,920
公投第１５案,新北市,永和區,永貞里,1506,1468,311,536,847,36,883
公投第１５案,新北市,永和區,永福里,1507,1305,302,512,814,44,858
公投第１５案,新北市,永和區,永福里,1508,1181,248,451,699,33,732
公投第１５案,新北市,永和區,河濱里,1509,1720,331,577,908,46,954
公投第１５案,新北市,永和區,河濱里,1510,1103,264,404,668,36,704
公投第１５案,新北市,永和區,秀和里,1511,1649,326,557,883,84,967
公投第１５案,新北市,永和區,秀和里,1512,1206,275,447,722,34,756
公投第１５案,新北市,永和區,秀和里,1513,1506,332,543,875,32,907
公投第１５案,新北市,永和區,永元里,1514,1488,291,527,818,39,857
公投第１５案,新北市,永和區,永元里,1515,1288,275,479,754,51,805
公投第１５案,新北市,永和區,永元里,1516,1413,271,453,724,38,762
公投第１５案,新北市,永和區,民權里,1517,1329,231,504,735,42,777
公投第１５案,新北市,永和區,民權里,1518,1436,302,554,856,30,886
公投第１５案,新北市,永和區,民權里,1519,1112,223,405,628,37,665
公投第１５案,新北市,永和區,民族里,1520,1100,232,469,701,43,744
公投第１５案,新北市,永和區,民族里,1521,1545,320,599,919,48,967
公投第１５案,新北市,永和區,民族里,1522,1436,242,562,804,21,825
公投第１５案,新北市,永和區,秀朗里,1523,1731,352,671,1023,60,1083
公投第１５案,新北市,永和區,秀朗里,1524,1762,385,649,1034,59,1093
公投第１５案,新北市,永和區,秀成里,1525,1320,255,452,707,42,749
公投第１５案,新北市,永和區,秀成里,1526,1297,237,390,627,18,645
公投第１５案,新北市,永和區,秀林里,1527,1798,377,580,957,55,1012
公投第１５案,新北市,永和區,秀林里,1528,1491,309,549,858,53,911
公投第１５案,新北市,永和區,秀得里,1529,1223,235,455,690,16,706
公投第１５案,新北市,永和區,秀得里,1530,1108,205,415,620,48,668
公投第１５案,新北市,永和區,秀元里,1531,1408,304,518,822,40,862
公投第１５案,新北市,永和區,秀元里,1532,1265,249,477,726,46,772
公投第１５案,新北市,永和區,民生里,1533,1115,200,412,612,14,626
公投第１５案,新北市,永和區,民生里,1534,1133,234,447,681,48,729
公投第１５案,新北市,永和區,民生里,1535,1217,239,453,692,48,740
公投第１５案,新北市,永和區,民本里,1536,1713,332,585,917,52,969
公投第１５案,新北市,永和區,民本里,1537,1721,337,576,913,37,950
公投第１５案,新北市,永和區,民富里,1538,1327,236,476,712,43,755
公投第１５案,新北市,永和區,民富里,1539,1257,261,497,758,26,784
公投第１５案,新北市,永和區,民樂里,1540,1348,267,536,803,35,838
公投第１５案,新北市,永和區,民樂里,1541,1461,311,585,896,37,933
公投第１５案,新北市,永和區,民樂里,1542,1368,276,483,759,57,816
公投第１５案,新北市,永和區,民治里,1543,1234,232,426,658,65,723
公投第１５案,新北市,永和區,民治里,1544,1303,267,459,726,40,766
公投第１５案,新北市,永和區,智光里,1545,1516,271,552,823,33,856
公投第１５案,新北市,永和區,智光里,1546,1422,263,558,821,54,875
公投第１５案,新北市,永和區,潭安里,1547,991,220,378,598,19,617
公投第１５案,新北市,永和區,潭安里,1548,1016,213,404,617,24,641
公投第１５案,新北市,永和區,潭安里,1549,1146,226,435,661,33,694
公投第１５案,新北市,永和區,潭安里,1550,1043,167,437,604,31,635
公投第１５案,新北市,永和區,潭墘里,1551,1210,259,474,733,14,747
公投第１５案,新北市,永和區,潭墘里,1552,1630,316,610,926,26,952
公投第１５案,新北市,永和區,潭墘里,1553,1092,221,419,640,21,661
公投第１５案,新北市,永和區,店街里,1554,1872,370,696,1066,46,1112
公投第１５案,新北市,永和區,店街里,1555,1781,346,647,993,22,1015
公投第１５案,新北市,永和區,大新里,1556,1049,214,403,617,33,650
公投第１５案,新北市,永和區,大新里,1557,1285,277,501,778,38,816
公投第１５案,新北市,永和區,永安里,1558,1209,270,448,718,35,753
公投第１５案,新北市,永和區,永安里,1559,1132,247,437,684,30,714
公投第１５案,新北市,永和區,永安里,1560,1287,264,529,793,33,826
公投第１５案,新北市,永和區,永樂里,1561,1068,234,400,634,37,671
公投第１５案,新北市,永和區,永樂里,1562,1098,258,400,658,41,699
公投第１５案,新北市,永和區,水源里,1563,1222,215,517,732,33,765
公投第１５案,新北市,永和區,水源里,1564,1157,232,445,677,37,714
公投第１５案,新北市,永和區,水源里,1565,1168,288,437,725,38,763
公投第１５案,新北市,永和區,協和里,1566,1283,266,445,711,41,752
公投第１５案,新北市,永和區,協和里,1567,1372,271,506,777,30,807
公投第１５案,新北市,永和區,雙和里,1568,1876,376,707,1083,44,1127
公投第１５案,新北市,永和區,雙和里,1569,1576,302,639,941,62,1003
公投第１５案,新北市,永和區,安和里,1570,1661,338,626,964,38,1002
公投第１５案,新北市,永和區,安和里,1571,1808,316,688,1004,24,1028
公投第１５案,新北市,永和區,前溪里,1572,1898,373,668,1041,49,1090
公投第１５案,新北市,永和區,和平里,1573,1508,329,568,897,39,936
公投第１５案,新北市,永和區,和平里,1574,1341,273,492,765,61,826
公投第１５案,新北市,永和區,和平里,1575,1422,280,511,791,46,837
公投第１５案,新北市,永和區,保平里,1576,1177,239,420,659,31,690
公投第１５案,新北市,永和區,保平里,1577,1557,316,556,872,52,924
公投第１５案,新北市,永和區,保平里,1578,1491,291,499,790,39,829
公投第１５案,新北市,永和區,中溪里,1579,1586,313,552,865,42,907
公投第１５案,新北市,永和區,中溪里,1580,1313,250,438,688,23,711
公投第１５案,新北市,永和區,中溪里,1581,1636,354,533,887,51,938
公投第１５案,新北市,永和區,保安里,1582,1598,326,553,879,45,924
公投第１５案,新北市,永和區,保安里,1583,1609,360,570,930,43,973
公投第１５案,新北市,永和區,保安里,1584,1375,318,501,819,34,853
公投第１５案,新北市,永和區,保安里,1585,1648,391,619,1010,28,1038
公投第１５案,新北市,永和區,保順里,1586,1077,235,385,620,32,652
公投第１５案,新北市,永和區,保順里,1587,1157,252,426,678,25,703
公投第１５案,新北市,永和區,保順里,1588,1339,311,518,829,22,851
公投第１５案,新北市,永和區,保順里,1589,1306,280,508,788,15,803
公投第１５案,新北市,永和區,保順里,1590,1236,274,486,760,15,775
公投第１５案,新北市,永和區,保順里,1591,1133,221,462,683,21,704
公投第１５案,新北市,永和區,保順里,1592,1425,295,549,844,24,868
公投第１５案,新北市,永和區,下溪里,1593,1938,389,662,1051,68,1119
公投第１５案,新北市,永和區,下溪里,1594,1607,352,563,915,43,958
公投第１５案,新北市,永和區,大同里,1595,853,131,361,492,33,525
公投第１５案,新北市,永和區,新生里,1596,768,112,269,381,46,427
公投第１５案,新北市,永和區,永成里,1597,893,119,290,409,30,439
公投第１５案,新北市,永和區,忠義里,1598,743,124,280,404,32,436
公投第１５案,新北市,永和區,仁愛里,1599,1155,262,433,695,39,734
公投第１５案,新北市,永和區,仁愛里,1600,1263,271,484,755,34,789
公投第１５案,新北市,永和區,文化里,1601,1189,243,470,713,22,735
公投第１５案,新北市,永和區,文化里,1602,1346,223,500,723,36,759
公投第１５案,新北市,永和區,信義里,1603,1368,268,477,745,37,782
公投第１５案,新北市,永和區,信義里,1604,1043,212,388,600,15,615
公投第１５案,新北市,永和區,後溪里,1605,1709,381,607,988,42,1030
公投第１５案,新北市,永和區,上溪里,1606,879,179,290,469,12,481
公投第１５案,新北市,永和區,上溪里,1607,904,209,304,513,28,541
公投第１５案,新北市,永和區,頂溪里,1608,1221,242,473,715,51,766
公投第１５案,新北市,永和區,頂溪里,1609,1018,207,390,597,38,635
公投第１５案,新北市,永和區,河堤里,1610,1551,311,531,842,46,888
公投第１５案,新北市,永和區,河堤里,1611,1428,295,527,822,37,859
公投第１５案,新北市,永和區,新廍里,1612,1044,211,393,604,51,655
公投第１５案,新北市,永和區,新廍里,1613,967,211,364,575,34,609
公投第１５案,新北市,樹林區,三興里,1614,1408,238,450,688,54,742
公投第１５案,新北市,樹林區,三興里,1615,1310,221,453,674,15,689
公投第１５案,新北市,樹林區,三興里,1616,1534,242,455,697,58,755
公投第１５案,新北市,樹林區,三福里,1617,1211,214,411,625,48,673
公投第１５案,新北市,樹林區,三福里,1618,1125,218,402,620,42,662
公投第１５案,新北市,樹林區,三福里,1619,1134,199,481,680,33,713
公投第１５案,新北市,樹林區,三多里,1620,1897,215,603,818,77,895
公投第１５案,新北市,樹林區,三多里,1621,1716,329,522,851,59,910
公投第１５案,新北市,樹林區,三龍里,1622,736,158,267,425,33,458
公投第１５案,新北市,樹林區,三龍里,1623,1137,260,410,670,27,697
公投第１５案,新北市,樹林區,獇寮里,1624,1542,311,447,758,47,805
公投第１５案,新北市,樹林區,獇寮里,1625,1470,277,479,756,60,816
公投第１５案,新北市,樹林區,獇寮里,1626,1456,257,426,683,26,709
公投第１５案,新北市,樹林區,光興里,1627,1124,222,394,616,27,643
公投第１５案,新北市,樹林區,光興里,1628,1235,211,415,626,32,658
公投第１５案,新北市,樹林區,光興里,1629,1212,229,416,645,29,674
公投第１５案,新北市,樹林區,金寮里,1630,1223,196,385,581,36,617
公投第１５案,新北市,樹林區,金寮里,1631,1335,215,544,759,72,831
公投第１５案,新北市,樹林區,金寮里,1632,1206,240,387,627,36,663
公投第１５案,新北市,樹林區,潭底里,1633,1927,239,412,651,60,711
公投第１５案,新北市,樹林區,潭底里,1634,914,165,307,472,49,521
公投第１５案,新北市,樹林區,潭底里,1635,1456,284,500,784,50,834
公投第１５案,新北市,樹林區,文林里,1636,1409,246,489,735,43,778
公投第１５案,新北市,樹林區,文林里,1637,1500,270,568,838,64,902
公投第１５案,新北市,樹林區,文林里,1638,1545,341,473,814,53,867
公投第１５案,新北市,樹林區,保安里,1639,1483,287,467,754,26,780
公投第１５案,新北市,樹林區,保安里,1640,1524,301,505,806,25,831
公投第１５案,新北市,樹林區,保安里,1641,1431,285,462,747,51,798
公投第１５案,新北市,樹林區,保安里,1642,1181,215,403,618,38,656
公投第１５案,新北市,樹林區,圳安里,1643,1116,216,384,600,51,651
公投第１５案,新北市,樹林區,圳安里,1644,1077,189,340,529,36,565
公投第１５案,新北市,樹林區,圳安里,1645,1103,195,353,548,15,563
公投第１５案,新北市,樹林區,圳福里,1646,1385,286,447,733,42,775
公投第１５案,新北市,樹林區,圳福里,1647,1266,236,400,636,35,671
公投第１５案,新北市,樹林區,圳福里,1648,1195,229,378,607,43,650
公投第１５案,新北市,樹林區,圳民里,1649,1254,238,389,627,56,683
公投第１５案,新北市,樹林區,圳民里,1650,1263,269,428,697,33,730
公投第１５案,新北市,樹林區,圳生里,1651,1473,319,531,850,62,912
公投第１５案,新北市,樹林區,樹德里,1652,870,151,321,472,30,502
公投第１５案,新北市,樹林區,樹德里,1653,1338,262,499,761,53,814
公投第１５案,新北市,樹林區,樹德里,1654,1010,187,325,512,34,546
公投第１５案,新北市,樹林區,樹福里,1655,1658,302,587,889,62,951
公投第１５案,新北市,樹林區,樹福里,1656,1538,372,531,903,62,965
公投第１５案,新北市,樹林區,樹西里,1657,1405,317,498,815,70,885
公投第１５案,新北市,樹林區,樹西里,1658,1587,321,517,838,51,889
公投第１５案,新北市,樹林區,樹西里,1659,1566,314,539,853,33,886
公投第１５案,新北市,樹林區,樹興里,1660,997,178,326,504,27,531
公投第１５案,新北市,樹林區,樹興里,1661,1187,230,394,624,55,679
公投第１５案,新北市,樹林區,樹興里,1662,1061,200,338,538,42,580
公投第１５案,新北市,樹林區,樹人里,1663,1701,309,619,928,43,971
公投第１５案,新北市,樹林區,樹人里,1664,1278,208,475,683,42,725
公投第１５案,新北市,樹林區,育英里,1665,1433,316,503,819,46,865
公投第１５案,新北市,樹林區,育英里,1666,1306,269,471,740,62,802
公投第１５案,新北市,樹林區,樹南里,1667,1268,262,454,716,61,777
公投第１５案,新北市,樹林區,樹南里,1668,1281,262,444,706,39,745
公投第１５案,新北市,樹林區,樹南里,1669,1200,266,406,672,45,717
公投第１５案,新北市,樹林區,坡內里,1670,1491,254,483,737,51,788
公投第１５案,新北市,樹林區,樹東里,1671,1066,179,363,542,38,580
公投第１５案,新北市,樹林區,樹北里,1672,877,182,375,557,54,611
公投第１５案,新北市,樹林區,彭福里,1673,1616,263,561,824,51,875
公投第１５案,新北市,樹林區,彭福里,1674,1589,260,438,698,53,751
公投第１５案,新北市,樹林區,彭福里,1675,1367,238,513,751,45,796
公投第１５案,新北市,樹林區,和平里,1676,1144,209,436,645,46,691
公投第１５案,新北市,樹林區,和平里,1677,1059,180,347,527,41,568
公投第１５案,新北市,樹林區,和平里,1678,1224,224,377,601,78,679
公投第１５案,新北市,樹林區,彭興里,1679,1141,217,329,546,39,585
公投第１５案,新北市,樹林區,彭興里,1680,1396,222,390,612,23,635
公投第１５案,新北市,樹林區,彭興里,1681,1157,250,351,601,37,638
公投第１５案,新北市,樹林區,彭興里,1682,1498,255,442,697,78,775
公投第１５案,新北市,樹林區,彭厝里,1683,1514,260,511,771,65,836
公投第１５案,新北市,樹林區,彭厝里,1684,1546,270,480,750,33,783
公投第１５案,新北市,樹林區,彭厝里,1685,1392,278,448,726,46,772
公投第１５案,新北市,樹林區,大同里,1686,1566,270,576,846,39,885
公投第１５案,新北市,樹林區,大同里,1687,1566,314,522,836,27,863
公投第１５案,新北市,樹林區,中華里,1688,1517,300,485,785,50,835
公投第１５案,新北市,樹林區,中華里,1689,1481,281,516,797,26,823
公投第１５案,新北市,樹林區,太順里,1690,1261,213,431,644,43,687
公投第１５案,新北市,樹林區,太順里,1691,1163,189,393,582,33,615
公投第１５案,新北市,樹林區,東昇里,1692,1661,353,578,931,74,1005
公投第１５案,新北市,樹林區,東昇里,1693,1585,322,535,857,39,896
公投第１５案,新北市,樹林區,東昇里,1694,1018,182,399,581,33,614
公投第１５案,新北市,樹林區,東陽里,1695,1247,218,428,646,53,699
公投第１５案,新北市,樹林區,東陽里,1696,1390,230,467,697,58,755
公投第１５案,新北市,樹林區,東陽里,1697,1293,241,461,702,43,745
公投第１５案,新北市,樹林區,東陽里,1698,1301,236,415,651,33,684
公投第１５案,新北市,樹林區,東山里,1699,1606,310,492,802,54,856
公投第１５案,新北市,樹林區,東山里,1700,1277,204,419,623,85,708
公投第１５案,新北市,樹林區,山佳里,1701,1219,248,394,642,56,698
公投第１５案,新北市,樹林區,山佳里,1702,1454,221,494,715,35,750
公投第１５案,新北市,樹林區,山佳里,1703,1314,210,461,671,30,701
公投第１５案,新北市,樹林區,山佳里,1704,1008,206,402,608,31,639
公投第１５案,新北市,樹林區,中山里,1705,1574,282,505,787,63,850
公投第１５案,新北市,樹林區,中山里,1706,1364,261,490,751,30,781
公投第１５案,新北市,樹林區,中山里,1707,1677,273,515,788,65,853
公投第１５案,新北市,樹林區,樂山里,1708,1683,246,484,730,30,760
公投第１５案,新北市,樹林區,柑園里,1709,1452,262,525,787,50,837
公投第１５案,新北市,樹林區,柑園里,1710,1592,326,574,900,31,931
公投第１５案,新北市,樹林區,柑園里,1711,1619,307,609,916,25,941
公投第１５案,新北市,樹林區,柑園里,1712,1642,338,638,976,26,1002
公投第１５案,新北市,樹林區,柑園里,1713,1357,290,446,736,11,747
公投第１５案,新北市,樹林區,西園里,1714,1638,300,574,874,68,942
公投第１５案,新北市,樹林區,南園里,1715,1592,333,508,841,37,878
公投第１５案,新北市,樹林區,南園里,1716,1521,259,603,862,35,897
公投第１５案,新北市,樹林區,南園里,1717,1707,345,626,971,52,1023
公投第１５案,新北市,樹林區,南園里,1718,1741,349,615,964,54,1018
公投第１５案,新北市,樹林區,南園里,1719,1655,297,589,886,42,928
公投第１５案,新北市,樹林區,南園里,1720,1775,307,554,861,54,915
公投第１５案,新北市,樹林區,南園里,1721,1781,275,668,943,43,986
公投第１５案,新北市,樹林區,東園里,1722,1565,286,415,701,42,743
公投第１５案,新北市,樹林區,北園里,1723,936,169,310,479,24,503
公投第１５案,新北市,樹林區,北園里,1724,1030,198,354,552,29,581
公投第１５案,新北市,鶯歌區,建德里,1725,515,99,185,284,14,298
公投第１５案,新北市,鶯歌區,東鶯里,1726,965,205,334,539,42,581
公投第１５案,新北市,鶯歌區,北鶯里,1727,1931,369,634,1003,63,1066
公投第１５案,新北市,鶯歌區,北鶯里,1728,1797,333,509,842,48,890
公投第１５案,新北市,鶯歌區,西鶯里,1729,1057,181,373,554,44,598
公投第１５案,新北市,鶯歌區,西鶯里,1730,962,174,306,480,13,493
公投第１５案,新北市,鶯歌區,中鶯里,1731,934,202,354,556,29,585
公投第１５案,新北市,鶯歌區,南鶯里,1732,1742,355,626,981,56,1037
公投第１５案,新北市,鶯歌區,南鶯里,1733,1634,310,517,827,47,874
公投第１５案,新北市,鶯歌區,南鶯里,1734,1676,302,507,809,36,845
公投第１５案,新北市,鶯歌區,建國里,1735,2052,398,651,1049,85,1134
公投第１５案,新北市,鶯歌區,建國里,1736,1977,357,555,912,29,941
公投第１５案,新北市,鶯歌區,建國里,1737,1957,412,621,1033,20,1053
公投第１５案,新北市,鶯歌區,二甲里,1738,850,133,252,385,5,390
公投第１５案,新北市,鶯歌區,二橋里,1739,1782,285,570,855,54,909
公投第１５案,新北市,鶯歌區,二橋里,1740,1496,276,482,758,40,798
公投第１５案,新北市,鶯歌區,二橋里,1741,2071,330,653,983,43,1026
公投第１５案,新北市,鶯歌區,二橋里,1742,1753,279,453,732,57,789
公投第１５案,新北市,鶯歌區,尖山里,1743,1737,288,570,858,35,893
公投第１５案,新北市,鶯歌區,尖山里,1744,1669,248,507,755,48,803
公投第１５案,新北市,鶯歌區,尖山里,1745,1842,296,503,799,37,836
公投第１５案,新北市,鶯歌區,尖山里,1746,1454,255,437,692,48,740
公投第１５案,新北市,鶯歌區,南靖里,1747,942,189,282,471,35,506
公投第１５案,新北市,鶯歌區,南靖里,1748,1317,238,414,652,52,704
公投第１５案,新北市,鶯歌區,南靖里,1749,949,154,295,449,17,466
公投第１５案,新北市,鶯歌區,同慶里,1750,1440,275,525,800,45,845
公投第１５案,新北市,鶯歌區,永昌里,1751,1809,305,619,924,69,993
公投第１５案,新北市,鶯歌區,永昌里,1752,1758,324,600,924,64,988
公投第１５案,新北市,鶯歌區,永昌里,1753,1589,269,562,831,37,868
公投第１５案,新北市,鶯歌區,永昌里,1754,1067,215,386,601,38,639
公投第１５案,新北市,鶯歌區,永昌里,1755,1092,202,413,615,30,645
公投第１５案,新北市,鶯歌區,永吉里,1756,1730,311,614,925,41,966
公投第１５案,新北市,鶯歌區,永吉里,1757,1281,197,477,674,41,715
公投第１５案,新北市,鶯歌區,永吉里,1758,1238,239,484,723,45,768
公投第１５案,新北市,鶯歌區,鳳祥里,1759,1568,270,544,814,55,869
公投第１５案,新北市,鶯歌區,鳳祥里,1760,1271,233,406,639,46,685
公投第１５案,新北市,鶯歌區,鳳祥里,1761,1183,181,315,496,25,521
公投第１５案,新北市,鶯歌區,鳳鳴里,1762,1026,161,313,474,27,501
公投第１５案,新北市,鶯歌區,鳳鳴里,1763,1721,297,513,810,43,853
公投第１５案,新北市,鶯歌區,鳳鳴里,1764,1317,231,394,625,68,693
公投第１５案,新北市,鶯歌區,鳳福里,1765,1046,207,378,585,42,627
公投第１５案,新北市,鶯歌區,鳳福里,1766,1144,236,397,633,56,689
公投第１５案,新北市,鶯歌區,鳳福里,1767,1336,219,367,586,60,646
公投第１５案,新北市,鶯歌區,大湖里,1768,1479,221,438,659,55,714
公投第１５案,新北市,鶯歌區,大湖里,1769,1736,298,542,840,55,895
公投第１５案,新北市,鶯歌區,大湖里,1770,1389,257,500,757,53,810
公投第１５案,新北市,鶯歌區,中湖里,1771,1956,313,664,977,63,1040
公投第１５案,新北市,鶯歌區,中湖里,1772,1371,253,449,702,53,755
公投第１５案,新北市,鶯歌區,中湖里,1773,1810,236,468,704,29,733
公投第１５案,新北市,鶯歌區,東湖里,1774,227,41,79,120,3,123
公投第１５案,新北市,土城區,祖田里,1775,1505,257,486,743,64,807
公投第１５案,新北市,土城區,頂新里,1776,1242,269,451,720,30,750
公投第１５案,新北市,土城區,頂新里,1777,1206,227,458,685,31,716
公投第１５案,新北市,土城區,頂福里,1778,1474,345,398,743,72,815
公投第１５案,新北市,土城區,頂福里,1779,1489,241,485,726,44,770
公投第１５案,新北市,土城區,頂福里,1780,1675,270,545,815,48,863
公投第１５案,新北市,土城區,頂埔里,1781,1499,292,488,780,44,824
公投第１５案,新北市,土城區,頂埔里,1782,1495,230,511,741,36,777
公投第１５案,新北市,土城區,頂埔里,1783,1411,233,466,699,61,760
公投第１５案,新北市,土城區,沛陂里,1784,1378,251,415,666,44,710
公投第１５案,新北市,土城區,沛陂里,1785,1256,237,393,630,34,664
公投第１５案,新北市,土城區,沛陂里,1786,1379,279,486,765,55,820
公投第１５案,新北市,土城區,永寧里,1787,1424,215,477,692,44,736
公投第１５案,新北市,土城區,永寧里,1788,1455,256,474,730,55,785
公投第１５案,新北市,土城區,永寧里,1789,1419,236,471,707,31,738
公投第１５案,新北市,土城區,永寧里,1790,1357,277,488,765,45,810
公投第１５案,新北市,土城區,永寧里,1791,1501,287,475,762,38,800
公投第１５案,新北市,土城區,大安里,1792,1206,227,398,625,69,694
公投第１５案,新北市,土城區,大安里,1793,1255,269,435,704,26,730
公投第１５案,新北市,土城區,大安里,1794,1869,300,611,911,56,967
公投第１５案,新北市,土城區,員仁里,1795,1292,231,450,681,31,712
公投第１５案,新北市,土城區,員仁里,1796,1324,232,417,649,35,684
公投第１５案,新北市,土城區,員仁里,1797,1155,188,380,568,47,615
公投第１５案,新北市,土城區,員仁里,1798,1183,215,393,608,45,653
公投第１５案,新北市,土城區,埤塘里,1799,2518,203,311,514,37,551
公投第１５案,新北市,土城區,埤塘里,1800,1218,223,401,624,39,663
公投第１５案,新北市,土城區,埤塘里,1801,1133,189,399,588,61,649
公投第１５案,新北市,土城區,土城里,1802,894,162,307,469,39,508
公投第１５案,新北市,土城區,土城里,1803,931,200,297,497,49,546
公投第１５案,新北市,土城區,長風里,1804,1820,364,754,1118,37,1155
公投第１５案,新北市,土城區,員信里,1805,1320,229,454,683,26,709
公投第１５案,新北市,土城區,員信里,1806,1241,237,392,629,35,664
公投第１５案,新北市,土城區,員信里,1807,1414,274,465,739,41,780
公投第１５案,新北市,土城區,員林里,1808,1378,287,447,734,50,784
公投第１５案,新北市,土城區,員林里,1809,1421,286,488,774,55,829
公投第１５案,新北市,土城區,員林里,1810,1340,237,455,692,39,731
公投第１５案,新北市,土城區,員林里,1811,1144,243,398,641,38,679
公投第１５案,新北市,土城區,員福里,1812,1268,249,413,662,63,725
公投第１５案,新北市,土城區,員福里,1813,1196,191,429,620,73,693
公投第１５案,新北市,土城區,員福里,1814,1308,270,473,743,36,779
公投第１５案,新北市,土城區,員福里,1815,1175,202,426,628,47,675
公投第１５案,新北市,土城區,日和里,1816,1230,224,429,653,52,705
公投第１５案,新北市,土城區,日和里,1817,1342,258,454,712,61,773
公投第１５案,新北市,土城區,日和里,1818,1268,257,442,699,46,745
公投第１５案,新北市,土城區,日和里,1819,1227,231,485,716,60,776
公投第１５案,新北市,土城區,日新里,1820,1356,235,467,702,77,779
公投第１５案,新北市,土城區,日新里,1821,1496,271,505,776,56,832
公投第１５案,新北市,土城區,日新里,1822,1309,224,453,677,68,745
公投第１５案,新北市,土城區,裕生里,1823,1175,251,399,650,51,701
公投第１５案,新北市,土城區,裕生里,1824,1237,235,405,640,58,698
公投第１５案,新北市,土城區,裕生里,1825,1256,226,448,674,48,722
公投第１５案,新北市,土城區,裕生里,1826,1228,242,399,641,24,665
公投第１５案,新北市,土城區,貨饒里,1827,1182,236,375,611,62,673
公投第１５案,新北市,土城區,貨饒里,1828,1558,311,501,812,43,855
公投第１５案,新北市,土城區,貨饒里,1829,1160,245,376,621,43,664
公投第１５案,新北市,土城區,瑞興里,1830,1357,275,448,723,46,769
公投第１５案,新北市,土城區,瑞興里,1831,1464,278,451,729,73,802
公投第１５案,新北市,土城區,復興里,1832,1335,232,423,655,45,700
公投第１５案,新北市,土城區,復興里,1833,1346,254,434,688,59,747
公投第１５案,新北市,土城區,復興里,1834,1435,321,511,832,36,868
公投第１５案,新北市,土城區,廣福里,1835,1639,318,546,864,41,905
公投第１５案,新北市,土城區,廣福里,1836,1728,365,580,945,42,987
公投第１５案,新北市,土城區,廣福里,1837,1665,288,445,733,28,761
公投第１５案,新北市,土城區,學成里,1838,1333,267,488,755,62,817
公投第１５案,新北市,土城區,學成里,1839,1567,327,542,869,38,907
公投第１５案,新北市,土城區,埤林里,1840,1576,300,506,806,59,865
公投第１５案,新北市,土城區,埤林里,1841,1458,294,484,778,52,830
公投第１５案,新北市,土城區,埤林里,1842,1517,284,502,786,83,869
公投第１５案,新北市,土城區,埤林里,1843,1489,315,536,851,29,880
公投第１５案,新北市,土城區,埤林里,1844,1463,348,503,851,17,868
公投第１５案,新北市,土城區,廣興里,1845,1584,315,547,862,28,890
公投第１５案,新北市,土城區,廣興里,1846,1464,285,475,760,39,799
公投第１５案,新北市,土城區,樂利里,1847,1598,314,526,840,58,898
公投第１５案,新北市,土城區,樂利里,1848,1500,310,428,738,65,803
公投第１５案,新北市,土城區,樂利里,1849,1542,309,499,808,36,844
公投第１５案,新北市,土城區,學府里,1850,1619,346,560,906,47,953
公投第１５案,新北市,土城區,學府里,1851,1521,271,490,761,30,791
公投第１５案,新北市,土城區,明德里,1852,1691,378,521,899,27,926
公投第１５案,新北市,土城區,明德里,1853,1657,332,496,828,56,884
公投第１５案,新北市,土城區,明德里,1854,1772,423,584,1007,26,1033
公投第１５案,新北市,土城區,學士里,1855,1423,290,502,792,15,807
公投第１５案,新北市,土城區,學士里,1856,1321,300,473,773,38,811
公投第１５案,新北市,土城區,學士里,1857,1429,321,502,823,49,872
公投第１５案,新北市,土城區,柑林里,1858,1445,249,489,738,40,778
公投第１５案,新北市,土城區,柑林里,1859,1520,298,555,853,33,886
公投第１５案,新北市,土城區,中正里,1860,1484,255,434,689,14,703
公投第１５案,新北市,土城區,中正里,1861,1362,285,429,714,19,733
公投第１５案,新北市,土城區,青雲里,1862,1262,217,438,655,32,687
公投第１５案,新北市,土城區,青雲里,1863,1343,290,440,730,42,772
公投第１５案,新北市,土城區,清和里,1864,1337,246,374,620,36,656
公投第１５案,新北市,土城區,清和里,1865,1325,199,353,552,40,592
公投第１５案,新北市,土城區,清和里,1866,1390,240,425,665,43,708
公投第１５案,新北市,土城區,清和里,1867,1534,294,479,773,58,831
公投第１５案,新北市,土城區,清化里,1868,1484,262,451,713,75,788
公投第１５案,新北市,土城區,清溪里,1869,1532,256,471,727,69,796
公投第１５案,新北市,土城區,清溪里,1870,1507,270,531,801,51,852
公投第１５案,新北市,土城區,清溪里,1871,1550,301,528,829,40,869
公投第１５案,新北市,土城區,清溪里,1872,1567,273,553,826,38,864
公投第１５案,新北市,土城區,青山里,1873,1367,342,400,742,41,783
公投第１５案,新北市,土城區,青山里,1874,1293,212,433,645,48,693
公投第１５案,新北市,土城區,清水里,1875,1402,265,473,738,51,789
公投第１５案,新北市,土城區,清水里,1876,1379,261,444,705,46,751
公投第１５案,新北市,土城區,清水里,1877,1471,270,459,729,45,774
公投第１５案,新北市,土城區,清水里,1878,1410,235,485,720,35,755
公投第１５案,新北市,土城區,清水里,1879,1542,307,493,800,35,835
公投第１５案,新北市,土城區,永豐里,1880,1238,226,404,630,52,682
公投第１５案,新北市,土城區,永豐里,1881,1301,226,412,638,52,690
公投第１５案,新北市,土城區,永豐里,1882,1311,295,517,812,29,841
公投第１５案,新北市,土城區,永富里,1883,1511,235,481,716,39,755
公投第１５案,新北市,土城區,永富里,1884,1531,269,500,769,50,819
公投第１５案,新北市,土城區,永富里,1885,1638,315,480,795,59,854
公投第１５案,新北市,土城區,廷寮里,1886,1335,244,502,746,45,791
公投第１５案,新北市,土城區,廷寮里,1887,1459,257,507,764,41,805
公投第１５案,新北市,土城區,廷寮里,1888,1489,294,481,775,30,805
公投第１５案,新北市,土城區,金城里,1889,1774,312,619,931,89,1020
公投第１５案,新北市,土城區,金城里,1890,1792,354,586,940,42,982
公投第１５案,新北市,土城區,金城里,1891,1798,285,653,938,60,998
公投第１５案,新北市,土城區,峯廷里,1892,1312,233,410,643,74,717
公投第１５案,新北市,土城區,峯廷里,1893,1301,233,393,626,55,681
公投第１５案,新北市,土城區,峯廷里,1894,1254,229,383,612,53,665
公投第１５案,新北市,土城區,峯廷里,1895,1215,240,382,622,33,655
公投第１５案,新北市,土城區,峯廷里,1896,1448,267,479,746,44,790
公投第１５案,新北市,土城區,延吉里,1897,1321,210,442,652,58,710
公投第１５案,新北市,土城區,延吉里,1898,1150,207,335,542,61,603
公投第１５案,新北市,土城區,延吉里,1899,1425,276,383,659,47,706
公投第１５案,新北市,土城區,延壽里,1900,1366,262,484,746,66,812
公投第１５案,新北市,土城區,延壽里,1901,1292,261,450,711,43,754
公投第１５案,新北市,土城區,延壽里,1902,1317,221,449,670,45,715
公投第１５案,新北市,土城區,延祿里,1903,1324,232,478,710,45,755
公投第１５案,新北市,土城區,延祿里,1904,1189,225,373,598,50,648
公投第１５案,新北市,土城區,延祿里,1905,1223,221,435,656,57,713
公投第１５案,新北市,土城區,平和里,1906,1550,184,589,773,56,829
公投第１５案,新北市,土城區,平和里,1907,1606,328,526,854,67,921
公投第１５案,新北市,土城區,平和里,1908,1509,281,495,776,54,830
公投第１５案,新北市,土城區,平和里,1909,1529,280,488,768,59,827
公投第１５案,新北市,土城區,安和里,1910,1458,240,469,709,60,769
公投第１５案,新北市,土城區,安和里,1911,1468,317,461,778,65,843
公投第１５案,新北市,土城區,安和里,1912,1495,306,452,758,42,800
公投第１５案,新北市,土城區,延和里,1913,1303,235,438,673,72,745
公投第１５案,新北市,土城區,延和里,1914,1365,255,469,724,47,771
公投第１５案,新北市,土城區,延和里,1915,1476,274,482,756,64,820
公投第１５案,新北市,土城區,延和里,1916,1519,293,525,818,33,851
公投第１５案,新北市,三峽區,三峽里,1917,274,58,109,167,20,187
公投第１５案,新北市,三峽區,秀川里,1918,583,105,187,292,30,322
公投第１５案,新北市,三峽區,八張里,1919,1765,271,517,788,20,808
公投第１５案,新北市,三峽區,八張里,1920,1714,317,548,865,42,907
公投第１５案,新北市,三峽區,中埔里,1921,1355,227,440,667,29,696
公投第１５案,新北市,三峽區,中埔里,1922,1329,248,461,709,45,754
公投第１５案,新北市,三峽區,弘道里,1923,1059,176,330,506,59,565
公投第１５案,新北市,三峽區,永舘里,1924,1364,289,450,739,47,786
公投第１５案,新北市,三峽區,永舘里,1925,1098,240,360,600,46,646
公投第１５案,新北市,三峽區,永舘里,1926,1296,251,417,668,45,713
公投第１５案,新北市,三峽區,永舘里,1927,1240,223,404,627,43,670
公投第１５案,新北市,三峽區,永舘里,1928,1531,317,459,776,38,814
公投第１５案,新北市,三峽區,鳶山里,1929,1444,233,454,687,26,713
公投第１５案,新北市,三峽區,鳶山里,1930,1347,232,425,657,71,728
公投第１５案,新北市,三峽區,鳶山里,1931,1455,254,490,744,44,788
公投第１５案,新北市,三峽區,鳶山里,1932,1556,249,457,706,35,741
公投第１５案,新北市,三峽區,鳶山里,1933,1390,225,367,592,26,618
公投第１５案,新北市,三峽區,鳶山里,1934,1532,283,496,779,42,821
公投第１５案,新北市,三峽區,龍埔里,1935,1377,206,413,619,55,674
公投第１５案,新北市,三峽區,龍埔里,1936,1731,302,556,858,41,899
公投第１５案,新北市,三峽區,龍埔里,1937,1705,284,547,831,31,862
公投第１５案,新北市,三峽區,龍埔里,1938,1590,328,517,845,34,879
公投第１５案,新北市,三峽區,龍埔里,1939,1650,302,610,912,31,943
公投第１５案,新北市,三峽區,龍恩里,1940,1441,269,504,773,25,798
公投第１５案,新北市,三峽區,龍恩里,1941,1404,267,521,788,24,812
公投第１５案,新北市,三峽區,龍恩里,1942,1295,278,463,741,32,773
公投第１５案,新北市,三峽區,龍恩里,1943,1348,228,356,584,27,611
公投第１５案,新北市,三峽區,龍學里,1944,1579,282,572,854,21,875
公投第１５案,新北市,三峽區,龍學里,1945,1435,245,502,747,23,770
公投第１５案,新北市,三峽區,龍學里,1946,1659,292,650,942,27,969
公投第１５案,新北市,三峽區,龍學里,1947,1512,345,552,897,23,920
公投第１５案,新北市,三峽區,龍學里,1948,1463,267,553,820,28,848
公投第１５案,新北市,三峽區,龍學里,1949,1465,310,541,851,12,863
公投第１５案,新北市,三峽區,龍學里,1950,1463,272,574,846,11,857
公投第１５案,新北市,三峽區,龍學里,1951,1443,275,534,809,27,836
公投第１５案,新北市,三峽區,礁溪里,1952,1634,281,512,793,37,830
公投第１５案,新北市,三峽區,礁溪里,1953,1716,292,586,878,51,929
公投第１５案,新北市,三峽區,礁溪里,1954,1675,282,553,835,32,867
公投第１５案,新北市,三峽區,安溪里,1955,1649,246,449,695,48,743
公投第１５案,新北市,三峽區,安溪里,1956,1489,257,482,739,50,789
公投第１５案,新北市,三峽區,安溪里,1957,1771,312,512,824,46,870
公投第１５案,新北市,三峽區,安溪里,1958,1726,366,554,920,28,948
公投第１５案,新北市,三峽區,介壽里,1959,1363,218,461,679,51,730
公投第１５案,新北市,三峽區,介壽里,1960,1624,314,523,837,36,873
公投第１５案,新北市,三峽區,介壽里,1961,1352,260,449,709,47,756
公投第１５案,新北市,三峽區,介壽里,1962,1608,234,401,635,16,651
公投第１５案,新北市,三峽區,中正里,1963,1458,255,480,735,50,785
公投第１５案,新北市,三峽區,中正里,1964,1641,278,479,757,42,799
公投第１５案,新北市,三峽區,中正里,1965,1530,257,451,708,103,811
公投第１５案,新北市,三峽區,大埔里,1966,1389,185,388,573,62,635
公投第１５案,新北市,三峽區,大埔里,1967,1315,216,384,600,66,666
公投第１５案,新北市,三峽區,大埔里,1968,934,136,393,529,39,568
公投第１５案,新北市,三峽區,嘉添里,1969,1270,202,382,584,28,612
公投第１５案,新北市,三峽區,嘉添里,1970,929,144,286,430,28,458
公投第１５案,新北市,三峽區,添福里,1971,1035,163,358,521,16,537
公投第１５案,新北市,三峽區,金圳里,1972,502,79,151,230,13,243
公投第１５案,新北市,三峽區,五寮里,1973,836,98,266,364,49,413
公投第１５案,新北市,三峽區,插角里,1974,669,85,190,275,54,329
公投第１５案,新北市,三峽區,有木里,1975,733,119,258,377,63,440
公投第１５案,新北市,三峽區,二鬮里,1976,1560,268,611,879,55,934
公投第１５案,新北市,三峽區,二鬮里,1977,1638,263,536,799,49,848
公投第１５案,新北市,三峽區,溪南里,1978,1394,188,497,685,31,716
公投第１５案,新北市,三峽區,溪北里,1979,771,143,266,409,36,445
公投第１５案,新北市,三峽區,溪北里,1980,1367,230,442,672,23,695
公投第１５案,新北市,三峽區,溪東里,1981,1241,183,409,592,55,647
公投第１５案,新北市,三峽區,溪東里,1982,1520,240,445,685,48,733
公投第１５案,新北市,三峽區,成福里,1983,873,142,378,520,37,557
公投第１５案,新北市,三峽區,竹崙里,1984,768,105,179,284,90,374
公投第１５案,新北市,三峽區,竹崙里,1985,1097,155,331,486,32,518
公投第１５案,新北市,三峽區,安坑里,1986,1322,166,349,515,66,581
公投第１５案,新北市,新店區,新店里,1987,1603,306,546,852,47,899
公投第１５案,新北市,新店區,張南里,1988,1921,272,665,937,47,984
公投第１５案,新北市,新店區,國校里,1989,1082,193,378,571,24,595
公投第１５案,新北市,新店區,國校里,1990,1235,251,433,684,35,719
公投第１５案,新北市,新店區,文中里,1991,1568,283,602,885,31,916
公投第１５案,新北市,新店區,廣明里,1992,771,180,251,431,33,464
公投第１５案,新北市,新店區,文明里,1993,1256,283,400,683,34,717
公投第１５案,新北市,新店區,文明里,1994,1008,196,360,556,48,604
公投第１５案,新北市,新店區,中興里,1995,1515,284,570,854,43,897
公投第１５案,新北市,新店區,中興里,1996,1637,308,663,971,38,1009
公投第１５案,新北市,新店區,中興里,1997,1549,330,538,868,36,904
公投第１５案,新北市,新店區,新生里,1998,2011,402,812,1214,50,1264
公投第１５案,新北市,新店區,新生里,1999,1554,285,559,844,62,906
公投第１５案,新北市,新店區,新生里,2000,1770,337,603,940,49,989
公投第１５案,新北市,新店區,新德里,2001,1316,265,464,729,53,782
公投第１５案,新北市,新店區,新德里,2002,1126,193,408,601,43,644
公投第１５案,新北市,新店區,張北里,2003,1460,261,501,762,40,802
公投第１５案,新北市,新店區,張北里,2004,1584,310,594,904,45,949
公投第１５案,新北市,新店區,張北里,2005,1449,278,513,791,41,832
公投第１５案,新北市,新店區,張北里,2006,1520,287,632,919,35,954
公投第１５案,新北市,新店區,張北里,2007,1821,334,710,1044,26,1070
公投第１５案,新北市,新店區,五峯里,2008,1956,398,684,1082,42,1124
公投第１５案,新北市,新店區,五峯里,2009,1665,331,599,930,49,979
公投第１５案,新北市,新店區,五峯里,2010,1588,183,768,951,16,967
公投第１５案,新北市,新店區,五峯里,2011,1519,321,516,837,12,849
公投第１５案,新北市,新店區,長春里,2012,1185,284,440,724,26,750
公投第１５案,新北市,新店區,長春里,2013,1095,264,410,674,22,696
公投第１５案,新北市,新店區,新安里,2014,1106,207,442,649,46,695
公投第１５案,新北市,新店區,新安里,2015,2700,150,242,392,18,410
公投第１５案,新北市,新店區,新安里,2016,995,195,396,591,19,610
公投第１５案,新北市,新店區,新安里,2017,1168,218,423,641,36,677
公投第１５案,新北市,新店區,忠誠里,2018,1123,238,484,722,41,763
公投第１５案,新北市,新店區,忠誠里,2019,1085,251,426,677,30,707
公投第１５案,新北市,新店區,中正里,2020,1412,300,540,840,46,886
公投第１５案,新北市,新店區,中正里,2021,1659,315,626,941,45,986
公投第１５案,新北市,新店區,中正里,2022,1198,230,495,725,38,763
公投第１５案,新北市,新店區,中正里,2023,1376,227,485,712,34,746
公投第１５案,新北市,新店區,中華里,2024,1300,224,466,690,30,720
公投第１５案,新北市,新店區,中華里,2025,1238,208,487,695,28,723
公投第１５案,新北市,新店區,中華里,2026,1388,237,489,726,26,752
公投第１５案,新北市,新店區,仁愛里,2027,933,193,357,550,38,588
公投第１５案,新北市,新店區,仁愛里,2028,908,187,377,564,20,584
公投第１５案,新北市,新店區,建國里,2029,1582,272,594,866,46,912
公投第１５案,新北市,新店區,建國里,2030,1247,248,483,731,49,780
公投第１５案,新北市,新店區,百忍里,2031,971,192,379,571,34,605
公投第１５案,新北市,新店區,百忍里,2032,1145,228,440,668,41,709
公投第１５案,新北市,新店區,百忍里,2033,1392,268,522,790,46,836
公投第１５案,新北市,新店區,百和里,2034,1452,266,599,865,52,917
公投第１５案,新北市,新店區,百和里,2035,1440,267,525,792,46,838
公投第１５案,新北市,新店區,福德里,2036,1786,341,613,954,57,1011
公投第１５案,新北市,新店區,福德里,2037,1825,349,667,1016,51,1067
公投第１５案,新北市,新店區,百福里,2038,1477,284,586,870,28,898
公投第１５案,新北市,新店區,百福里,2039,1750,372,616,988,43,1031
公投第１５案,新北市,新店區,福民里,2040,1792,272,710,982,39,1021
公投第１５案,新北市,新店區,福民里,2041,1979,334,756,1090,35,1125
公投第１５案,新北市,新店區,中山里,2042,826,158,321,479,27,506
公投第１５案,新北市,新店區,中山里,2043,1924,335,762,1097,45,1142
公投第１５案,新北市,新店區,中山里,2044,1383,277,579,856,18,874
公投第１５案,新北市,新店區,和平里,2045,830,137,261,398,31,429
公投第１５案,新北市,新店區,中央里,2046,1759,354,671,1025,39,1064
公投第１５案,新北市,新店區,中央里,2047,1957,387,755,1142,44,1186
公投第１５案,新北市,新店區,中央里,2048,1481,309,570,879,27,906
公投第１５案,新北市,新店區,國豐里,2049,1552,326,543,869,50,919
公投第１５案,新北市,新店區,國豐里,2050,1467,280,514,794,54,848
公投第１５案,新北市,新店區,明德里,2051,1371,258,503,761,38,799
公投第１５案,新北市,新店區,明德里,2052,991,199,372,571,30,601
公投第１５案,新北市,新店區,明德里,2053,1231,258,452,710,42,752
公投第１５案,新北市,新店區,大豐里,2054,1701,336,607,943,52,995
公投第１５案,新北市,新店區,大豐里,2055,1707,340,605,945,52,997
公投第１５案,新北市,新店區,大同里,2056,1773,329,639,968,36,1004
公投第１５案,新北市,新店區,大同里,2057,1866,325,634,959,32,991
公投第１５案,新北市,新店區,江陵里,2058,1735,363,637,1000,33,1033
公投第１５案,新北市,新店區,江陵里,2059,1632,370,649,1019,31,1050
公投第１５案,新北市,新店區,江陵里,2060,1591,325,576,901,46,947
公投第１５案,新北市,新店區,復興里,2061,1495,245,500,745,68,813
公投第１５案,新北市,新店區,復興里,2062,1511,232,531,763,22,785
公投第１５案,新北市,新店區,寶興里,2063,1260,241,443,684,52,736
公投第１５案,新北市,新店區,寶興里,2064,1948,367,759,1126,40,1166
公投第１５案,新北市,新店區,寶興里,2065,1582,320,626,946,39,985
公投第１５案,新北市,新店區,寶福里,2066,1315,257,474,731,35,766
公投第１５案,新北市,新店區,寶福里,2067,1562,301,517,818,48,866
公投第１５案,新北市,新店區,寶福里,2068,1982,410,752,1162,21,1183
公投第１５案,新北市,新店區,寶福里,2069,1518,295,558,853,50,903
公投第１５案,新北市,新店區,寶安里,2070,1735,328,623,951,31,982
公投第１５案,新北市,新店區,寶安里,2071,1716,293,622,915,39,954
公投第１５案,新北市,新店區,寶安里,2072,1580,324,565,889,37,926
公投第１５案,新北市,新店區,信義里,2073,1358,311,499,810,41,851
公投第１５案,新北市,新店區,信義里,2074,1610,346,591,937,65,1002
公投第１５案,新北市,新店區,信義里,2075,1383,257,490,747,37,784
公投第１５案,新北市,新店區,信義里,2076,1596,303,597,900,34,934
公投第１５案,新北市,新店區,忠孝里,2077,1360,224,465,689,38,727
公投第１５案,新北市,新店區,忠孝里,2078,1160,168,431,599,13,612
公投第１５案,新北市,新店區,大鵬里,2079,1236,192,594,786,34,820
公投第１５案,新北市,新店區,大鵬里,2080,1234,260,521,781,17,798
公投第１５案,新北市,新店區,太平里,2081,1579,292,548,840,76,916
公投第１５案,新北市,新店區,太平里,2082,1241,207,463,670,41,711
公投第１５案,新北市,新店區,美城里,2083,1275,239,455,694,28,722
公投第１５案,新北市,新店區,美城里,2084,1214,192,420,612,33,645
公投第１５案,新北市,新店區,頂城里,2085,1578,252,466,718,72,790
公投第１５案,新北市,新店區,下城里,2086,1442,292,464,756,39,795
公投第１５案,新北市,新店區,下城里,2087,1475,230,475,705,67,772
公投第１５案,新北市,新店區,柴埕里,2088,1580,301,586,887,45,932
公投第１５案,新北市,新店區,柴埕里,2089,1585,224,630,854,28,882
公投第１５案,新北市,新店區,柴埕里,2090,1586,301,534,835,58,893
公投第１５案,新北市,新店區,柴埕里,2091,1931,358,664,1022,55,1077
公投第１５案,新北市,新店區,柴埕里,2092,1239,218,440,658,25,683
公投第１５案,新北市,新店區,安和里,2093,1892,320,681,1001,48,1049
公投第１５案,新北市,新店區,安和里,2094,1529,231,521,752,56,808
公投第１５案,新北市,新店區,安和里,2095,1358,228,523,751,41,792
公投第１５案,新北市,新店區,安和里,2096,1905,347,608,955,42,997
公投第１５案,新北市,新店區,永安里,2097,1885,318,595,913,102,1015
公投第１５案,新北市,新店區,永安里,2098,1345,213,463,676,59,735
公投第１５案,新北市,新店區,永安里,2099,1387,230,520,750,51,801
公投第１５案,新北市,新店區,新和里,2100,1960,354,681,1035,43,1078
公投第１５案,新北市,新店區,新和里,2101,1837,332,632,964,67,1031
公投第１５案,新北市,新店區,永平里,2102,1662,326,581,907,41,948
公投第１５案,新北市,新店區,永平里,2103,1617,337,603,940,55,995
公投第１５案,新北市,新店區,永平里,2104,1704,324,620,944,34,978
公投第１５案,新北市,新店區,公崙里,2105,1835,313,619,932,59,991
公投第１５案,新北市,新店區,公崙里,2106,2009,339,686,1025,58,1083
公投第１５案,新北市,新店區,公崙里,2107,1450,240,519,759,53,812
公投第１５案,新北市,新店區,公崙里,2108,1726,316,608,924,37,961
公投第１５案,新北市,新店區,公崙里,2109,1797,332,591,923,53,976
公投第１５案,新北市,新店區,公崙里,2110,1739,313,622,935,37,972
公投第１５案,新北市,新店區,安昌里,2111,1523,252,579,831,28,859
公投第１５案,新北市,新店區,安昌里,2112,1642,297,578,875,21,896
公投第１５案,新北市,新店區,安昌里,2113,1644,335,573,908,19,927
公投第１５案,新北市,新店區,德安里,2114,1662,284,536,820,38,858
公投第１５案,新北市,新店區,德安里,2115,2067,410,713,1123,60,1183
公投第１５案,新北市,新店區,德安里,2116,1870,300,522,822,48,870
公投第１５案,新北市,新店區,達觀里,2117,1982,364,691,1055,26,1081
公投第１５案,新北市,新店區,達觀里,2118,1546,292,549,841,32,873
公投第１５案,新北市,新店區,明城里,2119,1712,322,679,1001,33,1034
公投第１５案,新北市,新店區,明城里,2120,1423,298,562,860,23,883
公投第１５案,新北市,新店區,小城里,2121,1666,360,594,954,55,1009
公投第１５案,新北市,新店區,小城里,2122,1769,339,721,1060,38,1098
公投第１５案,新北市,新店區,雙城里,2123,1079,177,331,508,36,544
公投第１５案,新北市,新店區,雙城里,2124,1140,198,400,598,21,619
公投第１５案,新北市,新店區,雙城里,2125,1825,321,630,951,52,1003
公投第１５案,新北市,新店區,雙城里,2126,1178,241,432,673,42,715
公投第１５案,新北市,新店區,香坡里,2127,1463,264,502,766,31,797
公投第１５案,新北市,新店區,香坡里,2128,1152,214,416,630,37,667
公投第１５案,新北市,新店區,香坡里,2129,2008,298,608,906,36,942
公投第１５案,新北市,新店區,香坡里,2130,2120,315,611,926,43,969
公投第１５案,新北市,新店區,香坡里,2131,1153,241,442,683,10,693
公投第１５案,新北市,新店區,香坡里,2132,1573,262,550,812,21,833
公投第１５案,新北市,新店區,日興里,2133,1992,287,616,903,69,972
公投第１５案,新北市,新店區,日興里,2134,1668,255,509,764,53,817
公投第１５案,新北市,新店區,日興里,2135,1617,254,508,762,38,800
公投第１５案,新北市,新店區,玫瑰里,2136,2013,343,657,1000,78,1078
公投第１５案,新北市,新店區,玫瑰里,2137,1791,350,658,1008,36,1044
公投第１５案,新北市,新店區,玫瑰里,2138,1624,288,597,885,43,928
公投第１５案,新北市,新店區,吉祥里,2139,1178,208,468,676,40,716
公投第１５案,新北市,新店區,吉祥里,2140,1277,242,488,730,24,754
公投第１５案,新北市,新店區,吉祥里,2141,1879,342,689,1031,32,1063
公投第１５案,新北市,新店區,塗潭里,2142,939,125,288,413,38,451
公投第１５案,新北市,新店區,華城里,2143,960,196,331,527,20,547
公投第１５案,新北市,新店區,華城里,2144,1434,241,547,788,91,879
公投第１５案,新北市,新店區,青潭里,2145,1838,306,592,898,51,949
公投第１５案,新北市,新店區,青潭里,2146,1453,272,505,777,39,816
公投第１５案,新北市,新店區,青潭里,2147,1549,263,521,784,47,831
公投第１５案,新北市,新店區,美潭里,2148,1860,354,687,1041,40,1081
公投第１５案,新北市,新店區,美潭里,2149,1743,277,594,871,37,908
公投第１５案,新北市,新店區,美潭里,2150,1122,240,469,709,28,737
公投第１５案,新北市,新店區,員潭里,2151,1468,215,562,777,38,815
公投第１５案,新北市,新店區,員潭里,2152,1763,340,580,920,32,952
公投第１５案,新北市,新店區,員潭里,2153,1344,253,423,676,29,705
公投第１５案,新北市,新店區,雙坑里,2154,753,90,275,365,43,408
公投第１５案,新北市,新店區,粗坑里,2155,602,137,185,322,11,333
公投第１５案,新北市,新店區,粗坑里,2156,2237,466,663,1129,46,1175
公投第１５案,新北市,新店區,屈尺里,2157,1096,203,374,577,32,609
公投第１５案,新北市,新店區,屈尺里,2158,1143,173,333,506,33,539
公投第１５案,新北市,新店區,龜山里,2159,1569,261,483,744,75,819
公投第１５案,新北市,新店區,廣興里,2160,1284,211,344,555,60,615
公投第１５案,新北市,新店區,直潭里,2161,439,53,91,144,12,156
公投第１５案,新北市,新店區,直潭里,2162,750,165,240,405,30,435
公投第１５案,新北市,深坑區,萬順里,2163,1142,203,373,576,28,604
公投第１５案,新北市,深坑區,萬順里,2164,1139,214,417,631,39,670
公投第１５案,新北市,深坑區,萬福里,2165,1065,188,347,535,41,576
公投第１５案,新北市,深坑區,萬福里,2166,1400,249,424,673,42,715
公投第１５案,新北市,深坑區,土庫里,2167,1330,242,414,656,37,693
公投第１５案,新北市,深坑區,土庫里,2168,1380,237,431,668,38,706
公投第１５案,新北市,深坑區,深坑里,2169,1496,258,434,692,9,701
公投第１５案,新北市,深坑區,深坑里,2170,1508,293,525,818,51,869
公投第１５案,新北市,深坑區,埔新里,2171,1624,343,527,870,62,932
公投第１５案,新北市,深坑區,埔新里,2172,2165,377,747,1124,49,1173
公投第１５案,新北市,深坑區,埔新里,2173,1790,364,639,1003,60,1063
公投第１５案,新北市,深坑區,昇高里,2174,782,133,234,367,32,399
公投第１５案,新北市,深坑區,昇高里,2175,1164,236,421,657,23,680
公投第１５案,新北市,深坑區,賴仲里,2176,1344,270,477,747,57,804
公投第１５案,新北市,深坑區,賴仲里,2177,739,147,278,425,30,455
公投第１５案,新北市,深坑區,阿柔里,2178,556,107,206,313,27,340
公投第１５案,新北市,石碇區,石碇里,2179,391,90,132,222,21,243
公投第１５案,新北市,石碇區,潭邊里,2180,789,108,258,366,39,405
公投第１５案,新北市,石碇區,烏塗里,2181,662,76,179,255,24,279
公投第１５案,新北市,石碇區,彭山里,2182,310,48,103,151,10,161
公投第１５案,新北市,石碇區,豐田里,2183,280,43,93,136,12,148
公投第１５案,新北市,石碇區,豐田里,2184,93,10,22,32,6,38
公投第１５案,新北市,石碇區,隆盛里,2185,683,111,160,271,32,303
公投第１５案,新北市,石碇區,豐林里,2186,323,68,131,199,8,207
公投第１５案,新北市,石碇區,中民里,2187,726,83,189,272,14,286
公投第１５案,新北市,石碇區,永定里,2188,591,95,201,296,20,316
公投第１５案,新北市,石碇區,光明里,2189,282,61,95,156,34,190
公投第１５案,新北市,石碇區,永安里,2190,788,105,213,318,21,339
公投第１５案,新北市,石碇區,格頭里,2191,943,196,306,502,52,554
公投第１５案,新北市,坪林區,坪林里,2192,1248,211,429,640,33,673
公投第１５案,新北市,坪林區,水德里,2193,612,83,167,250,42,292
公投第１５案,新北市,坪林區,大林里,2194,1141,182,392,574,80,654
公投第１５案,新北市,坪林區,石𥕢里,2195,417,65,104,169,7,176
公投第１５案,新北市,坪林區,粗窟里,2196,595,99,191,290,41,331
公投第１５案,新北市,坪林區,粗窟里,2197,248,42,87,129,26,155
公投第１５案,新北市,坪林區,上德里,2198,338,54,105,159,10,169
公投第１５案,新北市,坪林區,上德里,2199,478,59,125,184,22,206
公投第１５案,新北市,坪林區,漁光里,2200,390,52,99,151,9,160
公投第１５案,新北市,坪林區,漁光里,2201,424,51,130,181,21,202
公投第１５案,新北市,烏來區,忠治里,2202,1568,301,609,910,36,946
公投第１５案,新北市,烏來區,烏來里,2203,1198,187,406,593,10,603
公投第１５案,新北市,烏來區,烏來里,2204,1169,160,412,572,19,591
公投第１５案,新北市,烏來區,孝義里,2205,228,35,88,123,1,124
公投第１５案,新北市,烏來區,信賢里,2206,486,66,184,250,20,270
公投第１５案,新北市,烏來區,福山里,2207,615,83,220,303,19,322
公投第１５案,新北市,平溪區,薯榔里,2208,384,45,120,165,31,196
公投第１５案,新北市,平溪區,菁桐里,2209,232,29,69,98,3,101
公投第１５案,新北市,平溪區,白石里,2210,249,37,91,128,12,140
公投第１５案,新北市,平溪區,石底里,2211,458,82,126,208,44,252
公投第１５案,新北市,平溪區,平溪里,2212,232,29,80,109,18,127
公投第１５案,新北市,平溪區,嶺腳里,2213,635,82,165,247,17,264
公投第１５案,新北市,平溪區,東勢里,2214,427,55,157,212,35,247
公投第１５案,新北市,平溪區,十分里,2215,862,110,217,327,40,367
公投第１５案,新北市,平溪區,望古里,2216,147,21,50,71,2,73
公投第１５案,新北市,平溪區,南山里,2217,365,24,101,125,13,138
公投第１５案,新北市,平溪區,新寮里,2218,153,14,42,56,7,63
公投第１５案,新北市,平溪區,平湖里,2219,177,19,79,98,11,109
公投第１５案,新北市,瑞芳區,龍潭里,2220,725,125,264,389,31,420
公投第１５案,新北市,瑞芳區,龍興里,2221,1074,204,368,572,37,609
公投第１５案,新北市,瑞芳區,龍興里,2222,825,136,273,409,19,428
公投第１５案,新北市,瑞芳區,龍鎮里,2223,1242,230,397,627,33,660
公投第１５案,新北市,瑞芳區,龍安里,2224,598,89,216,305,26,331
公投第１５案,新北市,瑞芳區,龍川里,2225,872,152,287,439,30,469
公投第１５案,新北市,瑞芳區,龍川里,2226,760,114,220,334,32,366
公投第１５案,新北市,瑞芳區,龍山里,2227,1330,224,356,580,45,625
公投第１５案,新北市,瑞芳區,爪峯里,2228,1683,249,490,739,48,787
公投第１５案,新北市,瑞芳區,爪峯里,2229,980,159,310,469,48,517
公投第１５案,新北市,瑞芳區,爪峯里,2230,946,141,317,458,43,501
公投第１５案,新北市,瑞芳區,新峰里,2231,1375,189,407,596,30,626
公投第１５案,新北市,瑞芳區,新峰里,2232,1671,245,538,783,40,823
公投第１５案,新北市,瑞芳區,東和里,2233,978,132,279,411,25,436
公投第１５案,新北市,瑞芳區,東和里,2234,645,92,192,284,30,314
公投第１５案,新北市,瑞芳區,柑坪里,2235,1089,181,323,504,55,559
公投第１５案,新北市,瑞芳區,弓橋里,2236,286,42,65,107,17,124
公投第１５案,新北市,瑞芳區,猴硐里,2237,461,70,147,217,28,245
公投第１５案,新北市,瑞芳區,光復里,2238,274,38,77,115,22,137
公投第１５案,新北市,瑞芳區,碩仁里,2239,155,34,54,88,7,95
公投第１５案,新北市,瑞芳區,吉慶里,2240,817,174,243,417,33,450
公投第１５案,新北市,瑞芳區,吉慶里,2241,884,160,246,406,64,470
公投第１５案,新北市,瑞芳區,吉安里,2242,1333,222,355,577,41,618
公投第１５案,新北市,瑞芳區,吉安里,2243,607,96,150,246,8,254
公投第１５案,新北市,瑞芳區,吉安里,2244,1045,170,344,514,37,551
公投第１５案,新北市,瑞芳區,上天里,2245,673,113,217,330,38,368
公投第１５案,新北市,瑞芳區,上天里,2246,618,77,153,230,9,239
公投第１５案,新北市,瑞芳區,傑魚里,2247,1063,165,292,457,39,496
公投第１５案,新北市,瑞芳區,傑魚里,2248,860,136,287,423,44,467
公投第１５案,新北市,瑞芳區,基山里,2249,432,47,86,133,3,136
公投第１５案,新北市,瑞芳區,永慶里,2250,445,46,117,163,9,172
公投第１５案,新北市,瑞芳區,崇文里,2251,318,34,95,129,9,138
公投第１５案,新北市,瑞芳區,福住里,2252,159,13,57,70,7,77
公投第１５案,新北市,瑞芳區,頌德里,2253,337,41,95,136,11,147
公投第１５案,新北市,瑞芳區,瓜山里,2254,180,31,61,92,7,99
公投第１５案,新北市,瑞芳區,銅山里,2255,187,21,45,66,15,81
公投第１５案,新北市,瑞芳區,新山里,2256,369,55,123,178,12,190
公投第１５案,新北市,瑞芳區,石山里,2257,335,54,112,166,20,186
公投第１５案,新北市,瑞芳區,濓洞里,2258,470,58,128,186,18,204
公投第１５案,新北市,瑞芳區,濓新里,2259,297,36,74,110,8,118
公投第１５案,新北市,瑞芳區,南雅里,2260,267,48,125,173,3,176
公投第１５案,新北市,瑞芳區,鼻頭里,2261,876,51,175,226,15,241
公投第１５案,新北市,瑞芳區,海濱里,2262,1241,112,336,448,21,469
公投第１５案,新北市,瑞芳區,瑞濱里,2263,998,149,319,468,65,533
公投第１５案,新北市,瑞芳區,瑞濱里,2264,948,136,312,448,53,501
公投第１５案,新北市,瑞芳區,深澳里,2265,1308,144,338,482,30,512
公投第１５案,新北市,雙溪區,雙溪里,2266,455,54,141,195,20,215
公投第１５案,新北市,雙溪區,新基里,2267,286,38,95,133,15,148
公投第１５案,新北市,雙溪區,新基里,2268,496,73,176,249,25,274
公投第１５案,新北市,雙溪區,三港里,2269,383,45,109,154,12,166
公投第１５案,新北市,雙溪區,牡丹里,2270,887,97,238,335,43,378
公投第１５案,新北市,雙溪區,牡丹里,2271,652,77,177,254,24,278
公投第１５案,新北市,雙溪區,三貂里,2272,333,46,113,159,10,169
公投第１５案,新北市,雙溪區,平林里,2273,642,84,208,292,29,321
公投第１５案,新北市,雙溪區,平林里,2274,282,46,74,120,17,137
公投第１５案,新北市,雙溪區,上林里,2275,621,77,167,244,27,271
公投第１５案,新北市,雙溪區,外柑里,2276,422,55,107,162,10,172
公投第１５案,新北市,雙溪區,長源里,2277,369,33,79,112,25,137
公投第１５案,新北市,雙溪區,共和里,2278,120,18,40,58,7,65
公投第１５案,新北市,雙溪區,共和里,2279,271,34,82,116,18,134
公投第１５案,新北市,雙溪區,魚行里,2280,362,52,133,185,28,213
公投第１５案,新北市,雙溪區,魚行里,2281,371,59,114,173,20,193
公投第１５案,新北市,雙溪區,泰平里,2282,1047,149,419,568,44,612
公投第１５案,新北市,貢寮區,貢寮里,2283,876,126,253,379,55,434
公投第１５案,新北市,貢寮區,龍崗里,2284,433,74,123,197,20,217
公投第１５案,新北市,貢寮區,吉林里,2285,516,73,139,212,14,226
公投第１５案,新北市,貢寮區,雙玉里,2286,373,46,84,130,23,153
公投第１５案,新北市,貢寮區,雙玉里,2287,313,36,79,115,34,149
公投第１５案,新北市,貢寮區,福連里,2288,485,63,164,227,14,241
公投第１５案,新北市,貢寮區,福連里,2289,415,61,121,182,29,211
公投第１５案,新北市,貢寮區,福隆里,2290,812,88,224,312,26,338
公投第１５案,新北市,貢寮區,福隆里,2291,861,118,252,370,46,416
公投第１５案,新北市,貢寮區,龍門里,2292,676,85,149,234,32,266
公投第１５案,新北市,貢寮區,真理里,2293,1091,132,242,374,31,405
公投第１５案,新北市,貢寮區,真理里,2294,955,98,240,338,55,393
公投第１５案,新北市,貢寮區,仁里里,2295,769,93,202,295,7,302
公投第１５案,新北市,貢寮區,仁里里,2296,962,151,277,428,35,463
公投第１５案,新北市,貢寮區,美豐里,2297,390,44,159,203,11,214
公投第１５案,新北市,貢寮區,美豐里,2298,349,33,111,144,10,154
公投第１５案,新北市,貢寮區,和美里,2299,508,49,124,173,30,203
公投第１５案,新北市,貢寮區,和美里,2300,495,48,106,154,10,164
公投第１５案,新北市,金山區,和平里,2301,481,69,164,233,29,262
公投第１５案,新北市,金山區,大同里,2302,715,106,236,342,39,381
公投第１５案,新北市,金山區,豐漁里,2303,481,58,136,194,21,215
公投第１５案,新北市,金山區,磺港里,2304,1792,200,566,766,69,835
公投第１５案,新北市,金山區,美田里,2305,1781,277,553,830,82,912
公投第１５案,新北市,金山區,美田里,2306,2010,748,248,996,85,1081
公投第１５案,新北市,金山區,金美里,2307,1572,221,474,695,64,759
公投第１５案,新北市,金山區,金美里,2308,1777,382,450,832,81,913
公投第１５案,新北市,金山區,金美里,2309,1631,228,493,721,58,779
公投第１５案,新北市,金山區,五湖里,2310,828,139,264,403,33,436
公投第１５案,新北市,金山區,五湖里,2311,888,148,281,429,40,469
公投第１５案,新北市,金山區,重和里,2312,1211,188,366,554,58,612
公投第１５案,新北市,金山區,兩湖里,2313,416,62,154,216,23,239
公投第１５案,新北市,金山區,六股里,2314,682,122,228,350,48,398
公投第１５案,新北市,金山區,三界里,2315,644,90,209,299,50,349
公投第１５案,新北市,金山區,清泉里,2316,830,89,278,367,42,409
公投第１５案,新北市,金山區,西湖里,2317,188,27,62,89,11,100
公投第１５案,新北市,金山區,萬壽里,2318,469,63,172,235,26,261
公投第１５案,新北市,金山區,永興里,2319,582,54,132,186,31,217
公投第１５案,新北市,萬里區,萬里里,2320,1286,192,450,642,53,695
公投第１５案,新北市,萬里區,萬里里,2321,1576,263,535,798,61,859
公投第１５案,新北市,萬里區,萬里里,2322,1447,203,460,663,38,701
公投第１５案,新北市,萬里區,北基里,2323,1466,182,425,607,64,671
公投第１５案,新北市,萬里區,北基里,2324,1369,162,380,542,52,594
公投第１５案,新北市,萬里區,龜吼里,2325,1215,137,292,429,47,476
公投第１５案,新北市,萬里區,龜吼里,2326,1317,171,467,638,54,692
公投第１５案,新北市,萬里區,野柳里,2327,1676,186,389,575,152,727
公投第１５案,新北市,萬里區,野柳里,2328,1550,198,461,659,79,738
公投第１５案,新北市,萬里區,大鵬里,2329,945,170,356,526,59,585
公投第１５案,新北市,萬里區,大鵬里,2330,1760,256,620,876,85,961
公投第１５案,新北市,萬里區,磺潭里,2331,570,59,203,262,24,286
公投第１５案,新北市,萬里區,雙興里,2332,952,145,292,437,28,465
公投第１５案,新北市,萬里區,溪底里,2333,674,78,257,335,59,394
公投第１５案,新北市,萬里區,崁脚里,2334,405,64,128,192,20,212
公投第１５案,新北市,萬里區,中幅里,2335,1089,143,357,500,51,551
公投第１５案,新北市,汐止區,仁德里,2336,1595,296,500,796,62,858
公投第１５案,新北市,汐止區,義民里,2337,1262,248,416,664,42,706
公投第１５案,新北市,汐止區,禮門里,2338,917,191,300,491,50,541
公投第１５案,新北市,汐止區,智慧里,2339,1929,383,657,1040,35,1075
公投第１５案,新北市,汐止區,智慧里,2340,2227,437,697,1134,58,1192
公投第１５案,新北市,汐止區,大同里,2341,1143,234,362,596,46,642
公投第１５案,新北市,汐止區,大同里,2342,1367,277,509,786,29,815
公投第１５案,新北市,汐止區,信望里,2343,322,74,89,163,12,175
公投第１５案,新北市,汐止區,新昌里,2344,1460,296,491,787,6,793
公投第１５案,新北市,汐止區,新昌里,2345,1719,343,501,844,39,883
公投第１５案,新北市,汐止區,新昌里,2346,1661,272,545,817,48,865
公投第１５案,新北市,汐止區,福安里,2347,1590,327,532,859,45,904
公投第１５案,新北市,汐止區,福安里,2348,1599,294,547,841,38,879
公投第１５案,新北市,汐止區,福安里,2349,1749,596,337,933,39,972
公投第１５案,新北市,汐止區,秀峰里,2350,1809,144,185,329,27,356
公投第１５案,新北市,汐止區,秀峰里,2351,1601,281,460,741,28,769
公投第１５案,新北市,汐止區,秀峰里,2352,1387,240,442,682,56,738
公投第１５案,新北市,汐止區,秀山里,2353,1779,370,574,944,54,998
公投第１５案,新北市,汐止區,秀山里,2354,2074,389,726,1115,46,1161
公投第１５案,新北市,汐止區,復興里,2355,2072,417,660,1077,41,1118
公投第１５案,新北市,汐止區,復興里,2356,2120,453,733,1186,56,1242
公投第１５案,新北市,汐止區,復興里,2357,1952,447,626,1073,40,1113
公投第１５案,新北市,汐止區,自強里,2358,1654,290,529,819,62,881
公投第１５案,新北市,汐止區,自強里,2359,1444,261,448,709,54,763
公投第１５案,新北市,汐止區,自強里,2360,1627,358,574,932,31,963
公投第１５案,新北市,汐止區,文化里,2361,1751,329,522,851,61,912
公投第１５案,新北市,汐止區,文化里,2362,2066,418,619,1037,49,1086
公投第１５案,新北市,汐止區,白雲里,2363,1941,291,535,826,49,875
公投第１５案,新北市,汐止區,白雲里,2364,1906,316,557,873,41,914
公投第１５案,新北市,汐止區,茄苳里,2365,1363,227,430,657,61,718
公投第１５案,新北市,汐止區,茄苳里,2366,1368,237,424,661,36,697
公投第１５案,新北市,汐止區,茄苳里,2367,1233,215,351,566,48,614
公投第１５案,新北市,汐止區,崇德里,2368,1554,305,483,788,18,806
公投第１５案,新北市,汐止區,崇德里,2369,1700,295,538,833,40,873
公投第１５案,新北市,汐止區,崇德里,2370,1124,253,361,614,17,631
公投第１５案,新北市,汐止區,城中里,2371,1900,403,631,1034,54,1088
公投第１５案,新北市,汐止區,城中里,2372,2050,400,640,1040,58,1098
公投第１５案,新北市,汐止區,橋東里,2373,1244,275,345,620,52,672
公投第１５案,新北市,汐止區,橋東里,2374,1320,219,414,633,35,668
公投第１５案,新北市,汐止區,建成里,2375,1473,297,499,796,38,834
公投第１５案,新北市,汐止區,建成里,2376,1802,303,641,944,51,995
公投第１５案,新北市,汐止區,建成里,2377,1266,252,458,710,31,741
公投第１５案,新北市,汐止區,長安里,2378,1481,254,424,678,57,735
公投第１５案,新北市,汐止區,保安里,2379,1497,301,412,713,59,772
公投第１５案,新北市,汐止區,東山里,2380,556,93,211,304,12,316
公投第１５案,新北市,汐止區,保長里,2381,1913,324,580,904,55,959
公投第１５案,新北市,汐止區,保長里,2382,2027,368,616,984,32,1016
公投第１５案,新北市,汐止區,保新里,2383,1927,362,548,910,37,947
公投第１５案,新北市,汐止區,保新里,2384,696,133,208,341,47,388
公投第１５案,新北市,汐止區,鄉長里,2385,2127,386,612,998,60,1058
公投第１５案,新北市,汐止區,江北里,2386,1642,282,447,729,47,776
公投第１５案,新北市,汐止區,江北里,2387,1912,334,594,928,65,993
公投第１５案,新北市,汐止區,江北里,2388,1893,286,539,825,59,884
公投第１５案,新北市,汐止區,拱北里,2389,1466,244,419,663,53,716
公投第１５案,新北市,汐止區,拱北里,2390,1538,252,475,727,67,794
公投第１５案,新北市,汐止區,拱北里,2391,1550,299,449,748,41,789
公投第１５案,新北市,汐止區,烘內里,2392,1456,235,461,696,55,751
公投第１５案,新北市,汐止區,八連里,2393,947,180,357,537,38,575
公投第１５案,新北市,汐止區,長青里,2394,923,196,304,500,20,520
公投第１５案,新北市,汐止區,北峰里,2395,2043,321,578,899,128,1027
公投第１５案,新北市,汐止區,北峰里,2396,2012,351,551,902,53,955
公投第１５案,新北市,汐止區,金龍里,2397,1471,246,414,660,26,686
公投第１５案,新北市,汐止區,金龍里,2398,1603,274,502,776,38,814
公投第１５案,新北市,汐止區,金龍里,2399,1530,284,486,770,53,823
公投第１５案,新北市,汐止區,樟樹里,2400,1988,288,562,850,34,884
公投第１５案,新北市,汐止區,忠孝里,2401,2198,405,640,1045,47,1092
公投第１５案,新北市,汐止區,忠孝里,2402,1712,284,543,827,42,869
公投第１５案,新北市,汐止區,忠孝里,2403,1806,367,594,961,46,1007
公投第１５案,新北市,汐止區,忠孝里,2404,1576,271,498,769,71,840
公投第１５案,新北市,汐止區,厚德里,2405,1511,268,488,756,37,793
公投第１５案,新北市,汐止區,厚德里,2406,1691,298,498,796,36,832
公投第１５案,新北市,汐止區,厚德里,2407,1636,276,552,828,42,870
公投第１５案,新北市,汐止區,厚德里,2408,1676,298,524,822,49,871
公投第１５案,新北市,汐止區,山光里,2409,1264,216,413,629,30,659
公投第１５案,新北市,汐止區,山光里,2410,1165,179,407,586,26,612
公投第１５案,新北市,汐止區,中興里,2411,1765,298,554,852,42,894
公投第１５案,新北市,汐止區,中興里,2412,1815,251,522,773,29,802
公投第１５案,新北市,汐止區,中興里,2413,1778,289,519,808,67,875
公投第１５案,新北市,汐止區,中興里,2414,1580,305,509,814,59,873
公投第１５案,新北市,汐止區,福德里,2415,1516,302,461,763,46,809
公投第１５案,新北市,汐止區,福德里,2416,1425,236,430,666,50,716
公投第１５案,新北市,汐止區,興福里,2417,1388,234,494,728,36,764
公投第１５案,新北市,汐止區,興福里,2418,1436,253,473,726,57,783
公投第１５案,新北市,汐止區,康福里,2419,1591,321,476,797,41,838
公投第１５案,新北市,汐止區,康福里,2420,1639,298,487,785,30,815
公投第１５案,新北市,汐止區,康福里,2421,1394,258,429,687,17,704
公投第１５案,新北市,汐止區,湖光里,2422,2035,377,587,964,34,998
公投第１５案,新北市,汐止區,湖光里,2423,1895,316,621,937,46,983
公投第１５案,新北市,汐止區,湖光里,2424,1374,287,472,759,25,784
公投第１５案,新北市,汐止區,湖蓮里,2425,1061,252,353,605,23,628
公投第１５案,新北市,汐止區,湖蓮里,2426,1312,297,499,796,28,824
公投第１５案,新北市,汐止區,湖興里,2427,1548,291,531,822,31,853
公投第１５案,新北市,汐止區,湖興里,2428,1350,232,510,742,30,772
公投第１５案,新北市,汐止區,湖興里,2429,1499,300,481,781,35,816
公投第１５案,新北市,汐止區,湖興里,2430,1366,255,500,755,37,792
公投第１５案,新北市,汐止區,北山里,2431,1335,265,457,722,44,766
公投第１５案,新北市,汐止區,北山里,2432,1324,259,508,767,40,807
公投第１５案,新北市,汐止區,北山里,2433,1286,266,460,726,55,781
公投第１５案,新北市,汐止區,北山里,2434,1155,231,363,594,43,637
公投第１５案,新北市,汐止區,忠山里,2435,1682,331,678,1009,31,1040
公投第１５案,新北市,汐止區,忠山里,2436,1494,271,605,876,49,925
公投第１５案,新北市,汐止區,環河里,2437,1166,212,420,632,72,704
公投第１５案,新北市,汐止區,橫科里,2438,2184,416,693,1109,104,1213
公投第１５案,新北市,汐止區,橫科里,2439,2031,347,627,974,55,1029
公投第１５案,新北市,汐止區,福山里,2440,1759,335,581,916,57,973
公投第１５案,新北市,汐止區,福山里,2441,1577,326,528,854,47,901
公投第１５案,新北市,汐止區,宜興里,2442,1364,252,465,717,22,739
公投第１５案,新北市,汐止區,宜興里,2443,1401,273,502,775,40,815
公投第１５案,新北市,汐止區,東勢里,2444,1173,266,384,650,46,696
公投第１５案,新北市,汐止區,東勢里,2445,993,204,337,541,12,553
公投第１５案,新北市,汐止區,東勢里,2446,1587,271,546,817,23,840
公投第１５案,臺中市,大甲區,朝陽里,1,1356,234,516,750,63,813
公投第１５案,臺中市,大甲區,大甲里,2,1059,217,406,623,42,665
公投第１５案,臺中市,大甲區,順天里,3,694,139,274,413,30,443
公投第１５案,臺中市,大甲區,順天里,4,874,150,356,506,23,529
公投第１５案,臺中市,大甲區,孔門里,5,763,113,294,407,22,429
公投第１５案,臺中市,大甲區,平安里,6,856,166,348,514,35,549
公投第１５案,臺中市,大甲區,平安里,7,1249,215,496,711,43,754
公投第１５案,臺中市,大甲區,庄美里,8,922,154,337,491,29,520
公投第１５案,臺中市,大甲區,庄美里,9,1189,208,458,666,45,711
公投第１５案,臺中市,大甲區,新美里,10,1065,185,457,642,47,689
公投第１５案,臺中市,大甲區,新美里,11,1252,208,518,726,67,793
公投第１５案,臺中市,大甲區,新美里,12,1057,180,400,580,39,619
公投第１５案,臺中市,大甲區,岷山里,13,1031,171,398,569,35,604
公投第１５案,臺中市,大甲區,岷山里,14,1060,190,442,632,37,669
公投第１５案,臺中市,大甲區,中山里,15,1311,218,505,723,46,769
公投第１５案,臺中市,大甲區,中山里,16,1424,219,548,767,48,815
公投第１５案,臺中市,大甲區,中山里,17,1670,289,644,933,50,983
公投第１５案,臺中市,大甲區,南陽里,18,812,142,299,441,41,482
公投第１５案,臺中市,大甲區,薰風里,19,863,134,370,504,29,533
公投第１５案,臺中市,大甲區,義和里,20,1598,271,623,894,56,950
公投第１５案,臺中市,大甲區,義和里,21,1588,239,630,869,41,910
公投第１５案,臺中市,大甲區,武陵里,22,1197,202,435,637,59,696
公投第１５案,臺中市,大甲區,文曲里,23,1106,176,366,542,77,619
公投第１５案,臺中市,大甲區,武曲里,24,903,161,361,522,46,568
公投第１５案,臺中市,大甲區,武曲里,25,869,142,368,510,38,548
公投第１５案,臺中市,大甲區,文武里,26,1350,240,506,746,41,787
公投第１５案,臺中市,大甲區,文武里,27,1144,179,419,598,93,691
公投第１５案,臺中市,大甲區,文武里,28,1208,187,510,697,45,742
公投第１５案,臺中市,大甲區,文武里,29,1567,312,591,903,36,939
公投第１５案,臺中市,大甲區,奉化里,30,1246,284,496,780,31,811
公投第１５案,臺中市,大甲區,奉化里,31,767,125,312,437,30,467
公投第１５案,臺中市,大甲區,德化里,32,790,136,310,446,36,482
公投第１５案,臺中市,大甲區,德化里,33,972,152,406,558,37,595
公投第１５案,臺中市,大甲區,江南里,34,1388,222,494,716,54,770
公投第１５案,臺中市,大甲區,頂店里,35,1331,195,485,680,36,716
公投第１５案,臺中市,大甲區,頂店里,36,1167,212,475,687,40,727
公投第１５案,臺中市,大甲區,頂店里,37,1934,622,466,1088,37,1125
公投第１５案,臺中市,大甲區,太白里,38,1263,200,400,600,61,661
公投第１５案,臺中市,大甲區,孟春里,39,1390,240,508,748,47,795
公投第１５案,臺中市,大甲區,孟春里,40,1186,166,384,550,44,594
公投第１５案,臺中市,大甲區,孟春里,41,1397,234,528,762,31,793
公投第１５案,臺中市,大甲區,幸福里,42,1173,142,367,509,21,530
公投第１５案,臺中市,大甲區,幸福里,43,1398,243,477,720,53,773
公投第１５案,臺中市,大甲區,日南里,44,1228,204,385,589,51,640
公投第１５案,臺中市,大甲區,日南里,45,1258,200,442,642,40,682
公投第１５案,臺中市,大甲區,日南里,46,1435,225,522,747,42,789
公投第１５案,臺中市,大甲區,日南里,47,1532,268,536,804,40,844
公投第１５案,臺中市,大甲區,龍泉里,48,652,102,249,351,31,382
公投第１５案,臺中市,大甲區,龍泉里,49,870,123,277,400,38,438
公投第１５案,臺中市,大甲區,西岐里,50,891,124,328,452,26,478
公投第１５案,臺中市,大甲區,西岐里,51,784,128,306,434,32,466
公投第１５案,臺中市,大甲區,銅安里,52,1368,190,474,664,87,751
公投第１５案,臺中市,大甲區,福德里,53,1126,165,387,552,53,605
公投第１５案,臺中市,大甲區,建興里,54,1486,226,447,673,67,740
公投第１５案,臺中市,大安區,南埔里,55,1068,149,366,515,55,570
公投第１５案,臺中市,大安區,南庄里,56,1050,172,386,558,56,614
公投第１５案,臺中市,大安區,中庄里,57,1246,239,453,692,68,760
公投第１５案,臺中市,大安區,中庄里,58,1397,196,526,722,61,783
公投第１５案,臺中市,大安區,東安里,59,1227,213,498,711,57,768
公投第１５案,臺中市,大安區,福興里,60,1170,166,472,638,56,694
公投第１５案,臺中市,大安區,龜壳里,61,914,160,355,515,80,595
公投第１５案,臺中市,大安區,龜壳里,62,667,87,226,313,32,345
公投第１５案,臺中市,大安區,頂安里,63,890,143,299,442,44,486
公投第１５案,臺中市,大安區,永安里,64,1289,210,466,676,60,736
公投第１５案,臺中市,大安區,永安里,65,455,59,163,222,21,243
公投第１５案,臺中市,大安區,福住里,66,1028,170,390,560,38,598
公投第１５案,臺中市,大安區,海墘里,67,1446,227,559,786,80,866
公投第１５案,臺中市,大安區,西安里,68,688,122,296,418,28,446
公投第１５案,臺中市,大安區,西安里,69,1062,163,431,594,54,648
公投第１５案,臺中市,大安區,松雅里,70,923,189,372,561,39,600
公投第１５案,臺中市,外埔區,永豐里,71,1059,154,410,564,39,603
公投第１５案,臺中市,外埔區,六分里,72,1013,150,433,583,22,605
公投第１５案,臺中市,外埔區,六分里,73,1150,175,498,673,47,720
公投第１５案,臺中市,外埔區,大同里,74,1855,297,830,1127,53,1180
公投第１５案,臺中市,外埔區,大同里,75,1327,187,576,763,37,800
公投第１５案,臺中市,外埔區,大同里,76,1453,214,627,841,48,889
公投第１５案,臺中市,外埔區,大東里,77,1653,229,628,857,72,929
公投第１５案,臺中市,外埔區,大東里,78,1615,210,626,836,39,875
公投第１５案,臺中市,外埔區,大東里,79,1470,208,553,761,48,809
公投第１５案,臺中市,外埔區,大東里,80,1559,257,624,881,51,932
公投第１５案,臺中市,外埔區,三崁里,81,1902,290,693,983,87,1070
公投第１５案,臺中市,外埔區,水美里,82,1138,204,481,685,46,731
公投第１５案,臺中市,外埔區,水美里,83,1065,168,442,610,70,680
公投第１５案,臺中市,外埔區,水美里,84,1243,230,505,735,45,780
公投第１５案,臺中市,外埔區,鐵山里,85,962,153,321,474,54,528
公投第１５案,臺中市,外埔區,鐵山里,86,1169,195,415,610,46,656
公投第１５案,臺中市,外埔區,中山里,87,1216,208,534,742,50,792
公投第１５案,臺中市,外埔區,馬鳴里,88,1391,172,579,751,42,793
公投第１５案,臺中市,外埔區,土城里,89,1616,229,602,831,83,914
公投第１５案,臺中市,外埔區,廍子里,90,1203,172,380,552,39,591
公投第１５案,臺中市,清水區,鰲峰里,91,1076,197,362,559,28,587
公投第１５案,臺中市,清水區,靈泉里,92,953,211,373,584,41,625
公投第１５案,臺中市,清水區,清水里,93,914,189,326,515,60,575
公投第１５案,臺中市,清水區,清水里,94,1143,228,452,680,52,732
公投第１５案,臺中市,清水區,文昌里,95,680,136,260,396,28,424
公投第１５案,臺中市,清水區,南寧里,96,904,164,366,530,35,565
公投第１５案,臺中市,清水區,南寧里,97,893,182,350,532,50,582
公投第１５案,臺中市,清水區,西寧里,98,1577,285,586,871,48,919
公投第１５案,臺中市,清水區,北寧里,99,690,119,248,367,41,408
公投第１５案,臺中市,清水區,中興里,100,403,84,151,235,12,247
公投第１５案,臺中市,清水區,西社里,101,1413,266,516,782,63,845
公投第１５案,臺中市,清水區,西社里,102,777,135,289,424,39,463
公投第１５案,臺中市,清水區,南社里,103,1313,227,540,767,34,801
公投第１５案,臺中市,清水區,南社里,104,1439,249,596,845,48,893
公投第１５案,臺中市,清水區,南社里,105,1265,221,442,663,33,696
公投第１５案,臺中市,清水區,南社里,106,1277,251,516,767,38,805
公投第１５案,臺中市,清水區,南社里,107,1276,239,503,742,32,774
公投第１５案,臺中市,清水區,南社里,108,1376,284,558,842,25,867
公投第１５案,臺中市,清水區,南社里,109,1291,265,520,785,32,817
公投第１５案,臺中市,清水區,裕嘉里,110,1510,318,545,863,54,917
公投第１５案,臺中市,清水區,臨江里,111,1524,261,568,829,6,835
公投第１５案,臺中市,清水區,秀水里,112,1474,251,508,759,38,797
公投第１５案,臺中市,清水區,秀水里,113,1507,247,555,802,52,854
公投第１５案,臺中市,清水區,秀水里,114,1321,247,546,793,69,862
公投第１５案,臺中市,清水區,武鹿里,115,1157,186,392,578,35,613
公投第１５案,臺中市,清水區,武鹿里,116,1255,247,468,715,46,761
公投第１５案,臺中市,清水區,武鹿里,117,881,151,330,481,30,511
公投第１５案,臺中市,清水區,海濱里,118,1083,205,415,620,50,670
公投第１５案,臺中市,清水區,海濱里,119,951,177,388,565,29,594
公投第１５案,臺中市,清水區,槺榔里,120,1424,238,505,743,40,783
公投第１５案,臺中市,清水區,槺榔里,121,1233,200,410,610,63,673
公投第１５案,臺中市,清水區,槺榔里,122,1288,204,381,585,49,634
公投第１５案,臺中市,清水區,槺榔里,123,1200,214,456,670,52,722
公投第１５案,臺中市,清水區,中社里,124,1609,214,721,935,25,960
公投第１５案,臺中市,清水區,中社里,125,1136,238,464,702,23,725
公投第１５案,臺中市,清水區,高西里,126,1302,189,483,672,65,737
公投第１５案,臺中市,清水區,高南里,127,1373,242,460,702,78,780
公投第１５案,臺中市,清水區,高東里,128,1257,211,379,590,66,656
公投第１５案,臺中市,清水區,高北里,129,1184,175,382,557,68,625
公投第１５案,臺中市,清水區,高美里,130,1322,188,497,685,64,749
公投第１５案,臺中市,清水區,國姓里,131,1193,208,381,589,48,637
公投第１５案,臺中市,清水區,國姓里,132,927,159,300,459,88,547
公投第１５案,臺中市,清水區,菁埔里,133,1073,212,393,605,64,669
公投第１５案,臺中市,清水區,菁埔里,134,1163,241,418,659,65,724
公投第１５案,臺中市,清水區,頂湳里,135,855,124,319,443,35,478
公投第１５案,臺中市,清水區,頂湳里,136,902,140,301,441,61,502
公投第１５案,臺中市,清水區,田寮里,137,1415,268,503,771,48,819
公投第１５案,臺中市,清水區,田寮里,138,1066,177,368,545,38,583
公投第１５案,臺中市,清水區,橋頭里,139,1391,250,480,730,68,798
公投第１５案,臺中市,清水區,橋頭里,140,1449,202,525,727,39,766
公投第１５案,臺中市,清水區,橋頭里,141,1377,246,538,784,51,835
公投第１５案,臺中市,清水區,橋頭里,142,1423,268,530,798,48,846
公投第１５案,臺中市,清水區,橋頭里,143,1624,280,619,899,42,941
公投第１５案,臺中市,清水區,下湳里,144,1358,211,368,579,75,654
公投第１５案,臺中市,清水區,下湳里,145,1464,231,558,789,66,855
公投第１５案,臺中市,清水區,東山里,146,1211,236,441,677,68,745
公投第１５案,臺中市,清水區,吳厝里,147,1456,198,585,783,24,807
公投第１５案,臺中市,清水區,楊厝里,148,1162,182,475,657,68,725
公投第１５案,臺中市,清水區,海風里,149,1368,206,619,825,51,876
公投第１５案,臺中市,梧棲區,頂寮里,150,1541,281,541,822,50,872
公投第１５案,臺中市,梧棲區,頂寮里,151,1581,291,549,840,48,888
公投第１５案,臺中市,梧棲區,下寮里,152,1083,196,401,597,45,642
公投第１５案,臺中市,梧棲區,下寮里,153,876,166,342,508,22,530
公投第１５案,臺中市,梧棲區,中正里,154,1043,183,382,565,50,615
公投第１５案,臺中市,梧棲區,中正里,155,1502,230,506,736,41,777
公投第１５案,臺中市,梧棲區,中正里,156,1384,238,509,747,54,801
公投第１５案,臺中市,梧棲區,中和里,157,517,98,227,325,26,351
公投第１５案,臺中市,梧棲區,文化里,158,1169,219,484,703,50,753
公投第１５案,臺中市,梧棲區,安仁里,159,863,163,321,484,40,524
公投第１５案,臺中市,梧棲區,草湳里,160,1277,207,393,600,41,641
公投第１５案,臺中市,梧棲區,草湳里,161,1742,294,609,903,42,945
公投第１５案,臺中市,梧棲區,草湳里,162,1342,229,503,732,61,793
公投第１５案,臺中市,梧棲區,草湳里,163,1767,314,635,949,77,1026
公投第１５案,臺中市,梧棲區,南簡里,164,1542,268,482,750,48,798
公投第１５案,臺中市,梧棲區,南簡里,165,1636,244,609,853,44,897
公投第１５案,臺中市,梧棲區,南簡里,166,1796,287,612,899,54,953
公投第１５案,臺中市,梧棲區,福德里,167,1450,221,540,761,39,800
公投第１５案,臺中市,梧棲區,福德里,168,1548,219,548,767,89,856
公投第１５案,臺中市,梧棲區,福德里,169,1366,239,531,770,37,807
公投第１５案,臺中市,梧棲區,大庄里,170,955,187,404,591,29,620
公投第１５案,臺中市,梧棲區,大庄里,171,1305,183,490,673,47,720
公投第１５案,臺中市,梧棲區,大庄里,172,1239,164,543,707,28,735
公投第１５案,臺中市,梧棲區,大庄里,173,1079,175,430,605,64,669
公投第１５案,臺中市,梧棲區,大庄里,174,1220,193,466,659,36,695
公投第１５案,臺中市,梧棲區,大庄里,175,1544,262,594,856,71,927
公投第１５案,臺中市,梧棲區,大村里,176,1460,290,549,839,47,886
公投第１５案,臺中市,梧棲區,大村里,177,1292,233,514,747,40,787
公投第１５案,臺中市,梧棲區,大村里,178,1300,219,477,696,43,739
公投第１５案,臺中市,梧棲區,大村里,179,1555,269,532,801,38,839
公投第１５案,臺中市,梧棲區,興農里,180,1031,176,360,536,42,578
公投第１５案,臺中市,梧棲區,興農里,181,1277,215,471,686,54,740
公投第１５案,臺中市,梧棲區,永寧里,182,1037,174,370,544,38,582
公投第１５案,臺中市,梧棲區,永寧里,183,1187,206,450,656,52,708
公投第１５案,臺中市,梧棲區,永安里,184,1399,204,510,714,44,758
公投第１５案,臺中市,梧棲區,永安里,185,1135,178,428,606,34,640
公投第１５案,臺中市,沙鹿區,居仁里,186,1380,258,447,705,34,739
公投第１５案,臺中市,沙鹿區,洛泉里,187,852,160,335,495,27,522
公投第１５案,臺中市,沙鹿區,洛泉里,188,1176,320,378,698,32,730
公投第１５案,臺中市,沙鹿區,沙鹿里,189,958,210,373,583,63,646
公投第１５案,臺中市,沙鹿區,美仁里,190,488,91,207,298,37,335
公投第１５案,臺中市,沙鹿區,興仁里,191,1177,241,412,653,39,692
公投第１５案,臺中市,沙鹿區,興仁里,192,1285,236,452,688,49,737
公投第１５案,臺中市,沙鹿區,興安里,193,1736,278,594,872,68,940
公投第１５案,臺中市,沙鹿區,興安里,194,1628,307,629,936,63,999
公投第１５案,臺中市,沙鹿區,斗抵里,195,1469,238,538,776,34,810
公投第１５案,臺中市,沙鹿區,斗抵里,196,1423,250,586,836,35,871
公投第１５案,臺中市,沙鹿區,斗抵里,197,1444,220,587,807,55,862
公投第１５案,臺中市,沙鹿區,鹿峰里,198,1469,258,544,802,63,865
公投第１５案,臺中市,沙鹿區,鹿峰里,199,1902,364,678,1042,62,1104
公投第１５案,臺中市,沙鹿區,鹿峰里,200,1675,321,635,956,33,989
公投第１５案,臺中市,沙鹿區,鹿寮里,201,1098,193,393,586,49,635
公投第１５案,臺中市,沙鹿區,鹿寮里,202,1539,311,579,890,47,937
公投第１５案,臺中市,沙鹿區,鹿寮里,203,1329,257,533,790,23,813
公投第１５案,臺中市,沙鹿區,鹿寮里,204,1255,228,451,679,31,710
公投第１５案,臺中市,沙鹿區,鹿寮里,205,1507,291,558,849,49,898
公投第１５案,臺中市,沙鹿區,竹林里,206,1463,263,548,811,58,869
公投第１５案,臺中市,沙鹿區,竹林里,207,1279,216,435,651,57,708
公投第１５案,臺中市,沙鹿區,竹林里,208,1024,153,360,513,32,545
公投第１５案,臺中市,沙鹿區,竹林里,209,1388,213,492,705,55,760
公投第１５案,臺中市,沙鹿區,竹林里,210,1074,215,406,621,28,649
公投第１５案,臺中市,沙鹿區,竹林里,211,1072,196,426,622,33,655
公投第１５案,臺中市,沙鹿區,犁分里,212,1107,171,467,638,52,690
公投第１５案,臺中市,沙鹿區,福興里,213,1947,280,660,940,52,992
公投第１５案,臺中市,沙鹿區,福興里,214,1682,246,600,846,60,906
公投第１５案,臺中市,沙鹿區,北勢里,215,1633,270,639,909,45,954
公投第１５案,臺中市,沙鹿區,北勢里,216,1533,243,536,779,48,827
公投第１５案,臺中市,沙鹿區,北勢里,217,1605,235,513,748,30,778
公投第１５案,臺中市,沙鹿區,晉江里,218,1694,251,618,869,30,899
公投第１５案,臺中市,沙鹿區,六路里,219,1628,275,552,827,50,877
公投第１５案,臺中市,沙鹿區,六路里,220,1665,317,636,953,25,978
公投第１５案,臺中市,沙鹿區,六路里,221,1651,268,605,873,38,911
公投第１５案,臺中市,沙鹿區,南勢里,222,1108,194,463,657,32,689
公投第１５案,臺中市,沙鹿區,南勢里,223,1142,186,472,658,42,700
公投第１５案,臺中市,沙鹿區,南勢里,224,1039,148,426,574,29,603
公投第１５案,臺中市,沙鹿區,埔子里,225,1840,311,639,950,66,1016
公投第１５案,臺中市,沙鹿區,埔子里,226,1872,325,679,1004,36,1040
公投第１５案,臺中市,沙鹿區,埔子里,227,1558,265,525,790,48,838
公投第１５案,臺中市,沙鹿區,三鹿里,228,1739,283,584,867,38,905
公投第１５案,臺中市,沙鹿區,三鹿里,229,1672,248,546,794,51,845
公投第１５案,臺中市,沙鹿區,三鹿里,230,1634,268,611,879,31,910
公投第１５案,臺中市,沙鹿區,三鹿里,231,1616,248,530,778,49,827
公投第１５案,臺中市,沙鹿區,公明里,232,1593,270,593,863,44,907
公投第１５案,臺中市,沙鹿區,公明里,233,981,133,384,517,23,540
公投第１５案,臺中市,沙鹿區,公明里,234,1740,287,693,980,54,1034
公投第１５案,臺中市,沙鹿區,清泉里,235,1247,240,481,721,47,768
公投第１５案,臺中市,沙鹿區,清泉里,236,1047,153,455,608,16,624
公投第１５案,臺中市,沙鹿區,西勢里,237,1119,166,434,600,66,666
公投第１５案,臺中市,沙鹿區,西勢里,238,1025,142,415,557,22,579
公投第１５案,臺中市,龍井區,竹坑里,239,1758,324,677,1001,63,1064
公投第１５案,臺中市,龍井區,竹坑里,240,1275,204,488,692,47,739
公投第１５案,臺中市,龍井區,龍東里,241,1379,196,455,651,32,683
公投第１５案,臺中市,龍井區,龍東里,242,1403,208,488,696,54,750
公投第１５案,臺中市,龍井區,龍西里,243,974,150,376,526,44,570
公投第１５案,臺中市,龍井區,龍西里,244,901,156,465,621,36,657
公投第１５案,臺中市,龍井區,田中里,245,1779,315,604,919,79,998
公投第１５案,臺中市,龍井區,田中里,246,1609,321,568,889,71,960
公投第１５案,臺中市,龍井區,福田里,247,1038,150,367,517,29,546
公投第１５案,臺中市,龍井區,麗水里,248,1328,234,527,761,57,818
公投第１５案,臺中市,龍井區,麗水里,249,921,151,388,539,37,576
公投第１５案,臺中市,龍井區,龍津里,250,1609,234,545,779,68,847
公投第１５案,臺中市,龍井區,龍津里,251,1227,185,414,599,21,620
公投第１５案,臺中市,龍井區,龍津里,252,1278,185,485,670,56,726
公投第１５案,臺中市,龍井區,龍津里,253,914,129,276,405,16,421
公投第１５案,臺中市,龍井區,三德里,254,1678,246,545,791,41,832
公投第１５案,臺中市,龍井區,三德里,255,1233,189,422,611,37,648
公投第１５案,臺中市,龍井區,忠和里,256,1520,258,544,802,59,861
公投第１５案,臺中市,龍井區,忠和里,257,1905,280,664,944,43,987
公投第１５案,臺中市,龍井區,忠和里,258,1520,264,588,852,58,910
公投第１５案,臺中市,龍井區,山腳里,259,1385,202,488,690,62,752
公投第１５案,臺中市,龍井區,山腳里,260,1212,224,423,647,35,682
公投第１５案,臺中市,龍井區,山腳里,261,1432,230,564,794,27,821
公投第１５案,臺中市,龍井區,山腳里,262,1663,262,585,847,42,889
公投第１５案,臺中市,龍井區,龍泉里,263,1422,230,491,721,42,763
公投第１５案,臺中市,龍井區,龍泉里,264,1616,249,498,747,70,817
公投第１５案,臺中市,龍井區,龍泉里,265,1422,241,546,787,56,843
公投第１５案,臺中市,龍井區,龍泉里,266,1165,221,433,654,38,692
公投第１５案,臺中市,龍井區,龍泉里,267,1624,323,571,894,6,900
公投第１５案,臺中市,龍井區,龍崗里,268,1613,257,596,853,57,910
公投第１５案,臺中市,龍井區,龍崗里,269,943,159,388,547,45,592
公投第１５案,臺中市,龍井區,新庄里,270,1595,239,553,792,72,864
公投第１５案,臺中市,龍井區,新庄里,271,1508,260,563,823,66,889
公投第１５案,臺中市,龍井區,新庄里,272,1479,227,548,775,32,807
公投第１５案,臺中市,龍井區,新庄里,273,1509,274,549,823,52,875
公投第１５案,臺中市,龍井區,南寮里,274,1582,272,626,898,68,966
公投第１５案,臺中市,龍井區,東海里,275,1725,304,631,935,54,989
公投第１５案,臺中市,龍井區,東海里,276,1616,265,629,894,39,933
公投第１５案,臺中市,龍井區,東海里,277,1657,305,634,939,40,979
公投第１５案,臺中市,龍井區,東海里,278,1774,389,604,993,39,1032
公投第１５案,臺中市,龍井區,東海里,279,1701,364,619,983,55,1038
公投第１５案,臺中市,龍井區,新東里,280,1121,207,422,629,34,663
公投第１５案,臺中市,龍井區,新東里,281,987,193,383,576,46,622
公投第１５案,臺中市,龍井區,新東里,282,1206,222,439,661,50,711
公投第１５案,臺中市,龍井區,新東里,283,1378,246,560,806,41,847
公投第１５案,臺中市,大肚區,王田里,284,1415,212,557,769,33,802
公投第１５案,臺中市,大肚區,王田里,285,1392,215,480,695,51,746
公投第１５案,臺中市,大肚區,王田里,286,1520,256,620,876,46,922
公投第１５案,臺中市,大肚區,中和里,287,862,165,362,527,56,583
公投第１５案,臺中市,大肚區,福山里,288,1256,200,534,734,48,782
公投第１５案,臺中市,大肚區,福山里,289,1292,207,496,703,46,749
公投第１５案,臺中市,大肚區,福山里,290,1010,169,410,579,37,616
公投第１５案,臺中市,大肚區,營埔里,291,1485,271,564,835,83,918
公投第１５案,臺中市,大肚區,社腳里,292,1190,210,500,710,58,768
公投第１５案,臺中市,大肚區,社腳里,293,1250,209,461,670,74,744
公投第１５案,臺中市,大肚區,新興里,294,1310,280,459,739,42,781
公投第１５案,臺中市,大肚區,新興里,295,1294,226,470,696,42,738
公投第１５案,臺中市,大肚區,大東里,296,1734,292,739,1031,60,1091
公投第１５案,臺中市,大肚區,大東里,297,1316,211,511,722,51,773
公投第１５案,臺中市,大肚區,大肚里,298,854,159,312,471,40,511
公投第１５案,臺中市,大肚區,大肚里,299,1273,247,539,786,35,821
公投第１５案,臺中市,大肚區,永和里,300,851,150,369,519,23,542
公投第１５案,臺中市,大肚區,磺溪里,301,1629,251,627,878,43,921
公投第１５案,臺中市,大肚區,永順里,302,1709,273,615,888,85,973
公投第１５案,臺中市,大肚區,成功里,303,953,142,356,498,32,530
公投第１５案,臺中市,大肚區,山陽里,304,1336,202,556,758,54,812
公投第１５案,臺中市,大肚區,頂街里,305,2113,349,711,1060,86,1146
公投第１５案,臺中市,大肚區,頂街里,306,1730,290,633,923,98,1021
公投第１５案,臺中市,大肚區,頂街里,307,1692,313,605,918,37,955
公投第１５案,臺中市,大肚區,頂街里,308,1747,252,706,958,51,1009
公投第１５案,臺中市,大肚區,瑞井里,309,1672,290,604,894,65,959
公投第１５案,臺中市,大肚區,瑞井里,310,1675,256,607,863,40,903
公投第１５案,臺中市,大肚區,瑞井里,311,1673,227,674,901,62,963
公投第１５案,臺中市,大肚區,蔗廍里,312,1636,298,618,916,52,968
公投第１５案,臺中市,大肚區,蔗廍里,313,1753,270,618,888,66,954
公投第１５案,臺中市,大肚區,蔗廍里,314,1343,203,482,685,29,714
公投第１５案,臺中市,大肚區,自強里,315,1822,314,654,968,56,1024
公投第１５案,臺中市,大肚區,自強里,316,1670,251,693,944,91,1035
公投第１５案,臺中市,烏日區,烏日里,317,1480,279,602,881,52,933
公投第１５案,臺中市,烏日區,烏日里,318,1841,371,684,1055,79,1134
公投第１５案,臺中市,烏日區,烏日里,319,1751,316,626,942,59,1001
公投第１５案,臺中市,烏日區,烏日里,320,1547,289,600,889,67,956
公投第１５案,臺中市,烏日區,烏日里,321,1836,313,714,1027,42,1069
公投第１５案,臺中市,烏日區,湖日里,322,1239,282,453,735,96,831
公投第１５案,臺中市,烏日區,湖日里,323,1295,224,448,672,68,740
公投第１５案,臺中市,烏日區,三和里,324,1263,231,436,667,53,720
公投第１５案,臺中市,烏日區,三和里,325,1622,316,547,863,43,906
公投第１５案,臺中市,烏日區,三和里,326,1822,268,688,956,82,1038
公投第１５案,臺中市,烏日區,榮泉里,327,1966,332,696,1028,59,1087
公投第１５案,臺中市,烏日區,榮泉里,328,1615,285,614,899,52,951
公投第１５案,臺中市,烏日區,榮泉里,329,1232,235,469,704,43,747
公投第１５案,臺中市,烏日區,學田里,330,1347,220,489,709,40,749
公投第１５案,臺中市,烏日區,學田里,331,1165,201,383,584,42,626
公投第１５案,臺中市,烏日區,九德里,332,1664,303,653,956,47,1003
公投第１５案,臺中市,烏日區,九德里,333,1230,224,504,728,43,771
公投第１５案,臺中市,烏日區,九德里,334,1574,267,627,894,92,986
公投第１５案,臺中市,烏日區,九德里,335,1452,285,596,881,43,924
公投第１５案,臺中市,烏日區,九德里,336,1879,286,685,971,58,1029
公投第１５案,臺中市,烏日區,九德里,337,1601,296,583,879,41,920
公投第１５案,臺中市,烏日區,九德里,338,1546,278,632,910,45,955
公投第１５案,臺中市,烏日區,九德里,339,1866,293,610,903,43,946
公投第１５案,臺中市,烏日區,仁德里,340,1938,338,752,1090,63,1153
公投第１５案,臺中市,烏日區,仁德里,341,1759,337,631,968,69,1037
公投第１５案,臺中市,烏日區,仁德里,342,2061,348,687,1035,76,1111
公投第１５案,臺中市,烏日區,仁德里,343,1691,293,658,951,54,1005
公投第１５案,臺中市,烏日區,前竹里,344,1039,201,445,646,36,682
公投第１５案,臺中市,烏日區,前竹里,345,1221,206,499,705,41,746
公投第１５案,臺中市,烏日區,五光里,346,1650,297,635,932,72,1004
公投第１５案,臺中市,烏日區,光明里,347,937,184,353,537,44,581
公投第１５案,臺中市,烏日區,光明里,348,1220,236,458,694,39,733
公投第１５案,臺中市,烏日區,東園里,349,2139,303,720,1023,121,1144
公投第１５案,臺中市,烏日區,溪埧里,350,1371,239,587,826,58,884
公投第１５案,臺中市,烏日區,溪埧里,351,1277,201,494,695,60,755
公投第１５案,臺中市,烏日區,溪埧里,352,1708,259,621,880,69,949
公投第１５案,臺中市,烏日區,螺潭里,353,2048,293,767,1060,89,1149
公投第１５案,臺中市,烏日區,北里里,354,1632,269,587,856,54,910
公投第１５案,臺中市,烏日區,南里里,355,1327,218,511,729,76,805
公投第１５案,臺中市,烏日區,溪尾里,356,854,119,315,434,65,499
公投第１５案,臺中市,后里區,廣福里,357,852,154,351,505,42,547
公投第１５案,臺中市,后里區,廣福里,358,1135,164,424,588,62,650
公投第１５案,臺中市,后里區,仁里里,359,1079,170,366,536,52,588
公投第１５案,臺中市,后里區,義里里,360,1539,248,613,861,51,912
公投第１５案,臺中市,后里區,義里里,361,1591,280,600,880,46,926
公投第１５案,臺中市,后里區,義德里,362,1376,196,488,684,39,723
公投第１５案,臺中市,后里區,義德里,363,1298,227,497,724,24,748
公投第１５案,臺中市,后里區,后里里,364,1428,254,542,796,59,855
公投第１５案,臺中市,后里區,后里里,365,1178,235,505,740,43,783
公投第１５案,臺中市,后里區,后里里,366,1095,162,458,620,36,656
公投第１５案,臺中市,后里區,厚里里,367,963,172,351,523,27,550
公投第１５案,臺中市,后里區,厚里里,368,1163,204,422,626,43,669
公投第１５案,臺中市,后里區,墩東里,369,1018,191,399,590,29,619
公投第１５案,臺中市,后里區,墩東里,370,854,163,364,527,26,553
公投第１５案,臺中市,后里區,墩東里,371,1485,222,549,771,43,814
公投第１５案,臺中市,后里區,墩東里,372,1355,244,563,807,51,858
公投第１５案,臺中市,后里區,墩西里,373,840,142,280,422,47,469
公投第１５案,臺中市,后里區,墩西里,374,1146,198,438,636,55,691
公投第１５案,臺中市,后里區,墩南里,375,1669,289,671,960,66,1026
公投第１５案,臺中市,后里區,墩南里,376,1673,284,678,962,85,1047
公投第１５案,臺中市,后里區,墩北里,377,1493,279,556,835,39,874
公投第１５案,臺中市,后里區,墩北里,378,1052,210,393,603,53,656
公投第１５案,臺中市,后里區,墩北里,379,909,148,333,481,17,498
公投第１５案,臺中市,后里區,中和里,380,1091,194,421,615,64,679
公投第１５案,臺中市,后里區,中和里,381,1342,224,542,766,65,831
公投第１５案,臺中市,后里區,舊社里,382,1138,183,398,581,65,646
公投第１５案,臺中市,后里區,舊社里,383,977,162,396,558,31,589
公投第１５案,臺中市,后里區,聯合里,384,1584,216,523,739,42,781
公投第１５案,臺中市,后里區,太平里,385,915,131,375,506,33,539
公投第１５案,臺中市,后里區,太平里,386,1225,205,462,667,71,738
公投第１５案,臺中市,后里區,眉山里,387,1552,249,592,841,34,875
公投第１５案,臺中市,后里區,眉山里,388,1600,252,604,856,31,887
公投第１５案,臺中市,后里區,月眉里,389,942,148,357,505,30,535
公投第１５案,臺中市,后里區,月眉里,390,943,153,348,501,27,528
公投第１５案,臺中市,后里區,公館里,391,1055,271,249,520,42,562
公投第１５案,臺中市,后里區,公館里,392,1067,189,387,576,55,631
公投第１５案,臺中市,后里區,泰安里,393,1340,209,469,678,41,719
公投第１５案,臺中市,豐原區,豐原里,394,983,168,346,514,50,564
公投第１５案,臺中市,豐原區,豐原里,395,1309,231,522,753,42,795
公投第１５案,臺中市,豐原區,豐榮里,396,1116,264,383,647,55,702
公投第１５案,臺中市,豐原區,頂街里,397,945,188,375,563,48,611
公投第１５案,臺中市,豐原區,中山里,398,850,192,310,502,54,556
公投第１５案,臺中市,豐原區,下街里,399,760,165,293,458,38,496
公投第１５案,臺中市,豐原區,中陽里,400,1617,284,623,907,9,916
公投第１５案,臺中市,豐原區,中陽里,401,1677,257,598,855,43,898
公投第１５案,臺中市,豐原區,中陽里,402,1771,340,748,1088,41,1129
公投第１５案,臺中市,豐原區,大湳里,403,1145,181,432,613,50,663
公投第１５案,臺中市,豐原區,大湳里,404,1362,258,495,753,36,789
公投第１５案,臺中市,豐原區,北湳里,405,1389,248,563,811,33,844
公投第１５案,臺中市,豐原區,北湳里,406,1530,257,636,893,50,943
公投第１５案,臺中市,豐原區,東湳里,407,1471,263,534,797,87,884
公投第１５案,臺中市,豐原區,東湳里,408,1410,245,538,783,71,854
公投第１５案,臺中市,豐原區,東湳里,409,1162,182,459,641,42,683
公投第１５案,臺中市,豐原區,西湳里,410,1656,275,642,917,33,950
公投第１５案,臺中市,豐原區,西湳里,411,1838,276,726,1002,42,1044
公投第１５案,臺中市,豐原區,西湳里,412,1666,290,617,907,43,950
公投第１５案,臺中市,豐原區,西湳里,413,1821,331,690,1021,81,1102
公投第１５案,臺中市,豐原區,西湳里,414,1821,352,794,1146,67,1213
公投第１５案,臺中市,豐原區,豐西里,415,1647,329,582,911,32,943
公投第１５案,臺中市,豐原區,圳寮里,416,1256,271,501,772,71,843
公投第１５案,臺中市,豐原區,豐圳里,417,1552,298,637,935,61,996
公投第１５案,臺中市,豐原區,豐圳里,418,1793,329,676,1005,50,1055
公投第１５案,臺中市,豐原區,富春里,419,759,179,329,508,30,538
公投第１５案,臺中市,豐原區,葫蘆里,420,642,141,247,388,36,424
公投第１５案,臺中市,豐原區,西安里,421,1528,318,599,917,21,938
公投第１５案,臺中市,豐原區,西安里,422,1788,329,744,1073,64,1137
公投第１５案,臺中市,豐原區,西安里,423,1663,348,672,1020,75,1095
公投第１５案,臺中市,豐原區,西勢里,424,1260,256,565,821,54,875
公投第１５案,臺中市,豐原區,西勢里,425,902,176,330,506,26,532
公投第１５案,臺中市,豐原區,中興里,426,1357,231,506,737,29,766
公投第１５案,臺中市,豐原區,中興里,427,1592,275,654,929,37,966
公投第１５案,臺中市,豐原區,社皮里,428,1873,305,749,1054,48,1102
公投第１５案,臺中市,豐原區,社皮里,429,1867,317,728,1045,46,1091
公投第１５案,臺中市,豐原區,社皮里,430,1823,295,694,989,77,1066
公投第１５案,臺中市,豐原區,社皮里,431,1962,338,660,998,48,1046
公投第１５案,臺中市,豐原區,社皮里,432,2313,468,891,1359,59,1418
公投第１５案,臺中市,豐原區,三村里,433,1510,281,598,879,60,939
公投第１５案,臺中市,豐原區,三村里,434,1824,321,717,1038,60,1098
公投第１５案,臺中市,豐原區,三村里,435,1363,247,541,788,33,821
公投第１５案,臺中市,豐原區,三村里,436,1535,291,632,923,45,968
公投第１５案,臺中市,豐原區,東勢里,437,1457,310,562,872,41,913
公投第１５案,臺中市,豐原區,民生里,438,1184,233,469,702,32,734
公投第１５案,臺中市,豐原區,田心里,439,2299,388,678,1066,55,1121
公投第１５案,臺中市,豐原區,田心里,440,1940,328,742,1070,86,1156
公投第１５案,臺中市,豐原區,田心里,441,2067,382,731,1113,52,1165
公投第１５案,臺中市,豐原區,豐田里,442,2038,360,741,1101,62,1163
公投第１５案,臺中市,豐原區,豐田里,443,1835,354,663,1017,44,1061
公投第１５案,臺中市,豐原區,豐田里,444,1979,331,736,1067,81,1148
公投第１５案,臺中市,豐原區,豐田里,445,2014,340,733,1073,73,1146
公投第１５案,臺中市,豐原區,豐田里,446,2257,393,842,1235,86,1321
公投第１５案,臺中市,豐原區,鎌村里,447,1406,245,583,828,62,890
公投第１５案,臺中市,豐原區,鎌村里,448,1418,280,540,820,48,868
公投第１５案,臺中市,豐原區,鎌村里,449,1772,313,753,1066,58,1124
公投第１５案,臺中市,豐原區,陽明里,450,1202,257,496,753,26,779
公投第１５案,臺中市,豐原區,陽明里,451,1447,257,603,860,36,896
公投第１５案,臺中市,豐原區,南陽里,452,1758,319,693,1012,72,1084
公投第１５案,臺中市,豐原區,南陽里,453,1546,300,638,938,52,990
公投第１５案,臺中市,豐原區,南陽里,454,1815,288,796,1084,49,1133
公投第１５案,臺中市,豐原區,南陽里,455,1932,392,719,1111,54,1165
公投第１５案,臺中市,豐原區,南陽里,456,1770,358,700,1058,51,1109
公投第１５案,臺中市,豐原區,南陽里,457,1560,240,609,849,31,880
公投第１５案,臺中市,豐原區,北陽里,458,1810,323,693,1016,49,1065
公投第１５案,臺中市,豐原區,北陽里,459,1653,365,640,1005,42,1047
公投第１５案,臺中市,豐原區,北陽里,460,1444,572,242,814,54,868
公投第１５案,臺中市,豐原區,北陽里,461,1318,267,538,805,31,836
公投第１５案,臺中市,豐原區,北陽里,462,1566,337,554,891,67,958
公投第１５案,臺中市,豐原區,北陽里,463,1748,325,651,976,50,1026
公投第１５案,臺中市,豐原區,北陽里,464,1772,279,613,892,71,963
公投第１５案,臺中市,豐原區,北陽里,465,1721,276,670,946,66,1012
公投第１５案,臺中市,豐原區,東陽里,466,1578,274,636,910,47,957
公投第１５案,臺中市,豐原區,南村里,467,1859,358,676,1034,58,1092
公投第１５案,臺中市,豐原區,南村里,468,1479,298,549,847,37,884
公投第１５案,臺中市,豐原區,南村里,469,1889,345,739,1084,43,1127
公投第１５案,臺中市,豐原區,南田里,470,1803,333,662,995,46,1041
公投第１５案,臺中市,豐原區,南田里,471,1421,270,494,764,53,817
公投第１５案,臺中市,豐原區,南嵩里,472,1585,311,626,937,69,1006
公投第１５案,臺中市,豐原區,南嵩里,473,1774,313,727,1040,77,1117
公投第１５案,臺中市,豐原區,翁明里,474,2132,336,854,1190,73,1263
公投第１５案,臺中市,豐原區,翁子里,475,1515,250,589,839,67,906
公投第１５案,臺中市,豐原區,翁子里,476,1359,207,507,714,30,744
公投第１５案,臺中市,豐原區,翁社里,477,948,189,367,556,43,599
公投第１５案,臺中市,豐原區,翁社里,478,1134,219,456,675,39,714
公投第１５案,臺中市,豐原區,朴子里,479,1114,223,465,688,61,749
公投第１５案,臺中市,豐原區,朴子里,480,1050,191,403,594,44,638
公投第１５案,臺中市,豐原區,朴子里,481,1182,246,480,726,50,776
公投第１５案,臺中市,神岡區,神岡里,482,1684,277,649,926,62,988
公投第１５案,臺中市,神岡區,神岡里,483,1559,256,614,870,55,925
公投第１５案,臺中市,神岡區,庄前里,484,1095,188,418,606,34,640
公投第１５案,臺中市,神岡區,庄前里,485,1044,219,450,669,41,710
公投第１５案,臺中市,神岡區,北庄里,486,1310,219,558,777,78,855
公投第１５案,臺中市,神岡區,北庄里,487,1294,247,504,751,77,828
公投第１５案,臺中市,神岡區,庄後里,488,1143,188,447,635,56,691
公投第１５案,臺中市,神岡區,庄後里,489,1022,173,401,574,64,638
公投第１５案,臺中市,神岡區,圳前里,490,1269,167,497,664,51,715
公投第１５案,臺中市,神岡區,圳前里,491,1085,130,380,510,31,541
公投第１５案,臺中市,神岡區,圳堵里,492,942,171,389,560,38,598
公投第１５案,臺中市,神岡區,圳堵里,493,1154,180,459,639,41,680
公投第１５案,臺中市,神岡區,新庄里,494,1390,215,523,738,50,788
公投第１５案,臺中市,神岡區,新庄里,495,1372,229,573,802,66,868
公投第１５案,臺中市,神岡區,新庄里,496,1328,192,498,690,40,730
公投第１５案,臺中市,神岡區,山皮里,497,1038,191,372,563,17,580
公投第１５案,臺中市,神岡區,社口里,498,1452,214,562,776,40,816
公投第１５案,臺中市,神岡區,社口里,499,1551,268,627,895,60,955
公投第１５案,臺中市,神岡區,社口里,500,1567,262,538,800,61,861
公投第１５案,臺中市,神岡區,社口里,501,1449,260,543,803,38,841
公投第１５案,臺中市,神岡區,社口里,502,1246,188,452,640,29,669
公投第１５案,臺中市,神岡區,社南里,503,1431,224,582,806,54,860
公投第１５案,臺中市,神岡區,社南里,504,1163,236,434,670,64,734
公投第１５案,臺中市,神岡區,社南里,505,1402,279,559,838,74,912
公投第１５案,臺中市,神岡區,社南里,506,1271,231,480,711,55,766
公投第１５案,臺中市,神岡區,三角里,507,1198,196,480,676,59,735
公投第１５案,臺中市,神岡區,三角里,508,1312,197,543,740,66,806
公投第１５案,臺中市,神岡區,大社里,509,1590,257,589,846,61,907
公投第１５案,臺中市,神岡區,大社里,510,1324,214,501,715,31,746
公投第１５案,臺中市,神岡區,大社里,511,1415,251,506,757,31,788
公投第１５案,臺中市,神岡區,岸裡里,512,1483,254,644,898,59,957
公投第１５案,臺中市,神岡區,岸裡里,513,1402,220,509,729,36,765
公投第１５案,臺中市,神岡區,豐洲里,514,1275,208,458,666,51,717
公投第１５案,臺中市,神岡區,豐洲里,515,1288,197,467,664,41,705
公投第１５案,臺中市,神岡區,豐洲里,516,1080,147,414,561,56,617
公投第１５案,臺中市,神岡區,豐洲里,517,1344,228,502,730,30,760
公投第１５案,臺中市,神岡區,豐洲里,518,1061,200,419,619,49,668
公投第１５案,臺中市,神岡區,豐洲里,519,1176,240,456,696,50,746
公投第１５案,臺中市,神岡區,神洲里,520,1244,218,504,722,58,780
公投第１５案,臺中市,神岡區,神洲里,521,1318,229,553,782,66,848
公投第１５案,臺中市,神岡區,溪洲里,522,1471,225,540,765,47,812
公投第１５案,臺中市,神岡區,溪洲里,523,1323,236,563,799,77,876
公投第１５案,臺中市,大雅區,上雅里,524,2027,333,785,1118,53,1171
公投第１５案,臺中市,大雅區,上雅里,525,1967,328,659,987,38,1025
公投第１５案,臺中市,大雅區,上雅里,526,1912,506,494,1000,42,1042
公投第１５案,臺中市,大雅區,大雅里,527,1537,295,609,904,45,949
公投第１５案,臺中市,大雅區,大雅里,528,1439,262,595,857,40,897
公投第１５案,臺中市,大雅區,大雅里,529,1402,251,534,785,54,839
公投第１５案,臺中市,大雅區,文雅里,530,2013,353,709,1062,44,1106
公投第１５案,臺中市,大雅區,文雅里,531,1917,717,339,1056,64,1120
公投第１５案,臺中市,大雅區,文雅里,532,2011,359,707,1066,59,1125
公投第１５案,臺中市,大雅區,三和里,533,1887,293,757,1050,59,1109
公投第１５案,臺中市,大雅區,三和里,534,1480,302,562,864,46,910
公投第１５案,臺中市,大雅區,三和里,535,1816,300,697,997,48,1045
公投第１５案,臺中市,大雅區,二和里,536,1898,306,604,910,66,976
公投第１５案,臺中市,大雅區,二和里,537,2008,308,784,1092,61,1153
公投第１５案,臺中市,大雅區,二和里,538,1976,347,753,1100,53,1153
公投第１５案,臺中市,大雅區,四德里,539,1673,305,625,930,50,980
公投第１５案,臺中市,大雅區,四德里,540,1409,254,596,850,33,883
公投第１５案,臺中市,大雅區,四德里,541,1382,248,553,801,22,823
公投第１５案,臺中市,大雅區,西寶里,542,1635,231,629,860,72,932
公投第１５案,臺中市,大雅區,西寶里,543,1565,271,613,884,51,935
公投第１５案,臺中市,大雅區,西寶里,544,1528,257,553,810,37,847
公投第１５案,臺中市,大雅區,上楓里,545,1963,291,744,1035,34,1069
公投第１５案,臺中市,大雅區,上楓里,546,2073,331,722,1053,38,1091
公投第１５案,臺中市,大雅區,上楓里,547,1984,327,692,1019,82,1101
公投第１５案,臺中市,大雅區,大楓里,548,1688,289,613,902,51,953
公投第１５案,臺中市,大雅區,大楓里,549,1387,245,521,766,35,801
公投第１５案,臺中市,大雅區,大楓里,550,1701,282,673,955,81,1036
公投第１５案,臺中市,大雅區,雅楓里,551,1721,278,637,915,60,975
公投第１５案,臺中市,大雅區,雅楓里,552,1879,286,578,864,39,903
公投第１５案,臺中市,大雅區,員林里,553,1568,294,666,960,39,999
公投第１５案,臺中市,大雅區,員林里,554,1761,320,622,942,86,1028
公投第１５案,臺中市,大雅區,員林里,555,1752,288,705,993,80,1073
公投第１５案,臺中市,大雅區,員林里,556,1264,219,506,725,31,756
公投第１５案,臺中市,大雅區,員林里,557,1302,211,559,770,37,807
公投第１５案,臺中市,大雅區,員林里,558,1449,255,534,789,46,835
公投第１５案,臺中市,大雅區,六寶里,559,1621,253,673,926,81,1007
公投第１５案,臺中市,大雅區,六寶里,560,1647,262,597,859,67,926
公投第１５案,臺中市,大雅區,六寶里,561,1441,246,551,797,26,823
公投第１５案,臺中市,大雅區,六寶里,562,1460,200,601,801,27,828
公投第１５案,臺中市,大雅區,秀山里,563,1832,316,741,1057,74,1131
公投第１５案,臺中市,大雅區,秀山里,564,1371,253,562,815,55,870
公投第１５案,臺中市,大雅區,橫山里,565,1418,220,521,741,12,753
公投第１５案,臺中市,大雅區,橫山里,566,1473,255,601,856,34,890
公投第１５案,臺中市,大雅區,橫山里,567,1335,246,497,743,54,797
公投第１５案,臺中市,大雅區,忠義里,568,1733,217,717,934,61,995
公投第１５案,臺中市,大雅區,忠義里,569,1884,231,625,856,89,945
公投第１５案,臺中市,潭子區,潭秀里,570,1306,222,541,763,43,806
公投第１５案,臺中市,潭子區,潭北里,571,1128,211,446,657,42,699
公投第１５案,臺中市,潭子區,潭北里,572,1159,209,489,698,48,746
公投第１５案,臺中市,潭子區,潭陽里,573,1630,308,615,923,78,1001
公投第１５案,臺中市,潭子區,潭陽里,574,1532,260,586,846,43,889
公投第１５案,臺中市,潭子區,潭陽里,575,1677,269,574,843,33,876
公投第１５案,臺中市,潭子區,潭陽里,576,1744,276,611,887,58,945
公投第１５案,臺中市,潭子區,潭陽里,577,1795,328,655,983,59,1042
公投第１５案,臺中市,潭子區,潭陽里,578,1171,213,429,642,40,682
公投第１５案,臺中市,潭子區,潭陽里,579,1427,263,532,795,25,820
公投第１５案,臺中市,潭子區,福仁里,580,1709,258,678,936,54,990
公投第１５案,臺中市,潭子區,福仁里,581,1723,286,651,937,49,986
公投第１５案,臺中市,潭子區,福仁里,582,1782,244,690,934,52,986
公投第１５案,臺中市,潭子區,福仁里,583,1407,218,499,717,50,767
公投第１５案,臺中市,潭子區,福仁里,584,1771,343,675,1018,26,1044
公投第１５案,臺中市,潭子區,福仁里,585,1795,336,672,1008,78,1086
公投第１５案,臺中市,潭子區,頭家里,586,1612,296,647,943,67,1010
公投第１５案,臺中市,潭子區,頭家里,587,1894,326,707,1033,36,1069
公投第１５案,臺中市,潭子區,頭家里,588,1689,315,625,940,38,978
公投第１５案,臺中市,潭子區,頭家東里,589,1525,246,535,781,43,824
公投第１５案,臺中市,潭子區,頭家東里,590,1622,274,612,886,42,928
公投第１５案,臺中市,潭子區,頭家東里,591,1200,200,466,666,57,723
公投第１５案,臺中市,潭子區,家興里,592,1355,216,502,718,20,738
公投第１５案,臺中市,潭子區,家興里,593,1777,300,649,949,31,980
公投第１５案,臺中市,潭子區,家興里,594,1923,324,715,1039,39,1078
公投第１５案,臺中市,潭子區,家興里,595,1674,258,614,872,58,930
公投第１５案,臺中市,潭子區,家福里,596,1451,290,589,879,36,915
公投第１５案,臺中市,潭子區,家福里,597,1486,261,569,830,49,879
公投第１５案,臺中市,潭子區,家福里,598,1511,257,620,877,42,919
公投第１５案,臺中市,潭子區,甘蔗里,599,1666,292,657,949,49,998
公投第１５案,臺中市,潭子區,甘蔗里,600,1750,297,643,940,49,989
公投第１５案,臺中市,潭子區,甘蔗里,601,1437,226,560,786,32,818
公投第１５案,臺中市,潭子區,甘蔗里,602,1735,295,644,939,35,974
公投第１５案,臺中市,潭子區,甘蔗里,603,1612,284,594,878,37,915
公投第１５案,臺中市,潭子區,甘蔗里,604,1143,234,444,678,28,706
公投第１５案,臺中市,潭子區,東寶里,605,2096,338,775,1113,41,1154
公投第１５案,臺中市,潭子區,東寶里,606,1549,293,601,894,47,941
公投第１５案,臺中市,潭子區,東寶里,607,1573,263,639,902,32,934
公投第１５案,臺中市,潭子區,東寶里,608,1585,239,610,849,31,880
公投第１５案,臺中市,潭子區,東寶里,609,1572,280,582,862,32,894
公投第１５案,臺中市,潭子區,東寶里,610,1738,320,700,1020,35,1055
公投第１５案,臺中市,潭子區,東寶里,611,1883,388,609,997,57,1054
公投第１５案,臺中市,潭子區,大富里,612,1401,239,591,830,32,862
公投第１５案,臺中市,潭子區,大富里,613,1352,224,578,802,44,846
公投第１５案,臺中市,潭子區,大豐里,614,2085,329,833,1162,79,1241
公投第１５案,臺中市,潭子區,大豐里,615,2047,340,836,1176,66,1242
公投第１５案,臺中市,潭子區,大豐里,616,1673,300,581,881,32,913
公投第１５案,臺中市,潭子區,栗林里,617,1874,349,684,1033,80,1113
公投第１５案,臺中市,潭子區,栗林里,618,1051,200,386,586,54,640
公投第１５案,臺中市,潭子區,栗林里,619,1674,283,581,864,38,902
公投第１５案,臺中市,潭子區,嘉仁里,620,1831,308,711,1019,58,1077
公投第１５案,臺中市,潭子區,嘉仁里,621,2003,325,705,1030,68,1098
公投第１５案,臺中市,潭子區,新田里,622,1535,252,585,837,43,880
公投第１５案,臺中市,潭子區,聚興里,623,2286,301,791,1092,76,1168
公投第１５案,臺中市,潭子區,聚興里,624,1861,251,690,941,61,1002
公投第１５案,臺中市,西屯區,西安里,625,1638,359,625,984,38,1022
公投第１５案,臺中市,西屯區,西安里,626,1335,271,436,707,26,733
公投第１５案,臺中市,西屯區,西安里,627,1776,368,649,1017,40,1057
公投第１５案,臺中市,西屯區,至善里,628,1351,271,489,760,24,784
公投第１５案,臺中市,西屯區,至善里,629,1338,283,501,784,35,819
公投第１５案,臺中市,西屯區,至善里,630,1582,338,545,883,85,968
公投第１５案,臺中市,西屯區,西平里,631,1710,254,629,883,33,916
公投第１５案,臺中市,西屯區,西平里,632,1595,275,538,813,39,852
公投第１５案,臺中市,西屯區,西平里,633,1585,264,611,875,53,928
公投第１５案,臺中市,西屯區,西墩里,634,1749,313,615,928,57,985
公投第１５案,臺中市,西屯區,西墩里,635,1877,346,710,1056,39,1095
公投第１５案,臺中市,西屯區,西墩里,636,1697,326,567,893,40,933
公投第１５案,臺中市,西屯區,潮洋里,637,1480,301,573,874,33,907
公投第１５案,臺中市,西屯區,潮洋里,638,1483,362,576,938,47,985
公投第１５案,臺中市,西屯區,潮洋里,639,2484,307,565,872,34,906
公投第１５案,臺中市,西屯區,龍潭里,640,781,149,343,492,33,525
公投第１５案,臺中市,西屯區,惠來里,641,1477,282,571,853,44,897
公投第１５案,臺中市,西屯區,惠來里,642,1784,340,632,972,31,1003
公投第１５案,臺中市,西屯區,惠來里,643,1686,302,638,940,24,964
公投第１５案,臺中市,西屯區,惠來里,644,1692,334,602,936,26,962
公投第１５案,臺中市,西屯區,惠來里,645,1659,295,588,883,24,907
公投第１５案,臺中市,西屯區,惠來里,646,1648,358,600,958,25,983
公投第１５案,臺中市,西屯區,惠來里,647,1536,344,575,919,23,942
公投第１５案,臺中市,西屯區,惠來里,648,1666,321,640,961,40,1001
公投第１５案,臺中市,西屯區,上石里,649,1428,292,528,820,37,857
公投第１５案,臺中市,西屯區,上石里,650,1810,330,611,941,45,986
公投第１５案,臺中市,西屯區,上石里,651,1574,310,559,869,28,897
公投第１５案,臺中市,西屯區,上安里,652,1650,330,606,936,18,954
公投第１５案,臺中市,西屯區,上安里,653,1681,341,583,924,48,972
公投第１５案,臺中市,西屯區,上安里,654,1656,322,567,889,37,926
公投第１５案,臺中市,西屯區,上德里,655,1243,231,489,720,44,764
公投第１５案,臺中市,西屯區,上德里,656,1471,410,482,892,55,947
公投第１５案,臺中市,西屯區,上德里,657,1431,311,550,861,34,895
公投第１５案,臺中市,西屯區,逢甲里,658,1714,326,627,953,27,980
公投第１５案,臺中市,西屯區,逢甲里,659,1424,233,570,803,41,844
公投第１５案,臺中市,西屯區,逢甲里,660,1176,260,401,661,39,700
公投第１５案,臺中市,西屯區,逢福里,661,1456,293,548,841,42,883
公投第１５案,臺中市,西屯區,逢福里,662,1451,329,561,890,24,914
公投第１５案,臺中市,西屯區,逢福里,663,1063,237,442,679,18,697
公投第１５案,臺中市,西屯區,逢福里,664,1357,220,537,757,41,798
公投第１５案,臺中市,西屯區,鵬程里,665,1355,120,579,699,55,754
公投第１５案,臺中市,西屯區,鵬程里,666,1384,220,610,830,26,856
公投第１５案,臺中市,西屯區,何厝里,667,1613,326,598,924,43,967
公投第１５案,臺中市,西屯區,何厝里,668,1562,292,575,867,39,906
公投第１５案,臺中市,西屯區,何明里,669,1219,269,498,767,36,803
公投第１５案,臺中市,西屯區,何明里,670,1235,276,437,713,28,741
公投第１５案,臺中市,西屯區,何明里,671,1131,249,388,637,39,676
公投第１５案,臺中市,西屯區,何南里,672,1494,332,580,912,28,940
公投第１５案,臺中市,西屯區,何南里,673,1325,302,463,765,23,788
公投第１５案,臺中市,西屯區,何南里,674,1386,309,485,794,38,832
公投第１５案,臺中市,西屯區,何成里,675,1816,475,542,1017,60,1077
公投第１５案,臺中市,西屯區,何成里,676,1734,327,592,919,24,943
公投第１５案,臺中市,西屯區,何成里,677,1777,398,612,1010,59,1069
公投第１５案,臺中市,西屯區,何成里,678,1818,363,587,950,45,995
公投第１５案,臺中市,西屯區,何安里,679,1699,313,591,904,60,964
公投第１５案,臺中市,西屯區,何安里,680,1715,285,593,878,34,912
公投第１５案,臺中市,西屯區,何安里,681,1654,323,549,872,32,904
公投第１５案,臺中市,西屯區,何仁里,682,1636,316,580,896,16,912
公投第１５案,臺中市,西屯區,何仁里,683,1298,283,438,721,17,738
公投第１５案,臺中市,西屯區,何仁里,684,1391,276,519,795,46,841
公投第１５案,臺中市,西屯區,何仁里,685,1853,366,694,1060,38,1098
公投第１５案,臺中市,西屯區,何德里,686,1820,330,632,962,46,1008
公投第１５案,臺中市,西屯區,何德里,687,1809,359,658,1017,39,1056
公投第１５案,臺中市,西屯區,何福里,688,1352,263,539,802,42,844
公投第１５案,臺中市,西屯區,何福里,689,1521,267,584,851,41,892
公投第１５案,臺中市,西屯區,何福里,690,1486,296,591,887,26,913
公投第１５案,臺中市,西屯區,何源里,691,1674,331,620,951,41,992
公投第１５案,臺中市,西屯區,何源里,692,1610,328,637,965,43,1008
公投第１５案,臺中市,西屯區,何源里,693,1695,345,598,943,43,986
公投第１５案,臺中市,西屯區,何源里,694,1684,341,555,896,36,932
公投第１５案,臺中市,西屯區,大河里,695,1221,236,488,724,27,751
公投第１５案,臺中市,西屯區,大河里,696,1252,249,563,812,42,854
公投第１５案,臺中市,西屯區,大河里,697,1301,270,498,768,51,819
公投第１５案,臺中市,西屯區,大石里,698,1049,146,493,639,29,668
公投第１５案,臺中市,西屯區,大石里,699,1113,161,485,646,30,676
公投第１５案,臺中市,西屯區,大福里,700,1557,217,588,805,51,856
公投第１５案,臺中市,西屯區,大福里,701,1640,274,592,866,43,909
公投第１５案,臺中市,西屯區,大鵬里,702,1402,288,591,879,61,940
公投第１５案,臺中市,西屯區,大鵬里,703,1717,276,576,852,56,908
公投第１５案,臺中市,西屯區,大鵬里,704,1688,289,621,910,60,970
公投第１５案,臺中市,西屯區,港尾里,705,1168,197,437,634,89,723
公投第１５案,臺中市,西屯區,港尾里,706,1729,283,628,911,43,954
公投第１５案,臺中市,西屯區,港尾里,707,2007,338,698,1036,39,1075
公投第１５案,臺中市,西屯區,廣福里,708,1296,268,462,730,69,799
公投第１５案,臺中市,西屯區,廣福里,709,1068,180,370,550,21,571
公投第１５案,臺中市,西屯區,林厝里,710,1707,270,578,848,61,909
公投第１５案,臺中市,西屯區,林厝里,711,1636,329,606,935,36,971
公投第１５案,臺中市,西屯區,永安里,712,1761,294,540,834,25,859
公投第１５案,臺中市,西屯區,永安里,713,1314,274,478,752,29,781
公投第１５案,臺中市,西屯區,永安里,714,1233,267,502,769,23,792
公投第１５案,臺中市,西屯區,永安里,715,1549,264,558,822,32,854
公投第１５案,臺中市,西屯區,永安里,716,1639,285,591,876,21,897
公投第１５案,臺中市,西屯區,永安里,717,1486,205,577,782,29,811
公投第１５案,臺中市,西屯區,永安里,718,1806,374,588,962,24,986
公投第１５案,臺中市,西屯區,永安里,719,1451,303,476,779,12,791
公投第１５案,臺中市,西屯區,福安里,720,1302,242,516,758,17,775
公投第１５案,臺中市,西屯區,福安里,721,1353,300,502,802,45,847
公投第１５案,臺中市,西屯區,福雅里,722,2162,411,802,1213,52,1265
公投第１５案,臺中市,西屯區,福雅里,723,1520,280,546,826,34,860
公投第１５案,臺中市,西屯區,福雅里,724,1935,352,691,1043,38,1081
公投第１５案,臺中市,西屯區,福林里,725,1847,369,659,1028,36,1064
公投第１５案,臺中市,西屯區,福林里,726,1738,406,597,1003,24,1027
公投第１５案,臺中市,西屯區,福林里,727,1640,345,630,975,34,1009
公投第１５案,臺中市,西屯區,福林里,728,1908,396,662,1058,33,1091
公投第１５案,臺中市,西屯區,福瑞里,729,1402,314,482,796,23,819
公投第１５案,臺中市,西屯區,福瑞里,730,1515,296,489,785,32,817
公投第１５案,臺中市,西屯區,福聯里,731,1541,259,461,720,33,753
公投第１５案,臺中市,西屯區,福聯里,732,1502,319,487,806,27,833
公投第１５案,臺中市,西屯區,福和里,733,1526,334,524,858,54,912
公投第１５案,臺中市,西屯區,福和里,734,1425,303,512,815,58,873
公投第１５案,臺中市,西屯區,福和里,735,1334,274,527,801,29,830
公投第１５案,臺中市,西屯區,福中里,736,1649,344,624,968,39,1007
公投第１５案,臺中市,西屯區,福中里,737,1566,307,576,883,33,916
公投第１５案,臺中市,西屯區,福恩里,738,1629,348,624,972,26,998
公投第１５案,臺中市,西屯區,福恩里,739,1628,341,595,936,32,968
公投第１５案,臺中市,西屯區,福恩里,740,1442,315,546,861,29,890
公投第１５案,臺中市,西屯區,協和里,741,1206,241,399,640,34,674
公投第１５案,臺中市,西屯區,協和里,742,1086,185,446,631,59,690
公投第１５案,臺中市,西屯區,協和里,743,1088,209,473,682,35,717
公投第１５案,臺中市,西屯區,協和里,744,1140,239,428,667,23,690
公投第１５案,臺中市,南屯區,南屯里,745,1321,256,513,769,41,810
公投第１５案,臺中市,南屯區,南屯里,746,1346,292,498,790,56,846
公投第１５案,臺中市,南屯區,南屯里,747,1428,257,571,828,43,871
公投第１５案,臺中市,南屯區,南屯里,748,1442,278,528,806,28,834
公投第１５案,臺中市,南屯區,南屯里,749,1408,292,594,886,20,906
公投第１５案,臺中市,南屯區,南屯里,750,1404,287,553,840,23,863
公投第１５案,臺中市,南屯區,豐樂里,751,1354,268,556,824,39,863
公投第１５案,臺中市,南屯區,豐樂里,752,1332,309,493,802,36,838
公投第１５案,臺中市,南屯區,豐樂里,753,1463,331,568,899,27,926
公投第１５案,臺中市,南屯區,豐樂里,754,1413,305,497,802,49,851
公投第１５案,臺中市,南屯區,豐樂里,755,1218,292,472,764,25,789
公投第１５案,臺中市,南屯區,豐樂里,756,1308,262,500,762,31,793
公投第１５案,臺中市,南屯區,豐樂里,757,1527,335,604,939,37,976
公投第１５案,臺中市,南屯區,豐樂里,758,1294,304,485,789,33,822
公投第１５案,臺中市,南屯區,楓樹里,759,1516,264,522,786,27,813
公投第１５案,臺中市,南屯區,楓樹里,760,1529,297,589,886,63,949
公投第１５案,臺中市,南屯區,楓樹里,761,1397,248,565,813,50,863
公投第１５案,臺中市,南屯區,楓樹里,762,1406,234,530,764,32,796
公投第１５案,臺中市,南屯區,中和里,763,1497,251,542,793,34,827
公投第１５案,臺中市,南屯區,中和里,764,1424,257,515,772,58,830
公投第１５案,臺中市,南屯區,中和里,765,1488,273,448,721,46,767
公投第１５案,臺中市,南屯區,鎮平里,766,608,123,234,357,50,407
公投第１５案,臺中市,南屯區,鎮平里,767,813,154,325,479,57,536
公投第１５案,臺中市,南屯區,春社里,768,1190,230,459,689,49,738
公投第１５案,臺中市,南屯區,春社里,769,1174,189,454,643,34,677
公投第１５案,臺中市,南屯區,春社里,770,1224,237,470,707,13,720
公投第１５案,臺中市,南屯區,春社里,771,1466,212,475,687,47,734
公投第１５案,臺中市,南屯區,春社里,772,1333,143,408,551,24,575
公投第１５案,臺中市,南屯區,春安里,773,814,157,321,478,44,522
公投第１５案,臺中市,南屯區,文山里,774,1436,217,545,762,42,804
公投第１５案,臺中市,南屯區,文山里,775,1515,309,549,858,45,903
公投第１５案,臺中市,南屯區,文山里,776,1545,240,476,716,81,797
公投第１５案,臺中市,南屯區,文山里,777,1383,258,522,780,35,815
公投第１５案,臺中市,南屯區,文山里,778,1433,269,567,836,26,862
公投第１５案,臺中市,南屯區,文山里,779,1134,221,377,598,31,629
公投第１５案,臺中市,南屯區,文山里,780,1216,238,495,733,28,761
公投第１５案,臺中市,南屯區,寶山里,781,1271,241,429,670,65,735
公投第１５案,臺中市,南屯區,寶山里,782,1203,221,428,649,21,670
公投第１５案,臺中市,南屯區,寶山里,783,1268,246,476,722,23,745
公投第１５案,臺中市,南屯區,寶山里,784,1390,240,552,792,39,831
公投第１５案,臺中市,南屯區,新生里,785,1397,271,493,764,44,808
公投第１５案,臺中市,南屯區,永定里,786,1607,285,583,868,58,926
公投第１５案,臺中市,南屯區,永定里,787,1582,304,610,914,37,951
公投第１５案,臺中市,南屯區,永定里,788,1611,274,655,929,42,971
公投第１５案,臺中市,南屯區,三厝里,789,1322,281,533,814,29,843
公投第１５案,臺中市,南屯區,三厝里,790,1321,283,542,825,34,859
公投第１５案,臺中市,南屯區,三厝里,791,1360,256,540,796,34,830
公投第１５案,臺中市,南屯區,三厝里,792,1361,273,556,829,12,841
公投第１５案,臺中市,南屯區,三厝里,793,1257,296,485,781,19,800
公投第１５案,臺中市,南屯區,三義里,794,1207,266,490,756,27,783
公投第１５案,臺中市,南屯區,三義里,795,1282,298,501,799,22,821
公投第１５案,臺中市,南屯區,三義里,796,1248,304,489,793,29,822
公投第１５案,臺中市,南屯區,三義里,797,1304,304,505,809,42,851
公投第１５案,臺中市,南屯區,三義里,798,1214,248,477,725,20,745
公投第１５案,臺中市,南屯區,三和里,799,1102,260,423,683,28,711
公投第１５案,臺中市,南屯區,三和里,800,1630,328,685,1013,39,1052
公投第１５案,臺中市,南屯區,三和里,801,1333,302,498,800,31,831
公投第１５案,臺中市,南屯區,三和里,802,1292,294,505,799,22,821
公投第１５案,臺中市,南屯區,三和里,803,1272,258,503,761,30,791
公投第１５案,臺中市,南屯區,三和里,804,1345,287,509,796,22,818
公投第１５案,臺中市,南屯區,黎明里,805,981,212,427,639,52,691
公投第１５案,臺中市,南屯區,黎明里,806,1097,200,446,646,55,701
公投第１５案,臺中市,南屯區,黎明里,807,991,189,433,622,27,649
公投第１５案,臺中市,南屯區,黎明里,808,1170,213,482,695,28,723
公投第１５案,臺中市,南屯區,溝墘里,809,1171,268,448,716,35,751
公投第１５案,臺中市,南屯區,溝墘里,810,1349,279,468,747,50,797
公投第１５案,臺中市,南屯區,溝墘里,811,1368,291,551,842,32,874
公投第１５案,臺中市,南屯區,溝墘里,812,1263,290,511,801,20,821
公投第１５案,臺中市,南屯區,大業里,813,1547,350,567,917,44,961
公投第１５案,臺中市,南屯區,大業里,814,1649,362,582,944,44,988
公投第１５案,臺中市,南屯區,大業里,815,1629,331,576,907,30,937
公投第１５案,臺中市,南屯區,大業里,816,1580,328,474,802,38,840
公投第１５案,臺中市,南屯區,惠中里,817,1444,323,592,915,34,949
公投第１５案,臺中市,南屯區,惠中里,818,1413,279,535,814,21,835
公投第１５案,臺中市,南屯區,惠中里,819,1377,240,526,766,37,803
公投第１５案,臺中市,南屯區,惠中里,820,1527,370,533,903,33,936
公投第１５案,臺中市,南屯區,惠中里,821,1335,290,526,816,29,845
公投第１５案,臺中市,南屯區,田心里,822,1544,378,630,1008,28,1036
公投第１５案,臺中市,南屯區,田心里,823,1482,349,589,938,35,973
公投第１５案,臺中市,南屯區,田心里,824,1488,276,607,883,49,932
公投第１５案,臺中市,南屯區,田心里,825,1538,272,502,774,42,816
公投第１５案,臺中市,南屯區,向心里,826,1674,351,655,1006,54,1060
公投第１５案,臺中市,南屯區,向心里,827,1996,315,516,831,37,868
公投第１５案,臺中市,南屯區,向心里,828,1514,276,588,864,56,920
公投第１５案,臺中市,南屯區,文心里,829,1217,234,506,740,45,785
公投第１５案,臺中市,南屯區,文心里,830,1347,295,470,765,38,803
公投第１５案,臺中市,南屯區,文心里,831,1109,214,457,671,24,695
公投第１５案,臺中市,南屯區,同心里,832,1546,320,558,878,25,903
公投第１５案,臺中市,南屯區,同心里,833,1408,310,553,863,43,906
公投第１５案,臺中市,南屯區,同心里,834,1057,164,413,577,27,604
公投第１５案,臺中市,南屯區,同心里,835,1133,234,406,640,54,694
公投第１５案,臺中市,南屯區,大同里,836,1278,403,380,783,26,809
公投第１５案,臺中市,南屯區,大同里,837,1144,261,455,716,41,757
公投第１５案,臺中市,南屯區,大同里,838,1140,259,414,673,38,711
公投第１５案,臺中市,南屯區,大同里,839,1171,167,547,714,25,739
公投第１５案,臺中市,南屯區,大興里,840,1303,285,524,809,33,842
公投第１５案,臺中市,南屯區,大興里,841,1402,267,503,770,29,799
公投第１５案,臺中市,南屯區,大興里,842,1571,286,584,870,51,921
公投第１５案,臺中市,南屯區,大誠里,843,1139,283,430,713,23,736
公投第１５案,臺中市,南屯區,大誠里,844,1216,259,502,761,25,786
公投第１５案,臺中市,南屯區,大誠里,845,1162,233,476,709,33,742
公投第１５案,臺中市,北屯區,北屯里,846,1670,323,645,968,54,1022
公投第１５案,臺中市,北屯區,北屯里,847,1706,606,285,891,47,938
公投第１５案,臺中市,北屯區,北京里,848,1507,292,539,831,51,882
公投第１５案,臺中市,北屯區,北京里,849,1652,336,602,938,51,989
公投第１５案,臺中市,北屯區,北興里,850,1107,204,398,602,17,619
公投第１５案,臺中市,北屯區,北興里,851,2151,271,844,1115,48,1163
公投第１５案,臺中市,北屯區,三光里,852,1612,309,642,951,30,981
公投第１５案,臺中市,北屯區,三光里,853,1743,306,641,947,42,989
公投第１５案,臺中市,北屯區,三光里,854,2099,375,741,1116,33,1149
公投第１５案,臺中市,北屯區,三光里,855,1595,297,599,896,22,918
公投第１５案,臺中市,北屯區,三和里,856,1923,322,654,976,40,1016
公投第１５案,臺中市,北屯區,三和里,857,1641,260,593,853,53,906
公投第１５案,臺中市,北屯區,三和里,858,1157,249,471,720,28,748
公投第１５案,臺中市,北屯區,三和里,859,1041,210,428,638,26,664
公投第１５案,臺中市,北屯區,東光里,860,1563,264,548,812,36,848
公投第１５案,臺中市,北屯區,東光里,861,1559,234,561,795,46,841
公投第１５案,臺中市,北屯區,東光里,862,1411,192,516,708,18,726
公投第１５案,臺中市,北屯區,水景里,863,1761,344,646,990,33,1023
公投第１５案,臺中市,北屯區,水景里,864,1361,248,564,812,53,865
公投第１５案,臺中市,北屯區,水景里,865,1852,292,706,998,53,1051
公投第１５案,臺中市,北屯區,水景里,866,1928,343,742,1085,38,1123
公投第１５案,臺中市,北屯區,水景里,867,1492,291,635,926,34,960
公投第１５案,臺中市,北屯區,水景里,868,1998,314,731,1045,56,1101
公投第１５案,臺中市,北屯區,水景里,869,1272,254,536,790,34,824
公投第１５案,臺中市,北屯區,水景里,870,1317,254,521,775,34,809
公投第１５案,臺中市,北屯區,軍功里,871,1327,209,445,654,53,707
公投第１５案,臺中市,北屯區,軍功里,872,1280,254,369,623,24,647
公投第１５案,臺中市,北屯區,軍功里,873,1865,288,656,944,46,990
公投第１５案,臺中市,北屯區,軍功里,874,1230,243,508,751,42,793
公投第１５案,臺中市,北屯區,軍功里,875,1356,234,475,709,34,743
公投第１５案,臺中市,北屯區,軍功里,876,1732,311,645,956,35,991
公投第１５案,臺中市,北屯區,軍功里,877,1586,327,591,918,29,947
公投第１５案,臺中市,北屯區,軍功里,878,1441,299,501,800,25,825
公投第１５案,臺中市,北屯區,和平里,879,2045,351,693,1044,65,1109
公投第１５案,臺中市,北屯區,和平里,880,1914,335,623,958,46,1004
公投第１５案,臺中市,北屯區,和平里,881,1918,331,729,1060,40,1100
公投第１５案,臺中市,北屯區,和平里,882,2079,328,724,1052,32,1084
公投第１５案,臺中市,北屯區,和平里,883,2040,380,747,1127,40,1167
公投第１５案,臺中市,北屯區,廍子里,884,2027,340,628,968,42,1010
公投第１５案,臺中市,北屯區,廍子里,885,1402,208,539,747,38,785
公投第１５案,臺中市,北屯區,廍子里,886,1826,342,672,1014,47,1061
公投第１５案,臺中市,北屯區,廍子里,887,2162,365,703,1068,29,1097
公投第１５案,臺中市,北屯區,廍子里,888,2332,404,698,1102,18,1120
公投第１５案,臺中市,北屯區,民政里,889,985,132,400,532,50,582
公投第１５案,臺中市,北屯區,東山里,890,2037,315,711,1026,40,1066
公投第１５案,臺中市,北屯區,大坑里,891,1032,174,421,595,35,630
公投第１５案,臺中市,北屯區,大坑里,892,1062,192,410,602,31,633
公投第１５案,臺中市,北屯區,民德里,893,909,151,332,483,33,516
公投第１５案,臺中市,北屯區,舊社里,894,1445,289,548,837,46,883
公投第１５案,臺中市,北屯區,舊社里,895,1842,326,550,876,38,914
公投第１５案,臺中市,北屯區,舊社里,896,1187,234,458,692,26,718
公投第１５案,臺中市,北屯區,舊社里,897,1456,257,560,817,40,857
公投第１５案,臺中市,北屯區,松茂里,898,1866,322,706,1028,52,1080
公投第１５案,臺中市,北屯區,松茂里,899,1667,281,578,859,46,905
公投第１５案,臺中市,北屯區,松茂里,900,1683,322,653,975,22,997
公投第１５案,臺中市,北屯區,松強里,901,1642,333,569,902,20,922
公投第１５案,臺中市,北屯區,松強里,902,1475,297,568,865,19,884
公投第１５案,臺中市,北屯區,松強里,903,1644,284,606,890,20,910
公投第１５案,臺中市,北屯區,松強里,904,1603,329,621,950,26,976
公投第１５案,臺中市,北屯區,松勇里,905,1949,372,726,1098,67,1165
公投第１５案,臺中市,北屯區,松勇里,906,1790,349,744,1093,35,1128
公投第１５案,臺中市,北屯區,松勇里,907,1440,312,511,823,33,856
公投第１５案,臺中市,北屯區,松安里,908,1601,333,603,936,45,981
公投第１５案,臺中市,北屯區,松安里,909,1527,249,554,803,53,856
公投第１５案,臺中市,北屯區,松安里,910,1675,278,573,851,41,892
公投第１５案,臺中市,北屯區,松和里,911,1579,251,519,770,40,810
公投第１５案,臺中市,北屯區,松和里,912,1524,245,580,825,58,883
公投第１５案,臺中市,北屯區,松和里,913,1677,286,602,888,33,921
公投第１５案,臺中市,北屯區,松和里,914,1599,315,552,867,36,903
公投第１５案,臺中市,北屯區,松竹里,915,1458,323,516,839,49,888
公投第１５案,臺中市,北屯區,松竹里,916,1571,338,574,912,37,949
公投第１５案,臺中市,北屯區,松竹里,917,1579,304,597,901,47,948
公投第１５案,臺中市,北屯區,松竹里,918,1849,370,673,1043,44,1087
公投第１５案,臺中市,北屯區,松竹里,919,1682,336,603,939,28,967
公投第１５案,臺中市,北屯區,平興里,920,1760,304,644,948,26,974
公投第１５案,臺中市,北屯區,平興里,921,1699,327,613,940,50,990
公投第１５案,臺中市,北屯區,平興里,922,1626,355,630,985,47,1032
公投第１５案,臺中市,北屯區,平興里,923,1491,329,560,889,6,895
公投第１５案,臺中市,北屯區,平田里,924,1640,316,582,898,30,928
公投第１５案,臺中市,北屯區,平田里,925,2052,378,615,993,0,993
公投第１５案,臺中市,北屯區,平田里,926,1875,319,660,979,49,1028
公投第１５案,臺中市,北屯區,平昌里,927,1559,284,570,854,33,887
公投第１５案,臺中市,北屯區,平昌里,928,1480,293,539,832,52,884
公投第１５案,臺中市,北屯區,平昌里,929,1397,274,520,794,52,846
公投第１５案,臺中市,北屯區,平安里,930,1889,349,718,1067,30,1097
公投第１５案,臺中市,北屯區,平安里,931,1728,324,595,919,56,975
公投第１５案,臺中市,北屯區,平安里,932,1592,288,557,845,56,901
公投第１５案,臺中市,北屯區,平順里,933,1656,313,556,869,45,914
公投第１５案,臺中市,北屯區,平順里,934,1524,280,521,801,32,833
公投第１５案,臺中市,北屯區,平心里,935,1502,295,565,860,35,895
公投第１５案,臺中市,北屯區,平心里,936,1772,305,654,959,35,994
公投第１５案,臺中市,北屯區,平心里,937,1461,310,534,844,39,883
公投第１５案,臺中市,北屯區,平福里,938,1769,298,612,910,13,923
公投第１５案,臺中市,北屯區,平福里,939,1894,427,652,1079,51,1130
公投第１５案,臺中市,北屯區,平德里,940,2033,341,687,1028,49,1077
公投第１５案,臺中市,北屯區,平德里,941,1947,368,658,1026,40,1066
公投第１５案,臺中市,北屯區,平德里,942,2188,428,782,1210,60,1270
公投第１５案,臺中市,北屯區,平和里,943,1661,364,584,948,60,1008
公投第１５案,臺中市,北屯區,平和里,944,1667,319,629,948,32,980
公投第１５案,臺中市,北屯區,平和里,945,1728,302,638,940,38,978
公投第１５案,臺中市,北屯區,平陽里,946,1688,287,621,908,36,944
公投第１５案,臺中市,北屯區,平陽里,947,1475,301,524,825,23,848
公投第１５案,臺中市,北屯區,平陽里,948,1681,371,648,1019,31,1050
公投第１５案,臺中市,北屯區,仁和里,949,2078,418,765,1183,46,1229
公投第１５案,臺中市,北屯區,仁和里,950,2059,358,764,1122,42,1164
公投第１５案,臺中市,北屯區,仁和里,951,1792,361,631,992,55,1047
公投第１５案,臺中市,北屯區,仁和里,952,2974,362,668,1030,29,1059
公投第１５案,臺中市,北屯區,仁愛里,953,1072,200,392,592,38,630
公投第１５案,臺中市,北屯區,仁美里,954,2099,406,835,1241,39,1280
公投第１５案,臺中市,北屯區,仁美里,955,1823,401,733,1134,47,1181
公投第１５案,臺中市,北屯區,仁美里,956,2022,390,781,1171,72,1243
公投第１５案,臺中市,北屯區,仁美里,957,1992,365,759,1124,30,1154
公投第１５案,臺中市,北屯區,四民里,958,1585,229,693,922,58,980
公投第１５案,臺中市,北屯區,同榮里,959,1565,304,616,920,40,960
公投第１５案,臺中市,北屯區,同榮里,960,1780,272,633,905,45,950
公投第１５案,臺中市,北屯區,同榮里,961,1874,358,752,1110,45,1155
公投第１５案,臺中市,北屯區,后庄里,962,1755,300,722,1022,41,1063
公投第１５案,臺中市,北屯區,后庄里,963,1497,347,641,988,30,1018
公投第１５案,臺中市,北屯區,后庄里,964,1567,286,656,942,52,994
公投第１５案,臺中市,北屯區,后庄里,965,1624,279,613,892,28,920
公投第１５案,臺中市,北屯區,后庄里,966,1614,286,658,944,48,992
公投第１５案,臺中市,北屯區,后庄里,967,1595,303,590,893,25,918
公投第１５案,臺中市,北屯區,新平里,968,1782,345,549,894,64,958
公投第１５案,臺中市,北屯區,新平里,969,1357,222,476,698,32,730
公投第１５案,臺中市,北屯區,新平里,970,1071,165,400,565,60,625
公投第１５案,臺中市,北屯區,陳平里,971,1372,227,500,727,41,768
公投第１５案,臺中市,北屯區,陳平里,972,1415,255,543,798,52,850
公投第１５案,臺中市,北屯區,陳平里,973,1789,346,724,1070,48,1118
公投第１５案,臺中市,北屯區,忠平里,974,1907,228,899,1127,66,1193
公投第１５案,臺中市,北屯區,忠平里,975,2008,348,798,1146,37,1183
公投第１５案,臺中市,北屯區,大德里,976,1541,262,577,839,47,886
公投第１５案,臺中市,北屯區,大德里,977,1669,308,652,960,39,999
公投第１５案,臺中市,北屯區,大德里,978,1685,285,664,949,33,982
公投第１５案,臺中市,北屯區,水湳里,979,1785,331,673,1004,62,1066
公投第１５案,臺中市,北屯區,水湳里,980,1596,254,679,933,49,982
公投第１５案,臺中市,北屯區,水湳里,981,1731,347,642,989,62,1051
公投第１５案,臺中市,北屯區,水湳里,982,1496,254,529,783,69,852
公投第１５案,臺中市,北區,中正里,983,1437,270,486,756,31,787
公投第１５案,臺中市,北區,六合里,984,1708,291,547,838,75,913
公投第１５案,臺中市,北區,光大里,985,1051,185,338,523,37,560
公投第１５案,臺中市,北區,光大里,986,996,192,351,543,41,584
公投第１５案,臺中市,北區,文莊里,987,1504,248,619,867,20,887
公投第１５案,臺中市,北區,文莊里,988,975,193,364,557,48,605
公投第１５案,臺中市,北區,文莊里,989,886,167,329,496,28,524
公投第１５案,臺中市,北區,大湖里,990,1276,233,339,572,34,606
公投第１５案,臺中市,北區,大湖里,991,938,185,300,485,27,512
公投第１５案,臺中市,北區,五常里,992,1404,250,472,722,56,778
公投第１５案,臺中市,北區,錦平里,993,996,197,350,547,16,563
公投第１５案,臺中市,北區,錦平里,994,869,183,276,459,41,500
公投第１５案,臺中市,北區,新北里,995,704,150,273,423,22,445
公投第１５案,臺中市,北區,新北里,996,979,168,354,522,22,544
公投第１５案,臺中市,北區,新興里,997,773,135,262,397,13,410
公投第１５案,臺中市,北區,新興里,998,759,148,306,454,16,470
公投第１５案,臺中市,北區,樂英里,999,1438,204,600,804,40,844
公投第１５案,臺中市,北區,樂英里,1000,1212,172,449,621,23,644
公投第１５案,臺中市,北區,錦村里,1001,1731,330,631,961,32,993
公投第１５案,臺中市,北區,錦村里,1002,1445,257,606,863,37,900
公投第１５案,臺中市,北區,建成里,1003,1855,351,657,1008,44,1052
公投第１５案,臺中市,北區,建成里,1004,1728,275,565,840,42,882
公投第１５案,臺中市,北區,建成里,1005,1878,304,590,894,46,940
公投第１５案,臺中市,北區,建德里,1006,1793,277,604,881,60,941
公投第１５案,臺中市,北區,建德里,1007,1555,275,587,862,50,912
公投第１５案,臺中市,北區,錦洲里,1008,1761,213,658,871,15,886
公投第１５案,臺中市,北區,錦洲里,1009,1579,237,601,838,34,872
公投第１５案,臺中市,北區,錦祥里,1010,2192,388,744,1132,56,1188
公投第１５案,臺中市,北區,錦祥里,1011,1560,320,578,898,39,937
公投第１５案,臺中市,北區,金華里,1012,1476,268,551,819,32,851
公投第１５案,臺中市,北區,金華里,1013,1006,202,407,609,17,626
公投第１５案,臺中市,北區,金龍里,1014,1403,236,539,775,46,821
公投第１５案,臺中市,北區,金龍里,1015,1446,250,506,756,23,779
公投第１５案,臺中市,北區,金龍里,1016,1460,292,497,789,32,821
公投第１５案,臺中市,北區,邱厝里,1017,1233,249,456,705,18,723
公投第１５案,臺中市,北區,邱厝里,1018,1027,241,421,662,17,679
公投第１５案,臺中市,北區,建興里,1019,1207,262,427,689,22,711
公投第１５案,臺中市,北區,建興里,1020,1167,258,442,700,22,722
公投第１５案,臺中市,北區,建興里,1021,1150,231,402,633,31,664
公投第１５案,臺中市,北區,建興里,1022,1061,207,377,584,40,624
公投第１５案,臺中市,北區,建興里,1023,1005,223,367,590,21,611
公投第１５案,臺中市,北區,頂厝里,1024,1250,370,436,806,11,817
公投第１５案,臺中市,北區,頂厝里,1025,1448,290,534,824,50,874
公投第１５案,臺中市,北區,頂厝里,1026,1379,287,497,784,45,829
公投第１５案,臺中市,北區,崇德里,1027,1652,326,591,917,43,960
公投第１５案,臺中市,北區,崇德里,1028,1867,360,627,987,33,1020
公投第１５案,臺中市,北區,賴厝里,1029,2078,207,365,572,19,591
公投第１５案,臺中市,北區,賴厝里,1030,1562,280,630,910,34,944
公投第１５案,臺中市,北區,賴厝里,1031,1430,272,537,809,20,829
公投第１５案,臺中市,北區,賴福里,1032,2018,403,737,1140,33,1173
公投第１５案,臺中市,北區,賴福里,1033,1710,274,578,852,18,870
公投第１５案,臺中市,北區,賴興里,1034,1432,244,515,759,30,789
公投第１５案,臺中市,北區,賴興里,1035,1157,221,470,691,17,708
公投第１５案,臺中市,北區,賴興里,1036,1188,257,427,684,30,714
公投第１５案,臺中市,北區,賴旺里,1037,1419,244,535,779,28,807
公投第１５案,臺中市,北區,賴旺里,1038,1653,312,562,874,33,907
公投第１５案,臺中市,北區,賴旺里,1039,1233,263,436,699,35,734
公投第１５案,臺中市,北區,賴明里,1040,1243,255,452,707,19,726
公投第１５案,臺中市,北區,賴明里,1041,1219,218,416,634,17,651
公投第１５案,臺中市,北區,賴明里,1042,1272,270,455,725,33,758
公投第１５案,臺中市,北區,梅川里,1043,1285,263,483,746,19,765
公投第１５案,臺中市,北區,梅川里,1044,1780,364,652,1016,36,1052
公投第１５案,臺中市,北區,賴村里,1045,1461,261,472,733,28,761
公投第１５案,臺中市,北區,賴村里,1046,1310,234,526,760,30,790
公投第１５案,臺中市,北區,賴村里,1047,1669,357,532,889,28,917
公投第１５案,臺中市,北區,育德里,1048,1932,395,677,1072,47,1119
公投第１５案,臺中市,北區,育德里,1049,1682,319,600,919,30,949
公投第１５案,臺中市,北區,淡溝里,1050,1891,381,615,996,35,1031
公投第１５案,臺中市,北區,淡溝里,1051,1882,348,665,1013,51,1064
公投第１５案,臺中市,北區,淡溝里,1052,1159,215,411,626,36,662
公投第１５案,臺中市,北區,健行里,1053,1553,293,556,849,39,888
公投第１５案,臺中市,北區,健行里,1054,1607,320,538,858,35,893
公投第１５案,臺中市,北區,健行里,1055,1773,352,605,957,40,997
公投第１５案,臺中市,北區,健行里,1056,1524,303,533,836,40,876
公投第１５案,臺中市,北區,明德里,1057,1613,252,690,942,60,1002
公投第１５案,臺中市,北區,明德里,1058,1877,359,708,1067,45,1112
公投第１５案,臺中市,北區,明德里,1059,1792,352,633,985,48,1033
公投第１５案,臺中市,北區,明新里,1060,1392,251,522,773,51,824
公投第１５案,臺中市,北區,明新里,1061,1297,251,469,720,26,746
公投第１５案,臺中市,北區,長青里,1062,1556,336,561,897,37,934
公投第１５案,臺中市,北區,長青里,1063,1497,305,504,809,25,834
公投第１５案,臺中市,北區,長青里,1064,1550,271,569,840,45,885
公投第１５案,臺中市,北區,長青里,1065,1434,304,457,761,33,794
公投第１５案,臺中市,北區,立人里,1066,1793,370,625,995,47,1042
公投第１５案,臺中市,北區,立人里,1067,1866,385,641,1026,28,1054
公投第１５案,臺中市,北區,中達里,1068,1346,221,539,760,44,804
公投第１５案,臺中市,北區,中達里,1069,1267,239,450,689,46,735
公投第１５案,臺中市,中區,綠川里,1070,1652,344,602,946,79,1025
公投第１５案,臺中市,中區,繼光里,1071,1531,222,551,773,47,820
公投第１５案,臺中市,中區,公園里,1072,1431,215,568,783,27,810
公投第１５案,臺中市,中區,光復里,1073,1060,171,406,577,39,616
公投第１５案,臺中市,中區,光復里,1074,982,161,357,518,34,552
公投第１５案,臺中市,中區,大墩里,1075,1191,224,412,636,50,686
公投第１５案,臺中市,中區,大墩里,1076,855,171,286,457,36,493
公投第１５案,臺中市,中區,柳川里,1077,1135,161,354,515,28,543
公投第１５案,臺中市,中區,柳川里,1078,705,110,298,408,16,424
公投第１５案,臺中市,中區,大誠里,1079,1009,184,395,579,32,611
公投第１５案,臺中市,中區,大誠里,1080,1304,232,430,662,66,728
公投第１５案,臺中市,中區,中華里,1081,1841,292,609,901,31,932
公投第１５案,臺中市,西區,三民里,1082,1400,154,332,486,33,519
公投第１５案,臺中市,西區,三民里,1083,861,177,360,537,29,566
公投第１５案,臺中市,西區,利民里,1084,1416,306,523,829,35,864
公投第１５案,臺中市,西區,民生里,1085,1020,221,383,604,38,642
公投第１５案,臺中市,西區,民生里,1086,778,175,315,490,23,513
公投第１５案,臺中市,西區,廣民里,1087,1465,258,544,802,40,842
公投第１５案,臺中市,西區,平和里,1088,1017,174,408,582,20,602
公投第１５案,臺中市,西區,平和里,1089,868,188,316,504,26,530
公投第１５案,臺中市,西區,東昇里,1090,1251,281,486,767,44,811
公投第１５案,臺中市,西區,東昇里,1091,1044,245,409,654,34,688
公投第１５案,臺中市,西區,公民里,1092,1487,312,512,824,38,862
公投第１５案,臺中市,西區,公民里,1093,1573,338,548,886,42,928
公投第１５案,臺中市,西區,公民里,1094,1731,360,646,1006,43,1049
公投第１５案,臺中市,西區,藍興里,1095,1209,219,496,715,28,743
公投第１５案,臺中市,西區,藍興里,1096,1564,296,568,864,40,904
公投第１５案,臺中市,西區,藍興里,1097,1175,264,446,710,26,736
公投第１５案,臺中市,西區,公舘里,1098,1505,333,502,835,32,867
公投第１５案,臺中市,西區,公舘里,1099,1418,291,541,832,34,866
公投第１５案,臺中市,西區,公舘里,1100,1497,213,458,671,3,674
公投第１５案,臺中市,西區,公舘里,1101,1260,279,450,729,40,769
公投第１５案,臺中市,西區,安龍里,1102,1399,292,515,807,43,850
公投第１５案,臺中市,西區,安龍里,1103,1447,290,499,789,46,835
公投第１５案,臺中市,西區,吉龍里,1104,1683,349,594,943,41,984
公投第１５案,臺中市,西區,吉龍里,1105,1585,337,578,915,47,962
公投第１５案,臺中市,西區,吉龍里,1106,1557,393,535,928,31,959
公投第１５案,臺中市,西區,吉龍里,1107,1663,292,562,854,54,908
公投第１５案,臺中市,西區,土庫里,1108,1921,433,644,1077,48,1125
公投第１５案,臺中市,西區,土庫里,1109,1952,377,639,1016,34,1050
公投第１５案,臺中市,西區,土庫里,1110,1708,348,587,935,34,969
公投第１５案,臺中市,西區,大忠里,1111,1131,273,432,705,22,727
公投第１５案,臺中市,西區,大忠里,1112,1916,378,654,1032,37,1069
公投第１５案,臺中市,西區,大忠里,1113,1275,266,490,756,25,781
公投第１５案,臺中市,西區,民龍里,1114,1822,298,615,913,51,964
公投第１５案,臺中市,西區,民龍里,1115,1374,287,477,764,43,807
公投第１５案,臺中市,西區,和龍里,1116,1129,209,375,584,71,655
公投第１５案,臺中市,西區,和龍里,1117,1201,222,419,641,34,675
公投第１５案,臺中市,西區,後龍里,1118,1639,290,595,885,54,939
公投第１５案,臺中市,西區,後龍里,1119,1863,390,645,1035,55,1090
公投第１５案,臺中市,西區,双龍里,1120,1287,239,539,778,49,827
公投第１５案,臺中市,西區,双龍里,1121,1504,331,546,877,45,922
公投第１５案,臺中市,西區,昇平里,1122,1308,268,466,734,32,766
公投第１５案,臺中市,西區,昇平里,1123,1433,273,515,788,54,842
公投第１５案,臺中市,西區,昇平里,1124,1450,294,493,787,37,824
公投第１５案,臺中市,西區,昇平里,1125,1465,331,540,871,50,921
公投第１５案,臺中市,西區,中興里,1126,1818,314,628,942,52,994
公投第１５案,臺中市,西區,中興里,1127,1782,348,636,984,52,1036
公投第１５案,臺中市,西區,公益里,1128,1428,307,520,827,48,875
公投第１５案,臺中市,西區,公益里,1129,1366,232,468,700,28,728
公投第１５案,臺中市,西區,公德里,1130,1498,307,514,821,38,859
公投第１５案,臺中市,西區,公德里,1131,1350,304,501,805,25,830
公投第１５案,臺中市,西區,公德里,1132,1339,279,515,794,15,809
公投第１５案,臺中市,西區,公正里,1133,1613,328,601,929,37,966
公投第１５案,臺中市,西區,公正里,1134,1454,316,498,814,43,857
公投第１５案,臺中市,西區,公正里,1135,1597,361,593,954,31,985
公投第１５案,臺中市,西區,公正里,1136,1411,326,519,845,52,897
公投第１５案,臺中市,西區,公平里,1137,1493,310,532,842,52,894
公投第１５案,臺中市,西區,公平里,1138,1600,293,650,943,42,985
公投第１５案,臺中市,西區,公平里,1139,1710,345,594,939,52,991
公投第１５案,臺中市,西區,忠明里,1140,1139,250,406,656,25,681
公投第１５案,臺中市,西區,忠明里,1141,1105,223,438,661,23,684
公投第１５案,臺中市,西區,忠明里,1142,1498,270,548,818,49,867
公投第１５案,臺中市,西區,忠明里,1143,1921,321,628,949,34,983
公投第１５案,臺中市,西區,忠誠里,1144,1340,266,467,733,45,778
公投第１５案,臺中市,西區,忠誠里,1145,1536,327,605,932,29,961
公投第１５案,臺中市,西區,忠誠里,1146,1361,275,485,760,51,811
公投第１５案,臺中市,西區,忠誠里,1147,1430,304,555,859,35,894
公投第１５案,臺中市,東區,新庄里,1148,1138,168,264,432,17,449
公投第１５案,臺中市,東區,新庄里,1149,984,184,376,560,19,579
公投第１５案,臺中市,東區,新庄里,1150,877,155,339,494,28,522
公投第１５案,臺中市,東區,振興里,1151,1070,223,407,630,39,669
公投第１５案,臺中市,東區,振興里,1152,1106,213,426,639,48,687
公投第１５案,臺中市,東區,振興里,1153,953,165,360,525,53,578
公投第１５案,臺中市,東區,東橋里,1154,1195,220,479,699,34,733
公投第１５案,臺中市,東區,東橋里,1155,1251,211,469,680,33,713
公投第１５案,臺中市,東區,東橋里,1156,1190,223,435,658,49,707
公投第１５案,臺中市,東區,東興里,1157,1394,255,482,737,56,793
公投第１５案,臺中市,東區,東興里,1158,1443,285,547,832,61,893
公投第１５案,臺中市,東區,泉源里,1159,762,121,297,418,36,454
公投第１５案,臺中市,東區,泉源里,1160,1140,234,462,696,37,733
公投第１５案,臺中市,東區,干城里,1161,1211,218,462,680,70,750
公投第１５案,臺中市,東區,干城里,1162,755,161,293,454,29,483
公投第１５案,臺中市,東區,旱溪里,1163,1491,261,518,779,63,842
公投第１５案,臺中市,東區,旱溪里,1164,1000,162,372,534,21,555
公投第１５案,臺中市,東區,樂成里,1165,1114,225,409,634,48,682
公投第１５案,臺中市,東區,樂成里,1166,1101,199,408,607,33,640
公投第１５案,臺中市,東區,東門里,1167,1169,234,478,712,49,761
公投第１５案,臺中市,東區,東門里,1168,1283,235,505,740,73,813
公投第１５案,臺中市,東區,東門里,1169,1168,229,480,709,32,741
公投第１５案,臺中市,東區,東門里,1170,1386,248,485,733,38,771
公投第１５案,臺中市,東區,東門里,1171,1557,345,536,881,43,924
公投第１５案,臺中市,東區,十甲里,1172,1380,264,490,754,58,812
公投第１５案,臺中市,東區,十甲里,1173,1674,328,609,937,58,995
公投第１５案,臺中市,東區,十甲里,1174,1604,349,611,960,40,1000
公投第１５案,臺中市,東區,東英里,1175,1815,377,665,1042,52,1094
公投第１５案,臺中市,東區,東英里,1176,1700,298,609,907,55,962
公投第１５案,臺中市,東區,東英里,1177,1592,280,567,847,58,905
公投第１５案,臺中市,東區,東英里,1178,1850,328,615,943,62,1005
公投第１５案,臺中市,東區,東南里,1179,1252,208,521,729,32,761
公投第１５案,臺中市,東區,東南里,1180,1250,275,473,748,48,796
公投第１５案,臺中市,東區,東南里,1181,1241,213,502,715,36,751
公投第１５案,臺中市,東區,東勢里,1182,1318,246,422,668,42,710
公投第１５案,臺中市,東區,東勢里,1183,1288,213,464,677,65,742
公投第１５案,臺中市,東區,合作里,1184,1442,267,580,847,55,902
公投第１５案,臺中市,東區,合作里,1185,1202,215,455,670,50,720
公投第１５案,臺中市,東區,合作里,1186,1452,230,572,802,54,856
公投第１５案,臺中市,東區,富仁里,1187,1480,264,540,804,39,843
公投第１５案,臺中市,東區,富仁里,1188,1736,259,710,969,31,1000
公投第１５案,臺中市,東區,富仁里,1189,867,151,307,458,34,492
公投第１５案,臺中市,東區,富台里,1190,1693,242,606,848,42,890
公投第１５案,臺中市,東區,東信里,1191,1538,282,599,881,70,951
公投第１５案,臺中市,東區,東信里,1192,1593,315,594,909,101,1010
公投第１５案,臺中市,東區,東信里,1193,1481,265,519,784,25,809
公投第１５案,臺中市,東區,東信里,1194,1414,287,541,828,45,873
公投第１５案,臺中市,東區,東信里,1195,1297,251,479,730,30,760
公投第１５案,臺中市,東區,東信里,1196,1394,248,535,783,48,831
公投第１５案,臺中市,南區,長春里,1197,937,177,361,538,35,573
公投第１５案,臺中市,南區,長春里,1198,1001,206,412,618,40,658
公投第１５案,臺中市,南區,長榮里,1199,1249,262,507,769,52,821
公投第１５案,臺中市,南區,長榮里,1200,1202,256,530,786,33,819
公投第１５案,臺中市,南區,城隍里,1201,1130,237,418,655,67,722
公投第１５案,臺中市,南區,城隍里,1202,1239,220,507,727,57,784
公投第１５案,臺中市,南區,城隍里,1203,1238,240,450,690,42,732
公投第１５案,臺中市,南區,國光里,1204,1272,254,481,735,54,789
公投第１５案,臺中市,南區,國光里,1205,1273,251,476,727,45,772
公投第１５案,臺中市,南區,國光里,1206,1317,267,468,735,72,807
公投第１５案,臺中市,南區,南門里,1207,1160,278,485,763,33,796
公投第１５案,臺中市,南區,南門里,1208,1205,290,447,737,54,791
公投第１５案,臺中市,南區,南門里,1209,1111,254,399,653,39,692
公投第１５案,臺中市,南區,德義里,1210,1407,338,515,853,48,901
公投第１５案,臺中市,南區,德義里,1211,1419,279,538,817,39,856
公投第１５案,臺中市,南區,積善里,1212,1157,237,458,695,44,739
公投第１５案,臺中市,南區,積善里,1213,1415,273,515,788,40,828
公投第１５案,臺中市,南區,江川里,1214,1289,263,539,802,49,851
公投第１５案,臺中市,南區,江川里,1215,1454,290,547,837,36,873
公投第１５案,臺中市,南區,新榮里,1216,1491,276,548,824,43,867
公投第１５案,臺中市,南區,新榮里,1217,1394,286,524,810,25,835
公投第１５案,臺中市,南區,新榮里,1218,1430,306,499,805,56,861
公投第１５案,臺中市,南區,福興里,1219,1342,267,474,741,101,842
公投第１５案,臺中市,南區,福興里,1220,1304,272,532,804,78,882
公投第１５案,臺中市,南區,福興里,1221,1190,258,471,729,37,766
公投第１５案,臺中市,南區,福平里,1222,1273,203,500,703,52,755
公投第１５案,臺中市,南區,福平里,1223,1387,296,558,854,51,905
公投第１５案,臺中市,南區,福平里,1224,1356,292,494,786,33,819
公投第１５案,臺中市,南區,福平里,1225,1304,267,506,773,50,823
公投第１５案,臺中市,南區,福順里,1226,1256,269,519,788,30,818
公投第１５案,臺中市,南區,福順里,1227,1364,327,506,833,32,865
公投第１５案,臺中市,南區,福順里,1228,1361,288,491,779,71,850
公投第１５案,臺中市,南區,福順里,1229,1407,291,557,848,27,875
公投第１５案,臺中市,南區,和平里,1230,1308,218,525,743,55,798
公投第１５案,臺中市,南區,和平里,1231,1250,257,451,708,36,744
公投第１５案,臺中市,南區,和平里,1232,1284,269,449,718,24,742
公投第１５案,臺中市,南區,平和里,1233,1175,253,434,687,62,749
公投第１５案,臺中市,南區,平和里,1234,1158,221,506,727,41,768
公投第１５案,臺中市,南區,平和里,1235,1168,258,422,680,38,718
公投第１５案,臺中市,南區,南和里,1236,1626,326,666,992,47,1039
公投第１５案,臺中市,南區,南和里,1237,2115,326,547,873,24,897
公投第１５案,臺中市,南區,南和里,1238,1805,338,644,982,26,1008
公投第１５案,臺中市,南區,南和里,1239,1695,317,614,931,25,956
公投第１５案,臺中市,南區,永興里,1240,1643,344,675,1019,31,1050
公投第１５案,臺中市,南區,永興里,1241,1423,304,540,844,49,893
公投第１５案,臺中市,南區,永興里,1242,1542,292,583,875,46,921
公投第１５案,臺中市,南區,永興里,1243,1533,337,568,905,24,929
公投第１５案,臺中市,南區,永興里,1244,1531,345,586,931,56,987
公投第１５案,臺中市,南區,永和里,1245,1392,219,505,724,46,770
公投第１５案,臺中市,南區,永和里,1246,1592,317,560,877,42,919
公投第１５案,臺中市,南區,永和里,1247,1431,311,537,848,47,895
公投第１５案,臺中市,南區,樹義里,1248,1799,307,626,933,49,982
公投第１５案,臺中市,南區,樹義里,1249,1708,331,698,1029,59,1088
公投第１５案,臺中市,南區,樹義里,1250,1700,305,606,911,60,971
公投第１５案,臺中市,南區,樹義里,1251,1751,322,740,1062,30,1092
公投第１５案,臺中市,南區,樹義里,1252,2109,447,755,1202,64,1266
公投第１５案,臺中市,南區,樹義里,1253,1697,334,618,952,64,1016
公投第１５案,臺中市,南區,工學里,1254,1456,322,503,825,39,864
公投第１５案,臺中市,南區,工學里,1255,1726,388,714,1102,47,1149
公投第１５案,臺中市,南區,工學里,1256,1723,352,674,1026,48,1074
公投第１５案,臺中市,南區,工學里,1257,1569,337,595,932,43,975
公投第１５案,臺中市,南區,樹德里,1258,1274,260,489,749,55,804
公投第１５案,臺中市,南區,樹德里,1259,1390,287,599,886,35,921
公投第１５案,臺中市,南區,樹德里,1260,1295,262,561,823,27,850
公投第１５案,臺中市,南區,樹德里,1261,1312,234,522,756,49,805
公投第１５案,臺中市,南區,樹德里,1262,1417,287,584,871,33,904
公投第１５案,臺中市,南區,樹德里,1263,1230,278,543,821,35,856
公投第１５案,臺中市,南區,西川里,1264,1308,242,484,726,60,786
公投第１５案,臺中市,南區,西川里,1265,1467,276,543,819,64,883
公投第１５案,臺中市,南區,西川里,1266,1399,306,518,824,33,857
公投第１５案,臺中市,南區,崇倫里,1267,1207,212,457,669,64,733
公投第１５案,臺中市,南區,崇倫里,1268,1317,248,500,748,26,774
公投第１５案,臺中市,南區,崇倫里,1269,1563,342,547,889,29,918
公投第１５案,臺中市,南區,崇倫里,1270,1221,274,472,746,24,770
公投第１５案,臺中市,太平區,太平里,1271,1821,301,629,930,72,1002
公投第１５案,臺中市,太平區,太平里,1272,1680,233,595,828,42,870
公投第１５案,臺中市,太平區,太平里,1273,1947,318,717,1035,96,1131
公投第１５案,臺中市,太平區,長億里,1274,1910,322,740,1062,75,1137
公投第１５案,臺中市,太平區,長億里,1275,1894,321,654,975,42,1017
公投第１５案,臺中市,太平區,長億里,1276,1953,340,692,1032,53,1085
公投第１５案,臺中市,太平區,永成里,1277,1846,316,674,990,73,1063
公投第１５案,臺中市,太平區,永成里,1278,1493,255,588,843,50,893
公投第１５案,臺中市,太平區,永成里,1279,1605,229,616,845,47,892
公投第１５案,臺中市,太平區,永成里,1280,1619,286,634,920,48,968
公投第１５案,臺中市,太平區,中平里,1281,2011,320,729,1049,67,1116
公投第１５案,臺中市,太平區,中平里,1282,2056,348,708,1056,30,1086
公投第１５案,臺中市,太平區,中政里,1283,1876,327,652,979,57,1036
公投第１５案,臺中市,太平區,中政里,1284,1815,294,638,932,58,990
公投第１５案,臺中市,太平區,平安里,1285,1281,208,467,675,46,721
公投第１５案,臺中市,太平區,平安里,1286,1004,186,412,598,49,647
公投第１５案,臺中市,太平區,中興里,1287,1886,348,707,1055,70,1125
公投第１５案,臺中市,太平區,中興里,1288,1431,237,549,786,74,860
公投第１５案,臺中市,太平區,永平里,1289,1930,334,663,997,63,1060
公投第１５案,臺中市,太平區,永平里,1290,2164,331,739,1070,54,1124
公投第１５案,臺中市,太平區,東平里,1291,2048,305,753,1058,62,1120
公投第１５案,臺中市,太平區,東平里,1292,2035,311,723,1034,53,1087
公投第１５案,臺中市,太平區,成功里,1293,1685,291,573,864,70,934
公投第１５案,臺中市,太平區,成功里,1294,2185,318,678,996,85,1081
公投第１５案,臺中市,太平區,東和里,1295,1176,186,420,606,24,630
公投第１５案,臺中市,太平區,東和里,1296,1597,260,579,839,26,865
公投第１５案,臺中市,太平區,建國里,1297,1378,218,475,693,57,750
公投第１５案,臺中市,太平區,建國里,1298,1546,232,589,821,36,857
公投第１５案,臺中市,太平區,建興里,1299,1890,301,601,902,60,962
公投第１５案,臺中市,太平區,建興里,1300,1053,163,391,554,43,597
公投第１５案,臺中市,太平區,坪林里,1301,1582,262,624,886,78,964
公投第１５案,臺中市,太平區,坪林里,1302,1699,292,675,967,40,1007
公投第１５案,臺中市,太平區,大興里,1303,1493,258,493,751,63,814
公投第１５案,臺中市,太平區,大興里,1304,1063,166,371,537,35,572
公投第１５案,臺中市,太平區,勤益里,1305,1117,188,444,632,39,671
公投第１５案,臺中市,太平區,勤益里,1306,1084,197,425,622,33,655
公投第１５案,臺中市,太平區,光華里,1307,1776,309,595,904,35,939
公投第１５案,臺中市,太平區,光華里,1308,1729,279,601,880,57,937
公投第１５案,臺中市,太平區,光華里,1309,1658,240,534,774,62,836
公投第１５案,臺中市,太平區,光明里,1310,2010,277,738,1015,53,1068
公投第１５案,臺中市,太平區,光明里,1311,1752,272,607,879,54,933
公投第１５案,臺中市,太平區,中山里,1312,1654,294,640,934,56,990
公投第１５案,臺中市,太平區,中山里,1313,1951,216,519,735,33,768
公投第１５案,臺中市,太平區,豐年里,1314,2170,411,868,1279,80,1359
公投第１５案,臺中市,太平區,豐年里,1315,2231,408,880,1288,58,1346
公投第１５案,臺中市,太平區,宜欣里,1316,1623,287,615,902,39,941
公投第１５案,臺中市,太平區,宜欣里,1317,1548,208,525,733,42,775
公投第１５案,臺中市,太平區,宜欣里,1318,1442,232,517,749,48,797
公投第１５案,臺中市,太平區,宜欣里,1319,1501,213,482,695,38,733
公投第１５案,臺中市,太平區,宜佳里,1320,2025,325,654,979,29,1008
公投第１５案,臺中市,太平區,宜佳里,1321,1885,308,653,961,58,1019
公投第１５案,臺中市,太平區,宜佳里,1322,2155,336,649,985,71,1056
公投第１５案,臺中市,太平區,宜昌里,1323,1775,272,587,859,49,908
公投第１５案,臺中市,太平區,宜昌里,1324,2021,277,588,865,69,934
公投第１５案,臺中市,太平區,新坪里,1325,2075,346,785,1131,69,1200
公投第１５案,臺中市,太平區,新坪里,1326,1723,290,580,870,37,907
公投第１５案,臺中市,太平區,新坪里,1327,2049,348,746,1094,51,1145
公投第１５案,臺中市,太平區,新坪里,1328,1415,245,515,760,22,782
公投第１５案,臺中市,太平區,新吉里,1329,1778,305,662,967,38,1005
公投第１５案,臺中市,太平區,新吉里,1330,1706,283,587,870,36,906
公投第１５案,臺中市,太平區,新吉里,1331,2090,367,722,1089,38,1127
公投第１５案,臺中市,太平區,新城里,1332,2093,329,638,967,78,1045
公投第１５案,臺中市,太平區,新城里,1333,1688,219,566,785,32,817
公投第１５案,臺中市,太平區,新城里,1334,1488,253,465,718,35,753
公投第１５案,臺中市,太平區,新光里,1335,1667,275,649,924,47,971
公投第１５案,臺中市,太平區,新光里,1336,1793,305,671,976,54,1030
公投第１５案,臺中市,太平區,新光里,1337,1903,366,684,1050,33,1083
公投第１５案,臺中市,太平區,新光里,1338,1834,285,679,964,63,1027
公投第１５案,臺中市,太平區,新興里,1339,1526,241,560,801,33,834
公投第１５案,臺中市,太平區,新興里,1340,1483,340,570,910,20,930
公投第１５案,臺中市,太平區,新興里,1341,1694,343,592,935,26,961
公投第１５案,臺中市,太平區,新高里,1342,1952,313,633,946,29,975
公投第１５案,臺中市,太平區,新高里,1343,1995,346,698,1044,46,1090
公投第１５案,臺中市,太平區,新高里,1344,1311,259,488,747,14,761
公投第１５案,臺中市,太平區,新高里,1345,1537,398,583,981,37,1018
公投第１５案,臺中市,太平區,新福里,1346,1974,296,649,945,52,997
公投第１５案,臺中市,太平區,新福里,1347,1828,324,669,993,43,1036
公投第１５案,臺中市,太平區,新福里,1348,2191,372,666,1038,47,1085
公投第１５案,臺中市,太平區,頭汴里,1349,1825,234,662,896,80,976
公投第１５案,臺中市,太平區,聖和里,1350,1559,222,546,768,18,786
公投第１５案,臺中市,太平區,東汴里,1351,1225,196,444,640,53,693
公投第１５案,臺中市,太平區,興隆里,1352,1678,219,651,870,57,927
公投第１５案,臺中市,太平區,興隆里,1353,1501,229,490,719,83,802
公投第１５案,臺中市,太平區,福隆里,1354,1450,274,571,845,74,919
公投第１５案,臺中市,太平區,福隆里,1355,2126,333,712,1045,66,1111
公投第１５案,臺中市,太平區,黃竹里,1356,699,97,313,410,38,448
公投第１５案,臺中市,太平區,光隆里,1357,1428,240,457,697,40,737
公投第１５案,臺中市,太平區,光隆里,1358,1666,387,407,794,77,871
公投第１５案,臺中市,太平區,永隆里,1359,1241,207,467,674,41,715
公投第１５案,臺中市,太平區,永隆里,1360,1266,208,487,695,61,756
公投第１５案,臺中市,太平區,德隆里,1361,1166,177,447,624,46,670
公投第１５案,臺中市,太平區,德隆里,1362,1790,300,687,987,69,1056
公投第１５案,臺中市,太平區,德隆里,1363,1754,212,556,768,47,815
公投第１５案,臺中市,大里區,東湖里,1364,1614,260,557,817,33,850
公投第１５案,臺中市,大里區,東湖里,1365,1599,236,533,769,38,807
公投第１５案,臺中市,大里區,東湖里,1366,1715,547,271,818,56,874
公投第１５案,臺中市,大里區,東湖里,1367,1264,216,498,714,22,736
公投第１５案,臺中市,大里區,東湖里,1368,1416,240,484,724,34,758
公投第１５案,臺中市,大里區,東湖里,1369,1188,191,432,623,33,656
公投第１５案,臺中市,大里區,東湖里,1370,1359,223,465,688,62,750
公投第１５案,臺中市,大里區,西湖里,1371,1457,242,561,803,47,850
公投第１５案,臺中市,大里區,西湖里,1372,1403,226,562,788,44,832
公投第１５案,臺中市,大里區,大里里,1373,1697,285,628,913,40,953
公投第１５案,臺中市,大里區,大里里,1374,1811,328,673,1001,87,1088
公投第１５案,臺中市,大里區,新里里,1375,1830,297,689,986,50,1036
公投第１５案,臺中市,大里區,新里里,1376,2228,265,602,867,99,966
公投第１５案,臺中市,大里區,新里里,1377,1997,343,705,1048,64,1112
公投第１５案,臺中市,大里區,新里里,1378,2033,438,830,1268,32,1300
公投第１５案,臺中市,大里區,新里里,1379,1835,360,675,1035,43,1078
公投第１５案,臺中市,大里區,國光里,1380,1268,237,471,708,25,733
公投第１５案,臺中市,大里區,國光里,1381,1645,289,627,916,46,962
公投第１５案,臺中市,大里區,國光里,1382,1561,312,594,906,29,935
公投第１５案,臺中市,大里區,國光里,1383,1301,265,556,821,28,849
公投第１５案,臺中市,大里區,樹王里,1384,1621,270,571,841,61,902
公投第１５案,臺中市,大里區,樹王里,1385,1797,309,630,939,49,988
公投第１５案,臺中市,大里區,祥興里,1386,1230,198,451,649,26,675
公投第１５案,臺中市,大里區,祥興里,1387,1488,219,562,781,44,825
公投第１５案,臺中市,大里區,祥興里,1388,1459,266,464,730,68,798
公投第１５案,臺中市,大里區,祥興里,1389,1647,294,607,901,43,944
公投第１５案,臺中市,大里區,祥興里,1390,1100,198,436,634,55,689
公投第１５案,臺中市,大里區,內新里,1391,1410,250,513,763,49,812
公投第１５案,臺中市,大里區,內新里,1392,1807,265,627,892,69,961
公投第１５案,臺中市,大里區,內新里,1393,1331,236,491,727,44,771
公投第１５案,臺中市,大里區,內新里,1394,1801,227,714,941,29,970
公投第１５案,臺中市,大里區,內新里,1395,1909,333,606,939,35,974
公投第１５案,臺中市,大里區,中新里,1396,1699,307,506,813,55,868
公投第１５案,臺中市,大里區,中新里,1397,1627,304,589,893,47,940
公投第１５案,臺中市,大里區,中新里,1398,1912,354,644,998,44,1042
公投第１５案,臺中市,大里區,東昇里,1399,1753,261,613,874,68,942
公投第１５案,臺中市,大里區,東昇里,1400,1602,255,587,842,47,889
公投第１５案,臺中市,大里區,大元里,1401,1144,215,408,623,48,671
公投第１５案,臺中市,大里區,大元里,1402,1655,281,638,919,59,978
公投第１５案,臺中市,大里區,大元里,1403,1438,262,498,760,48,808
公投第１５案,臺中市,大里區,夏田里,1404,1000,198,350,548,50,598
公投第１５案,臺中市,大里區,仁化里,1405,1711,295,613,908,56,964
公投第１５案,臺中市,大里區,仁化里,1406,1698,264,642,906,13,919
公投第１５案,臺中市,大里區,仁化里,1407,1914,305,693,998,77,1075
公投第１５案,臺中市,大里區,仁化里,1408,1465,297,535,832,31,863
公投第１５案,臺中市,大里區,仁化里,1409,1581,263,577,840,64,904
公投第１５案,臺中市,大里區,仁德里,1410,1509,230,613,843,57,900
公投第１５案,臺中市,大里區,仁德里,1411,1570,247,575,822,28,850
公投第１５案,臺中市,大里區,仁德里,1412,1425,276,516,792,35,827
公投第１５案,臺中市,大里區,仁德里,1413,1384,258,506,764,56,820
公投第１５案,臺中市,大里區,健民里,1414,1204,181,387,568,26,594
公投第１５案,臺中市,大里區,健民里,1415,1761,278,589,867,27,894
公投第１５案,臺中市,大里區,健民里,1416,1473,216,470,686,30,716
公投第１５案,臺中市,大里區,塗城里,1417,1675,257,622,879,71,950
公投第１５案,臺中市,大里區,塗城里,1418,1755,274,656,930,56,986
公投第１５案,臺中市,大里區,塗城里,1419,1593,273,590,863,79,942
公投第１５案,臺中市,大里區,塗城里,1420,1799,203,720,923,67,990
公投第１５案,臺中市,大里區,塗城里,1421,1606,282,572,854,64,918
公投第１５案,臺中市,大里區,東興里,1422,1875,318,666,984,41,1025
公投第１５案,臺中市,大里區,東興里,1423,1670,300,605,905,52,957
公投第１５案,臺中市,大里區,東興里,1424,1898,337,646,983,55,1038
公投第１５案,臺中市,大里區,東興里,1425,1679,300,562,862,30,892
公投第１５案,臺中市,大里區,大明里,1426,1373,219,481,700,57,757
公投第１５案,臺中市,大里區,大明里,1427,1299,208,487,695,57,752
公投第１５案,臺中市,大里區,大明里,1428,1430,247,533,780,36,816
公投第１５案,臺中市,大里區,永隆里,1429,1805,354,751,1105,39,1144
公投第１５案,臺中市,大里區,永隆里,1430,1806,426,730,1156,17,1173
公投第１５案,臺中市,大里區,永隆里,1431,1826,383,758,1141,45,1186
公投第１５案,臺中市,大里區,永隆里,1432,1805,329,801,1130,50,1180
公投第１５案,臺中市,大里區,永隆里,1433,1907,388,720,1108,40,1148
公投第１５案,臺中市,大里區,日新里,1434,1103,107,564,671,26,697
公投第１５案,臺中市,大里區,日新里,1435,1419,530,245,775,59,834
公投第１５案,臺中市,大里區,日新里,1436,1434,185,574,759,60,819
公投第１５案,臺中市,大里區,西榮里,1437,1875,275,634,909,42,951
公投第１５案,臺中市,大里區,西榮里,1438,1862,335,647,982,50,1032
公投第１５案,臺中市,大里區,西榮里,1439,1850,328,635,963,32,995
公投第１５案,臺中市,大里區,長榮里,1440,1622,278,597,875,60,935
公投第１５案,臺中市,大里區,長榮里,1441,1638,302,663,965,52,1017
公投第１５案,臺中市,大里區,長榮里,1442,1633,302,655,957,62,1019
公投第１５案,臺中市,大里區,長榮里,1443,1662,321,591,912,41,953
公投第１５案,臺中市,大里區,長榮里,1444,1917,409,705,1114,33,1147
公投第１５案,臺中市,大里區,金城里,1445,1701,262,574,836,58,894
公投第１５案,臺中市,大里區,金城里,1446,1549,249,529,778,55,833
公投第１５案,臺中市,大里區,金城里,1447,1567,276,627,903,43,946
公投第１５案,臺中市,大里區,金城里,1448,1614,273,603,876,51,927
公投第１５案,臺中市,大里區,金城里,1449,1811,316,653,969,78,1047
公投第１５案,臺中市,大里區,金城里,1450,1336,231,486,717,42,759
公投第１５案,臺中市,大里區,立仁里,1451,1759,264,646,910,49,959
公投第１５案,臺中市,大里區,立仁里,1452,1783,264,624,888,58,946
公投第１５案,臺中市,大里區,立仁里,1453,1736,245,581,826,56,882
公投第１５案,臺中市,大里區,立德里,1454,1874,300,713,1013,53,1066
公投第１５案,臺中市,大里區,立德里,1455,1889,327,663,990,72,1062
公投第１５案,臺中市,大里區,立德里,1456,1947,268,739,1007,63,1070
公投第１５案,臺中市,大里區,立德里,1457,1938,327,768,1095,37,1132
公投第１５案,臺中市,大里區,新仁里,1458,1836,295,664,959,65,1024
公投第１５案,臺中市,大里區,新仁里,1459,1913,290,703,993,64,1057
公投第１５案,臺中市,大里區,新仁里,1460,1913,274,669,943,76,1019
公投第１５案,臺中市,大里區,新仁里,1461,1937,255,716,971,41,1012
公投第１５案,臺中市,大里區,瑞城里,1462,1508,227,553,780,40,820
公投第１５案,臺中市,大里區,瑞城里,1463,1340,234,533,767,34,801
公投第１５案,臺中市,大里區,瑞城里,1464,1656,271,646,917,56,973
公投第１５案,臺中市,大里區,瑞城里,1465,1290,203,500,703,31,734
公投第１５案,臺中市,大里區,瑞城里,1466,1655,279,606,885,35,920
公投第１５案,臺中市,大里區,瑞城里,1467,1260,213,401,614,23,637
公投第１５案,臺中市,大里區,瑞城里,1468,1247,244,476,720,26,746
公投第１５案,臺中市,大里區,瑞城里,1469,1548,239,543,782,86,868
公投第１５案,臺中市,霧峰區,桐林里,1470,1205,225,473,698,48,746
公投第１５案,臺中市,霧峰區,吉峰里,1471,1620,269,599,868,49,917
公投第１５案,臺中市,霧峰區,吉峰里,1472,1559,312,597,909,56,965
公投第１５案,臺中市,霧峰區,吉峰里,1473,1660,296,596,892,65,957
公投第１５案,臺中市,霧峰區,吉峰里,1474,1602,279,648,927,57,984
公投第１５案,臺中市,霧峰區,吉峰里,1475,1325,216,470,686,47,733
公投第１５案,臺中市,霧峰區,吉峰里,1476,1515,239,590,829,62,891
公投第１５案,臺中市,霧峰區,甲寅里,1477,1561,248,564,812,54,866
公投第１５案,臺中市,霧峰區,甲寅里,1478,1691,264,613,877,39,916
公投第１５案,臺中市,霧峰區,甲寅里,1479,1486,239,566,805,57,862
公投第１５案,臺中市,霧峰區,本鄉里,1480,975,160,407,567,44,611
公投第１５案,臺中市,霧峰區,本鄉里,1481,1358,216,577,793,57,850
公投第１５案,臺中市,霧峰區,中正里,1482,1141,224,494,718,31,749
公投第１５案,臺中市,霧峰區,中正里,1483,855,152,372,524,42,566
公投第１５案,臺中市,霧峰區,錦榮里,1484,1202,211,505,716,46,762
公投第１５案,臺中市,霧峰區,萊園里,1485,1078,165,407,572,36,608
公投第１５案,臺中市,霧峰區,本堂里,1486,1456,292,579,871,61,932
公投第１５案,臺中市,霧峰區,本堂里,1487,1573,300,615,915,41,956
公投第１５案,臺中市,霧峰區,本堂里,1488,1591,255,646,901,42,943
公投第１５案,臺中市,霧峰區,本堂里,1489,1214,222,508,730,52,782
公投第１５案,臺中市,霧峰區,北柳里,1490,1267,199,486,685,46,731
公投第１５案,臺中市,霧峰區,北柳里,1491,1277,229,485,714,47,761
公投第１５案,臺中市,霧峰區,北柳里,1492,1366,252,490,742,41,783
公投第１５案,臺中市,霧峰區,南柳里,1493,994,219,423,642,48,690
公投第１５案,臺中市,霧峰區,南柳里,1494,863,159,367,526,27,553
公投第１５案,臺中市,霧峰區,四德里,1495,1274,222,468,690,49,739
公投第１５案,臺中市,霧峰區,四德里,1496,1162,193,426,619,69,688
公投第１５案,臺中市,霧峰區,五福里,1497,1252,197,608,805,70,875
公投第１５案,臺中市,霧峰區,五福里,1498,1322,232,500,732,56,788
公投第１５案,臺中市,霧峰區,丁台里,1499,1116,207,460,667,44,711
公投第１５案,臺中市,霧峰區,丁台里,1500,1156,221,431,652,87,739
公投第１５案,臺中市,霧峰區,北勢里,1501,1147,169,512,681,48,729
公投第１５案,臺中市,霧峰區,北勢里,1502,928,141,447,588,42,630
公投第１５案,臺中市,霧峰區,南勢里,1503,1296,193,492,685,44,729
公投第１５案,臺中市,霧峰區,萬豐里,1504,1314,225,426,651,68,719
公投第１５案,臺中市,霧峰區,萬豐里,1505,1328,215,537,752,56,808
公投第１５案,臺中市,霧峰區,舊正里,1506,989,196,331,527,59,586
公投第１５案,臺中市,霧峰區,舊正里,1507,1088,200,418,618,63,681
公投第１５案,臺中市,霧峰區,坑口里,1508,1363,215,590,805,56,861
公投第１５案,臺中市,霧峰區,坑口里,1509,1573,269,632,901,63,964
公投第１５案,臺中市,霧峰區,峰谷里,1510,1117,162,430,592,86,678
公投第１５案,臺中市,霧峰區,六股里,1511,1342,227,563,790,74,864
公投第１５案,臺中市,霧峰區,六股里,1512,1024,187,429,616,68,684
公投第１５案,臺中市,東勢區,慶福里,1513,1299,160,501,661,62,723
公投第１５案,臺中市,東勢區,慶東里,1514,1007,135,386,521,60,581
公投第１５案,臺中市,東勢區,慶東里,1515,859,111,320,431,49,480
公投第１５案,臺中市,東勢區,上城里,1516,991,173,408,581,65,646
公投第１５案,臺中市,東勢區,下城里,1517,863,118,314,432,25,457
公投第１５案,臺中市,東勢區,詒福里,1518,1628,220,613,833,95,928
公投第１５案,臺中市,東勢區,新盛里,1519,1335,213,441,654,60,714
公投第１５案,臺中市,東勢區,新盛里,1520,1092,200,441,641,60,701
公投第１５案,臺中市,東勢區,新盛里,1521,1050,137,497,634,44,678
公投第１５案,臺中市,東勢區,新盛里,1522,1431,196,591,787,42,829
公投第１５案,臺中市,東勢區,福隆里,1523,1372,588,196,784,42,826
公投第１５案,臺中市,東勢區,福隆里,1524,1412,216,530,746,47,793
公投第１５案,臺中市,東勢區,福隆里,1525,878,113,349,462,57,519
公投第１５案,臺中市,東勢區,隆興里,1526,1475,166,534,700,65,765
公投第１５案,臺中市,東勢區,中嵙里,1527,872,108,347,455,17,472
公投第１５案,臺中市,東勢區,中嵙里,1528,1006,133,373,506,66,572
公投第１５案,臺中市,東勢區,泰昌里,1529,1222,185,477,662,30,692
公投第１５案,臺中市,東勢區,泰昌里,1530,1228,204,557,761,46,807
公投第１５案,臺中市,東勢區,泰昌里,1531,1036,164,455,619,27,646
公投第１５案,臺中市,東勢區,上新里,1532,977,160,442,602,30,632
公投第１５案,臺中市,東勢區,廣興里,1533,1395,216,539,755,40,795
公投第１５案,臺中市,東勢區,延平里,1534,1169,171,485,656,85,741
公投第１５案,臺中市,東勢區,延平里,1535,1027,155,435,590,53,643
公投第１５案,臺中市,東勢區,南平里,1536,984,154,419,573,26,599
公投第１５案,臺中市,東勢區,南平里,1537,866,146,409,555,31,586
公投第１５案,臺中市,東勢區,東安里,1538,1031,159,401,560,79,639
公投第１５案,臺中市,東勢區,中寧里,1539,865,141,381,522,57,579
公投第１５案,臺中市,東勢區,北興里,1540,1357,197,623,820,46,866
公投第１５案,臺中市,東勢區,粵寧里,1541,736,120,303,423,33,456
公投第１５案,臺中市,東勢區,粵寧里,1542,1314,203,529,732,46,778
公投第１５案,臺中市,東勢區,下新里,1543,1677,236,578,814,105,919
公投第１５案,臺中市,東勢區,東新里,1544,950,150,412,562,24,586
公投第１５案,臺中市,東勢區,東新里,1545,1007,147,439,586,42,628
公投第１５案,臺中市,東勢區,興隆里,1546,1214,170,425,595,38,633
公投第１５案,臺中市,東勢區,茂興里,1547,907,106,375,481,43,524
公投第１５案,臺中市,東勢區,茂興里,1548,902,140,315,455,41,496
公投第１５案,臺中市,東勢區,泰興里,1549,720,92,226,318,12,330
公投第１５案,臺中市,東勢區,埤頭里,1550,666,93,221,314,14,328
公投第１５案,臺中市,東勢區,明正里,1551,1361,200,496,696,51,747
公投第１５案,臺中市,石岡區,石岡里,1552,1244,212,480,692,39,731
公投第１５案,臺中市,石岡區,萬安里,1553,1539,224,581,805,65,870
公投第１５案,臺中市,石岡區,九房里,1554,1202,200,478,678,38,716
公投第１５案,臺中市,石岡區,金星里,1555,1272,197,431,628,69,697
公投第１５案,臺中市,石岡區,龍興里,1556,652,89,265,354,36,390
公投第１５案,臺中市,石岡區,萬興里,1557,1457,281,606,887,71,958
公投第１５案,臺中市,石岡區,梅子里,1558,1836,316,650,966,66,1032
公投第１５案,臺中市,石岡區,土牛里,1559,1001,147,385,532,50,582
公投第１５案,臺中市,石岡區,德興里,1560,1448,227,594,821,62,883
公投第１５案,臺中市,石岡區,和盛里,1561,1229,216,494,710,56,766
公投第１５案,臺中市,新社區,新社里,1562,1011,159,397,556,28,584
公投第１５案,臺中市,新社區,新社里,1563,1195,183,480,663,39,702
公投第１５案,臺中市,新社區,新社里,1564,1053,191,422,613,22,635
公投第１５案,臺中市,新社區,復盛里,1565,961,101,299,400,29,429
公投第１５案,臺中市,新社區,復盛里,1566,919,120,350,470,13,483
公投第１５案,臺中市,新社區,中正里,1567,1367,209,572,781,57,838
公投第１５案,臺中市,新社區,月湖里,1568,1010,172,345,517,30,547
公投第１５案,臺中市,新社區,崑山里,1569,1169,171,364,535,61,596
公投第１５案,臺中市,新社區,大南里,1570,989,179,339,518,47,565
公投第１５案,臺中市,新社區,大南里,1571,894,138,343,481,20,501
公投第１５案,臺中市,新社區,永源里,1572,1033,134,387,521,18,539
公投第１５案,臺中市,新社區,永源里,1573,1058,137,314,451,24,475
公投第１５案,臺中市,新社區,永源里,1574,845,121,289,410,15,425
公投第１５案,臺中市,新社區,中興里,1575,576,91,266,357,28,385
公投第１５案,臺中市,新社區,協成里,1576,1229,159,420,579,50,629
公投第１５案,臺中市,新社區,協成里,1577,890,139,273,412,21,433
公投第１５案,臺中市,新社區,協成里,1578,781,113,272,385,26,411
公投第１５案,臺中市,新社區,東興里,1579,1244,181,462,643,38,681
公投第１５案,臺中市,新社區,慶西里,1580,213,22,49,71,8,79
公投第１５案,臺中市,新社區,慶西里,1581,676,81,207,288,29,317
公投第１５案,臺中市,新社區,中和里,1582,585,56,205,261,23,284
公投第１５案,臺中市,新社區,福興里,1583,938,106,380,486,50,536
公投第１５案,臺中市,新社區,福興里,1584,224,21,82,103,8,111
公投第１５案,臺中市,和平區,南勢里,1585,956,169,399,568,46,614
公投第１５案,臺中市,和平區,南勢里,1586,963,131,467,598,35,633
公投第１５案,臺中市,和平區,天輪里,1587,456,74,182,256,15,271
公投第１５案,臺中市,和平區,博愛里,1588,1011,118,488,606,54,660
公投第１５案,臺中市,和平區,博愛里,1589,636,71,298,369,15,384
公投第１５案,臺中市,和平區,自由里,1590,270,27,147,174,7,181
公投第１５案,臺中市,和平區,自由里,1591,460,55,282,337,20,357
公投第１５案,臺中市,和平區,自由里,1592,321,50,176,226,17,243
公投第１５案,臺中市,和平區,達觀里,1593,783,143,337,480,36,516
公投第１５案,臺中市,和平區,達觀里,1594,336,57,160,217,14,231
公投第１５案,臺中市,和平區,中坑里,1595,451,85,224,309,12,321
公投第１５案,臺中市,和平區,梨山里,1596,366,35,158,193,15,208
公投第１５案,臺中市,和平區,梨山里,1597,771,79,271,350,12,362
公投第１５案,臺中市,和平區,梨山里,1598,574,61,231,292,29,321
公投第１５案,臺中市,和平區,梨山里,1599,274,32,125,157,14,171
公投第１５案,臺中市,和平區,平等里,1600,157,20,60,80,7,87
公投第１５案,臺中市,和平區,平等里,1601,713,73,343,416,28,444
公投第１５案,臺南市,後壁區,後壁里,1,743,122,264,386,40,426
公投第１５案,臺南市,後壁區,後壁里,2,898,137,295,432,15,447
公投第１５案,臺南市,後壁區,侯伯里,3,786,120,214,334,35,369
公投第１５案,臺南市,後壁區,侯伯里,4,534,93,150,243,32,275
公投第１５案,臺南市,後壁區,嘉苳里,5,1034,157,310,467,64,531
公投第１５案,臺南市,後壁區,嘉苳里,6,232,55,34,89,17,106
公投第１５案,臺南市,後壁區,土溝里,7,479,66,137,203,30,233
公投第１５案,臺南市,後壁區,土溝里,8,837,122,237,359,27,386
公投第１５案,臺南市,後壁區,上茄苳里,9,1085,161,258,419,29,448
公投第１５案,臺南市,後壁區,上茄苳里,10,1157,141,258,399,22,421
公投第１５案,臺南市,後壁區,菁豐里,11,755,99,236,335,50,385
公投第１５案,臺南市,後壁區,菁豐里,12,458,100,127,227,23,250
公投第１５案,臺南市,後壁區,菁寮里,13,371,40,114,154,19,173
公投第１５案,臺南市,後壁區,菁寮里,14,676,108,182,290,37,327
公投第１５案,臺南市,後壁區,菁寮里,15,428,53,114,167,23,190
公投第１５案,臺南市,後壁區,新嘉里,16,547,66,137,203,8,211
公投第１５案,臺南市,後壁區,新嘉里,17,455,69,128,197,39,236
公投第１５案,臺南市,後壁區,長短樹里,18,984,109,240,349,55,404
公投第１５案,臺南市,後壁區,長短樹里,19,483,75,117,192,32,224
公投第１５案,臺南市,後壁區,長短樹里,20,536,54,149,203,22,225
公投第１５案,臺南市,後壁區,竹新里,21,958,109,227,336,14,350
公投第１５案,臺南市,後壁區,竹新里,22,441,63,163,226,25,251
公投第１５案,臺南市,後壁區,新東里,23,677,113,189,302,59,361
公投第１５案,臺南市,後壁區,新東里,24,996,148,323,471,58,529
公投第１５案,臺南市,後壁區,頂安里,25,1255,175,356,531,24,555
公投第１５案,臺南市,後壁區,長安里,26,678,104,175,279,14,293
公投第１５案,臺南市,後壁區,長安里,27,553,60,164,224,7,231
公投第１５案,臺南市,後壁區,福安里,28,616,75,138,213,15,228
公投第１５案,臺南市,後壁區,福安里,29,1189,181,339,520,32,552
公投第１５案,臺南市,白河區,白河里,30,1176,200,358,558,69,627
公投第１５案,臺南市,白河區,白河里,31,546,99,160,259,15,274
公投第１５案,臺南市,白河區,永安里,32,859,181,264,445,21,466
公投第１５案,臺南市,白河區,永安里,33,946,160,335,495,30,525
公投第１５案,臺南市,白河區,永安里,34,1116,170,365,535,37,572
公投第１５案,臺南市,白河區,外角里,35,1397,173,350,523,25,548
公投第１５案,臺南市,白河區,庄內里,36,756,106,183,289,16,305
公投第１５案,臺南市,白河區,庄內里,37,871,131,249,380,46,426
公投第１５案,臺南市,白河區,秀祐里,38,897,135,280,415,31,446
公投第１５案,臺南市,白河區,河東里,39,784,94,148,242,34,276
公投第１５案,臺南市,白河區,河東里,40,572,79,139,218,16,234
公投第１５案,臺南市,白河區,虎山里,41,457,42,99,141,9,150
公投第１５案,臺南市,白河區,大林里,42,600,63,138,201,11,212
公投第１５案,臺南市,白河區,崁頭里,43,375,39,69,108,3,111
公投第１５案,臺南市,白河區,六溪里,44,508,47,74,121,12,133
公投第１５案,臺南市,白河區,關嶺里,45,631,64,124,188,13,201
公投第１５案,臺南市,白河區,關嶺里,46,391,39,73,112,7,119
公投第１５案,臺南市,白河區,仙草里,47,799,68,185,253,12,265
公投第１５案,臺南市,白河區,仙草里,48,506,48,105,153,16,169
公投第１５案,臺南市,白河區,詔豐里,49,832,133,217,350,22,372
公投第１５案,臺南市,白河區,詔豐里,50,1179,188,327,515,33,548
公投第１５案,臺南市,白河區,大竹里,51,744,100,144,244,11,255
公投第１５案,臺南市,白河區,大竹里,52,699,85,164,249,14,263
公投第１５案,臺南市,白河區,廣蓮里,53,633,76,132,208,12,220
公投第１５案,臺南市,白河區,廣蓮里,54,859,162,244,406,54,460
公投第１５案,臺南市,白河區,竹門里,55,884,124,223,347,40,387
公投第１５案,臺南市,白河區,崎內里,56,740,56,139,195,14,209
公投第１５案,臺南市,白河區,昇安里,57,1334,165,348,513,51,564
公投第１５案,臺南市,白河區,汴頭里,58,723,112,182,294,58,352
公投第１５案,臺南市,白河區,內角里,59,682,115,220,335,45,380
公投第１５案,臺南市,白河區,馬稠後里,60,855,160,237,397,41,438
公投第１５案,臺南市,白河區,馬稠後里,61,543,62,140,202,20,222
公投第１５案,臺南市,東山區,東山里,62,1401,168,400,568,51,619
公投第１５案,臺南市,東山區,東中里,63,1185,107,300,407,30,437
公投第１５案,臺南市,東山區,東中里,64,1303,175,312,487,47,534
公投第１５案,臺南市,東山區,東正里,65,732,83,183,266,28,294
公投第１５案,臺南市,東山區,東正里,66,721,84,158,242,33,275
公投第１５案,臺南市,東山區,大客里,67,1104,127,221,348,51,399
公投第１５案,臺南市,東山區,三榮里,68,943,113,244,357,27,384
公投第１５案,臺南市,東山區,科里里,69,653,52,103,155,4,159
公投第１５案,臺南市,東山區,科里里,70,596,90,143,233,61,294
公投第１５案,臺南市,東山區,東河里,71,878,131,216,347,51,398
公投第１５案,臺南市,東山區,聖賢里,72,771,170,109,279,42,321
公投第１５案,臺南市,東山區,聖賢里,73,483,76,118,194,16,210
公投第１５案,臺南市,東山區,聖賢里,74,640,104,180,284,34,318
公投第１５案,臺南市,東山區,南溪里,75,425,31,64,95,3,98
公投第１５案,臺南市,東山區,水雲里,76,394,39,99,138,7,145
公投第１５案,臺南市,東山區,林安里,77,373,50,107,157,30,187
公投第１５案,臺南市,東山區,東原里,78,1257,109,297,406,33,439
公投第１５案,臺南市,東山區,東原里,79,887,61,150,211,7,218
公投第１５案,臺南市,東山區,嶺南里,80,658,39,131,170,7,177
公投第１５案,臺南市,東山區,南勢里,81,1101,87,213,300,23,323
公投第１５案,臺南市,東山區,青山里,82,1057,78,195,273,16,289
公投第１５案,臺南市,東山區,高原里,83,639,80,196,276,29,305
公投第１５案,臺南市,東山區,高原里,84,270,35,65,100,17,117
公投第１５案,臺南市,鹽水區,水秀里,85,1037,162,337,499,59,558
公投第１５案,臺南市,鹽水區,水秀里,86,480,93,147,240,18,258
公投第１５案,臺南市,鹽水區,津城里,87,636,138,221,359,22,381
公投第１５案,臺南市,鹽水區,津城里,88,321,58,104,162,8,170
公投第１５案,臺南市,鹽水區,津城里,89,497,97,178,275,22,297
公投第１５案,臺南市,鹽水區,月港里,90,759,284,138,422,16,438
公投第１５案,臺南市,鹽水區,月港里,91,341,53,98,151,13,164
公投第１５案,臺南市,鹽水區,月港里,92,507,79,180,259,19,278
公投第１５案,臺南市,鹽水區,橋南里,93,863,132,229,361,16,377
公投第１５案,臺南市,鹽水區,橋南里,94,1373,210,427,637,21,658
公投第１５案,臺南市,鹽水區,橋南里,95,1507,243,452,695,55,750
公投第１５案,臺南市,鹽水區,岸內里,96,1374,236,437,673,55,728
公投第１５案,臺南市,鹽水區,岸內里,97,1244,191,348,539,40,579
公投第１５案,臺南市,鹽水區,岸內里,98,1022,147,347,494,44,538
公投第１５案,臺南市,鹽水區,汫水里,99,921,110,203,313,36,349
公投第１５案,臺南市,鹽水區,義中里,100,847,152,270,422,36,458
公投第１５案,臺南市,鹽水區,義中里,101,736,100,140,240,7,247
公投第１５案,臺南市,鹽水區,三明里,102,761,114,246,360,18,378
公投第１５案,臺南市,鹽水區,三明里,103,285,45,82,127,9,136
公投第１５案,臺南市,鹽水區,三明里,104,493,72,133,205,21,226
公投第１５案,臺南市,鹽水區,文昌里,105,621,65,151,216,21,237
公投第１５案,臺南市,鹽水區,文昌里,106,392,43,86,129,7,136
公投第１５案,臺南市,鹽水區,歡雅里,107,925,143,275,418,22,440
公投第１５案,臺南市,鹽水區,歡雅里,108,728,75,210,285,32,317
公投第１５案,臺南市,鹽水區,三和里,109,214,15,47,62,18,80
公投第１５案,臺南市,鹽水區,三和里,110,387,44,118,162,15,177
公投第１５案,臺南市,鹽水區,三和里,111,301,43,92,135,18,153
公投第１５案,臺南市,鹽水區,竹林里,112,755,97,167,264,29,293
公投第１５案,臺南市,鹽水區,竹林里,113,365,44,78,122,26,148
公投第１５案,臺南市,鹽水區,坔頭港里,114,935,150,241,391,28,419
公投第１５案,臺南市,鹽水區,坔頭港里,115,494,73,125,198,23,221
公投第１５案,臺南市,新營區,忠政里,116,1693,248,503,751,44,795
公投第１５案,臺南市,新營區,忠政里,117,1561,275,544,819,53,872
公投第１５案,臺南市,新營區,忠政里,118,1487,248,526,774,33,807
公投第１５案,臺南市,新營區,民權里,119,1232,206,418,624,15,639
公投第１５案,臺南市,新營區,民權里,120,1067,196,329,525,20,545
公投第１５案,臺南市,新營區,三仙里,121,1419,227,397,624,32,656
公投第１５案,臺南市,新營區,三仙里,122,1466,271,501,772,30,802
公投第１５案,臺南市,新營區,永平里,123,932,207,320,527,45,572
公投第１５案,臺南市,新營區,永平里,124,1099,168,315,483,19,502
公投第１５案,臺南市,新營區,永平里,125,757,114,225,339,22,361
公投第１５案,臺南市,新營區,大宏里,126,888,177,292,469,32,501
公投第１５案,臺南市,新營區,大宏里,127,1115,219,341,560,9,569
公投第１５案,臺南市,新營區,大宏里,128,937,156,288,444,12,456
公投第１５案,臺南市,新營區,王公里,129,1387,135,518,653,33,686
公投第１５案,臺南市,新營區,王公里,130,1526,249,467,716,43,759
公投第１５案,臺南市,新營區,王公里,131,1301,234,475,709,25,734
公投第１５案,臺南市,新營區,新東里,132,1538,285,552,837,33,870
公投第１５案,臺南市,新營區,新東里,133,1584,296,527,823,34,857
公投第１５案,臺南市,新營區,新東里,134,1583,339,532,871,21,892
公投第１５案,臺南市,新營區,新東里,135,1530,310,508,818,23,841
公投第１５案,臺南市,新營區,中營里,136,1193,242,419,661,34,695
公投第１５案,臺南市,新營區,土庫里,137,1439,261,297,558,13,571
公投第１５案,臺南市,新營區,興業里,138,1438,252,525,777,34,811
公投第１５案,臺南市,新營區,興業里,139,359,69,125,194,17,211
公投第１５案,臺南市,新營區,南興里,140,1233,181,321,502,24,526
公投第１５案,臺南市,新營區,南興里,141,1227,150,359,509,17,526
公投第１５案,臺南市,新營區,民生里,142,1320,202,382,584,22,606
公投第１５案,臺南市,新營區,民生里,143,1930,299,493,792,24,816
公投第１５案,臺南市,新營區,新北里,144,1501,266,495,761,28,789
公投第１５案,臺南市,新營區,新北里,145,1475,238,458,696,27,723
公投第１５案,臺南市,新營區,新北里,146,1753,324,574,898,37,935
公投第１５案,臺南市,新營區,新南里,147,1748,319,519,838,26,864
公投第１５案,臺南市,新營區,新南里,148,1741,294,558,852,41,893
公投第１５案,臺南市,新營區,新南里,149,1433,235,443,678,15,693
公投第１５案,臺南市,新營區,民榮里,150,1595,273,522,795,33,828
公投第１５案,臺南市,新營區,民榮里,151,959,143,277,420,20,440
公投第１５案,臺南市,新營區,民榮里,152,1865,299,556,855,53,908
公投第１５案,臺南市,新營區,埤寮里,153,1678,255,458,713,73,786
公投第１５案,臺南市,新營區,護鎮里,154,1373,190,379,569,53,622
公投第１５案,臺南市,新營區,太南里,155,1431,184,335,519,25,544
公投第１５案,臺南市,新營區,太南里,156,291,45,60,105,1,106
公投第１５案,臺南市,新營區,太北里,157,1749,312,511,823,33,856
公投第１５案,臺南市,新營區,南紙里,158,1862,275,546,821,30,851
公投第１５案,臺南市,新營區,南紙里,159,1821,325,584,909,73,982
公投第１５案,臺南市,新營區,嘉芳里,160,1845,273,534,807,54,861
公投第１５案,臺南市,新營區,姑爺里,161,542,56,140,196,9,205
公投第１５案,臺南市,新營區,姑爺里,162,402,58,87,145,1,146
公投第１５案,臺南市,新營區,五興里,163,703,131,224,355,56,411
公投第１５案,臺南市,新營區,五興里,164,941,130,259,389,30,419
公投第１５案,臺南市,柳營區,士林里,165,1166,197,337,534,43,577
公投第１５案,臺南市,柳營區,士林里,166,625,124,215,339,7,346
公投第１５案,臺南市,柳營區,光福里,167,738,96,205,301,22,323
公投第１５案,臺南市,柳營區,光福里,168,834,158,283,441,23,464
公投第１５案,臺南市,柳營區,中埕里,169,1104,173,304,477,31,508
公投第１５案,臺南市,柳營區,東昇里,170,1015,154,300,454,18,472
公投第１５案,臺南市,柳營區,東昇里,171,1720,269,594,863,81,944
公投第１５案,臺南市,柳營區,八翁里,172,1391,208,387,595,64,659
公投第１５案,臺南市,柳營區,人和里,173,425,60,128,188,10,198
公投第１５案,臺南市,柳營區,人和里,174,318,37,91,128,10,138
公投第１５案,臺南市,柳營區,太康里,175,753,114,223,337,35,372
公投第１５案,臺南市,柳營區,太康里,176,730,104,205,309,37,346
公投第１５案,臺南市,柳營區,重溪里,177,725,105,212,317,37,354
公投第１５案,臺南市,柳營區,重溪里,178,787,124,267,391,35,426
公投第１５案,臺南市,柳營區,重溪里,179,297,46,106,152,18,170
公投第１５案,臺南市,柳營區,篤農里,180,673,102,238,340,34,374
公投第１５案,臺南市,柳營區,篤農里,181,640,116,196,312,51,363
公投第１５案,臺南市,柳營區,大農里,182,660,105,158,263,32,295
公投第１５案,臺南市,柳營區,神農里,183,1212,172,326,498,33,531
公投第１５案,臺南市,柳營區,神農里,184,202,27,60,87,4,91
公投第１５案,臺南市,柳營區,果毅里,185,1049,134,305,439,70,509
公投第１５案,臺南市,柳營區,果毅里,186,158,28,46,74,1,75
公投第１５案,臺南市,柳營區,旭山里,187,921,136,273,409,55,464
公投第１５案,臺南市,柳營區,旭山里,188,504,68,152,220,12,232
公投第１５案,臺南市,柳營區,旭山里,189,157,15,47,62,3,65
公投第１５案,臺南市,北門區,永隆里,190,484,82,129,211,14,225
公投第１５案,臺南市,北門區,永隆里,191,401,45,110,155,11,166
公投第１５案,臺南市,北門區,北門里,192,456,41,130,171,5,176
公投第１５案,臺南市,北門區,北門里,193,382,74,115,189,17,206
公投第１５案,臺南市,北門區,玉港里,194,356,46,114,160,21,181
公投第１５案,臺南市,北門區,玉港里,195,389,48,91,139,4,143
公投第１５案,臺南市,北門區,保吉里,196,742,76,226,302,7,309
公投第１５案,臺南市,北門區,保吉里,197,599,67,189,256,10,266
公投第１５案,臺南市,北門區,蚵寮里,198,594,70,154,224,26,250
公投第１５案,臺南市,北門區,蚵寮里,199,572,69,161,230,15,245
公投第１５案,臺南市,北門區,蚵寮里,200,318,36,68,104,4,108
公投第１５案,臺南市,北門區,雙春里,201,473,57,111,168,9,177
公投第１５案,臺南市,北門區,錦湖里,202,954,86,222,308,17,325
公投第１５案,臺南市,北門區,慈安里,203,737,93,274,367,30,397
公投第１５案,臺南市,北門區,三光里,204,679,59,166,225,12,237
公投第１５案,臺南市,北門區,三光里,205,521,51,118,169,29,198
公投第１５案,臺南市,北門區,文山里,206,632,64,144,208,18,226
公投第１５案,臺南市,北門區,文山里,207,636,75,155,230,11,241
公投第１５案,臺南市,學甲區,秀昌里,208,862,156,288,444,40,484
公投第１５案,臺南市,學甲區,秀昌里,209,611,116,218,334,10,344
公投第１５案,臺南市,學甲區,秀昌里,210,936,153,295,448,28,476
公投第１５案,臺南市,學甲區,明宜里,211,1066,168,315,483,31,514
公投第１５案,臺南市,學甲區,明宜里,212,869,158,290,448,32,480
公投第１５案,臺南市,學甲區,慈福里,213,635,108,201,309,23,332
公投第１５案,臺南市,學甲區,慈福里,214,822,126,241,367,14,381
公投第１５案,臺南市,學甲區,慈福里,215,443,58,122,180,12,192
公投第１５案,臺南市,學甲區,仁得里,216,1370,219,437,656,36,692
公投第１５案,臺南市,學甲區,仁得里,217,1117,195,373,568,41,609
公投第１５案,臺南市,學甲區,仁得里,218,1365,201,418,619,61,680
公投第１５案,臺南市,學甲區,新達里,219,1489,197,469,666,47,713
公投第１５案,臺南市,學甲區,新達里,220,627,71,161,232,31,263
公投第１５案,臺南市,學甲區,新榮里,221,1052,195,309,504,22,526
公投第１５案,臺南市,學甲區,新榮里,222,1183,188,353,541,19,560
公投第１５案,臺南市,學甲區,大灣里,223,979,119,275,394,21,415
公投第１５案,臺南市,學甲區,豐和里,224,1241,181,332,513,44,557
公投第１５案,臺南市,學甲區,中洲里,225,843,102,200,302,19,321
公投第１５案,臺南市,學甲區,中洲里,226,580,86,168,254,27,281
公投第１５案,臺南市,學甲區,光華里,227,832,86,217,303,16,319
公投第１５案,臺南市,學甲區,光華里,228,406,44,101,145,5,150
公投第１５案,臺南市,學甲區,宅港里,229,818,132,260,392,33,425
公投第１５案,臺南市,學甲區,平和里,230,1052,130,260,390,16,406
公投第１５案,臺南市,學甲區,三慶里,231,578,73,155,228,14,242
公投第１５案,臺南市,學甲區,三慶里,232,430,52,107,159,19,178
公投第１５案,臺南市,學甲區,三慶里,233,361,43,117,160,7,167
公投第１５案,臺南市,將軍區,長榮里,234,1110,200,387,587,51,638
公投第１５案,臺南市,將軍區,西甲里,235,1418,101,450,551,23,574
公投第１５案,臺南市,將軍區,西甲里,236,969,136,309,445,25,470
公投第１５案,臺南市,將軍區,忠嘉里,237,519,86,180,266,37,303
公投第１５案,臺南市,將軍區,忠嘉里,238,1106,180,348,528,13,541
公投第１５案,臺南市,將軍區,忠嘉里,239,542,94,149,243,27,270
公投第１５案,臺南市,將軍區,忠嘉里,240,315,31,91,122,7,129
公投第１５案,臺南市,將軍區,苓仔寮里,241,584,69,150,219,23,242
公投第１５案,臺南市,將軍區,苓仔寮里,242,398,60,117,177,6,183
公投第１５案,臺南市,將軍區,苓仔寮里,243,608,15,151,166,87,253
公投第１５案,臺南市,將軍區,苓仔寮里,244,442,73,138,211,15,226
公投第１５案,臺南市,將軍區,巷埔里,245,650,70,163,233,8,241
公投第１５案,臺南市,將軍區,巷埔里,246,573,58,135,193,11,204
公投第１５案,臺南市,將軍區,將軍里,247,617,68,163,231,4,235
公投第１５案,臺南市,將軍區,將軍里,248,573,62,189,251,22,273
公投第１５案,臺南市,將軍區,將軍里,249,434,45,155,200,20,220
公投第１５案,臺南市,將軍區,玉山里,250,849,108,221,329,16,345
公投第１５案,臺南市,將軍區,廣山里,251,645,65,172,237,22,259
公投第１５案,臺南市,將軍區,長沙里,252,690,63,191,254,27,281
公投第１５案,臺南市,將軍區,長沙里,253,663,44,149,193,8,201
公投第１５案,臺南市,將軍區,平沙里,254,1175,136,359,495,25,520
公投第１５案,臺南市,將軍區,鯤鯓里,255,837,83,194,277,29,306
公投第１５案,臺南市,將軍區,鯤鯓里,256,1061,144,321,465,90,555
公投第１５案,臺南市,將軍區,鯤溟里,257,976,102,232,334,13,347
公投第１５案,臺南市,七股區,後港里,258,534,83,159,242,12,254
公投第１５案,臺南市,七股區,後港里,259,508,86,170,256,15,271
公投第１５案,臺南市,七股區,大潭里,260,665,83,173,256,5,261
公投第１５案,臺南市,七股區,篤加里,261,834,108,236,344,18,362
公投第１５案,臺南市,七股區,頂山里,262,810,88,255,343,10,353
公投第１５案,臺南市,七股區,西寮里,263,480,41,121,162,8,170
公投第１５案,臺南市,七股區,塩埕里,264,445,45,119,164,10,174
公投第１５案,臺南市,七股區,中寮里,265,680,48,132,180,14,194
公投第１５案,臺南市,七股區,龍山里,266,838,104,220,324,15,339
公投第１５案,臺南市,七股區,龍山里,267,780,85,194,279,18,297
公投第１５案,臺南市,七股區,溪南里,268,350,67,115,182,13,195
公投第１５案,臺南市,七股區,七股里,269,907,166,307,473,49,522
公投第１５案,臺南市,七股區,玉成里,270,780,86,239,325,19,344
公投第１５案,臺南市,七股區,大埕里,271,1658,242,467,709,26,735
公投第１５案,臺南市,七股區,大埕里,272,913,113,280,393,18,411
公投第１５案,臺南市,七股區,樹林里,273,1202,206,345,551,54,605
公投第１５案,臺南市,七股區,樹林里,274,696,71,178,249,7,256
公投第１５案,臺南市,七股區,竹橋里,275,647,100,191,291,29,320
公投第１５案,臺南市,七股區,竹橋里,276,622,116,245,361,31,392
公投第１５案,臺南市,七股區,義合里,277,1175,179,423,602,71,673
公投第１５案,臺南市,七股區,義合里,278,698,113,175,288,23,311
公投第１５案,臺南市,七股區,永吉里,279,983,146,317,463,49,512
公投第１５案,臺南市,七股區,三股里,280,1366,165,335,500,41,541
公投第１５案,臺南市,七股區,十份里,281,1379,182,361,543,65,608
公投第１５案,臺南市,佳里區,東寧里,282,1391,240,489,729,48,777
公投第１５案,臺南市,佳里區,東寧里,283,829,172,294,466,25,491
公投第１５案,臺南市,佳里區,忠仁里,284,1401,206,401,607,38,645
公投第１５案,臺南市,佳里區,忠仁里,285,1452,203,417,620,17,637
公投第１５案,臺南市,佳里區,鎮山里,286,1382,226,457,683,65,748
公投第１５案,臺南市,佳里區,鎮山里,287,1463,247,488,735,41,776
公投第１５案,臺南市,佳里區,鎮山里,288,1280,285,323,608,32,640
公投第１５案,臺南市,佳里區,鎮山里,289,1486,275,489,764,50,814
公投第１５案,臺南市,佳里區,安西里,290,1378,273,439,712,49,761
公投第１５案,臺南市,佳里區,安西里,291,1505,148,535,683,40,723
公投第１５案,臺南市,佳里區,安西里,292,1860,289,632,921,44,965
公投第１５案,臺南市,佳里區,安西里,293,1134,204,365,569,64,633
公投第１５案,臺南市,佳里區,文新里,294,1426,252,481,733,29,762
公投第１５案,臺南市,佳里區,文新里,295,1779,327,567,894,48,942
公投第１５案,臺南市,佳里區,文新里,296,1906,343,656,999,42,1041
公投第１５案,臺南市,佳里區,建南里,297,1425,235,457,692,30,722
公投第１５案,臺南市,佳里區,建南里,298,1255,215,407,622,37,659
公投第１５案,臺南市,佳里區,建南里,299,1524,235,468,703,47,750
公投第１５案,臺南市,佳里區,南勢里,300,1631,307,503,810,22,832
公投第１５案,臺南市,佳里區,南勢里,301,1546,271,552,823,42,865
公投第１５案,臺南市,佳里區,南勢里,302,1187,230,449,679,32,711
公投第１５案,臺南市,佳里區,六安里,303,1381,243,461,704,26,730
公投第１５案,臺南市,佳里區,六安里,304,1364,224,448,672,16,688
公投第１５案,臺南市,佳里區,六安里,305,1314,219,472,691,13,704
公投第１５案,臺南市,佳里區,佳化里,306,1164,186,414,600,50,650
公投第１５案,臺南市,佳里區,佳化里,307,961,150,339,489,32,521
公投第１５案,臺南市,佳里區,佳興里,308,1218,186,404,590,38,628
公投第１５案,臺南市,佳里區,佳興里,309,919,264,222,486,12,498
公投第１５案,臺南市,佳里區,營溪里,310,689,116,217,333,23,356
公投第１５案,臺南市,佳里區,營溪里,311,383,62,104,166,12,178
公投第１５案,臺南市,佳里區,海澄里,312,1507,199,480,679,42,721
公投第１５案,臺南市,佳里區,海澄里,313,702,107,210,317,29,346
公投第１５案,臺南市,佳里區,下營里,314,907,143,329,472,32,504
公投第１５案,臺南市,佳里區,下營里,315,937,175,338,513,39,552
公投第１５案,臺南市,佳里區,塭內里,316,1030,168,297,465,86,551
公投第１５案,臺南市,佳里區,塭內里,317,981,151,318,469,42,511
公投第１５案,臺南市,佳里區,塭內里,318,787,113,242,355,20,375
公投第１５案,臺南市,佳里區,民安里,319,1513,216,504,720,57,777
公投第１５案,臺南市,佳里區,子龍里,320,714,109,176,285,20,305
公投第１５案,臺南市,佳里區,子龍里,321,745,135,192,327,41,368
公投第１５案,臺南市,佳里區,子龍里,322,951,171,250,421,22,443
公投第１５案,臺南市,西港區,西港里,323,933,155,297,452,13,465
公投第１５案,臺南市,西港區,西港里,324,901,158,289,447,25,472
公投第１５案,臺南市,西港區,西港里,325,1314,202,392,594,24,618
公投第１５案,臺南市,西港區,慶安里,326,1349,223,419,642,51,693
公投第１５案,臺南市,西港區,慶安里,327,1014,180,347,527,36,563
公投第１５案,臺南市,西港區,慶安里,328,1900,237,503,740,22,762
公投第１５案,臺南市,西港區,南海里,329,1663,278,427,705,43,748
公投第１５案,臺南市,西港區,南海里,330,738,109,188,297,17,314
公投第１５案,臺南市,西港區,港東里,331,1211,199,411,610,38,648
公投第１５案,臺南市,西港區,港東里,332,382,69,97,166,19,185
公投第１５案,臺南市,西港區,檨林里,333,786,104,250,354,20,374
公投第１５案,臺南市,西港區,檨林里,334,838,115,273,388,15,403
公投第１５案,臺南市,西港區,後營里,335,1449,229,337,566,45,611
公投第１５案,臺南市,西港區,營西里,336,1479,188,413,601,25,626
公投第１５案,臺南市,西港區,金砂里,337,763,111,266,377,47,424
公投第１５案,臺南市,西港區,劉厝里,338,1297,177,388,565,16,581
公投第１５案,臺南市,西港區,竹林里,339,1393,210,401,611,32,643
公投第１５案,臺南市,西港區,永樂里,340,958,126,244,370,13,383
公投第１５案,臺南市,西港區,永樂里,341,391,73,122,195,21,216
公投第１５案,臺南市,西港區,新復里,342,805,113,264,377,46,423
公投第１５案,臺南市,下營區,下營里,343,1558,210,423,633,45,678
公投第１５案,臺南市,下營區,仁里里,344,1112,172,254,426,28,454
公投第１５案,臺南市,下營區,仁里里,345,893,123,259,382,42,424
公投第１５案,臺南市,下營區,宅內里,346,1623,190,439,629,49,678
公投第１５案,臺南市,下營區,後街里,347,1568,254,450,704,66,770
公投第１５案,臺南市,下營區,新興里,348,985,132,335,467,38,505
公投第１５案,臺南市,下營區,新興里,349,953,144,272,416,16,432
公投第１５案,臺南市,下營區,營前里,350,1031,164,202,366,112,478
公投第１５案,臺南市,下營區,營前里,351,1077,197,340,537,64,601
公投第１５案,臺南市,下營區,大吉里,352,703,100,159,259,36,295
公投第１５案,臺南市,下營區,大吉里,353,854,99,244,343,16,359
公投第１５案,臺南市,下營區,茅營里,354,1164,192,346,538,50,588
公投第１５案,臺南市,下營區,茅營里,355,1091,159,298,457,26,483
公投第１５案,臺南市,下營區,開化里,356,959,134,311,445,48,493
公投第１５案,臺南市,下營區,開化里,357,935,145,266,411,33,444
公投第１５案,臺南市,下營區,西連里,358,893,152,263,415,46,461
公投第１５案,臺南市,下營區,賀建里,359,1293,193,408,601,74,675
公投第１５案,臺南市,下營區,紅甲里,360,1185,198,319,517,108,625
公投第１５案,臺南市,下營區,紅甲里,361,1070,133,244,377,16,393
公投第１５案,臺南市,六甲區,六甲里,362,819,149,269,418,51,469
公投第１５案,臺南市,六甲區,六甲里,363,645,123,186,309,18,327
公投第１５案,臺南市,六甲區,六甲里,364,1444,248,361,609,46,655
公投第１５案,臺南市,六甲區,甲東里,365,1554,235,381,616,40,656
公投第１５案,臺南市,六甲區,甲東里,366,1171,169,290,459,40,499
公投第１５案,臺南市,六甲區,甲南里,367,1351,198,385,583,65,648
公投第１５案,臺南市,六甲區,七甲里,368,1010,138,258,396,72,468
公投第１５案,臺南市,六甲區,七甲里,369,919,145,240,385,48,433
公投第１５案,臺南市,六甲區,二甲里,370,1369,225,379,604,58,662
公投第１５案,臺南市,六甲區,二甲里,371,976,167,278,445,63,508
公投第１５案,臺南市,六甲區,二甲里,372,1015,171,331,502,47,549
公投第１５案,臺南市,六甲區,水林里,373,1176,317,185,502,25,527
公投第１５案,臺南市,六甲區,水林里,374,939,143,287,430,52,482
公投第１５案,臺南市,六甲區,中社里,375,712,134,196,330,43,373
公投第１５案,臺南市,六甲區,中社里,376,881,164,253,417,41,458
公投第１５案,臺南市,六甲區,龜港里,377,1184,212,419,631,60,691
公投第１５案,臺南市,六甲區,菁埔里,378,599,107,233,340,25,365
公投第１５案,臺南市,六甲區,王爺里,379,759,74,162,236,9,245
公投第１５案,臺南市,六甲區,大丘里,380,621,78,141,219,27,246
公投第１５案,臺南市,麻豆區,新興里,381,1205,213,363,576,38,614
公投第１５案,臺南市,麻豆區,新興里,382,660,135,218,353,17,370
公投第１５案,臺南市,麻豆區,巷口里,383,523,108,166,274,16,290
公投第１５案,臺南市,麻豆區,巷口里,384,1597,291,467,758,33,791
公投第１５案,臺南市,麻豆區,東角里,385,1262,256,395,651,51,702
公投第１５案,臺南市,麻豆區,東角里,386,1325,252,465,717,31,748
公投第１５案,臺南市,麻豆區,晋江里,387,1384,265,406,671,25,696
公投第１５案,臺南市,麻豆區,晋江里,388,1121,228,322,550,23,573
公投第１５案,臺南市,麻豆區,中興里,389,1021,190,287,477,12,489
公投第１５案,臺南市,麻豆區,中興里,390,954,192,262,454,21,475
公投第１５案,臺南市,麻豆區,興農里,391,1513,243,414,657,30,687
公投第１５案,臺南市,麻豆區,油車里,392,1726,246,490,736,31,767
公投第１５案,臺南市,麻豆區,油車里,393,1804,295,552,847,62,909
公投第１５案,臺南市,麻豆區,北勢里,394,1106,172,326,498,27,525
公投第１５案,臺南市,麻豆區,大埕里,395,1503,273,461,734,43,777
公投第１５案,臺南市,麻豆區,大埕里,396,1302,223,396,619,47,666
公投第１５案,臺南市,麻豆區,清水里,397,645,113,186,299,13,312
公投第１５案,臺南市,麻豆區,清水里,398,777,140,266,406,30,436
公投第１５案,臺南市,麻豆區,南勢里,399,1612,267,458,725,40,765
公投第１５案,臺南市,麻豆區,南勢里,400,718,123,175,298,15,313
公投第１５案,臺南市,麻豆區,寮廍里,401,1656,249,433,682,25,707
公投第１５案,臺南市,麻豆區,埤頭里,402,1355,255,344,599,66,665
公投第１５案,臺南市,麻豆區,埤頭里,403,977,151,230,381,27,408
公投第１５案,臺南市,麻豆區,海埔里,404,1012,163,267,430,26,456
公投第１５案,臺南市,麻豆區,海埔里,405,626,128,200,328,19,347
公投第１５案,臺南市,麻豆區,海埔里,406,467,55,90,145,5,150
公投第１５案,臺南市,麻豆區,港尾里,407,1260,189,348,537,27,564
公投第１５案,臺南市,麻豆區,麻口里,408,1111,182,355,537,45,582
公投第１５案,臺南市,麻豆區,安業里,409,550,117,159,276,20,296
公投第１５案,臺南市,麻豆區,安業里,410,798,150,212,362,49,411
公投第１５案,臺南市,麻豆區,謝厝寮里,411,852,158,291,449,62,511
公投第１５案,臺南市,麻豆區,謝厝寮里,412,830,137,198,335,13,348
公投第１５案,臺南市,麻豆區,安正里,413,941,158,223,381,21,402
公投第１５案,臺南市,麻豆區,井東里,414,1158,206,361,567,29,596
公投第１５案,臺南市,麻豆區,井東里,415,612,98,174,272,9,281
公投第１５案,臺南市,官田區,官田里,416,1104,157,317,474,17,491
公投第１５案,臺南市,官田區,官田里,417,965,156,278,434,40,474
公投第１５案,臺南市,官田區,二鎮里,418,1402,265,393,658,42,700
公投第１５案,臺南市,官田區,二鎮里,419,1653,304,512,816,91,907
公投第１５案,臺南市,官田區,烏山頭里,420,966,151,254,405,47,452
公投第１５案,臺南市,官田區,烏山頭里,421,284,39,73,112,13,125
公投第１５案,臺南市,官田區,大崎里,422,402,48,65,113,8,121
公投第１５案,臺南市,官田區,隆田里,423,982,186,293,479,10,489
公投第１５案,臺南市,官田區,隆田里,424,975,136,259,395,29,424
公投第１５案,臺南市,官田區,隆本里,425,802,130,246,376,23,399
公投第１５案,臺南市,官田區,隆本里,426,1118,190,379,569,37,606
公投第１５案,臺南市,官田區,隆本里,427,1455,242,444,686,34,720
公投第１５案,臺南市,官田區,南廍里,428,1208,185,389,574,32,606
公投第１５案,臺南市,官田區,東西庄里,429,1293,216,344,560,60,620
公投第１５案,臺南市,官田區,東西庄里,430,607,98,130,228,20,248
公投第１５案,臺南市,官田區,渡拔里,431,501,69,142,211,27,238
公投第１５案,臺南市,官田區,渡拔里,432,728,133,213,346,55,401
公投第１５案,臺南市,官田區,渡拔里,433,842,160,223,383,29,412
公投第１５案,臺南市,官田區,渡拔里,434,515,82,161,243,34,277
公投第１５案,臺南市,官田區,社子里,435,873,121,236,357,21,378
公投第１５案,臺南市,大內區,石湖里,436,759,91,188,279,49,328
公投第１５案,臺南市,大內區,石湖里,437,262,20,64,84,5,89
公投第１５案,臺南市,大內區,石林里,438,646,75,150,225,17,242
公投第１５案,臺南市,大內區,石城里,439,1473,188,355,543,57,600
公投第１５案,臺南市,大內區,內江里,440,915,125,306,431,66,497
公投第１５案,臺南市,大內區,大內里,441,779,154,251,405,34,439
公投第１５案,臺南市,大內區,內郭里,442,637,131,215,346,43,389
公投第１５案,臺南市,大內區,頭社里,443,993,133,275,408,34,442
公投第１５案,臺南市,大內區,環湖里,444,766,79,282,361,48,409
公投第１５案,臺南市,大內區,二溪里,445,841,109,273,382,40,422
公投第１５案,臺南市,大內區,曲溪里,446,583,66,187,253,33,286
公投第１５案,臺南市,楠西區,楠西里,447,978,97,323,420,56,476
公投第１５案,臺南市,楠西區,楠西里,448,870,134,299,433,43,476
公投第１５案,臺南市,楠西區,灣丘里,449,1160,88,296,384,14,398
公投第１５案,臺南市,楠西區,密枝里,450,699,72,216,288,15,303
公投第１５案,臺南市,楠西區,照興里,451,990,102,272,374,14,388
公投第１５案,臺南市,楠西區,鹿田里,452,928,140,247,387,28,415
公投第１５案,臺南市,楠西區,龜丹里,453,660,71,209,280,39,319
公投第１５案,臺南市,楠西區,東勢里,454,1187,155,358,513,74,587
公投第１５案,臺南市,楠西區,東勢里,455,1056,136,324,460,36,496
公投第１５案,臺南市,南化區,南化里,456,690,120,218,338,37,375
公投第１５案,臺南市,南化區,南化里,457,695,123,219,342,45,387
公投第１５案,臺南市,南化區,小崙里,458,806,93,228,321,37,358
公投第１５案,臺南市,南化區,東和里,459,654,65,168,233,39,272
公投第１５案,臺南市,南化區,西埔里,460,783,97,154,251,33,284
公投第１５案,臺南市,南化區,中坑里,461,425,56,136,192,13,205
公投第１５案,臺南市,南化區,北平里,462,559,76,170,246,30,276
公投第１５案,臺南市,南化區,北寮里,463,1189,156,335,491,33,524
公投第１５案,臺南市,南化區,玉山里,464,1044,143,363,506,34,540
公投第１５案,臺南市,南化區,關山里,465,941,125,340,465,22,487
公投第１５案,臺南市,玉井區,玉井里,466,1242,177,400,577,28,605
公投第１５案,臺南市,玉井區,玉田里,467,1141,142,420,562,36,598
公投第１５案,臺南市,玉井區,玉田里,468,698,98,221,319,25,344
公投第１５案,臺南市,玉井區,玉田里,469,849,140,259,399,27,426
公投第１５案,臺南市,玉井區,玉田里,470,949,125,329,454,57,511
公投第１５案,臺南市,玉井區,中正里,471,618,95,199,294,21,315
公投第１５案,臺南市,玉井區,中正里,472,594,72,167,239,8,247
公投第１５案,臺南市,玉井區,竹圍里,473,927,123,251,374,16,390
公投第１５案,臺南市,玉井區,竹圍里,474,512,72,167,239,36,275
公投第１５案,臺南市,玉井區,沙田里,475,509,69,149,218,24,242
公投第１５案,臺南市,玉井區,三埔里,476,496,70,173,243,24,267
公投第１５案,臺南市,玉井區,三和里,477,759,101,238,339,13,352
公投第１５案,臺南市,玉井區,望明里,478,669,68,184,252,8,260
公投第１５案,臺南市,玉井區,望明里,479,787,84,242,326,53,379
公投第１５案,臺南市,玉井區,層林里,480,620,80,174,254,38,292
公投第１５案,臺南市,玉井區,豐里里,481,987,149,305,454,48,502
公投第１５案,臺南市,左鎮區,光和里,482,392,51,114,165,24,189
公投第１５案,臺南市,左鎮區,榮和里,483,644,92,207,299,39,338
公投第１５案,臺南市,左鎮區,左鎮里,484,468,51,121,172,16,188
公投第１５案,臺南市,左鎮區,中正里,485,753,72,216,288,39,327
公投第１５案,臺南市,左鎮區,睦光里,486,345,39,98,137,24,161
公投第１５案,臺南市,左鎮區,內庄里,487,393,47,106,153,16,169
公投第１５案,臺南市,左鎮區,岡林里,488,420,46,132,178,17,195
公投第１５案,臺南市,左鎮區,草山里,489,313,28,78,106,12,118
公投第１５案,臺南市,左鎮區,二寮里,490,186,19,44,63,4,67
公投第１５案,臺南市,左鎮區,澄山里,491,504,56,129,185,41,226
公投第１５案,臺南市,善化區,東關里,492,1132,170,336,506,15,521
公投第１５案,臺南市,善化區,坐駕里,493,1845,312,543,855,57,912
公投第１５案,臺南市,善化區,坐駕里,494,2090,374,611,985,65,1050
公投第１５案,臺南市,善化區,光文里,495,1582,303,515,818,57,875
公投第１５案,臺南市,善化區,光文里,496,1901,394,604,998,56,1054
公投第１５案,臺南市,善化區,光文里,497,1818,338,574,912,40,952
公投第１５案,臺南市,善化區,文昌里,498,1639,283,524,807,51,858
公投第１５案,臺南市,善化區,文昌里,499,1061,215,350,565,32,597
公投第１５案,臺南市,善化區,南關里,500,1786,312,622,934,62,996
公投第１５案,臺南市,善化區,頂街里,501,1147,175,402,577,34,611
公投第１５案,臺南市,善化區,文正里,502,1581,276,454,730,56,786
公投第１５案,臺南市,善化區,胡家里,503,1240,234,334,568,88,656
公投第１５案,臺南市,善化區,胡厝里,504,1743,254,460,714,30,744
公投第１５案,臺南市,善化區,什乃里,505,1246,263,389,652,47,699
公投第１５案,臺南市,善化區,溪美里,506,961,164,284,448,28,476
公投第１５案,臺南市,善化區,溪美里,507,938,133,292,425,13,438
公投第１５案,臺南市,善化區,六分里,508,722,131,225,356,13,369
公投第１５案,臺南市,善化區,六德里,509,1062,155,310,465,27,492
公投第１５案,臺南市,善化區,田寮里,510,1715,280,517,797,79,876
公投第１５案,臺南市,善化區,昌隆里,511,1120,172,321,493,55,548
公投第１５案,臺南市,善化區,昌隆里,512,865,137,266,403,31,434
公投第１５案,臺南市,善化區,牛庄里,513,1574,297,457,754,67,821
公投第１５案,臺南市,善化區,嘉北里,514,1535,221,404,625,70,695
公投第１５案,臺南市,善化區,嘉南里,515,1106,204,319,523,60,583
公投第１５案,臺南市,善化區,小新里,516,1402,223,429,652,35,687
公投第１５案,臺南市,善化區,小新里,517,1458,268,536,804,63,867
公投第１５案,臺南市,善化區,小新里,518,1380,260,346,606,34,640
公投第１５案,臺南市,善化區,蓮潭里,519,1232,282,354,636,7,643
公投第１５案,臺南市,善化區,蓮潭里,520,1069,262,309,571,12,583
公投第１５案,臺南市,安定區,蘇林里,521,1251,236,473,709,61,770
公投第１５案,臺南市,安定區,蘇林里,522,899,154,308,462,33,495
公投第１５案,臺南市,安定區,蘇厝里,523,1106,189,358,547,61,608
公投第１５案,臺南市,安定區,蘇厝里,524,948,133,354,487,41,528
公投第１５案,臺南市,安定區,安定里,525,1442,252,415,667,31,698
公投第１５案,臺南市,安定區,安加里,526,1385,225,416,641,54,695
公投第１５案,臺南市,安定區,安加里,527,801,115,306,421,37,458
公投第１５案,臺南市,安定區,港尾里,528,736,112,207,319,24,343
公投第１５案,臺南市,安定區,港尾里,529,781,127,239,366,37,403
公投第１５案,臺南市,安定區,中榮里,530,795,141,278,419,16,435
公投第１５案,臺南市,安定區,中榮里,531,862,144,327,471,38,509
公投第１５案,臺南市,安定區,港口里,532,1487,202,484,686,29,715
公投第１５案,臺南市,安定區,港口里,533,1385,213,464,677,27,704
公投第１５案,臺南市,安定區,港南里,534,1518,250,51,301,28,329
公投第１５案,臺南市,安定區,港南里,535,1094,199,401,600,41,641
公投第１５案,臺南市,安定區,嘉同里,536,1590,243,553,796,86,882
公投第１５案,臺南市,安定區,嘉同里,537,754,115,290,405,22,427
公投第１５案,臺南市,安定區,中沙里,538,716,124,252,376,35,411
公投第１５案,臺南市,安定區,新吉里,539,1492,267,506,773,43,816
公投第１５案,臺南市,安定區,新吉里,540,943,179,313,492,26,518
公投第１５案,臺南市,安定區,海寮里,541,1157,187,419,606,29,635
公投第１５案,臺南市,安定區,海寮里,542,1384,241,465,706,63,769
公投第１５案,臺南市,安定區,文科里,543,967,176,310,486,40,526
公投第１５案,臺南市,安定區,文科里,544,611,113,200,313,17,330
公投第１５案,臺南市,新市區,新市里,545,960,155,286,441,29,470
公投第１５案,臺南市,新市區,新市里,546,1118,216,401,617,36,653
公投第１５案,臺南市,新市區,新市里,547,850,139,260,399,17,416
公投第１５案,臺南市,新市區,新和里,548,1241,217,394,611,48,659
公投第１５案,臺南市,新市區,新和里,549,1297,234,438,672,33,705
公投第１５案,臺南市,新市區,新和里,550,962,162,337,499,43,542
公投第１５案,臺南市,新市區,新和里,551,1237,220,439,659,40,699
公投第１５案,臺南市,新市區,新和里,552,1326,237,424,661,51,712
公投第１５案,臺南市,新市區,社內里,553,1211,237,402,639,58,697
公投第１５案,臺南市,新市區,社內里,554,1305,237,393,630,32,662
公投第１５案,臺南市,新市區,大洲里,555,688,108,236,344,33,377
公投第１５案,臺南市,新市區,豐華里,556,911,178,310,488,28,516
公投第１５案,臺南市,新市區,三舍里,557,1525,256,451,707,30,737
公投第１５案,臺南市,新市區,大營里,558,1091,169,279,448,7,455
公投第１５案,臺南市,新市區,大營里,559,1122,182,370,552,15,567
公投第１５案,臺南市,新市區,大營里,560,1049,174,331,505,25,530
公投第１５案,臺南市,新市區,大社里,561,1564,264,435,699,17,716
公投第１５案,臺南市,新市區,大社里,562,1515,254,514,768,44,812
公投第１５案,臺南市,新市區,大社里,563,1378,226,453,679,37,716
公投第１５案,臺南市,新市區,潭頂里,564,827,179,295,474,41,515
公投第１５案,臺南市,新市區,潭頂里,565,960,195,331,526,87,613
公投第１５案,臺南市,新市區,港墘里,566,951,141,319,460,40,500
公投第１５案,臺南市,新市區,港墘里,567,1264,218,433,651,43,694
公投第１５案,臺南市,新市區,港墘里,568,1173,220,369,589,30,619
公投第１５案,臺南市,新市區,永就里,569,684,125,248,373,18,391
公投第１５案,臺南市,新市區,永就里,570,1055,190,412,602,46,648
公投第１５案,臺南市,新市區,永就里,571,1122,241,421,662,29,691
公投第１５案,臺南市,山上區,明和里,572,855,103,203,306,56,362
公投第１５案,臺南市,山上區,明和里,573,836,97,200,297,32,329
公投第１５案,臺南市,山上區,南洲里,574,753,128,209,337,39,376
公投第１５案,臺南市,山上區,南洲里,575,788,113,226,339,32,371
公投第１５案,臺南市,山上區,山上里,576,984,158,303,461,33,494
公投第１５案,臺南市,山上區,新莊里,577,972,166,247,413,10,423
公投第１５案,臺南市,山上區,玉峯里,578,553,46,120,166,3,169
公投第１５案,臺南市,山上區,平陽里,579,378,58,93,151,6,157
公投第１５案,臺南市,山上區,豐德里,580,392,59,112,171,17,188
公投第１５案,臺南市,新化區,武安里,581,746,121,305,426,25,451
公投第１５案,臺南市,新化區,武安里,582,1102,219,401,620,33,653
公投第１５案,臺南市,新化區,武安里,583,370,58,147,205,11,216
公投第１５案,臺南市,新化區,武安里,584,947,294,220,514,53,567
公投第１５案,臺南市,新化區,東榮里,585,1154,172,373,545,58,603
公投第１５案,臺南市,新化區,東榮里,586,1082,214,335,549,58,607
公投第１５案,臺南市,新化區,東榮里,587,1075,202,365,567,44,611
公投第１５案,臺南市,新化區,東榮里,588,640,91,224,315,23,338
公投第１５案,臺南市,新化區,護國里,589,410,72,128,200,15,215
公投第１５案,臺南市,新化區,護國里,590,533,75,178,253,24,277
公投第１５案,臺南市,新化區,護國里,591,836,171,275,446,21,467
公投第１５案,臺南市,新化區,護國里,592,978,126,273,399,21,420
公投第１５案,臺南市,新化區,太平里,593,1348,270,432,702,31,733
公投第１５案,臺南市,新化區,太平里,594,1015,167,332,499,39,538
公投第１５案,臺南市,新化區,太平里,595,1228,189,359,548,33,581
公投第１５案,臺南市,新化區,太平里,596,789,157,252,409,46,455
公投第１５案,臺南市,新化區,協興里,597,1022,173,337,510,23,533
公投第１５案,臺南市,新化區,協興里,598,1021,163,343,506,16,522
公投第１５案,臺南市,新化區,協興里,599,1229,250,413,663,47,710
公投第１５案,臺南市,新化區,唪口里,600,1153,207,370,577,24,601
公投第１５案,臺南市,新化區,唪口里,601,1012,156,263,419,20,439
公投第１５案,臺南市,新化區,北勢里,602,1458,272,476,748,53,801
公投第１５案,臺南市,新化區,豐榮里,603,1645,283,577,860,57,917
公投第１５案,臺南市,新化區,豐榮里,604,1016,188,354,542,47,589
公投第１５案,臺南市,新化區,豐榮里,605,559,100,172,272,14,286
公投第１５案,臺南市,新化區,全興里,606,1222,237,418,655,26,681
公投第１５案,臺南市,新化區,全興里,607,1562,336,539,875,42,917
公投第１５案,臺南市,新化區,崙頂里,608,994,154,290,444,30,474
公投第１５案,臺南市,新化區,崙頂里,609,1013,160,337,497,66,563
公投第１５案,臺南市,新化區,知義里,610,1197,209,405,614,58,672
公投第１５案,臺南市,新化區,知義里,611,1021,144,326,470,43,513
公投第１５案,臺南市,新化區,山脚里,612,1428,197,389,586,60,646
公投第１５案,臺南市,新化區,大坑里,613,456,74,115,189,27,216
公投第１５案,臺南市,新化區,𦰡拔里,614,1037,164,368,532,50,582
公投第１５案,臺南市,新化區,𦰡拔里,615,1097,176,384,560,54,614
公投第１５案,臺南市,新化區,羊林里,616,902,152,303,455,47,502
公投第１５案,臺南市,新化區,礁坑里,617,999,137,285,422,88,510
公投第１５案,臺南市,安南區,東和里,618,2549,527,792,1319,26,1345
公投第１５案,臺南市,安南區,󻕯南里,619,2321,372,764,1136,57,1193
公投第１５案,臺南市,安南區,󻕯南里,620,2156,384,752,1136,58,1194
公投第１５案,臺南市,安南區,州南里,621,1662,292,621,913,58,971
公投第１５案,臺南市,安南區,州南里,622,1512,250,566,816,75,891
公投第１５案,臺南市,安南區,州南里,623,1625,255,519,774,51,825
公投第１５案,臺南市,安南區,安順里,624,2143,332,619,951,47,998
公投第１５案,臺南市,安南區,安順里,625,2457,462,795,1257,69,1326
公投第１５案,臺南市,安南區,州北里,626,2148,404,725,1129,72,1201
公投第１５案,臺南市,安南區,州北里,627,2364,455,710,1165,67,1232
公投第１５案,臺南市,安南區,新順里,628,1868,380,489,869,40,909
公投第１５案,臺南市,安南區,新順里,629,1797,353,639,992,56,1048
公投第１５案,臺南市,安南區,新順里,630,2268,367,814,1181,39,1220
公投第１５案,臺南市,安南區,頂安里,631,2291,360,614,974,63,1037
公投第１５案,臺南市,安南區,頂安里,632,2255,387,725,1112,40,1152
公投第１５案,臺南市,安南區,安慶里,633,1940,338,545,883,57,940
公投第１５案,臺南市,安南區,安慶里,634,2013,280,767,1047,43,1090
公投第１５案,臺南市,安南區,安慶里,635,2024,340,658,998,47,1045
公投第１５案,臺南市,安南區,溪北里,636,1613,349,569,918,65,983
公投第１５案,臺南市,安南區,溪北里,637,1178,203,379,582,30,612
公投第１５案,臺南市,安南區,安和里,638,2143,349,728,1077,73,1150
公投第１５案,臺南市,安南區,安西里,639,1721,361,540,901,64,965
公投第１５案,臺南市,安南區,安西里,640,1773,345,613,958,50,1008
公投第１５案,臺南市,安南區,溪頂里,641,1428,291,458,749,18,767
公投第１５案,臺南市,安南區,溪頂里,642,1626,284,562,846,45,891
公投第１５案,臺南市,安南區,溪頂里,643,1358,275,425,700,34,734
公投第１５案,臺南市,安南區,安東里,644,1447,266,546,812,37,849
公投第１５案,臺南市,安南區,安東里,645,1358,266,439,705,66,771
公投第１５案,臺南市,安南區,鳳凰里,646,2116,337,674,1011,32,1043
公投第１５案,臺南市,安南區,鳳凰里,647,2321,254,819,1073,42,1115
公投第１５案,臺南市,安南區,梅花里,648,2117,363,671,1034,30,1064
公投第１５案,臺南市,安南區,梅花里,649,1927,323,582,905,54,959
公投第１５案,臺南市,安南區,理想里,650,2242,386,679,1065,82,1147
公投第１５案,臺南市,安南區,理想里,651,2334,361,729,1090,42,1132
公投第１５案,臺南市,安南區,大安里,652,1822,330,613,943,49,992
公投第１５案,臺南市,安南區,大安里,653,1813,324,622,946,70,1016
公投第１５案,臺南市,安南區,原佃里,654,2188,377,709,1086,82,1168
公投第１５案,臺南市,安南區,長安里,655,2399,386,711,1097,76,1173
公投第１５案,臺南市,安南區,長安里,656,2247,356,647,1003,57,1060
公投第１５案,臺南市,安南區,公親里,657,1165,220,445,665,54,719
公投第１５案,臺南市,安南區,布袋里,658,1539,251,484,735,42,777
公投第１５案,臺南市,安南區,總頭里,659,1835,321,631,952,83,1035
公投第１５案,臺南市,安南區,南興里,660,1797,297,610,907,66,973
公投第１５案,臺南市,安南區,學東里,661,2223,370,659,1029,69,1098
公投第１５案,臺南市,安南區,公󻕯里,662,977,197,372,569,53,622
公投第１５案,臺南市,安南區,佃東里,663,1642,255,478,733,34,767
公投第１５案,臺南市,安南區,佃東里,664,1697,313,574,887,53,940
公投第１５案,臺南市,安南區,佃西里,665,1966,299,604,903,48,951
公投第１５案,臺南市,安南區,淵西里,666,1319,225,422,647,53,700
公投第１５案,臺南市,安南區,淵西里,667,1909,346,533,879,56,935
公投第１５案,臺南市,安南區,海西里,668,1763,300,600,900,48,948
公投第１５案,臺南市,安南區,海西里,669,965,194,279,473,43,516
公投第１５案,臺南市,安南區,海東里,670,1547,226,440,666,42,708
公投第１５案,臺南市,安南區,海東里,671,1784,311,549,860,44,904
公投第１５案,臺南市,安南區,海東里,672,2145,330,634,964,60,1024
公投第１５案,臺南市,安南區,溪心里,673,2443,471,808,1279,51,1330
公投第１５案,臺南市,安南區,溪心里,674,2565,379,716,1095,35,1130
公投第１５案,臺南市,安南區,溪心里,675,2480,398,830,1228,60,1288
公投第１５案,臺南市,安南區,淵東里,676,2349,363,620,983,76,1059
公投第１５案,臺南市,安南區,淵東里,677,2168,398,699,1097,64,1161
公投第１５案,臺南市,安南區,淵中里,678,1630,269,534,803,42,845
公投第１５案,臺南市,安南區,淵中里,679,1675,255,504,759,30,789
公投第１５案,臺南市,安南區,溪墘里,680,1627,400,543,943,76,1019
公投第１５案,臺南市,安南區,溪墘里,681,1493,254,507,761,56,817
公投第１５案,臺南市,安南區,海佃里,682,1397,240,484,724,63,787
公投第１５案,臺南市,安南區,海佃里,683,1416,237,457,694,50,744
公投第１５案,臺南市,安南區,海佃里,684,1460,264,475,739,36,775
公投第１５案,臺南市,安南區,國安里,685,2222,324,652,976,34,1010
公投第１５案,臺南市,安南區,溪東里,686,2070,369,664,1033,65,1098
公投第１５案,臺南市,安南區,溪東里,687,1739,312,615,927,32,959
公投第１５案,臺南市,安南區,安富里,688,1830,302,575,877,65,942
公投第１５案,臺南市,安南區,安富里,689,1803,327,666,993,63,1056
公投第１５案,臺南市,安南區,安富里,690,1800,353,610,963,52,1015
公投第１５案,臺南市,安南區,幸福里,691,1815,297,500,797,55,852
公投第１５案,臺南市,安南區,幸福里,692,1846,280,580,860,30,890
公投第１５案,臺南市,安南區,海南里,693,905,180,330,510,47,557
公投第１５案,臺南市,安南區,海南里,694,1073,220,384,604,60,664
公投第１５案,臺南市,安南區,城東里,695,1579,269,587,856,58,914
公投第１５案,臺南市,安南區,城南里,696,1876,300,589,889,84,973
公投第１５案,臺南市,安南區,城南里,697,1194,207,373,580,37,617
公投第１５案,臺南市,安南區,青草里,698,1475,178,392,570,25,595
公投第１５案,臺南市,安南區,城西里,699,1380,199,464,663,19,682
公投第１５案,臺南市,安南區,城北里,700,1462,256,432,688,33,721
公投第１５案,臺南市,安南區,城中里,701,1044,172,396,568,50,618
公投第１５案,臺南市,安南區,砂崙里,702,603,134,223,357,38,395
公投第１５案,臺南市,安南區,砂崙里,703,690,120,259,379,20,399
公投第１５案,臺南市,安南區,顯宮里,704,1447,238,442,680,43,723
公投第１５案,臺南市,安南區,鹿耳里,705,910,175,391,566,32,598
公投第１５案,臺南市,安南區,四草里,706,1850,264,563,827,67,894
公投第１５案,臺南市,安南區,塩田里,707,1501,263,570,833,47,880
公投第１５案,臺南市,永康區,五王里,708,1398,233,470,703,61,764
公投第１５案,臺南市,永康區,五王里,709,1478,229,409,638,25,663
公投第１５案,臺南市,永康區,五王里,710,1442,261,446,707,18,725
公投第１５案,臺南市,永康區,五王里,711,1353,220,416,636,30,666
公投第１５案,臺南市,永康區,三合里,712,1160,201,371,572,28,600
公投第１５案,臺南市,永康區,三合里,713,1122,198,395,593,25,618
公投第１５案,臺南市,永康區,三合里,714,1165,194,381,575,10,585
公投第１５案,臺南市,永康區,六合里,715,1317,246,384,630,26,656
公投第１５案,臺南市,永康區,六合里,716,1376,215,459,674,31,705
公投第１５案,臺南市,永康區,六合里,717,1361,259,440,699,28,727
公投第１５案,臺南市,永康區,六合里,718,1374,309,471,780,23,803
公投第１５案,臺南市,永康區,網寮里,719,1709,297,493,790,48,838
公投第１５案,臺南市,永康區,網寮里,720,1717,277,517,794,38,832
公投第１５案,臺南市,永康區,網寮里,721,1759,283,530,813,33,846
公投第１５案,臺南市,永康區,網寮里,722,1636,275,552,827,31,858
公投第１５案,臺南市,永康區,二王里,723,1442,254,467,721,42,763
公投第１５案,臺南市,永康區,二王里,724,1545,270,486,756,20,776
公投第１５案,臺南市,永康區,二王里,725,1565,223,540,763,34,797
公投第１５案,臺南市,永康區,二王里,726,1684,281,505,786,28,814
公投第１５案,臺南市,永康區,二王里,727,1548,250,494,744,14,758
公投第１５案,臺南市,永康區,永康里,728,1389,240,499,739,25,764
公投第１５案,臺南市,永康區,永康里,729,1369,259,424,683,43,726
公投第１５案,臺南市,永康區,永康里,730,1415,227,486,713,60,773
公投第１５案,臺南市,永康區,永康里,731,1386,214,409,623,7,630
公投第１５案,臺南市,永康區,永康里,732,1747,147,269,416,7,423
公投第１５案,臺南市,永康區,永康里,733,1485,249,481,730,37,767
公投第１５案,臺南市,永康區,埔園里,734,1747,308,532,840,53,893
公投第１５案,臺南市,永康區,埔園里,735,1744,275,483,758,37,795
公投第１５案,臺南市,永康區,埔園里,736,1797,274,547,821,33,854
公投第１５案,臺南市,永康區,埔園里,737,1800,321,604,925,50,975
公投第１５案,臺南市,永康區,龍埔里,738,1720,245,576,821,15,836
公投第１５案,臺南市,永康區,龍埔里,739,1708,312,580,892,28,920
公投第１５案,臺南市,永康區,正強里,740,1519,280,562,842,17,859
公投第１５案,臺南市,永康區,正強里,741,1497,253,530,783,58,841
公投第１５案,臺南市,永康區,正強里,742,1509,237,559,796,15,811
公投第１５案,臺南市,永康區,正強里,743,1542,263,585,848,61,909
公投第１５案,臺南市,永康區,正強里,744,1536,326,493,819,22,841
公投第１５案,臺南市,永康區,大橋里,745,1531,279,507,786,37,823
公投第１５案,臺南市,永康區,大橋里,746,1327,250,465,715,29,744
公投第１５案,臺南市,永康區,大橋里,747,1456,272,477,749,13,762
公投第１５案,臺南市,永康區,大橋里,748,1396,298,452,750,28,778
公投第１５案,臺南市,永康區,東橋里,749,1636,272,528,800,44,844
公投第１５案,臺南市,永康區,東橋里,750,1592,322,517,839,25,864
公投第１５案,臺南市,永康區,東橋里,751,2017,432,513,945,15,960
公投第１５案,臺南市,永康區,東橋里,752,672,120,233,353,14,367
公投第１５案,臺南市,永康區,西橋里,753,1611,257,499,756,22,778
公投第１５案,臺南市,永康區,西橋里,754,1502,310,450,760,33,793
公投第１５案,臺南市,永康區,安康里,755,1660,272,452,724,17,741
公投第１５案,臺南市,永康區,安康里,756,1561,272,394,666,27,693
公投第１５案,臺南市,永康區,安康里,757,1590,296,460,756,25,781
公投第１５案,臺南市,永康區,蔦松里,758,924,193,271,464,18,482
公投第１５案,臺南市,永康區,蔦松里,759,938,185,337,522,24,546
公投第１５案,臺南市,永康區,三民里,760,957,185,322,507,32,539
公投第１５案,臺南市,永康區,三民里,761,496,91,160,251,26,277
公投第１５案,臺南市,永康區,塩行里,762,1717,309,553,862,47,909
公投第１５案,臺南市,永康區,塩行里,763,1615,276,474,750,31,781
公投第１５案,臺南市,永康區,塩行里,764,1554,256,494,750,19,769
公投第１５案,臺南市,永康區,塩興里,765,1196,189,394,583,18,601
公投第１５案,臺南市,永康區,塩興里,766,1274,246,395,641,24,665
公投第１５案,臺南市,永康區,塩興里,767,1215,223,403,626,26,652
公投第１５案,臺南市,永康區,塩洲里,768,1457,256,493,749,19,768
公投第１５案,臺南市,永康區,塩洲里,769,1451,265,500,765,15,780
公投第１５案,臺南市,永康區,塩洲里,770,1423,227,424,651,39,690
公投第１５案,臺南市,永康區,塩洲里,771,1394,218,511,729,28,757
公投第１５案,臺南市,永康區,甲頂里,772,890,170,315,485,32,517
公投第１５案,臺南市,永康區,甲頂里,773,1018,202,379,581,34,615
公投第１５案,臺南市,永康區,甲頂里,774,368,64,132,196,19,215
公投第１５案,臺南市,永康區,尚頂里,775,1208,238,439,677,43,720
公投第１５案,臺南市,永康區,尚頂里,776,1187,222,366,588,27,615
公投第１５案,臺南市,永康區,尚頂里,777,1381,261,422,683,20,703
公投第１５案,臺南市,永康區,龍潭里,778,1405,232,454,686,47,733
公投第１５案,臺南市,永康區,龍潭里,779,1445,250,427,677,51,728
公投第１５案,臺南市,永康區,龍潭里,780,1687,313,497,810,42,852
公投第１５案,臺南市,永康區,龍潭里,781,1535,243,425,668,29,697
公投第１５案,臺南市,永康區,永明里,782,1542,283,521,804,33,837
公投第１５案,臺南市,永康區,永明里,783,1618,273,526,799,25,824
公投第１５案,臺南市,永康區,永明里,784,1338,269,457,726,17,743
公投第１５案,臺南市,永康區,王行里,785,1285,246,445,691,53,744
公投第１５案,臺南市,永康區,王行里,786,1240,218,402,620,22,642
公投第１５案,臺南市,永康區,烏竹里,787,1343,216,417,633,46,679
公投第１５案,臺南市,永康區,烏竹里,788,1327,250,482,732,34,766
公投第１５案,臺南市,永康區,西勢里,789,1565,300,484,784,32,816
公投第１５案,臺南市,永康區,西勢里,790,1476,279,474,753,70,823
公投第１５案,臺南市,永康區,西勢里,791,1476,475,264,739,36,775
公投第１５案,臺南市,永康區,西勢里,792,1463,301,505,806,36,842
公投第１５案,臺南市,永康區,新樹里,793,983,198,309,507,69,576
公投第１５案,臺南市,永康區,新樹里,794,1116,192,409,601,53,654
公投第１５案,臺南市,永康區,大灣里,795,1117,194,347,541,51,592
公投第１５案,臺南市,永康區,大灣里,796,1069,177,328,505,18,523
公投第１５案,臺南市,永康區,大灣里,797,1180,223,436,659,38,697
公投第１５案,臺南市,永康區,東灣里,798,1176,197,386,583,67,650
公投第１５案,臺南市,永康區,東灣里,799,1158,206,361,567,41,608
公投第１５案,臺南市,永康區,東灣里,800,1208,241,425,666,48,714
公投第１５案,臺南市,永康區,西灣里,801,1501,274,476,750,56,806
公投第１５案,臺南市,永康區,西灣里,802,1298,245,454,699,22,721
公投第１５案,臺南市,永康區,西灣里,803,1542,286,503,789,21,810
公投第１５案,臺南市,永康區,西灣里,804,1537,304,526,830,31,861
公投第１５案,臺南市,永康區,西灣里,805,1359,306,484,790,35,825
公投第１５案,臺南市,永康區,南灣里,806,1139,178,333,511,26,537
公投第１５案,臺南市,永康區,南灣里,807,1158,200,345,545,30,575
公投第１５案,臺南市,永康區,南灣里,808,1538,286,441,727,56,783
公投第１５案,臺南市,永康區,崑山里,809,1166,180,381,561,17,578
公投第１５案,臺南市,永康區,崑山里,810,1228,213,385,598,22,620
公投第１５案,臺南市,永康區,崑山里,811,1200,231,404,635,41,676
公投第１５案,臺南市,永康區,崑山里,812,1131,248,359,607,31,638
公投第１５案,臺南市,永康區,崑山里,813,1147,213,379,592,18,610
公投第１５案,臺南市,永康區,北灣里,814,1442,237,442,679,53,732
公投第１５案,臺南市,永康區,北灣里,815,1325,235,411,646,22,668
公投第１５案,臺南市,永康區,北灣里,816,1260,193,373,566,30,596
公投第１５案,臺南市,永康區,北興里,817,1631,242,509,751,50,801
公投第１５案,臺南市,永康區,北興里,818,1549,246,495,741,29,770
公投第１５案,臺南市,永康區,北興里,819,1666,284,530,814,22,836
公投第１５案,臺南市,永康區,復興里,820,1012,124,339,463,34,497
公投第１５案,臺南市,永康區,復興里,821,976,129,301,430,19,449
公投第１５案,臺南市,永康區,光復里,822,531,82,197,279,11,290
公投第１５案,臺南市,永康區,建國里,823,859,157,290,447,40,487
公投第１５案,臺南市,永康區,建國里,824,937,171,266,437,32,469
公投第１５案,臺南市,永康區,復國里,825,1307,207,466,673,30,703
公投第１５案,臺南市,永康區,復國里,826,1482,215,471,686,24,710
公投第１５案,臺南市,永康區,復國里,827,1341,203,405,608,24,632
公投第１５案,臺南市,永康區,復國里,828,1376,228,442,670,31,701
公投第１５案,臺南市,永康區,復國里,829,1390,209,450,659,32,691
公投第１５案,臺南市,永康區,復國里,830,1534,263,541,804,28,832
公投第１５案,臺南市,永康區,復華里,831,1460,247,535,782,31,813
公投第１５案,臺南市,永康區,復華里,832,1383,227,462,689,14,703
公投第１５案,臺南市,永康區,復華里,833,1299,232,436,668,26,694
公投第１５案,臺南市,永康區,復華里,834,1264,247,448,695,15,710
公投第１５案,臺南市,永康區,復華里,835,1355,269,468,737,31,768
公投第１５案,臺南市,永康區,復華里,836,1414,220,463,683,23,706
公投第１５案,臺南市,永康區,復華里,837,1109,213,392,605,24,629
公投第１５案,臺南市,永康區,神洲里,838,1151,166,388,554,35,589
公投第１５案,臺南市,永康區,成功里,839,1026,104,522,626,34,660
公投第１５案,臺南市,永康區,成功里,840,1071,147,381,528,22,550
公投第１５案,臺南市,永康區,中華里,841,1387,279,548,827,45,872
公投第１５案,臺南市,永康區,中華里,842,1377,264,521,785,30,815
公投第１５案,臺南市,永康區,中興里,843,1687,285,568,853,54,907
公投第１５案,臺南市,永康區,中興里,844,1700,295,507,802,41,843
公投第１５案,臺南市,永康區,勝利里,845,1444,274,502,776,27,803
公投第１５案,臺南市,永康區,勝利里,846,1485,239,496,735,27,762
公投第１５案,臺南市,永康區,勝利里,847,1717,255,536,791,33,824
公投第１５案,臺南市,永康區,勝利里,848,1701,272,491,763,38,801
公投第１５案,臺南市,永康區,勝利里,849,1382,238,444,682,22,704
公投第１５案,臺南市,北區,開元里,850,1793,289,558,847,64,911
公投第１５案,臺南市,北區,開元里,851,1708,268,528,796,39,835
公投第１５案,臺南市,北區,元寶里,852,997,211,294,505,9,514
公投第１５案,臺南市,北區,元寶里,853,1452,274,363,637,16,653
公投第１５案,臺南市,北區,元寶里,854,1351,262,402,664,19,683
公投第１５案,臺南市,北區,合興里,855,1323,280,505,785,43,828
公投第１５案,臺南市,北區,合興里,856,1073,192,400,592,20,612
公投第１５案,臺南市,北區,合興里,857,1138,209,428,637,25,662
公投第１５案,臺南市,北區,力行里,858,1189,194,410,604,29,633
公投第１５案,臺南市,北區,力行里,859,1262,275,466,741,28,769
公投第１５案,臺南市,北區,重興里,860,1017,230,364,594,16,610
公投第１５案,臺南市,北區,重興里,861,847,152,300,452,16,468
公投第１５案,臺南市,北區,東興里,862,1076,165,426,591,31,622
公投第１５案,臺南市,北區,東興里,863,954,182,364,546,23,569
公投第１５案,臺南市,北區,長勝里,864,1300,196,437,633,61,694
公投第１５案,臺南市,北區,長勝里,865,1390,199,505,704,33,737
公投第１５案,臺南市,北區,長勝里,866,1318,209,500,709,34,743
公投第１５案,臺南市,北區,振興里,867,974,171,331,502,16,518
公投第１５案,臺南市,北區,振興里,868,990,184,341,525,18,543
公投第１５案,臺南市,北區,仁愛里,869,1016,234,370,604,21,625
公投第１５案,臺南市,北區,仁愛里,870,1053,186,380,566,25,591
公投第１５案,臺南市,北區,中樓里,871,1466,264,449,713,50,763
公投第１５案,臺南市,北區,永祥里,872,1535,271,544,815,38,853
公投第１５案,臺南市,北區,永祥里,873,1544,246,541,787,43,830
公投第１５案,臺南市,北區,北門里,874,1760,496,441,937,46,983
公投第１５案,臺南市,北區,北門里,875,1372,229,457,686,20,706
公投第１５案,臺南市,北區,北門里,876,1002,179,377,556,31,587
公投第１５案,臺南市,北區,北門里,877,1171,208,440,648,33,681
公投第１５案,臺南市,北區,大光里,878,1285,195,418,613,21,634
公投第１５案,臺南市,北區,大光里,879,1036,149,373,522,24,546
公投第１５案,臺南市,北區,大光里,880,1392,224,485,709,40,749
公投第１５案,臺南市,北區,大光里,881,1147,174,425,599,41,640
公投第１５案,臺南市,北區,大興里,882,1526,208,461,669,25,694
公投第１５案,臺南市,北區,大興里,883,1559,281,517,798,31,829
公投第１５案,臺南市,北區,公園里,884,892,147,309,456,55,511
公投第１５案,臺南市,北區,公園里,885,937,182,272,454,35,489
公投第１５案,臺南市,北區,北華里,886,1449,281,506,787,46,833
公投第１５案,臺南市,北區,北華里,887,1160,219,371,590,25,615
公投第１５案,臺南市,北區,北華里,888,1567,219,339,558,37,595
公投第１５案,臺南市,北區,長興里,889,1346,243,427,670,45,715
公投第１５案,臺南市,北區,長興里,890,1451,263,419,682,11,693
公投第１５案,臺南市,北區,小北里,891,1522,277,475,752,30,782
公投第１５案,臺南市,北區,小北里,892,1278,214,433,647,19,666
公投第１５案,臺南市,北區,小北里,893,1164,179,385,564,38,602
公投第１５案,臺南市,北區,正覺里,894,1091,203,307,510,14,524
公投第１５案,臺南市,北區,正覺里,895,993,159,339,498,17,515
公投第１５案,臺南市,北區,正覺里,896,1119,175,327,502,26,528
公投第１５案,臺南市,北區,成功里,897,1685,327,552,879,49,928
公投第１５案,臺南市,北區,成功里,898,1368,283,436,719,11,730
公投第１５案,臺南市,北區,成功里,899,1389,259,461,720,35,755
公投第１５案,臺南市,北區,華德里,900,1469,326,500,826,20,846
公投第１５案,臺南市,北區,華德里,901,1655,345,570,915,36,951
公投第１５案,臺南市,北區,福德里,902,1261,256,444,700,21,721
公投第１５案,臺南市,北區,福德里,903,1490,270,494,764,13,777
公投第１５案,臺南市,北區,福德里,904,1436,303,506,809,24,833
公投第１５案,臺南市,北區,成德里,905,1340,252,491,743,51,794
公投第１５案,臺南市,北區,成德里,906,1464,313,466,779,31,810
公投第１５案,臺南市,北區,成德里,907,1513,324,521,845,26,871
公投第１５案,臺南市,北區,和順里,908,1709,385,556,941,15,956
公投第１５案,臺南市,北區,和順里,909,1517,382,496,878,31,909
公投第１５案,臺南市,北區,和順里,910,1598,317,507,824,25,849
公投第１５案,臺南市,北區,立人里,911,1399,294,411,705,33,738
公投第１５案,臺南市,北區,立人里,912,1214,219,383,602,46,648
公投第１５案,臺南市,北區,雙安里,913,1064,239,346,585,15,600
公投第１５案,臺南市,北區,雙安里,914,1148,278,390,668,36,704
公投第１５案,臺南市,北區,文成里,915,1391,260,485,745,35,780
公投第１５案,臺南市,北區,文成里,916,1584,320,541,861,33,894
公投第１５案,臺南市,北區,元美里,917,1595,297,571,868,24,892
公投第１５案,臺南市,北區,元美里,918,1397,241,473,714,27,741
公投第１５案,臺南市,北區,文元里,919,1662,325,528,853,34,887
公投第１５案,臺南市,北區,文元里,920,1634,322,493,815,23,838
公投第１５案,臺南市,北區,大和里,921,1793,336,627,963,53,1016
公投第１５案,臺南市,北區,大和里,922,1872,364,657,1021,34,1055
公投第１５案,臺南市,北區,大港里,923,1874,344,616,960,57,1017
公投第１５案,臺南市,北區,大港里,924,1760,304,576,880,42,922
公投第１５案,臺南市,北區,大港里,925,1753,301,543,844,62,906
公投第１５案,臺南市,北區,大豐里,926,1502,248,409,657,21,678
公投第１５案,臺南市,北區,大豐里,927,1470,270,489,759,34,793
公投第１５案,臺南市,北區,大豐里,928,1319,265,388,653,56,709
公投第１５案,臺南市,北區,賢北里,929,1876,334,681,1015,34,1049
公投第１５案,臺南市,北區,賢北里,930,1720,330,560,890,13,903
公投第１５案,臺南市,中西區,赤嵌里,931,1332,285,410,695,45,740
公投第１５案,臺南市,中西區,赤嵌里,932,1246,227,466,693,28,721
公投第１５案,臺南市,中西區,赤嵌里,933,1276,196,446,642,36,678
公投第１５案,臺南市,中西區,郡王里,934,1583,352,516,868,35,903
公投第１５案,臺南市,中西區,郡王里,935,1464,326,487,813,25,838
公投第１５案,臺南市,中西區,法華里,936,1234,252,385,637,11,648
公投第１５案,臺南市,中西區,法華里,937,1368,278,478,756,32,788
公投第１５案,臺南市,中西區,開山里,938,1322,130,386,516,30,546
公投第１５案,臺南市,中西區,開山里,939,1216,231,375,606,37,643
公投第１５案,臺南市,中西區,永華里,940,1289,249,416,665,28,693
公投第１５案,臺南市,中西區,永華里,941,1237,216,458,674,31,705
公投第１５案,臺南市,中西區,藥王里,942,1189,202,341,543,27,570
公投第１５案,臺南市,中西區,藥王里,943,1201,221,410,631,53,684
公投第１５案,臺南市,中西區,藥王里,944,1065,220,376,596,40,636
公投第１５案,臺南市,中西區,光賢里,945,1055,189,374,563,52,615
公投第１５案,臺南市,中西區,光賢里,946,1170,280,406,686,28,714
公投第１５案,臺南市,中西區,光賢里,947,1280,252,513,765,27,792
公投第１５案,臺南市,中西區,大涼里,948,1223,249,422,671,24,695
公投第１５案,臺南市,中西區,大涼里,949,1292,237,473,710,44,754
公投第１５案,臺南市,中西區,西湖里,950,993,213,361,574,15,589
公投第１５案,臺南市,中西區,西湖里,951,1541,321,487,808,38,846
公投第１５案,臺南市,中西區,西湖里,952,1652,371,581,952,35,987
公投第１５案,臺南市,中西區,西湖里,953,1212,253,418,671,17,688
公投第１５案,臺南市,中西區,西賢里,954,1621,321,555,876,70,946
公投第１５案,臺南市,中西區,西賢里,955,1660,350,556,906,30,936
公投第１５案,臺南市,中西區,西賢里,956,1595,268,559,827,39,866
公投第１５案,臺南市,中西區,城隍里,957,1436,275,461,736,32,768
公投第１５案,臺南市,中西區,城隍里,958,1265,235,454,689,37,726
公投第１５案,臺南市,中西區,城隍里,959,856,150,350,500,27,527
公投第１５案,臺南市,中西區,南美里,960,1168,202,395,597,31,628
公投第１５案,臺南市,中西區,南美里,961,1134,251,380,631,37,668
公投第１５案,臺南市,中西區,南美里,962,995,219,367,586,38,624
公投第１５案,臺南市,中西區,南門里,963,1313,256,535,791,23,814
公投第１５案,臺南市,中西區,南門里,964,1265,274,456,730,30,760
公投第１５案,臺南市,中西區,小西門里,965,1215,233,384,617,34,651
公投第１５案,臺南市,中西區,小西門里,966,1248,231,417,648,43,691
公投第１５案,臺南市,中西區,小西門里,967,687,141,208,349,33,382
公投第１５案,臺南市,中西區,五條港里,968,1139,214,367,581,58,639
公投第１５案,臺南市,中西區,五條港里,969,971,186,345,531,36,567
公投第１５案,臺南市,中西區,兌悅里,970,1254,177,331,508,42,550
公投第１５案,臺南市,中西區,兌悅里,971,979,187,345,532,35,567
公投第１５案,臺南市,中西區,兌悅里,972,1745,317,542,859,36,895
公投第１５案,臺南市,中西區,淺草里,973,1074,192,358,550,36,586
公投第１５案,臺南市,中西區,淺草里,974,1436,253,438,691,36,727
公投第１５案,臺南市,中西區,府前里,975,865,190,284,474,30,504
公投第１５案,臺南市,中西區,府前里,976,1164,233,373,606,33,639
公投第１５案,臺南市,中西區,南廠里,977,1285,239,365,604,29,633
公投第１５案,臺南市,中西區,南廠里,978,1078,186,375,561,33,594
公投第１５案,臺南市,中西區,南廠里,979,1704,261,480,741,34,775
公投第１５案,臺南市,中西區,西和里,980,1296,235,466,701,55,756
公投第１５案,臺南市,中西區,西和里,981,1128,208,383,591,36,627
公投第１５案,臺南市,中西區,西和里,982,1245,242,423,665,22,687
公投第１５案,臺南市,安平區,文平里,983,1753,326,598,924,46,970
公投第１５案,臺南市,安平區,文平里,984,1859,355,571,926,36,962
公投第１５案,臺南市,安平區,文平里,985,1382,257,528,785,31,816
公投第１５案,臺南市,安平區,建平里,986,2547,394,816,1210,56,1266
公投第１５案,臺南市,安平區,建平里,987,2407,465,763,1228,31,1259
公投第１５案,臺南市,安平區,怡平里,988,2070,355,582,937,32,969
公投第１５案,臺南市,安平區,怡平里,989,2132,401,696,1097,26,1123
公投第１５案,臺南市,安平區,華平里,990,1450,261,524,785,14,799
公投第１５案,臺南市,安平區,華平里,991,1605,308,482,790,18,808
公投第１５案,臺南市,安平區,華平里,992,1755,310,591,901,46,947
公投第１５案,臺南市,安平區,平通里,993,1728,276,515,791,24,815
公投第１５案,臺南市,安平區,平通里,994,1754,262,459,721,27,748
公投第１５案,臺南市,安平區,平通里,995,1686,331,500,831,41,872
公投第１５案,臺南市,安平區,平通里,996,1843,329,630,959,39,998
公投第１５案,臺南市,安平區,億載里,997,1565,315,542,857,31,888
公投第１５案,臺南市,安平區,億載里,998,1288,254,434,688,14,702
公投第１５案,臺南市,安平區,育平里,999,1653,328,468,796,14,810
公投第１５案,臺南市,安平區,育平里,1000,1697,271,544,815,16,831
公投第１５案,臺南市,安平區,育平里,1001,2154,355,629,984,33,1017
公投第１５案,臺南市,安平區,育平里,1002,2107,342,660,1002,27,1029
公投第１５案,臺南市,安平區,國平里,1003,1675,349,545,894,32,926
公投第１５案,臺南市,安平區,國平里,1004,1979,399,588,987,38,1025
公投第１５案,臺南市,安平區,國平里,1005,1602,298,484,782,17,799
公投第１５案,臺南市,安平區,國平里,1006,1586,306,472,778,27,805
公投第１５案,臺南市,安平區,漁光里,1007,438,62,130,192,5,197
公投第１５案,臺南市,安平區,平安里,1008,1780,334,520,854,48,902
公投第１５案,臺南市,安平區,平安里,1009,1623,291,476,767,34,801
公投第１５案,臺南市,安平區,天妃里,1010,2157,334,664,998,71,1069
公投第１５案,臺南市,安平區,天妃里,1011,1286,213,415,628,35,663
公投第１５案,臺南市,安平區,王城里,1012,1492,230,515,745,44,789
公投第１５案,臺南市,安平區,王城里,1013,1325,171,431,602,23,625
公投第１５案,臺南市,安平區,金城里,1014,2001,297,621,918,72,990
公投第１５案,臺南市,南區,大恩里,1015,1221,216,447,663,39,702
公投第１５案,臺南市,南區,大恩里,1016,2171,333,619,952,61,1013
公投第１５案,臺南市,南區,大林里,1017,1150,227,415,642,26,668
公投第１５案,臺南市,南區,大林里,1018,1122,200,421,621,27,648
公投第１５案,臺南市,南區,大忠里,1019,1444,216,460,676,35,711
公投第１５案,臺南市,南區,大忠里,1020,1765,303,534,837,43,880
公投第１５案,臺南市,南區,大忠里,1021,1298,234,479,713,39,752
公投第１５案,臺南市,南區,新生里,1022,1458,232,541,773,30,803
公投第１５案,臺南市,南區,新生里,1023,1940,307,634,941,24,965
公投第１５案,臺南市,南區,竹溪里,1024,1637,284,554,838,43,881
公投第１５案,臺南市,南區,明德里,1025,871,158,239,397,10,407
公投第１５案,臺南市,南區,大成里,1026,589,132,191,323,18,341
公投第１５案,臺南市,南區,大成里,1027,801,180,312,492,36,528
公投第１５案,臺南市,南區,田寮里,1028,990,166,363,529,39,568
公投第１５案,臺南市,南區,田寮里,1029,1222,227,478,705,36,741
公投第１５案,臺南市,南區,田寮里,1030,997,183,359,542,57,599
公投第１５案,臺南市,南區,新興里,1031,1204,209,380,589,26,615
公投第１５案,臺南市,南區,新興里,1032,1570,267,458,725,24,749
公投第１５案,臺南市,南區,再興里,1033,1222,255,379,634,46,680
公投第１５案,臺南市,南區,再興里,1034,1076,172,341,513,19,532
公投第１５案,臺南市,南區,廣州里,1035,1127,198,396,594,26,620
公投第１５案,臺南市,南區,廣州里,1036,1135,205,390,595,45,640
公投第１５案,臺南市,南區,新昌里,1037,1263,230,394,624,47,671
公投第１５案,臺南市,南區,新昌里,1038,1014,186,311,497,25,522
公投第１５案,臺南市,南區,文華里,1039,1491,273,521,794,45,839
公投第１５案,臺南市,南區,文華里,1040,1815,331,607,938,35,973
公投第１５案,臺南市,南區,文南里,1041,1398,269,431,700,16,716
公投第１５案,臺南市,南區,文南里,1042,2107,296,588,884,33,917
公投第１５案,臺南市,南區,文南里,1043,1587,321,585,906,38,944
公投第１５案,臺南市,南區,金華里,1044,1626,203,546,749,55,804
公投第１５案,臺南市,南區,金華里,1045,1761,288,547,835,30,865
公投第１５案,臺南市,南區,金華里,1046,1630,291,511,802,67,869
公投第１５案,臺南市,南區,國宅里,1047,1542,251,540,791,44,835
公投第１５案,臺南市,南區,國宅里,1048,1464,273,436,709,71,780
公投第１５案,臺南市,南區,鹽埕里,1049,1727,259,572,831,78,909
公投第１５案,臺南市,南區,鹽埕里,1050,1085,232,371,603,53,656
公投第１５案,臺南市,南區,鹽埕里,1051,939,157,308,465,23,488
公投第１５案,臺南市,南區,光明里,1052,1419,214,408,622,67,689
公投第１５案,臺南市,南區,光明里,1053,1333,226,404,630,40,670
公投第１５案,臺南市,南區,光明里,1054,1465,261,439,700,38,738
公投第１５案,臺南市,南區,明亮里,1055,1099,211,362,573,23,596
公投第１５案,臺南市,南區,明亮里,1056,1133,183,355,538,19,557
公投第１５案,臺南市,南區,明亮里,1057,1375,200,439,639,75,714
公投第１５案,臺南市,南區,府南里,1058,1781,306,493,799,23,822
公投第１５案,臺南市,南區,府南里,1059,1542,273,556,829,47,876
公投第１５案,臺南市,南區,府南里,1060,1486,221,467,688,31,719
公投第１５案,臺南市,南區,明興里,1061,1640,288,576,864,61,925
公投第１５案,臺南市,南區,明興里,1062,1701,252,482,734,38,772
公投第１５案,臺南市,南區,郡南里,1063,1541,208,479,687,63,750
公投第１５案,臺南市,南區,郡南里,1064,2027,317,618,935,90,1025
公投第１５案,臺南市,南區,建南里,1065,1774,315,667,982,57,1039
公投第１５案,臺南市,南區,建南里,1066,1613,270,521,791,46,837
公投第１５案,臺南市,南區,建南里,1067,1707,275,554,829,13,842
公投第１５案,臺南市,南區,南都里,1068,1657,179,386,565,21,586
公投第１５案,臺南市,南區,南都里,1069,1077,179,369,548,34,582
公投第１５案,臺南市,南區,南華里,1070,1185,209,392,601,32,633
公投第１５案,臺南市,南區,南華里,1071,1249,227,392,619,41,660
公投第１５案,臺南市,南區,開南里,1072,1985,281,600,881,29,910
公投第１５案,臺南市,南區,開南里,1073,2017,313,556,869,49,918
公投第１５案,臺南市,南區,開南里,1074,1717,289,497,786,50,836
公投第１５案,臺南市,南區,彰南里,1075,929,158,328,486,35,521
公投第１５案,臺南市,南區,彰南里,1076,695,146,226,372,22,394
公投第１５案,臺南市,南區,鯤鯓里,1077,997,133,319,452,25,477
公投第１５案,臺南市,南區,鯤鯓里,1078,784,103,263,366,16,382
公投第１５案,臺南市,南區,喜北里,1079,1119,169,417,586,65,651
公投第１５案,臺南市,南區,喜北里,1080,1054,155,286,441,36,477
公投第１５案,臺南市,南區,喜南里,1081,1245,198,395,593,48,641
公投第１５案,臺南市,南區,喜東里,1082,2064,286,606,892,77,969
公投第１５案,臺南市,南區,省躬里,1083,2056,286,527,813,21,834
公投第１５案,臺南市,南區,省躬里,1084,1373,193,424,617,21,638
公投第１５案,臺南市,南區,永寧里,1085,1002,137,293,430,30,460
公投第１５案,臺南市,南區,永寧里,1086,760,132,255,387,57,444
公投第１５案,臺南市,南區,松安里,1087,1031,190,322,512,57,569
公投第１５案,臺南市,南區,松安里,1088,744,143,238,381,33,414
公投第１５案,臺南市,南區,佛壇里,1089,1186,226,361,587,58,645
公投第１５案,臺南市,南區,佛壇里,1090,1358,242,454,696,46,742
公投第１５案,臺南市,南區,同安里,1091,897,139,267,406,20,426
公投第１５案,臺南市,南區,同安里,1092,1265,214,407,621,42,663
公投第１５案,臺南市,南區,興農里,1093,1093,159,341,500,28,528
公投第１５案,臺南市,南區,興農里,1094,1016,206,333,539,33,572
公投第１５案,臺南市,東區,崇信里,1095,2681,360,670,1030,41,1071
公投第１５案,臺南市,東區,崇信里,1096,1811,348,584,932,28,960
公投第１５案,臺南市,東區,崇學里,1097,1491,321,555,876,58,934
公投第１５案,臺南市,東區,崇學里,1098,1378,273,452,725,30,755
公投第１５案,臺南市,東區,崇德里,1099,1552,325,528,853,43,896
公投第１５案,臺南市,東區,崇德里,1100,1326,254,504,758,14,772
公投第１５案,臺南市,東區,崇德里,1101,1594,303,551,854,44,898
公投第１５案,臺南市,東區,崇善里,1102,1639,361,557,918,30,948
公投第１５案,臺南市,東區,崇善里,1103,1724,343,554,897,43,940
公投第１５案,臺南市,東區,崇善里,1104,1629,288,564,852,58,910
公投第１５案,臺南市,東區,崇成里,1105,1399,278,487,765,19,784
公投第１５案,臺南市,東區,崇成里,1106,1534,306,528,834,33,867
公投第１５案,臺南市,東區,崇文里,1107,1656,347,566,913,28,941
公投第１５案,臺南市,東區,崇文里,1108,1322,229,467,696,35,731
公投第１５案,臺南市,東區,崇文里,1109,1620,347,504,851,25,876
公投第１５案,臺南市,東區,崇文里,1110,1331,272,515,787,28,815
公投第１５案,臺南市,東區,東智里,1111,1039,173,395,568,31,599
公投第１５案,臺南市,東區,東智里,1112,1257,184,431,615,25,640
公投第１５案,臺南市,東區,大智里,1113,2067,350,643,993,70,1063
公投第１５案,臺南市,東區,大智里,1114,2153,341,799,1140,27,1167
公投第１５案,臺南市,東區,大智里,1115,2363,415,792,1207,41,1248
公投第１５案,臺南市,東區,德高里,1116,1427,246,499,745,40,785
公投第１５案,臺南市,東區,德高里,1117,1555,297,573,870,28,898
公投第１５案,臺南市,東區,仁和里,1118,2115,316,611,927,42,969
公投第１５案,臺南市,東區,仁和里,1119,2340,408,699,1107,49,1156
公投第１５案,臺南市,東區,和平里,1120,2474,476,799,1275,38,1313
公投第１５案,臺南市,東區,和平里,1121,2391,383,808,1191,50,1241
公投第１５案,臺南市,東區,虎尾里,1122,1673,335,568,903,33,936
公投第１５案,臺南市,東區,虎尾里,1123,1594,298,538,836,28,864
公投第１５案,臺南市,東區,虎尾里,1124,1607,304,572,876,44,920
公投第１５案,臺南市,東區,裕聖里,1125,2087,453,735,1188,22,1210
公投第１５案,臺南市,東區,裕聖里,1126,2369,507,823,1330,27,1357
公投第１５案,臺南市,東區,復興里,1127,1696,277,567,844,67,911
公投第１５案,臺南市,東區,復興里,1128,1612,316,549,865,31,896
公投第１５案,臺南市,東區,自強里,1129,1708,311,542,853,36,889
公投第１５案,臺南市,東區,自強里,1130,1560,292,535,827,32,859
公投第１５案,臺南市,東區,自強里,1131,1854,356,589,945,46,991
公投第１５案,臺南市,東區,東聖里,1132,2278,392,704,1096,33,1129
公投第１５案,臺南市,東區,關聖里,1133,2093,402,667,1069,28,1097
公投第１５案,臺南市,東區,關聖里,1134,2242,463,781,1244,30,1274
公投第１５案,臺南市,東區,南聖里,1135,1152,248,414,662,30,692
公投第１５案,臺南市,東區,南聖里,1136,1318,282,502,784,14,798
公投第１５案,臺南市,東區,文聖里,1137,2200,457,744,1201,36,1237
公投第１５案,臺南市,東區,文聖里,1138,1960,411,707,1118,25,1143
公投第１５案,臺南市,東區,後甲里,1139,1489,277,489,766,45,811
公投第１５案,臺南市,東區,後甲里,1140,1443,282,457,739,55,794
公投第１５案,臺南市,東區,東光里,1141,1498,374,506,880,30,910
公投第１５案,臺南市,東區,東光里,1142,1622,339,551,890,19,909
公投第１５案,臺南市,東區,東光里,1143,1738,353,577,930,38,968
公投第１５案,臺南市,東區,東明里,1144,1501,282,467,749,48,797
公投第１５案,臺南市,東區,東明里,1145,1482,255,543,798,37,835
公投第１５案,臺南市,東區,莊敬里,1146,1829,308,558,866,33,899
公投第１５案,臺南市,東區,莊敬里,1147,1764,307,616,923,42,965
公投第１５案,臺南市,東區,小東里,1148,1427,311,496,807,24,831
公投第１５案,臺南市,東區,小東里,1149,1427,272,450,722,50,772
公投第１５案,臺南市,東區,小東里,1150,1388,277,467,744,38,782
公投第１５案,臺南市,東區,大學里,1151,1131,289,385,674,21,695
公投第１５案,臺南市,東區,成大里,1152,1000,195,320,515,30,545
公投第１５案,臺南市,東區,成大里,1153,996,181,354,535,22,557
公投第１５案,臺南市,東區,東門里,1154,935,155,310,465,36,501
公投第１５案,臺南市,東區,東門里,1155,947,196,310,506,39,545
公投第１５案,臺南市,東區,圍下里,1156,1090,228,356,584,11,595
公投第１５案,臺南市,東區,圍下里,1157,896,172,278,450,30,480
公投第１５案,臺南市,東區,中西里,1158,1589,320,510,830,26,856
公投第１５案,臺南市,東區,中西里,1159,1497,321,499,820,32,852
公投第１５案,臺南市,東區,東安里,1160,1386,243,448,691,47,738
公投第１５案,臺南市,東區,新東里,1161,1101,226,375,601,16,617
公投第１５案,臺南市,東區,新東里,1162,1332,271,457,728,46,774
公投第１５案,臺南市,東區,崇誨里,1163,1185,223,425,648,25,673
公投第１５案,臺南市,東區,崇誨里,1164,1262,236,474,710,35,745
公投第１５案,臺南市,東區,衛國里,1165,1517,228,498,726,52,778
公投第１５案,臺南市,東區,裕農里,1166,1287,241,404,645,70,715
公投第１５案,臺南市,東區,裕農里,1167,1657,326,549,875,49,924
公投第１５案,臺南市,東區,富強里,1168,2238,749,405,1154,68,1222
公投第１５案,臺南市,東區,富強里,1169,2246,449,682,1131,49,1180
公投第１５案,臺南市,東區,富裕里,1170,2191,428,690,1118,41,1159
公投第１５案,臺南市,東區,忠孝里,1171,2063,374,663,1037,46,1083
公投第１５案,臺南市,東區,忠孝里,1172,2177,408,783,1191,66,1257
公投第１５案,臺南市,東區,崇明里,1173,1863,333,719,1052,39,1091
公投第１５案,臺南市,東區,崇明里,1174,2185,403,779,1182,31,1213
公投第１５案,臺南市,東區,大福里,1175,1721,270,525,795,39,834
公投第１５案,臺南市,東區,大德里,1176,1556,275,511,786,78,864
公投第１５案,臺南市,東區,路東里,1177,1602,354,534,888,32,920
公投第１５案,臺南市,東區,大同里,1178,1523,268,492,760,50,810
公投第１５案,臺南市,東區,大同里,1179,1382,253,411,664,34,698
公投第１５案,臺南市,東區,泉南里,1180,1486,280,490,770,35,805
公投第１５案,臺南市,東區,泉南里,1181,1560,285,547,832,45,877
公投第１５案,臺南市,東區,泉南里,1182,1684,313,484,797,49,846
公投第１５案,臺南市,東區,龍山里,1183,1653,351,534,885,30,915
公投第１５案,臺南市,東區,龍山里,1184,1554,372,475,847,11,858
公投第１５案,臺南市,東區,龍山里,1185,1408,302,486,788,15,803
公投第１５案,臺南市,東區,德光里,1186,2084,394,791,1185,27,1212
公投第１５案,臺南市,東區,德光里,1187,1896,419,588,1007,28,1035
公投第１５案,臺南市,仁德區,太子里,1188,1318,241,429,670,61,731
公投第１５案,臺南市,仁德區,太子里,1189,1406,247,470,717,51,768
公投第１５案,臺南市,仁德區,太子里,1190,1465,235,474,709,56,765
公投第１５案,臺南市,仁德區,太子里,1191,1192,244,411,655,65,720
公投第１５案,臺南市,仁德區,土庫里,1192,1429,268,496,764,59,823
公投第１５案,臺南市,仁德區,土庫里,1193,1320,223,409,632,92,724
公投第１５案,臺南市,仁德區,一甲里,1194,1373,244,512,756,77,833
公投第１５案,臺南市,仁德區,一甲里,1195,1330,232,491,723,45,768
公投第１５案,臺南市,仁德區,仁德里,1196,1687,307,608,915,33,948
公投第１５案,臺南市,仁德區,仁德里,1197,1491,264,437,701,54,755
公投第１５案,臺南市,仁德區,仁德里,1198,1151,169,349,518,28,546
公投第１５案,臺南市,仁德區,仁德里,1199,1407,211,499,710,17,727
公投第１５案,臺南市,仁德區,仁德里,1200,1465,248,544,792,39,831
公投第１５案,臺南市,仁德區,仁義里,1201,1335,250,479,729,32,761
公投第１５案,臺南市,仁德區,仁義里,1202,1490,247,478,725,61,786
公投第１５案,臺南市,仁德區,仁義里,1203,1453,276,532,808,44,852
公投第１５案,臺南市,仁德區,仁義里,1204,990,181,310,491,15,506
公投第１５案,臺南市,仁德區,仁義里,1205,1573,256,588,844,43,887
公投第１５案,臺南市,仁德區,仁義里,1206,1031,166,346,512,54,566
公投第１５案,臺南市,仁德區,仁義里,1207,1194,201,415,616,29,645
公投第１５案,臺南市,仁德區,新田里,1208,1268,216,390,606,45,651
公投第１５案,臺南市,仁德區,新田里,1209,929,186,302,488,36,524
公投第１５案,臺南市,仁德區,新田里,1210,1145,178,350,528,16,544
公投第１５案,臺南市,仁德區,後壁里,1211,1413,240,456,696,41,737
公投第１５案,臺南市,仁德區,後壁里,1212,1465,224,480,704,83,787
公投第１５案,臺南市,仁德區,後壁里,1213,1390,246,505,751,43,794
公投第１５案,臺南市,仁德區,後壁里,1214,1396,253,442,695,70,765
公投第１５案,臺南市,仁德區,後壁里,1215,1906,346,600,946,52,998
公投第１５案,臺南市,仁德區,後壁里,1216,1546,253,498,751,24,775
公投第１５案,臺南市,仁德區,上崙里,1217,1546,258,414,672,22,694
公投第１５案,臺南市,仁德區,上崙里,1218,1399,233,500,733,50,783
公投第１５案,臺南市,仁德區,上崙里,1219,1748,303,540,843,81,924
公投第１５案,臺南市,仁德區,上崙里,1220,1140,204,403,607,33,640
公投第１５案,臺南市,仁德區,文賢里,1221,1277,202,432,634,30,664
公投第１５案,臺南市,仁德區,文賢里,1222,1019,183,421,604,42,646
公投第１５案,臺南市,仁德區,保安里,1223,1414,216,453,669,34,703
公投第１５案,臺南市,仁德區,保安里,1224,1349,198,407,605,28,633
公投第１５案,臺南市,仁德區,成功里,1225,1471,244,471,715,22,737
公投第１５案,臺南市,仁德區,成功里,1226,1324,238,436,674,19,693
公投第１５案,臺南市,仁德區,成功里,1227,1310,163,426,589,52,641
公投第１５案,臺南市,仁德區,成功里,1228,554,117,170,287,24,311
公投第１５案,臺南市,仁德區,仁和里,1229,1395,170,549,719,31,750
公投第１５案,臺南市,仁德區,仁愛里,1230,1264,177,451,628,15,643
公投第１５案,臺南市,仁德區,二行里,1231,1180,172,406,578,60,638
公投第１５案,臺南市,仁德區,二行里,1232,928,151,270,421,25,446
公投第１５案,臺南市,仁德區,大甲里,1233,965,149,286,435,17,452
公投第１５案,臺南市,仁德區,大甲里,1234,1119,186,347,533,29,562
公投第１５案,臺南市,仁德區,中洲里,1235,1206,187,418,605,51,656
公投第１５案,臺南市,仁德區,中洲里,1236,1466,216,460,676,44,720
公投第１５案,臺南市,歸仁區,南保里,1237,1560,232,510,742,65,807
公投第１５案,臺南市,歸仁區,南保里,1238,1383,255,524,779,58,837
公投第１５案,臺南市,歸仁區,南保里,1239,1491,275,478,753,39,792
公投第１５案,臺南市,歸仁區,南保里,1240,1482,237,469,706,45,751
公投第１５案,臺南市,歸仁區,南興里,1241,1330,249,445,694,23,717
公投第１５案,臺南市,歸仁區,南興里,1242,1399,274,464,738,48,786
公投第１５案,臺南市,歸仁區,南興里,1243,1416,258,419,677,35,712
公投第１５案,臺南市,歸仁區,六甲里,1244,1336,202,342,544,37,581
公投第１５案,臺南市,歸仁區,六甲里,1245,1183,175,348,523,65,588
公投第１５案,臺南市,歸仁區,六甲里,1246,1237,206,369,575,22,597
公投第１５案,臺南市,歸仁區,歸南里,1247,1133,202,381,583,55,638
公投第１５案,臺南市,歸仁區,歸南里,1248,1149,199,361,560,33,593
公投第１５案,臺南市,歸仁區,後市里,1249,1105,190,377,567,2,569
公投第１５案,臺南市,歸仁區,後市里,1250,1099,201,362,563,39,602
公投第１５案,臺南市,歸仁區,後市里,1251,1082,177,396,573,62,635
公投第１５案,臺南市,歸仁區,文化里,1252,1519,258,551,809,38,847
公投第１５案,臺南市,歸仁區,文化里,1253,1467,261,526,787,53,840
公投第１５案,臺南市,歸仁區,辜厝里,1254,1090,185,349,534,38,572
公投第１５案,臺南市,歸仁區,辜厝里,1255,1131,193,364,557,29,586
公投第１５案,臺南市,歸仁區,辜厝里,1256,1080,168,361,529,27,556
公投第１５案,臺南市,歸仁區,新厝里,1257,1121,164,328,492,22,514
公投第１５案,臺南市,歸仁區,新厝里,1258,1336,239,431,670,54,724
公投第１５案,臺南市,歸仁區,許厝里,1259,1128,201,354,555,60,615
公投第１５案,臺南市,歸仁區,許厝里,1260,1055,180,352,532,23,555
公投第１５案,臺南市,歸仁區,許厝里,1261,1102,180,374,554,35,589
公投第１５案,臺南市,歸仁區,看西里,1262,1068,206,344,550,42,592
公投第１５案,臺南市,歸仁區,看西里,1263,1033,191,361,552,42,594
公投第１５案,臺南市,歸仁區,看東里,1264,1772,245,467,712,20,732
公投第１５案,臺南市,歸仁區,崙頂里,1265,1399,247,465,712,60,772
公投第１５案,臺南市,歸仁區,崙頂里,1266,1544,282,523,805,32,837
公投第１５案,臺南市,歸仁區,沙崙里,1267,684,110,190,300,8,308
公投第１５案,臺南市,歸仁區,大潭里,1268,839,173,296,469,31,500
公投第１５案,臺南市,歸仁區,大潭里,1269,1014,208,338,546,50,596
公投第１５案,臺南市,歸仁區,武東里,1270,1906,232,443,675,32,707
公投第１５案,臺南市,歸仁區,歸仁里,1271,1245,233,436,669,44,713
公投第１５案,臺南市,歸仁區,歸仁里,1272,1048,174,355,529,28,557
公投第１５案,臺南市,歸仁區,八甲里,1273,1175,192,396,588,22,610
公投第１５案,臺南市,歸仁區,八甲里,1274,1411,231,424,655,31,686
公投第１５案,臺南市,歸仁區,七甲里,1275,1514,312,509,821,35,856
公投第１５案,臺南市,歸仁區,七甲里,1276,1678,321,521,842,62,904
公投第１５案,臺南市,歸仁區,媽廟里,1277,949,190,301,491,31,522
公投第１５案,臺南市,歸仁區,媽廟里,1278,1009,166,386,552,52,604
公投第１５案,臺南市,歸仁區,西埔里,1279,984,218,375,593,5,598
公投第１５案,臺南市,歸仁區,西埔里,1280,756,134,287,421,30,451
公投第１５案,臺南市,歸仁區,大廟里,1281,1478,280,558,838,43,881
公投第１５案,臺南市,歸仁區,大廟里,1282,1467,282,518,800,60,860
公投第１５案,臺南市,關廟區,關廟里,1283,982,161,335,496,25,521
公投第１５案,臺南市,關廟區,關廟里,1284,1156,228,426,654,34,688
公投第１５案,臺南市,關廟區,山西里,1285,1006,154,321,475,18,493
公投第１５案,臺南市,關廟區,山西里,1286,1043,207,370,577,56,633
公投第１５案,臺南市,關廟區,香洋里,1287,1012,183,322,505,82,587
公投第１５案,臺南市,關廟區,香洋里,1288,1013,156,294,450,15,465
公投第１５案,臺南市,關廟區,香洋里,1289,1294,215,398,613,32,645
公投第１５案,臺南市,關廟區,北勢里,1290,1264,200,396,596,42,638
公投第１５案,臺南市,關廟區,北勢里,1291,1166,196,396,592,30,622
公投第１５案,臺南市,關廟區,新埔里,1292,1018,183,302,485,15,500
公投第１５案,臺南市,關廟區,新光里,1293,733,89,213,302,42,344
公投第１５案,臺南市,關廟區,五甲里,1294,1093,169,448,617,28,645
公投第１５案,臺南市,關廟區,五甲里,1295,1081,183,394,577,29,606
公投第１５案,臺南市,關廟區,五甲里,1296,978,189,353,542,33,575
公投第１５案,臺南市,關廟區,東勢里,1297,1116,167,345,512,17,529
公投第１５案,臺南市,關廟區,東勢里,1298,972,138,343,481,40,521
公投第１５案,臺南市,關廟區,東勢里,1299,1045,188,339,527,73,600
公投第１５案,臺南市,關廟區,松腳里,1300,872,170,266,436,35,471
公投第１５案,臺南市,關廟區,松腳里,1301,1007,194,353,547,42,589
公投第１５案,臺南市,關廟區,花園里,1302,763,145,272,417,41,458
公投第１５案,臺南市,關廟區,花園里,1303,630,93,211,304,30,334
公投第１５案,臺南市,關廟區,花園里,1304,959,150,344,494,62,556
公投第１５案,臺南市,關廟區,花園里,1305,1123,169,384,553,30,583
公投第１５案,臺南市,關廟區,深坑里,1306,804,130,267,397,62,459
公投第１５案,臺南市,關廟區,深坑里,1307,720,122,228,350,14,364
公投第１５案,臺南市,關廟區,布袋里,1308,843,119,251,370,19,389
公投第１５案,臺南市,關廟區,布袋里,1309,358,49,113,162,13,175
公投第１５案,臺南市,關廟區,南雄里,1310,797,127,240,367,61,428
公投第１５案,臺南市,關廟區,南雄里,1311,709,90,208,298,18,316
公投第１５案,臺南市,關廟區,埤頭里,1312,904,128,267,395,19,414
公投第１５案,臺南市,關廟區,埤頭里,1313,963,152,324,476,25,501
公投第１５案,臺南市,關廟區,下湖里,1314,489,104,155,259,14,273
公投第１５案,臺南市,龍崎區,崎頂里,1315,1047,169,311,480,55,535
公投第１５案,臺南市,龍崎區,土崎里,1316,630,67,217,284,16,300
公投第１５案,臺南市,龍崎區,中坑里,1317,141,12,40,52,4,56
公投第１５案,臺南市,龍崎區,楠坑里,1318,367,51,112,163,17,180
公投第１５案,臺南市,龍崎區,牛埔里,1319,337,46,121,167,13,180
公投第１５案,臺南市,龍崎區,大坪里,1320,318,42,95,137,3,140
公投第１５案,臺南市,龍崎區,龍船里,1321,427,44,148,192,22,214
公投第１５案,臺南市,龍崎區,石𥕢里,1322,446,54,123,177,20,197
公投第１５案,桃園市,桃園區,大林里,1,1593,275,492,767,41,808
公投第１５案,桃園市,桃園區,大林里,2,1934,295,522,817,31,848
公投第１５案,桃園市,桃園區,大林里,3,1661,308,549,857,54,911
公投第１５案,桃園市,桃園區,大林里,4,1448,230,440,670,14,684
公投第１５案,桃園市,桃園區,大樹里,5,1974,340,580,920,39,959
公投第１５案,桃園市,桃園區,大樹里,6,1882,271,542,813,55,868
公投第１５案,桃園市,桃園區,大豐里,7,1800,329,519,848,32,880
公投第１５案,桃園市,桃園區,大豐里,8,1598,308,521,829,45,874
公投第１５案,桃園市,桃園區,大豐里,9,1626,252,463,715,49,764
公投第１５案,桃園市,桃園區,建國里,10,1590,272,475,747,42,789
公投第１５案,桃園市,桃園區,建國里,11,1637,302,489,791,44,835
公投第１５案,桃園市,桃園區,建國里,12,1943,522,373,895,52,947
公投第１５案,桃園市,桃園區,雲林里,13,1482,280,454,734,43,777
公投第１５案,桃園市,桃園區,雲林里,14,1423,254,496,750,35,785
公投第１５案,桃園市,桃園區,雲林里,15,1509,320,482,802,33,835
公投第１５案,桃園市,桃園區,雲林里,16,1567,298,522,820,28,848
公投第１５案,桃園市,桃園區,福安里,17,1305,239,435,674,36,710
公投第１５案,桃園市,桃園區,福安里,18,1416,249,409,658,30,688
公投第１５案,桃園市,桃園區,福安里,19,1439,298,481,779,31,810
公投第１５案,桃園市,桃園區,福林里,20,1399,267,477,744,45,789
公投第１５案,桃園市,桃園區,福林里,21,1540,288,535,823,40,863
公投第１５案,桃園市,桃園區,福林里,22,1638,249,535,784,24,808
公投第１５案,桃園市,桃園區,福林里,23,1228,219,422,641,26,667
公投第１５案,桃園市,桃園區,豐林里,24,1649,260,509,769,59,828
公投第１５案,桃園市,桃園區,豐林里,25,1601,267,533,800,38,838
公投第１５案,桃園市,桃園區,豐林里,26,1477,277,425,702,101,803
公投第１５案,桃園市,桃園區,豐林里,27,1503,264,519,783,31,814
公投第１５案,桃園市,桃園區,中和里,28,1375,274,463,737,58,795
公投第１５案,桃園市,桃園區,中興里,29,1743,291,611,902,42,944
公投第１５案,桃園市,桃園區,中興里,30,1862,301,563,864,51,915
公投第１５案,桃園市,桃園區,中興里,31,1728,301,564,865,38,903
公投第１５案,桃園市,桃園區,文化里,32,690,147,198,345,17,362
公投第１５案,桃園市,桃園區,文昌里,33,852,197,296,493,26,519
公投第１５案,桃園市,桃園區,文明里,34,1353,281,469,750,46,796
公投第１５案,桃園市,桃園區,北門里,35,1698,239,395,634,24,658
公投第１５案,桃園市,桃園區,民生里,36,1452,281,415,696,42,738
公投第１５案,桃園市,桃園區,永興里,37,1681,299,517,816,58,874
公投第１５案,桃園市,桃園區,光興里,38,1669,603,199,802,53,855
公投第１５案,桃園市,桃園區,光興里,39,1530,277,549,826,48,874
公投第１５案,桃園市,桃園區,光興里,40,1582,344,475,819,44,863
公投第１５案,桃園市,桃園區,西門里,41,1587,235,485,720,42,762
公投第１５案,桃園市,桃園區,西湖里,42,1451,263,489,752,49,801
公投第１５案,桃園市,桃園區,武陵里,43,1582,273,415,688,44,732
公投第１５案,桃園市,桃園區,長美里,44,1028,213,332,545,39,584
公投第１５案,桃園市,桃園區,南門里,45,1934,309,621,930,36,966
公投第１５案,桃園市,桃園區,南門里,46,1016,180,319,499,52,551
公投第１５案,桃園市,桃園區,南門里,47,1079,217,340,557,27,584
公投第１５案,桃園市,桃園區,南門里,48,1837,370,508,878,16,894
公投第１５案,桃園市,桃園區,南華里,49,1390,246,483,729,47,776
公投第１５案,桃園市,桃園區,中山里,50,1489,259,518,777,24,801
公投第１５案,桃園市,桃園區,中山里,51,1821,389,608,997,18,1015
公投第１５案,桃園市,桃園區,中山里,52,1563,262,474,736,22,758
公投第１５案,桃園市,桃園區,中山里,53,1697,336,545,881,33,914
公投第１５案,桃園市,桃園區,中平里,54,1740,327,577,904,33,937
公投第１５案,桃園市,桃園區,中平里,55,1626,287,540,827,30,857
公投第１５案,桃園市,桃園區,中平里,56,1239,249,430,679,13,692
公投第１５案,桃園市,桃園區,中正里,57,1766,345,562,907,33,940
公投第１５案,桃園市,桃園區,中正里,58,1555,267,523,790,47,837
公投第１５案,桃園市,桃園區,中正里,59,1831,333,590,923,39,962
公投第１５案,桃園市,桃園區,中成里,60,1115,204,432,636,29,665
公投第１５案,桃園市,桃園區,中成里,61,1562,303,518,821,41,862
公投第１５案,桃園市,桃園區,中成里,62,1744,274,590,864,35,899
公投第１５案,桃園市,桃園區,中信里,63,1838,299,527,826,38,864
公投第１５案,桃園市,桃園區,中信里,64,1889,362,595,957,57,1014
公投第１５案,桃園市,桃園區,中信里,65,1985,303,582,885,57,942
公投第１５案,桃園市,桃園區,中原里,66,1524,296,539,835,40,875
公投第１５案,桃園市,桃園區,中原里,67,1425,282,564,846,28,874
公投第１５案,桃園市,桃園區,中原里,68,1606,325,562,887,32,919
公投第１５案,桃園市,桃園區,中泰里,69,2056,362,762,1124,23,1147
公投第１５案,桃園市,桃園區,中泰里,70,2010,385,693,1078,31,1109
公投第１５案,桃園市,桃園區,中聖里,71,2245,364,692,1056,51,1107
公投第１５案,桃園市,桃園區,中聖里,72,1590,330,492,822,34,856
公投第１５案,桃園市,桃園區,中聖里,73,1536,314,578,892,22,914
公投第１５案,桃園市,桃園區,中路里,74,1949,345,564,909,39,948
公投第１５案,桃園市,桃園區,中路里,75,1965,320,615,935,43,978
公投第１５案,桃園市,桃園區,中德里,76,2414,330,699,1029,52,1081
公投第１５案,桃園市,桃園區,中德里,77,1942,319,624,943,51,994
公投第１５案,桃園市,桃園區,中德里,78,2156,346,717,1063,53,1116
公投第１５案,桃園市,桃園區,文中里,79,1404,272,474,746,45,791
公投第１５案,桃園市,桃園區,文中里,80,1194,242,452,694,31,725
公投第１５案,桃園市,桃園區,玉山里,81,1449,347,440,787,49,836
公投第１５案,桃園市,桃園區,玉山里,82,1803,286,521,807,67,874
公投第１５案,桃園市,桃園區,玉山里,83,1692,291,565,856,43,899
公投第１５案,桃園市,桃園區,泰山里,84,1913,365,593,958,40,998
公投第１５案,桃園市,桃園區,泰山里,85,1815,342,571,913,36,949
公投第１５案,桃園市,桃園區,龍山里,86,1173,210,339,549,38,587
公投第１５案,桃園市,桃園區,龍山里,87,1162,196,361,557,18,575
公投第１５案,桃園市,桃園區,龍山里,88,1194,142,346,488,64,552
公投第１５案,桃園市,桃園區,龍安里,89,1695,324,510,834,49,883
公投第１５案,桃園市,桃園區,龍安里,90,1797,316,561,877,29,906
公投第１５案,桃園市,桃園區,龍安里,91,1592,259,538,797,21,818
公投第１５案,桃園市,桃園區,龍岡里,92,1780,268,576,844,57,901
公投第１５案,桃園市,桃園區,龍岡里,93,1904,322,527,849,27,876
公投第１５案,桃園市,桃園區,龍岡里,94,2021,347,613,960,26,986
公投第１５案,桃園市,桃園區,龍祥里,95,1545,219,534,753,46,799
公投第１５案,桃園市,桃園區,龍祥里,96,1617,254,517,771,23,794
公投第１５案,桃園市,桃園區,龍祥里,97,1683,276,544,820,30,850
公投第１５案,桃園市,桃園區,龍壽里,98,1834,332,615,947,54,1001
公投第１５案,桃園市,桃園區,龍壽里,99,2055,349,589,938,36,974
公投第１５案,桃園市,桃園區,龍壽里,100,1828,301,561,862,25,887
公投第１５案,桃園市,桃園區,龍鳳里,101,1873,305,579,884,32,916
公投第１５案,桃園市,桃園區,龍鳳里,102,3687,255,471,726,33,759
公投第１５案,桃園市,桃園區,龍鳳里,103,1850,334,591,925,24,949
公投第１５案,桃園市,桃園區,龍鳳里,104,1827,295,589,884,43,927
公投第１５案,桃園市,桃園區,中埔里,105,1149,193,466,659,33,692
公投第１５案,桃園市,桃園區,中埔里,106,1061,210,367,577,44,621
公投第１５案,桃園市,桃園區,中寧里,107,1831,307,544,851,23,874
公投第１５案,桃園市,桃園區,中寧里,108,2168,368,664,1032,39,1071
公投第１５案,桃園市,桃園區,中寧里,109,1874,337,569,906,17,923
公投第１５案,桃園市,桃園區,北埔里,110,1524,253,434,687,18,705
公投第１５案,桃園市,桃園區,北埔里,111,1528,288,495,783,22,805
公投第１５案,桃園市,桃園區,北埔里,112,1489,311,465,776,31,807
公投第１５案,桃園市,桃園區,永安里,113,1308,252,374,626,50,676
公投第１５案,桃園市,桃園區,永安里,114,1583,260,514,774,41,815
公投第１５案,桃園市,桃園區,永安里,115,1618,302,531,833,47,880
公投第１５案,桃園市,桃園區,同安里,116,2127,360,635,995,49,1044
公投第１５案,桃園市,桃園區,同安里,117,2033,334,633,967,17,984
公投第１５案,桃園市,桃園區,同安里,118,2098,353,686,1039,18,1057
公投第１５案,桃園市,桃園區,同安里,119,2126,285,710,995,57,1052
公投第１５案,桃園市,桃園區,同德里,120,1917,305,600,905,33,938
公投第１５案,桃園市,桃園區,同德里,121,1997,348,603,951,32,983
公投第１５案,桃園市,桃園區,同德里,122,1929,352,649,1001,27,1028
公投第１５案,桃園市,桃園區,自強里,123,1691,295,526,821,38,859
公投第１５案,桃園市,桃園區,自強里,124,1900,345,591,936,20,956
公投第１５案,桃園市,桃園區,自強里,125,1761,300,580,880,54,934
公投第１５案,桃園市,桃園區,自強里,126,1922,356,590,946,23,969
公投第１５案,桃園市,桃園區,西埔里,127,1995,311,630,941,49,990
公投第１５案,桃園市,桃園區,西埔里,128,1063,199,359,558,29,587
公投第１５案,桃園市,桃園區,明德里,129,1412,263,449,712,25,737
公投第１５案,桃園市,桃園區,明德里,130,1746,348,569,917,26,943
公投第１５案,桃園市,桃園區,東埔里,131,1689,285,478,763,45,808
公投第１５案,桃園市,桃園區,東埔里,132,1542,239,431,670,22,692
公投第１５案,桃園市,桃園區,東埔里,133,1437,231,454,685,37,722
公投第１５案,桃園市,桃園區,長安里,134,1679,281,548,829,35,864
公投第１５案,桃園市,桃園區,長安里,135,1886,303,527,830,48,878
公投第１５案,桃園市,桃園區,長德里,136,1657,307,511,818,69,887
公投第１５案,桃園市,桃園區,長德里,137,1349,266,434,700,23,723
公投第１５案,桃園市,桃園區,長德里,138,1805,335,576,911,32,943
公投第１５案,桃園市,桃園區,信光里,139,1846,313,577,890,48,938
公投第１５案,桃園市,桃園區,信光里,140,1644,266,475,741,38,779
公投第１５案,桃園市,桃園區,信光里,141,1674,296,477,773,33,806
公投第１５案,桃園市,桃園區,信光里,142,1737,282,558,840,47,887
公投第１５案,桃園市,桃園區,南埔里,143,1566,265,532,797,42,839
公投第１５案,桃園市,桃園區,南埔里,144,1517,287,494,781,30,811
公投第１５案,桃園市,桃園區,南埔里,145,1619,274,439,713,34,747
公投第１５案,桃園市,桃園區,莊敬里,146,1774,334,513,847,31,878
公投第１５案,桃園市,桃園區,莊敬里,147,1666,295,537,832,35,867
公投第１５案,桃園市,桃園區,莊敬里,148,1528,281,502,783,16,799
公投第１５案,桃園市,桃園區,莊敬里,149,1709,294,537,831,41,872
公投第１５案,桃園市,桃園區,莊敬里,150,1719,325,523,848,19,867
公投第１５案,桃園市,桃園區,慈文里,151,1569,244,446,690,42,732
公投第１５案,桃園市,桃園區,慈文里,152,1505,220,497,717,28,745
公投第１５案,桃園市,桃園區,慈文里,153,1496,252,455,707,51,758
公投第１５案,桃園市,桃園區,慈文里,154,1505,268,502,770,33,803
公投第１５案,桃園市,桃園區,新埔里,155,1807,325,553,878,31,909
公投第１５案,桃園市,桃園區,新埔里,156,1857,332,578,910,38,948
公投第１５案,桃園市,桃園區,新埔里,157,1589,255,587,842,52,894
公投第１５案,桃園市,桃園區,新埔里,158,2088,382,634,1016,39,1055
公投第１５案,桃園市,桃園區,新埔里,159,1893,313,608,921,29,950
公投第１５案,桃園市,桃園區,瑞慶里,160,1303,181,387,568,24,592
公投第１５案,桃園市,桃園區,瑞慶里,161,1416,274,451,725,33,758
公投第１５案,桃園市,桃園區,瑞慶里,162,1351,211,430,641,23,664
公投第１５案,桃園市,桃園區,瑞慶里,163,1659,300,492,792,25,817
公投第１５案,桃園市,桃園區,寶安里,164,2103,331,661,992,29,1021
公投第１５案,桃園市,桃園區,寶安里,165,1943,331,604,935,28,963
公投第１５案,桃園市,桃園區,寶安里,166,1927,363,591,954,30,984
公投第１５案,桃園市,桃園區,寶安里,167,1929,317,530,847,34,881
公投第１５案,桃園市,桃園區,寶慶里,168,2204,450,760,1210,27,1237
公投第１５案,桃園市,桃園區,寶慶里,169,2033,414,500,914,20,934
公投第１５案,桃園市,桃園區,寶慶里,170,1656,262,571,833,14,847
公投第１５案,桃園市,桃園區,三元里,171,1712,317,512,829,44,873
公投第１５案,桃園市,桃園區,三元里,172,1738,331,513,844,30,874
公投第１５案,桃園市,桃園區,三民里,173,1432,287,546,833,25,858
公投第１５案,桃園市,桃園區,三民里,174,1421,316,470,786,35,821
公投第１５案,桃園市,桃園區,三民里,175,1344,264,430,694,11,705
公投第１５案,桃園市,桃園區,大有里,176,1942,316,562,878,22,900
公投第１５案,桃園市,桃園區,大有里,177,2001,346,633,979,29,1008
公投第１５案,桃園市,桃園區,大有里,178,1941,332,545,877,17,894
公投第１５案,桃園市,桃園區,大業里,179,1702,292,584,876,37,913
公投第１５案,桃園市,桃園區,大業里,180,1589,296,495,791,29,820
公投第１５案,桃園市,桃園區,大業里,181,1544,267,501,768,28,796
公投第１５案,桃園市,桃園區,大興里,182,1860,260,514,774,40,814
公投第１５案,桃園市,桃園區,大興里,183,1726,291,525,816,54,870
公投第１５案,桃園市,桃園區,大興里,184,1798,279,548,827,40,867
公投第１５案,桃園市,桃園區,成功里,185,1925,356,594,950,26,976
公投第１５案,桃園市,桃園區,成功里,186,1945,366,573,939,29,968
公投第１５案,桃園市,桃園區,汴洲里,187,1764,302,494,796,37,833
公投第１５案,桃園市,桃園區,汴洲里,188,1899,282,684,966,65,1031
公投第１５案,桃園市,桃園區,汴洲里,189,1415,250,460,710,20,730
公投第１５案,桃園市,桃園區,忠義里,190,1790,303,528,831,24,855
公投第１５案,桃園市,桃園區,忠義里,191,1693,280,512,792,29,821
公投第１５案,桃園市,桃園區,東山里,192,1916,311,590,901,43,944
公投第１５案,桃園市,桃園區,東門里,193,1434,250,413,663,19,682
公投第１５案,桃園市,桃園區,東門里,194,1494,309,496,805,42,847
公投第１５案,桃園市,桃園區,青溪里,195,1311,230,436,666,56,722
公投第１５案,桃園市,桃園區,青溪里,196,1476,258,477,735,38,773
公投第１５案,桃園市,桃園區,青溪里,197,1484,325,475,800,31,831
公投第１５案,桃園市,桃園區,春日里,198,1514,288,452,740,38,778
公投第１５案,桃園市,桃園區,春日里,199,1446,248,466,714,43,757
公投第１５案,桃園市,桃園區,春日里,200,1573,259,482,741,24,765
公投第１５案,桃園市,桃園區,春日里,201,1564,233,465,698,30,728
公投第１５案,桃園市,桃園區,朝陽里,202,1015,207,334,541,34,575
公投第１５案,桃園市,桃園區,朝陽里,203,955,172,286,458,31,489
公投第１５案,桃園市,桃園區,會稽里,204,1796,311,562,873,26,899
公投第１５案,桃園市,桃園區,會稽里,205,1878,339,557,896,15,911
公投第１５案,桃園市,桃園區,會稽里,206,1729,272,544,816,38,854
公投第１５案,桃園市,桃園區,會稽里,207,1843,281,536,817,24,841
公投第１５案,桃園市,桃園區,會稽里,208,1817,263,493,756,23,779
公投第１５案,桃園市,桃園區,萬壽里,209,979,185,344,529,24,553
公投第１５案,桃園市,桃園區,福元里,210,1363,300,403,703,21,724
公投第１５案,桃園市,桃園區,福元里,211,1546,281,497,778,13,791
公投第１５案,桃園市,桃園區,福元里,212,1308,248,391,639,23,662
公投第１５案,桃園市,桃園區,寶山里,213,2164,366,656,1022,50,1072
公投第１５案,桃園市,桃園區,寶山里,214,2020,329,619,948,38,986
公投第１５案,桃園市,桃園區,寶山里,215,1924,292,543,835,26,861
公投第１５案,桃園市,桃園區,寶山里,216,2088,280,584,864,34,898
公投第１５案,桃園市,龜山區,精忠里,217,874,131,329,460,25,485
公投第１５案,桃園市,龜山區,精忠里,218,2014,275,734,1009,65,1074
公投第１５案,桃園市,龜山區,精忠里,219,2145,393,635,1028,22,1050
公投第１５案,桃園市,龜山區,陸光里,220,1744,216,686,902,43,945
公投第１５案,桃園市,龜山區,陸光里,221,1885,251,706,957,60,1017
公投第１５案,桃園市,龜山區,中興里,222,1546,248,457,705,46,751
公投第１５案,桃園市,龜山區,中興里,223,1684,300,478,778,55,833
公投第１５案,桃園市,龜山區,中興里,224,1477,128,509,637,40,677
公投第１５案,桃園市,龜山區,新興里,225,1528,266,548,814,42,856
公投第１５案,桃園市,龜山區,新興里,226,1428,95,180,275,16,291
公投第１５案,桃園市,龜山區,新路里,227,1525,246,507,753,47,800
公投第１５案,桃園市,龜山區,新路里,228,1041,201,363,564,45,609
公投第１５案,桃園市,龜山區,新路里,229,1404,239,422,661,35,696
公投第１５案,桃園市,龜山區,新路里,230,1478,258,514,772,45,817
公投第１５案,桃園市,龜山區,龜山里,231,2178,336,731,1067,61,1128
公投第１５案,桃園市,龜山區,龜山里,232,1672,299,543,842,64,906
公投第１５案,桃園市,龜山區,龜山里,233,1376,102,454,556,28,584
公投第１５案,桃園市,龜山區,龜山里,234,1480,245,467,712,41,753
公投第１５案,桃園市,龜山區,大同里,235,1258,250,410,660,36,696
公投第１５案,桃園市,龜山區,大同里,236,1464,248,477,725,24,749
公投第１５案,桃園市,龜山區,大同里,237,1844,318,550,868,73,941
公投第１５案,桃園市,龜山區,大同里,238,1169,228,361,589,21,610
公投第１５案,桃園市,龜山區,山頂里,239,1921,240,490,730,40,770
公投第１５案,桃園市,龜山區,山頂里,240,1694,261,519,780,34,814
公投第１５案,桃園市,龜山區,山頂里,241,1771,335,600,935,48,983
公投第１５案,桃園市,龜山區,山德里,242,1665,258,485,743,49,792
公投第１５案,桃園市,龜山區,山德里,243,1439,251,434,685,52,737
公投第１５案,桃園市,龜山區,山德里,244,1728,236,500,736,59,795
公投第１５案,桃園市,龜山區,山福里,245,1788,306,576,882,41,923
公投第１５案,桃園市,龜山區,山福里,246,1465,208,449,657,46,703
公投第１５案,桃園市,龜山區,幸福里,247,1659,311,442,753,46,799
公投第１５案,桃園市,龜山區,幸福里,248,1693,278,430,708,27,735
公投第１５案,桃園市,龜山區,幸福里,249,1818,263,423,686,20,706
公投第１５案,桃園市,龜山區,龍壽里,250,1752,272,556,828,62,890
公投第１５案,桃園市,龜山區,龍華里,251,1818,341,531,872,17,889
公投第１５案,桃園市,龜山區,龍華里,252,1499,257,472,729,23,752
公投第１５案,桃園市,龜山區,迴龍里,253,1916,350,570,920,50,970
公投第１５案,桃園市,龜山區,迴龍里,254,1804,327,563,890,36,926
公投第１５案,桃園市,龜山區,迴龍里,255,2127,375,610,985,27,1012
公投第１５案,桃園市,龜山區,嶺頂里,256,1005,165,311,476,56,532
公投第１５案,桃園市,龜山區,嶺頂里,257,1449,256,473,729,39,768
公投第１５案,桃園市,龜山區,嶺頂里,258,1498,246,423,669,57,726
公投第１５案,桃園市,龜山區,新嶺里,259,2149,305,594,899,51,950
公投第１５案,桃園市,龜山區,新嶺里,260,1771,241,405,646,42,688
公投第１５案,桃園市,龜山區,兔坑里,261,841,145,274,419,25,444
公投第１５案,桃園市,龜山區,兔坑里,262,2284,404,587,991,55,1046
公投第１５案,桃園市,龜山區,兔坑里,263,1228,200,407,607,44,651
公投第１５案,桃園市,龜山區,福源里,264,1979,268,601,869,48,917
公投第１５案,桃園市,龜山區,舊路里,265,1378,173,433,606,38,644
公投第１５案,桃園市,龜山區,舊路里,266,1061,163,321,484,48,532
公投第１５案,桃園市,龜山區,大坑里,267,1917,290,575,865,54,919
公投第１５案,桃園市,龜山區,楓福里,268,1540,307,568,875,26,901
公投第１５案,桃園市,龜山區,楓福里,269,1433,239,509,748,28,776
公投第１５案,桃園市,龜山區,楓樹里,270,1455,266,459,725,21,746
公投第１５案,桃園市,龜山區,楓樹里,271,2280,410,755,1165,58,1223
公投第１５案,桃園市,龜山區,樂善里,272,1668,347,534,881,38,919
公投第１５案,桃園市,龜山區,樂善里,273,1885,321,566,887,41,928
公投第１５案,桃園市,龜山區,長庚里,274,1849,432,459,891,16,907
公投第１５案,桃園市,龜山區,長庚里,275,1704,462,470,932,16,948
公投第１５案,桃園市,龜山區,公西里,276,1156,208,375,583,38,621
公投第１５案,桃園市,龜山區,大崗里,277,2114,298,532,830,48,878
公投第１５案,桃園市,龜山區,大崗里,278,1943,313,483,796,42,838
公投第１５案,桃園市,龜山區,大湖里,279,1800,312,495,807,26,833
公投第１５案,桃園市,龜山區,大湖里,280,2020,384,552,936,41,977
公投第１５案,桃園市,龜山區,大湖里,281,1319,275,426,701,28,729
公投第１５案,桃園市,龜山區,大華里,282,2229,436,712,1148,36,1184
公投第１５案,桃園市,龜山區,大華里,283,1992,354,582,936,30,966
公投第１５案,桃園市,龜山區,大華里,284,2237,382,633,1015,41,1056
公投第１５案,桃園市,龜山區,大華里,285,2133,411,584,995,25,1020
公投第１５案,桃園市,龜山區,文化里,286,2187,423,647,1070,37,1107
公投第１５案,桃園市,龜山區,文化里,287,1959,340,567,907,42,949
公投第１５案,桃園市,龜山區,文化里,288,1910,338,518,856,22,878
公投第１５案,桃園市,龜山區,南上里,289,1840,721,173,894,84,978
公投第１５案,桃園市,龜山區,南美里,290,2266,352,743,1095,37,1132
公投第１５案,桃園市,龜山區,文青里,291,2387,344,711,1055,21,1076
公投第１５案,桃園市,龜山區,文青里,292,1692,278,520,798,19,817
公投第１５案,桃園市,龜山區,文青里,293,904,178,275,453,13,466
公投第１５案,桃園市,龜山區,文青里,294,1469,290,480,770,15,785
公投第１５案,桃園市,八德區,興仁里,295,1761,250,508,758,70,828
公投第１５案,桃園市,八德區,興仁里,296,1804,267,452,719,11,730
公投第１５案,桃園市,八德區,興仁里,297,1813,188,312,500,14,514
公投第１５案,桃園市,八德區,興仁里,298,1784,285,516,801,24,825
公投第１５案,桃園市,八德區,福興里,299,2257,302,641,943,24,967
公投第１５案,桃園市,八德區,福興里,300,1857,233,527,760,33,793
公投第１５案,桃園市,八德區,福興里,301,2261,299,643,942,34,976
公投第１５案,桃園市,八德區,福興里,302,1903,319,620,939,50,989
公投第１５案,桃園市,八德區,瑞豐里,303,1955,283,631,914,69,983
公投第１５案,桃園市,八德區,瑞豐里,304,1665,264,454,718,21,739
公投第１５案,桃園市,八德區,瑞興里,305,1431,265,464,729,54,783
公投第１５案,桃園市,八德區,瑞興里,306,1263,198,457,655,38,693
公投第１５案,桃園市,八德區,瑞泰里,307,1583,275,561,836,48,884
公投第１５案,桃園市,八德區,瑞泰里,308,1246,191,456,647,37,684
公投第１５案,桃園市,八德區,瑞泰里,309,1356,224,469,693,36,729
公投第１５案,桃園市,八德區,瑞發里,310,1630,267,577,844,59,903
公投第１５案,桃園市,八德區,瑞發里,311,1586,228,502,730,53,783
公投第１５案,桃園市,八德區,瑞德里,312,1649,245,564,809,63,872
公投第１５案,桃園市,八德區,瑞德里,313,1910,250,566,816,78,894
公投第１５案,桃園市,八德區,瑞祥里,314,1612,224,605,829,72,901
公投第１５案,桃園市,八德區,瑞祥里,315,1640,248,553,801,53,854
公投第１５案,桃園市,八德區,廣德里,316,1303,217,404,621,39,660
公投第１５案,桃園市,八德區,廣德里,317,1413,271,500,771,45,816
公投第１５案,桃園市,八德區,廣興里,318,1711,267,561,828,44,872
公投第１５案,桃園市,八德區,廣興里,319,1562,236,530,766,80,846
公投第１５案,桃園市,八德區,廣隆里,320,1735,253,584,837,47,884
公投第１５案,桃園市,八德區,廣隆里,321,1658,275,545,820,28,848
公投第１５案,桃園市,八德區,廣隆里,322,1022,173,391,564,49,613
公投第１５案,桃園市,八德區,竹園里,323,1673,241,478,719,46,765
公投第１５案,桃園市,八德區,竹園里,324,1741,269,558,827,32,859
公投第１５案,桃園市,八德區,霄裡里,325,2110,307,701,1008,60,1068
公投第１５案,桃園市,八德區,龍友里,326,1145,153,436,589,29,618
公投第１５案,桃園市,八德區,龍友里,327,1010,150,400,550,38,588
公投第１５案,桃園市,八德區,茄明里,328,1848,271,521,792,29,821
公投第１５案,桃園市,八德區,茄明里,329,1334,223,474,697,29,726
公投第１５案,桃園市,八德區,茄明里,330,1349,198,375,573,15,588
公投第１５案,桃園市,八德區,茄苳里,331,1341,255,470,725,31,756
公投第１５案,桃園市,八德區,茄苳里,332,1178,196,441,637,39,676
公投第１５案,桃園市,八德區,永豐里,333,1374,247,462,709,39,748
公投第１５案,桃園市,八德區,永豐里,334,1462,239,453,692,50,742
公投第１５案,桃園市,八德區,高明里,335,1943,237,555,792,68,860
公投第１５案,桃園市,八德區,高明里,336,1928,274,429,703,58,761
公投第１５案,桃園市,八德區,高城里,337,1403,233,439,672,29,701
公投第１５案,桃園市,八德區,高城里,338,1672,256,492,748,54,802
公投第１５案,桃園市,八德區,白鷺里,339,1947,313,554,867,40,907
公投第１５案,桃園市,八德區,白鷺里,340,1200,209,403,612,47,659
公投第１５案,桃園市,八德區,大湳里,341,1895,270,556,826,61,887
公投第１５案,桃園市,八德區,大湳里,342,1988,304,551,855,60,915
公投第１５案,桃園市,八德區,大發里,343,2006,336,647,983,66,1049
公投第１５案,桃園市,八德區,大仁里,344,2061,306,603,909,10,919
公投第１５案,桃園市,八德區,大仁里,345,2108,282,624,906,67,973
公投第１５案,桃園市,八德區,大明里,346,1862,263,560,823,55,878
公投第１５案,桃園市,八德區,大明里,347,1681,267,526,793,25,818
公投第１５案,桃園市,八德區,大安里,348,1317,219,457,676,57,733
公投第１５案,桃園市,八德區,大安里,349,2093,403,717,1120,45,1165
公投第１５案,桃園市,八德區,大竹里,350,1499,261,539,800,53,853
公投第１５案,桃園市,八德區,大興里,351,1782,273,581,854,52,906
公投第１５案,桃園市,八德區,大興里,352,1763,293,576,869,32,901
公投第１５案,桃園市,八德區,大愛里,353,1226,209,408,617,51,668
公投第１５案,桃園市,八德區,大愛里,354,1311,267,426,693,28,721
公投第１５案,桃園市,八德區,大華里,355,1170,224,401,625,40,665
公投第１５案,桃園市,八德區,大華里,356,1313,212,472,684,34,718
公投第１５案,桃園市,八德區,大順里,357,1186,211,417,628,26,654
公投第１５案,桃園市,八德區,大順里,358,1481,243,434,677,47,724
公投第１５案,桃園市,八德區,大和里,359,1998,331,635,966,63,1029
公投第１５案,桃園市,八德區,大和里,360,916,156,329,485,34,519
公投第１５案,桃園市,八德區,大和里,361,1943,281,600,881,46,927
公投第１５案,桃園市,八德區,大和里,362,2076,288,668,956,29,985
公投第１５案,桃園市,八德區,大昌里,363,1363,217,463,680,52,732
公投第１５案,桃園市,八德區,大昌里,364,1491,234,502,736,56,792
公投第１５案,桃園市,八德區,大信里,365,1474,221,476,697,65,762
公投第１５案,桃園市,八德區,大信里,366,718,30,130,160,15,175
公投第１５案,桃園市,八德區,大信里,367,1386,216,468,684,48,732
公投第１５案,桃園市,八德區,陸光里,368,1487,219,478,697,77,774
公投第１５案,桃園市,八德區,陸光里,369,1552,212,502,714,76,790
公投第１５案,桃園市,八德區,陸光里,370,1255,156,407,563,56,619
公投第１５案,桃園市,八德區,大同里,371,1505,292,471,763,48,811
公投第１５案,桃園市,八德區,大慶里,372,1436,214,441,655,46,701
公投第１５案,桃園市,八德區,大成里,373,1618,304,515,819,59,878
公投第１５案,桃園市,八德區,大成里,374,1685,247,553,800,55,855
公投第１５案,桃園市,八德區,大義里,375,1835,297,508,805,46,851
公投第１５案,桃園市,八德區,大義里,376,1881,286,607,893,54,947
公投第１５案,桃園市,八德區,大忠里,377,1766,271,561,832,32,864
公投第１５案,桃園市,八德區,大智里,378,1817,260,589,849,78,927
公投第１５案,桃園市,八德區,大智里,379,2198,362,740,1102,26,1128
公投第１５案,桃園市,八德區,大宏里,380,1732,312,560,872,40,912
公投第１５案,桃園市,八德區,大宏里,381,2089,389,769,1158,19,1177
公投第１５案,桃園市,八德區,大正里,382,1257,228,443,671,34,705
公投第１５案,桃園市,八德區,大正里,383,1267,232,381,613,43,656
公投第１５案,桃園市,八德區,大正里,384,1427,267,495,762,15,777
公投第１５案,桃園市,八德區,大福里,385,1685,311,603,914,56,970
公投第１５案,桃園市,八德區,大福里,386,1748,320,576,896,50,946
公投第１５案,桃園市,八德區,大福里,387,1650,311,795,1106,34,1140
公投第１５案,桃園市,八德區,大強里,388,1478,269,482,751,50,801
公投第１５案,桃園市,八德區,大強里,389,1607,240,569,809,39,848
公投第１５案,桃園市,八德區,大勇里,390,1841,319,648,967,56,1023
公投第１５案,桃園市,八德區,大勇里,391,2082,368,652,1020,47,1067
公投第１５案,桃園市,八德區,大榮里,392,1959,470,379,849,56,905
公投第１５案,桃園市,八德區,大千里,393,2209,369,696,1065,45,1110
公投第１５案,桃園市,八德區,大漢里,394,1864,313,624,937,36,973
公投第１５案,桃園市,八德區,大漢里,395,2000,323,606,929,45,974
公投第１５案,桃園市,蘆竹區,新興里,396,1358,206,426,632,79,711
公投第１５案,桃園市,蘆竹區,新興里,397,1538,216,492,708,68,776
公投第１５案,桃園市,蘆竹區,中福里,398,2118,214,598,812,51,863
公投第１５案,桃園市,蘆竹區,中福里,399,1673,284,595,879,61,940
公投第１５案,桃園市,蘆竹區,上興里,400,1500,263,512,775,28,803
公投第１５案,桃園市,蘆竹區,上興里,401,1699,282,581,863,41,904
公投第１５案,桃園市,蘆竹區,中興里,402,2250,352,758,1110,38,1148
公投第１５案,桃園市,蘆竹區,中興里,403,2354,383,653,1036,20,1056
公投第１５案,桃園市,蘆竹區,新莊里,404,1446,212,448,660,27,687
公投第１５案,桃園市,蘆竹區,新莊里,405,1623,253,456,709,53,762
公投第１５案,桃園市,蘆竹區,新莊里,406,1747,285,529,814,33,847
公投第１５案,桃園市,蘆竹區,上竹里,407,1988,310,658,968,55,1023
公投第１５案,桃園市,蘆竹區,上竹里,408,1437,249,467,716,38,754
公投第１５案,桃園市,蘆竹區,宏竹里,409,1532,261,548,809,58,867
公投第１５案,桃園市,蘆竹區,宏竹里,410,1447,102,570,672,41,713
公投第１５案,桃園市,蘆竹區,大竹里,411,2189,713,335,1048,53,1101
公投第１５案,桃園市,蘆竹區,大竹里,412,2498,335,783,1118,48,1166
公投第１５案,桃園市,蘆竹區,富竹里,413,1322,226,457,683,38,721
公投第１５案,桃園市,蘆竹區,蘆竹里,414,1991,265,521,786,65,851
公投第１５案,桃園市,蘆竹區,蘆竹里,415,2097,330,588,918,74,992
公投第１５案,桃園市,蘆竹區,南興里,416,1558,290,509,799,49,848
公投第１５案,桃園市,蘆竹區,南興里,417,1891,352,607,959,33,992
公投第１５案,桃園市,蘆竹區,南興里,418,1590,255,479,734,39,773
公投第１５案,桃園市,蘆竹區,福昌里,419,2404,343,695,1038,45,1083
公投第１５案,桃園市,蘆竹區,福昌里,420,2522,401,803,1204,46,1250
公投第１５案,桃園市,蘆竹區,福興里,421,1633,269,555,824,20,844
公投第１５案,桃園市,蘆竹區,福興里,422,1715,299,558,857,30,887
公投第１５案,桃園市,蘆竹區,正興里,423,2215,333,678,1011,23,1034
公投第１５案,桃園市,蘆竹區,正興里,424,2029,340,606,946,35,981
公投第１５案,桃園市,蘆竹區,順興里,425,1731,268,547,815,27,842
公投第１５案,桃園市,蘆竹區,順興里,426,1820,306,592,898,31,929
公投第１５案,桃園市,蘆竹區,蘆興里,427,1633,293,551,844,38,882
公投第１５案,桃園市,蘆竹區,南榮里,428,1668,231,501,732,20,752
公投第１５案,桃園市,蘆竹區,南榮里,429,1493,290,496,786,28,814
公投第１５案,桃園市,蘆竹區,南崁里,430,1864,296,633,929,48,977
公投第１５案,桃園市,蘆竹區,南崁里,431,1703,293,518,811,23,834
公投第１５案,桃園市,蘆竹區,錦興里,432,1893,318,603,921,33,954
公投第１５案,桃園市,蘆竹區,錦興里,433,1922,366,657,1023,34,1057
公投第１５案,桃園市,蘆竹區,興榮里,434,1393,225,500,725,22,747
公投第１５案,桃園市,蘆竹區,興榮里,435,1338,235,477,712,25,737
公投第１５案,桃園市,蘆竹區,錦中里,436,1688,268,558,826,27,853
公投第１５案,桃園市,蘆竹區,錦中里,437,1462,243,446,689,62,751
公投第１５案,桃園市,蘆竹區,長興里,438,1232,184,439,623,29,652
公投第１５案,桃園市,蘆竹區,長興里,439,1356,197,431,628,23,651
公投第１５案,桃園市,蘆竹區,五福里,440,1181,227,458,685,33,718
公投第１５案,桃園市,蘆竹區,五福里,441,1199,190,392,582,24,606
公投第１５案,桃園市,蘆竹區,中山里,442,1710,313,569,882,31,913
公投第１５案,桃園市,蘆竹區,中山里,443,1423,247,439,686,28,714
公投第１５案,桃園市,蘆竹區,福祿里,444,1522,318,479,797,19,816
公投第１５案,桃園市,蘆竹區,福祿里,445,1639,685,161,846,35,881
公投第１５案,桃園市,蘆竹區,羊稠里,446,2055,346,643,989,40,1029
公投第１５案,桃園市,蘆竹區,羊稠里,447,2178,409,665,1074,25,1099
公投第１５案,桃園市,蘆竹區,吉祥里,448,1709,335,554,889,29,918
公投第１５案,桃園市,蘆竹區,長壽里,449,1667,292,581,873,43,916
公投第１５案,桃園市,蘆竹區,長壽里,450,1745,319,597,916,30,946
公投第１５案,桃園市,蘆竹區,長壽里,451,1967,362,680,1042,33,1075
公投第１５案,桃園市,蘆竹區,吉祥里,452,1802,330,652,982,24,1006
公投第１５案,桃園市,蘆竹區,營盤里,453,2727,430,847,1277,38,1315
公投第１５案,桃園市,蘆竹區,營盤里,454,1868,324,523,847,34,881
公投第１５案,桃園市,蘆竹區,營福里,455,1537,272,461,733,50,783
公投第１５案,桃園市,蘆竹區,營福里,456,1616,308,504,812,34,846
公投第１５案,桃園市,蘆竹區,瓦窯里,457,1483,279,542,821,33,854
公投第１５案,桃園市,蘆竹區,瓦窯里,458,1689,281,511,792,51,843
公投第１５案,桃園市,蘆竹區,內厝里,459,1318,173,350,523,42,565
公投第１５案,桃園市,蘆竹區,內厝里,460,1203,193,494,687,86,773
公投第１５案,桃園市,蘆竹區,山鼻里,461,1771,248,537,785,38,823
公投第１５案,桃園市,蘆竹區,山腳里,462,1832,257,528,785,72,857
公投第１５案,桃園市,蘆竹區,山腳里,463,1763,267,532,799,91,890
公投第１５案,桃園市,蘆竹區,外社里,464,1497,231,386,617,20,637
公投第１５案,桃園市,蘆竹區,坑子里,465,1671,267,614,881,115,996
公投第１５案,桃園市,蘆竹區,坑口里,466,929,163,319,482,56,538
公投第１５案,桃園市,蘆竹區,坑口里,467,1559,251,540,791,88,879
公投第１５案,桃園市,蘆竹區,海湖里,468,1497,228,539,767,25,792
公投第１５案,桃園市,蘆竹區,海湖里,469,1441,245,608,853,59,912
公投第１５案,桃園市,蘆竹區,濱海里,470,1465,211,492,703,51,754
公投第１５案,桃園市,蘆竹區,濱海里,471,1029,150,352,502,32,534
公投第１５案,桃園市,大園區,大園里,472,1538,229,438,667,39,706
公投第１５案,桃園市,大園區,大園里,473,1616,203,429,632,31,663
公投第１５案,桃園市,大園區,大園里,474,1437,267,495,762,48,810
公投第１５案,桃園市,大園區,大園里,475,1554,248,569,817,34,851
公投第１５案,桃園市,大園區,田心里,476,1237,214,391,605,40,645
公投第１５案,桃園市,大園區,田心里,477,1347,211,435,646,52,698
公投第１５案,桃園市,大園區,田心里,478,1261,226,398,624,23,647
公投第１５案,桃園市,大園區,田心里,479,1256,212,388,600,39,639
公投第１５案,桃園市,大園區,田心里,480,1370,281,344,625,21,646
公投第１５案,桃園市,大園區,溪海里,481,1610,207,503,710,35,745
公投第１５案,桃園市,大園區,溪海里,482,1419,197,480,677,37,714
公投第１５案,桃園市,大園區,溪海里,483,1588,204,428,632,20,652
公投第１５案,桃園市,大園區,和平里,484,1612,265,505,770,44,814
公投第１５案,桃園市,大園區,橫峰里,485,1440,221,452,673,45,718
公投第１５案,桃園市,大園區,橫峰里,486,1326,211,401,612,35,647
公投第１５案,桃園市,大園區,橫峰里,487,1455,241,520,761,57,818
公投第１５案,桃園市,大園區,橫峰里,488,1562,260,529,789,51,840
公投第１５案,桃園市,大園區,橫峰里,489,1284,231,465,696,31,727
公投第１５案,桃園市,大園區,橫峰里,490,1454,258,418,676,17,693
公投第１５案,桃園市,大園區,橫峰里,491,1490,285,454,739,20,759
公投第１５案,桃園市,大園區,五權里,492,1617,234,482,716,33,749
公投第１５案,桃園市,大園區,五權里,493,1594,250,505,755,73,828
公投第１５案,桃園市,大園區,五權里,494,1650,229,557,786,58,844
公投第１５案,桃園市,大園區,埔心里,495,1467,208,467,675,20,695
公投第１５案,桃園市,大園區,埔心里,496,1494,232,489,721,29,750
公投第１５案,桃園市,大園區,埔心里,497,1538,246,480,726,48,774
公投第１５案,桃園市,大園區,埔心里,498,1397,214,459,673,24,697
公投第１５案,桃園市,大園區,大海里,499,1637,243,512,755,28,783
公投第１５案,桃園市,大園區,三石里,500,1452,206,448,654,44,698
公投第１５案,桃園市,大園區,三石里,501,1414,240,556,796,45,841
公投第１５案,桃園市,大園區,菓林里,502,1670,245,573,818,34,852
公投第１５案,桃園市,大園區,菓林里,503,1701,269,497,766,18,784
公投第１５案,桃園市,大園區,菓林里,504,1813,230,518,748,31,779
公投第１５案,桃園市,大園區,菓林里,505,1687,252,519,771,35,806
公投第１５案,桃園市,大園區,竹圍里,506,1650,284,554,838,10,848
公投第１５案,桃園市,大園區,竹圍里,507,1556,313,533,846,39,885
公投第１５案,桃園市,大園區,海口里,508,1844,273,522,795,30,825
公投第１５案,桃園市,大園區,沙崙里,509,1336,191,403,594,59,653
公投第１５案,桃園市,大園區,沙崙里,510,1414,232,495,727,58,785
公投第１５案,桃園市,大園區,後厝里,511,1238,221,474,695,47,742
公投第１５案,桃園市,大園區,後厝里,512,1227,118,596,714,30,744
公投第１５案,桃園市,大園區,圳頭里,513,1199,207,373,580,24,604
公投第１５案,桃園市,大園區,圳頭里,514,1349,174,422,596,32,628
公投第１５案,桃園市,大園區,內海里,515,1120,184,362,546,29,575
公投第１５案,桃園市,大園區,內海里,516,1080,173,368,541,27,568
公投第１５案,桃園市,大園區,北港里,517,1341,194,433,627,32,659
公投第１５案,桃園市,大園區,北港里,518,1345,223,459,682,28,710
公投第１５案,桃園市,大園區,南港里,519,1565,203,461,664,45,709
公投第１５案,桃園市,大園區,南港里,520,1519,215,424,639,20,659
公投第１５案,桃園市,大園區,南港里,521,2130,270,661,931,49,980
公投第１５案,桃園市,大溪區,興和里,522,1477,269,508,777,52,829
公投第１５案,桃園市,大溪區,福仁里,523,1006,178,349,527,33,560
公投第１５案,桃園市,大溪區,田心里,524,1553,228,521,749,66,815
公投第１５案,桃園市,大溪區,田心里,525,1597,288,517,805,64,869
公投第１５案,桃園市,大溪區,田心里,526,1358,240,441,681,45,726
公投第１５案,桃園市,大溪區,一心里,527,1585,244,480,724,38,762
公投第１５案,桃園市,大溪區,一心里,528,1612,266,530,796,44,840
公投第１５案,桃園市,大溪區,一心里,529,1555,210,484,694,31,725
公投第１５案,桃園市,大溪區,一德里,530,1282,230,490,720,54,774
公投第１５案,桃園市,大溪區,一德里,531,1392,207,468,675,55,730
公投第１５案,桃園市,大溪區,一德里,532,1422,207,461,668,50,718
公投第１５案,桃園市,大溪區,一德里,533,1448,255,475,730,58,788
公投第１５案,桃園市,大溪區,月眉里,534,1269,244,485,729,47,776
公投第１５案,桃園市,大溪區,永福里,535,977,170,354,524,67,591
公投第１５案,桃園市,大溪區,康安里,536,1359,228,490,718,48,766
公投第１５案,桃園市,大溪區,義和里,537,1135,222,398,620,66,686
公投第１５案,桃園市,大溪區,義和里,538,660,112,184,296,56,352
公投第１５案,桃園市,大溪區,美華里,539,1056,187,304,491,40,531
公投第１５案,桃園市,大溪區,美華里,540,1263,200,387,587,59,646
公投第１５案,桃園市,大溪區,美華里,541,717,115,252,367,33,400
公投第１５案,桃園市,大溪區,福安里,542,1299,176,356,532,27,559
公投第１５案,桃園市,大溪區,福安里,543,976,169,323,492,50,542
公投第１５案,桃園市,大溪區,復興里,544,938,129,320,449,59,508
公投第１５案,桃園市,大溪區,新峰里,545,832,107,288,395,28,423
公投第１５案,桃園市,大溪區,中新里,546,866,122,251,373,24,397
公投第１５案,桃園市,大溪區,中新里,547,694,133,183,316,31,347
公投第１５案,桃園市,大溪區,瑞興里,548,1410,208,448,656,44,700
公投第１５案,桃園市,大溪區,瑞興里,549,1303,168,426,594,55,649
公投第１５案,桃園市,大溪區,仁善里,550,1125,194,358,552,37,589
公投第１５案,桃園市,大溪區,仁善里,551,1170,212,404,616,28,644
公投第１５案,桃園市,大溪區,仁善里,552,1308,253,478,731,34,765
公投第１５案,桃園市,大溪區,仁美里,553,1094,198,350,548,69,617
公投第１５案,桃園市,大溪區,仁美里,554,2153,343,738,1081,65,1146
公投第１５案,桃園市,大溪區,僑愛里,555,1173,147,496,643,36,679
公投第１５案,桃園市,大溪區,僑愛里,556,1369,183,497,680,25,705
公投第１５案,桃園市,大溪區,仁義里,557,1446,203,475,678,65,743
公投第１５案,桃園市,大溪區,仁義里,558,1406,141,430,571,45,616
公投第１５案,桃園市,大溪區,仁和里,559,1592,244,591,835,27,862
公投第１５案,桃園市,大溪區,仁和里,560,1497,248,543,791,62,853
公投第１５案,桃園市,大溪區,仁和里,561,1559,271,563,834,54,888
公投第１５案,桃園市,大溪區,仁愛里,562,1684,264,569,833,23,856
公投第１５案,桃園市,大溪區,仁愛里,563,1959,312,699,1011,73,1084
公投第１５案,桃園市,大溪區,仁愛里,564,1369,218,503,721,63,784
公投第１５案,桃園市,大溪區,仁武里,565,1431,248,506,754,49,803
公投第１５案,桃園市,大溪區,仁武里,566,1657,185,457,642,27,669
公投第１５案,桃園市,大溪區,仁文里,567,1387,190,390,580,29,609
公投第１５案,桃園市,大溪區,仁文里,568,1085,183,349,532,37,569
公投第１５案,桃園市,大溪區,仁文里,569,1403,244,509,753,51,804
公投第１５案,桃園市,大溪區,南興里,570,1511,240,480,720,64,784
公投第１５案,桃園市,大溪區,南興里,571,1719,260,457,717,81,798
公投第１５案,桃園市,大溪區,南興里,572,1717,202,506,708,84,792
公投第１５案,桃園市,大溪區,光明里,573,1207,192,398,590,62,652
公投第１５案,桃園市,大溪區,光明里,574,1188,164,447,611,63,674
公投第１５案,桃園市,大溪區,員林里,575,1514,235,472,707,25,732
公投第１５案,桃園市,大溪區,三元里,576,1529,247,535,782,74,856
公投第１５案,桃園市,大溪區,三元里,577,1260,211,495,706,37,743
公投第１５案,桃園市,大溪區,瑞源里,578,831,139,327,466,15,481
公投第１５案,桃園市,大溪區,瑞源里,579,1407,229,505,734,49,783
公投第１５案,桃園市,大溪區,瑞源里,580,1494,217,481,698,47,745
公投第１５案,桃園市,復興區,三民里,581,1991,210,824,1034,82,1116
公投第１５案,桃園市,復興區,澤仁里,582,1392,142,606,748,52,800
公投第１５案,桃園市,復興區,霞雲里,583,564,67,229,296,18,314
公投第１５案,桃園市,復興區,義盛里,584,716,82,290,372,18,390
公投第１５案,桃園市,復興區,羅浮里,585,1016,134,466,600,44,644
公投第１５案,桃園市,復興區,長興里,586,669,90,202,292,14,306
公投第１５案,桃園市,復興區,奎輝里,587,760,72,300,372,13,385
公投第１５案,桃園市,復興區,高義里,588,751,57,343,400,16,416
公投第１５案,桃園市,復興區,三光里,589,683,41,218,259,6,265
公投第１５案,桃園市,復興區,華陵里,590,1224,89,563,652,31,683
公投第１５案,桃園市,中壢區,後寮里,591,1401,236,471,707,36,743
公投第１５案,桃園市,中壢區,後寮里,592,1798,296,562,858,42,900
公投第１５案,桃園市,中壢區,後寮里,593,1642,265,479,744,29,773
公投第１５案,桃園市,中壢區,明德里,594,1670,296,553,849,40,889
公投第１５案,桃園市,中壢區,明德里,595,1456,273,504,777,23,800
公投第１５案,桃園市,中壢區,明德里,596,1531,296,609,905,25,930
公投第１５案,桃園市,中壢區,至善里,597,1623,259,646,905,33,938
公投第１５案,桃園市,中壢區,至善里,598,1953,239,630,869,27,896
公投第１５案,桃園市,中壢區,龍慈里,599,1155,197,440,637,22,659
公投第１５案,桃園市,中壢區,龍慈里,600,1800,238,570,808,30,838
公投第１５案,桃園市,中壢區,龍慈里,601,1757,259,565,824,23,847
公投第１５案,桃園市,中壢區,龍興里,602,1281,215,510,725,36,761
公投第１５案,桃園市,中壢區,龍興里,603,1462,249,561,810,23,833
公投第１５案,桃園市,中壢區,龍興里,604,1560,200,525,725,48,773
公投第１５案,桃園市,中壢區,龍德里,605,1602,289,621,910,26,936
公投第１５案,桃園市,中壢區,龍德里,606,1006,161,458,619,26,645
公投第１５案,桃園市,中壢區,龍德里,607,1474,241,574,815,22,837
公投第１５案,桃園市,中壢區,龍岡里,608,1627,216,593,809,77,886
公投第１５案,桃園市,中壢區,龍岡里,609,1519,252,571,823,36,859
公投第１５案,桃園市,中壢區,龍岡里,610,1526,210,575,785,55,840
公投第１５案,桃園市,中壢區,龍東里,611,1618,207,600,807,66,873
公投第１５案,桃園市,中壢區,龍東里,612,1554,245,605,850,56,906
公投第１５案,桃園市,中壢區,龍東里,613,1706,223,636,859,64,923
公投第１５案,桃園市,中壢區,龍昌里,614,1818,306,689,995,42,1037
公投第１５案,桃園市,中壢區,龍昌里,615,1991,295,661,956,38,994
公投第１５案,桃園市,中壢區,龍昌里,616,1609,240,589,829,34,863
公投第１５案,桃園市,中壢區,龍平里,617,1329,159,466,625,27,652
公投第１５案,桃園市,中壢區,龍平里,618,1587,219,520,739,65,804
公投第１５案,桃園市,中壢區,仁美里,619,1955,289,678,967,30,997
公投第１５案,桃園市,中壢區,仁美里,620,1711,260,578,838,51,889
公投第１５案,桃園市,中壢區,仁美里,621,1712,249,581,830,49,879
公投第１５案,桃園市,中壢區,仁福里,622,1448,238,556,794,42,836
公投第１５案,桃園市,中壢區,仁福里,623,1605,253,538,791,42,833
公投第１５案,桃園市,中壢區,仁福里,624,1633,218,547,765,13,778
公投第１５案,桃園市,中壢區,華愛里,625,1795,305,662,967,49,1016
公投第１５案,桃園市,中壢區,華愛里,626,1689,239,654,893,21,914
公投第１５案,桃園市,中壢區,普仁里,627,1201,208,438,646,25,671
公投第１５案,桃園市,中壢區,普仁里,628,1353,257,445,702,25,727
公投第１５案,桃園市,中壢區,普仁里,629,1587,252,522,774,25,799
公投第１５案,桃園市,中壢區,普忠里,630,1883,311,656,967,37,1004
公投第１５案,桃園市,中壢區,普忠里,631,1448,245,482,727,23,750
公投第１５案,桃園市,中壢區,普強里,632,1810,312,595,907,35,942
公投第１５案,桃園市,中壢區,普強里,633,1916,322,616,938,41,979
公投第１５案,桃園市,中壢區,普慶里,634,1177,200,455,655,23,678
公投第１５案,桃園市,中壢區,普慶里,635,1410,272,540,812,30,842
公投第１５案,桃園市,中壢區,信義里,636,1368,237,458,695,25,720
公投第１５案,桃園市,中壢區,信義里,637,1424,246,567,813,38,851
公投第１５案,桃園市,中壢區,信義里,638,1573,294,557,851,28,879
公投第１５案,桃園市,中壢區,正義里,639,1152,225,420,645,17,662
公投第１５案,桃園市,中壢區,正義里,640,1178,212,439,651,11,662
公投第１５案,桃園市,中壢區,正義里,641,1966,328,678,1006,38,1044
公投第１５案,桃園市,中壢區,普義里,642,3474,250,441,691,23,714
公投第１５案,桃園市,中壢區,普義里,643,2099,406,679,1085,44,1129
公投第１５案,桃園市,中壢區,德義里,644,1178,301,331,632,31,663
公投第１５案,桃園市,中壢區,德義里,645,1397,296,519,815,40,855
公投第１５案,桃園市,中壢區,仁義里,646,1669,310,578,888,38,926
公投第１５案,桃園市,中壢區,仁義里,647,2087,323,661,984,41,1025
公投第１５案,桃園市,中壢區,忠義里,648,1900,311,626,937,38,975
公投第１５案,桃園市,中壢區,忠義里,649,1640,256,449,705,18,723
公投第１５案,桃園市,中壢區,龍安里,650,994,177,389,566,24,590
公投第１５案,桃園市,中壢區,龍安里,651,1131,191,497,688,39,727
公投第１５案,桃園市,中壢區,仁愛里,652,1625,330,599,929,26,955
公投第１５案,桃園市,中壢區,仁愛里,653,1384,284,549,833,28,861
公投第１５案,桃園市,中壢區,仁德里,654,1588,254,566,820,34,854
公投第１５案,桃園市,中壢區,仁德里,655,1445,190,546,736,51,787
公投第１５案,桃園市,中壢區,仁和里,656,1743,203,569,772,34,806
公投第１５案,桃園市,中壢區,仁和里,657,1812,255,589,844,20,864
公投第１５案,桃園市,中壢區,仁祥里,658,1546,236,514,750,38,788
公投第１５案,桃園市,中壢區,仁祥里,659,1290,195,455,650,37,687
公投第１５案,桃園市,中壢區,華勛里,660,2145,271,706,977,69,1046
公投第１５案,桃園市,中壢區,華勛里,661,1451,226,462,688,31,719
公投第１５案,桃園市,中壢區,中堅里,662,1489,221,514,735,41,776
公投第１５案,桃園市,中壢區,中堅里,663,827,156,282,438,23,461
公投第１５案,桃園市,中壢區,中堅里,664,1442,220,501,721,26,747
公投第１５案,桃園市,中壢區,興仁里,665,1842,286,566,852,19,871
公投第１５案,桃園市,中壢區,興仁里,666,1520,237,481,718,29,747
公投第１５案,桃園市,中壢區,中正里,667,1764,531,255,786,39,825
公投第１５案,桃園市,中壢區,中正里,668,1488,250,557,807,16,823
公投第１５案,桃園市,中壢區,中正里,669,1593,258,560,818,30,848
公投第１５案,桃園市,中壢區,中山里,670,1505,333,444,777,23,800
公投第１５案,桃園市,中壢區,中山里,671,1661,250,597,847,19,866
公投第１５案,桃園市,中壢區,中山里,672,1492,238,554,792,27,819
公投第１５案,桃園市,中壢區,篤行里,673,1249,192,399,591,26,617
公投第１５案,桃園市,中壢區,篤行里,674,1257,217,458,675,25,700
公投第１５案,桃園市,中壢區,自強里,675,1659,271,546,817,48,865
公投第１５案,桃園市,中壢區,自強里,676,1815,335,627,962,26,988
公投第１５案,桃園市,中壢區,中興里,677,1702,282,553,835,28,863
公投第１５案,桃園市,中壢區,中興里,678,1541,284,522,806,19,825
公投第１５案,桃園市,中壢區,自立里,679,1659,233,545,778,41,819
公投第１５案,桃園市,中壢區,自立里,680,1874,246,659,905,67,972
公投第１５案,桃園市,中壢區,自立里,681,1603,191,574,765,36,801
公投第１５案,桃園市,中壢區,自信里,682,1735,290,555,845,39,884
公投第１５案,桃園市,中壢區,自信里,683,1815,314,585,899,21,920
公投第１５案,桃園市,中壢區,自信里,684,1873,393,594,987,26,1013
公投第１５案,桃園市,中壢區,莊敬里,685,1739,249,662,911,56,967
公投第１５案,桃園市,中壢區,莊敬里,686,1709,265,542,807,37,844
公投第１５案,桃園市,中壢區,自治里,687,1655,277,597,874,38,912
公投第１５案,桃園市,中壢區,自治里,688,1664,227,631,858,31,889
公投第１５案,桃園市,中壢區,內壢里,689,1087,151,387,538,21,559
公投第１５案,桃園市,中壢區,內壢里,690,1065,179,381,560,39,599
公投第１５案,桃園市,中壢區,成功里,691,1844,300,634,934,57,991
公投第１５案,桃園市,中壢區,成功里,692,1220,167,382,549,31,580
公投第１５案,桃園市,中壢區,成功里,693,1219,227,400,627,30,657
公投第１５案,桃園市,中壢區,福德里,694,1260,216,440,656,39,695
公投第１５案,桃園市,中壢區,福德里,695,1594,279,601,880,47,927
公投第１５案,桃園市,中壢區,中原里,696,1733,329,548,877,66,943
公投第１５案,桃園市,中壢區,中原里,697,1979,336,664,1000,41,1041
公投第１５案,桃園市,中壢區,忠孝里,698,1621,325,534,859,23,882
公投第１５案,桃園市,中壢區,忠孝里,699,1391,247,508,755,31,786
公投第１５案,桃園市,中壢區,忠孝里,700,1531,280,555,835,16,851
公投第１５案,桃園市,中壢區,復興里,701,1943,258,646,904,35,939
公投第１５案,桃園市,中壢區,復興里,702,1363,223,474,697,17,714
公投第１５案,桃園市,中壢區,復興里,703,2172,321,615,936,41,977
公投第１５案,桃園市,中壢區,復興里,704,1798,241,601,842,37,879
公投第１５案,桃園市,中壢區,復興里,705,1671,230,580,810,18,828
公投第１５案,桃園市,中壢區,復華里,706,1969,302,622,924,61,985
公投第１５案,桃園市,中壢區,復華里,707,1563,295,641,936,48,984
公投第１５案,桃園市,中壢區,復華里,708,1762,314,632,946,32,978
公投第１５案,桃園市,中壢區,文化里,709,1923,245,436,681,34,715
公投第１５案,桃園市,中壢區,文化里,710,1572,290,559,849,52,901
公投第１５案,桃園市,中壢區,文化里,711,1850,304,683,987,27,1014
公投第１５案,桃園市,中壢區,文化里,712,1583,268,510,778,44,822
公投第１５案,桃園市,中壢區,文化里,713,1735,306,548,854,41,895
公投第１５案,桃園市,中壢區,和平里,714,1292,209,449,658,29,687
公投第１５案,桃園市,中壢區,和平里,715,1265,217,449,666,19,685
公投第１５案,桃園市,中壢區,內定里,716,1798,272,620,892,38,930
公投第１５案,桃園市,中壢區,內定里,717,1822,294,699,993,49,1042
公投第１５案,桃園市,中壢區,內定里,718,1613,263,569,832,28,860
公投第１５案,桃園市,中壢區,內定里,719,1405,281,441,722,36,758
公投第１５案,桃園市,中壢區,石頭里,720,1730,319,603,922,62,984
公投第１５案,桃園市,中壢區,中央里,721,1384,273,525,798,34,832
公投第１５案,桃園市,中壢區,中央里,722,1122,222,400,622,12,634
公投第１５案,桃園市,中壢區,中央里,723,992,212,354,566,38,604
公投第１５案,桃園市,中壢區,新興里,724,1820,322,590,912,33,945
公投第１５案,桃園市,中壢區,新興里,725,1847,293,603,896,46,942
公投第１５案,桃園市,中壢區,林森里,726,1302,202,516,718,43,761
公投第１５案,桃園市,中壢區,林森里,727,1203,224,431,655,42,697
公投第１５案,桃園市,中壢區,林森里,728,1226,252,498,750,40,790
公投第１５案,桃園市,中壢區,振興里,729,1234,234,469,703,31,734
公投第１５案,桃園市,中壢區,振興里,730,2023,278,628,906,46,952
公投第１５案,桃園市,中壢區,振興里,731,1555,232,482,714,28,742
公投第１５案,桃園市,中壢區,東興里,732,1951,339,600,939,40,979
公投第１５案,桃園市,中壢區,東興里,733,1383,254,480,734,36,770
公投第１５案,桃園市,中壢區,健行里,734,1164,198,472,670,36,706
公投第１５案,桃園市,中壢區,健行里,735,1482,254,533,787,26,813
公投第１５案,桃園市,中壢區,健行里,736,1770,266,648,914,39,953
公投第１５案,桃園市,中壢區,水尾里,737,1703,310,612,922,63,985
公投第１５案,桃園市,中壢區,水尾里,738,1841,283,630,913,43,956
公投第１５案,桃園市,中壢區,金華里,739,1941,389,645,1034,32,1066
公投第１５案,桃園市,中壢區,金華里,740,2029,373,711,1084,33,1117
公投第１５案,桃園市,中壢區,忠福里,741,1636,284,624,908,23,931
公投第１５案,桃園市,中壢區,忠福里,742,1528,244,596,840,34,874
公投第１５案,桃園市,中壢區,忠福里,743,2289,354,692,1046,57,1103
公投第１５案,桃園市,中壢區,忠福里,744,2020,357,613,970,27,997
公投第１５案,桃園市,中壢區,幸福里,745,2027,346,700,1046,26,1072
公投第１５案,桃園市,中壢區,幸福里,746,1883,297,516,813,21,834
公投第１５案,桃園市,中壢區,幸福里,747,2080,339,650,989,35,1024
公投第１５案,桃園市,中壢區,永福里,748,646,124,215,339,12,351
公投第１５案,桃園市,中壢區,永福里,749,1780,325,749,1074,42,1116
公投第１５案,桃園市,中壢區,永福里,750,1372,205,562,767,24,791
公投第１５案,桃園市,中壢區,永福里,751,1668,300,629,929,32,961
公投第１５案,桃園市,中壢區,青埔里,752,1987,351,616,967,27,994
公投第１５案,桃園市,中壢區,青埔里,753,1520,258,540,798,20,818
公投第１５案,桃園市,中壢區,新街里,754,852,154,285,439,28,467
公投第１５案,桃園市,中壢區,新街里,755,1209,261,386,647,23,670
公投第１５案,桃園市,中壢區,興南里,756,1481,257,491,748,55,803
公投第１５案,桃園市,中壢區,興南里,757,1564,259,473,732,16,748
公投第１５案,桃園市,中壢區,興國里,758,1957,341,664,1005,51,1056
公投第１５案,桃園市,中壢區,興平里,759,1223,247,441,688,41,729
公投第１５案,桃園市,中壢區,興平里,760,1182,232,432,664,29,693
公投第１５案,桃園市,中壢區,興和里,761,1066,190,409,599,31,630
公投第１５案,桃園市,中壢區,興和里,762,1701,296,650,946,37,983
公投第１５案,桃園市,中壢區,永興里,763,943,164,313,477,29,506
公投第１５案,桃園市,中壢區,中壢里,764,731,149,268,417,25,442
公投第１５案,桃園市,中壢區,中榮里,765,851,166,287,453,38,491
公投第１５案,桃園市,中壢區,中建里,766,1011,205,318,523,32,555
公投第１５案,桃園市,中壢區,舊明里,767,1532,291,550,841,37,878
公投第１５案,桃園市,中壢區,新明里,768,1028,184,344,528,32,560
公投第１５案,桃園市,中壢區,新明里,769,1157,314,317,631,43,674
公投第１５案,桃園市,中壢區,新明里,770,1591,295,511,806,43,849
公投第１５案,桃園市,中壢區,光明里,771,2156,316,661,977,50,1027
公投第１５案,桃園市,中壢區,光明里,772,1479,223,458,681,27,708
公投第１５案,桃園市,中壢區,光明里,773,1780,325,582,907,32,939
公投第１５案,桃園市,中壢區,永光里,774,1651,279,559,838,55,893
公投第１５案,桃園市,中壢區,永光里,775,1870,379,604,983,27,1010
公投第１５案,桃園市,中壢區,永光里,776,1913,303,557,860,18,878
公投第１５案,桃園市,中壢區,三民里,777,1609,220,495,715,32,747
公投第１５案,桃園市,中壢區,三民里,778,1539,248,507,755,27,782
公投第１５案,桃園市,中壢區,五權里,779,1426,246,499,745,21,766
公投第１５案,桃園市,中壢區,五權里,780,1618,255,489,744,42,786
公投第１５案,桃園市,中壢區,五權里,781,1441,229,519,748,36,784
公投第１５案,桃園市,中壢區,五權里,782,1528,298,515,813,28,841
公投第１５案,桃園市,中壢區,五福里,783,1683,283,572,855,51,906
公投第１５案,桃園市,中壢區,五福里,784,1945,339,676,1015,59,1074
公投第１５案,桃園市,中壢區,芝芭里,785,1534,235,519,754,54,808
公投第１５案,桃園市,中壢區,芝芭里,786,1810,183,683,866,47,913
公投第１５案,桃園市,中壢區,洽溪里,787,1097,195,330,525,37,562
公投第１５案,桃園市,中壢區,洽溪里,788,1917,351,556,907,24,931
公投第１５案,桃園市,中壢區,洽溪里,789,1858,360,568,928,48,976
公投第１５案,桃園市,中壢區,內厝里,790,1576,411,434,845,36,881
公投第１５案,桃園市,中壢區,內厝里,791,1478,260,515,775,53,828
公投第１５案,桃園市,中壢區,內厝里,792,1589,296,517,813,28,841
公投第１５案,桃園市,中壢區,月眉里,793,2037,357,687,1044,79,1123
公投第１５案,桃園市,中壢區,月眉里,794,1158,234,433,667,33,700
公投第１５案,桃園市,中壢區,月眉里,795,1967,306,688,994,75,1069
公投第１５案,桃園市,中壢區,山東里,796,1830,285,580,865,62,927
公投第１５案,桃園市,中壢區,山東里,797,1856,294,659,953,31,984
公投第１５案,桃園市,中壢區,過嶺里,798,2068,310,665,975,63,1038
公投第１５案,桃園市,中壢區,過嶺里,799,2152,292,561,853,38,891
公投第１５案,桃園市,中壢區,過嶺里,800,2158,365,580,945,44,989
公投第１５案,桃園市,平鎮區,平鎮里,801,1487,228,485,713,46,759
公投第１５案,桃園市,平鎮區,平鎮里,802,1453,213,508,721,43,764
公投第１５案,桃園市,平鎮區,平鎮里,803,1491,238,533,771,39,810
公投第１５案,桃園市,平鎮區,鎮興里,804,1346,214,446,660,44,704
公投第１５案,桃園市,平鎮區,鎮興里,805,1660,252,573,825,25,850
公投第１５案,桃園市,平鎮區,南勢里,806,1921,419,502,921,30,951
公投第１５案,桃園市,平鎮區,南勢里,807,1974,310,720,1030,38,1068
公投第１５案,桃園市,平鎮區,南勢里,808,1867,274,615,889,47,936
公投第１５案,桃園市,平鎮區,金星里,809,1786,257,645,902,29,931
公投第１５案,桃園市,平鎮區,金星里,810,1634,195,463,658,30,688
公投第１５案,桃園市,平鎮區,金星里,811,1080,170,409,579,26,605
公投第１５案,桃園市,平鎮區,金星里,812,1514,242,529,771,29,800
公投第１５案,桃園市,平鎮區,平安里,813,1918,268,574,842,41,883
公投第１５案,桃園市,平鎮區,平安里,814,1182,175,406,581,78,659
公投第１５案,桃園市,平鎮區,平安里,815,1667,233,543,776,29,805
公投第１５案,桃園市,平鎮區,平南里,816,1640,228,502,730,32,762
公投第１５案,桃園市,平鎮區,平南里,817,1603,253,549,802,24,826
公投第１５案,桃園市,平鎮區,平南里,818,1556,236,620,856,18,874
公投第１５案,桃園市,平鎮區,平南里,819,1697,239,586,825,30,855
公投第１５案,桃園市,平鎮區,山峰里,820,1130,154,405,559,13,572
公投第１５案,桃園市,平鎮區,山峰里,821,1196,185,438,623,25,648
公投第１５案,桃園市,平鎮區,福林里,822,1685,255,600,855,31,886
公投第１５案,桃園市,平鎮區,福林里,823,1532,255,576,831,30,861
公投第１５案,桃園市,平鎮區,湧光里,824,1564,238,550,788,35,823
公投第１５案,桃園市,平鎮區,湧光里,825,1824,203,545,748,43,791
公投第１５案,桃園市,平鎮區,湧光里,826,1912,289,632,921,28,949
公投第１５案,桃園市,平鎮區,莊敬里,827,1048,143,376,519,48,567
公投第１５案,桃園市,平鎮區,莊敬里,828,1259,198,465,663,39,702
公投第１５案,桃園市,平鎮區,莊敬里,829,1061,158,384,542,23,565
公投第１５案,桃園市,平鎮區,莊敬里,830,1072,160,452,612,28,640
公投第１５案,桃園市,平鎮區,湧豐里,831,1788,254,625,879,48,927
公投第１５案,桃園市,平鎮區,湧安里,832,1510,221,544,765,33,798
公投第１５案,桃園市,平鎮區,湧安里,833,1403,213,487,700,41,741
公投第１５案,桃園市,平鎮區,湧安里,834,1407,220,495,715,50,765
公投第１５案,桃園市,平鎮區,宋屋里,835,1901,415,561,976,40,1016
公投第１５案,桃園市,平鎮區,宋屋里,836,1994,272,622,894,16,910
公投第１５案,桃園市,平鎮區,平興里,837,1730,288,582,870,36,906
公投第１５案,桃園市,平鎮區,平興里,838,1905,343,635,978,32,1010
公投第１５案,桃園市,平鎮區,平興里,839,1723,303,625,928,17,945
公投第１５案,桃園市,平鎮區,廣興里,840,1307,200,483,683,47,730
公投第１５案,桃園市,平鎮區,廣興里,841,1337,229,491,720,31,751
公投第１５案,桃園市,平鎮區,廣興里,842,980,211,404,615,24,639
公投第１５案,桃園市,平鎮區,廣興里,843,1818,293,594,887,48,935
公投第１５案,桃園市,平鎮區,廣達里,844,1463,275,501,776,31,807
公投第１５案,桃園市,平鎮區,廣達里,845,1213,231,453,684,29,713
公投第１５案,桃園市,平鎮區,廣達里,846,1085,203,407,610,25,635
公投第１５案,桃園市,平鎮區,廣仁里,847,1458,182,528,710,28,738
公投第１５案,桃園市,平鎮區,廣仁里,848,1408,209,521,730,52,782
公投第１５案,桃園市,平鎮區,廣仁里,849,1396,228,449,677,41,718
公投第１５案,桃園市,平鎮區,復旦里,850,1044,234,412,646,24,670
公投第１５案,桃園市,平鎮區,復旦里,851,1124,217,397,614,16,630
公投第１５案,桃園市,平鎮區,復旦里,852,1517,288,518,806,21,827
公投第１５案,桃園市,平鎮區,復旦里,853,1571,306,512,818,16,834
公投第１５案,桃園市,平鎮區,復興里,854,1752,330,630,960,30,990
公投第１５案,桃園市,平鎮區,復興里,855,1434,280,556,836,33,869
公投第１５案,桃園市,平鎮區,復興里,856,1710,335,623,958,28,986
公投第１５案,桃園市,平鎮區,義民里,857,1555,291,561,852,26,878
公投第１５案,桃園市,平鎮區,義民里,858,2051,324,625,949,33,982
公投第１５案,桃園市,平鎮區,義民里,859,1477,265,502,767,20,787
公投第１５案,桃園市,平鎮區,義興里,860,1501,254,536,790,22,812
公投第１５案,桃園市,平鎮區,義興里,861,1405,248,488,736,47,783
公投第１５案,桃園市,平鎮區,義興里,862,1656,252,569,821,52,873
公投第１５案,桃園市,平鎮區,義興里,863,1921,304,565,869,25,894
公投第１５案,桃園市,平鎮區,雙連里,864,1717,254,561,815,23,838
公投第１５案,桃園市,平鎮區,雙連里,865,1319,240,446,686,35,721
公投第１５案,桃園市,平鎮區,雙連里,866,1745,302,570,872,34,906
公投第１５案,桃園市,平鎮區,高雙里,867,1721,296,609,905,38,943
公投第１５案,桃園市,平鎮區,高雙里,868,1206,220,430,650,22,672
公投第１５案,桃園市,平鎮區,高雙里,869,1202,280,485,765,18,783
公投第１５案,桃園市,平鎮區,北勢里,870,1208,209,463,672,33,705
公投第１５案,桃園市,平鎮區,北勢里,871,1267,226,513,739,15,754
公投第１５案,桃園市,平鎮區,北華里,872,1094,197,393,590,20,610
公投第１５案,桃園市,平鎮區,北華里,873,1394,276,503,779,42,821
公投第１５案,桃園市,平鎮區,北華里,874,1215,285,452,737,13,750
公投第１５案,桃園市,平鎮區,新勢里,875,1010,189,363,552,33,585
公投第１５案,桃園市,平鎮區,新勢里,876,1261,228,468,696,24,720
公投第１５案,桃園市,平鎮區,新勢里,877,1314,214,536,750,26,776
公投第１５案,桃園市,平鎮區,北安里,878,722,122,265,387,34,421
公投第１５案,桃園市,平鎮區,北安里,879,839,151,276,427,21,448
公投第１５案,桃園市,平鎮區,新榮里,880,1399,240,505,745,28,773
公投第１５案,桃園市,平鎮區,新榮里,881,1968,353,595,948,43,991
公投第１５案,桃園市,平鎮區,新榮里,882,1672,276,591,867,30,897
公投第１５案,桃園市,平鎮區,新富里,883,2213,205,421,626,26,652
公投第１５案,桃園市,平鎮區,新富里,884,949,215,362,577,16,593
公投第１５案,桃園市,平鎮區,新富里,885,1621,336,601,937,30,967
公投第１５案,桃園市,平鎮區,新富里,886,1643,293,522,815,15,830
公投第１５案,桃園市,平鎮區,新英里,887,1844,360,620,980,32,1012
公投第１５案,桃園市,平鎮區,新英里,888,1752,316,600,916,32,948
公投第１５案,桃園市,平鎮區,新貴里,889,1577,249,506,755,35,790
公投第１５案,桃園市,平鎮區,新貴里,890,1517,266,558,824,25,849
公投第１５案,桃園市,平鎮區,北興里,891,1039,192,399,591,23,614
公投第１５案,桃園市,平鎮區,北興里,892,1318,226,519,745,32,777
公投第１５案,桃園市,平鎮區,北興里,893,1636,244,590,834,42,876
公投第１５案,桃園市,平鎮區,金陵里,894,1316,243,471,714,31,745
公投第１５案,桃園市,平鎮區,金陵里,895,1474,241,563,804,16,820
公投第１５案,桃園市,平鎮區,北貴里,896,1480,206,463,669,47,716
公投第１５案,桃園市,平鎮區,北貴里,897,1330,205,491,696,19,715
公投第１５案,桃園市,平鎮區,北貴里,898,1228,196,455,651,30,681
公投第１５案,桃園市,平鎮區,北富里,899,1377,280,504,784,30,814
公投第１５案,桃園市,平鎮區,北富里,900,1198,234,472,706,25,731
公投第１５案,桃園市,平鎮區,北富里,901,1231,218,503,721,30,751
公投第１５案,桃園市,平鎮區,建安里,902,1243,225,425,650,64,714
公投第１５案,桃園市,平鎮區,建安里,903,1590,243,539,782,59,841
公投第１５案,桃園市,平鎮區,建安里,904,1366,210,490,700,37,737
公投第１５案,桃園市,平鎮區,華安里,905,1332,198,486,684,37,721
公投第１５案,桃園市,平鎮區,華安里,906,1201,169,392,561,20,581
公投第１５案,桃園市,平鎮區,華安里,907,1668,235,515,750,29,779
公投第１５案,桃園市,平鎮區,東安里,908,1351,190,462,652,52,704
公投第１５案,桃園市,平鎮區,東安里,909,1460,183,492,675,27,702
公投第１５案,桃園市,平鎮區,新安里,910,1841,259,634,893,31,924
公投第１５案,桃園市,平鎮區,新安里,911,1475,234,469,703,16,719
公投第１５案,桃園市,平鎮區,新安里,912,1011,154,383,537,22,559
公投第１５案,桃園市,平鎮區,東勢里,913,1052,142,337,479,38,517
公投第１５案,桃園市,平鎮區,東勢里,914,1154,216,441,657,49,706
公投第１５案,桃園市,平鎮區,東勢里,915,1645,251,551,802,21,823
公投第１５案,桃園市,平鎮區,東勢里,916,1539,216,479,695,79,774
公投第１５案,桃園市,平鎮區,龍恩里,917,1385,216,487,703,49,752
公投第１５案,桃園市,平鎮區,龍恩里,918,1395,210,506,716,29,745
公投第１５案,桃園市,平鎮區,東社里,919,1711,225,620,845,28,873
公投第１５案,桃園市,平鎮區,東社里,920,1631,234,560,794,42,836
公投第１５案,桃園市,平鎮區,忠貞里,921,1110,203,396,599,19,618
公投第１５案,桃園市,平鎮區,貿易里,922,1931,259,762,1021,38,1059
公投第１５案,桃園市,平鎮區,龍興里,923,1127,180,408,588,35,623
公投第１５案,桃園市,平鎮區,龍興里,924,1414,204,527,731,48,779
公投第１５案,桃園市,平鎮區,中正里,925,1609,230,597,827,26,853
公投第１５案,桃園市,楊梅區,仁美里,926,1269,187,468,655,53,708
公投第１５案,桃園市,楊梅區,仁美里,927,1246,190,537,727,43,770
公投第１５案,桃園市,楊梅區,仁美里,928,1408,218,563,781,40,821
公投第１５案,桃園市,楊梅區,埔心里,929,1434,225,536,761,45,806
公投第１５案,桃園市,楊梅區,光華里,930,1515,208,525,733,53,786
公投第１５案,桃園市,楊梅區,光華里,931,1657,206,562,768,46,814
公投第１５案,桃園市,楊梅區,金龍里,932,1137,165,461,626,34,660
公投第１５案,桃園市,楊梅區,四維里,933,2211,323,742,1065,38,1103
公投第１５案,桃園市,楊梅區,四維里,934,2008,298,692,990,23,1013
公投第１５案,桃園市,楊梅區,永平里,935,1911,318,657,975,29,1004
公投第１５案,桃園市,楊梅區,瑞塘里,936,1449,244,524,768,49,817
公投第１５案,桃園市,楊梅區,瑞塘里,937,1877,267,551,818,48,866
公投第１５案,桃園市,楊梅區,瑞塘里,938,1988,271,655,926,32,958
公投第１５案,桃園市,楊梅區,瑞坪里,939,1931,315,751,1066,29,1095
公投第１５案,桃園市,楊梅區,瑞坪里,940,1938,356,650,1006,48,1054
公投第１５案,桃園市,楊梅區,瑞坪里,941,1677,246,615,861,22,883
公投第１５案,桃園市,楊梅區,梅溪里,942,1848,286,614,900,13,913
公投第１５案,桃園市,楊梅區,梅溪里,943,1882,316,636,952,26,978
公投第１５案,桃園市,楊梅區,瑞溪里,944,1541,195,417,612,18,630
公投第１５案,桃園市,楊梅區,瑞溪里,945,1938,281,624,905,40,945
公投第１５案,桃園市,楊梅區,金溪里,946,1562,214,500,714,12,726
公投第１５案,桃園市,楊梅區,金溪里,947,2125,432,714,1146,33,1179
公投第１５案,桃園市,楊梅區,三民里,948,1516,137,720,857,31,888
公投第１５案,桃園市,楊梅區,三民里,949,1807,248,623,871,28,899
公投第１５案,桃園市,楊梅區,楊明里,950,2101,316,657,973,28,1001
公投第１５案,桃園市,楊梅區,楊明里,951,2054,339,669,1008,42,1050
公投第１５案,桃園市,楊梅區,楊明里,952,2226,304,714,1018,17,1035
公投第１５案,桃園市,楊梅區,裕成里,953,1405,222,533,755,12,767
公投第１５案,桃園市,楊梅區,裕成里,954,1843,294,556,850,27,877
公投第１５案,桃園市,楊梅區,裕新里,955,2324,296,695,991,40,1031
公投第１５案,桃園市,楊梅區,大同里,956,1713,291,606,897,24,921
公投第１５案,桃園市,楊梅區,大同里,957,1587,233,598,831,52,883
公投第１５案,桃園市,楊梅區,中山里,958,1416,251,535,786,22,808
公投第１５案,桃園市,楊梅區,中山里,959,1591,248,606,854,18,872
公投第１５案,桃園市,楊梅區,楊梅里,960,1943,275,684,959,44,1003
公投第１５案,桃園市,楊梅區,楊梅里,961,1762,281,630,911,34,945
公投第１５案,桃園市,楊梅區,楊江里,962,1083,167,395,562,27,589
公投第１５案,桃園市,楊梅區,梅新里,963,2027,287,711,998,54,1052
公投第１５案,桃園市,楊梅區,紅梅里,964,1274,468,206,674,55,729
公投第１５案,桃園市,楊梅區,紅梅里,965,1359,201,536,737,47,784
公投第１５案,桃園市,楊梅區,永寧里,966,2444,288,549,837,29,866
公投第１５案,桃園市,楊梅區,永寧里,967,2298,258,738,996,34,1030
公投第１５案,桃園市,楊梅區,永寧里,968,2222,292,763,1055,38,1093
公投第１５案,桃園市,楊梅區,大平里,969,1610,251,529,780,73,853
公投第１５案,桃園市,楊梅區,大平里,970,1627,250,545,795,72,867
公投第１５案,桃園市,楊梅區,秀才里,971,1589,309,509,818,50,868
公投第１５案,桃園市,楊梅區,秀才里,972,1758,271,611,882,55,937
公投第１５案,桃園市,楊梅區,東流里,973,1776,227,503,730,50,780
公投第１５案,桃園市,楊梅區,東流里,974,1000,159,311,470,23,493
公投第１５案,桃園市,楊梅區,豐野里,975,2290,281,693,974,68,1042
公投第１５案,桃園市,楊梅區,豐野里,976,1551,228,532,760,53,813
公投第１５案,桃園市,楊梅區,富岡里,977,1861,270,610,880,53,933
公投第１５案,桃園市,楊梅區,富豐里,978,1141,155,325,480,59,539
公投第１５案,桃園市,楊梅區,富豐里,979,1785,222,597,819,45,864
公投第１５案,桃園市,楊梅區,員本里,980,1498,204,534,738,62,800
公投第１５案,桃園市,楊梅區,員本里,981,1187,177,386,563,61,624
公投第１５案,桃園市,楊梅區,三湖里,982,1270,211,447,658,50,708
公投第１５案,桃園市,楊梅區,三湖里,983,1424,205,508,713,33,746
公投第１５案,桃園市,楊梅區,頭湖里,984,1273,245,510,755,19,774
公投第１５案,桃園市,楊梅區,頭湖里,985,1534,229,451,680,31,711
公投第１５案,桃園市,楊梅區,上湖里,986,1783,240,526,766,55,821
公投第１５案,桃園市,楊梅區,上湖里,987,1709,225,579,804,18,822
公投第１５案,桃園市,楊梅區,上湖里,988,1920,743,75,818,67,885
公投第１５案,桃園市,楊梅區,上田里,989,1194,193,426,619,29,648
公投第１５案,桃園市,楊梅區,上田里,990,1408,223,530,753,19,772
公投第１５案,桃園市,楊梅區,高山里,991,1737,220,531,751,27,778
公投第１５案,桃園市,楊梅區,高山里,992,1920,260,676,936,20,956
公投第１５案,桃園市,楊梅區,高上里,993,1234,209,404,613,33,646
公投第１５案,桃園市,楊梅區,高上里,994,1491,231,548,779,51,830
公投第１５案,桃園市,楊梅區,青山里,995,2020,282,631,913,39,952
公投第１５案,桃園市,楊梅區,青山里,996,1863,288,547,835,29,864
公投第１５案,桃園市,楊梅區,高榮里,997,1692,246,620,866,45,911
公投第１５案,桃園市,楊梅區,高榮里,998,1686,273,568,841,28,869
公投第１５案,桃園市,楊梅區,雙榮里,999,1626,269,551,820,68,888
公投第１５案,桃園市,楊梅區,雙榮里,1000,1557,259,575,834,27,861
公投第１５案,桃園市,楊梅區,新榮里,1001,1603,286,586,872,55,927
公投第１５案,桃園市,楊梅區,新榮里,1002,1889,270,598,868,62,930
公投第１５案,桃園市,楊梅區,水美里,1003,1448,220,648,868,30,898
公投第１５案,桃園市,楊梅區,水美里,1004,1351,196,525,721,42,763
公投第１５案,桃園市,楊梅區,水美里,1005,1313,212,505,717,46,763
公投第１５案,桃園市,楊梅區,瑞原里,1006,1689,236,597,833,49,882
公投第１５案,桃園市,楊梅區,瑞原里,1007,2063,278,668,946,34,980
公投第１５案,桃園市,龍潭區,黃唐里,1008,1482,199,536,735,28,763
公投第１５案,桃園市,龍潭區,黃唐里,1009,1528,247,486,733,38,771
公投第１５案,桃園市,龍潭區,黃唐里,1010,1503,231,517,748,45,793
公投第１５案,桃園市,龍潭區,永興里,1011,1568,234,514,748,46,794
公投第１５案,桃園市,龍潭區,永興里,1012,1216,168,404,572,59,631
公投第１５案,桃園市,龍潭區,中山里,1013,2088,297,576,873,76,949
公投第１５案,桃園市,龍潭區,中山里,1014,1987,290,752,1042,75,1117
公投第１５案,桃園市,龍潭區,中山里,1015,1586,352,526,878,41,919
公投第１５案,桃園市,龍潭區,烏樹林里,1016,1221,195,400,595,32,627
公投第１５案,桃園市,龍潭區,烏樹林里,1017,1134,170,438,608,42,650
公投第１５案,桃園市,龍潭區,烏林里,1018,2081,262,677,939,56,995
公投第１５案,桃園市,龍潭區,烏林里,1019,1925,257,620,877,37,914
公投第１５案,桃園市,龍潭區,百年里,1020,2095,331,776,1107,27,1134
公投第１５案,桃園市,龍潭區,百年里,1021,2040,347,774,1121,43,1164
公投第１５案,桃園市,龍潭區,凌雲里,1022,1790,267,561,828,54,882
公投第１５案,桃園市,龍潭區,凌雲里,1023,1872,292,651,943,75,1018
公投第１５案,桃園市,龍潭區,龍祥里,1024,1726,280,627,907,65,972
公投第１５案,桃園市,龍潭區,龍祥里,1025,1792,251,664,915,53,968
公投第１５案,桃園市,龍潭區,八德里,1026,1398,220,505,725,33,758
公投第１５案,桃園市,龍潭區,八德里,1027,1345,186,474,660,31,691
公投第１５案,桃園市,龍潭區,八德里,1028,1409,231,502,733,39,772
公投第１５案,桃園市,龍潭區,聖德里,1029,1362,233,416,649,16,665
公投第１５案,桃園市,龍潭區,聖德里,1030,1650,294,595,889,45,934
公投第１５案,桃園市,龍潭區,上林里,1031,1597,232,548,780,51,831
公投第１５案,桃園市,龍潭區,上林里,1032,1410,228,492,720,27,747
公投第１５案,桃園市,龍潭區,上林里,1033,1275,209,462,671,36,707
公投第１５案,桃園市,龍潭區,龍潭里,1034,1909,337,715,1052,60,1112
公投第１５案,桃園市,龍潭區,龍星里,1035,2024,298,761,1059,46,1105
公投第１５案,桃園市,龍潭區,龍星里,1036,2002,297,729,1026,52,1078
公投第１５案,桃園市,龍潭區,中正里,1037,1786,301,683,984,32,1016
公投第１５案,桃園市,龍潭區,中正里,1038,1756,292,571,863,37,900
公投第１５案,桃園市,龍潭區,中正里,1039,1830,291,703,994,28,1022
公投第１５案,桃園市,龍潭區,上華里,1040,1697,288,674,962,35,997
公投第１５案,桃園市,龍潭區,上華里,1041,1519,220,596,816,31,847
公投第１５案,桃園市,龍潭區,九龍里,1042,1805,246,594,840,52,892
公投第１５案,桃園市,龍潭區,九龍里,1043,1792,222,553,775,34,809
公投第１５案,桃園市,龍潭區,武漢里,1044,1500,208,612,820,61,881
公投第１５案,桃園市,龍潭區,祥和里,1045,1427,216,463,679,36,715
公投第１５案,桃園市,龍潭區,東興里,1046,1444,195,431,626,35,661
公投第１５案,桃園市,龍潭區,東興里,1047,1321,184,445,629,43,672
公投第１５案,桃園市,龍潭區,東興里,1048,1215,208,485,693,35,728
公投第１５案,桃園市,龍潭區,中興里,1049,1297,174,466,640,54,694
公投第１５案,桃園市,龍潭區,中興里,1050,1407,198,477,675,15,690
公投第１５案,桃園市,龍潭區,中興里,1051,1564,230,499,729,40,769
公投第１５案,桃園市,龍潭區,北興里,1052,1317,173,469,642,58,700
公投第１５案,桃園市,龍潭區,北興里,1053,1023,126,343,469,39,508
公投第１５案,桃園市,龍潭區,佳安里,1054,1721,250,641,891,45,936
公投第１５案,桃園市,龍潭區,佳安里,1055,1764,259,674,933,45,978
公投第１５案,桃園市,龍潭區,三坑里,1056,1499,210,560,770,53,823
公投第１５案,桃園市,龍潭區,大平里,1057,2151,276,689,965,48,1013
公投第１５案,桃園市,龍潭區,三林里,1058,1524,236,603,839,23,862
公投第１５案,桃園市,龍潭區,三林里,1059,1456,262,588,850,22,872
公投第１５案,桃園市,龍潭區,建林里,1060,1847,276,804,1080,28,1108
公投第１５案,桃園市,龍潭區,建林里,1061,1899,281,843,1124,21,1145
公投第１５案,桃園市,龍潭區,富林里,1062,1725,249,651,900,37,937
公投第１５案,桃園市,龍潭區,富林里,1063,1665,267,699,966,46,1012
公投第１５案,桃園市,龍潭區,高平里,1064,1649,254,540,794,36,830
公投第１５案,桃園市,龍潭區,高平里,1065,1539,202,500,702,46,748
公投第１５案,桃園市,龍潭區,高原里,1066,1541,263,575,838,48,886
公投第１５案,桃園市,龍潭區,高原里,1067,1375,242,472,714,40,754
公投第１５案,桃園市,龍潭區,高原里,1068,1453,239,510,749,30,779
公投第１５案,桃園市,龍潭區,三和里,1069,1074,188,378,566,43,609
公投第１５案,桃園市,龍潭區,三和里,1070,1299,252,491,743,16,759
公投第１５案,桃園市,龍潭區,三水里,1071,678,105,210,315,15,330
公投第１５案,桃園市,新屋區,新屋里,1072,1306,232,519,751,22,773
公投第１５案,桃園市,新屋區,新屋里,1073,1556,269,548,817,43,860
公投第１５案,桃園市,新屋區,新生里,1074,1849,213,747,960,56,1016
公投第１５案,桃園市,新屋區,新生里,1075,2096,383,778,1161,63,1224
公投第１５案,桃園市,新屋區,後湖里,1076,1517,211,533,744,54,798
公投第１５案,桃園市,新屋區,清華里,1077,2095,339,782,1121,63,1184
公投第１５案,桃園市,新屋區,清華里,1078,1856,265,551,816,47,863
公投第１５案,桃園市,新屋區,石磊里,1079,1986,306,744,1050,44,1094
公投第１５案,桃園市,新屋區,東明里,1080,1425,188,451,639,64,703
公投第１５案,桃園市,新屋區,社子里,1081,1385,192,461,653,30,683
公投第１５案,桃園市,新屋區,埔頂里,1082,1271,239,493,732,49,781
公投第１５案,桃園市,新屋區,埔頂里,1083,1271,192,454,646,36,682
公投第１５案,桃園市,新屋區,九斗里,1084,1234,211,457,668,40,708
公投第１５案,桃園市,新屋區,九斗里,1085,1085,188,367,555,52,607
公投第１５案,桃園市,新屋區,頭洲里,1086,1992,317,779,1096,42,1138
公投第１５案,桃園市,新屋區,頭洲里,1087,2032,340,777,1117,75,1192
公投第１５案,桃園市,新屋區,大坡里,1088,1291,197,455,652,57,709
公投第１５案,桃園市,新屋區,望間里,1089,1401,202,484,686,38,724
公投第１５案,桃園市,新屋區,後庄里,1090,1106,163,440,603,44,647
公投第１５案,桃園市,新屋區,蚵間里,1091,908,147,322,469,17,486
公投第１５案,桃園市,新屋區,深圳里,1092,663,122,255,377,31,408
公投第１５案,桃園市,新屋區,槺榔里,1093,1088,152,389,541,47,588
公投第１５案,桃園市,新屋區,笨港里,1094,1050,168,437,605,63,668
公投第１５案,桃園市,新屋區,永安里,1095,896,131,364,495,25,520
公投第１５案,桃園市,新屋區,永安里,1096,1369,230,538,768,52,820
公投第１５案,桃園市,新屋區,永興里,1097,995,121,333,454,47,501
公投第１５案,桃園市,新屋區,下埔里,1098,741,112,285,397,29,426
公投第１５案,桃園市,新屋區,石牌里,1099,943,174,354,528,54,582
公投第１５案,桃園市,新屋區,下田里,1100,1714,203,586,789,83,872
公投第１５案,桃園市,新屋區,赤欄里,1101,1340,201,519,720,27,747
公投第１５案,桃園市,觀音區,觀音里,1102,1371,196,432,628,40,668
公投第１５案,桃園市,觀音區,觀音里,1103,1362,186,374,560,26,586
公投第１５案,桃園市,觀音區,白玉里,1104,997,167,306,473,61,534
公投第１５案,桃園市,觀音區,廣興里,1105,1407,199,438,637,34,671
公投第１５案,桃園市,觀音區,大潭里,1106,1692,283,581,864,31,895
公投第１５案,桃園市,觀音區,保生里,1107,1279,179,455,634,32,666
公投第１５案,桃園市,觀音區,保生里,1108,791,132,270,402,13,415
公投第１５案,桃園市,觀音區,武威里,1109,892,149,329,478,28,506
公投第１５案,桃園市,觀音區,三和里,1110,886,140,363,503,29,532
公投第１５案,桃園市,觀音區,新興里,1111,712,111,247,358,39,397
公投第１５案,桃園市,觀音區,坑尾里,1112,1609,230,507,737,76,813
公投第１５案,桃園市,觀音區,金湖里,1113,1274,213,440,653,52,705
公投第１５案,桃園市,觀音區,金湖里,1114,1351,174,393,567,30,597
公投第１５案,桃園市,觀音區,藍埔里,1115,1262,239,445,684,43,727
公投第１５案,桃園市,觀音區,藍埔里,1116,1242,210,449,659,48,707
公投第１５案,桃園市,觀音區,大同里,1117,1461,252,469,721,51,772
公投第１５案,桃園市,觀音區,大同里,1118,1613,289,510,799,39,838
公投第１５案,桃園市,觀音區,大堀里,1119,1479,231,539,770,44,814
公投第１５案,桃園市,觀音區,崙坪里,1120,1552,223,450,673,62,735
公投第１５案,桃園市,觀音區,崙坪里,1121,1517,251,483,734,30,764
公投第１５案,桃園市,觀音區,崙坪里,1122,1691,274,517,791,45,836
公投第１５案,桃園市,觀音區,富源里,1123,1157,219,422,641,13,654
公投第１５案,桃園市,觀音區,富源里,1124,1455,228,473,701,47,748
公投第１５案,桃園市,觀音區,富源里,1125,1150,169,410,579,30,609
公投第１５案,桃園市,觀音區,上大里,1126,1112,187,390,577,49,626
公投第１５案,桃園市,觀音區,上大里,1127,1251,180,422,602,18,620
公投第１５案,桃園市,觀音區,新坡里,1128,1446,222,488,710,70,780
公投第１５案,桃園市,觀音區,新坡里,1129,1493,247,441,688,102,790
公投第１５案,桃園市,觀音區,廣福里,1130,1339,213,425,638,67,705
公投第１５案,桃園市,觀音區,廣福里,1131,1137,197,432,629,39,668
公投第１５案,桃園市,觀音區,塔腳里,1132,1043,142,349,491,38,529
公投第１５案,桃園市,觀音區,保障里,1133,993,159,276,435,28,463
公投第１５案,桃園市,觀音區,保障里,1134,975,156,312,468,26,494
公投第１５案,桃園市,觀音區,草漯里,1135,2029,282,500,782,37,819
公投第１５案,桃園市,觀音區,草新里,1136,1765,294,628,922,41,963
公投第１５案,桃園市,觀音區,草新里,1137,1809,287,599,886,34,920
公投第１５案,桃園市,觀音區,草新里,1138,1869,245,625,870,34,904
公投第１５案,桃園市,觀音區,樹林里,1139,1870,241,514,755,55,810
公投第１５案,桃園市,觀音區,樹林里,1140,1932,226,422,648,41,689
公投第１５案,桃園市,觀音區,富林里,1141,899,114,270,384,10,394
公投第１５案,桃園市,觀音區,富林里,1142,985,139,275,414,15,429
