公投案編號,縣市,行政區,村里,投開票所,投票權人數,同意票數,不同意票數,有效票數,無效票數,投票人數
公投第８案,連江縣,,,,11205,4705,769,5474,257,5731
公投第８案,金門縣,,,,122695,34139,6816,40955,2945,43900
公投第８案,宜蘭縣,,,,386089,148910,43259,192169,19570,211739
公投第８案,新竹縣,,,,445051,183636,50494,234130,15306,249436
公投第８案,苗栗縣,,,,461580,188547,53465,242012,19013,261025
公投第８案,彰化縣,,,,1066994,427390,128963,556353,52105,608458
公投第８案,南投縣,,,,427089,178821,46683,225504,19043,244547
公投第８案,雲林縣,,,,584480,201784,65207,266991,30111,297102
公投第８案,嘉義縣,,,,442775,145827,49345,195172,24257,219429
公投第８案,屏東縣,,,,711720,245566,79966,325532,37095,362627
公投第８案,臺東縣,,,,185996,65521,18824,84345,9356,93701
公投第８案,花蓮縣,,,,278059,104153,28095,132248,12163,144411
公投第８案,澎湖縣,,,,90405,28232,7910,36142,3599,39741
公投第８案,基隆市,,,,320030,118570,33570,152140,10546,162686
公投第８案,新竹市,,,,351775,141640,43061,184701,11576,196277
公投第８案,嘉義市,,,,221553,81506,27853,109359,8800,118159
公投第８案,臺北市,,,,2228430,892660,295984,1188644,86198,1274842
公投第８案,高雄市,,,,2353342,944727,307838,1252565,100943,1353508
公投第８案,新北市,,,,3375513,1300337,403443,1703780,142560,1846340
公投第８案,臺中市,,,,2295642,950822,273963,1224785,93034,1317819
公投第８案,臺南市,,,,1594821,541984,188192,730176,67891,798067
公投第８案,桃園市,,,,1801823,669790,192616,862406,57577,919983
公投第８案,連江縣,北竿鄉,,,2125,903,142,1045,59,1104
公投第８案,連江縣,莒光鄉,,,1481,610,124,734,43,777
公投第８案,連江縣,南竿鄉,,,6461,2708,425,3133,139,3272
公投第８案,連江縣,東引鄉,,,1138,484,78,562,16,578
公投第８案,金門縣,金城鎮,,,37815,10346,2034,12380,812,13192
公投第８案,金門縣,金湖鎮,,,25915,7443,1448,8891,688,9579
公投第８案,金門縣,金寧鄉,,,28162,7708,1798,9506,651,10157
公投第８案,金門縣,金沙鎮,,,18560,5095,960,6055,505,6560
公投第８案,金門縣,烏坵鄉,,,567,135,20,155,10,165
公投第８案,金門縣,烈嶼鄉,,,11676,3412,556,3968,279,4247
公投第８案,宜蘭縣,三星鄉,,,19051,6724,2119,8843,1029,9872
公投第８案,宜蘭縣,冬山鄉,,,45405,17407,4801,22208,1804,24012
公投第８案,宜蘭縣,頭城鎮,,,25135,9390,2823,12213,1535,13748
公投第８案,宜蘭縣,壯圍鄉,,,21447,8149,2591,10740,1453,12193
公投第８案,宜蘭縣,羅東鎮,,,57686,23361,6884,30245,2814,33059
公投第８案,宜蘭縣,宜蘭市,,,79167,32163,8747,40910,3586,44496
公投第８案,宜蘭縣,蘇澳鎮,,,34512,13182,4065,17247,2029,19276
公投第８案,宜蘭縣,五結鄉,,,34892,13195,3768,16963,1577,18540
公投第８案,宜蘭縣,員山鄉,,,28131,10219,3058,13277,1740,15017
公投第８案,宜蘭縣,大同鄉,,,4935,1581,471,2052,273,2325
公投第８案,宜蘭縣,礁溪鄉,,,31084,11552,3510,15062,1503,16565
公投第８案,宜蘭縣,南澳鄉,,,4644,1987,422,2409,227,2636
公投第８案,新竹縣,竹東鎮,,,78794,31275,8381,39656,2551,42207
公投第８案,新竹縣,橫山鄉,,,11346,4816,1321,6137,536,6673
公投第８案,新竹縣,峨眉鄉,,,5068,2134,612,2746,302,3048
公投第８案,新竹縣,寶山鄉,,,12973,5520,1553,7073,491,7564
公投第８案,新竹縣,五峰鄉,,,3997,1217,347,1564,87,1651
公投第８案,新竹縣,芎林鄉,,,17293,7308,2084,9392,721,10113
公投第８案,新竹縣,新豐鄉,,,45790,18567,5228,23795,1691,25486
公投第８案,新竹縣,北埔鄉,,,8180,3310,931,4241,297,4538
公投第８案,新竹縣,尖石鄉,,,7364,2272,655,2927,202,3129
公投第８案,新竹縣,湖口鄉,,,63511,26304,7039,33343,2124,35467
公投第８案,新竹縣,竹北市,,,137129,58887,16366,75253,4168,79421
公投第８案,新竹縣,關西鎮,,,24712,10240,2754,12994,966,13960
公投第８案,新竹縣,新埔鎮,,,28894,11786,3223,15009,1170,16179
公投第８案,苗栗縣,公館鄉,,,28318,11979,3364,15343,1361,16704
公投第８案,苗栗縣,苗栗市,,,74249,32286,8001,40287,2503,42790
公投第８案,苗栗縣,頭份市,,,83617,34955,9243,44198,2893,47091
公投第８案,苗栗縣,卓蘭鎮,,,14772,6104,1799,7903,650,8553
公投第８案,苗栗縣,通霄鎮,,,29709,10444,3914,14358,1525,15883
公投第８案,苗栗縣,後龍鎮,,,30948,11546,3888,15434,1628,17062
公投第８案,苗栗縣,竹南鎮,,,68528,28011,7800,35811,2497,38308
公投第８案,苗栗縣,苑裡鎮,,,38890,14932,5203,20135,1912,22047
公投第８案,苗栗縣,大湖鄉,,,12653,4829,1347,6176,566,6742
公投第８案,苗栗縣,泰安鄉,,,5180,2425,688,3113,254,3367
公投第８案,苗栗縣,西湖鄉,,,6382,2586,661,3247,278,3525
公投第８案,苗栗縣,三義鄉,,,13889,6123,1538,7661,471,8132
公投第８案,苗栗縣,頭屋鄉,,,9390,4533,1161,5694,392,6086
公投第８案,苗栗縣,三灣鄉,,,5852,2335,716,3051,322,3373
公投第８案,苗栗縣,銅鑼鄉,,,15424,6444,1608,8052,584,8636
公投第８案,苗栗縣,造橋鄉,,,11027,4538,1279,5817,587,6404
公投第８案,苗栗縣,南庄鄉,,,8784,3033,885,3918,386,4304
公投第８案,苗栗縣,獅潭鄉,,,3968,1444,370,1814,204,2018
公投第８案,彰化縣,埤頭鄉,,,25677,9625,2777,12402,1486,13888
公投第８案,彰化縣,彰化市,,,190995,81200,25213,106413,8530,114943
公投第８案,彰化縣,北斗鎮,,,27593,11209,3312,14521,1520,16041
公投第８案,彰化縣,鹿港鎮,,,70505,28359,8531,36890,3742,40632
公投第８案,彰化縣,和美鎮,,,75286,30448,9110,39558,3001,42559
公投第８案,彰化縣,員林市,,,102028,41186,12364,53550,3952,57502
公投第８案,彰化縣,秀水鄉,,,32394,13411,4221,17632,1516,19148
公投第８案,彰化縣,溪湖鎮,,,45147,18816,5155,23971,2109,26080
公投第８案,彰化縣,福興鄉,,,39745,14835,4407,19242,2147,21389
公投第８案,彰化縣,田中鎮,,,35391,14080,4422,18502,1855,20357
公投第８案,彰化縣,社頭鄉,,,36306,14676,4415,19091,1643,20734
公投第８案,彰化縣,二林鎮,,,42976,15723,4767,20490,2296,22786
公投第８案,彰化縣,伸港鄉,,,30407,12385,3334,15719,1434,17153
公投第８案,彰化縣,花壇鄉,,,38924,15558,5026,20584,1998,22582
公投第８案,彰化縣,線西鄉,,,14065,5907,1723,7630,746,8376
公投第８案,彰化縣,大村鄉,,,31492,13152,3807,16959,1477,18436
公投第８案,彰化縣,埔心鄉,,,29642,12457,4053,16510,1667,18177
公投第８案,彰化縣,二水鄉,,,13339,5356,1784,7140,840,7980
公投第８案,彰化縣,埔鹽鄉,,,28026,11850,3486,15336,1527,16863
公投第８案,彰化縣,芬園鄉,,,20408,7792,2316,10108,1147,11255
公投第８案,彰化縣,永靖鄉,,,31239,12889,3845,16734,1690,18424
公投第８案,彰化縣,竹塘鄉,,,12821,4516,1489,6005,817,6822
公投第８案,彰化縣,大城鄉,,,14713,3820,1117,4937,662,5599
公投第８案,彰化縣,溪州鄉,,,25405,8824,2685,11509,1338,12847
公投第８案,彰化縣,芳苑鄉,,,29291,9529,2813,12342,1818,14160
公投第８案,彰化縣,田尾鄉,,,23179,9787,2791,12578,1147,13725
公投第８案,南投縣,埔里鎮,,,68763,29379,7062,36441,2913,39354
公投第８案,南投縣,中寮鄉,,,13181,5299,1549,6848,746,7594
公投第８案,南投縣,仁愛鄉,,,12589,4953,1158,6111,535,6646
公投第８案,南投縣,水里鄉,,,15458,6115,1728,7843,674,8517
公投第８案,南投縣,信義鄉,,,13299,5078,1353,6431,1055,7486
公投第８案,南投縣,國姓鄉,,,16597,6621,1861,8482,802,9284
公投第８案,南投縣,名間鄉,,,33408,14224,3820,18044,1911,19955
公投第８案,南投縣,竹山鎮,,,47034,18263,5289,23552,2222,25774
公投第８案,南投縣,魚池鄉,,,13958,5418,1488,6906,657,7563
公投第８案,南投縣,草屯鎮,,,82922,35497,9226,44723,3042,47765
公投第８案,南投縣,鹿谷鄉,,,15941,6191,1574,7765,737,8502
公投第８案,南投縣,集集鎮,,,9611,4010,1023,5033,502,5535
公投第８案,南投縣,南投市,,,84328,37773,9552,47325,3247,50572
公投第８案,雲林縣,西螺鎮,,,38142,13352,4447,17799,2186,19985
公投第８案,雲林縣,麥寮鄉,,,37119,11823,4152,15975,1967,17942
公投第８案,雲林縣,東勢鄉,,,13239,4190,1419,5609,843,6452
公投第８案,雲林縣,水林鄉,,,22508,6110,2137,8247,1214,9461
公投第８案,雲林縣,虎尾鎮,,,58167,21498,6641,28139,2288,30427
公投第８案,雲林縣,臺西鄉,,,21125,6272,1982,8254,1231,9485
公投第８案,雲林縣,斗六市,,,89761,37013,10854,47867,3212,51079
公投第８案,雲林縣,大埤鄉,,,16509,5714,1835,7549,848,8397
公投第８案,雲林縣,斗南鎮,,,38138,14869,4663,19532,1803,21335
公投第８案,雲林縣,林內鄉,,,15551,5852,1805,7657,1072,8729
公投第８案,雲林縣,古坑鄉,,,27477,9830,3001,12831,1389,14220
公投第８案,雲林縣,二崙鄉,,,23367,7014,2497,9511,1410,10921
公投第８案,雲林縣,莿桐鄉,,,24570,8735,3012,11747,1614,13361
公投第８案,雲林縣,北港鎮,,,33958,12097,4026,16123,2146,18269
公投第８案,雲林縣,土庫鎮,,,24412,8329,2817,11146,1490,12636
公投第８案,雲林縣,元長鄉,,,22830,6174,2194,8368,1185,9553
公投第８案,雲林縣,崙背鄉,,,21050,6625,2318,8943,1083,10026
公投第８案,雲林縣,口湖鄉,,,24193,7192,2367,9559,1578,11137
公投第８案,雲林縣,四湖鄉,,,20983,5233,1748,6981,1011,7992
公投第８案,雲林縣,褒忠鄉,,,11381,3862,1292,5154,541,5695
公投第８案,嘉義縣,大林鎮,,,26922,9111,3032,12143,1408,13551
公投第８案,嘉義縣,朴子市,,,35191,12009,3835,15844,2053,17897
公投第８案,嘉義縣,布袋鎮,,,23965,7385,2490,9875,1525,11400
公投第８案,嘉義縣,東石鄉,,,21915,5381,1864,7245,1233,8478
公投第８案,嘉義縣,義竹鄉,,,16647,5431,1796,7227,1014,8241
公投第８案,嘉義縣,鹿草鄉,,,13937,4098,1349,5447,1042,6489
公投第８案,嘉義縣,民雄鄉,,,61209,21538,7626,29164,3313,32477
公投第８案,嘉義縣,竹崎鄉,,,31228,10700,3474,14174,1401,15575
公投第８案,嘉義縣,新港鄉,,,27342,9189,3294,12483,1935,14418
公投第８案,嘉義縣,大埔鄉,,,3999,1488,448,1936,177,2113
公投第８案,嘉義縣,中埔鄉,,,39139,12092,4090,16182,1719,17901
公投第８案,嘉義縣,太保市,,,31568,10962,3836,14798,1601,16399
公投第８案,嘉義縣,水上鄉,,,43857,15249,5407,20656,2205,22861
公投第８案,嘉義縣,番路鄉,,,10156,3888,1102,4990,569,5559
公投第８案,嘉義縣,溪口鄉,,,13105,4125,1455,5580,875,6455
公投第８案,嘉義縣,六腳鄉,,,20821,5473,1859,7332,1019,8351
公投第８案,嘉義縣,阿里山鄉,,,4691,1539,369,1908,133,2041
公投第８案,嘉義縣,梅山鄉,,,17083,6169,2019,8188,1035,9223
公投第８案,屏東縣,枋寮鄉,,,21394,7292,2451,9743,1469,11212
公投第８案,屏東縣,新園鄉,,,30706,10269,3577,13846,2072,15918
公投第８案,屏東縣,枋山鄉,,,4856,1616,530,2146,256,2402
公投第８案,屏東縣,春日鄉,,,3923,739,233,972,61,1033
公投第８案,屏東縣,三地門鄉,,,6373,2208,644,2852,320,3172
公投第８案,屏東縣,滿州鄉,,,7206,2123,663,2786,255,3041
公投第８案,屏東縣,佳冬鄉,,,17063,5317,1854,7171,1101,8272
公投第８案,屏東縣,林邊鄉,,,15691,5553,1908,7461,1108,8569
公投第８案,屏東縣,南州鄉,,,9479,3279,1098,4377,555,4932
公投第８案,屏東縣,車城鄉,,,7595,2023,694,2717,306,3023
公投第８案,屏東縣,崁頂鄉,,,12270,4227,1400,5627,649,6276
公投第８案,屏東縣,新埤鄉,,,9033,2880,990,3870,548,4418
公投第８案,屏東縣,潮州鎮,,,46444,16580,5151,21731,2123,23854
公投第８案,屏東縣,東港鎮,,,39495,13572,4579,18151,2671,20822
公投第８案,屏東縣,萬丹鄉,,,43478,14920,5311,20231,2511,22742
公投第８案,屏東縣,麟洛鄉,,,9970,3838,1289,5127,451,5578
公投第８案,屏東縣,長治鄉,,,26256,9433,3174,12607,1667,14274
公投第８案,屏東縣,里港鄉,,,22128,7701,2799,10500,1576,12076
公投第８案,屏東縣,九如鄉,,,19132,6601,2369,8970,1357,10327
公投第８案,屏東縣,恆春鎮,,,25661,8345,2490,10835,982,11817
公投第８案,屏東縣,來義鄉,,,6257,2576,642,3218,349,3567
公投第８案,屏東縣,霧臺鄉,,,2950,1106,340,1446,112,1558
公投第８案,屏東縣,泰武鄉,,,4344,1791,580,2371,325,2696
公投第８案,屏東縣,琉球鄉,,,10706,2962,827,3789,602,4391
公投第８案,屏東縣,牡丹鄉,,,4314,1305,314,1619,112,1731
公投第８案,屏東縣,獅子鄉,,,4230,1382,314,1696,127,1823
公投第８案,屏東縣,屏東市,,,170148,63176,19070,82246,6383,88629
公投第８案,屏東縣,瑪家鄉,,,5663,2346,681,3027,252,3279
公投第８案,屏東縣,鹽埔鄉,,,22402,7560,2514,10074,1294,11368
公投第８案,屏東縣,高樹鄉,,,21697,6482,2513,8995,1308,10303
公投第８案,屏東縣,竹田鄉,,,15353,5777,2046,7823,962,8785
公投第８案,屏東縣,萬巒鄉,,,17945,5697,2105,7802,1120,8922
公投第８案,屏東縣,內埔鄉,,,47558,14890,4816,19706,2111,21817
公投第８案,臺東縣,池上鄉,,,7162,2209,673,2882,362,3244
公投第８案,臺東縣,延平鄉,,,2930,974,337,1311,199,1510
公投第８案,臺東縣,金峰鄉,,,3028,1060,340,1400,212,1612
公投第８案,臺東縣,綠島鄉,,,3579,1147,300,1447,101,1548
公投第８案,臺東縣,關山鎮,,,7509,2662,701,3363,313,3676
公投第８案,臺東縣,海端鄉,,,3278,1129,391,1520,212,1732
公投第８案,臺東縣,太麻里鄉,,,9666,2997,971,3968,569,4537
公投第８案,臺東縣,達仁鄉,,,3137,1291,270,1561,198,1759
公投第８案,臺東縣,成功鎮,,,12426,4010,1193,5203,869,6072
公投第８案,臺東縣,卑南鄉,,,14976,5255,1631,6886,835,7721
公投第８案,臺東縣,鹿野鄉,,,6936,2011,727,2738,343,3081
公投第８案,臺東縣,大武鄉,,,5266,1577,542,2119,555,2674
公投第８案,臺東縣,臺東市,,,87803,34531,9173,43704,3501,47205
公投第８案,臺東縣,東河鄉,,,7635,2087,663,2750,463,3213
公投第８案,臺東縣,長濱鄉,,,6484,1590,511,2101,484,2585
公投第８案,臺東縣,蘭嶼鄉,,,4181,991,401,1392,140,1532
公投第８案,花蓮縣,鳳林鎮,,,9676,3783,934,4717,573,5290
公投第８案,花蓮縣,玉里鎮,,,20650,6519,1916,8435,1232,9667
公投第８案,花蓮縣,富里鄉,,,9065,2782,822,3604,509,4113
公投第８案,花蓮縣,秀林鄉,,,12562,4254,1246,5500,518,6018
公投第８案,花蓮縣,萬榮鄉,,,5269,1802,667,2469,355,2824
公投第８案,花蓮縣,新城鄉,,,17029,6668,1798,8466,699,9165
公投第８案,花蓮縣,花蓮市,,,84807,33828,8590,42418,2948,45366
公投第８案,花蓮縣,吉安鄉,,,72116,28209,7124,35333,2515,37848
公投第８案,花蓮縣,卓溪鄉,,,4947,1819,555,2374,304,2678
公投第８案,花蓮縣,光復鄉,,,11417,3925,1155,5080,738,5818
公投第８案,花蓮縣,壽豐鄉,,,15847,5963,1879,7842,882,8724
公投第８案,花蓮縣,豐濱鄉,,,4395,1172,403,1575,314,1889
公投第８案,花蓮縣,瑞穗鄉,,,10279,3429,1006,4435,576,5011
公投第８案,澎湖縣,湖西鄉,,,12741,3825,1035,4860,485,5345
公投第８案,澎湖縣,望安鄉,,,4628,1192,333,1525,232,1757
公投第８案,澎湖縣,七美鄉,,,3374,667,211,878,114,992
公投第８案,澎湖縣,西嶼鄉,,,7382,1618,461,2079,382,2461
公投第８案,澎湖縣,白沙鄉,,,8625,2443,756,3199,389,3588
公投第８案,澎湖縣,馬公市,,,53655,18487,5114,23601,1997,25598
公投第８案,基隆市,中山區,,,41856,14924,4550,19474,1463,20937
公投第８案,基隆市,中正區,,,45545,15275,4267,19542,1538,21080
公投第８案,基隆市,仁愛區,,,36738,13573,4225,17798,1682,19480
公投第８案,基隆市,安樂區,,,70396,26895,7380,34275,1970,36245
公投第８案,基隆市,暖暖區,,,33225,12703,3527,16230,893,17123
公投第８案,基隆市,信義區,,,46014,17958,4332,22290,1302,23592
公投第８案,基隆市,七堵區,,,46256,17242,5289,22531,1698,24229
公投第８案,新竹市,香山區,,,64896,26341,7542,33883,2329,36212
公投第８案,新竹市,東區,,,163757,66631,20584,87215,4981,92196
公投第８案,新竹市,北區,,,123122,48668,14935,63603,4266,67869
公投第８案,嘉義市,東區,,,100647,37194,12843,50037,3705,53742
公投第８案,嘉義市,西區,,,120906,44312,15010,59322,5095,64417
公投第８案,臺北市,內湖區,,,236824,97954,30319,128273,7966,136239
公投第８案,臺北市,信義區,,,190444,77960,24430,102390,6933,109323
公投第８案,臺北市,中正區,,,128292,51892,17351,69243,4648,73891
公投第８案,臺北市,大同區,,,107557,40451,16258,56709,5064,61773
公投第８案,臺北市,文山區,,,227211,98167,28002,126169,8977,135146
公投第８案,臺北市,南港區,,,101907,41696,13143,54839,3544,58383
公投第８案,臺北市,大安區,,,252645,101321,33964,135285,8129,143414
公投第８案,臺北市,松山區,,,169278,70346,22879,93225,6471,99696
公投第８案,臺北市,萬華區,,,164020,61941,21093,83034,7357,90391
公投第８案,臺北市,士林區,,,241854,92720,33559,126279,10881,137160
公投第８案,臺北市,北投區,,,213250,82553,27879,110432,8451,118883
公投第８案,臺北市,中山區,,,195148,75659,27107,102766,7777,110543
公投第８案,高雄市,新興區,,,44355,17858,6745,24603,1859,26462
公投第８案,高雄市,燕巢區,,,26012,9937,3265,13202,1399,14601
公投第８案,高雄市,旗山區,,,31996,11993,3911,15904,1580,17484
公投第８案,高雄市,大寮區,,,97309,38152,12176,50328,4102,54430
公投第８案,高雄市,彌陀區,,,16487,6672,2280,8952,1100,10052
公投第８案,高雄市,林園區,,,59129,21562,7309,28871,2647,31518
公投第８案,高雄市,鹽埕區,,,21617,8031,3161,11192,705,11897
公投第８案,高雄市,楠梓區,,,153132,63689,19693,83382,7497,90879
公投第８案,高雄市,前鎮區,,,161797,63622,21376,84998,7668,92666
公投第８案,高雄市,鼓山區,,,114979,47801,14884,62685,4110,66795
公投第８案,高雄市,三民區,,,289519,116063,39799,155862,11491,167353
公投第８案,高雄市,左營區,,,161367,70034,20435,90469,5819,96288
公投第８案,高雄市,小港區,,,132733,53331,17489,70820,5365,76185
公投第８案,高雄市,大樹區,,,36772,13775,4495,18270,1662,19932
公投第８案,高雄市,鳳山區,,,300510,125228,38044,163272,12418,175690
公投第８案,高雄市,苓雅區,,,146786,60364,21461,81825,5570,87395
公投第８案,高雄市,旗津區,,,24860,7980,2930,10910,1363,12273
公投第８案,高雄市,前金區,,,23928,9714,3464,13178,953,14131
公投第８案,高雄市,田寮區,,,6671,1969,745,2714,366,3080
公投第８案,高雄市,仁武區,,,73611,30136,9368,39504,2644,42148
公投第８案,高雄市,岡山區,,,81244,35021,10410,45431,3363,48794
公投第８案,高雄市,橋頭區,,,32565,13387,4597,17984,1877,19861
公投第８案,高雄市,鳥松區,,,39191,16185,5680,21865,1588,23453
公投第８案,高雄市,大社區,,,30046,11407,4150,15557,1432,16989
公投第８案,高雄市,湖內區,,,25729,9563,3311,12874,1074,13948
公投第８案,高雄市,阿蓮區,,,24534,8896,3061,11957,944,12901
公投第８案,高雄市,路竹區,,,43850,17563,5709,23272,2274,25546
公投第８案,高雄市,梓官區,,,31025,11955,4135,16090,1564,17654
公投第８案,高雄市,永安區,,,12001,4954,1826,6780,691,7471
公投第８案,高雄市,茄萣區,,,26212,8933,3368,12301,1321,13622
公投第８案,高雄市,茂林區,,,1615,784,183,967,91,1058
公投第８案,高雄市,甲仙區,,,5417,1786,515,2301,296,2597
公投第８案,高雄市,桃源區,,,3498,1284,348,1632,112,1744
公投第８案,高雄市,美濃區,,,35311,13355,3817,17172,1861,19033
公投第８案,高雄市,內門區,,,13002,4045,1307,5352,732,6084
公投第８案,高雄市,杉林區,,,10607,3178,1039,4217,508,4725
公投第８案,高雄市,六龜區,,,11501,3583,1077,4660,737,5397
公投第８案,高雄市,那瑪夏區,,,2424,937,275,1212,160,1372
公投第８案,新北市,金山區,,,18978,6535,2082,8617,943,9560
公投第８案,新北市,瑞芳區,,,35036,11838,3585,15423,1369,16792
公投第８案,新北市,貢寮區,,,11279,3171,1167,4338,466,4804
公投第８案,新北市,雙溪區,,,7999,2599,814,3413,440,3853
公投第８案,新北市,泰山區,,,64252,24980,7590,32570,2522,35092
公投第８案,新北市,板橋區,,,463411,176926,59047,235973,21774,257747
公投第８案,新北市,永和區,,,187798,80629,22072,102701,7080,109781
公投第８案,新北市,蘆洲區,,,167457,60780,20753,81533,7713,89246
公投第８案,新北市,石碇區,,,6861,2232,829,3061,329,3390
公投第８案,新北市,新莊區,,,344981,134468,44611,179079,15707,194786
公投第８案,新北市,新店區,,,264053,111123,28106,139229,9000,148229
公投第８案,新北市,樹林區,,,152102,57950,18893,76843,6359,83202
公投第８案,新北市,中和區,,,355978,142856,39619,182475,13264,195739
公投第８案,新北市,三重區,,,329846,122219,42907,165126,18008,183134
公投第８案,新北市,鶯歌區,,,71645,26086,8489,34575,2638,37213
公投第８案,新北市,淡水區,,,147272,55441,16540,71981,4862,76843
公投第８案,新北市,三峽區,,,94291,35036,10500,45536,3548,49084
公投第８案,新北市,土城區,,,200783,76760,24004,100764,8642,109406
公投第８案,新北市,汐止區,,,173831,65487,19406,84893,6318,91211
公投第８案,新北市,林口區,,,86203,34725,10463,45188,2983,48171
公投第８案,新北市,深坑區,,,20624,7992,2416,10408,793,11201
公投第８案,新北市,三芝區,,,20119,6742,2135,8877,788,9665
公投第８案,新北市,坪林區,,,5891,1957,618,2575,356,2931
公投第８案,新北市,五股區,,,72443,26234,8658,34892,3268,38160
公投第８案,新北市,八里區,,,32970,11981,3941,15922,1485,17407
公投第８案,新北市,石門區,,,10528,3696,1170,4866,563,5429
公投第８案,新北市,烏來區,,,5264,1982,542,2524,183,2707
公投第８案,新北市,平溪區,,,4321,1333,447,1780,245,2025
公投第８案,新北市,萬里區,,,19297,6579,2039,8618,914,9532
公投第８案,臺中市,潭子區,,,89487,37158,10407,47565,3331,50896
公投第８案,臺中市,霧峰區,,,55225,23502,6672,30174,3067,33241
公投第８案,臺中市,和平區,,,9498,4208,1007,5215,450,5665
公投第８案,臺中市,大里區,,,171769,68915,20147,89062,6611,95673
公投第８案,臺中市,太平區,,,157926,61930,17365,79295,6258,85553
公投第８案,臺中市,大肚區,,,47457,19777,5502,25279,2139,27418
公投第８案,臺中市,龍井區,,,63584,25170,7724,32894,2476,35370
公投第８案,臺中市,外埔區,,,27059,11290,3099,14389,1294,15683
公投第８案,臺中市,烏日區,,,61705,25559,7417,32976,2718,35694
公投第８案,臺中市,大雅區,,,77189,32177,8781,40958,2890,43848
公投第８案,臺中市,大安區,,,16520,6763,1921,8684,1010,9694
公投第８案,臺中市,石岡區,,,12880,5359,1555,6914,695,7609
公投第８案,臺中市,后里區,,,44962,18679,5157,23836,2124,25960
公投第８案,臺中市,沙鹿區,,,74207,29978,8985,38963,2982,41945
公投第８案,臺中市,神岡區,,,54565,22607,6854,29461,2490,31951
公投第８案,臺中市,大甲區,,,63069,25384,7620,33004,3018,36022
公投第８案,臺中市,梧棲區,,,47040,18726,5879,24605,2163,26768
公投第８案,臺中市,北屯區,,,227720,95846,25843,121689,7633,129322
公投第８案,臺中市,南屯區,,,135448,59274,16840,76114,5177,81291
公投第８案,臺中市,北區,,,124621,50598,14519,65117,4179,69296
公投第８案,臺中市,南區,,,103643,45430,13472,58902,4366,63268
公投第８案,臺中市,東勢區,,,43181,17561,4978,22539,2316,24855
公投第８案,臺中市,西屯區,,,183814,78086,21557,99643,6371,106014
公投第８案,臺中市,中區,,,14696,5704,1769,7473,656,8129
公投第８案,臺中市,東區,,,64291,26338,8256,34594,2732,37326
公投第８案,臺中市,西區,,,95040,39299,12191,51490,3481,54971
公投第８案,臺中市,豐原區,,,136658,58195,17585,75780,6078,81858
公投第８案,臺中市,清水區,,,71528,29604,8760,38364,3373,41737
公投第８案,臺中市,新社區,,,20860,7705,2101,9806,956,10762
公投第８案,臺南市,新市區,,,30386,10793,3857,14650,1357,16007
公投第８案,臺南市,六甲區,,,19144,5861,2209,8070,1018,9088
公投第８案,臺南市,下營區,,,20947,6324,2082,8406,1044,9450
公投第８案,臺南市,官田區,,,18675,5689,2207,7896,843,8739
公投第８案,臺南市,白河區,,,24894,6685,2443,9128,1081,10209
公投第８案,臺南市,南區,,,108650,36014,13298,49312,4974,54286
公投第８案,臺南市,鹽水區,,,22121,6743,2449,9192,1001,10193
公投第８案,臺南市,仁德區,,,64632,23085,7505,30590,2993,33583
公投第８案,臺南市,龍崎區,,,3713,1137,377,1514,184,1698
公投第８案,臺南市,中西區,,,65261,23255,9332,32587,3058,35645
公投第８案,臺南市,北區,,,110906,39802,14099,53901,4263,58164
公投第８案,臺南市,永康區,,,195001,69493,22722,92215,7200,99415
公投第８案,臺南市,安平區,,,55379,19061,6603,25664,1803,27467
公投第８案,臺南市,新營區,,,64949,22398,6951,29349,2136,31485
公投第８案,臺南市,左鎮區,,,4418,1219,412,1631,280,1911
公投第８案,臺南市,安南區,,,159654,54864,19800,74664,7489,82153
公投第８案,臺南市,學甲區,,,22567,7007,2508,9515,926,10441
公投第８案,臺南市,佳里區,,,50407,17798,5733,23531,2249,25780
公投第８案,臺南市,新化區,,,37296,13258,4349,17607,2058,19665
公投第８案,臺南市,將軍區,,,17754,4896,1613,6509,743,7252
公投第８案,臺南市,北門區,,,9925,2613,829,3442,343,3785
公投第８案,臺南市,柳營區,,,18804,6048,1944,7992,1015,9007
公投第８案,臺南市,善化區,,,39950,13391,4901,18292,1754,20046
公投第８案,臺南市,安定區,,,26104,9082,3227,12309,1359,13668
公投第８案,臺南市,楠西區,,,8528,2534,745,3279,380,3659
公投第８案,臺南市,山上區,,,6511,1824,635,2459,302,2761
公投第８案,臺南市,玉井區,,,12357,4041,1204,5245,549,5794
公投第８案,臺南市,南化區,,,7786,2452,783,3235,377,3612
公投第８案,臺南市,東區,,,153359,56699,19840,76539,5810,82349
公投第８案,臺南市,關廟區,,,29913,10370,3637,14007,1315,15322
公投第８案,臺南市,歸仁區,,,57387,20119,7113,27232,2388,29620
公投第８案,臺南市,西港區,,,21564,6716,2122,8838,739,9577
公投第８案,臺南市,七股區,,,19950,5675,1847,7522,899,8421
公投第８案,臺南市,麻豆區,,,37963,12101,4413,16514,1309,17823
公投第８案,臺南市,大內區,,,8654,2664,835,3499,517,4016
公投第８案,臺南市,東山區,,,18471,4312,1513,5825,904,6729
公投第８案,臺南市,後壁區,,,20841,5961,2055,8016,1231,9247
公投第８案,桃園市,中壢區,,,334402,130138,34651,164789,10142,174931
公投第８案,桃園市,平鎮區,,,183560,71904,18993,90897,5495,96392
公投第８案,桃園市,八德區,,,165065,59933,17095,77028,5780,82808
公投第８案,桃園市,蘆竹區,,,129252,46150,14602,60752,4314,65066
公投第８案,桃園市,龜山區,,,131702,45663,14542,60205,3969,64174
公投第８案,桃園市,大園區,,,73900,25568,8256,33824,2421,36245
公投第８案,桃園市,觀音區,,,55149,19477,5998,25475,1935,27410
公投第８案,桃園市,大溪區,,,78285,28638,8815,37453,3444,40897
公投第８案,桃園市,桃園區,,,359790,130494,39403,169897,10996,180893
公投第８案,桃園市,龍潭區,,,101574,40185,10399,50584,3133,53717
公投第８案,桃園市,新屋區,,,41461,16095,5142,21237,1573,22810
公投第８案,桃園市,復興區,,,9766,3560,968,4528,402,4930
公投第８案,桃園市,楊梅區,,,137917,51985,13752,65737,3973,69710
公投第８案,連江縣,南竿鄉,介壽村,1,1967,830,139,969,44,1013
公投第８案,連江縣,南竿鄉,福沃村、復興村,2,1837,717,115,832,46,878
公投第８案,連江縣,南竿鄉,清水村、珠螺村,3,1114,471,93,564,23,587
公投第８案,連江縣,南竿鄉,馬祖村、津沙村、四維村、仁愛村,4,1543,690,78,768,26,794
公投第８案,連江縣,北竿鄉,后沃村、橋仔村、塘岐村,5,1515,657,108,765,49,814
公投第８案,連江縣,北竿鄉,坂里村、白沙村、芹壁村,6,610,246,34,280,10,290
公投第８案,連江縣,莒光鄉,田沃村、西坵村、青帆村,7,698,264,57,321,14,335
公投第８案,連江縣,莒光鄉,大坪村、福正村,8,783,346,67,413,29,442
公投第８案,連江縣,東引鄉,樂華村、中柳村,9,1138,484,78,562,16,578
公投第８案,金門縣,金城鎮,東門里,1,1396,400,62,462,30,492
公投第８案,金門縣,金城鎮,東門里,2,1831,525,126,651,42,693
公投第８案,金門縣,金城鎮,東門里,3,1750,493,106,599,44,643
公投第８案,金門縣,金城鎮,南門里,4,1889,564,100,664,53,717
公投第８案,金門縣,金城鎮,南門里,5,1675,403,103,506,30,536
公投第８案,金門縣,金城鎮,南門里,6,1901,625,109,734,46,780
公投第８案,金門縣,金城鎮,西門里,7,1610,405,96,501,55,556
公投第８案,金門縣,金城鎮,西門里,8,1687,484,86,570,32,602
公投第８案,金門縣,金城鎮,西門里,9,1594,481,77,558,22,580
公投第８案,金門縣,金城鎮,西門里,10,1726,482,95,577,22,599
公投第８案,金門縣,金城鎮,西門里,11,1733,512,92,604,25,629
公投第８案,金門縣,金城鎮,西門里,12,1532,488,107,595,31,626
公投第８案,金門縣,金城鎮,北門里,13,2079,547,115,662,55,717
公投第８案,金門縣,金城鎮,北門里,14,2033,506,107,613,38,651
公投第８案,金門縣,金城鎮,賢庵里,15,2517,705,129,834,48,882
公投第８案,金門縣,金城鎮,賢庵里,16,2083,580,110,690,36,726
公投第８案,金門縣,金城鎮,金水里,17,2140,557,123,680,55,735
公投第８案,金門縣,金城鎮,古城里,18,2435,570,102,672,37,709
公投第８案,金門縣,金城鎮,古城里,19,1353,243,62,305,40,345
公投第８案,金門縣,金城鎮,珠沙里,20,1574,399,68,467,29,496
公投第８案,金門縣,金城鎮,珠沙里,21,1277,377,59,436,42,478
公投第８案,金門縣,金寧鄉,古寧村,22,1735,400,82,482,59,541
公投第８案,金門縣,金寧鄉,古寧村,23,1537,366,80,446,38,484
公投第８案,金門縣,金寧鄉,安美村,24,1766,436,114,550,41,591
公投第８案,金門縣,金寧鄉,安美村,25,1015,294,64,358,17,375
公投第８案,金門縣,金寧鄉,安美村,26,1726,466,94,560,52,612
公投第８案,金門縣,金寧鄉,湖埔村,27,1691,408,93,501,33,534
公投第８案,金門縣,金寧鄉,湖埔村,28,2044,582,245,827,38,865
公投第８案,金門縣,金寧鄉,湖埔村,29,1848,624,104,728,36,764
公投第８案,金門縣,金寧鄉,湖埔村,30,1735,484,86,570,33,603
公投第８案,金門縣,金寧鄉,榜林村,31,1795,490,90,580,47,627
公投第８案,金門縣,金寧鄉,榜林村,32,1834,457,76,533,47,580
公投第８案,金門縣,金寧鄉,榜林村,33,1528,393,71,464,43,507
公投第８案,金門縣,金寧鄉,盤山村,34,1473,460,79,539,29,568
公投第８案,金門縣,金寧鄉,盤山村,35,1679,476,84,560,43,603
公投第８案,金門縣,金寧鄉,盤山村,36,1921,600,288,888,43,931
公投第８案,金門縣,金寧鄉,盤山村,37,1298,373,75,448,19,467
公投第８案,金門縣,金寧鄉,后盤村,38,1537,399,73,472,33,505
公投第８案,金門縣,烈嶼鄉,林湖村,39,1647,618,67,685,37,722
公投第８案,金門縣,烈嶼鄉,林湖村,40,1733,505,71,576,41,617
公投第８案,金門縣,烈嶼鄉,黃埔村,41,1635,480,85,565,39,604
公投第８案,金門縣,烈嶼鄉,西口村,42,1296,348,65,413,27,440
公投第８案,金門縣,烈嶼鄉,西口村,43,1099,281,41,322,33,355
公投第８案,金門縣,烈嶼鄉,上林村,44,1425,370,79,449,30,479
公投第８案,金門縣,烈嶼鄉,上岐村,45,1412,412,84,496,29,525
公投第８案,金門縣,烈嶼鄉,上岐村,46,1429,398,64,462,43,505
公投第８案,金門縣,烏坵鄉,大坵村,47,275,63,11,74,4,78
公投第８案,金門縣,烏坵鄉,小坵村,48,292,72,9,81,6,87
公投第８案,金門縣,金湖鎮,新市里,49,1348,392,101,493,47,540
公投第８案,金門縣,金湖鎮,新市里,50,1386,360,85,445,42,487
公投第８案,金門縣,金湖鎮,新市里,51,1403,467,83,550,54,604
公投第８案,金門縣,金湖鎮,山外里,52,1771,534,95,629,44,673
公投第８案,金門縣,金湖鎮,山外里,53,1493,394,109,503,52,555
公投第８案,金門縣,金湖鎮,溪湖里,54,1510,421,62,483,55,538
公投第８案,金門縣,金湖鎮,蓮庵里,55,1607,601,61,662,42,704
公投第８案,金門縣,金湖鎮,料羅里,56,2006,534,88,622,52,674
公投第８案,金門縣,金湖鎮,新湖里,57,1780,500,107,607,34,641
公投第８案,金門縣,金湖鎮,新湖里,58,1739,521,92,613,22,635
公投第８案,金門縣,金湖鎮,新湖里,59,1384,372,72,444,34,478
公投第８案,金門縣,金湖鎮,新湖里,60,1400,398,92,490,38,528
公投第８案,金門縣,金湖鎮,新湖里,61,1325,449,104,553,32,585
公投第８案,金門縣,金湖鎮,正義里,62,1236,312,65,377,35,412
公投第８案,金門縣,金湖鎮,正義里,63,1382,358,74,432,38,470
公投第８案,金門縣,金湖鎮,瓊林里,64,1631,446,85,531,29,560
公投第８案,金門縣,金湖鎮,瓊林里,65,1514,384,73,457,38,495
公投第８案,金門縣,金沙鎮,汶沙里,66,1909,493,109,602,52,654
公投第８案,金門縣,金沙鎮,汶沙里,67,1524,483,91,574,51,625
公投第８案,金門縣,金沙鎮,汶沙里,68,1673,416,81,497,47,544
公投第８案,金門縣,金沙鎮,何斗里,69,2003,519,87,606,54,660
公投第８案,金門縣,金沙鎮,浦山里,70,1212,376,86,462,31,493
公投第８案,金門縣,金沙鎮,浦山里,71,1126,303,67,370,40,410
公投第８案,金門縣,金沙鎮,西園里,72,1540,375,69,444,35,479
公投第８案,金門縣,金沙鎮,官嶼里,73,1216,281,60,341,35,376
公投第８案,金門縣,金沙鎮,官嶼里,74,950,196,44,240,18,258
公投第８案,金門縣,金沙鎮,三山里,75,1895,586,72,658,43,701
公投第８案,金門縣,金沙鎮,大洋里,76,1135,356,70,426,37,463
公投第８案,金門縣,金沙鎮,光前里,77,1252,330,62,392,43,435
公投第８案,金門縣,金沙鎮,光前里,78,1125,381,62,443,19,462
公投第８案,宜蘭縣,宜蘭市,民族里,1,982,384,107,491,24,515
公投第８案,宜蘭縣,宜蘭市,民族里,2,1270,510,127,637,61,698
公投第８案,宜蘭縣,宜蘭市,建軍里,3,849,344,91,435,26,461
公投第８案,宜蘭縣,宜蘭市,建軍里,4,756,322,93,415,25,440
公投第８案,宜蘭縣,宜蘭市,泰山里,5,1107,428,74,502,57,559
公投第８案,宜蘭縣,宜蘭市,泰山里,6,893,354,93,447,49,496
公投第８案,宜蘭縣,宜蘭市,負郭里,7,912,375,90,465,39,504
公投第８案,宜蘭縣,宜蘭市,負郭里,8,1335,529,148,677,72,749
公投第８案,宜蘭縣,宜蘭市,負郭里,9,686,247,82,329,36,365
公投第８案,宜蘭縣,宜蘭市,思源里,10,1366,619,153,772,41,813
公投第８案,宜蘭縣,宜蘭市,思源里,11,1363,592,150,742,35,777
公投第８案,宜蘭縣,宜蘭市,思源里,12,1540,685,144,829,54,883
公投第８案,宜蘭縣,宜蘭市,七結里,13,1341,582,121,703,26,729
公投第８案,宜蘭縣,宜蘭市,七結里,14,1209,483,135,618,64,682
公投第８案,宜蘭縣,宜蘭市,文化里,15,900,353,99,452,55,507
公投第８案,宜蘭縣,宜蘭市,文化里,16,980,368,100,468,46,514
公投第８案,宜蘭縣,宜蘭市,文化里,17,1165,465,142,607,35,642
公投第８案,宜蘭縣,宜蘭市,復興里,18,904,398,78,476,25,501
公投第８案,宜蘭縣,宜蘭市,復興里,19,813,336,90,426,31,457
公投第８案,宜蘭縣,宜蘭市,復興里,20,978,381,114,495,45,540
公投第８案,宜蘭縣,宜蘭市,民權里,21,1282,434,116,550,32,582
公投第８案,宜蘭縣,宜蘭市,民權里,22,465,189,66,255,14,269
公投第８案,宜蘭縣,宜蘭市,神農里,23,669,264,82,346,45,391
公投第８案,宜蘭縣,宜蘭市,神農里,24,923,406,82,488,40,528
公投第８案,宜蘭縣,宜蘭市,神農里,25,1006,385,103,488,44,532
公投第８案,宜蘭縣,宜蘭市,大新里,26,762,335,111,446,50,496
公投第８案,宜蘭縣,宜蘭市,新民里,27,727,290,110,400,48,448
公投第８案,宜蘭縣,宜蘭市,新民里,28,833,365,110,475,69,544
公投第８案,宜蘭縣,宜蘭市,進士里,29,1143,485,130,615,30,645
公投第８案,宜蘭縣,宜蘭市,進士里,30,979,408,100,508,24,532
公投第８案,宜蘭縣,宜蘭市,南橋里,31,1214,478,123,601,60,661
公投第８案,宜蘭縣,宜蘭市,凱旋里,32,1283,459,185,644,97,741
公投第８案,宜蘭縣,宜蘭市,南津里,33,946,409,101,510,38,548
公投第８案,宜蘭縣,宜蘭市,南津里,34,1090,460,85,545,40,585
公投第８案,宜蘭縣,宜蘭市,建業里,35,943,410,94,504,29,533
公投第８案,宜蘭縣,宜蘭市,建業里,36,774,345,109,454,39,493
公投第８案,宜蘭縣,宜蘭市,擺厘里,37,968,436,108,544,46,590
公投第８案,宜蘭縣,宜蘭市,擺厘里,38,926,425,117,542,30,572
公投第８案,宜蘭縣,宜蘭市,擺厘里,39,1019,437,120,557,55,612
公投第８案,宜蘭縣,宜蘭市,延平里,40,1084,443,111,554,58,612
公投第８案,宜蘭縣,宜蘭市,延平里,41,1095,439,119,558,35,593
公投第８案,宜蘭縣,宜蘭市,延平里,42,1083,472,117,589,31,620
公投第８案,宜蘭縣,宜蘭市,成功里,43,1108,448,108,556,35,591
公投第８案,宜蘭縣,宜蘭市,成功里,44,848,366,103,469,25,494
公投第８案,宜蘭縣,宜蘭市,成功里,45,1095,460,113,573,31,604
公投第８案,宜蘭縣,宜蘭市,東村里,46,1110,483,114,597,29,626
公投第８案,宜蘭縣,宜蘭市,東村里,47,1104,478,109,587,56,643
公投第８案,宜蘭縣,宜蘭市,新東里,48,1134,479,116,595,46,641
公投第８案,宜蘭縣,宜蘭市,新東里,49,1146,484,133,617,43,660
公投第８案,宜蘭縣,宜蘭市,新東里,50,876,370,105,475,53,528
公投第８案,宜蘭縣,宜蘭市,黎明里,51,905,359,85,444,62,506
公投第８案,宜蘭縣,宜蘭市,黎明里,52,910,388,96,484,50,534
公投第８案,宜蘭縣,宜蘭市,七張里,53,1434,506,122,628,51,679
公投第８案,宜蘭縣,宜蘭市,孝廉里,54,1152,432,129,561,76,637
公投第８案,宜蘭縣,宜蘭市,東門里,55,966,396,133,529,48,577
公投第８案,宜蘭縣,宜蘭市,小東里,56,711,283,87,370,44,414
公投第８案,宜蘭縣,宜蘭市,小東里,57,884,375,111,486,48,534
公投第８案,宜蘭縣,宜蘭市,菜園里,58,1326,534,165,699,65,764
公投第８案,宜蘭縣,宜蘭市,慈安里,59,909,327,104,431,33,464
公投第８案,宜蘭縣,宜蘭市,慈安里,60,894,342,97,439,50,489
公投第８案,宜蘭縣,宜蘭市,中興里,61,1259,462,133,595,40,635
公投第８案,宜蘭縣,宜蘭市,中興里,62,789,306,77,383,36,419
公投第８案,宜蘭縣,宜蘭市,中興里,63,867,342,96,438,38,476
公投第８案,宜蘭縣,宜蘭市,新生里,64,1454,536,182,718,88,806
公投第８案,宜蘭縣,宜蘭市,新生里,65,1130,528,123,651,41,692
公投第８案,宜蘭縣,宜蘭市,茭白里,66,1087,405,71,476,30,506
公投第８案,宜蘭縣,宜蘭市,茭白里,67,938,412,110,522,56,578
公投第８案,宜蘭縣,宜蘭市,北津里,68,1285,503,142,645,71,716
公投第８案,宜蘭縣,宜蘭市,北津里,69,952,342,109,451,28,479
公投第８案,宜蘭縣,宜蘭市,梅洲里,70,948,363,141,504,67,571
公投第８案,宜蘭縣,宜蘭市,梅洲里,71,1160,425,122,547,62,609
公投第８案,宜蘭縣,宜蘭市,梅洲里,72,1015,417,116,533,70,603
公投第８案,宜蘭縣,宜蘭市,南門里,73,424,196,49,245,16,261
公投第８案,宜蘭縣,宜蘭市,南門里,74,964,394,110,504,59,563
公投第８案,宜蘭縣,宜蘭市,中山里,75,959,344,113,457,58,515
公投第８案,宜蘭縣,宜蘭市,西門里,76,814,369,106,475,45,520
公投第８案,宜蘭縣,宜蘭市,西門里,77,885,329,138,467,59,526
公投第８案,宜蘭縣,宜蘭市,北門里,78,1162,451,149,600,77,677
公投第８案,宜蘭縣,羅東鎮,開明里,79,689,288,82,370,37,407
公投第８案,宜蘭縣,羅東鎮,開明里,80,718,281,88,369,29,398
公投第８案,宜蘭縣,羅東鎮,大新里,81,1475,541,192,733,85,818
公投第８案,宜蘭縣,羅東鎮,東安里,82,1466,539,177,716,81,797
公投第８案,宜蘭縣,羅東鎮,東安里,83,1075,434,123,557,46,603
公投第８案,宜蘭縣,羅東鎮,東安里,84,963,378,116,494,42,536
公投第８案,宜蘭縣,羅東鎮,新群里,85,1511,553,153,706,105,811
公投第８案,宜蘭縣,羅東鎮,新群里,86,1166,453,132,585,42,627
公投第８案,宜蘭縣,羅東鎮,羅莊里,87,1273,496,173,669,68,737
公投第８案,宜蘭縣,羅東鎮,羅莊里,88,1735,690,171,861,53,914
公投第８案,宜蘭縣,羅東鎮,南昌里,89,1487,612,166,778,62,840
公投第８案,宜蘭縣,羅東鎮,南昌里,90,837,354,106,460,42,502
公投第８案,宜蘭縣,羅東鎮,南豪里,91,1312,540,171,711,73,784
公投第８案,宜蘭縣,羅東鎮,成功里,92,1502,580,148,728,69,797
公投第８案,宜蘭縣,羅東鎮,仁德里,93,1138,428,121,549,31,580
公投第８案,宜蘭縣,羅東鎮,仁和里,94,1010,381,122,503,57,560
公投第８案,宜蘭縣,羅東鎮,中山里,95,1373,506,184,690,99,789
公投第８案,宜蘭縣,羅東鎮,漢民里,96,1089,425,131,556,51,607
公投第８案,宜蘭縣,羅東鎮,漢民里,97,1304,519,132,651,57,708
公投第８案,宜蘭縣,羅東鎮,漢民里,98,1288,469,147,616,73,689
公投第８案,宜蘭縣,羅東鎮,維揚里,99,1036,443,130,573,68,641
公投第８案,宜蘭縣,羅東鎮,維揚里,100,969,444,118,562,52,614
公投第８案,宜蘭縣,羅東鎮,維揚里,101,985,409,126,535,56,591
公投第８案,宜蘭縣,羅東鎮,西安里,102,1420,546,189,735,96,831
公投第８案,宜蘭縣,羅東鎮,西安里,103,1430,613,151,764,57,821
公投第８案,宜蘭縣,羅東鎮,北成里,104,1075,438,128,566,65,631
公投第８案,宜蘭縣,羅東鎮,北成里,105,879,378,98,476,45,521
公投第８案,宜蘭縣,羅東鎮,北成里,106,850,336,99,435,34,469
公投第８案,宜蘭縣,羅東鎮,國華里,107,1111,470,144,614,48,662
公投第８案,宜蘭縣,羅東鎮,國華里,108,1139,518,132,650,59,709
公投第８案,宜蘭縣,羅東鎮,國華里,109,1130,500,156,656,36,692
公投第８案,宜蘭縣,羅東鎮,國華里,110,980,401,126,527,52,579
公投第８案,宜蘭縣,羅東鎮,賢文里,111,1431,585,160,745,59,804
公投第８案,宜蘭縣,羅東鎮,賢文里,112,1109,470,112,582,49,631
公投第８案,宜蘭縣,羅東鎮,賢文里,113,1083,444,115,559,50,609
公投第８案,宜蘭縣,羅東鎮,公正里,114,1404,590,152,742,69,811
公投第８案,宜蘭縣,羅東鎮,公正里,115,1288,518,163,681,59,740
公投第８案,宜蘭縣,羅東鎮,集祥里,116,1183,367,126,493,53,546
公投第８案,宜蘭縣,羅東鎮,信義里,117,1105,471,137,608,53,661
公投第８案,宜蘭縣,羅東鎮,信義里,118,987,393,157,550,51,601
公投第８案,宜蘭縣,羅東鎮,信義里,119,773,306,115,421,51,472
公投第８案,宜蘭縣,羅東鎮,樹林里,120,1366,647,167,814,49,863
公投第８案,宜蘭縣,羅東鎮,樹林里,121,907,421,125,546,37,583
公投第８案,宜蘭縣,羅東鎮,樹林里,122,1158,537,130,667,50,717
公投第８案,宜蘭縣,羅東鎮,竹林里,123,977,383,123,506,55,561
公投第８案,宜蘭縣,羅東鎮,竹林里,124,972,358,116,474,55,529
公投第８案,宜蘭縣,羅東鎮,竹林里,125,977,409,125,534,42,576
公投第８案,宜蘭縣,羅東鎮,仁愛里,126,1398,591,162,753,70,823
公投第８案,宜蘭縣,羅東鎮,仁愛里,127,1022,416,128,544,32,576
公投第８案,宜蘭縣,羅東鎮,仁愛里,128,1131,492,139,631,60,691
公投第８案,宜蘭縣,蘇澳鎮,龍德里,129,1194,459,147,606,64,670
公投第８案,宜蘭縣,蘇澳鎮,龍德里,130,1128,413,130,543,42,585
公投第８案,宜蘭縣,蘇澳鎮,龍德里,131,1042,471,117,588,52,640
公投第８案,宜蘭縣,蘇澳鎮,頂寮里,132,997,416,117,533,51,584
公投第８案,宜蘭縣,蘇澳鎮,永榮里,133,1303,506,160,666,65,731
公投第８案,宜蘭縣,蘇澳鎮,永榮里,134,1260,525,148,673,74,747
公投第８案,宜蘭縣,蘇澳鎮,永榮里,135,1130,449,120,569,73,642
公投第８案,宜蘭縣,蘇澳鎮,存仁里,136,559,207,65,272,43,315
公投第８案,宜蘭縣,蘇澳鎮,存仁里,137,351,110,44,154,26,180
公投第８案,宜蘭縣,蘇澳鎮,港邊里,138,889,312,111,423,65,488
公投第８案,宜蘭縣,蘇澳鎮,港邊里,139,434,154,59,213,28,241
公投第８案,宜蘭縣,蘇澳鎮,隘丁里,140,835,351,195,546,39,585
公投第８案,宜蘭縣,蘇澳鎮,隘丁里,141,975,389,113,502,49,551
公投第８案,宜蘭縣,蘇澳鎮,隘丁里,142,1135,451,149,600,72,672
公投第８案,宜蘭縣,蘇澳鎮,新城里,143,788,358,122,480,31,511
公投第８案,宜蘭縣,蘇澳鎮,新城里,144,469,162,56,218,32,250
公投第８案,宜蘭縣,蘇澳鎮,聖愛里,145,811,301,88,389,41,430
公投第８案,宜蘭縣,蘇澳鎮,聖愛里,146,867,345,88,433,26,459
公投第８案,宜蘭縣,蘇澳鎮,聖愛里,147,1139,460,133,593,49,642
公投第８案,宜蘭縣,蘇澳鎮,聖湖里,148,1146,452,104,556,44,600
公投第８案,宜蘭縣,蘇澳鎮,聖湖里,149,1154,469,115,584,68,652
公投第８案,宜蘭縣,蘇澳鎮,蘇西里,150,908,312,106,418,24,442
公投第８案,宜蘭縣,蘇澳鎮,蘇西里,151,656,255,77,332,32,364
公投第８案,宜蘭縣,蘇澳鎮,蘇西里,152,834,351,103,454,60,514
公投第８案,宜蘭縣,蘇澳鎮,蘇北里,153,1025,415,146,561,44,605
公投第８案,宜蘭縣,蘇澳鎮,蘇南里,154,455,165,78,243,21,264
公投第８案,宜蘭縣,蘇澳鎮,蘇東里,155,535,217,66,283,30,313
公投第８案,宜蘭縣,蘇澳鎮,長安里,156,536,244,61,305,32,337
公投第８案,宜蘭縣,蘇澳鎮,永光里,157,451,188,64,252,22,274
公投第８案,宜蘭縣,蘇澳鎮,永春里,158,593,216,78,294,36,330
公投第８案,宜蘭縣,蘇澳鎮,永樂里,159,441,175,39,214,33,247
公投第８案,宜蘭縣,蘇澳鎮,南安里,160,954,376,114,490,59,549
公投第８案,宜蘭縣,蘇澳鎮,南正里,161,952,355,91,446,72,518
公投第８案,宜蘭縣,蘇澳鎮,南成里,162,1125,364,142,506,82,588
公投第８案,宜蘭縣,蘇澳鎮,南興里,163,763,274,78,352,75,427
公投第８案,宜蘭縣,蘇澳鎮,南興里,164,706,204,61,265,50,315
公投第８案,宜蘭縣,蘇澳鎮,南寧里,165,1068,324,111,435,80,515
公投第８案,宜蘭縣,蘇澳鎮,南建里,166,666,234,85,319,69,388
公投第８案,宜蘭縣,蘇澳鎮,南建里,167,574,181,67,248,76,324
公投第８案,宜蘭縣,蘇澳鎮,東澳里,168,351,91,31,122,13,135
公投第８案,宜蘭縣,蘇澳鎮,南強里,169,717,309,41,350,55,405
公投第８案,宜蘭縣,蘇澳鎮,朝陽里,170,373,118,21,139,16,155
公投第８案,宜蘭縣,蘇澳鎮,朝陽里,171,223,54,24,78,14,92
公投第８案,宜蘭縣,頭城鎮,石城里,172,292,57,32,89,15,104
公投第８案,宜蘭縣,頭城鎮,大里里,173,688,249,67,316,52,368
公投第８案,宜蘭縣,頭城鎮,龜山里,174,688,260,88,348,48,396
公投第８案,宜蘭縣,頭城鎮,大溪里,175,879,269,115,384,59,443
公投第８案,宜蘭縣,頭城鎮,合興里,176,335,131,40,171,33,204
公投第８案,宜蘭縣,頭城鎮,更新里,177,624,252,101,353,40,393
公投第８案,宜蘭縣,頭城鎮,更新里,178,732,225,73,298,45,343
公投第８案,宜蘭縣,頭城鎮,外澳里,179,892,282,87,369,48,417
公投第８案,宜蘭縣,頭城鎮,港口里,180,690,218,66,284,29,313
公投第８案,宜蘭縣,頭城鎮,武營里,181,842,322,83,405,47,452
公投第８案,宜蘭縣,頭城鎮,武營里,182,736,283,90,373,37,410
公投第８案,宜蘭縣,頭城鎮,大坑里,183,788,276,79,355,39,394
公投第８案,宜蘭縣,頭城鎮,大坑里,184,560,188,66,254,32,286
公投第８案,宜蘭縣,頭城鎮,城東里,185,712,286,97,383,40,423
公投第８案,宜蘭縣,頭城鎮,城北里,186,502,222,61,283,38,321
公投第８案,宜蘭縣,頭城鎮,城西里,187,569,257,66,323,35,358
公投第８案,宜蘭縣,頭城鎮,城南里,188,633,252,69,321,40,361
公投第８案,宜蘭縣,頭城鎮,竹安里,189,1132,345,105,450,78,528
公投第８案,宜蘭縣,頭城鎮,竹安里,190,1035,347,97,444,51,495
公投第８案,宜蘭縣,頭城鎮,新建里,191,847,333,122,455,48,503
公投第８案,宜蘭縣,頭城鎮,新建里,192,1172,474,133,607,52,659
公投第８案,宜蘭縣,頭城鎮,拔雅里,193,896,344,85,429,36,465
公投第８案,宜蘭縣,頭城鎮,拔雅里,194,1075,476,118,594,30,624
公投第８案,宜蘭縣,頭城鎮,福成里,195,931,348,125,473,70,543
公投第８案,宜蘭縣,頭城鎮,金面里,196,1021,399,97,496,66,562
公投第８案,宜蘭縣,頭城鎮,金面里,197,709,219,70,289,58,347
公投第８案,宜蘭縣,頭城鎮,金盈里,198,689,305,87,392,50,442
公投第８案,宜蘭縣,頭城鎮,頂埔里,199,615,271,61,332,50,382
公投第８案,宜蘭縣,頭城鎮,頂埔里,200,759,282,76,358,57,415
公投第８案,宜蘭縣,頭城鎮,下埔里,201,917,381,113,494,69,563
公投第８案,宜蘭縣,頭城鎮,中崙里,202,1045,398,126,524,74,598
公投第８案,宜蘭縣,頭城鎮,二城里,203,1130,439,128,567,69,636
公投第８案,宜蘭縣,礁溪鄉,白雲村,204,1122,382,99,481,50,531
公投第８案,宜蘭縣,礁溪鄉,白雲村,205,505,186,51,237,29,266
公投第８案,宜蘭縣,礁溪鄉,玉石村,206,988,347,115,462,47,509
公投第８案,宜蘭縣,礁溪鄉,玉石村,207,971,377,96,473,40,513
公投第８案,宜蘭縣,礁溪鄉,德陽村,208,1246,427,138,565,52,617
公投第８案,宜蘭縣,礁溪鄉,德陽村,209,1655,558,173,731,48,779
公投第８案,宜蘭縣,礁溪鄉,德陽村,210,1132,376,99,475,37,512
公投第８案,宜蘭縣,礁溪鄉,大忠村,211,783,323,79,402,34,436
公投第８案,宜蘭縣,礁溪鄉,大忠村,212,928,342,116,458,40,498
公投第８案,宜蘭縣,礁溪鄉,大忠村,213,848,321,78,399,54,453
公投第８案,宜蘭縣,礁溪鄉,大義村,214,663,290,87,377,41,418
公投第８案,宜蘭縣,礁溪鄉,六結村,215,608,254,60,314,19,333
公投第８案,宜蘭縣,礁溪鄉,六結村,216,833,328,92,420,44,464
公投第８案,宜蘭縣,礁溪鄉,二龍村,217,1233,399,130,529,25,554
公投第８案,宜蘭縣,礁溪鄉,時潮村,218,854,331,99,430,49,479
公投第８案,宜蘭縣,礁溪鄉,時潮村,219,575,204,72,276,24,300
公投第８案,宜蘭縣,礁溪鄉,玉田村,220,835,303,114,417,49,466
公投第８案,宜蘭縣,礁溪鄉,玉田村,221,1305,518,156,674,69,743
公投第８案,宜蘭縣,礁溪鄉,三民村,222,830,315,96,411,48,459
公投第８案,宜蘭縣,礁溪鄉,三民村,223,649,274,98,372,55,427
公投第８案,宜蘭縣,礁溪鄉,三民村,224,923,306,88,394,48,442
公投第８案,宜蘭縣,礁溪鄉,林美村,225,1177,378,103,481,49,530
公投第８案,宜蘭縣,礁溪鄉,白鵝村,226,840,317,96,413,47,460
公投第８案,宜蘭縣,礁溪鄉,玉光村,227,1051,408,127,535,39,574
公投第８案,宜蘭縣,礁溪鄉,光武村,228,1339,466,132,598,57,655
公投第８案,宜蘭縣,礁溪鄉,吳沙村,229,1194,501,127,628,73,701
公投第８案,宜蘭縣,礁溪鄉,吳沙村,230,1314,497,183,680,94,774
公投第８案,宜蘭縣,礁溪鄉,龍潭村,231,1125,424,147,571,27,598
公投第８案,宜蘭縣,礁溪鄉,龍潭村,232,1207,505,140,645,74,719
公投第８案,宜蘭縣,礁溪鄉,龍潭村,233,979,361,125,486,62,548
公投第８案,宜蘭縣,礁溪鄉,匏崙村,234,954,388,129,517,68,585
公投第８案,宜蘭縣,礁溪鄉,二結村,235,418,146,65,211,11,222
公投第８案,宜蘭縣,壯圍鄉,吉祥村,236,1435,570,177,747,116,863
公投第８案,宜蘭縣,壯圍鄉,吉祥村,237,1049,412,149,561,63,624
公投第８案,宜蘭縣,壯圍鄉,古結村,238,1068,433,144,577,79,656
公投第８案,宜蘭縣,壯圍鄉,美福村,239,868,301,104,405,93,498
公投第８案,宜蘭縣,壯圍鄉,美福村,240,967,354,108,462,45,507
公投第８案,宜蘭縣,壯圍鄉,新南村,241,940,377,120,497,78,575
公投第８案,宜蘭縣,壯圍鄉,東港村,242,975,324,87,411,38,449
公投第８案,宜蘭縣,壯圍鄉,復興村,243,797,301,110,411,76,487
公投第８案,宜蘭縣,壯圍鄉,復興村,244,808,308,85,393,72,465
公投第８案,宜蘭縣,壯圍鄉,過嶺村,245,911,303,141,444,93,537
公投第８案,宜蘭縣,壯圍鄉,過嶺村,246,612,201,58,259,41,300
公投第８案,宜蘭縣,壯圍鄉,永鎮村,247,790,327,119,446,54,500
公投第８案,宜蘭縣,壯圍鄉,忠孝村,248,878,335,131,466,57,523
公投第８案,宜蘭縣,壯圍鄉,忠孝村,249,723,320,91,411,52,463
公投第８案,宜蘭縣,壯圍鄉,忠孝村,250,737,230,83,313,44,357
公投第８案,宜蘭縣,壯圍鄉,古亭村,251,686,249,96,345,68,413
公投第８案,宜蘭縣,壯圍鄉,古亭村,252,895,345,79,424,14,438
公投第８案,宜蘭縣,壯圍鄉,功勞村,253,1237,535,138,673,80,753
公投第８案,宜蘭縣,壯圍鄉,美城村,254,1134,453,119,572,78,650
公投第８案,宜蘭縣,壯圍鄉,美城村,255,1107,403,133,536,76,612
公投第８案,宜蘭縣,壯圍鄉,新社村,256,1057,434,124,558,38,596
公投第８案,宜蘭縣,壯圍鄉,大福村,257,1051,382,106,488,42,530
公投第８案,宜蘭縣,壯圍鄉,大福村,258,722,252,89,341,56,397
公投第８案,宜蘭縣,員山鄉,員山村,259,1393,542,133,675,29,704
公投第８案,宜蘭縣,員山鄉,員山村,260,895,344,89,433,27,460
公投第８案,宜蘭縣,員山鄉,員山村,261,1231,496,99,595,74,669
公投第８案,宜蘭縣,員山鄉,員山村,262,1098,419,97,516,40,556
公投第８案,宜蘭縣,員山鄉,員山村,263,1031,392,86,478,50,528
公投第８案,宜蘭縣,員山鄉,尚德村,264,1030,365,110,475,79,554
公投第８案,宜蘭縣,員山鄉,尚德村,265,1168,379,114,493,52,545
公投第８案,宜蘭縣,員山鄉,惠好村,266,809,288,95,383,74,457
公投第８案,宜蘭縣,員山鄉,惠好村,267,778,298,91,389,58,447
公投第８案,宜蘭縣,員山鄉,七賢村,268,1465,626,139,765,80,845
公投第８案,宜蘭縣,員山鄉,深溝村,269,979,395,131,526,52,578
公投第８案,宜蘭縣,員山鄉,深溝村,270,860,343,89,432,48,480
公投第８案,宜蘭縣,員山鄉,蓁巷村,271,1205,387,114,501,96,597
公投第８案,宜蘭縣,員山鄉,內城村,272,1082,409,111,520,92,612
公投第８案,宜蘭縣,員山鄉,內城村,273,412,152,54,206,37,243
公投第８案,宜蘭縣,員山鄉,中華村,274,403,115,50,165,20,185
公投第８案,宜蘭縣,員山鄉,中華村,275,232,60,29,89,15,104
公投第８案,宜蘭縣,員山鄉,永和村,276,944,330,107,437,68,505
公投第８案,宜蘭縣,員山鄉,永和村,277,894,326,104,430,63,493
公投第８案,宜蘭縣,員山鄉,頭分村,278,1356,506,155,661,91,752
公投第８案,宜蘭縣,員山鄉,枕山村,279,780,301,102,403,50,453
公投第８案,宜蘭縣,員山鄉,枕山村,280,932,339,157,496,94,590
公投第８案,宜蘭縣,員山鄉,枕山村,281,583,180,78,258,43,301
公投第８案,宜蘭縣,員山鄉,同樂村,282,900,333,92,425,77,502
公投第８案,宜蘭縣,員山鄉,同樂村,283,747,258,91,349,53,402
公投第８案,宜蘭縣,員山鄉,同樂村,284,788,299,74,373,58,431
公投第８案,宜蘭縣,員山鄉,湖東村,285,884,283,116,399,65,464
公投第８案,宜蘭縣,員山鄉,逸仙村,286,857,293,95,388,22,410
公投第８案,宜蘭縣,員山鄉,湖北村,287,1016,341,108,449,34,483
公投第８案,宜蘭縣,員山鄉,湖西村,288,690,196,64,260,45,305
公投第８案,宜蘭縣,員山鄉,湖西村,289,689,224,84,308,54,362
公投第８案,宜蘭縣,冬山鄉,珍珠村,290,807,329,104,433,54,487
公投第８案,宜蘭縣,冬山鄉,珍珠村,291,817,339,99,438,19,457
公投第８案,宜蘭縣,冬山鄉,補城村,292,1156,480,114,594,64,658
公投第８案,宜蘭縣,冬山鄉,三奇村,293,892,317,105,422,50,472
公投第８案,宜蘭縣,冬山鄉,大興村,294,897,360,125,485,44,529
公投第８案,宜蘭縣,冬山鄉,東城村,295,1392,583,181,764,62,826
公投第８案,宜蘭縣,冬山鄉,香和村,296,1471,623,163,786,51,837
公投第８案,宜蘭縣,冬山鄉,香和村,297,1435,454,135,589,44,633
公投第８案,宜蘭縣,冬山鄉,南興村,298,1519,560,165,725,43,768
公投第８案,宜蘭縣,冬山鄉,南興村,299,1456,634,152,786,29,815
公投第８案,宜蘭縣,冬山鄉,安平村,300,711,280,95,375,53,428
公投第８案,宜蘭縣,冬山鄉,冬山村,301,694,295,72,367,37,404
公投第８案,宜蘭縣,冬山鄉,太和村,302,1526,678,207,885,67,952
公投第８案,宜蘭縣,冬山鄉,八寶村,303,884,435,4,439,34,473
公投第８案,宜蘭縣,冬山鄉,丸山村,304,1465,504,43,547,68,615
公投第８案,宜蘭縣,冬山鄉,中山村,305,488,184,52,236,40,276
公投第８案,宜蘭縣,冬山鄉,順安村,306,1218,467,126,593,53,646
公投第８案,宜蘭縣,冬山鄉,順安村,307,1291,470,134,604,52,656
公投第８案,宜蘭縣,冬山鄉,順安村,308,1324,490,135,625,37,662
公投第８案,宜蘭縣,冬山鄉,順安村,309,1160,407,115,522,50,572
公投第８案,宜蘭縣,冬山鄉,永美村,310,1246,479,121,600,58,658
公投第８案,宜蘭縣,冬山鄉,永美村,311,1754,649,187,836,38,874
公投第８案,宜蘭縣,冬山鄉,武淵村,312,1217,451,131,582,60,642
公投第８案,宜蘭縣,冬山鄉,群英村,313,1495,532,135,667,51,718
公投第８案,宜蘭縣,冬山鄉,群英村,314,937,356,113,469,41,510
公投第８案,宜蘭縣,冬山鄉,群英村,315,1101,384,125,509,39,548
公投第８案,宜蘭縣,冬山鄉,群英村,316,1118,394,120,514,67,581
公投第８案,宜蘭縣,冬山鄉,清溝村,317,1301,558,148,706,46,752
公投第８案,宜蘭縣,冬山鄉,清溝村,318,1225,469,128,597,28,625
公投第８案,宜蘭縣,冬山鄉,清溝村,319,1206,487,163,650,50,700
公投第８案,宜蘭縣,冬山鄉,鹿埔村,320,1278,439,145,584,38,622
公投第８案,宜蘭縣,冬山鄉,鹿埔村,321,1151,418,125,543,51,594
公投第８案,宜蘭縣,冬山鄉,得安村,322,1094,384,98,482,58,540
公投第８案,宜蘭縣,冬山鄉,廣興村,323,1247,499,157,656,50,706
公投第８案,宜蘭縣,冬山鄉,廣興村,324,1247,434,138,572,55,627
公投第８案,宜蘭縣,冬山鄉,廣安村,325,979,389,107,496,33,529
公投第８案,宜蘭縣,冬山鄉,廣安村,326,698,314,86,400,24,424
公投第８案,宜蘭縣,冬山鄉,柯林村,327,1726,637,175,812,51,863
公投第８案,宜蘭縣,冬山鄉,大進村,328,782,245,73,318,15,333
公投第８案,宜蘭縣,五結鄉,三興村,329,1076,372,118,490,60,550
公投第８案,宜蘭縣,五結鄉,三興村,330,944,340,111,451,31,482
公投第８案,宜蘭縣,五結鄉,二結村,331,836,349,76,425,25,450
公投第８案,宜蘭縣,五結鄉,二結村,332,937,364,116,480,50,530
公投第８案,宜蘭縣,五結鄉,鎮安村,333,1255,468,143,611,41,652
公投第８案,宜蘭縣,五結鄉,鎮安村,334,1270,446,163,609,76,685
公投第８案,宜蘭縣,五結鄉,上四村,335,801,282,81,363,31,394
公投第８案,宜蘭縣,五結鄉,上四村,336,802,300,74,374,43,417
公投第８案,宜蘭縣,五結鄉,中興村,337,1306,476,121,597,49,646
公投第８案,宜蘭縣,五結鄉,四結村,338,1190,455,116,571,55,626
公投第８案,宜蘭縣,五結鄉,四結村,339,1316,547,99,646,25,671
公投第８案,宜蘭縣,五結鄉,福興村,340,965,386,106,492,26,518
公投第８案,宜蘭縣,五結鄉,福興村,341,814,317,79,396,39,435
公投第８案,宜蘭縣,五結鄉,五結村,342,1254,460,129,589,52,641
公投第８案,宜蘭縣,五結鄉,五結村,343,1060,418,117,535,69,604
公投第８案,宜蘭縣,五結鄉,五結村,344,1323,540,150,690,37,727
公投第８案,宜蘭縣,五結鄉,協和村,345,1120,448,142,590,46,636
公投第８案,宜蘭縣,五結鄉,協和村,346,893,361,82,443,29,472
公投第８案,宜蘭縣,五結鄉,協和村,347,1220,444,150,594,49,643
公投第８案,宜蘭縣,五結鄉,大吉村,348,924,412,96,508,28,536
公投第８案,宜蘭縣,五結鄉,大吉村,349,933,399,112,511,50,561
公投第８案,宜蘭縣,五結鄉,大吉村,350,986,407,86,493,35,528
公投第８案,宜蘭縣,五結鄉,大吉村,351,748,290,78,368,40,408
公投第８案,宜蘭縣,五結鄉,孝威村,352,1550,581,165,746,86,832
公投第８案,宜蘭縣,五結鄉,錦眾村,353,629,249,75,324,30,354
公投第８案,宜蘭縣,五結鄉,錦眾村,354,806,322,80,402,37,439
公投第８案,宜蘭縣,五結鄉,利澤村,355,956,309,139,448,49,497
公投第８案,宜蘭縣,五結鄉,利澤村,356,1066,406,109,515,50,565
公投第８案,宜蘭縣,五結鄉,成興村,357,1513,517,145,662,86,748
公投第８案,宜蘭縣,五結鄉,成興村,358,1566,580,186,766,56,822
公投第８案,宜蘭縣,五結鄉,季新村,359,894,327,102,429,66,495
公投第８案,宜蘭縣,五結鄉,季新村,360,1235,364,137,501,79,580
公投第８案,宜蘭縣,五結鄉,季新村,361,704,259,85,344,52,396
公投第８案,宜蘭縣,三星鄉,員山村,362,215,70,28,98,16,114
公投第８案,宜蘭縣,三星鄉,天山村,363,523,154,53,207,34,241
公投第８案,宜蘭縣,三星鄉,天福村,364,745,231,112,343,47,390
公投第８案,宜蘭縣,三星鄉,萬德村,365,617,189,74,263,41,304
公投第８案,宜蘭縣,三星鄉,貴林村,366,497,151,69,220,43,263
公投第８案,宜蘭縣,三星鄉,萬富村,367,735,254,100,354,57,411
公投第８案,宜蘭縣,三星鄉,雙賢村,368,583,209,59,268,56,324
公投第８案,宜蘭縣,三星鄉,人和村,369,436,162,41,203,31,234
公投第８案,宜蘭縣,三星鄉,義德村,370,1224,449,122,571,65,636
公投第８案,宜蘭縣,三星鄉,集慶村,371,1151,384,112,496,48,544
公投第８案,宜蘭縣,三星鄉,月眉村,372,870,344,91,435,42,477
公投第８案,宜蘭縣,三星鄉,拱照村,373,1284,378,105,483,50,533
公投第８案,宜蘭縣,三星鄉,行健村,374,897,365,113,478,52,530
公投第８案,宜蘭縣,三星鄉,大隱村,375,1439,559,153,712,61,773
公投第８案,宜蘭縣,三星鄉,大隱村,376,1445,516,159,675,60,735
公投第８案,宜蘭縣,三星鄉,大隱村,377,1402,540,155,695,34,729
公投第８案,宜蘭縣,三星鄉,大義村,378,1230,428,157,585,55,640
公投第８案,宜蘭縣,三星鄉,尚武村,379,774,276,97,373,59,432
公投第８案,宜蘭縣,三星鄉,大洲村,380,827,330,97,427,50,477
公投第８案,宜蘭縣,三星鄉,大洲村,381,736,261,88,349,40,389
公投第８案,宜蘭縣,三星鄉,尾塹村,382,1421,474,134,608,88,696
公投第８案,宜蘭縣,大同鄉,寒溪村,383,893,229,80,309,49,358
公投第８案,宜蘭縣,大同鄉,崙埤村,384,632,333,73,406,52,458
公投第８案,宜蘭縣,大同鄉,松羅村,385,684,221,54,275,19,294
公投第８案,宜蘭縣,大同鄉,復興村,386,264,112,31,143,31,174
公投第８案,宜蘭縣,大同鄉,英士村,387,337,97,12,109,5,114
公投第８案,宜蘭縣,大同鄉,樂水村,388,404,99,31,130,10,140
公投第８案,宜蘭縣,大同鄉,太平村,389,55,14,7,21,5,26
公投第８案,宜蘭縣,大同鄉,茂安村,390,199,75,52,127,26,153
公投第８案,宜蘭縣,大同鄉,四季村,391,787,184,47,231,17,248
公投第８案,宜蘭縣,大同鄉,南山村,392,680,217,84,301,59,360
公投第８案,宜蘭縣,南澳鄉,東岳村,393,444,178,34,212,12,224
公投第８案,宜蘭縣,南澳鄉,南澳村,394,1210,488,78,566,25,591
公投第８案,宜蘭縣,南澳鄉,碧候村,395,962,418,83,501,82,583
公投第８案,宜蘭縣,南澳鄉,金岳村,396,411,114,30,144,7,151
公投第８案,宜蘭縣,南澳鄉,武塔村,397,447,237,50,287,21,308
公投第８案,宜蘭縣,南澳鄉,金洋村,398,475,248,77,325,43,368
公投第８案,宜蘭縣,南澳鄉,澳花村,399,695,304,70,374,37,411
公投第８案,新竹縣,竹北市,鹿場里,1,1319,643,178,821,33,854
公投第８案,新竹縣,竹北市,鹿場里,2,1321,575,189,764,37,801
公投第８案,新竹縣,竹北市,鹿場里,3,1272,593,163,756,47,803
公投第８案,新竹縣,竹北市,鹿場里,4,1467,657,150,807,34,841
公投第８案,新竹縣,竹北市,鹿場里,5,1226,488,179,667,24,691
公投第８案,新竹縣,竹北市,鹿場里,6,1412,598,180,778,18,796
公投第８案,新竹縣,竹北市,鹿場里,7,1400,674,189,863,12,875
公投第８案,新竹縣,竹北市,東平里,8,1415,645,203,848,29,877
公投第８案,新竹縣,竹北市,東平里,9,1361,589,169,758,31,789
公投第８案,新竹縣,竹北市,東平里,10,1515,617,187,804,20,824
公投第８案,新竹縣,竹北市,東平里,11,1495,654,200,854,32,886
公投第８案,新竹縣,竹北市,東平里,12,1417,589,211,800,38,838
公投第８案,新竹縣,竹北市,東平里,13,1548,618,222,840,42,882
公投第８案,新竹縣,竹北市,東平里,14,1434,544,200,744,32,776
公投第８案,新竹縣,竹北市,中興里,15,1385,625,151,776,37,813
公投第８案,新竹縣,竹北市,中興里,16,1247,602,145,747,45,792
公投第８案,新竹縣,竹北市,中興里,17,1373,572,196,768,29,797
公投第８案,新竹縣,竹北市,中興里,18,1345,624,204,828,29,857
公投第８案,新竹縣,竹北市,中興里,19,1165,520,109,629,40,669
公投第８案,新竹縣,竹北市,隘口里,20,1164,547,158,705,40,745
公投第８案,新竹縣,竹北市,隘口里,21,1212,544,170,714,40,754
公投第８案,新竹縣,竹北市,東海里,22,1507,578,149,727,32,759
公投第８案,新竹縣,竹北市,東海里,23,1576,648,123,771,44,815
公投第８案,新竹縣,竹北市,東興里,24,1464,633,165,798,30,828
公投第８案,新竹縣,竹北市,東興里,25,1428,604,180,784,28,812
公投第８案,新竹縣,竹北市,東興里,26,1442,533,177,710,21,731
公投第８案,新竹縣,竹北市,東興里,27,1415,615,160,775,67,842
公投第８案,新竹縣,竹北市,北興里,28,1666,641,181,822,26,848
公投第８案,新竹縣,竹北市,北興里,29,1751,669,216,885,52,937
公投第８案,新竹縣,竹北市,十興里,30,1196,548,153,701,32,733
公投第８案,新竹縣,竹北市,十興里,31,1235,560,156,716,26,742
公投第８案,新竹縣,竹北市,十興里,32,1204,516,143,659,24,683
公投第８案,新竹縣,竹北市,十興里,33,1308,616,151,767,26,793
公投第８案,新竹縣,竹北市,十興里,34,1233,527,158,685,19,704
公投第８案,新竹縣,竹北市,興安里,35,1129,515,139,654,18,672
公投第８案,新竹縣,竹北市,興安里,36,1069,516,116,632,29,661
公投第８案,新竹縣,竹北市,興安里,37,1114,545,123,668,43,711
公投第８案,新竹縣,竹北市,文化里,38,1103,491,148,639,27,666
公投第８案,新竹縣,竹北市,文化里,39,1029,507,128,635,35,670
公投第８案,新竹縣,竹北市,文化里,40,1133,545,144,689,36,725
公投第８案,新竹縣,竹北市,斗崙里,41,1301,570,155,725,31,756
公投第８案,新竹縣,竹北市,斗崙里,42,1798,789,210,999,49,1048
公投第８案,新竹縣,竹北市,斗崙里,43,1427,620,188,808,40,848
公投第８案,新竹縣,竹北市,斗崙里,44,1462,701,165,866,40,906
公投第８案,新竹縣,竹北市,中崙里,45,1342,631,173,804,36,840
公投第８案,新竹縣,竹北市,中崙里,46,1480,705,164,869,30,899
公投第８案,新竹縣,竹北市,中崙里,47,1645,724,173,897,31,928
公投第８案,新竹縣,竹北市,中崙里,48,1256,612,162,774,29,803
公投第８案,新竹縣,竹北市,北崙里,49,1181,523,163,686,35,721
公投第８案,新竹縣,竹北市,北崙里,50,1329,656,159,815,40,855
公投第８案,新竹縣,竹北市,北崙里,51,1228,606,147,753,25,778
公投第８案,新竹縣,竹北市,新崙里,52,1552,638,203,841,35,876
公投第８案,新竹縣,竹北市,新崙里,53,1480,670,190,860,33,893
公投第８案,新竹縣,竹北市,新崙里,54,1487,582,187,769,32,801
公投第８案,新竹縣,竹北市,新崙里,55,1470,574,193,767,41,808
公投第８案,新竹縣,竹北市,竹北里,56,1477,586,162,748,37,785
公投第８案,新竹縣,竹北市,竹北里,57,1611,708,196,904,63,967
公投第８案,新竹縣,竹北市,竹北里,58,1555,662,171,833,74,907
公投第８案,新竹縣,竹北市,竹北里,59,1468,598,158,756,45,801
公投第８案,新竹縣,竹北市,竹仁里,60,1509,650,187,837,58,895
公投第８案,新竹縣,竹北市,竹仁里,61,1602,653,186,839,45,884
公投第８案,新竹縣,竹北市,竹仁里,62,1448,639,168,807,59,866
公投第８案,新竹縣,竹北市,竹仁里,63,1318,577,150,727,69,796
公投第８案,新竹縣,竹北市,竹仁里,64,1634,764,181,945,55,1000
公投第８案,新竹縣,竹北市,竹仁里,65,1345,539,171,710,63,773
公投第８案,新竹縣,竹北市,福德里,66,958,461,108,569,38,607
公投第８案,新竹縣,竹北市,福德里,67,1112,524,138,662,40,702
公投第８案,新竹縣,竹北市,福德里,68,1134,452,149,601,68,669
公投第８案,新竹縣,竹北市,竹義里,69,1483,654,162,816,38,854
公投第８案,新竹縣,竹北市,竹義里,70,1332,562,147,709,42,751
公投第８案,新竹縣,竹北市,竹義里,71,1482,571,150,721,41,762
公投第８案,新竹縣,竹北市,竹義里,72,1449,453,138,591,26,617
公投第８案,新竹縣,竹北市,泰和里,73,1319,560,128,688,31,719
公投第８案,新竹縣,竹北市,泰和里,74,1332,538,145,683,42,725
公投第８案,新竹縣,竹北市,泰和里,75,1412,543,168,711,39,750
公投第８案,新竹縣,竹北市,泰和里,76,1640,660,163,823,55,878
公投第８案,新竹縣,竹北市,新社里,77,1323,563,155,718,37,755
公投第８案,新竹縣,竹北市,新社里,78,1428,721,76,797,57,854
公投第８案,新竹縣,竹北市,新社里,79,1533,664,172,836,57,893
公投第８案,新竹縣,竹北市,新社里,80,1346,524,144,668,28,696
公投第８案,新竹縣,竹北市,新社里,81,1219,495,126,621,48,669
公投第８案,新竹縣,竹北市,新國里,82,1466,647,172,819,73,892
公投第８案,新竹縣,竹北市,新國里,83,1147,458,132,590,39,629
公投第８案,新竹縣,竹北市,新國里,84,1529,557,157,714,39,753
公投第８案,新竹縣,竹北市,新國里,85,1522,654,167,821,57,878
公投第８案,新竹縣,竹北市,聯興里,86,1383,625,161,786,44,830
公投第８案,新竹縣,竹北市,聯興里,87,1569,642,211,853,42,895
公投第８案,新竹縣,竹北市,聯興里,88,1506,604,154,758,24,782
公投第８案,新竹縣,竹北市,麻園里,89,877,364,106,470,36,506
公投第８案,新竹縣,竹北市,麻園里,90,1074,465,117,582,44,626
公投第８案,新竹縣,竹北市,溪州里,91,1089,513,148,661,42,703
公投第８案,新竹縣,竹北市,溪州里,92,1336,570,162,732,61,793
公投第８案,新竹縣,竹北市,新庄里,93,1058,412,119,531,72,603
公投第８案,新竹縣,竹北市,白地里,94,937,445,123,568,57,625
公投第８案,新竹縣,竹北市,白地里,95,1206,500,149,649,40,689
公投第８案,新竹縣,竹北市,新港里,96,1205,478,154,632,49,681
公投第８案,新竹縣,竹北市,大眉里,97,1718,733,225,958,70,1028
公投第８案,新竹縣,竹北市,大義里,98,917,350,124,474,50,524
公投第８案,新竹縣,竹北市,大義里,99,668,273,95,368,34,402
公投第８案,新竹縣,竹北市,尚義里,100,824,312,100,412,42,454
公投第８案,新竹縣,竹北市,尚義里,101,782,316,74,390,74,464
公投第８案,新竹縣,竹北市,崇義里,102,977,404,118,522,71,593
公投第８案,新竹縣,竹北市,崇義里,103,937,318,104,422,22,444
公投第８案,新竹縣,竹東鎮,上坪里,104,309,112,29,141,11,152
公投第８案,新竹縣,竹東鎮,瑞峰里,105,416,134,54,188,27,215
公投第８案,新竹縣,竹東鎮,軟橋里,106,386,143,39,182,10,192
公投第８案,新竹縣,竹東鎮,員崠里,107,950,356,90,446,22,468
公投第８案,新竹縣,竹東鎮,員崠里,108,1275,531,110,641,17,658
公投第８案,新竹縣,竹東鎮,上舘里,109,1213,481,137,618,39,657
公投第８案,新竹縣,竹東鎮,上舘里,110,1548,659,152,811,51,862
公投第８案,新竹縣,竹東鎮,上舘里,111,1246,481,101,582,36,618
公投第８案,新竹縣,竹東鎮,上舘里,112,1252,426,105,531,44,575
公投第８案,新竹縣,竹東鎮,上舘里,113,1359,531,129,660,58,718
公投第８案,新竹縣,竹東鎮,上舘里,114,1255,485,141,626,44,670
公投第８案,新竹縣,竹東鎮,上舘里,115,1304,584,130,714,35,749
公投第８案,新竹縣,竹東鎮,東寧里,116,1292,544,138,682,46,728
公投第８案,新竹縣,竹東鎮,東寧里,117,1111,441,102,543,11,554
公投第８案,新竹縣,竹東鎮,東寧里,118,880,392,86,478,43,521
公投第８案,新竹縣,竹東鎮,中正里,119,670,289,81,370,22,392
公投第８案,新竹縣,竹東鎮,中正里,120,1244,553,130,683,42,725
公投第８案,新竹縣,竹東鎮,大鄉里,121,1126,447,108,555,52,607
公投第８案,新竹縣,竹東鎮,大鄉里,122,1073,442,107,549,40,589
公投第８案,新竹縣,竹東鎮,大鄉里,123,1215,494,155,649,45,694
公投第８案,新竹縣,竹東鎮,大鄉里,124,1155,533,110,643,17,660
公投第８案,新竹縣,竹東鎮,中山里,125,852,335,106,441,43,484
公投第８案,新竹縣,竹東鎮,中山里,126,875,368,116,484,42,526
公投第８案,新竹縣,竹東鎮,南華里,127,1070,473,137,610,44,654
公投第８案,新竹縣,竹東鎮,東華里,128,704,272,81,353,25,378
公投第８案,新竹縣,竹東鎮,商華里,129,951,280,71,351,31,382
公投第８案,新竹縣,竹東鎮,商華里,130,984,419,115,534,23,557
公投第８案,新竹縣,竹東鎮,商華里,131,1113,364,90,454,19,473
公投第８案,新竹縣,竹東鎮,竹東里,132,595,247,83,330,26,356
公投第８案,新竹縣,竹東鎮,竹東里,133,762,317,102,419,47,466
公投第８案,新竹縣,竹東鎮,忠孝里,134,763,313,83,396,25,421
公投第８案,新竹縣,竹東鎮,忠孝里,135,813,294,104,398,22,420
公投第８案,新竹縣,竹東鎮,鷄林里,136,1310,461,124,585,32,617
公投第８案,新竹縣,竹東鎮,鷄林里,137,1434,520,136,656,48,704
公投第８案,新竹縣,竹東鎮,鷄林里,138,1131,477,140,617,33,650
公投第８案,新竹縣,竹東鎮,仁愛里,139,967,401,106,507,21,528
公投第８案,新竹縣,竹東鎮,仁愛里,140,1196,436,134,570,42,612
公投第８案,新竹縣,竹東鎮,仁愛里,141,1154,486,127,613,41,654
公投第８案,新竹縣,竹東鎮,榮樂里,142,715,301,99,400,39,439
公投第８案,新竹縣,竹東鎮,榮樂里,143,685,296,75,371,13,384
公投第８案,新竹縣,竹東鎮,榮華里,144,1352,535,133,668,50,718
公投第８案,新竹縣,竹東鎮,榮華里,145,1407,598,143,741,64,805
公投第８案,新竹縣,竹東鎮,榮華里,146,1362,563,134,697,32,729
公投第８案,新竹縣,竹東鎮,榮華里,147,1330,565,138,703,47,750
公投第８案,新竹縣,竹東鎮,榮華里,148,1441,556,164,720,61,781
公投第８案,新竹縣,竹東鎮,五豐里,149,1248,477,130,607,18,625
公投第８案,新竹縣,竹東鎮,五豐里,150,1263,407,127,534,31,565
公投第８案,新竹縣,竹東鎮,五豐里,151,1232,447,115,562,28,590
公投第８案,新竹縣,竹東鎮,五豐里,152,1143,411,104,515,26,541
公投第８案,新竹縣,竹東鎮,五豐里,153,1529,641,152,793,36,829
公投第８案,新竹縣,竹東鎮,五豐里,154,1140,465,119,584,42,626
公投第８案,新竹縣,竹東鎮,陸豐里,155,570,257,80,337,27,364
公投第８案,新竹縣,竹東鎮,三重里,156,1345,491,129,620,36,656
公投第８案,新竹縣,竹東鎮,三重里,157,1381,521,145,666,66,732
公投第８案,新竹縣,竹東鎮,三重里,158,1379,537,157,694,62,756
公投第８案,新竹縣,竹東鎮,三重里,159,1033,436,111,547,53,600
公投第８案,新竹縣,竹東鎮,三重里,160,1066,444,99,543,38,581
公投第８案,新竹縣,竹東鎮,二重里,161,938,395,112,507,47,554
公投第８案,新竹縣,竹東鎮,二重里,162,952,430,109,539,47,586
公投第８案,新竹縣,竹東鎮,二重里,163,1468,682,162,844,41,885
公投第８案,新竹縣,竹東鎮,二重里,164,1915,708,225,933,40,973
公投第８案,新竹縣,竹東鎮,二重里,165,1220,479,112,591,40,631
公投第８案,新竹縣,竹東鎮,二重里,166,1166,406,104,510,21,531
公投第８案,新竹縣,竹東鎮,二重里,167,1492,537,145,682,30,712
公投第８案,新竹縣,竹東鎮,二重里,168,1245,438,172,610,42,652
公投第８案,新竹縣,竹東鎮,頭重里,169,1083,445,139,584,37,621
公投第８案,新竹縣,竹東鎮,頭重里,170,1102,437,131,568,35,603
公投第８案,新竹縣,竹東鎮,頭重里,171,1068,454,106,560,19,579
公投第８案,新竹縣,竹東鎮,頭重里,172,1097,450,145,595,30,625
公投第８案,新竹縣,竹東鎮,員山里,173,962,366,93,459,19,478
公投第８案,新竹縣,竹東鎮,員山里,174,909,366,126,492,26,518
公投第８案,新竹縣,竹東鎮,柯湖里,175,603,213,57,270,32,302
公投第８案,新竹縣,新埔鎮,新埔里,176,983,444,101,545,41,586
公投第８案,新竹縣,新埔鎮,新生里,177,597,233,97,330,39,369
公投第８案,新竹縣,新埔鎮,新民里,178,1070,454,111,565,25,590
公投第８案,新竹縣,新埔鎮,田新里,179,935,389,97,486,38,524
公投第８案,新竹縣,新埔鎮,田新里,180,753,298,96,394,38,432
公投第８案,新竹縣,新埔鎮,田新里,181,838,412,114,526,26,552
公投第８案,新竹縣,新埔鎮,旱坑里,182,924,392,87,479,33,512
公投第８案,新竹縣,新埔鎮,旱坑里,183,905,335,82,417,31,448
公投第８案,新竹縣,新埔鎮,五埔里,184,948,401,107,508,28,536
公投第８案,新竹縣,新埔鎮,五埔里,185,1017,433,110,543,46,589
公投第８案,新竹縣,新埔鎮,四座里,186,1176,533,137,670,44,714
公投第８案,新竹縣,新埔鎮,四座里,187,1122,478,160,638,60,698
公投第８案,新竹縣,新埔鎮,四座里,188,1022,341,92,433,22,455
公投第８案,新竹縣,新埔鎮,照門里,189,1429,518,151,669,49,718
公投第８案,新竹縣,新埔鎮,清水里,190,451,204,59,263,42,305
公投第８案,新竹縣,新埔鎮,鹿鳴里,191,724,279,100,379,31,410
公投第８案,新竹縣,新埔鎮,新北里,192,617,262,87,349,43,392
公投第８案,新竹縣,新埔鎮,巨埔里,193,1144,490,128,618,60,678
公投第８案,新竹縣,新埔鎮,內立里,194,1139,472,140,612,44,656
公投第８案,新竹縣,新埔鎮,寶石里,195,861,366,89,455,22,477
公投第８案,新竹縣,新埔鎮,文山里,196,1093,414,99,513,45,558
公投第８案,新竹縣,新埔鎮,文山里,197,978,367,101,468,37,505
公投第８案,新竹縣,新埔鎮,文山里,198,1040,377,100,477,31,508
公投第８案,新竹縣,新埔鎮,文山里,199,1160,445,131,576,44,620
公投第８案,新竹縣,新埔鎮,上寮里,200,950,439,110,549,26,575
公投第８案,新竹縣,新埔鎮,上寮里,201,882,380,86,466,31,497
公投第８案,新竹縣,新埔鎮,下寮里,202,1281,526,148,674,65,739
公投第８案,新竹縣,新埔鎮,下寮里,203,1212,469,128,597,54,651
公投第８案,新竹縣,新埔鎮,南平里,204,1013,354,87,441,42,483
公投第８案,新竹縣,新埔鎮,北平里,205,630,281,88,369,33,402
公投第８案,新竹縣,關西鎮,東興里,206,480,231,47,278,29,307
公投第８案,新竹縣,關西鎮,西安里,207,903,388,111,499,42,541
公投第８案,新竹縣,關西鎮,西安里,208,1020,442,112,554,40,594
公投第８案,新竹縣,關西鎮,南雄里,209,705,273,84,357,20,377
公投第８案,新竹縣,關西鎮,北斗里,210,1056,420,125,545,33,578
公投第８案,新竹縣,關西鎮,北斗里,211,1275,506,143,649,47,696
公投第８案,新竹縣,關西鎮,北斗里,212,1287,574,127,701,53,754
公投第８案,新竹縣,關西鎮,北山里,213,771,333,104,437,29,466
公投第８案,新竹縣,關西鎮,仁安里,214,1046,417,109,526,43,569
公投第８案,新竹縣,關西鎮,南山里,215,1030,427,127,554,48,602
公投第８案,新竹縣,關西鎮,東安里,216,1208,534,109,643,45,688
公投第８案,新竹縣,關西鎮,東安里,217,1095,418,91,509,21,530
公投第８案,新竹縣,關西鎮,東安里,218,1350,500,156,656,55,711
公投第８案,新竹縣,關西鎮,東山里,219,846,409,101,510,27,537
公投第８案,新竹縣,關西鎮,東光里,220,1362,529,145,674,69,743
公投第８案,新竹縣,關西鎮,南新里,221,903,326,88,414,28,442
公投第８案,新竹縣,關西鎮,新富里,222,551,193,54,247,22,269
公投第８案,新竹縣,關西鎮,玉山里,223,461,137,35,172,19,191
公投第８案,新竹縣,關西鎮,金山里,224,572,233,56,289,30,319
公投第８案,新竹縣,關西鎮,錦山里,225,943,358,120,478,29,507
公投第８案,新竹縣,關西鎮,大同里,226,808,316,105,421,47,468
公投第８案,新竹縣,關西鎮,石光里,227,923,449,111,560,23,583
公投第８案,新竹縣,關西鎮,石光里,228,903,395,102,497,38,535
公投第８案,新竹縣,關西鎮,東平里,229,977,420,112,532,43,575
公投第８案,新竹縣,關西鎮,上林里,230,824,352,112,464,38,502
公投第８案,新竹縣,關西鎮,新力里,231,559,260,65,325,17,342
公投第８案,新竹縣,關西鎮,南和里,232,854,400,103,503,31,534
公投第８案,新竹縣,湖口鄉,和興村,233,1393,488,171,659,44,703
公投第８案,新竹縣,湖口鄉,和興村,234,1505,625,204,829,48,877
公投第８案,新竹縣,湖口鄉,東興村,235,1188,545,168,713,43,756
公投第８案,新竹縣,湖口鄉,東興村,236,1267,512,167,679,50,729
公投第８案,新竹縣,湖口鄉,東興村,237,1668,709,184,893,40,933
公投第８案,新竹縣,湖口鄉,德盛村,238,1719,728,201,929,68,997
公投第８案,新竹縣,湖口鄉,德盛村,239,1162,538,136,674,49,723
公投第８案,新竹縣,湖口鄉,德盛村,240,1833,692,184,876,51,927
公投第８案,新竹縣,湖口鄉,愛勢村,241,1444,684,89,773,54,827
公投第８案,新竹縣,湖口鄉,愛勢村,242,1347,607,155,762,70,832
公投第８案,新竹縣,湖口鄉,愛勢村,243,1202,539,128,667,19,686
公投第８案,新竹縣,湖口鄉,仁勢村,244,851,368,98,466,44,510
公投第８案,新竹縣,湖口鄉,孝勢村,245,1272,552,165,717,61,778
公投第８案,新竹縣,湖口鄉,中勢村,246,1275,513,161,674,49,723
公投第８案,新竹縣,湖口鄉,中勢村,247,1560,705,198,903,56,959
公投第８案,新竹縣,湖口鄉,中正村,248,1147,505,134,639,92,731
公投第８案,新竹縣,湖口鄉,中正村,249,1729,747,172,919,58,977
公投第８案,新竹縣,湖口鄉,信勢村,250,1402,552,154,706,46,752
公投第８案,新竹縣,湖口鄉,信勢村,251,1183,511,135,646,61,707
公投第８案,新竹縣,湖口鄉,信勢村,252,1282,591,148,739,42,781
公投第８案,新竹縣,湖口鄉,信勢村,253,1335,588,173,761,47,808
公投第８案,新竹縣,湖口鄉,信義村,254,1493,691,188,879,48,927
公投第８案,新竹縣,湖口鄉,信義村,255,1877,803,160,963,25,988
公投第８案,新竹縣,湖口鄉,波羅村,256,1082,505,130,635,36,671
公投第８案,新竹縣,湖口鄉,波羅村,257,1115,461,159,620,66,686
公投第８案,新竹縣,湖口鄉,長嶺村,258,1193,422,132,554,43,597
公投第８案,新竹縣,湖口鄉,長嶺村,259,1947,757,195,952,52,1004
公投第８案,新竹縣,湖口鄉,長安村,260,1125,468,156,624,49,673
公投第８案,新竹縣,湖口鄉,湖口村,261,1050,421,139,560,48,608
公投第８案,新竹縣,湖口鄉,湖口村,262,1733,738,206,944,52,996
公投第８案,新竹縣,湖口鄉,湖鏡村,263,1284,564,149,713,44,757
公投第８案,新竹縣,湖口鄉,湖鏡村,264,1062,486,114,600,31,631
公投第８案,新竹縣,湖口鄉,湖南村,265,1547,669,152,821,56,877
公投第８案,新竹縣,湖口鄉,中興村,266,1494,552,142,694,47,741
公投第８案,新竹縣,湖口鄉,中興村,267,1634,603,147,750,31,781
公投第８案,新竹縣,湖口鄉,中興村,268,1444,531,114,645,21,666
公投第８案,新竹縣,湖口鄉,中興村,269,1324,523,145,668,27,695
公投第８案,新竹縣,湖口鄉,鳳凰村,270,1058,453,109,562,39,601
公投第８案,新竹縣,湖口鄉,鳳凰村,271,1220,380,106,486,22,508
公投第８案,新竹縣,湖口鄉,鳳凰村,272,1333,556,153,709,39,748
公投第８案,新竹縣,湖口鄉,鳳凰村,273,1461,567,142,709,57,766
公投第８案,新竹縣,湖口鄉,勝利村,274,1429,554,162,716,28,744
公投第８案,新竹縣,湖口鄉,勝利村,275,1506,539,138,677,25,702
公投第８案,新竹縣,湖口鄉,勝利村,276,1103,510,114,624,41,665
公投第８案,新竹縣,湖口鄉,鳳山村,277,1495,528,173,701,40,741
公投第８案,新竹縣,湖口鄉,鳳山村,278,752,310,85,395,38,433
公投第８案,新竹縣,湖口鄉,鳳山村,279,986,414,104,518,27,545
公投第８案,新竹縣,新豐鄉,福興村,280,1080,400,115,515,62,577
公投第８案,新竹縣,新豐鄉,青埔村,281,887,334,102,436,34,470
公投第８案,新竹縣,新豐鄉,青埔村,282,954,381,119,500,34,534
公投第８案,新竹縣,新豐鄉,中崙村,283,1003,388,123,511,38,549
公投第８案,新竹縣,新豐鄉,中崙村,284,1106,441,116,557,47,604
公投第８案,新竹縣,新豐鄉,中崙村,285,1123,475,147,622,39,661
公投第８案,新竹縣,新豐鄉,瑞興村,286,891,359,117,476,50,526
公投第８案,新竹縣,新豐鄉,瑞興村,287,874,316,95,411,29,440
公投第８案,新竹縣,新豐鄉,後湖村,288,824,327,94,421,35,456
公投第８案,新竹縣,新豐鄉,後湖村,289,975,363,94,457,32,489
公投第８案,新竹縣,新豐鄉,坡頭村,290,847,308,106,414,58,472
公投第８案,新竹縣,新豐鄉,埔和村,291,1477,564,174,738,93,831
公投第８案,新竹縣,新豐鄉,埔和村,292,1266,441,168,609,56,665
公投第８案,新竹縣,新豐鄉,新豐村,293,1029,366,121,487,72,559
公投第８案,新竹縣,新豐鄉,新豐村,294,1063,369,146,515,53,568
公投第８案,新竹縣,新豐鄉,員山村,295,1055,445,101,546,30,576
公投第８案,新竹縣,新豐鄉,員山村,296,1445,645,122,767,38,805
公投第８案,新竹縣,新豐鄉,忠孝村,297,1413,673,148,821,43,864
公投第８案,新竹縣,新豐鄉,忠孝村,298,971,452,126,578,40,618
公投第８案,新竹縣,新豐鄉,忠孝村,299,1135,520,132,652,26,678
公投第８案,新竹縣,新豐鄉,山崎村,300,1269,482,145,627,53,680
公投第８案,新竹縣,新豐鄉,山崎村,301,1257,519,152,671,41,712
公投第８案,新竹縣,新豐鄉,山崎村,302,1662,739,178,917,47,964
公投第８案,新竹縣,新豐鄉,上坑村,303,1486,552,187,739,29,768
公投第８案,新竹縣,新豐鄉,鳳坑村,304,1067,458,143,601,66,667
公投第８案,新竹縣,新豐鄉,重興村,305,1302,580,145,725,59,784
公投第８案,新竹縣,新豐鄉,重興村,306,1410,554,159,713,77,790
公投第８案,新竹縣,新豐鄉,重興村,307,1267,485,159,644,51,695
公投第８案,新竹縣,新豐鄉,重興村,308,1258,461,120,581,50,631
公投第８案,新竹縣,新豐鄉,崎頂村,309,1217,445,124,569,23,592
公投第８案,新竹縣,新豐鄉,崎頂村,310,1456,592,166,758,43,801
公投第８案,新竹縣,新豐鄉,松林村,311,1157,506,137,643,36,679
公投第８案,新竹縣,新豐鄉,松林村,312,1089,419,121,540,32,572
公投第８案,新竹縣,新豐鄉,松林村,313,1160,511,117,628,20,648
公投第８案,新竹縣,新豐鄉,松林村,314,976,481,111,592,17,609
公投第８案,新竹縣,新豐鄉,松柏村,315,1443,596,170,766,40,806
公投第８案,新竹縣,新豐鄉,松柏村,316,1247,464,136,600,23,623
公投第８案,新竹縣,新豐鄉,松柏村,317,1411,606,153,759,28,787
公投第８案,新竹縣,新豐鄉,松柏村,318,1238,550,139,689,47,736
公投第８案,新竹縣,芎林鄉,華龍村,319,417,163,63,226,17,243
公投第８案,新竹縣,芎林鄉,五龍村,320,534,257,83,340,29,369
公投第８案,新竹縣,芎林鄉,秀湖村,321,963,413,108,521,43,564
公投第８案,新竹縣,芎林鄉,永興村,322,418,189,54,243,28,271
公投第８案,新竹縣,芎林鄉,石潭村,323,1312,531,132,663,57,720
公投第８案,新竹縣,芎林鄉,石潭村,324,1354,493,138,631,44,675
公投第８案,新竹縣,芎林鄉,新鳳村,325,785,325,101,426,44,470
公投第８案,新竹縣,芎林鄉,新鳳村,326,797,364,79,443,46,489
公投第８案,新竹縣,芎林鄉,中坑村,327,623,272,80,352,22,374
公投第８案,新竹縣,芎林鄉,水坑村,328,759,298,100,398,37,435
公投第８案,新竹縣,芎林鄉,文林村,329,1272,479,121,600,45,645
公投第８案,新竹縣,芎林鄉,文林村,330,1129,506,129,635,37,672
公投第８案,新竹縣,芎林鄉,芎林村,331,713,309,106,415,30,445
公投第８案,新竹縣,芎林鄉,芎林村,332,839,360,110,470,51,521
公投第８案,新竹縣,芎林鄉,上山村,333,1123,544,150,694,39,733
公投第８案,新竹縣,芎林鄉,上山村,334,981,443,115,558,20,578
公投第８案,新竹縣,芎林鄉,上山村,335,1078,455,153,608,49,657
公投第８案,新竹縣,芎林鄉,上山村,336,1094,444,128,572,25,597
公投第８案,新竹縣,芎林鄉,下山村,337,1102,463,134,597,58,655
公投第８案,新竹縣,橫山鄉,橫山村,338,1231,554,142,696,53,749
公投第８案,新竹縣,橫山鄉,橫山村,339,1041,430,129,559,67,626
公投第８案,新竹縣,橫山鄉,橫山村,340,1132,496,146,642,44,686
公投第８案,新竹縣,橫山鄉,田寮村,341,859,367,97,464,41,505
公投第８案,新竹縣,橫山鄉,南昌村,342,204,78,23,101,16,117
公投第８案,新竹縣,橫山鄉,豐鄉村,343,222,63,27,90,10,100
公投第８案,新竹縣,橫山鄉,豐田村,344,338,140,43,183,34,217
公投第８案,新竹縣,橫山鄉,內灣村,345,916,369,84,453,39,492
公投第８案,新竹縣,橫山鄉,力行村,346,573,184,41,225,13,238
公投第８案,新竹縣,橫山鄉,力行村,347,275,132,48,180,9,189
公投第８案,新竹縣,橫山鄉,福興村,348,463,160,44,204,22,226
公投第８案,新竹縣,橫山鄉,沙坑村,349,690,324,75,399,41,440
公投第８案,新竹縣,橫山鄉,沙坑村,350,288,97,32,129,12,141
公投第８案,新竹縣,橫山鄉,新興村,351,685,321,90,411,31,442
公投第８案,新竹縣,橫山鄉,新興村,352,868,399,98,497,40,537
公投第８案,新竹縣,橫山鄉,大肚村,353,1561,702,202,904,64,968
公投第８案,新竹縣,北埔鄉,北埔村,354,1158,406,131,537,22,559
公投第８案,新竹縣,北埔鄉,南興村,355,1238,484,187,671,61,732
公投第８案,新竹縣,北埔鄉,大湖村,356,580,237,75,312,25,337
公投第８案,新竹縣,北埔鄉,埔尾村,357,931,408,99,507,32,539
公投第８案,新竹縣,北埔鄉,埔尾村,358,1653,685,170,855,74,929
公投第８案,新竹縣,北埔鄉,水磜村,359,845,356,96,452,32,484
公投第８案,新竹縣,北埔鄉,南埔村,360,384,156,40,196,12,208
公投第８案,新竹縣,北埔鄉,大林村,361,763,334,74,408,12,420
公投第８案,新竹縣,北埔鄉,南坑村,362,333,126,39,165,20,185
公投第８案,新竹縣,北埔鄉,外坪村,363,295,118,20,138,7,145
公投第８案,新竹縣,寶山鄉,雙溪村,364,1158,470,128,598,62,660
公投第８案,新竹縣,寶山鄉,雙溪村,365,1437,605,175,780,42,822
公投第８案,新竹縣,寶山鄉,雙新村,366,1470,584,199,783,51,834
公投第８案,新竹縣,寶山鄉,雙新村,367,1170,508,148,656,46,702
公投第８案,新竹縣,寶山鄉,大崎村,368,1900,797,243,1040,55,1095
公投第８案,新竹縣,寶山鄉,三峰村,369,1056,425,88,513,24,537
公投第８案,新竹縣,寶山鄉,新城村,370,1205,534,159,693,63,756
公投第８案,新竹縣,寶山鄉,寶斗村,371,766,323,81,404,37,441
公投第８案,新竹縣,寶山鄉,深井村,372,846,395,80,475,42,517
公投第８案,新竹縣,寶山鄉,寶山村,373,804,357,97,454,34,488
公投第８案,新竹縣,寶山鄉,油田村,374,607,276,63,339,21,360
公投第８案,新竹縣,寶山鄉,山湖村,375,554,246,92,338,14,352
公投第８案,新竹縣,峨眉鄉,峨眉村,376,879,414,101,515,55,570
公投第８案,新竹縣,峨眉鄉,中盛村,377,683,286,88,374,56,430
公投第８案,新竹縣,峨眉鄉,石井村,378,604,251,83,334,31,365
公投第８案,新竹縣,峨眉鄉,七星村,379,339,143,37,180,18,198
公投第８案,新竹縣,峨眉鄉,七星村,380,276,72,34,106,8,114
公投第８案,新竹縣,峨眉鄉,富興村,381,1406,607,167,774,83,857
公投第８案,新竹縣,峨眉鄉,湖光村,382,462,209,48,257,32,289
公投第８案,新竹縣,峨眉鄉,湖光村,383,419,152,54,206,19,225
公投第８案,新竹縣,尖石鄉,嘉樂村,384,474,132,44,176,9,185
公投第８案,新竹縣,尖石鄉,嘉樂村,385,357,134,25,159,9,168
公投第８案,新竹縣,尖石鄉,義興村,386,225,75,19,94,16,110
公投第８案,新竹縣,尖石鄉,義興村,387,374,132,31,163,6,169
公投第８案,新竹縣,尖石鄉,新樂村,388,773,252,45,297,8,305
公投第８案,新竹縣,尖石鄉,新樂村,389,490,155,42,197,15,212
公投第８案,新竹縣,尖石鄉,錦屏村,390,531,140,36,176,6,182
公投第８案,新竹縣,尖石鄉,錦屏村,391,660,206,46,252,6,258
公投第８案,新竹縣,尖石鄉,梅花村,392,613,241,100,341,59,400
公投第８案,新竹縣,尖石鄉,玉峰村,393,593,187,65,252,2,254
公投第８案,新竹縣,尖石鄉,玉峰村,394,575,183,56,239,18,257
公投第８案,新竹縣,尖石鄉,玉峰村,395,126,65,12,77,7,84
公投第８案,新竹縣,尖石鄉,秀巒村,396,499,131,27,158,6,164
公投第８案,新竹縣,尖石鄉,秀巒村,397,785,143,59,202,16,218
公投第８案,新竹縣,尖石鄉,秀巒村,398,289,96,48,144,19,163
公投第８案,新竹縣,五峰鄉,大隘村,399,672,250,78,328,29,357
公投第８案,新竹縣,五峰鄉,大隘村,400,713,219,71,290,12,302
公投第８案,新竹縣,五峰鄉,桃山村,401,594,151,39,190,7,197
公投第８案,新竹縣,五峰鄉,桃山村,402,896,274,68,342,26,368
公投第８案,新竹縣,五峰鄉,花園村,403,727,216,61,277,4,281
公投第８案,新竹縣,五峰鄉,竹林村,404,395,107,30,137,9,146
公投第８案,苗栗縣,苗栗市,中苗里,1,1087,484,104,588,36,624
公投第８案,苗栗縣,苗栗市,青苗里,2,1018,436,93,529,42,571
公投第８案,苗栗縣,苗栗市,維祥里,3,1156,482,148,630,21,651
公投第８案,苗栗縣,苗栗市,維祥里,4,1118,479,98,577,32,609
公投第８案,苗栗縣,苗栗市,維祥里,5,1084,468,115,583,46,629
公投第８案,苗栗縣,苗栗市,維新里,6,1203,545,137,682,38,720
公投第８案,苗栗縣,苗栗市,維新里,7,1306,600,124,724,53,777
公投第８案,苗栗縣,苗栗市,維新里,8,1193,527,141,668,52,720
公投第８案,苗栗縣,苗栗市,玉清里,9,1115,513,110,623,36,659
公投第８案,苗栗縣,苗栗市,玉清里,10,1119,519,121,640,47,687
公投第８案,苗栗縣,苗栗市,玉華里,11,1132,509,137,646,50,696
公投第８案,苗栗縣,苗栗市,玉華里,12,1289,572,134,706,33,739
公投第８案,苗栗縣,苗栗市,玉華里,13,1264,577,139,716,41,757
公投第８案,苗栗縣,苗栗市,綠苗里,14,870,369,97,466,26,492
公投第８案,苗栗縣,苗栗市,高苗里,15,1008,396,75,471,41,512
公投第８案,苗栗縣,苗栗市,高苗里,16,1078,419,119,538,31,569
公投第８案,苗栗縣,苗栗市,高苗里,17,1077,495,123,618,26,644
公投第８案,苗栗縣,苗栗市,新苗里,18,880,374,91,465,41,506
公投第８案,苗栗縣,苗栗市,玉苗里,19,894,365,91,456,46,502
公投第８案,苗栗縣,苗栗市,大同里,20,522,224,49,273,29,302
公投第８案,苗栗縣,苗栗市,恭敬里,21,1376,615,184,799,70,869
公投第８案,苗栗縣,苗栗市,水源里,22,1391,596,126,722,27,749
公投第８案,苗栗縣,苗栗市,水源里,23,1081,458,131,589,57,646
公投第８案,苗栗縣,苗栗市,勝利里,24,1272,530,131,661,48,709
公投第８案,苗栗縣,苗栗市,勝利里,25,1112,499,168,667,47,714
公投第８案,苗栗縣,苗栗市,勝利里,26,813,413,106,519,25,544
公投第８案,苗栗縣,苗栗市,勝利里,27,767,314,90,404,33,437
公投第８案,苗栗縣,苗栗市,清華里,28,1010,420,115,535,29,564
公投第８案,苗栗縣,苗栗市,清華里,29,1182,519,113,632,35,667
公投第８案,苗栗縣,苗栗市,清華里,30,965,426,103,529,25,554
公投第８案,苗栗縣,苗栗市,上苗里,31,607,286,62,348,16,364
公投第８案,苗栗縣,苗栗市,上苗里,32,990,452,125,577,35,612
公投第８案,苗栗縣,苗栗市,北苗里,33,1230,486,112,598,71,669
公投第８案,苗栗縣,苗栗市,北苗里,34,1372,601,153,754,41,795
公投第８案,苗栗縣,苗栗市,北苗里,35,1213,546,117,663,47,710
公投第８案,苗栗縣,苗栗市,北苗里,36,1272,560,119,679,45,724
公投第８案,苗栗縣,苗栗市,嘉盛里,37,1221,558,139,697,51,748
公投第８案,苗栗縣,苗栗市,嘉盛里,38,1104,474,133,607,37,644
公投第８案,苗栗縣,苗栗市,嘉盛里,39,1171,465,128,593,12,605
公投第８案,苗栗縣,苗栗市,福星里,40,1392,581,152,733,50,783
公投第８案,苗栗縣,苗栗市,福星里,41,1356,569,186,755,40,795
公投第８案,苗栗縣,苗栗市,福星里,42,1387,575,164,739,64,803
公投第８案,苗栗縣,苗栗市,福安里,43,1206,510,127,637,37,674
公投第８案,苗栗縣,苗栗市,福安里,44,1004,469,129,598,38,636
公投第８案,苗栗縣,苗栗市,福安里,45,1202,495,145,640,33,673
公投第８案,苗栗縣,苗栗市,嘉新里,46,1052,494,117,611,31,642
公投第８案,苗栗縣,苗栗市,嘉新里,47,873,420,93,513,26,539
公投第８案,苗栗縣,苗栗市,嘉新里,48,975,510,117,627,26,653
公投第８案,苗栗縣,苗栗市,建功里,49,1003,483,126,609,34,643
公投第８案,苗栗縣,苗栗市,建功里,50,1000,444,118,562,17,579
公投第８案,苗栗縣,苗栗市,建功里,51,1047,463,98,561,29,590
公投第８案,苗栗縣,苗栗市,建功里,52,1025,497,91,588,38,626
公投第８案,苗栗縣,苗栗市,福麗里,53,1130,464,109,573,36,609
公投第８案,苗栗縣,苗栗市,福麗里,54,1146,508,112,620,34,654
公投第８案,苗栗縣,苗栗市,福麗里,55,1432,629,149,778,57,835
公投第８案,苗栗縣,苗栗市,福麗里,56,1492,530,128,658,35,693
公投第８案,苗栗縣,苗栗市,文山里,57,1125,519,133,652,39,691
公投第８案,苗栗縣,苗栗市,文山里,58,1241,522,140,662,33,695
公投第８案,苗栗縣,苗栗市,文山里,59,1278,582,145,727,38,765
公投第８案,苗栗縣,苗栗市,文聖里,60,1293,579,112,691,23,714
公投第８案,苗栗縣,苗栗市,文聖里,61,1342,547,127,674,35,709
公投第８案,苗栗縣,苗栗市,文聖里,62,857,336,105,441,37,478
公投第８案,苗栗縣,苗栗市,新川里,63,1180,492,112,604,43,647
公投第８案,苗栗縣,苗栗市,南勢里,64,1072,477,128,605,31,636
公投第８案,苗栗縣,苗栗市,南勢里,65,912,386,71,457,25,482
公投第８案,苗栗縣,苗栗市,新英里,66,796,312,85,397,29,426
公投第８案,苗栗縣,苗栗市,新英里,67,869,322,81,403,27,430
公投第８案,苗栗縣,公館鄉,館中村,68,789,349,110,459,62,521
公投第８案,苗栗縣,公館鄉,館中村,69,792,395,97,492,30,522
公投第８案,苗栗縣,公館鄉,館東村,70,1117,468,169,637,71,708
公投第８案,苗栗縣,公館鄉,館東村,71,1255,557,166,723,62,785
公投第８案,苗栗縣,公館鄉,館南村,72,1141,510,137,647,36,683
公投第８案,苗栗縣,公館鄉,館南村,73,1172,510,135,645,42,687
公投第８案,苗栗縣,公館鄉,館南村,74,1100,499,151,650,45,695
公投第８案,苗栗縣,公館鄉,中義村,75,1232,480,124,604,48,652
公投第８案,苗栗縣,公館鄉,中義村,76,1081,406,107,513,56,569
公投第８案,苗栗縣,公館鄉,玉泉村,77,1250,610,119,729,46,775
公投第８案,苗栗縣,公館鄉,玉泉村,78,1081,450,131,581,50,631
公投第８案,苗栗縣,公館鄉,大坑村,79,964,384,106,490,63,553
公投第８案,苗栗縣,公館鄉,福基村,80,1038,460,120,580,57,637
公投第８案,苗栗縣,公館鄉,福德村,81,360,152,48,200,27,227
公投第８案,苗栗縣,公館鄉,福星村,82,865,336,113,449,49,498
公投第８案,苗栗縣,公館鄉,福星村,83,1166,475,134,609,43,652
公投第８案,苗栗縣,公館鄉,石墻村,84,719,323,81,404,25,429
公投第８案,苗栗縣,公館鄉,石墻村,85,788,303,94,397,38,435
公投第８案,苗栗縣,公館鄉,開礦村,86,303,138,37,175,27,202
公投第８案,苗栗縣,公館鄉,五谷村,87,1322,565,166,731,56,787
公投第８案,苗栗縣,公館鄉,五谷村,88,933,363,109,472,62,534
公投第８案,苗栗縣,公館鄉,玉谷村,89,1455,573,142,715,77,792
公投第８案,苗栗縣,公館鄉,鶴岡村,90,1615,708,207,915,84,999
公投第８案,苗栗縣,公館鄉,鶴山村,91,1451,565,169,734,72,806
公投第８案,苗栗縣,公館鄉,尖山村,92,1462,651,174,825,57,882
公投第８案,苗栗縣,公館鄉,仁安村,93,1317,504,172,676,61,737
公投第８案,苗栗縣,公館鄉,南河村,94,221,112,15,127,4,131
公投第８案,苗栗縣,公館鄉,北河村,95,329,133,31,164,11,175
公投第８案,苗栗縣,頭屋鄉,頭屋村,96,1335,652,186,838,55,893
公投第８案,苗栗縣,頭屋鄉,頭屋村,97,1168,619,149,768,59,827
公投第８案,苗栗縣,頭屋鄉,獅潭村,98,792,375,110,485,31,516
公投第８案,苗栗縣,頭屋鄉,獅潭村,99,918,499,113,612,46,658
公投第８案,苗栗縣,頭屋鄉,北坑村,100,725,343,84,427,35,462
公投第８案,苗栗縣,頭屋鄉,曲洞村,101,899,429,100,529,25,554
公投第８案,苗栗縣,頭屋鄉,飛鳳村,102,369,128,38,166,15,181
公投第８案,苗栗縣,頭屋鄉,象山村,103,844,373,106,479,25,504
公投第８案,苗栗縣,頭屋鄉,象山村,104,1007,459,105,564,32,596
公投第８案,苗栗縣,頭屋鄉,明德村,105,794,373,91,464,37,501
公投第８案,苗栗縣,頭屋鄉,明德村,106,211,116,29,145,12,157
公投第８案,苗栗縣,頭屋鄉,鳴鳳村,107,328,167,50,217,20,237
公投第８案,苗栗縣,銅鑼鄉,銅鑼村,108,887,414,95,509,39,548
公投第８案,苗栗縣,銅鑼鄉,銅鑼村,109,1052,465,118,583,47,630
公投第８案,苗栗縣,銅鑼鄉,銅鑼村,110,1347,635,164,799,27,826
公投第８案,苗栗縣,銅鑼鄉,銅鑼村,111,1177,500,130,630,41,671
公投第８案,苗栗縣,銅鑼鄉,樟樹村,112,1268,504,145,649,34,683
公投第８案,苗栗縣,銅鑼鄉,九湖村,113,1185,428,113,541,36,577
公投第８案,苗栗縣,銅鑼鄉,福興村,114,1029,477,87,564,39,603
公投第８案,苗栗縣,銅鑼鄉,朝陽村,115,905,421,74,495,26,521
公投第８案,苗栗縣,銅鑼鄉,朝陽村,116,750,331,92,423,43,466
公投第８案,苗栗縣,銅鑼鄉,竹森村,117,1080,398,115,513,41,554
公投第８案,苗栗縣,銅鑼鄉,中平村,118,1108,440,103,543,56,599
公投第８案,苗栗縣,銅鑼鄉,中平村,119,862,344,73,417,40,457
公投第８案,苗栗縣,銅鑼鄉,中平村,120,1216,488,127,615,32,647
公投第８案,苗栗縣,銅鑼鄉,興隆村,121,588,212,62,274,29,303
公投第８案,苗栗縣,銅鑼鄉,盛隆村,122,429,154,48,202,32,234
公投第８案,苗栗縣,銅鑼鄉,新隆村,123,541,233,62,295,22,317
公投第８案,苗栗縣,三義鄉,廣盛村,124,853,374,99,473,49,522
公投第８案,苗栗縣,三義鄉,廣盛村,125,983,472,114,586,26,612
公投第８案,苗栗縣,三義鄉,廣盛村,126,1080,480,124,604,43,647
公投第８案,苗栗縣,三義鄉,廣盛村,127,1216,527,103,630,18,648
公投第８案,苗栗縣,三義鄉,勝興村,128,1017,465,102,567,36,603
公投第８案,苗栗縣,三義鄉,勝興村,129,1180,508,105,613,19,632
公投第８案,苗栗縣,三義鄉,勝興村,130,1198,544,118,662,22,684
公投第８案,苗栗縣,三義鄉,龍騰村,131,417,175,44,219,22,241
公投第８案,苗栗縣,三義鄉,双湖村,132,991,382,106,488,27,515
公投第８案,苗栗縣,三義鄉,双湖村,133,834,368,106,474,14,488
公投第８案,苗栗縣,三義鄉,双潭村,134,622,269,66,335,31,366
公投第８案,苗栗縣,三義鄉,双潭村,135,749,315,105,420,39,459
公投第８案,苗栗縣,三義鄉,西湖村,136,692,355,81,436,24,460
公投第８案,苗栗縣,三義鄉,西湖村,137,759,398,99,497,37,534
公投第８案,苗栗縣,三義鄉,鯉魚潭村,138,629,241,67,308,27,335
公投第８案,苗栗縣,三義鄉,鯉魚潭村,139,669,250,99,349,37,386
公投第８案,苗栗縣,西湖鄉,高埔村,140,601,235,65,300,24,324
公投第８案,苗栗縣,西湖鄉,下埔村,141,566,258,60,318,23,341
公投第８案,苗栗縣,西湖鄉,五湖村,142,843,360,91,451,40,491
公投第８案,苗栗縣,西湖鄉,四湖村,143,648,257,71,328,15,343
公投第８案,苗栗縣,西湖鄉,三湖村,144,936,339,96,435,39,474
公投第８案,苗栗縣,西湖鄉,龍洞村,145,461,187,46,233,14,247
公投第８案,苗栗縣,西湖鄉,金獅村,146,515,218,59,277,18,295
公投第８案,苗栗縣,西湖鄉,湖東村,147,1141,432,116,548,67,615
公投第８案,苗栗縣,西湖鄉,二湖村,148,671,300,57,357,38,395
公投第８案,苗栗縣,通霄鎮,通東里,149,1142,427,153,580,71,651
公投第８案,苗栗縣,通霄鎮,通西里,150,884,352,156,508,65,573
公投第８案,苗栗縣,通霄鎮,通西里,151,1068,389,133,522,69,591
公投第８案,苗栗縣,通霄鎮,平元里,152,1009,380,136,516,48,564
公投第８案,苗栗縣,通霄鎮,平元里,153,859,367,141,508,53,561
公投第８案,苗栗縣,通霄鎮,平安里,154,1040,503,52,555,47,602
公投第８案,苗栗縣,通霄鎮,平安里,155,1008,314,91,405,14,419
公投第８案,苗栗縣,通霄鎮,圳頭里,156,686,260,91,351,57,408
公投第８案,苗栗縣,通霄鎮,梅南里,157,761,321,128,449,54,503
公投第８案,苗栗縣,通霄鎮,梅南里,158,790,275,96,371,26,397
公投第８案,苗栗縣,通霄鎮,通南里,159,966,337,135,472,58,530
公投第８案,苗栗縣,通霄鎮,通南里,160,972,319,112,431,72,503
公投第８案,苗栗縣,通霄鎮,通南里,161,771,288,96,384,48,432
公投第８案,苗栗縣,通霄鎮,內湖里,162,758,213,88,301,28,329
公投第８案,苗栗縣,通霄鎮,內湖里,163,1078,377,153,530,52,582
公投第８案,苗栗縣,通霄鎮,楓樹里,164,459,124,52,176,23,199
公投第８案,苗栗縣,通霄鎮,烏眉里,165,894,313,91,404,45,449
公投第８案,苗栗縣,通霄鎮,福龍里,166,402,108,41,149,10,159
公投第８案,苗栗縣,通霄鎮,福源里,167,802,287,116,403,30,433
公投第８案,苗栗縣,通霄鎮,城北里,168,684,215,103,318,28,346
公投第８案,苗栗縣,通霄鎮,城南里,169,943,311,84,395,44,439
公投第８案,苗栗縣,通霄鎮,南和里,170,790,95,321,416,61,477
公投第８案,苗栗縣,通霄鎮,福興里,171,673,199,63,262,15,277
公投第８案,苗栗縣,通霄鎮,坪頂里,172,1232,446,143,589,60,649
公投第８案,苗栗縣,通霄鎮,五南里,173,1286,505,176,681,74,755
公投第８案,苗栗縣,通霄鎮,五北里,174,649,248,91,339,47,386
公投第８案,苗栗縣,通霄鎮,五北里,175,769,270,88,358,28,386
公投第８案,苗栗縣,通霄鎮,通灣里,176,1148,398,160,558,72,630
公投第８案,苗栗縣,通霄鎮,通灣里,177,1138,366,136,502,73,575
公投第８案,苗栗縣,通霄鎮,新埔里,178,1121,367,127,494,49,543
公投第８案,苗栗縣,通霄鎮,內島里,179,769,296,109,405,22,427
公投第８案,苗栗縣,通霄鎮,白東里,180,616,188,97,285,12,297
公投第８案,苗栗縣,通霄鎮,白東里,181,799,314,87,401,37,438
公投第８案,苗栗縣,通霄鎮,白西里,182,743,272,68,340,33,373
公投第８案,苗栗縣,苑裡鎮,苑東里,183,873,331,139,470,53,523
公投第８案,苗栗縣,苑裡鎮,苑東里,184,1346,551,178,729,44,773
公投第８案,苗栗縣,苑裡鎮,苑南里,185,951,424,138,562,68,630
公投第８案,苗栗縣,苑裡鎮,苑南里,186,615,219,83,302,18,320
公投第８案,苗栗縣,苑裡鎮,苑北里,187,878,358,117,475,73,548
公投第８案,苗栗縣,苑裡鎮,西平里,188,767,330,106,436,32,468
公投第８案,苗栗縣,苑裡鎮,西平里,189,776,287,106,393,40,433
公投第８案,苗栗縣,苑裡鎮,苑港里,190,1231,424,136,560,74,634
公投第８案,苗栗縣,苑裡鎮,西勢里,191,1145,467,153,620,52,672
公投第８案,苗栗縣,苑裡鎮,西勢里,192,850,312,113,425,40,465
公投第８案,苗栗縣,苑裡鎮,海岸里,193,1052,373,152,525,54,579
公投第８案,苗栗縣,苑裡鎮,房裡里,194,1114,438,157,595,44,639
公投第８案,苗栗縣,苑裡鎮,房裡里,195,1136,435,174,609,61,670
公投第８案,苗栗縣,苑裡鎮,客庄里,196,1194,459,161,620,44,664
公投第８案,苗栗縣,苑裡鎮,客庄里,197,1579,645,193,838,62,900
公投第８案,苗栗縣,苑裡鎮,客庄里,198,1149,481,159,640,68,708
公投第８案,苗栗縣,苑裡鎮,中正里,199,1057,414,157,571,69,640
公投第８案,苗栗縣,苑裡鎮,中正里,200,1101,388,133,521,19,540
公投第８案,苗栗縣,苑裡鎮,苑坑里,201,912,265,110,375,46,421
公投第８案,苗栗縣,苑裡鎮,水坡里,202,652,228,86,314,50,364
公投第８案,苗栗縣,苑裡鎮,新復里,203,1348,529,163,692,80,772
公投第８案,苗栗縣,苑裡鎮,山脚里,204,733,217,98,315,26,341
公投第８案,苗栗縣,苑裡鎮,山脚里,205,662,251,64,315,13,328
公投第８案,苗栗縣,苑裡鎮,舊社里,206,893,356,109,465,51,516
公投第８案,苗栗縣,苑裡鎮,舊社里,207,910,377,121,498,47,545
公投第８案,苗栗縣,苑裡鎮,福田里,208,1270,465,167,632,61,693
公投第８案,苗栗縣,苑裡鎮,石鎮里,209,545,210,52,262,30,292
公投第８案,苗栗縣,苑裡鎮,蕉埔里,210,792,342,93,435,67,502
公投第８案,苗栗縣,苑裡鎮,南勢里,211,726,272,109,381,36,417
公投第８案,苗栗縣,苑裡鎮,泰田里,212,827,256,67,323,21,344
公投第８案,苗栗縣,苑裡鎮,泰田里,213,782,308,101,409,55,464
公投第８案,苗栗縣,苑裡鎮,上舘里,214,788,207,199,406,28,434
公投第８案,苗栗縣,苑裡鎮,上舘里,215,846,320,101,421,39,460
公投第８案,苗栗縣,苑裡鎮,玉田里,216,828,329,120,449,55,504
公投第８案,苗栗縣,苑裡鎮,玉田里,217,943,392,112,504,46,550
公投第８案,苗栗縣,苑裡鎮,社苓里,218,1082,469,131,600,32,632
公投第８案,苗栗縣,苑裡鎮,社苓里,219,1234,511,176,687,62,749
公投第８案,苗栗縣,苑裡鎮,山柑里,220,1434,550,171,721,62,783
公投第８案,苗栗縣,苑裡鎮,田心里,221,987,393,130,523,45,568
公投第８案,苗栗縣,苑裡鎮,田心里,222,882,349,168,517,45,562
公投第８案,苗栗縣,後龍鎮,南龍里,223,590,228,76,304,36,340
公投第８案,苗栗縣,後龍鎮,南龍里,224,883,371,131,502,56,558
公投第８案,苗栗縣,後龍鎮,中龍里,225,793,336,103,439,54,493
公投第８案,苗栗縣,後龍鎮,北龍里,226,732,273,133,406,33,439
公投第８案,苗栗縣,後龍鎮,北龍里,227,592,224,93,317,41,358
公投第８案,苗栗縣,後龍鎮,大庄里,228,1113,456,157,613,50,663
公投第８案,苗栗縣,後龍鎮,大庄里,229,1195,474,151,625,52,677
公投第８案,苗栗縣,後龍鎮,大庄里,230,997,434,138,572,48,620
公投第８案,苗栗縣,後龍鎮,大庄里,231,913,301,108,409,26,435
公投第８案,苗栗縣,後龍鎮,東明里,232,641,213,85,298,37,335
公投第８案,苗栗縣,後龍鎮,東明里,233,848,300,107,407,30,437
公投第８案,苗栗縣,後龍鎮,灣寶里,234,1264,451,158,609,94,703
公投第８案,苗栗縣,後龍鎮,海寶里,235,965,339,108,447,42,489
公投第８案,苗栗縣,後龍鎮,豐富里,236,1216,620,163,783,68,851
公投第８案,苗栗縣,後龍鎮,校椅里,237,977,396,101,497,36,533
公投第８案,苗栗縣,後龍鎮,埔頂里,238,943,305,115,420,55,475
公投第８案,苗栗縣,後龍鎮,埔頂里,239,910,328,127,455,66,521
公投第８案,苗栗縣,後龍鎮,埔頂里,240,851,340,89,429,45,474
公投第８案,苗栗縣,後龍鎮,新民里,241,725,301,120,421,27,448
公投第８案,苗栗縣,後龍鎮,新民里,242,650,261,85,346,43,389
公投第８案,苗栗縣,後龍鎮,復興里,243,706,231,90,321,45,366
公投第８案,苗栗縣,後龍鎮,大山里,244,748,259,122,381,50,431
公投第８案,苗栗縣,後龍鎮,大山里,245,801,231,98,329,45,374
公投第８案,苗栗縣,後龍鎮,溪洲里,246,1107,433,146,579,46,625
公投第８案,苗栗縣,後龍鎮,溪洲里,247,1197,458,131,589,61,650
公投第８案,苗栗縣,後龍鎮,外埔里,248,1036,370,109,479,48,527
公投第８案,苗栗縣,後龍鎮,海埔里,249,913,260,105,365,45,410
公投第８案,苗栗縣,後龍鎮,秀水里,250,719,287,98,385,55,440
公投第８案,苗栗縣,後龍鎮,水尾里,251,1037,380,117,497,102,599
公投第８案,苗栗縣,後龍鎮,龍津里,252,601,218,67,285,21,306
公投第８案,苗栗縣,後龍鎮,龍坑里,253,1269,495,124,619,48,667
公投第８案,苗栗縣,後龍鎮,福寧里,254,735,240,86,326,30,356
公投第８案,苗栗縣,後龍鎮,中和里,255,422,92,41,133,11,144
公投第８案,苗栗縣,後龍鎮,中和里,256,625,253,77,330,25,355
公投第８案,苗栗縣,後龍鎮,南港里,257,1234,388,129,517,57,574
公投第８案,苗栗縣,造橋鄉,造橋村,258,1171,568,130,698,66,764
公投第８案,苗栗縣,造橋鄉,造橋村,259,889,394,93,487,39,526
公投第８案,苗栗縣,造橋鄉,平興村,260,479,184,34,218,17,235
公投第８案,苗栗縣,造橋鄉,豐湖村,261,1024,439,119,558,44,602
公投第８案,苗栗縣,造橋鄉,大西村,262,1214,452,137,589,68,657
公投第８案,苗栗縣,造橋鄉,大西村,263,1071,395,122,517,45,562
公投第８案,苗栗縣,造橋鄉,大西村,264,1157,421,122,543,64,607
公投第８案,苗栗縣,造橋鄉,錦水村,265,512,209,54,263,34,297
公投第８案,苗栗縣,造橋鄉,大龍村,266,491,224,61,285,25,310
公投第８案,苗栗縣,造橋鄉,朝陽村,267,1272,549,162,711,55,766
公投第８案,苗栗縣,造橋鄉,談文村,268,785,314,97,411,41,452
公投第８案,苗栗縣,造橋鄉,龍昇村,269,962,389,148,537,89,626
公投第８案,苗栗縣,竹南鎮,竹南里,270,1086,450,162,612,37,649
公投第８案,苗栗縣,竹南鎮,竹南里,271,826,360,90,450,36,486
公投第８案,苗栗縣,竹南鎮,照南里,272,1051,378,114,492,59,551
公投第８案,苗栗縣,竹南鎮,照南里,273,1235,561,128,689,42,731
公投第８案,苗栗縣,竹南鎮,照南里,274,1016,411,128,539,75,614
公投第８案,苗栗縣,竹南鎮,正南里,275,1472,546,189,735,62,797
公投第８案,苗栗縣,竹南鎮,正南里,276,1301,443,152,595,40,635
公投第８案,苗栗縣,竹南鎮,新南里,277,1544,567,173,740,41,781
公投第８案,苗栗縣,竹南鎮,新南里,278,1512,700,94,794,36,830
公投第８案,苗栗縣,竹南鎮,新南里,279,1463,540,176,716,59,775
公投第８案,苗栗縣,竹南鎮,大厝里,280,1073,409,123,532,35,567
公投第８案,苗栗縣,竹南鎮,大厝里,281,1453,625,175,800,35,835
公投第８案,苗栗縣,竹南鎮,大厝里,282,1245,573,140,713,39,752
公投第８案,苗栗縣,竹南鎮,大厝里,283,1487,685,161,846,42,888
公投第８案,苗栗縣,竹南鎮,營盤里,284,1018,518,39,557,40,597
公投第８案,苗栗縣,竹南鎮,營盤里,285,1105,475,150,625,31,656
公投第８案,苗栗縣,竹南鎮,營盤里,286,1322,485,171,656,44,700
公投第８案,苗栗縣,竹南鎮,聖福里,287,1140,507,131,638,24,662
公投第８案,苗栗縣,竹南鎮,聖福里,288,1067,487,133,620,35,655
公投第８案,苗栗縣,竹南鎮,聖福里,289,1136,510,160,670,47,717
公投第８案,苗栗縣,竹南鎮,竹興里,290,1253,489,118,607,46,653
公投第８案,苗栗縣,竹南鎮,竹興里,291,963,353,102,455,57,512
公投第８案,苗栗縣,竹南鎮,竹興里,292,1021,379,130,509,47,556
公投第８案,苗栗縣,竹南鎮,龍山里,293,1154,501,144,645,47,692
公投第８案,苗栗縣,竹南鎮,龍山里,294,1042,433,127,560,32,592
公投第８案,苗栗縣,竹南鎮,天文里,295,1293,559,143,702,41,743
公投第８案,苗栗縣,竹南鎮,天文里,296,816,364,98,462,18,480
公投第８案,苗栗縣,竹南鎮,龍鳳里,297,989,407,106,513,49,562
公投第８案,苗栗縣,竹南鎮,龍鳳里,298,1122,525,116,641,36,677
公投第８案,苗栗縣,竹南鎮,山佳里,299,1111,382,100,482,41,523
公投第８案,苗栗縣,竹南鎮,山佳里,300,1036,453,100,553,62,615
公投第８案,苗栗縣,竹南鎮,山佳里,301,1112,413,116,529,30,559
公投第８案,苗栗縣,竹南鎮,山佳里,302,1348,645,29,674,26,700
公投第８案,苗栗縣,竹南鎮,佳興里,303,1114,470,151,621,23,644
公投第８案,苗栗縣,竹南鎮,佳興里,304,1119,477,143,620,51,671
公投第８案,苗栗縣,竹南鎮,佳興里,305,878,364,99,463,35,498
公投第８案,苗栗縣,竹南鎮,中港里,306,1059,461,137,598,53,651
公投第８案,苗栗縣,竹南鎮,中華里,307,869,348,128,476,40,516
公投第８案,苗栗縣,竹南鎮,中華里,308,800,311,101,412,30,442
公投第８案,苗栗縣,竹南鎮,中華里,309,1165,522,150,672,40,712
公投第８案,苗栗縣,竹南鎮,中英里,310,791,330,98,428,36,464
公投第８案,苗栗縣,竹南鎮,中英里,311,677,242,105,347,24,371
公投第８案,苗栗縣,竹南鎮,中美里,312,797,377,87,464,53,517
公投第８案,苗栗縣,竹南鎮,中美里,313,1191,480,129,609,42,651
公投第８案,苗栗縣,竹南鎮,開元里,314,1027,387,123,510,22,532
公投第８案,苗栗縣,竹南鎮,海口里,315,1341,588,155,743,48,791
公投第８案,苗栗縣,竹南鎮,海口里,316,1378,502,144,646,57,703
公投第８案,苗栗縣,竹南鎮,海口里,317,1216,505,145,650,32,682
公投第８案,苗栗縣,竹南鎮,港墘里,318,1570,628,157,785,37,822
公投第８案,苗栗縣,竹南鎮,港墘里,319,538,226,70,296,35,331
公投第８案,苗栗縣,竹南鎮,公舘里,320,1166,408,115,523,21,544
公投第８案,苗栗縣,竹南鎮,大埔里,321,1488,558,183,741,34,775
公投第８案,苗栗縣,竹南鎮,大埔里,322,1449,543,150,693,26,719
公投第８案,苗栗縣,竹南鎮,大埔里,323,1182,434,158,592,69,661
公投第８案,苗栗縣,竹南鎮,頂埔里,324,1175,445,160,605,65,670
公投第８案,苗栗縣,竹南鎮,頂埔里,325,983,400,113,513,42,555
公投第８案,苗栗縣,竹南鎮,崎頂里,326,492,230,55,285,24,309
公投第８案,苗栗縣,竹南鎮,崎頂里,327,1074,438,143,581,41,622
公投第８案,苗栗縣,竹南鎮,崎頂里,328,852,297,123,420,48,468
公投第８案,苗栗縣,竹南鎮,崎頂里,329,1297,519,137,656,31,687
公投第８案,苗栗縣,竹南鎮,公義里,330,1028,388,123,511,47,558
公投第８案,苗栗縣,頭份市,流東里,331,915,346,96,442,55,497
公投第８案,苗栗縣,頭份市,流東里,332,1292,529,150,679,56,735
公投第８案,苗栗縣,頭份市,珊湖里,333,928,397,125,522,30,552
公投第８案,苗栗縣,頭份市,珊湖里,334,835,318,70,388,14,402
公投第８案,苗栗縣,頭份市,斗煥里,335,1070,430,121,551,36,587
公投第８案,苗栗縣,頭份市,斗煥里,336,879,322,95,417,12,429
公投第８案,苗栗縣,頭份市,斗煥里,337,1039,380,114,494,44,538
公投第８案,苗栗縣,頭份市,新華里,338,1129,477,120,597,61,658
公投第８案,苗栗縣,頭份市,新華里,339,1041,421,113,534,38,572
公投第８案,苗栗縣,頭份市,新華里,340,1546,565,150,715,72,787
公投第８案,苗栗縣,頭份市,興隆里,341,935,429,118,547,38,585
公投第８案,苗栗縣,頭份市,興隆里,342,1180,422,152,574,43,617
公投第８案,苗栗縣,頭份市,興隆里,343,1499,577,139,716,40,756
公投第８案,苗栗縣,頭份市,興隆里,344,747,316,69,385,19,404
公投第８案,苗栗縣,頭份市,上埔里,345,1406,563,150,713,35,748
公投第８案,苗栗縣,頭份市,上埔里,346,1193,495,122,617,57,674
公投第８案,苗栗縣,頭份市,土牛里,347,948,384,134,518,34,552
公投第８案,苗栗縣,頭份市,頭份里,348,869,346,92,438,26,464
公投第８案,苗栗縣,頭份市,頭份里,349,1142,485,131,616,49,665
公投第８案,苗栗縣,頭份市,頭份里,350,1286,520,150,670,28,698
公投第８案,苗栗縣,頭份市,忠孝里,351,903,399,102,501,33,534
公投第８案,苗栗縣,頭份市,忠孝里,352,1186,567,127,694,41,735
公投第８案,苗栗縣,頭份市,忠孝里,353,1016,469,93,562,26,588
公投第８案,苗栗縣,頭份市,自強里,354,985,414,110,524,35,559
公投第８案,苗栗縣,頭份市,自強里,355,1037,441,108,549,27,576
公投第８案,苗栗縣,頭份市,信義里,356,947,340,88,428,36,464
公投第８案,苗栗縣,頭份市,仁愛里,357,890,401,80,481,37,518
公投第８案,苗栗縣,頭份市,仁愛里,358,646,270,96,366,40,406
公投第８案,苗栗縣,頭份市,上興里,359,975,390,137,527,49,576
公投第８案,苗栗縣,頭份市,上興里,360,1015,284,87,371,21,392
公投第８案,苗栗縣,頭份市,下興里,361,1399,627,172,799,59,858
公投第８案,苗栗縣,頭份市,下興里,362,1143,507,130,637,50,687
公投第８案,苗栗縣,頭份市,和平里,363,1030,456,140,596,73,669
公投第８案,苗栗縣,頭份市,山下里,364,1338,569,162,731,40,771
公投第８案,苗栗縣,頭份市,山下里,365,1450,599,137,736,36,772
公投第８案,苗栗縣,頭份市,山下里,366,1042,487,95,582,23,605
公投第８案,苗栗縣,頭份市,後庄里,367,1326,596,157,753,44,797
公投第８案,苗栗縣,頭份市,後庄里,368,1270,614,154,768,32,800
公投第８案,苗栗縣,頭份市,後庄里,369,1288,518,155,673,41,714
公投第８案,苗栗縣,頭份市,合興里,370,1243,537,139,676,36,712
公投第８案,苗栗縣,頭份市,合興里,371,1280,573,141,714,36,750
公投第８案,苗栗縣,頭份市,文化里,372,1618,648,180,828,74,902
公投第８案,苗栗縣,頭份市,文化里,373,1759,711,174,885,47,932
公投第８案,苗栗縣,頭份市,中興里,374,1264,581,128,709,40,749
公投第８案,苗栗縣,頭份市,中興里,375,1326,604,129,733,32,765
公投第８案,苗栗縣,頭份市,蟠桃里,376,1551,697,149,846,39,885
公投第８案,苗栗縣,頭份市,蟠桃里,377,1574,629,139,768,44,812
公投第８案,苗栗縣,頭份市,建國里,378,1262,540,159,699,40,739
公投第８案,苗栗縣,頭份市,建國里,379,1171,523,120,643,43,686
公投第８案,苗栗縣,頭份市,建國里,380,1074,518,137,655,41,696
公投第８案,苗栗縣,頭份市,成功里,381,1141,521,135,656,32,688
公投第８案,苗栗縣,頭份市,成功里,382,1259,519,167,686,45,731
公投第８案,苗栗縣,頭份市,成功里,383,1186,485,136,621,34,655
公投第８案,苗栗縣,頭份市,民族里,384,1121,440,112,552,31,583
公投第８案,苗栗縣,頭份市,民族里,385,847,355,100,455,31,486
公投第８案,苗栗縣,頭份市,民權里,386,993,446,124,570,28,598
公投第８案,苗栗縣,頭份市,民權里,387,1055,417,115,532,36,568
公投第８案,苗栗縣,頭份市,東庄里,388,1655,634,138,772,54,826
公投第８案,苗栗縣,頭份市,東庄里,389,1799,758,165,923,66,989
公投第８案,苗栗縣,頭份市,田寮里,390,1141,500,126,626,36,662
公投第８案,苗栗縣,頭份市,田寮里,391,1431,566,163,729,52,781
公投第８案,苗栗縣,頭份市,田寮里,392,1412,491,128,619,32,651
公投第８案,苗栗縣,頭份市,民生里,393,1074,416,109,525,39,564
公投第８案,苗栗縣,頭份市,民生里,394,1245,570,131,701,42,743
公投第８案,苗栗縣,頭份市,蘆竹里,395,1344,554,190,744,55,799
公投第８案,苗栗縣,頭份市,尖山里,396,1363,614,168,782,61,843
公投第８案,苗栗縣,頭份市,廣興里,397,898,414,104,518,45,563
公投第８案,苗栗縣,頭份市,尖下里,398,1182,507,141,648,62,710
公投第８案,苗栗縣,頭份市,尖下里,399,1413,569,167,736,37,773
公投第８案,苗栗縣,頭份市,濫坑里,400,991,453,133,586,30,616
公投第８案,苗栗縣,頭份市,濫坑里,401,1180,495,155,650,43,693
公投第８案,苗栗縣,三灣鄉,三灣村,402,996,448,108,556,38,594
公投第８案,苗栗縣,三灣鄉,三灣村,403,1205,475,145,620,70,690
公投第８案,苗栗縣,三灣鄉,內灣村,404,635,261,90,351,36,387
公投第８案,苗栗縣,三灣鄉,銅鏡村,405,862,330,118,448,45,493
公投第８案,苗栗縣,三灣鄉,頂寮村,406,238,87,19,106,12,118
公投第８案,苗栗縣,三灣鄉,北埔村,407,541,203,61,264,29,293
公投第８案,苗栗縣,三灣鄉,大河村,408,578,200,65,265,33,298
公投第８案,苗栗縣,三灣鄉,大坪村,409,405,178,65,243,35,278
公投第８案,苗栗縣,三灣鄉,永和村,410,392,153,45,198,24,222
公投第８案,苗栗縣,南庄鄉,東村,411,1155,447,123,570,69,639
公投第８案,苗栗縣,南庄鄉,西村,412,650,242,79,321,44,365
公投第８案,苗栗縣,南庄鄉,南江村,413,1353,486,153,639,61,700
公投第８案,苗栗縣,南庄鄉,田美村,414,813,249,64,313,42,355
公投第８案,苗栗縣,南庄鄉,獅山村,415,837,253,73,326,31,357
公投第８案,苗栗縣,南庄鄉,南富村,416,1093,430,110,540,33,573
公投第８案,苗栗縣,南庄鄉,員林村,417,1048,380,135,515,55,570
公投第８案,苗栗縣,南庄鄉,蓬萊村,418,872,308,98,406,40,446
公投第８案,苗栗縣,南庄鄉,東河村,419,963,238,50,288,11,299
公投第８案,苗栗縣,大湖鄉,大湖村,420,744,284,95,379,24,403
公投第８案,苗栗縣,大湖鄉,大湖村,421,881,370,85,455,31,486
公投第８案,苗栗縣,大湖鄉,明湖村,422,596,240,55,295,44,339
公投第８案,苗栗縣,大湖鄉,大寮村,423,1260,449,136,585,65,650
公投第８案,苗栗縣,大湖鄉,靜湖村,424,867,348,78,426,29,455
公投第８案,苗栗縣,大湖鄉,靜湖村,425,923,379,88,467,43,510
公投第８案,苗栗縣,大湖鄉,富興村,426,1395,500,170,670,67,737
公投第８案,苗栗縣,大湖鄉,大南村,427,561,131,52,183,20,203
公投第８案,苗栗縣,大湖鄉,南湖村,428,638,266,76,342,28,370
公投第８案,苗栗縣,大湖鄉,東興村,429,754,284,71,355,44,399
公投第８案,苗栗縣,大湖鄉,武榮村,430,501,171,63,234,14,248
公投第８案,苗栗縣,大湖鄉,義和村,431,652,247,79,326,32,358
公投第８案,苗栗縣,大湖鄉,義和村,432,843,299,86,385,23,408
公投第８案,苗栗縣,大湖鄉,栗林村,433,1020,419,109,528,69,597
公投第８案,苗栗縣,大湖鄉,新開村,434,1018,442,104,546,33,579
公投第８案,苗栗縣,獅潭鄉,百壽村,435,328,102,17,119,8,127
公投第８案,苗栗縣,獅潭鄉,永興村,436,565,157,53,210,38,248
公投第８案,苗栗縣,獅潭鄉,新店村,437,911,357,99,456,68,524
公投第８案,苗栗縣,獅潭鄉,和興村,438,568,186,62,248,19,267
公投第８案,苗栗縣,獅潭鄉,豐林村,439,580,249,59,308,33,341
公投第８案,苗栗縣,獅潭鄉,新豐村,440,333,136,24,160,6,166
公投第８案,苗栗縣,獅潭鄉,竹木村,441,683,257,56,313,32,345
公投第８案,苗栗縣,卓蘭鎮,老庄里,442,961,436,115,551,34,585
公投第８案,苗栗縣,卓蘭鎮,老庄里,443,1017,393,120,513,59,572
公投第８案,苗栗縣,卓蘭鎮,新榮里,444,1095,471,169,640,64,704
公投第８案,苗栗縣,卓蘭鎮,中街里,445,745,319,96,415,32,447
公投第８案,苗栗縣,卓蘭鎮,新厝里,446,783,299,93,392,38,430
公投第８案,苗栗縣,卓蘭鎮,新厝里,447,745,250,86,336,19,355
公投第８案,苗栗縣,卓蘭鎮,豐田里,448,999,356,108,464,23,487
公投第８案,苗栗縣,卓蘭鎮,西坪里,449,671,312,69,381,37,418
公投第８案,苗栗縣,卓蘭鎮,苗豐里,450,734,335,90,425,54,479
公投第８案,苗栗縣,卓蘭鎮,上新里,451,865,369,119,488,46,534
公投第８案,苗栗縣,卓蘭鎮,上新里,452,828,378,101,479,42,521
公投第８案,苗栗縣,卓蘭鎮,上新里,453,386,171,44,215,29,244
公投第８案,苗栗縣,卓蘭鎮,內灣里,454,688,319,88,407,37,444
公投第８案,苗栗縣,卓蘭鎮,內灣里,455,792,319,129,448,46,494
公投第８案,苗栗縣,卓蘭鎮,內灣里,456,729,308,93,401,29,430
公投第８案,苗栗縣,卓蘭鎮,坪林里,457,1093,364,118,482,30,512
公投第８案,苗栗縣,卓蘭鎮,坪林里,458,615,277,58,335,11,346
公投第８案,苗栗縣,卓蘭鎮,西坪里,459,86,39,3,42,1,43
公投第８案,苗栗縣,卓蘭鎮,景山里,460,940,389,100,489,19,508
公投第８案,苗栗縣,泰安鄉,八卦村,461,325,106,26,132,14,146
公投第８案,苗栗縣,泰安鄉,錦水村,462,484,195,73,268,17,285
公投第８案,苗栗縣,泰安鄉,錦水村,463,666,341,99,440,46,486
公投第８案,苗栗縣,泰安鄉,清安村,464,574,268,78,346,43,389
公投第８案,苗栗縣,泰安鄉,清安村,465,333,136,24,160,11,171
公投第８案,苗栗縣,泰安鄉,大興村,466,495,265,58,323,12,335
公投第８案,苗栗縣,泰安鄉,中興村,467,544,275,83,358,36,394
公投第８案,苗栗縣,泰安鄉,梅園村,468,500,159,57,216,20,236
公投第８案,苗栗縣,泰安鄉,象鼻村,469,670,320,109,429,50,479
公投第８案,苗栗縣,泰安鄉,士林村,470,589,360,81,441,5,446
公投第８案,彰化縣,彰化市,桃源里,1,871,362,123,485,36,521
公投第８案,彰化縣,彰化市,桃源里,2,751,252,70,322,40,362
公投第８案,彰化縣,彰化市,桃源里,3,923,334,230,564,44,608
公投第８案,彰化縣,彰化市,東興里,4,779,312,115,427,54,481
公投第８案,彰化縣,彰化市,東興里,5,779,324,111,435,45,480
公投第８案,彰化縣,彰化市,華北里,6,720,272,117,389,30,419
公投第８案,彰化縣,彰化市,華北里,7,749,298,112,410,37,447
公投第８案,彰化縣,彰化市,華陽里,8,767,359,94,453,50,503
公投第８案,彰化縣,彰化市,華陽里,9,1047,438,152,590,62,652
公投第８案,彰化縣,彰化市,大同里,10,1027,402,135,537,47,584
公投第８案,彰化縣,彰化市,永生里,11,1249,488,148,636,74,710
公投第８案,彰化縣,彰化市,建寶里,12,1136,465,163,628,48,676
公投第８案,彰化縣,彰化市,建寶里,13,1169,515,150,665,59,724
公投第８案,彰化縣,彰化市,光南里,14,766,343,112,455,27,482
公投第８案,彰化縣,彰化市,光南里,15,643,280,71,351,26,377
公投第８案,彰化縣,彰化市,介壽里,16,1251,567,118,685,68,753
公投第８案,彰化縣,彰化市,介壽里,17,1301,340,125,465,40,505
公投第８案,彰化縣,彰化市,延平里,18,1280,567,157,724,43,767
公投第８案,彰化縣,彰化市,延平里,19,1179,510,168,678,46,724
公投第８案,彰化縣,彰化市,延平里,20,1168,505,142,647,41,688
公投第８案,彰化縣,彰化市,延平里,21,1218,522,149,671,55,726
公投第８案,彰化縣,彰化市,延平里,22,1351,651,180,831,45,876
公投第８案,彰化縣,彰化市,延平里,23,1204,519,202,721,34,755
公投第８案,彰化縣,彰化市,延平里,24,1189,526,161,687,25,712
公投第８案,彰化縣,彰化市,延和里,25,1207,502,150,652,58,710
公投第８案,彰化縣,彰化市,延和里,26,1161,609,34,643,54,697
公投第８案,彰化縣,彰化市,延和里,27,1166,432,176,608,44,652
公投第８案,彰化縣,彰化市,延和里,28,1362,608,171,779,55,834
公投第８案,彰化縣,彰化市,南興里,29,1236,524,202,726,44,770
公投第８案,彰化縣,彰化市,南興里,30,1065,452,143,595,49,644
公投第８案,彰化縣,彰化市,南興里,31,1199,498,160,658,63,721
公投第８案,彰化縣,彰化市,南興里,32,1233,532,169,701,47,748
公投第８案,彰化縣,彰化市,南興里,33,1245,536,146,682,39,721
公投第８案,彰化縣,彰化市,南興里,34,1153,506,180,686,35,721
公投第８案,彰化縣,彰化市,南瑤里,35,1045,421,128,549,44,593
公投第８案,彰化縣,彰化市,南瑤里,36,1097,448,162,610,21,631
公投第８案,彰化縣,彰化市,南瑤里,37,1190,475,156,631,61,692
公投第８案,彰化縣,彰化市,南瑤里,38,1106,483,174,657,36,693
公投第８案,彰化縣,彰化市,南瑤里,39,1097,481,139,620,42,662
公投第８案,彰化縣,彰化市,南瑤里,40,1048,437,154,591,49,640
公投第８案,彰化縣,彰化市,南瑤里,41,980,432,139,571,44,615
公投第８案,彰化縣,彰化市,成功里,42,707,310,113,423,25,448
公投第８案,彰化縣,彰化市,成功里,43,809,336,110,446,43,489
公投第８案,彰化縣,彰化市,福安里,44,1008,420,155,575,56,631
公投第８案,彰化縣,彰化市,西安里,45,901,334,119,453,60,513
公投第８案,彰化縣,彰化市,西安里,46,951,398,110,508,40,548
公投第８案,彰化縣,彰化市,西安里,47,1076,468,139,607,41,648
公投第８案,彰化縣,彰化市,彰安里,48,1022,378,145,523,40,563
公投第８案,彰化縣,彰化市,彰安里,49,894,364,115,479,53,532
公投第８案,彰化縣,彰化市,彰安里,50,1016,430,150,580,47,627
公投第８案,彰化縣,彰化市,中央里,51,771,311,140,451,44,495
公投第８案,彰化縣,彰化市,富貴里,52,868,353,133,486,48,534
公投第８案,彰化縣,彰化市,民權里,53,1135,450,154,604,85,689
公投第８案,彰化縣,彰化市,萬壽里,54,910,348,143,491,67,558
公投第８案,彰化縣,彰化市,長樂里,55,1004,408,157,565,42,607
公投第８案,彰化縣,彰化市,西興里,56,1077,479,139,618,52,670
公投第８案,彰化縣,彰化市,西興里,57,1258,606,162,768,59,827
公投第８案,彰化縣,彰化市,西興里,58,1025,486,121,607,44,651
公投第８案,彰化縣,彰化市,西勢里,59,1177,534,147,681,61,742
公投第８案,彰化縣,彰化市,西勢里,60,1262,516,138,654,62,716
公投第８案,彰化縣,彰化市,西勢里,61,1209,543,153,696,62,758
公投第８案,彰化縣,彰化市,忠權里,62,1041,465,153,618,42,660
公投第８案,彰化縣,彰化市,忠權里,63,1075,490,147,637,36,673
公投第８案,彰化縣,彰化市,忠權里,64,1029,428,97,525,65,590
公投第８案,彰化縣,彰化市,忠孝里,65,1203,467,147,614,84,698
公投第８案,彰化縣,彰化市,五權里,66,1014,418,122,540,45,585
公投第８案,彰化縣,彰化市,五權里,67,1069,470,130,600,40,640
公投第８案,彰化縣,彰化市,五權里,68,969,350,117,467,30,497
公投第８案,彰化縣,彰化市,五權里,69,1105,423,129,552,40,592
公投第８案,彰化縣,彰化市,平和里,70,981,433,147,580,47,627
公投第８案,彰化縣,彰化市,平和里,71,1095,454,172,626,68,694
公投第８案,彰化縣,彰化市,平和里,72,1087,488,154,642,27,669
公投第８案,彰化縣,彰化市,平和里,73,1050,445,143,588,44,632
公投第８案,彰化縣,彰化市,崙平里,74,1252,539,182,721,53,774
公投第８案,彰化縣,彰化市,崙平里,75,1113,439,148,587,34,621
公投第８案,彰化縣,彰化市,崙平里,76,1009,467,134,601,32,633
公投第８案,彰化縣,彰化市,崙平里,77,999,402,134,536,43,579
公投第８案,彰化縣,彰化市,崙平里,78,997,424,135,559,26,585
公投第８案,彰化縣,彰化市,向陽里,79,1145,549,149,698,44,742
公投第８案,彰化縣,彰化市,向陽里,80,1227,504,186,690,26,716
公投第８案,彰化縣,彰化市,向陽里,81,1208,547,172,719,35,754
公投第８案,彰化縣,彰化市,向陽里,82,1598,699,186,885,42,927
公投第８案,彰化縣,彰化市,莿桐里,83,890,390,111,501,48,549
公投第８案,彰化縣,彰化市,莿桐里,84,1104,508,150,658,41,699
公投第８案,彰化縣,彰化市,莿桐里,85,1097,472,132,604,26,630
公投第８案,彰化縣,彰化市,南美里,86,799,323,91,414,50,464
公投第８案,彰化縣,彰化市,南美里,87,1000,451,129,580,43,623
公投第８案,彰化縣,彰化市,南安里,88,1153,455,140,595,81,676
公投第８案,彰化縣,彰化市,南安里,89,977,423,124,547,56,603
公投第８案,彰化縣,彰化市,東芳里,90,1201,480,156,636,61,697
公投第８案,彰化縣,彰化市,東芳里,91,1057,425,186,611,50,661
公投第８案,彰化縣,彰化市,東芳里,92,1238,482,170,652,77,729
公投第８案,彰化縣,彰化市,磚磘里,93,1210,542,163,705,43,748
公投第８案,彰化縣,彰化市,磚磘里,94,1026,458,135,593,44,637
公投第８案,彰化縣,彰化市,磚磘里,95,1061,509,140,649,47,696
公投第８案,彰化縣,彰化市,卦山里,96,1213,512,153,665,58,723
公投第８案,彰化縣,彰化市,卦山里,97,1264,568,158,726,43,769
公投第８案,彰化縣,彰化市,光復里,98,691,288,127,415,50,465
公投第８案,彰化縣,彰化市,永福里,99,893,387,140,527,49,576
公投第８案,彰化縣,彰化市,光華里,100,733,297,118,415,41,456
公投第８案,彰化縣,彰化市,中正里,101,692,269,125,394,45,439
公投第８案,彰化縣,彰化市,中正里,102,728,315,82,397,37,434
公投第８案,彰化縣,彰化市,中山里,103,773,358,105,463,37,500
公投第８案,彰化縣,彰化市,龍山里,104,975,349,118,467,22,489
公投第８案,彰化縣,彰化市,龍山里,105,908,362,147,509,44,553
公投第８案,彰化縣,彰化市,新興里,106,1156,483,178,661,4,665
公投第８案,彰化縣,彰化市,新興里,107,1235,518,176,694,64,758
公投第８案,彰化縣,彰化市,新興里,108,1376,543,178,721,60,781
公投第８案,彰化縣,彰化市,新興里,109,1389,572,167,739,50,789
公投第８案,彰化縣,彰化市,新華里,110,846,300,210,510,50,560
公投第８案,彰化縣,彰化市,新華里,111,859,384,129,513,41,554
公投第８案,彰化縣,彰化市,興北里,112,781,323,126,449,35,484
公投第８案,彰化縣,彰化市,興北里,113,875,355,129,484,36,520
公投第８案,彰化縣,彰化市,信義里,114,816,322,130,452,32,484
公投第８案,彰化縣,彰化市,民生里,115,687,300,99,399,39,438
公投第８案,彰化縣,彰化市,民生里,116,727,321,108,429,44,473
公投第８案,彰化縣,彰化市,文化里,117,662,283,109,392,32,424
公投第８案,彰化縣,彰化市,文化里,118,633,291,91,382,23,405
公投第８案,彰化縣,彰化市,陽明里,119,906,419,130,549,38,587
公投第８案,彰化縣,彰化市,陽明里,120,853,337,109,446,41,487
公投第８案,彰化縣,彰化市,萬安里,121,1027,456,148,604,41,645
公投第８案,彰化縣,彰化市,萬安里,122,993,446,146,592,44,636
公投第８案,彰化縣,彰化市,萬安里,123,848,342,127,469,53,522
公投第８案,彰化縣,彰化市,萬安里,124,1118,518,149,667,32,699
公投第８案,彰化縣,彰化市,下廍里,125,1263,604,67,671,81,752
公投第８案,彰化縣,彰化市,下廍里,126,1268,596,151,747,48,795
公投第８案,彰化縣,彰化市,下廍里,127,1258,551,160,711,60,771
公投第８案,彰化縣,彰化市,下廍里,128,1212,547,161,708,40,748
公投第８案,彰化縣,彰化市,茄苳里,129,924,399,114,513,60,573
公投第８案,彰化縣,彰化市,茄南里,130,939,439,124,563,33,596
公投第８案,彰化縣,彰化市,茄南里,131,953,429,149,578,62,640
公投第８案,彰化縣,彰化市,茄南里,132,981,473,133,606,44,650
公投第８案,彰化縣,彰化市,寶廍里,133,1249,565,146,711,77,788
公投第８案,彰化縣,彰化市,古夷里,134,817,329,117,446,64,510
公投第８案,彰化縣,彰化市,古夷里,135,872,370,107,477,55,532
公投第８案,彰化縣,彰化市,古夷里,136,689,281,91,372,32,404
公投第８案,彰化縣,彰化市,阿夷里,137,1156,552,131,683,43,726
公投第８案,彰化縣,彰化市,阿夷里,138,1291,549,157,706,34,740
公投第８案,彰化縣,彰化市,阿夷里,139,1139,491,128,619,40,659
公投第８案,彰化縣,彰化市,阿夷里,140,1125,516,137,653,52,705
公投第８案,彰化縣,彰化市,阿夷里,141,1258,535,139,674,52,726
公投第８案,彰化縣,彰化市,阿夷里,142,1123,495,122,617,47,664
公投第８案,彰化縣,彰化市,阿夷里,143,1175,500,148,648,51,699
公投第８案,彰化縣,彰化市,和調里,144,862,379,156,535,35,570
公投第８案,彰化縣,彰化市,和調里,145,872,358,124,482,46,528
公投第８案,彰化縣,彰化市,和調里,146,897,424,130,554,20,574
公投第８案,彰化縣,彰化市,復興里,147,1003,410,119,529,29,558
公投第８案,彰化縣,彰化市,復興里,148,915,366,114,480,26,506
公投第８案,彰化縣,彰化市,復興里,149,1158,472,150,622,46,668
公投第８案,彰化縣,彰化市,復興里,150,1084,501,141,642,42,684
公投第８案,彰化縣,彰化市,中庄里,151,1372,632,76,708,68,776
公投第８案,彰化縣,彰化市,中庄里,152,1113,485,145,630,53,683
公投第８案,彰化縣,彰化市,竹中里,153,800,366,100,466,41,507
公投第８案,彰化縣,彰化市,竹中里,154,885,345,130,475,54,529
公投第８案,彰化縣,彰化市,香山里,155,1000,459,120,579,26,605
公投第８案,彰化縣,彰化市,香山里,156,1159,430,149,579,45,624
公投第８案,彰化縣,彰化市,香山里,157,1123,482,121,603,36,639
公投第８案,彰化縣,彰化市,牛埔里,158,907,401,137,538,65,603
公投第８案,彰化縣,彰化市,牛埔里,159,989,376,109,485,77,562
公投第８案,彰化縣,彰化市,牛埔里,160,1012,429,143,572,66,638
公投第８案,彰化縣,彰化市,台鳳里,161,1033,394,124,518,31,549
公投第８案,彰化縣,彰化市,台鳳里,162,1116,503,136,639,43,682
公投第８案,彰化縣,彰化市,台鳳里,163,1154,539,142,681,31,712
公投第８案,彰化縣,彰化市,台鳳里,164,1064,491,112,603,39,642
公投第８案,彰化縣,彰化市,國聖里,165,770,331,119,450,52,502
公投第８案,彰化縣,彰化市,國聖里,166,889,379,142,521,36,557
公投第８案,彰化縣,彰化市,國聖里,167,786,337,106,443,57,500
公投第８案,彰化縣,彰化市,福山里,168,1120,404,158,562,57,619
公投第８案,彰化縣,彰化市,福山里,169,1269,494,141,635,38,673
公投第８案,彰化縣,彰化市,福山里,170,1159,495,157,652,54,706
公投第８案,彰化縣,彰化市,福山里,171,1184,499,168,667,60,727
公投第８案,彰化縣,彰化市,福山里,172,1089,449,144,593,42,635
公投第８案,彰化縣,彰化市,福山里,173,968,416,135,551,53,604
公投第８案,彰化縣,彰化市,安溪里,174,930,413,95,508,36,544
公投第８案,彰化縣,彰化市,安溪里,175,973,424,121,545,44,589
公投第８案,彰化縣,彰化市,三村里,176,1184,437,135,572,36,608
公投第８案,彰化縣,彰化市,大竹里,177,1002,423,132,555,58,613
公投第８案,彰化縣,彰化市,大竹里,178,1148,496,115,611,27,638
公投第８案,彰化縣,彰化市,大竹里,179,1112,466,135,601,45,646
公投第８案,彰化縣,彰化市,田中里,180,907,445,122,567,53,620
公投第８案,彰化縣,彰化市,快官里,181,1112,488,119,607,71,678
公投第８案,彰化縣,彰化市,竹巷里,182,823,301,81,382,42,424
公投第８案,彰化縣,彰化市,福田里,183,1276,543,131,674,70,744
公投第８案,彰化縣,彰化市,石牌里,184,1161,461,143,604,58,662
公投第８案,彰化縣,花壇鄉,花壇村,185,901,371,120,491,50,541
公投第８案,彰化縣,花壇鄉,花壇村,186,1042,335,131,466,48,514
公投第８案,彰化縣,花壇鄉,花壇村,187,1314,514,142,656,28,684
公投第８案,彰化縣,花壇鄉,金墩村,188,808,315,113,428,59,487
公投第８案,彰化縣,花壇鄉,金墩村,189,1019,400,134,534,53,587
公投第８案,彰化縣,花壇鄉,中庄村,190,1144,454,155,609,91,700
公投第８案,彰化縣,花壇鄉,中庄村,191,1240,486,116,602,125,727
公投第８案,彰化縣,花壇鄉,崙雅村,192,1425,615,164,779,100,879
公投第８案,彰化縣,花壇鄉,劉厝村,193,1095,479,163,642,84,726
公投第８案,彰化縣,花壇鄉,南口村,194,910,380,122,502,43,545
公投第８案,彰化縣,花壇鄉,南口村,195,982,416,127,543,36,579
公投第８案,彰化縣,花壇鄉,北口村,196,1070,390,154,544,23,567
公投第８案,彰化縣,花壇鄉,北口村,197,700,277,71,348,22,370
公投第８案,彰化縣,花壇鄉,中口村,198,764,349,100,449,51,500
公投第８案,彰化縣,花壇鄉,文德村,199,953,127,421,548,55,603
公投第８案,彰化縣,花壇鄉,文德村,200,974,403,118,521,34,555
公投第８案,彰化縣,花壇鄉,文德村,201,1111,438,143,581,66,647
公投第８案,彰化縣,花壇鄉,白沙村,202,1101,483,112,595,73,668
公投第８案,彰化縣,花壇鄉,白沙村,203,1110,425,122,547,59,606
公投第８案,彰化縣,花壇鄉,白沙村,204,1262,518,147,665,60,725
公投第８案,彰化縣,花壇鄉,白沙村,205,1103,450,170,620,29,649
公投第８案,彰化縣,花壇鄉,岩竹村,206,1347,470,151,621,76,697
公投第８案,彰化縣,花壇鄉,長沙村,207,1169,443,120,563,71,634
公投第８案,彰化縣,花壇鄉,長沙村,208,1274,542,158,700,64,764
公投第８案,彰化縣,花壇鄉,長沙村,209,1280,582,149,731,60,791
公投第８案,彰化縣,花壇鄉,長沙村,210,1244,533,142,675,46,721
公投第８案,彰化縣,花壇鄉,橋頭村,211,1159,451,159,610,70,680
公投第８案,彰化縣,花壇鄉,橋頭村,212,1042,493,114,607,46,653
公投第８案,彰化縣,花壇鄉,橋頭村,213,1111,436,134,570,50,620
公投第８案,彰化縣,花壇鄉,灣雅村,214,893,395,120,515,52,567
公投第８案,彰化縣,花壇鄉,灣東村,215,953,372,131,503,62,565
公投第８案,彰化縣,花壇鄉,三春村,216,987,377,59,436,35,471
公投第８案,彰化縣,花壇鄉,三春村,217,925,405,135,540,58,598
公投第８案,彰化縣,花壇鄉,永春村,218,951,389,106,495,29,524
公投第８案,彰化縣,花壇鄉,永春村,219,955,397,116,513,31,544
公投第８案,彰化縣,花壇鄉,長春村,220,895,354,103,457,29,486
公投第８案,彰化縣,花壇鄉,長春村,221,711,294,84,378,30,408
公投第８案,彰化縣,芬園鄉,舊社村,222,958,396,93,489,45,534
公投第８案,彰化縣,芬園鄉,舊社村,223,794,304,94,398,56,454
公投第８案,彰化縣,芬園鄉,大埔村,224,1415,493,155,648,98,746
公投第８案,彰化縣,芬園鄉,竹林村,225,927,401,130,531,45,576
公投第８案,彰化縣,芬園鄉,竹林村,226,831,345,83,428,46,474
公投第８案,彰化縣,芬園鄉,楓坑村,227,570,239,61,300,19,319
公投第８案,彰化縣,芬園鄉,社口村,228,1227,449,127,576,57,633
公投第８案,彰化縣,芬園鄉,社口村,229,1238,482,125,607,75,682
公投第８案,彰化縣,芬園鄉,茄荖村,230,1362,515,190,705,80,785
公投第８案,彰化縣,芬園鄉,茄荖村,231,989,399,116,515,66,581
公投第８案,彰化縣,芬園鄉,嘉興村,232,1054,474,124,598,67,665
公投第８案,彰化縣,芬園鄉,嘉興村,233,607,292,75,367,30,397
公投第８案,彰化縣,芬園鄉,芬園村,234,882,385,102,487,49,536
公投第８案,彰化縣,芬園鄉,縣庄村,235,1143,399,110,509,52,561
公投第８案,彰化縣,芬園鄉,圳墘村,236,661,222,53,275,25,300
公投第８案,彰化縣,芬園鄉,溪頭村,237,838,294,101,395,6,401
公投第８案,彰化縣,芬園鄉,溪頭村,238,847,290,113,403,39,442
公投第８案,彰化縣,芬園鄉,進芬村,239,987,401,116,517,75,592
公投第８案,彰化縣,芬園鄉,同安村,240,1217,397,145,542,83,625
公投第８案,彰化縣,芬園鄉,中崙村,241,865,260,94,354,83,437
公投第８案,彰化縣,芬園鄉,大竹村,242,996,355,109,464,51,515
公投第８案,彰化縣,鹿港鎮,大有里,243,1140,470,179,649,60,709
公投第８案,彰化縣,鹿港鎮,中興里,244,511,198,73,271,33,304
公投第８案,彰化縣,鹿港鎮,洛津里,245,857,285,83,368,30,398
公投第８案,彰化縣,鹿港鎮,順興里,246,946,407,138,545,59,604
公投第８案,彰化縣,鹿港鎮,埔崙里,247,945,392,121,513,48,561
公投第８案,彰化縣,鹿港鎮,埔崙里,248,1097,455,126,581,60,641
公投第８案,彰化縣,鹿港鎮,埔崙里,249,1479,535,134,669,41,710
公投第８案,彰化縣,鹿港鎮,埔崙里,250,1425,567,207,774,83,857
公投第８案,彰化縣,鹿港鎮,新宮里,251,880,352,119,471,86,557
公投第８案,彰化縣,鹿港鎮,玉順里,252,1183,437,144,581,77,658
公投第８案,彰化縣,鹿港鎮,東石里,253,1047,426,131,557,80,637
公投第８案,彰化縣,鹿港鎮,東石里,254,1097,403,133,536,30,566
公投第８案,彰化縣,鹿港鎮,東石里,255,1030,402,124,526,67,593
公投第８案,彰化縣,鹿港鎮,東石里,256,1161,478,134,612,54,666
公投第８案,彰化縣,鹿港鎮,郭厝里,257,540,210,74,284,56,340
公投第８案,彰化縣,鹿港鎮,永安里,258,1135,438,153,591,53,644
公投第８案,彰化縣,鹿港鎮,永安里,259,1155,446,153,599,67,666
公投第８案,彰化縣,鹿港鎮,永安里,260,1127,498,150,648,48,696
公投第８案,彰化縣,鹿港鎮,永安里,261,1045,426,138,564,60,624
公投第８案,彰化縣,鹿港鎮,景福里,262,1127,426,159,585,81,666
公投第８案,彰化縣,鹿港鎮,泰興里,263,1178,524,160,684,75,759
公投第８案,彰化縣,鹿港鎮,長興里,264,284,115,38,153,16,169
公投第８案,彰化縣,鹿港鎮,興化里,265,584,222,85,307,38,345
公投第８案,彰化縣,鹿港鎮,龍山里,266,659,299,93,392,41,433
公投第８案,彰化縣,鹿港鎮,菜園里,267,915,347,114,461,23,484
公投第８案,彰化縣,鹿港鎮,街尾里,268,1079,457,153,610,66,676
公投第８案,彰化縣,鹿港鎮,街尾里,269,1129,501,150,651,79,730
公投第８案,彰化縣,鹿港鎮,詔安里,270,1273,499,142,641,62,703
公投第８案,彰化縣,鹿港鎮,詔安里,271,706,273,65,338,36,374
公投第８案,彰化縣,鹿港鎮,海埔里,272,1137,431,107,538,92,630
公投第８案,彰化縣,鹿港鎮,海埔里,273,1195,478,130,608,54,662
公投第８案,彰化縣,鹿港鎮,海埔里,274,1225,486,119,605,57,662
公投第８案,彰化縣,鹿港鎮,洋厝里,275,957,427,135,562,68,630
公投第８案,彰化縣,鹿港鎮,洋厝里,276,758,256,74,330,70,400
公投第８案,彰化縣,鹿港鎮,洋厝里,277,723,293,80,373,57,430
公投第８案,彰化縣,鹿港鎮,草中里,278,984,403,94,497,39,536
公投第８案,彰化縣,鹿港鎮,草中里,279,1018,471,113,584,60,644
公投第８案,彰化縣,鹿港鎮,草中里,280,1165,458,131,589,56,645
公投第８案,彰化縣,鹿港鎮,頭南里,281,1161,432,128,560,54,614
公投第８案,彰化縣,鹿港鎮,頭南里,282,1020,405,102,507,46,553
公投第８案,彰化縣,鹿港鎮,山崙里,283,1068,404,138,542,73,615
公投第８案,彰化縣,鹿港鎮,山崙里,284,1024,437,124,561,41,602
公投第８案,彰化縣,鹿港鎮,山崙里,285,974,390,121,511,88,599
公投第８案,彰化縣,鹿港鎮,頂番里,286,1505,555,168,723,91,814
公投第８案,彰化縣,鹿港鎮,頂番里,287,1092,425,130,555,46,601
公投第８案,彰化縣,鹿港鎮,頂番里,288,1223,518,148,666,76,742
公投第８案,彰化縣,鹿港鎮,頭崙里,289,1572,559,131,690,48,738
公投第８案,彰化縣,鹿港鎮,頭崙里,290,1003,448,113,561,57,618
公投第８案,彰化縣,鹿港鎮,溝墘里,291,933,414,104,518,37,555
公投第８案,彰化縣,鹿港鎮,溝墘里,292,1093,469,132,601,62,663
公投第８案,彰化縣,鹿港鎮,溝墘里,293,907,364,114,478,27,505
公投第８案,彰化縣,鹿港鎮,溝墘里,294,1219,459,165,624,47,671
公投第８案,彰化縣,鹿港鎮,廖厝里,295,1397,643,159,802,83,885
公投第８案,彰化縣,鹿港鎮,廖厝里,296,1229,516,138,654,41,695
公投第８案,彰化縣,鹿港鎮,廖厝里,297,1444,592,145,737,44,781
公投第８案,彰化縣,鹿港鎮,東崎里,298,1227,491,172,663,73,736
公投第８案,彰化縣,鹿港鎮,東崎里,299,1187,477,177,654,67,721
公投第８案,彰化縣,鹿港鎮,東崎里,300,1296,527,128,655,27,682
公投第８案,彰化縣,鹿港鎮,東崎里,301,1451,497,180,677,81,758
公投第８案,彰化縣,鹿港鎮,頂厝里,302,1299,481,179,660,77,737
公投第８案,彰化縣,鹿港鎮,頂厝里,303,1298,600,158,758,45,803
公投第８案,彰化縣,鹿港鎮,頂厝里,304,1458,601,178,779,63,842
公投第８案,彰化縣,鹿港鎮,頂厝里,305,1138,462,151,613,57,670
公投第８案,彰化縣,鹿港鎮,頂厝里,306,1170,476,141,617,65,682
公投第８案,彰化縣,鹿港鎮,頂厝里,307,1221,526,151,677,64,741
公投第８案,彰化縣,福興鄉,三汴村,308,1363,472,197,669,74,743
公投第８案,彰化縣,福興鄉,萬豐村,309,821,338,100,438,35,473
公投第８案,彰化縣,福興鄉,元中村,310,1256,463,128,591,66,657
公投第８案,彰化縣,福興鄉,外中村,311,1166,396,132,528,107,635
公投第８案,彰化縣,福興鄉,外埔村,312,1464,545,162,707,59,766
公投第８案,彰化縣,福興鄉,大崙村,313,1251,459,142,601,58,659
公投第８案,彰化縣,福興鄉,番婆村,314,1465,550,155,705,69,774
公投第８案,彰化縣,福興鄉,番婆村,315,960,333,102,435,34,469
公投第８案,彰化縣,福興鄉,橋頭村,316,1323,457,168,625,89,714
公投第８案,彰化縣,福興鄉,橋頭村,317,1365,599,86,685,68,753
公投第８案,彰化縣,福興鄉,社尾村,318,1458,459,147,606,40,646
公投第８案,彰化縣,福興鄉,番社村,319,1492,602,85,687,101,788
公投第８案,彰化縣,福興鄉,西勢村,320,888,299,93,392,32,424
公投第８案,彰化縣,福興鄉,西勢村,321,1054,436,131,567,62,629
公投第８案,彰化縣,福興鄉,同安村,322,1043,363,108,471,50,521
公投第８案,彰化縣,福興鄉,同安村,323,1340,485,176,661,78,739
公投第８案,彰化縣,福興鄉,秀厝村,324,1085,387,119,506,44,550
公投第８案,彰化縣,福興鄉,秀厝村,325,1392,498,150,648,52,700
公投第８案,彰化縣,福興鄉,福興村,326,1316,557,126,683,91,774
公投第８案,彰化縣,福興鄉,福興村,327,1255,514,180,694,63,757
公投第８案,彰化縣,福興鄉,福興村,328,1101,485,136,621,51,672
公投第８案,彰化縣,福興鄉,福南村,329,1167,471,100,571,85,656
公投第８案,彰化縣,福興鄉,福南村,330,1393,487,159,646,83,729
公投第８案,彰化縣,福興鄉,鎮平村,331,1216,485,143,628,64,692
公投第８案,彰化縣,福興鄉,三和村,332,1063,365,114,479,52,531
公投第８案,彰化縣,福興鄉,二港村,333,1306,484,149,633,74,707
公投第８案,彰化縣,福興鄉,福寶村,334,1287,387,141,528,62,590
公投第８案,彰化縣,福興鄉,頂粘村,335,994,385,123,508,50,558
公投第８案,彰化縣,福興鄉,頂粘村,336,1311,516,148,664,77,741
公投第８案,彰化縣,福興鄉,廈粘村,337,926,379,124,503,46,549
公投第８案,彰化縣,福興鄉,廈粘村,338,995,342,126,468,51,519
公投第８案,彰化縣,福興鄉,麥厝村,339,1079,443,138,581,88,669
公投第８案,彰化縣,福興鄉,麥厝村,340,1150,394,119,513,92,605
公投第８案,彰化縣,秀水鄉,秀水村,341,1066,446,140,586,81,667
公投第８案,彰化縣,秀水鄉,秀水村,342,620,259,93,352,45,397
公投第８案,彰化縣,秀水鄉,安溪村,343,876,322,103,425,16,441
公投第８案,彰化縣,秀水鄉,安溪村,344,1196,494,188,682,55,737
公投第８案,彰化縣,秀水鄉,莊雅村,345,1369,557,178,735,55,790
公投第８案,彰化縣,秀水鄉,莊雅村,346,1273,520,171,691,65,756
公投第８案,彰化縣,秀水鄉,陝西村,347,1433,572,172,744,62,806
公投第８案,彰化縣,秀水鄉,金興村,348,967,409,137,546,24,570
公投第８案,彰化縣,秀水鄉,金興村,349,921,404,109,513,21,534
公投第８案,彰化縣,秀水鄉,安東村,350,689,315,81,396,37,433
公投第８案,彰化縣,秀水鄉,安東村,351,688,281,97,378,43,421
公投第８案,彰化縣,秀水鄉,安東村,352,1252,553,177,730,51,781
公投第８案,彰化縣,秀水鄉,安東村,353,1281,502,144,646,37,683
公投第８案,彰化縣,秀水鄉,鶴鳴村,354,754,302,85,387,30,417
公投第８案,彰化縣,秀水鄉,鶴鳴村,355,1024,403,127,530,52,582
公投第８案,彰化縣,秀水鄉,鶴鳴村,356,1433,597,138,735,28,763
公投第８案,彰化縣,秀水鄉,馬興村,357,1366,611,209,820,54,874
公投第８案,彰化縣,秀水鄉,馬興村,358,895,357,129,486,58,544
公投第８案,彰化縣,秀水鄉,義興村,359,1386,522,152,674,80,754
公投第８案,彰化縣,秀水鄉,福安村,360,896,350,127,477,67,544
公投第８案,彰化縣,秀水鄉,福安村,361,804,368,121,489,40,529
公投第８案,彰化縣,秀水鄉,福安村,362,827,380,104,484,33,517
公投第８案,彰化縣,秀水鄉,福安村,363,996,436,109,545,48,593
公投第８案,彰化縣,秀水鄉,福安村,364,931,442,121,563,54,617
公投第８案,彰化縣,秀水鄉,埔崙村,365,715,281,88,369,35,404
公投第８案,彰化縣,秀水鄉,埔崙村,366,1229,545,172,717,50,767
公投第８案,彰化縣,秀水鄉,曾厝村,367,890,328,97,425,34,459
公投第８案,彰化縣,秀水鄉,曾厝村,368,811,350,105,455,54,509
公投第８案,彰化縣,秀水鄉,金陵村,369,786,332,115,447,39,486
公投第８案,彰化縣,秀水鄉,金陵村,370,931,304,199,503,39,542
公投第８案,彰化縣,秀水鄉,下崙村,371,1265,523,160,683,85,768
公投第８案,彰化縣,秀水鄉,下崙村,372,824,346,73,419,44,463
公投第８案,彰化縣,和美鎮,竹營里,373,1341,491,182,673,62,735
公投第８案,彰化縣,和美鎮,竹營里,374,1480,557,145,702,67,769
公投第８案,彰化縣,和美鎮,竹營里,375,1529,636,178,814,45,859
公投第８案,彰化縣,和美鎮,竹營里,376,1711,660,150,810,29,839
公投第８案,彰化縣,和美鎮,和東里,377,1057,433,141,574,40,614
公投第８案,彰化縣,和美鎮,和東里,378,1032,439,135,574,41,615
公投第８案,彰化縣,和美鎮,和東里,379,1015,426,123,549,70,619
公投第８案,彰化縣,和美鎮,和東里,380,1209,505,179,684,47,731
公投第８案,彰化縣,和美鎮,和南里,381,430,165,66,231,20,251
公投第８案,彰化縣,和美鎮,和北里,382,856,332,113,445,19,464
公投第８案,彰化縣,和美鎮,和北里,383,966,444,97,541,26,567
公投第８案,彰化縣,和美鎮,和西里,384,1059,407,147,554,24,578
公投第８案,彰化縣,和美鎮,和西里,385,1117,436,159,595,43,638
公投第８案,彰化縣,和美鎮,和西里,386,1066,416,137,553,41,594
公投第８案,彰化縣,和美鎮,四張里,387,1252,462,162,624,46,670
公投第８案,彰化縣,和美鎮,四張里,388,1528,588,164,752,53,805
公投第８案,彰化縣,和美鎮,頭前里,389,826,347,113,460,36,496
公投第８案,彰化縣,和美鎮,頭前里,390,854,357,94,451,30,481
公投第８案,彰化縣,和美鎮,面前里,391,1387,559,118,677,63,740
公投第８案,彰化縣,和美鎮,面前里,392,765,334,111,445,32,477
公投第８案,彰化縣,和美鎮,鎮平里,393,1438,564,130,694,56,750
公投第８案,彰化縣,和美鎮,鎮平里,394,1396,607,154,761,69,830
公投第８案,彰化縣,和美鎮,大霞里,395,658,273,78,351,28,379
公投第８案,彰化縣,和美鎮,大霞里,396,809,383,98,481,34,515
公投第８案,彰化縣,和美鎮,源埤里,397,932,353,112,465,16,481
公投第８案,彰化縣,和美鎮,源埤里,398,888,360,93,453,34,487
公投第８案,彰化縣,和美鎮,南佃里,399,1144,483,168,651,49,700
公投第８案,彰化縣,和美鎮,南佃里,400,1077,456,105,561,48,609
公投第８案,彰化縣,和美鎮,雅溝里,401,1349,502,146,648,61,709
公投第８案,彰化縣,和美鎮,山犁里,402,1155,509,160,669,51,720
公投第８案,彰化縣,和美鎮,山犁里,403,1253,525,137,662,34,696
公投第８案,彰化縣,和美鎮,山犁里,404,1252,514,122,636,47,683
公投第８案,彰化縣,和美鎮,山犁里,405,1474,584,165,749,30,779
公投第８案,彰化縣,和美鎮,仁愛里,406,1396,516,129,645,39,684
公投第８案,彰化縣,和美鎮,仁愛里,407,1348,554,125,679,47,726
公投第８案,彰化縣,和美鎮,嘉犁里,408,999,458,122,580,40,620
公投第８案,彰化縣,和美鎮,嘉犁里,409,911,367,132,499,52,551
公投第８案,彰化縣,和美鎮,詔安里,410,1005,395,161,556,33,589
公投第８案,彰化縣,和美鎮,詔安里,411,967,395,122,517,44,561
公投第８案,彰化縣,和美鎮,鐵山里,412,1308,536,174,710,51,761
公投第８案,彰化縣,和美鎮,鐵山里,413,1324,539,160,699,47,746
公投第８案,彰化縣,和美鎮,柑井里,414,1102,419,173,592,64,656
公投第８案,彰化縣,和美鎮,柑井里,415,1124,425,141,566,52,618
公投第８案,彰化縣,和美鎮,柑井里,416,1211,444,199,643,59,702
公投第８案,彰化縣,和美鎮,竹園里,417,884,403,148,551,42,593
公投第８案,彰化縣,和美鎮,新庄里,418,1119,421,156,577,74,651
公投第８案,彰化縣,和美鎮,新庄里,419,1300,517,158,675,62,737
公投第８案,彰化縣,和美鎮,犁盛里,420,1104,434,126,560,47,607
公投第８案,彰化縣,和美鎮,犁盛里,421,1213,628,73,701,37,738
公投第８案,彰化縣,和美鎮,中寮里,422,1127,398,131,529,48,577
公投第８案,彰化縣,和美鎮,中圍里,423,919,358,107,465,57,522
公投第８案,彰化縣,和美鎮,中圍里,424,987,418,128,546,49,595
公投第８案,彰化縣,和美鎮,中圍里,425,958,406,137,543,48,591
公投第８案,彰化縣,和美鎮,糖友里,426,1362,574,168,742,47,789
公投第８案,彰化縣,和美鎮,糖友里,427,1461,611,152,763,30,793
公投第８案,彰化縣,和美鎮,糖友里,428,1405,601,172,773,34,807
公投第８案,彰化縣,和美鎮,還社里,429,860,370,106,476,45,521
公投第８案,彰化縣,和美鎮,塗厝里,430,875,366,84,450,20,470
公投第８案,彰化縣,和美鎮,塗厝里,431,871,349,109,458,44,502
公投第８案,彰化縣,和美鎮,地潭里,432,883,386,119,505,45,550
公投第８案,彰化縣,和美鎮,湖內里,433,1224,439,176,615,58,673
公投第８案,彰化縣,和美鎮,嘉寶里,434,1075,420,134,554,43,597
公投第８案,彰化縣,和美鎮,嘉寶里,435,956,375,125,500,41,541
公投第８案,彰化縣,和美鎮,月眉里,436,1037,396,124,520,57,577
公投第８案,彰化縣,和美鎮,月眉里,437,1011,420,110,530,25,555
公投第８案,彰化縣,和美鎮,月眉里,438,1023,376,138,514,57,571
公投第８案,彰化縣,和美鎮,好修里,439,719,281,83,364,27,391
公投第８案,彰化縣,和美鎮,好修里,440,913,346,126,472,45,517
公投第８案,彰化縣,伸港鄉,大同村,441,1182,461,89,550,44,594
公投第８案,彰化縣,伸港鄉,大同村,442,1166,555,115,670,47,717
公投第８案,彰化縣,伸港鄉,海尾村,443,966,401,106,507,51,558
公投第８案,彰化縣,伸港鄉,海尾村,444,873,349,96,445,42,487
公投第８案,彰化縣,伸港鄉,全興村,445,812,336,103,439,50,489
公投第８案,彰化縣,伸港鄉,全興村,446,875,365,90,455,37,492
公投第８案,彰化縣,伸港鄉,溪底村,447,904,349,106,455,48,503
公投第８案,彰化縣,伸港鄉,溪底村,448,1008,404,113,517,43,560
公投第８案,彰化縣,伸港鄉,定興村,449,1154,480,140,620,63,683
公投第８案,彰化縣,伸港鄉,定興村,450,1486,546,161,707,77,784
公投第８案,彰化縣,伸港鄉,什股村,451,1095,438,118,556,52,608
公投第８案,彰化縣,伸港鄉,什股村,452,1087,399,130,529,28,557
公投第８案,彰化縣,伸港鄉,泉州村,453,1085,450,138,588,58,646
公投第８案,彰化縣,伸港鄉,泉州村,454,908,398,100,498,45,543
公投第８案,彰化縣,伸港鄉,泉厝村,455,1264,586,129,715,44,759
公投第８案,彰化縣,伸港鄉,曾家村,456,854,319,94,413,57,470
公投第８案,彰化縣,伸港鄉,曾家村,457,846,304,89,393,33,426
公投第８案,彰化縣,伸港鄉,蚵寮村,458,1143,388,117,505,104,609
公投第８案,彰化縣,伸港鄉,新港村,459,1357,557,155,712,38,750
公投第８案,彰化縣,伸港鄉,新港村,460,1349,503,180,683,62,745
公投第８案,彰化縣,伸港鄉,新港村,461,1154,478,143,621,55,676
公投第８案,彰化縣,伸港鄉,新港村,462,1279,498,153,651,44,695
公投第８案,彰化縣,伸港鄉,埤墘村,463,1317,657,53,710,64,774
公投第８案,彰化縣,伸港鄉,七嘉村,464,990,419,137,556,48,604
公投第８案,彰化縣,伸港鄉,七嘉村,465,852,381,90,471,32,503
公投第８案,彰化縣,伸港鄉,七嘉村,466,1178,502,142,644,31,675
公投第８案,彰化縣,伸港鄉,汴頭村,467,1088,418,108,526,74,600
公投第８案,彰化縣,伸港鄉,汴頭村,468,1135,444,139,583,63,646
公投第８案,彰化縣,線西鄉,線西村,469,1071,456,117,573,34,607
公投第８案,彰化縣,線西鄉,線西村,470,1166,520,129,649,43,692
公投第８案,彰化縣,線西鄉,頂庄村,471,1269,504,173,677,75,752
公投第８案,彰化縣,線西鄉,寓埔村,472,1138,457,136,593,60,653
公投第８案,彰化縣,線西鄉,寓埔村,473,1128,499,145,644,75,719
公投第８案,彰化縣,線西鄉,塭仔村,474,1275,524,159,683,83,766
公投第８案,彰化縣,線西鄉,溝內村,475,1187,500,149,649,58,707
公投第８案,彰化縣,線西鄉,下犁村,476,991,415,132,547,57,604
公投第８案,彰化縣,線西鄉,下犁村,477,938,375,128,503,58,561
公投第８案,彰化縣,線西鄉,頂犁村,478,1276,479,137,616,63,679
公投第８案,彰化縣,線西鄉,頂犁村,479,1285,551,142,693,63,756
公投第８案,彰化縣,線西鄉,德興村,480,1341,627,176,803,77,880
公投第８案,彰化縣,員林市,崙雅里,481,1087,443,91,534,25,559
公投第８案,彰化縣,員林市,崙雅里,482,1353,501,163,664,36,700
公投第８案,彰化縣,員林市,振興里,483,1313,495,142,637,57,694
公投第８案,彰化縣,員林市,振興里,484,1328,443,129,572,27,599
公投第８案,彰化縣,員林市,林厝里,485,1055,411,152,563,34,597
公投第８案,彰化縣,員林市,林厝里,486,959,385,92,477,44,521
公投第８案,彰化縣,員林市,林厝里,487,772,315,93,408,43,451
公投第８案,彰化縣,員林市,出水里,488,831,359,107,466,44,510
公投第８案,彰化縣,員林市,出水里,489,854,253,76,329,15,344
公投第８案,彰化縣,員林市,湖水里,490,1190,378,117,495,38,533
公投第８案,彰化縣,員林市,大峯里,491,726,306,73,379,20,399
公投第８案,彰化縣,員林市,鎮興里,492,1124,429,136,565,65,630
公投第８案,彰化縣,員林市,鎮興里,493,860,293,92,385,62,447
公投第８案,彰化縣,員林市,浮圳里,494,1122,480,138,618,58,676
公投第８案,彰化縣,員林市,浮圳里,495,1075,440,148,588,50,638
公投第８案,彰化縣,員林市,西東里,496,993,357,125,482,69,551
公投第８案,彰化縣,員林市,西東里,497,967,362,112,474,31,505
公投第８案,彰化縣,員林市,南東里,498,1008,371,143,514,63,577
公投第８案,彰化縣,員林市,南東里,499,804,298,107,405,49,454
公投第８案,彰化縣,員林市,中東里,500,867,340,112,452,32,484
公投第８案,彰化縣,員林市,中東里,501,885,345,92,437,30,467
公投第８案,彰化縣,員林市,東北里,502,1097,367,85,452,18,470
公投第８案,彰化縣,員林市,東北里,503,1255,493,136,629,33,662
公投第８案,彰化縣,員林市,東和里,504,1063,427,145,572,48,620
公投第８案,彰化縣,員林市,民生里,505,925,308,176,484,33,517
公投第８案,彰化縣,員林市,民生里,506,947,370,138,508,49,557
公投第８案,彰化縣,員林市,民生里,507,916,385,129,514,31,545
公投第８案,彰化縣,員林市,黎明里,508,862,349,95,444,34,478
公投第８案,彰化縣,員林市,黎明里,509,987,411,123,534,24,558
公投第８案,彰化縣,員林市,惠來里,510,1085,422,128,550,47,597
公投第８案,彰化縣,員林市,惠來里,511,1110,473,136,609,29,638
公投第８案,彰化縣,員林市,惠來里,512,1095,408,127,535,24,559
公投第８案,彰化縣,員林市,惠來里,513,1278,613,130,743,38,781
公投第８案,彰化縣,員林市,惠來里,514,1109,494,115,609,44,653
公投第８案,彰化縣,員林市,中央里,515,1055,404,137,541,61,602
公投第８案,彰化縣,員林市,中央里,516,876,380,122,502,32,534
公投第８案,彰化縣,員林市,溝皂里,517,1115,379,133,512,44,556
公投第８案,彰化縣,員林市,溝皂里,518,1186,513,128,641,48,689
公投第８案,彰化縣,員林市,大饒里,519,995,449,107,556,44,600
公投第８案,彰化縣,員林市,大饒里,520,999,397,108,505,12,517
公投第８案,彰化縣,員林市,大饒里,521,1201,472,145,617,41,658
公投第８案,彰化縣,員林市,大明里,522,1342,555,140,695,35,730
公投第８案,彰化縣,員林市,大明里,523,1086,405,139,544,32,576
公投第８案,彰化縣,員林市,萬年里,524,854,326,98,424,33,457
公投第８案,彰化縣,員林市,萬年里,525,1064,435,120,555,36,591
公投第８案,彰化縣,員林市,萬年里,526,879,385,114,499,19,518
公投第８案,彰化縣,員林市,萬年里,527,827,427,103,530,31,561
公投第８案,彰化縣,員林市,中正里,528,867,352,88,440,18,458
公投第８案,彰化縣,員林市,中正里,529,1201,497,142,639,39,678
公投第８案,彰化縣,員林市,中正里,530,1106,475,126,601,42,643
公投第８案,彰化縣,員林市,仁美里,531,845,331,125,456,48,504
公投第８案,彰化縣,員林市,仁美里,532,894,373,116,489,36,525
公投第８案,彰化縣,員林市,仁美里,533,849,352,111,463,42,505
公投第８案,彰化縣,員林市,新興里,534,747,315,105,420,50,470
公投第８案,彰化縣,員林市,和平里,535,884,405,114,519,29,548
公投第８案,彰化縣,員林市,和平里,536,900,341,101,442,36,478
公投第８案,彰化縣,員林市,和平里,537,1040,386,128,514,30,544
公投第８案,彰化縣,員林市,光明里,538,831,307,125,432,22,454
公投第８案,彰化縣,員林市,中山里,539,591,256,86,342,40,382
公投第８案,彰化縣,員林市,三條里,540,1330,500,174,674,49,723
公投第８案,彰化縣,員林市,三條里,541,1295,567,126,693,37,730
公投第８案,彰化縣,員林市,忠孝里,542,1283,506,143,649,66,715
公投第８案,彰化縣,員林市,忠孝里,543,943,404,125,529,38,567
公投第８案,彰化縣,員林市,仁愛里,544,1388,597,185,782,59,841
公投第８案,彰化縣,員林市,三和里,545,1176,534,108,642,35,677
公投第８案,彰化縣,員林市,三和里,546,867,315,87,402,13,415
公投第８案,彰化縣,員林市,三和里,547,1121,424,139,563,49,612
公投第８案,彰化縣,員林市,三和里,548,1190,455,134,589,39,628
公投第８案,彰化縣,員林市,三和里,549,945,410,120,530,35,565
公投第８案,彰化縣,員林市,三和里,550,906,400,109,509,36,545
公投第８案,彰化縣,員林市,三橋里,551,978,393,154,547,48,595
公投第８案,彰化縣,員林市,三橋里,552,949,416,94,510,45,555
公投第８案,彰化縣,員林市,三橋里,553,949,412,109,521,29,550
公投第８案,彰化縣,員林市,三愛里,554,1006,418,109,527,35,562
公投第８案,彰化縣,員林市,三愛里,555,889,361,123,484,44,528
公投第８案,彰化縣,員林市,三愛里,556,923,418,123,541,28,569
公投第８案,彰化縣,員林市,三信里,557,1209,538,163,701,39,740
公投第８案,彰化縣,員林市,三信里,558,1075,471,138,609,41,650
公投第８案,彰化縣,員林市,三多里,559,1342,620,160,780,44,824
公投第８案,彰化縣,員林市,三多里,560,1039,486,160,646,42,688
公投第８案,彰化縣,員林市,三義里,561,1131,425,128,553,77,630
公投第８案,彰化縣,員林市,三義里,562,1356,497,168,665,35,700
公投第８案,彰化縣,員林市,新生里,563,1370,556,147,703,64,767
公投第８案,彰化縣,員林市,新生里,564,1090,446,143,589,46,635
公投第８案,彰化縣,員林市,新生里,565,821,391,108,499,31,530
公投第８案,彰化縣,員林市,新生里,566,910,388,117,505,36,541
公投第８案,彰化縣,員林市,南平里,567,1203,484,147,631,50,681
公投第８案,彰化縣,員林市,南平里,568,1378,553,166,719,55,774
公投第８案,彰化縣,員林市,南平里,569,1352,563,174,737,34,771
公投第８案,彰化縣,員林市,南平里,570,1060,462,165,627,23,650
公投第８案,彰化縣,員林市,南興里,571,1317,529,136,665,54,719
公投第８案,彰化縣,員林市,南興里,572,1120,425,138,563,44,607
公投第８案,彰化縣,員林市,南興里,573,1025,403,109,512,42,554
公投第８案,彰化縣,員林市,南興里,574,1097,434,143,577,53,630
公投第８案,彰化縣,員林市,源潭里,575,859,350,134,484,44,528
公投第８案,彰化縣,員林市,源潭里,576,837,306,113,419,46,465
公投第８案,彰化縣,員林市,大埔里,577,1090,478,150,628,55,683
公投第８案,彰化縣,員林市,大埔里,578,1073,410,131,541,68,609
公投第８案,彰化縣,大村鄉,大村村,579,1426,655,177,832,70,902
公投第８案,彰化縣,大村鄉,大村村,580,1726,793,200,993,83,1076
公投第８案,彰化縣,大村鄉,茄苳村,581,797,334,110,444,61,505
公投第８案,彰化縣,大村鄉,茄苳村,582,745,300,92,392,21,413
公投第８案,彰化縣,大村鄉,田洋村,583,1125,493,132,625,63,688
公投第８案,彰化縣,大村鄉,貢旗村,584,1486,569,196,765,97,862
公投第８案,彰化縣,大村鄉,南勢村,585,1426,590,169,759,74,833
公投第８案,彰化縣,大村鄉,大橋村,586,824,360,120,480,44,524
公投第８案,彰化縣,大村鄉,大橋村,587,1177,440,118,558,43,601
公投第８案,彰化縣,大村鄉,加錫村,588,1478,635,174,809,72,881
公投第８案,彰化縣,大村鄉,大崙村,589,779,295,92,387,19,406
公投第８案,彰化縣,大村鄉,大崙村,590,812,357,98,455,55,510
公投第８案,彰化縣,大村鄉,新興村,591,1161,465,131,596,39,635
公投第８案,彰化縣,大村鄉,擺塘村,592,1238,486,133,619,34,653
公投第８案,彰化縣,大村鄉,擺塘村,593,1259,515,154,669,58,727
公投第８案,彰化縣,大村鄉,過溝村,594,1412,606,158,764,56,820
公投第８案,彰化縣,大村鄉,過溝村,595,1401,582,177,759,30,789
公投第８案,彰化縣,大村鄉,村上村,596,1395,592,167,759,79,838
公投第８案,彰化縣,大村鄉,美港村,597,996,390,149,539,62,601
公投第８案,彰化縣,大村鄉,美港村,598,1047,430,129,559,52,611
公投第８案,彰化縣,大村鄉,美港村,599,985,425,119,544,40,584
公投第８案,彰化縣,大村鄉,黃厝村,600,1054,470,140,610,48,658
公投第８案,彰化縣,大村鄉,黃厝村,601,1200,515,147,662,50,712
公投第８案,彰化縣,大村鄉,福興村,602,1003,437,110,547,71,618
公投第８案,彰化縣,大村鄉,福興村,603,1046,403,129,532,40,572
公投第８案,彰化縣,大村鄉,平和村,604,1189,519,138,657,55,712
公投第８案,彰化縣,大村鄉,平和村,605,1305,496,148,644,61,705
公投第８案,彰化縣,永靖鄉,浮圳村,606,1255,460,128,588,76,664
公投第８案,彰化縣,永靖鄉,東寧村,607,889,367,113,480,62,542
公投第８案,彰化縣,永靖鄉,東寧村,608,1026,407,129,536,41,577
公投第８案,彰化縣,永靖鄉,光雲村,609,724,315,87,402,46,448
公投第８案,彰化縣,永靖鄉,光雲村,610,924,373,134,507,43,550
公投第８案,彰化縣,永靖鄉,五汴村,611,659,280,97,377,43,420
公投第８案,彰化縣,永靖鄉,五汴村,612,734,313,87,400,32,432
公投第８案,彰化縣,永靖鄉,永興村,613,758,243,82,325,29,354
公投第８案,彰化縣,永靖鄉,永興村,614,848,388,15,403,49,452
公投第８案,彰化縣,永靖鄉,崙子村,615,1404,506,166,672,88,760
公投第８案,彰化縣,永靖鄉,永東村,616,792,381,115,496,53,549
公投第８案,彰化縣,永靖鄉,永西村,617,695,293,99,392,51,443
公投第８案,彰化縣,永靖鄉,永西村,618,821,387,80,467,42,509
公投第８案,彰化縣,永靖鄉,永南村,619,1064,464,127,591,76,667
公投第８案,彰化縣,永靖鄉,永南村,620,840,321,116,437,43,480
公投第８案,彰化縣,永靖鄉,永北村,621,1079,462,161,623,43,666
公投第８案,彰化縣,永靖鄉,永北村,622,1048,471,138,609,45,654
公投第８案,彰化縣,永靖鄉,港西村,623,960,445,126,571,45,616
公投第８案,彰化縣,永靖鄉,港西村,624,798,344,109,453,28,481
公投第８案,彰化縣,永靖鄉,五福村,625,796,355,126,481,46,527
公投第８案,彰化縣,永靖鄉,五福村,626,662,257,84,341,39,380
公投第８案,彰化縣,永靖鄉,湳港村,627,1040,412,139,551,57,608
公投第８案,彰化縣,永靖鄉,新莊村,628,1025,397,131,528,56,584
公投第８案,彰化縣,永靖鄉,瑚璉村,629,1357,628,186,814,65,879
公投第８案,彰化縣,永靖鄉,瑚璉村,630,1236,544,133,677,69,746
公投第８案,彰化縣,永靖鄉,獨鰲村,631,871,364,110,474,50,524
公投第８案,彰化縣,永靖鄉,敦厚村,632,706,265,76,341,44,385
公投第８案,彰化縣,永靖鄉,崙美村,633,770,364,99,463,40,503
公投第８案,彰化縣,永靖鄉,同安村,634,669,314,90,404,35,439
公投第８案,彰化縣,永靖鄉,同仁村,635,862,336,105,441,52,493
公投第８案,彰化縣,永靖鄉,湳墘村,636,847,329,94,423,49,472
公投第８案,彰化縣,永靖鄉,四芳村,637,668,300,78,378,51,429
公投第８案,彰化縣,永靖鄉,福興村,638,1073,377,122,499,38,537
公投第８案,彰化縣,永靖鄉,竹子村,639,1339,427,163,590,64,654
公投第８案,彰化縣,溪湖鎮,光平里,640,1221,477,146,623,54,677
公投第８案,彰化縣,溪湖鎮,平和里,641,638,286,87,373,36,409
公投第８案,彰化縣,溪湖鎮,太平里,642,817,347,91,438,47,485
公投第８案,彰化縣,溪湖鎮,太平里,643,968,435,103,538,46,584
公投第８案,彰化縣,溪湖鎮,光華里,644,448,221,57,278,17,295
公投第８案,彰化縣,溪湖鎮,湖東里,645,1123,412,121,533,34,567
公投第８案,彰化縣,溪湖鎮,湖東里,646,1166,458,140,598,58,656
公投第８案,彰化縣,溪湖鎮,湖東里,647,1151,462,141,603,39,642
公投第８案,彰化縣,溪湖鎮,湖東里,648,1249,522,159,681,42,723
公投第８案,彰化縣,溪湖鎮,中山里,649,1146,473,149,622,57,679
公投第８案,彰化縣,溪湖鎮,中山里,650,1199,505,120,625,64,689
公投第８案,彰化縣,溪湖鎮,西溪里,651,895,364,108,472,49,521
公投第８案,彰化縣,溪湖鎮,西溪里,652,964,432,113,545,21,566
公投第８案,彰化縣,溪湖鎮,中竹里,653,851,350,115,465,31,496
公投第８案,彰化縣,溪湖鎮,東寮里,654,1072,443,126,569,40,609
公投第８案,彰化縣,溪湖鎮,東寮里,655,1113,477,134,611,57,668
公投第８案,彰化縣,溪湖鎮,東寮里,656,1090,481,132,613,41,654
公投第８案,彰化縣,溪湖鎮,西寮里,657,1193,554,120,674,42,716
公投第８案,彰化縣,溪湖鎮,西寮里,658,952,431,100,531,60,591
公投第８案,彰化縣,溪湖鎮,大突里,659,1172,467,146,613,61,674
公投第８案,彰化縣,溪湖鎮,大突里,660,1027,474,109,583,9,592
公投第８案,彰化縣,溪湖鎮,大突里,661,1188,596,96,692,54,746
公投第８案,彰化縣,溪湖鎮,北勢里,662,1403,512,175,687,63,750
公投第８案,彰化縣,溪湖鎮,汴頭里,663,1397,486,150,636,80,716
公投第８案,彰化縣,溪湖鎮,汴頭里,664,1636,643,202,845,63,908
公投第８案,彰化縣,溪湖鎮,大竹里,665,1298,542,141,683,85,768
公投第８案,彰化縣,溪湖鎮,大竹里,666,1214,520,119,639,59,698
公投第８案,彰化縣,溪湖鎮,湖西里,667,1297,589,132,721,55,776
公投第８案,彰化縣,溪湖鎮,湖西里,668,968,452,98,550,55,605
公投第８案,彰化縣,溪湖鎮,田中里,669,839,343,124,467,37,504
公投第８案,彰化縣,溪湖鎮,河東里,670,907,385,121,506,45,551
公投第８案,彰化縣,溪湖鎮,河東里,671,898,332,90,422,20,442
公投第８案,彰化縣,溪湖鎮,頂庄里,672,650,330,87,417,32,449
公投第８案,彰化縣,溪湖鎮,忠覺里,673,1279,519,134,653,84,737
公投第８案,彰化縣,溪湖鎮,湳底里,674,730,307,98,405,54,459
公投第８案,彰化縣,溪湖鎮,大庭里,675,1407,690,45,735,75,810
公投第８案,彰化縣,溪湖鎮,媽厝里,676,1273,422,157,579,62,641
公投第８案,彰化縣,溪湖鎮,番婆里,677,988,406,104,510,32,542
公投第８案,彰化縣,溪湖鎮,番婆里,678,754,335,94,429,52,481
公投第８案,彰化縣,溪湖鎮,西勢里,679,1052,337,134,471,54,525
公投第８案,彰化縣,溪湖鎮,西勢里,680,1149,435,136,571,45,616
公投第８案,彰化縣,溪湖鎮,東溪里,681,1365,564,201,765,98,863
公投第８案,彰化縣,埔鹽鄉,埔鹽村,682,958,429,118,547,46,593
公投第８案,彰化縣,埔鹽鄉,埔鹽村,683,754,355,105,460,35,495
公投第８案,彰化縣,埔鹽鄉,埔南村,684,757,362,106,468,33,501
公投第８案,彰化縣,埔鹽鄉,埔南村,685,806,370,101,471,33,504
公投第８案,彰化縣,埔鹽鄉,廍子村,686,1280,600,114,714,51,765
公投第８案,彰化縣,埔鹽鄉,出水村,687,928,409,97,506,46,552
公投第８案,彰化縣,埔鹽鄉,南港村,688,895,387,142,529,60,589
公投第８案,彰化縣,埔鹽鄉,南港村,689,815,362,110,472,53,525
公投第８案,彰化縣,埔鹽鄉,打廉村,690,957,406,112,518,41,559
公投第８案,彰化縣,埔鹽鄉,豐澤村,691,1338,555,124,679,107,786
公投第８案,彰化縣,埔鹽鄉,崑崙村,692,1106,454,120,574,60,634
公投第８案,彰化縣,埔鹽鄉,角樹村,693,690,325,99,424,45,469
公投第８案,彰化縣,埔鹽鄉,瓦磘村,694,1230,519,136,655,50,705
公投第８案,彰化縣,埔鹽鄉,好修村,695,847,359,95,454,32,486
公投第８案,彰化縣,埔鹽鄉,好修村,696,897,413,121,534,28,562
公投第８案,彰化縣,埔鹽鄉,西湖村,697,882,362,118,480,49,529
公投第８案,彰化縣,埔鹽鄉,西湖村,698,1180,532,139,671,45,716
公投第８案,彰化縣,埔鹽鄉,大有村,699,1215,465,155,620,85,705
公投第８案,彰化縣,埔鹽鄉,新興村,700,422,227,27,254,27,281
公投第８案,彰化縣,埔鹽鄉,永平村,701,1106,482,83,565,53,618
公投第８案,彰化縣,埔鹽鄉,永樂村,702,874,383,120,503,62,565
公投第８案,彰化縣,埔鹽鄉,石埤村,703,1445,585,173,758,99,857
公投第８案,彰化縣,埔鹽鄉,天盛村,704,875,375,111,486,62,548
公投第８案,彰化縣,埔鹽鄉,太平村,705,837,309,82,391,55,446
公投第８案,彰化縣,埔鹽鄉,太平村,706,685,307,77,384,28,412
公投第８案,彰化縣,埔鹽鄉,新水村,707,733,326,89,415,49,464
公投第８案,彰化縣,埔鹽鄉,新水村,708,798,106,313,419,76,495
公投第８案,彰化縣,埔鹽鄉,三省村,709,1381,574,157,731,65,796
公投第８案,彰化縣,埔鹽鄉,南新村,710,1335,512,142,654,52,706
公投第８案,彰化縣,埔心鄉,東門村,711,1139,484,137,621,88,709
公投第８案,彰化縣,埔心鄉,東門村,712,1217,470,167,637,77,714
公投第８案,彰化縣,埔心鄉,東門村,713,1248,542,215,757,55,812
公投第８案,彰化縣,埔心鄉,埔心村,714,1248,521,191,712,80,792
公投第８案,彰化縣,埔心鄉,義民村,715,916,377,139,516,49,565
公投第８案,彰化縣,埔心鄉,義民村,716,625,290,88,378,33,411
公投第８案,彰化縣,埔心鄉,油車村,717,1271,489,160,649,83,732
公投第８案,彰化縣,埔心鄉,瓦北村,718,608,270,76,346,30,376
公投第８案,彰化縣,埔心鄉,瓦北村,719,1132,503,148,651,42,693
公投第８案,彰化縣,埔心鄉,瓦中村,720,1027,433,143,576,64,640
公投第８案,彰化縣,埔心鄉,瓦中村,721,926,401,131,532,53,585
公投第８案,彰化縣,埔心鄉,瓦南村,722,778,307,112,419,63,482
公投第８案,彰化縣,埔心鄉,瓦南村,723,660,304,84,388,38,426
公投第８案,彰化縣,埔心鄉,經口村,724,1330,585,167,752,68,820
公投第８案,彰化縣,埔心鄉,經口村,725,991,404,147,551,29,580
公投第８案,彰化縣,埔心鄉,太平村,726,985,418,129,547,43,590
公投第８案,彰化縣,埔心鄉,太平村,727,1034,416,142,558,38,596
公投第８案,彰化縣,埔心鄉,大華村,728,612,260,90,350,46,396
公投第８案,彰化縣,埔心鄉,仁里村,729,1236,567,155,722,67,789
公投第８案,彰化縣,埔心鄉,舊舘村,730,775,331,108,439,52,491
公投第８案,彰化縣,埔心鄉,舊舘村,731,738,317,127,444,47,491
公投第８案,彰化縣,埔心鄉,南舘村,732,1036,420,163,583,47,630
公投第８案,彰化縣,埔心鄉,新舘村,733,975,355,125,480,78,558
公投第８案,彰化縣,埔心鄉,芎蕉村,734,885,362,114,476,45,521
公投第８案,彰化縣,埔心鄉,芎蕉村,735,939,393,132,525,64,589
公投第８案,彰化縣,埔心鄉,羅厝村,736,689,295,78,373,38,411
公投第８案,彰化縣,埔心鄉,羅厝村,737,659,272,82,354,33,387
公投第８案,彰化縣,埔心鄉,梧鳳村,738,910,348,102,450,43,493
公投第８案,彰化縣,埔心鄉,二重村,739,1352,595,217,812,81,893
公投第８案,彰化縣,埔心鄉,埤霞村,740,759,301,93,394,44,438
公投第８案,彰化縣,埔心鄉,埤脚村,741,942,427,91,518,49,567
公投第８案,彰化縣,田中鎮,香山里,742,854,296,93,389,87,476
公投第８案,彰化縣,田中鎮,碧峰里,743,963,342,96,438,51,489
公投第８案,彰化縣,田中鎮,碧峰里,744,175,24,14,38,7,45
公投第８案,彰化縣,田中鎮,東源里,745,739,276,82,358,36,394
公投第８案,彰化縣,田中鎮,復興里,746,826,305,95,400,39,439
公投第８案,彰化縣,田中鎮,復興里,747,741,286,106,392,55,447
公投第８案,彰化縣,田中鎮,平和里,748,506,165,40,205,12,217
公投第８案,彰化縣,田中鎮,平和里,749,1001,367,110,477,45,522
公投第８案,彰化縣,田中鎮,頂潭里,750,1281,509,151,660,83,743
公投第８案,彰化縣,田中鎮,新庄里,751,1035,412,125,537,57,594
公投第８案,彰化縣,田中鎮,新庄里,752,1327,557,167,724,54,778
公投第８案,彰化縣,田中鎮,中潭里,753,844,374,102,476,43,519
公投第８案,彰化縣,田中鎮,中潭里,754,913,360,108,468,53,521
公投第８案,彰化縣,田中鎮,龍潭里,755,613,277,82,359,44,403
公投第８案,彰化縣,田中鎮,北路里,756,1382,564,181,745,75,820
公投第８案,彰化縣,田中鎮,北路里,757,1034,505,126,631,46,677
公投第８案,彰化縣,田中鎮,北路里,758,935,453,123,576,41,617
公投第８案,彰化縣,田中鎮,西路里,759,1301,523,173,696,52,748
公投第８案,彰化縣,田中鎮,西路里,760,1100,472,152,624,40,664
公投第８案,彰化縣,田中鎮,東路里,761,1071,438,149,587,53,640
公投第８案,彰化縣,田中鎮,南路里,762,1163,485,167,652,64,716
公投第８案,彰化縣,田中鎮,中路里,763,809,373,109,482,42,524
公投第８案,彰化縣,田中鎮,中路里,764,1155,490,149,639,58,697
公投第８案,彰化縣,田中鎮,梅州里,765,1270,478,164,642,86,728
公投第８案,彰化縣,田中鎮,三安里,766,870,346,103,449,40,489
公投第８案,彰化縣,田中鎮,三安里,767,736,276,93,369,53,422
公投第８案,彰化縣,田中鎮,大崙里,768,1335,482,154,636,57,693
公投第８案,彰化縣,田中鎮,沙崙里,769,876,332,118,450,41,491
公投第８案,彰化縣,田中鎮,沙崙里,770,898,301,136,437,57,494
公投第８案,彰化縣,田中鎮,新民里,771,1298,560,162,722,28,750
公投第８案,彰化縣,田中鎮,新民里,772,1451,525,201,726,81,807
公投第８案,彰化縣,田中鎮,新民里,773,1475,606,163,769,65,834
公投第８案,彰化縣,田中鎮,三民里,774,766,263,86,349,51,400
公投第８案,彰化縣,田中鎮,三民里,775,810,328,79,407,29,436
公投第８案,彰化縣,田中鎮,三光里,776,953,363,134,497,68,565
公投第８案,彰化縣,田中鎮,大社里,777,885,367,129,496,62,558
公投第８案,彰化縣,社頭鄉,社頭村,778,791,289,133,422,41,463
公投第８案,彰化縣,社頭鄉,社頭村,779,984,393,127,520,43,563
公投第８案,彰化縣,社頭鄉,社頭村,780,990,361,129,490,19,509
公投第８案,彰化縣,社頭鄉,廣興村,781,1016,438,130,568,59,627
公投第８案,彰化縣,社頭鄉,廣興村,782,1091,446,164,610,49,659
公投第８案,彰化縣,社頭鄉,廣興村,783,1236,502,169,671,73,744
公投第８案,彰化縣,社頭鄉,廣興村,784,1203,484,130,614,34,648
公投第８案,彰化縣,社頭鄉,東興村,785,753,306,90,396,32,428
公投第８案,彰化縣,社頭鄉,東興村,786,725,259,90,349,37,386
公投第８案,彰化縣,社頭鄉,松竹村,787,1023,425,126,551,72,623
公投第８案,彰化縣,社頭鄉,舊社村,788,562,238,98,336,41,377
公投第８案,彰化縣,社頭鄉,舊社村,789,1049,414,128,542,36,578
公投第８案,彰化縣,社頭鄉,廣福村,790,933,412,109,521,38,559
公投第８案,彰化縣,社頭鄉,橋頭村,791,990,408,144,552,53,605
公投第８案,彰化縣,社頭鄉,橋頭村,792,1076,397,127,524,37,561
公投第８案,彰化縣,社頭鄉,新厝村,793,742,317,109,426,21,447
公投第８案,彰化縣,社頭鄉,新厝村,794,672,277,63,340,21,361
公投第８案,彰化縣,社頭鄉,張厝村,795,1235,459,117,576,49,625
公投第８案,彰化縣,社頭鄉,湳底村,796,750,286,126,412,39,451
公投第８案,彰化縣,社頭鄉,湳底村,797,895,338,108,446,39,485
公投第８案,彰化縣,社頭鄉,仁雅村,798,688,285,73,358,25,383
公投第８案,彰化縣,社頭鄉,仁雅村,799,870,364,76,440,36,476
公投第８案,彰化縣,社頭鄉,仁雅村,800,1140,515,135,650,29,679
公投第８案,彰化縣,社頭鄉,里仁村,801,985,497,44,541,42,583
公投第８案,彰化縣,社頭鄉,美雅村,802,1266,589,128,717,70,787
公投第８案,彰化縣,社頭鄉,崙雅村,803,937,389,118,507,45,552
公投第８案,彰化縣,社頭鄉,清水村,804,1219,524,122,646,45,691
公投第８案,彰化縣,社頭鄉,山湖村,805,1165,438,150,588,81,669
公投第８案,彰化縣,社頭鄉,埤斗村,806,986,398,126,524,61,585
公投第８案,彰化縣,社頭鄉,仁和村,807,724,330,97,427,31,458
公投第８案,彰化縣,社頭鄉,平和村,808,1015,442,99,541,49,590
公投第８案,彰化縣,社頭鄉,協和村,809,1116,406,134,540,32,572
公投第８案,彰化縣,社頭鄉,協和村,810,1061,368,152,520,55,575
公投第８案,彰化縣,社頭鄉,泰安村,811,992,422,131,553,42,595
公投第８案,彰化縣,社頭鄉,朝興村,812,1092,407,128,535,31,566
公投第８案,彰化縣,社頭鄉,龍井村,813,828,335,120,455,51,506
公投第８案,彰化縣,社頭鄉,湳雅村,814,787,267,98,365,59,424
公投第８案,彰化縣,社頭鄉,湳雅村,815,719,251,67,318,26,344
公投第８案,彰化縣,二水鄉,復興村,816,1028,388,146,534,72,606
公投第８案,彰化縣,二水鄉,十五村,817,689,292,84,376,57,433
公投第８案,彰化縣,二水鄉,合和村,818,871,314,101,415,56,471
公投第８案,彰化縣,二水鄉,上豊村,819,953,387,107,494,67,561
公投第８案,彰化縣,二水鄉,過圳村,820,624,209,76,285,55,340
公投第８案,彰化縣,二水鄉,五伯村,821,645,290,82,372,55,427
公投第８案,彰化縣,二水鄉,文化村,822,986,473,128,601,47,648
公投第８案,彰化縣,二水鄉,光化村,823,943,389,154,543,79,622
公投第８案,彰化縣,二水鄉,聖化村,824,455,192,65,257,6,263
公投第８案,彰化縣,二水鄉,二水村,825,831,385,131,516,38,554
公投第８案,彰化縣,二水鄉,惠民村,826,831,353,103,456,43,499
公投第８案,彰化縣,二水鄉,裕民村,827,1013,380,142,522,30,552
公投第８案,彰化縣,二水鄉,大園村,828,796,299,127,426,79,505
公投第８案,彰化縣,二水鄉,修仁村,829,781,306,94,400,54,454
公投第８案,彰化縣,二水鄉,合興村,830,692,242,84,326,22,348
公投第８案,彰化縣,二水鄉,源泉村,831,635,256,72,328,42,370
公投第８案,彰化縣,二水鄉,倡和村,832,566,201,88,289,38,327
公投第８案,彰化縣,北斗鎮,中寮里,833,925,324,111,435,80,515
公投第８案,彰化縣,北斗鎮,中寮里,834,869,344,125,469,56,525
公投第８案,彰化縣,北斗鎮,中寮里,835,855,381,128,509,48,557
公投第８案,彰化縣,北斗鎮,大道里,836,1065,463,150,613,57,670
公投第８案,彰化縣,北斗鎮,大道里,837,828,329,104,433,68,501
公投第８案,彰化縣,北斗鎮,西德里,838,1124,479,134,613,56,669
公投第８案,彰化縣,北斗鎮,西德里,839,1096,469,141,610,58,668
公投第８案,彰化縣,北斗鎮,西德里,840,1213,506,154,660,52,712
公投第８案,彰化縣,北斗鎮,西德里,841,1164,449,126,575,70,645
公投第８案,彰化縣,北斗鎮,西安里,842,730,276,97,373,29,402
公投第８案,彰化縣,北斗鎮,西安里,843,878,362,92,454,38,492
公投第８案,彰化縣,北斗鎮,光復里,844,833,369,105,474,37,511
公投第８案,彰化縣,北斗鎮,光復里,845,957,411,112,523,45,568
公投第８案,彰化縣,北斗鎮,新政里,846,783,311,98,409,35,444
公投第８案,彰化縣,北斗鎮,重慶里,847,573,205,72,277,37,314
公投第８案,彰化縣,北斗鎮,五權里,848,672,246,92,338,46,384
公投第８案,彰化縣,北斗鎮,七星里,849,695,248,85,333,45,378
公投第８案,彰化縣,北斗鎮,七星里,850,747,266,94,360,41,401
公投第８案,彰化縣,北斗鎮,居仁里,851,643,297,80,377,32,409
公投第８案,彰化縣,北斗鎮,居仁里,852,662,273,69,342,51,393
公投第８案,彰化縣,北斗鎮,東光里,853,1085,483,138,621,67,688
公投第８案,彰化縣,北斗鎮,東光里,854,1121,472,138,610,58,668
公投第８案,彰化縣,北斗鎮,文昌里,855,830,370,92,462,46,508
公投第８案,彰化縣,北斗鎮,文昌里,856,975,385,115,500,46,546
公投第８案,彰化縣,北斗鎮,文昌里,857,1212,488,133,621,39,660
公投第８案,彰化縣,北斗鎮,中和里,858,1302,544,153,697,83,780
公投第８案,彰化縣,北斗鎮,新生里,859,1077,390,96,486,39,525
公投第８案,彰化縣,北斗鎮,新生里,860,917,361,82,443,63,506
公投第８案,彰化縣,北斗鎮,大新里,861,825,314,92,406,42,448
公投第８案,彰化縣,北斗鎮,大新里,862,937,394,104,498,56,554
公投第８案,彰化縣,田尾鄉,田尾村,863,1284,456,151,607,46,653
公投第８案,彰化縣,田尾鄉,溪畔村,864,1187,505,154,659,66,725
公投第８案,彰化縣,田尾鄉,打簾村,865,1033,562,101,663,46,709
公投第８案,彰化縣,田尾鄉,打簾村,866,696,309,78,387,39,426
公投第８案,彰化縣,田尾鄉,正義村,867,872,413,84,497,37,534
公投第８案,彰化縣,田尾鄉,北曾村,868,680,266,69,335,26,361
公投第８案,彰化縣,田尾鄉,北曾村,869,875,365,140,505,49,554
公投第８案,彰化縣,田尾鄉,南曾村,870,1337,485,152,637,67,704
公投第８案,彰化縣,田尾鄉,饒平村,871,1376,634,160,794,50,844
公投第８案,彰化縣,田尾鄉,饒平村,872,1186,558,129,687,49,736
公投第８案,彰化縣,田尾鄉,豐田村,873,874,461,96,557,50,607
公投第８案,彰化縣,田尾鄉,仁里村,874,647,234,88,322,34,356
公投第８案,彰化縣,田尾鄉,仁里村,875,959,407,119,526,42,568
公投第８案,彰化縣,田尾鄉,新厝村,876,263,93,35,128,13,141
公投第８案,彰化縣,田尾鄉,溪頂村,877,618,237,63,300,34,334
公投第８案,彰化縣,田尾鄉,柳鳳村,878,938,407,141,548,28,576
公投第８案,彰化縣,田尾鄉,陸豐村,879,880,430,87,517,46,563
公投第８案,彰化縣,田尾鄉,海豐村,880,804,293,100,393,41,434
公投第８案,彰化縣,田尾鄉,海豐村,881,592,224,69,293,34,327
公投第８案,彰化縣,田尾鄉,睦宜村,882,1079,466,132,598,85,683
公投第８案,彰化縣,田尾鄉,新生村,883,1336,541,174,715,59,774
公投第８案,彰化縣,田尾鄉,北鎮村,884,1198,452,139,591,60,651
公投第８案,彰化縣,田尾鄉,南鎮村,885,621,230,83,313,41,354
公投第８案,彰化縣,田尾鄉,福田村,886,760,294,84,378,32,410
公投第８案,彰化縣,田尾鄉,新興村,887,1084,465,163,628,73,701
公投第８案,彰化縣,埤頭鄉,和豊村,888,1178,387,132,519,62,581
公投第８案,彰化縣,埤頭鄉,和豊村,889,1290,584,54,638,50,688
公投第８案,彰化縣,埤頭鄉,興農村,890,973,378,90,468,57,525
公投第８案,彰化縣,埤頭鄉,興農村,891,783,275,102,377,38,415
公投第８案,彰化縣,埤頭鄉,埤頭村,892,733,275,93,368,50,418
公投第８案,彰化縣,埤頭鄉,埤頭村,893,899,351,97,448,77,525
公投第８案,彰化縣,埤頭鄉,豊崙村,894,965,378,116,494,51,545
公投第８案,彰化縣,埤頭鄉,豊崙村,895,1356,525,123,648,68,716
公投第８案,彰化縣,埤頭鄉,崙子村,896,1265,478,133,611,76,687
公投第８案,彰化縣,埤頭鄉,永豊村,897,877,373,106,479,49,528
公投第８案,彰化縣,埤頭鄉,永豊村,898,705,259,74,333,49,382
公投第８案,彰化縣,埤頭鄉,合興村,899,1062,473,113,586,49,635
公投第８案,彰化縣,埤頭鄉,合興村,900,1300,511,167,678,52,730
公投第８案,彰化縣,埤頭鄉,合興村,901,923,365,102,467,69,536
公投第８案,彰化縣,埤頭鄉,平原村,902,1085,392,104,496,41,537
公投第８案,彰化縣,埤頭鄉,平原村,903,1103,465,128,593,60,653
公投第８案,彰化縣,埤頭鄉,崙腳村,904,735,249,90,339,35,374
公投第８案,彰化縣,埤頭鄉,元埔村,905,574,207,63,270,46,316
公投第８案,彰化縣,埤頭鄉,芙朝村,906,767,281,62,343,41,384
公投第８案,彰化縣,埤頭鄉,芙朝村,907,737,255,98,353,54,407
公投第８案,彰化縣,埤頭鄉,新庄村,908,1058,295,136,431,59,490
公投第８案,彰化縣,埤頭鄉,陸嘉村,909,826,255,95,350,73,423
公投第８案,彰化縣,埤頭鄉,竹圍村,910,1082,357,100,457,88,545
公投第８案,彰化縣,埤頭鄉,中和村,911,737,307,84,391,55,446
公投第８案,彰化縣,埤頭鄉,中和村,912,711,270,79,349,28,377
公投第８案,彰化縣,埤頭鄉,庄內村,913,1043,366,145,511,79,590
公投第８案,彰化縣,埤頭鄉,大湖村,914,910,314,91,405,30,435
公投第８案,彰化縣,溪州鄉,溪厝村,915,778,303,81,384,46,430
公投第８案,彰化縣,溪州鄉,溪厝村,916,1061,345,119,464,28,492
公投第８案,彰化縣,溪州鄉,坑厝村,917,701,210,80,290,33,323
公投第８案,彰化縣,溪州鄉,瓦厝村,918,879,357,122,479,51,530
公投第８案,彰化縣,溪州鄉,溪州村,919,654,275,106,381,47,428
公投第８案,彰化縣,溪州鄉,溪州村,920,878,341,97,438,50,488
公投第８案,彰化縣,溪州鄉,尾厝村,921,942,404,122,526,50,576
公投第８案,彰化縣,溪州鄉,尾厝村,922,871,341,92,433,37,470
公投第８案,彰化縣,溪州鄉,東州村,923,1047,379,108,487,31,518
公投第８案,彰化縣,溪州鄉,東州村,924,858,347,101,448,48,496
公投第８案,彰化縣,溪州鄉,舊眉村,925,1409,437,137,574,65,639
公投第８案,彰化縣,溪州鄉,圳寮村,926,792,248,92,340,38,378
公投第８案,彰化縣,溪州鄉,圳寮村,927,714,230,90,320,66,386
公投第８案,彰化縣,溪州鄉,西畔村,928,1109,354,120,474,65,539
公投第８案,彰化縣,溪州鄉,西畔村,929,962,369,6,375,52,427
公投第８案,彰化縣,溪州鄉,柑園村,930,1157,367,97,464,63,527
公投第８案,彰化縣,溪州鄉,成功村,931,952,344,95,439,51,490
公投第８案,彰化縣,溪州鄉,成功村,932,887,317,117,434,43,477
公投第８案,彰化縣,溪州鄉,大庄村,933,866,259,75,334,46,380
公投第８案,彰化縣,溪州鄉,大庄村,934,1010,307,110,417,63,480
公投第８案,彰化縣,溪州鄉,榮光村,935,853,298,100,398,24,422
公投第８案,彰化縣,溪州鄉,潮洋村,936,843,286,80,366,70,436
公投第８案,彰化縣,溪州鄉,張厝村,937,711,179,52,231,11,242
公投第８案,彰化縣,溪州鄉,菜公村,938,851,308,87,395,72,467
公投第８案,彰化縣,溪州鄉,三條村,939,883,264,110,374,34,408
公投第８案,彰化縣,溪州鄉,三圳村,940,1247,400,109,509,63,572
公投第８案,彰化縣,溪州鄉,水尾村,941,1490,555,180,735,91,826
公投第８案,彰化縣,二林鎮,豐田里,942,731,215,68,283,30,313
公投第８案,彰化縣,二林鎮,豐田里,943,1025,416,117,533,54,587
公投第８案,彰化縣,二林鎮,豐田里,944,784,324,104,428,24,452
公投第８案,彰化縣,二林鎮,東和里,945,892,352,123,475,41,516
公投第８案,彰化縣,二林鎮,東和里,946,1256,494,147,641,74,715
公投第８案,彰化縣,二林鎮,南光里,947,1043,404,100,504,55,559
公投第８案,彰化縣,二林鎮,南光里,948,1076,467,138,605,43,648
公投第８案,彰化縣,二林鎮,南光里,949,1082,453,120,573,65,638
公投第８案,彰化縣,二林鎮,西平里,950,1427,522,167,689,67,756
公投第８案,彰化縣,二林鎮,北平里,951,1030,336,127,463,70,533
公投第８案,彰化縣,二林鎮,北平里,952,1033,363,114,477,68,545
公投第８案,彰化縣,二林鎮,北平里,953,977,405,113,518,50,568
公投第８案,彰化縣,二林鎮,中西里,954,683,251,66,317,31,348
公投第８案,彰化縣,二林鎮,中西里,955,975,329,193,522,85,607
公投第８案,彰化縣,二林鎮,廣興里,956,1336,416,106,522,86,608
公投第８案,彰化縣,二林鎮,香田里,957,1019,311,107,418,65,483
公投第８案,彰化縣,二林鎮,外竹里,958,1003,303,96,399,61,460
公投第８案,彰化縣,二林鎮,興華里,959,1151,478,98,576,75,651
公投第８案,彰化縣,二林鎮,東興里,960,1598,610,180,790,120,910
公投第８案,彰化縣,二林鎮,後厝里,961,1488,592,143,735,61,796
公投第８案,彰化縣,二林鎮,後厝里,962,1771,729,306,1035,69,1104
公投第８案,彰化縣,二林鎮,頂厝里,963,1360,401,128,529,58,587
公投第８案,彰化縣,二林鎮,趙甲里,964,1613,535,151,686,70,756
公投第８案,彰化縣,二林鎮,振興里,965,1228,433,110,543,90,633
公投第８案,彰化縣,二林鎮,萬興里,966,771,341,68,409,30,439
公投第８案,彰化縣,二林鎮,永興里,967,858,355,106,461,37,498
公投第８案,彰化縣,二林鎮,永興里,968,661,229,62,291,0,291
公投第８案,彰化縣,二林鎮,西庄里,969,1268,408,133,541,88,629
公投第８案,彰化縣,二林鎮,梅芳里,970,1081,362,109,471,39,510
公投第８案,彰化縣,二林鎮,華崙里,971,1213,414,124,538,45,583
公投第８案,彰化縣,二林鎮,華崙里,972,1328,527,143,670,72,742
公投第８案,彰化縣,二林鎮,華崙里,973,1118,357,95,452,82,534
公投第８案,彰化縣,二林鎮,萬合里,974,1157,469,115,584,48,632
公投第８案,彰化縣,二林鎮,東勢里,975,972,323,105,428,46,474
公投第８案,彰化縣,二林鎮,大永里,976,902,338,97,435,48,483
公投第８案,彰化縣,二林鎮,原斗里,977,1273,524,165,689,93,782
公投第８案,彰化縣,二林鎮,西斗里,978,1087,379,118,497,48,545
公投第８案,彰化縣,二林鎮,東華里,979,987,375,124,499,79,578
公投第８案,彰化縣,二林鎮,復豐里,980,719,183,81,264,29,293
公投第８案,彰化縣,大城鄉,山腳村,981,1288,280,86,366,31,397
公投第８案,彰化縣,大城鄉,潭墘村,982,1104,263,81,344,81,425
公投第８案,彰化縣,大城鄉,大城村,983,964,366,104,470,67,537
公投第８案,彰化縣,大城鄉,東城村,984,1312,416,117,533,74,607
公投第８案,彰化縣,大城鄉,西城村,985,853,230,74,304,62,366
公投第８案,彰化縣,大城鄉,上山村,986,518,135,25,160,21,181
公投第８案,彰化縣,大城鄉,上山村,987,574,172,48,220,29,249
公投第８案,彰化縣,大城鄉,永和村,988,702,178,51,229,39,268
公投第８案,彰化縣,大城鄉,公館村,989,376,82,21,103,15,118
公投第８案,彰化縣,大城鄉,公館村,990,693,155,34,189,25,214
公投第８案,彰化縣,大城鄉,豐美村,991,877,252,84,336,49,385
公投第８案,彰化縣,大城鄉,三豐村,992,655,121,48,169,15,184
公投第８案,彰化縣,大城鄉,菜寮村,993,1103,296,71,367,38,405
公投第８案,彰化縣,大城鄉,東港村,994,1192,282,93,375,31,406
公投第８案,彰化縣,大城鄉,西港村,995,917,246,83,329,32,361
公投第８案,彰化縣,大城鄉,頂庄村,996,686,153,38,191,33,224
公投第８案,彰化縣,大城鄉,臺西村,997,899,193,59,252,20,272
公投第８案,彰化縣,芳苑鄉,芳苑村,998,940,208,64,272,58,330
公投第８案,彰化縣,芳苑鄉,芳中村,999,403,92,29,121,31,152
公投第８案,彰化縣,芳苑鄉,仁愛村,1000,756,239,84,323,41,364
公投第８案,彰化縣,芳苑鄉,信義村,1001,548,108,40,148,30,178
公投第８案,彰化縣,芳苑鄉,後寮村,1002,997,358,91,449,68,517
公投第８案,彰化縣,芳苑鄉,三合村,1003,1300,381,140,521,70,591
公投第８案,彰化縣,芳苑鄉,三合村,1004,859,303,99,402,40,442
公投第８案,彰化縣,芳苑鄉,永興村,1005,734,251,74,325,24,349
公投第８案,彰化縣,芳苑鄉,永興村,1006,636,230,51,281,23,304
公投第８案,彰化縣,芳苑鄉,新街村,1007,808,231,74,305,70,375
公投第８案,彰化縣,芳苑鄉,路上村,1008,668,192,58,250,45,295
公投第８案,彰化縣,芳苑鄉,路平村,1009,744,267,77,344,34,378
公投第８案,彰化縣,芳苑鄉,三成村,1010,1026,300,88,388,98,486
公投第８案,彰化縣,芳苑鄉,福榮村,1011,586,156,46,202,13,215
公投第８案,彰化縣,芳苑鄉,頂廍村,1012,593,208,77,285,28,313
公投第８案,彰化縣,芳苑鄉,王功村,1013,1071,338,120,458,115,573
公投第８案,彰化縣,芳苑鄉,王功村,1014,1060,357,106,463,98,561
公投第８案,彰化縣,芳苑鄉,博愛村,1015,708,224,67,291,24,315
公投第８案,彰化縣,芳苑鄉,和平村,1016,735,213,73,286,62,348
公投第８案,彰化縣,芳苑鄉,興仁村,1017,571,202,67,269,63,332
公投第８案,彰化縣,芳苑鄉,興仁村,1018,729,223,49,272,36,308
公投第８案,彰化縣,芳苑鄉,民生村,1019,674,214,59,273,74,347
公投第８案,彰化縣,芳苑鄉,新寶村,1020,846,287,94,381,47,428
公投第８案,彰化縣,芳苑鄉,新寶村,1021,806,310,86,396,57,453
公投第８案,彰化縣,芳苑鄉,五俊村,1022,470,122,31,153,13,166
公投第８案,彰化縣,芳苑鄉,草湖村,1023,1124,431,102,533,74,607
公投第８案,彰化縣,芳苑鄉,草湖村,1024,317,104,22,126,26,152
公投第８案,彰化縣,芳苑鄉,建平村,1025,1158,317,107,424,70,494
公投第８案,彰化縣,芳苑鄉,建平村,1026,967,308,90,398,30,428
公投第８案,彰化縣,芳苑鄉,崙腳村,1027,762,281,69,350,48,398
公投第８案,彰化縣,芳苑鄉,文津村,1028,1086,335,85,420,57,477
公投第８案,彰化縣,芳苑鄉,新生村,1029,747,275,68,343,25,368
公投第８案,彰化縣,芳苑鄉,新生村,1030,653,203,35,238,28,266
公投第８案,彰化縣,芳苑鄉,漢寶村,1031,872,347,103,450,63,513
公投第８案,彰化縣,芳苑鄉,漢寶村,1032,1235,531,156,687,58,745
公投第８案,彰化縣,芳苑鄉,漢寶村,1033,1102,383,132,515,77,592
公投第８案,彰化縣,竹塘鄉,竹元村,1034,1168,453,134,587,78,665
公投第８案,彰化縣,竹塘鄉,竹塘村,1035,965,352,140,492,46,538
公投第８案,彰化縣,竹塘鄉,竹塘村,1036,960,407,130,537,60,597
公投第８案,彰化縣,竹塘鄉,小西村,1037,743,319,97,416,67,483
公投第８案,彰化縣,竹塘鄉,民靖村,1038,751,225,70,295,42,337
公投第８案,彰化縣,竹塘鄉,五庄村,1039,792,240,90,330,49,379
公投第８案,彰化縣,竹塘鄉,五庄村,1040,733,231,62,293,17,310
公投第８案,彰化縣,竹塘鄉,樹腳村,1041,657,224,77,301,47,348
公投第８案,彰化縣,竹塘鄉,田頭村,1042,1063,378,106,484,44,528
公投第８案,彰化縣,竹塘鄉,新廣村,1043,1114,423,122,545,86,631
公投第８案,彰化縣,竹塘鄉,溪墘村,1044,506,207,81,288,54,342
公投第８案,彰化縣,竹塘鄉,竹林村,1045,823,267,102,369,51,420
公投第８案,彰化縣,竹塘鄉,土庫村,1046,654,222,80,302,42,344
公投第８案,彰化縣,竹塘鄉,內新村,1047,577,162,53,215,29,244
公投第８案,彰化縣,竹塘鄉,長安村,1048,772,257,91,348,59,407
公投第８案,彰化縣,竹塘鄉,永安村,1049,543,149,54,203,46,249
公投第８案,南投縣,南投市,龍泉里,1,927,405,118,523,25,548
公投第８案,南投縣,南投市,康壽里,2,667,342,78,420,34,454
公投第８案,南投縣,南投市,康壽里,3,773,363,85,448,29,477
公投第８案,南投縣,南投市,三民里,4,818,356,116,472,40,512
公投第８案,南投縣,南投市,仁和里,5,525,249,81,330,26,356
公投第８案,南投縣,南投市,南投里,6,575,271,79,350,31,381
公投第８案,南投縣,南投市,彰仁里,7,368,182,57,239,14,253
公投第８案,南投縣,南投市,崇文里,8,956,444,141,585,48,633
公投第８案,南投縣,南投市,三興里,9,1245,502,127,629,24,653
公投第８案,南投縣,南投市,三興里,10,1484,682,37,719,31,750
公投第８案,南投縣,南投市,三興里,11,1191,596,143,739,37,776
公投第８案,南投縣,南投市,三興里,12,1506,667,193,860,55,915
公投第８案,南投縣,南投市,三和里,13,1070,484,151,635,42,677
公投第８案,南投縣,南投市,三和里,14,670,313,80,393,25,418
公投第８案,南投縣,南投市,三和里,15,1050,496,148,644,49,693
公投第８案,南投縣,南投市,嘉興里,16,1122,429,128,557,52,609
公投第８案,南投縣,南投市,嘉興里,17,984,390,133,523,35,558
公投第８案,南投縣,南投市,嘉和里,18,1062,542,109,651,25,676
公投第８案,南投縣,南投市,嘉和里,19,1053,460,125,585,61,646
公投第８案,南投縣,南投市,嘉和里,20,1104,485,173,658,44,702
公投第８案,南投縣,南投市,嘉和里,21,1192,505,133,638,53,691
公投第８案,南投縣,南投市,平和里,22,960,392,108,500,47,547
公投第８案,南投縣,南投市,平和里,23,906,407,109,516,42,558
公投第８案,南投縣,南投市,平和里,24,957,423,120,543,47,590
公投第８案,南投縣,南投市,平和里,25,997,447,151,598,53,651
公投第８案,南投縣,南投市,平和里,26,1008,466,122,588,39,627
公投第８案,南投縣,南投市,平和里,27,1164,496,155,651,33,684
公投第８案,南投縣,南投市,振興里,28,587,254,70,324,30,354
公投第８案,南投縣,南投市,振興里,29,734,261,103,364,37,401
公投第８案,南投縣,南投市,振興里,30,724,301,83,384,40,424
公投第８案,南投縣,南投市,千秋里,31,1003,456,104,560,36,596
公投第８案,南投縣,南投市,軍功里,32,1356,605,133,738,49,787
公投第８案,南投縣,南投市,軍功里,33,1373,564,129,693,51,744
公投第８案,南投縣,南投市,軍功里,34,1452,609,158,767,38,805
公投第８案,南投縣,南投市,軍功里,35,362,153,26,179,17,196
公投第８案,南投縣,南投市,東山里,36,389,162,43,205,29,234
公投第８案,南投縣,南投市,營南里,37,1276,597,169,766,65,831
公投第８案,南投縣,南投市,營南里,38,1089,510,141,651,56,707
公投第８案,南投縣,南投市,營北里,39,921,438,108,546,47,593
公投第８案,南投縣,南投市,營北里,40,892,490,100,590,35,625
公投第８案,南投縣,南投市,營北里,41,1050,543,109,652,35,687
公投第８案,南投縣,南投市,營北里,42,1078,538,115,653,26,679
公投第８案,南投縣,南投市,營北里,43,1078,522,101,623,44,667
公投第８案,南投縣,南投市,營北里,44,861,484,118,602,21,623
公投第８案,南投縣,南投市,內興里,45,1221,625,25,650,78,728
公投第８案,南投縣,南投市,內興里,46,1105,487,134,621,29,650
公投第８案,南投縣,南投市,內興里,47,1230,577,149,726,28,754
公投第８案,南投縣,南投市,內興里,48,1092,530,103,633,42,675
公投第８案,南投縣,南投市,內興里,49,1286,679,126,805,18,823
公投第８案,南投縣,南投市,內興里,50,655,342,77,419,28,447
公投第８案,南投縣,南投市,內新里,51,719,347,99,446,33,479
公投第８案,南投縣,南投市,內新里,52,720,313,74,387,30,417
公投第８案,南投縣,南投市,光輝里,53,509,260,65,325,17,342
公投第８案,南投縣,南投市,光榮里,54,492,228,35,263,16,279
公投第８案,南投縣,南投市,光榮里,55,616,310,46,356,21,377
公投第８案,南投縣,南投市,光明里,56,1010,525,82,607,31,638
公投第８案,南投縣,南投市,光華里,57,848,418,64,482,26,508
公投第８案,南投縣,南投市,漳興里,58,1387,626,186,812,74,886
公投第８案,南投縣,南投市,漳興里,59,1245,608,156,764,39,803
公投第８案,南投縣,南投市,漳和里,60,1199,543,117,660,31,691
公投第８案,南投縣,南投市,漳和里,61,1288,567,163,730,47,777
公投第８案,南投縣,南投市,漳和里,62,1040,446,126,572,52,624
公投第８案,南投縣,南投市,漳和里,63,1070,489,119,608,56,664
公投第８案,南投縣,南投市,漳和里,64,1299,648,134,782,36,818
公投第８案,南投縣,南投市,漳和里,65,1122,533,145,678,31,709
公投第８案,南投縣,南投市,平山里,66,1414,625,156,781,44,825
公投第８案,南投縣,南投市,平山里,67,1121,489,125,614,50,664
公投第８案,南投縣,南投市,平山里,68,1434,596,181,777,36,813
公投第８案,南投縣,南投市,平山里,69,1393,583,149,732,41,773
公投第８案,南投縣,南投市,新興里,70,1059,434,125,559,31,590
公投第８案,南投縣,南投市,新興里,71,1218,527,145,672,37,709
公投第８案,南投縣,南投市,新興里,72,1293,524,122,646,19,665
公投第８案,南投縣,南投市,新興里,73,1337,508,125,633,45,678
公投第８案,南投縣,南投市,永豐里,74,876,391,129,520,34,554
公投第８案,南投縣,南投市,永豐里,75,971,419,115,534,30,564
公投第８案,南投縣,南投市,永豐里,76,1012,412,141,553,40,593
公投第８案,南投縣,南投市,福興里,77,973,399,92,491,43,534
公投第８案,南投縣,南投市,福興里,78,1002,444,136,580,44,624
公投第８案,南投縣,南投市,福興里,79,1024,433,133,566,40,606
公投第８案,南投縣,南投市,鳳山里,80,1122,357,131,488,106,594
公投第８案,南投縣,南投市,永興里,81,790,277,85,362,35,397
公投第８案,南投縣,南投市,鳳鳴里,82,647,195,51,246,28,274
公投第８案,南投縣,南投市,福山里,83,950,392,90,482,51,533
公投第８案,南投縣,南投市,福山里,84,980,386,86,472,33,505
公投第８案,南投縣,埔里鎮,東門里,85,828,365,80,445,54,499
公投第８案,南投縣,埔里鎮,東門里,86,786,358,85,443,42,485
公投第８案,南投縣,埔里鎮,東門里,87,1062,451,105,556,39,595
公投第８案,南投縣,埔里鎮,杷城里,88,1201,566,131,697,49,746
公投第８案,南投縣,埔里鎮,杷城里,89,1415,597,127,724,34,758
公投第８案,南投縣,埔里鎮,枇杷里,90,1282,555,122,677,37,714
公投第８案,南投縣,埔里鎮,枇杷里,91,859,375,75,450,47,497
公投第８案,南投縣,埔里鎮,枇杷里,92,1288,538,135,673,83,756
公投第８案,南投縣,埔里鎮,枇杷里,93,1330,590,144,734,24,758
公投第８案,南投縣,埔里鎮,枇杷里,94,1416,578,140,718,52,770
公投第８案,南投縣,埔里鎮,枇杷里,95,1283,488,117,605,45,650
公投第８案,南投縣,埔里鎮,水頭里,96,1151,485,138,623,80,703
公投第８案,南投縣,埔里鎮,水頭里,97,1193,483,116,599,35,634
公投第８案,南投縣,埔里鎮,水頭里,98,1471,614,146,760,83,843
公投第８案,南投縣,埔里鎮,麒麟里,99,1044,362,95,457,75,532
公投第８案,南投縣,埔里鎮,珠格里,100,1122,498,105,603,61,664
公投第８案,南投縣,埔里鎮,溪南里,101,1129,563,115,678,50,728
公投第８案,南投縣,埔里鎮,西門里,102,901,374,93,467,17,484
公投第８案,南投縣,埔里鎮,西門里,103,997,394,96,490,54,544
公投第８案,南投縣,埔里鎮,西門里,104,1209,513,121,634,43,677
公投第８案,南投縣,埔里鎮,南門里,105,838,423,92,515,37,552
公投第８案,南投縣,埔里鎮,北門里,106,1226,454,107,561,53,614
公投第８案,南投縣,埔里鎮,北門里,107,1263,578,148,726,59,785
公投第８案,南投縣,埔里鎮,北安里,108,1045,505,101,606,33,639
公投第８案,南投縣,埔里鎮,北安里,109,1120,544,108,652,41,693
公投第８案,南投縣,埔里鎮,北安里,110,1062,517,127,644,47,691
公投第８案,南投縣,埔里鎮,北梅里,111,1022,443,100,543,37,580
公投第８案,南投縣,埔里鎮,北梅里,112,1051,442,125,567,31,598
公投第８案,南投縣,埔里鎮,北梅里,113,1106,458,116,574,42,616
公投第８案,南投縣,埔里鎮,泰安里,114,1098,461,106,567,28,595
公投第８案,南投縣,埔里鎮,泰安里,115,1067,505,92,597,35,632
公投第８案,南投縣,埔里鎮,大湳里,116,725,285,88,373,53,426
公投第８案,南投縣,埔里鎮,大湳里,117,905,429,75,504,28,532
公投第８案,南投縣,埔里鎮,蜈蚣里,118,1179,476,103,579,63,642
公投第８案,南投縣,埔里鎮,蜈蚣里,119,944,367,89,456,35,491
公投第８案,南投縣,埔里鎮,蜈蚣里,120,465,190,53,243,26,269
公投第８案,南投縣,埔里鎮,同聲里,121,1133,480,124,604,45,649
公投第８案,南投縣,埔里鎮,同聲里,122,1100,443,94,537,39,576
公投第８案,南投縣,埔里鎮,清新里,123,1155,508,108,616,56,672
公投第８案,南投縣,埔里鎮,清新里,124,1254,485,129,614,55,669
公投第８案,南投縣,埔里鎮,清新里,125,1296,519,114,633,65,698
公投第８案,南投縣,埔里鎮,薰化里,126,1023,470,153,623,40,663
公投第８案,南投縣,埔里鎮,大城里,127,964,383,69,452,20,472
公投第８案,南投縣,埔里鎮,大城里,128,986,431,104,535,34,569
公投第８案,南投縣,埔里鎮,大城里,129,1016,486,101,587,29,616
公投第８案,南投縣,埔里鎮,大城里,130,898,365,115,480,50,530
公投第８案,南投縣,埔里鎮,大城里,131,980,447,108,555,41,596
公投第８案,南投縣,埔里鎮,大城里,132,933,411,116,527,34,561
公投第８案,南投縣,埔里鎮,籃城里,133,929,465,141,606,43,649
公投第８案,南投縣,埔里鎮,桃米里,134,1032,415,113,528,60,588
公投第８案,南投縣,埔里鎮,成功里,135,315,115,24,139,10,149
公投第８案,南投縣,埔里鎮,南村里,136,1363,499,139,638,71,709
公投第８案,南投縣,埔里鎮,愛蘭里,137,725,324,76,400,38,438
公投第８案,南投縣,埔里鎮,愛蘭里,138,705,293,114,407,21,428
公投第８案,南投縣,埔里鎮,鐵山里,139,751,361,92,453,35,488
公投第８案,南投縣,埔里鎮,鐵山里,140,932,404,87,491,43,534
公投第８案,南投縣,埔里鎮,房里里,141,956,415,114,529,40,569
公投第８案,南投縣,埔里鎮,房里里,142,376,154,45,199,12,211
公投第８案,南投縣,埔里鎮,向善里,143,682,288,80,368,39,407
公投第８案,南投縣,埔里鎮,一新里,144,990,545,48,593,52,645
公投第８案,南投縣,埔里鎮,合成里,145,1324,468,127,595,64,659
公投第８案,南投縣,埔里鎮,合成里,146,298,100,32,132,14,146
公投第８案,南投縣,埔里鎮,廣成里,147,1170,501,97,598,63,661
公投第８案,南投縣,埔里鎮,史港里,148,604,262,68,330,23,353
公投第８案,南投縣,埔里鎮,福興里,149,999,387,124,511,42,553
公投第８案,南投縣,埔里鎮,牛眠里,150,923,341,88,429,25,454
公投第８案,南投縣,埔里鎮,牛眠里,151,887,400,107,507,30,537
公投第８案,南投縣,埔里鎮,牛眠里,152,981,390,95,485,28,513
公投第８案,南投縣,草屯鎮,玉峰里,153,998,455,129,584,23,607
公投第８案,南投縣,草屯鎮,玉峰里,154,1127,484,109,593,30,623
公投第８案,南投縣,草屯鎮,明正里,155,1401,599,104,703,28,731
公投第８案,南投縣,草屯鎮,明正里,156,1110,410,166,576,37,613
公投第８案,南投縣,草屯鎮,明正里,157,1285,576,138,714,57,771
公投第８案,南投縣,草屯鎮,炎峰里,158,936,382,118,500,33,533
公投第８案,南投縣,草屯鎮,炎峰里,159,1141,456,145,601,57,658
公投第８案,南投縣,草屯鎮,中正里,160,705,328,90,418,27,445
公投第８案,南投縣,草屯鎮,和平里,161,1121,490,146,636,27,663
公投第８案,南投縣,草屯鎮,中山里,162,877,419,130,549,34,583
公投第８案,南投縣,草屯鎮,中山里,163,1401,589,162,751,52,803
公投第８案,南投縣,草屯鎮,敦和里,164,1267,507,133,640,56,696
公投第８案,南投縣,草屯鎮,敦和里,165,1214,550,103,653,68,721
公投第８案,南投縣,草屯鎮,敦和里,166,1259,519,160,679,66,745
公投第８案,南投縣,草屯鎮,敦和里,167,1442,665,158,823,45,868
公投第８案,南投縣,草屯鎮,敦和里,168,1273,554,149,703,55,758
公投第８案,南投縣,草屯鎮,山腳里,169,1145,490,120,610,41,651
公投第８案,南投縣,草屯鎮,山腳里,170,1279,547,129,676,29,705
公投第８案,南投縣,草屯鎮,山腳里,171,1158,602,17,619,26,645
公投第８案,南投縣,草屯鎮,山腳里,172,1335,809,118,927,53,980
公投第８案,南投縣,草屯鎮,山腳里,173,1178,616,141,757,35,792
公投第８案,南投縣,草屯鎮,山腳里,174,1327,605,134,739,43,782
公投第８案,南投縣,草屯鎮,新厝里,175,1000,424,129,553,34,587
公投第８案,南投縣,草屯鎮,新厝里,176,1257,585,89,674,35,709
公投第８案,南投縣,草屯鎮,新厝里,177,883,423,110,533,28,561
公投第８案,南投縣,草屯鎮,上林里,178,1121,478,115,593,28,621
公投第８案,南投縣,草屯鎮,上林里,179,1043,478,112,590,32,622
公投第８案,南投縣,草屯鎮,上林里,180,979,463,113,576,23,599
公投第８案,南投縣,草屯鎮,碧峰里,181,1048,385,109,494,28,522
公投第８案,南投縣,草屯鎮,碧峰里,182,1009,415,121,536,36,572
公投第８案,南投縣,草屯鎮,碧峰里,183,1138,478,103,581,24,605
公投第８案,南投縣,草屯鎮,碧峰里,184,1197,458,173,631,33,664
公投第８案,南投縣,草屯鎮,碧洲里,185,1364,637,131,768,38,806
公投第８案,南投縣,草屯鎮,碧洲里,186,1059,476,121,597,45,642
公投第８案,南投縣,草屯鎮,復興里,187,1108,502,100,602,48,650
公投第８案,南投縣,草屯鎮,復興里,188,879,367,92,459,43,502
公投第８案,南投縣,草屯鎮,復興里,189,957,414,102,516,48,564
公投第８案,南投縣,草屯鎮,御史里,190,1395,495,139,634,27,661
公投第８案,南投縣,草屯鎮,御史里,191,1101,498,142,640,42,682
公投第８案,南投縣,草屯鎮,御史里,192,1297,514,140,654,41,695
公投第８案,南投縣,草屯鎮,御史里,193,877,274,91,365,25,390
公投第８案,南投縣,草屯鎮,御史里,194,1376,486,131,617,61,678
公投第８案,南投縣,草屯鎮,新豐里,195,1008,488,113,601,50,651
公投第８案,南投縣,草屯鎮,新豐里,196,1080,493,122,615,51,666
公投第８案,南投縣,草屯鎮,新豐里,197,1017,398,118,516,49,565
公投第８案,南投縣,草屯鎮,新豐里,198,961,427,138,565,48,613
公投第８案,南投縣,草屯鎮,新庄里,199,1160,522,125,647,62,709
公投第８案,南投縣,草屯鎮,新庄里,200,1121,495,117,612,31,643
公投第８案,南投縣,草屯鎮,新庄里,201,1243,517,149,666,35,701
公投第８案,南投縣,草屯鎮,加老里,202,932,391,128,519,29,548
公投第８案,南投縣,草屯鎮,加老里,203,1323,637,159,796,61,857
公投第８案,南投縣,草屯鎮,石川里,204,1518,574,158,732,38,770
公投第８案,南投縣,草屯鎮,北投里,205,923,385,136,521,47,568
公投第８案,南投縣,草屯鎮,北投里,206,970,366,128,494,36,530
公投第８案,南投縣,草屯鎮,北投里,207,1026,401,131,532,34,566
公投第８案,南投縣,草屯鎮,富寮里,208,1466,574,179,753,72,825
公投第８案,南投縣,草屯鎮,富寮里,209,1180,510,127,637,37,674
公投第８案,南投縣,草屯鎮,富寮里,210,1006,455,130,585,26,611
公投第８案,南投縣,草屯鎮,富寮里,211,1000,377,89,466,40,506
公投第８案,南投縣,草屯鎮,富寮里,212,1128,516,140,656,31,687
公投第８案,南投縣,草屯鎮,富寮里,213,623,247,76,323,13,336
公投第８案,南投縣,草屯鎮,北勢里,214,707,259,106,365,53,418
公投第８案,南投縣,草屯鎮,北勢里,215,719,279,77,356,31,387
公投第８案,南投縣,草屯鎮,北勢里,216,527,191,41,232,26,258
公投第８案,南投縣,草屯鎮,中原里,217,1183,528,131,659,49,708
公投第８案,南投縣,草屯鎮,中原里,218,869,390,108,498,33,531
公投第８案,南投縣,草屯鎮,南埔里,219,1132,423,116,539,14,553
公投第８案,南投縣,草屯鎮,南埔里,220,949,389,129,518,50,568
公投第８案,南投縣,草屯鎮,南埔里,221,965,440,111,551,34,585
公投第８案,南投縣,草屯鎮,南埔里,222,1068,404,128,532,33,565
公投第８案,南投縣,草屯鎮,坪頂里,223,1024,451,130,581,43,624
公投第８案,南投縣,草屯鎮,土城里,224,642,264,60,324,28,352
公投第８案,南投縣,草屯鎮,土城里,225,1017,389,100,489,49,538
公投第８案,南投縣,草屯鎮,平林里,226,1092,484,96,580,43,623
公投第８案,南投縣,草屯鎮,雙冬里,227,1170,456,136,592,66,658
公投第８案,南投縣,草屯鎮,雙冬里,228,1106,475,132,607,59,666
公投第８案,南投縣,竹山鎮,竹山里,229,1170,514,138,652,52,704
公投第８案,南投縣,竹山鎮,竹山里,230,850,367,120,487,45,532
公投第８案,南投縣,竹山鎮,中正里,231,621,244,66,310,32,342
公投第８案,南投縣,竹山鎮,中山里,232,905,387,84,471,35,506
公投第８案,南投縣,竹山鎮,中山里,233,1099,411,96,507,49,556
公投第８案,南投縣,竹山鎮,中山里,234,1214,451,114,565,72,637
公投第８案,南投縣,竹山鎮,中山里,235,1287,563,147,710,66,776
公投第８案,南投縣,竹山鎮,雲林里,236,1191,493,123,616,62,678
公投第８案,南投縣,竹山鎮,雲林里,237,1118,431,124,555,82,637
公投第８案,南投縣,竹山鎮,雲林里,238,1278,585,131,716,38,754
公投第８案,南投縣,竹山鎮,竹圍里,239,1153,476,139,615,53,668
公投第８案,南投縣,竹山鎮,竹圍里,240,1243,93,479,572,70,642
公投第８案,南投縣,竹山鎮,桂林里,241,1308,551,126,677,55,732
公投第８案,南投縣,竹山鎮,桂林里,242,1358,511,156,667,51,718
公投第８案,南投縣,竹山鎮,桂林里,243,1044,423,94,517,55,572
公投第８案,南投縣,竹山鎮,下坪里,244,511,241,50,291,30,321
公投第８案,南投縣,竹山鎮,下坪里,245,682,289,61,350,10,360
公投第８案,南投縣,竹山鎮,中和里,246,989,340,118,458,24,482
公投第８案,南投縣,竹山鎮,中崎里,247,1378,561,135,696,45,741
公投第８案,南投縣,竹山鎮,秀林里,248,217,73,31,104,7,111
公投第８案,南投縣,竹山鎮,秀林里,249,479,213,49,262,26,288
公投第８案,南投縣,竹山鎮,大鞍里,250,430,133,48,181,17,198
公投第８案,南投縣,竹山鎮,延和里,251,1437,575,160,735,73,808
公投第８案,南投縣,竹山鎮,延和里,252,1286,556,167,723,48,771
公投第８案,南投縣,竹山鎮,延和里,253,1080,491,120,611,47,658
公投第８案,南投縣,竹山鎮,延和里,254,1070,425,127,552,42,594
公投第８案,南投縣,竹山鎮,延祥里,255,1295,541,129,670,58,728
公投第８案,南投縣,竹山鎮,延祥里,256,1047,442,113,555,35,590
公投第８案,南投縣,竹山鎮,延祥里,257,1300,536,131,667,57,724
公投第８案,南投縣,竹山鎮,延正里,258,908,304,96,400,28,428
公投第８案,南投縣,竹山鎮,延正里,259,821,280,86,366,54,420
公投第８案,南投縣,竹山鎮,延平里,260,1320,550,159,709,56,765
公投第８案,南投縣,竹山鎮,延平里,261,967,353,99,452,31,483
公投第８案,南投縣,竹山鎮,延平里,262,595,211,55,266,24,290
公投第８案,南投縣,竹山鎮,延山里,263,859,318,89,407,67,474
公投第８案,南投縣,竹山鎮,山崇里,264,1196,460,120,580,65,645
公投第８案,南投縣,竹山鎮,山崇里,265,649,274,61,335,34,369
公投第８案,南投縣,竹山鎮,社寮里,266,1341,531,153,684,59,743
公投第８案,南投縣,竹山鎮,中央里,267,1222,420,117,537,76,613
公投第８案,南投縣,竹山鎮,富州里,268,602,242,78,320,27,347
公投第８案,南投縣,竹山鎮,田子里,269,617,250,61,311,35,346
公投第８案,南投縣,竹山鎮,硘磘里,270,793,322,109,431,58,489
公投第８案,南投縣,竹山鎮,硘磘里,271,922,389,86,475,19,494
公投第８案,南投縣,竹山鎮,德興里,272,366,142,31,173,21,194
公投第８案,南投縣,竹山鎮,德興里,273,509,187,27,214,10,224
公投第８案,南投縣,竹山鎮,福興里,274,193,78,15,93,11,104
公投第８案,南投縣,竹山鎮,福興里,275,406,181,45,226,25,251
公投第８案,南投縣,竹山鎮,鯉魚里,276,495,168,54,222,30,252
公投第８案,南投縣,竹山鎮,鯉魚里,277,307,75,19,94,12,106
公投第８案,南投縣,竹山鎮,坪頂里,278,440,175,22,197,37,234
公投第８案,南投縣,竹山鎮,瑞竹里,279,577,221,43,264,49,313
公投第８案,南投縣,竹山鎮,桶頭里,280,486,112,62,174,40,214
公投第８案,南投縣,竹山鎮,桶頭里,281,403,104,26,130,18,148
公投第８案,南投縣,集集鎮,集集里,282,1070,493,105,598,50,648
公投第８案,南投縣,集集鎮,和平里,283,918,423,110,533,28,561
公投第８案,南投縣,集集鎮,林尾里,284,581,245,70,315,33,348
公投第８案,南投縣,集集鎮,田寮里,285,1194,542,123,665,48,713
公投第８案,南投縣,集集鎮,隘寮里,286,488,147,52,199,22,221
公投第８案,南投縣,集集鎮,玉映里,287,504,226,47,273,40,313
公投第８案,南投縣,集集鎮,吳厝里,288,910,350,121,471,92,563
公投第８案,南投縣,集集鎮,八張里,289,773,354,70,424,61,485
公投第８案,南投縣,集集鎮,八張里,290,709,280,91,371,31,402
公投第８案,南投縣,集集鎮,永昌里,291,960,395,102,497,35,532
公投第８案,南投縣,集集鎮,廣明里,292,503,198,55,253,22,275
公投第８案,南投縣,集集鎮,廣明里,293,419,153,33,186,25,211
公投第８案,南投縣,集集鎮,富山里,294,582,204,44,248,15,263
公投第８案,南投縣,名間鄉,南雅村,295,1050,519,150,669,61,730
公投第８案,南投縣,名間鄉,中正村,296,920,402,98,500,54,554
公投第８案,南投縣,名間鄉,中正村,297,727,333,99,432,42,474
公投第８案,南投縣,名間鄉,中正村,298,861,423,104,527,26,553
公投第８案,南投縣,名間鄉,中正村,299,897,385,92,477,43,520
公投第８案,南投縣,名間鄉,中山村,300,1055,466,128,594,57,651
公投第８案,南投縣,名間鄉,中山村,301,1184,517,113,630,66,696
公投第８案,南投縣,名間鄉,濁水村,302,783,303,98,401,45,446
公投第８案,南投縣,名間鄉,濁水村,303,781,343,97,440,45,485
公投第８案,南投縣,名間鄉,新民村,304,977,403,89,492,41,533
公投第８案,南投縣,名間鄉,炭寮村,305,1015,411,96,507,58,565
公投第８案,南投縣,名間鄉,新街村,306,914,405,104,509,41,550
公投第８案,南投縣,名間鄉,新街村,307,1028,431,109,540,20,560
公投第８案,南投縣,名間鄉,新街村,308,1018,465,110,575,42,617
公投第８案,南投縣,名間鄉,新街村,309,1274,541,137,678,73,751
公投第８案,南投縣,名間鄉,東湖村,310,755,309,95,404,50,454
公投第８案,南投縣,名間鄉,東湖村,311,895,423,114,537,55,592
公投第８案,南投縣,名間鄉,仁和村,312,892,432,63,495,28,523
公投第８案,南投縣,名間鄉,萬丹村,313,951,375,118,493,58,551
公投第８案,南投縣,名間鄉,田仔村,314,1261,510,147,657,68,725
公投第８案,南投縣,名間鄉,大坑村,315,768,299,103,402,41,443
公投第８案,南投縣,名間鄉,大庄村,316,962,374,145,519,60,579
公投第８案,南投縣,名間鄉,大庄村,317,867,360,106,466,67,533
公投第８案,南投縣,名間鄉,廍下村,318,930,383,113,496,69,565
公投第８案,南投縣,名間鄉,赤水村,319,641,244,77,321,67,388
公投第８案,南投縣,名間鄉,赤水村,320,530,191,60,251,30,281
公投第８案,南投縣,名間鄉,竹圍村,321,931,366,113,479,76,555
公投第８案,南投縣,名間鄉,三崙村,322,1127,485,131,616,58,674
公投第８案,南投縣,名間鄉,三崙村,323,443,201,53,254,40,294
公投第８案,南投縣,名間鄉,松山村,324,870,369,108,477,55,532
公投第８案,南投縣,名間鄉,松山村,325,621,256,76,332,58,390
公投第８案,南投縣,名間鄉,松柏村,326,1179,417,138,555,45,600
公投第８案,南投縣,名間鄉,崁腳村,327,881,426,84,510,49,559
公投第８案,南投縣,名間鄉,埔中村,328,876,438,96,534,62,596
公投第８案,南投縣,名間鄉,新厝村,329,783,326,89,415,59,474
公投第８案,南投縣,名間鄉,新光村,330,778,308,62,370,49,419
公投第８案,南投縣,名間鄉,新光村,331,983,385,105,490,53,543
公投第８案,南投縣,鹿谷鄉,鹿谷村,332,934,372,65,437,47,484
公投第８案,南投縣,鹿谷鄉,鹿谷村,333,940,385,104,489,48,537
公投第８案,南投縣,鹿谷鄉,彰雅村,334,852,327,96,423,32,455
公投第８案,南投縣,鹿谷鄉,彰雅村,335,451,138,39,177,24,201
公投第８案,南投縣,鹿谷鄉,廣興村,336,810,370,85,455,34,489
公投第８案,南投縣,鹿谷鄉,廣興村,337,1142,526,125,651,61,712
公投第８案,南投縣,鹿谷鄉,永隆村,338,766,283,56,339,21,360
公投第８案,南投縣,鹿谷鄉,永隆村,339,884,372,92,464,53,517
公投第８案,南投縣,鹿谷鄉,鳳凰村,340,811,318,104,422,36,458
公投第８案,南投縣,鹿谷鄉,鳳凰村,341,581,185,60,245,31,276
公投第８案,南投縣,鹿谷鄉,內湖村,342,578,201,70,271,23,294
公投第８案,南投縣,鹿谷鄉,內湖村,343,467,216,41,257,22,279
公投第８案,南投縣,鹿谷鄉,和雅村,344,622,261,53,314,32,346
公投第８案,南投縣,鹿谷鄉,竹林村,345,740,284,67,351,30,381
公投第８案,南投縣,鹿谷鄉,竹林村,346,767,297,91,388,45,433
公投第８案,南投縣,鹿谷鄉,竹豐村,347,909,387,98,485,42,527
公投第８案,南投縣,鹿谷鄉,初鄉村,348,713,283,58,341,28,369
公投第８案,南投縣,鹿谷鄉,初鄉村,349,717,249,57,306,30,336
公投第８案,南投縣,鹿谷鄉,秀峰村,350,794,272,89,361,39,400
公投第８案,南投縣,鹿谷鄉,清水村,351,726,236,73,309,28,337
公投第８案,南投縣,鹿谷鄉,瑞田村,352,737,229,51,280,31,311
公投第８案,南投縣,中寮鄉,廣興村,353,822,336,110,446,60,506
公投第８案,南投縣,中寮鄉,崁頂村,354,253,108,33,141,14,155
公投第８案,南投縣,中寮鄉,崁頂村,355,221,67,16,83,11,94
公投第８案,南投縣,中寮鄉,八仙村,356,353,113,37,150,6,156
公投第８案,南投縣,中寮鄉,八仙村,357,427,163,44,207,29,236
公投第８案,南投縣,中寮鄉,福盛村,358,406,164,45,209,18,227
公投第８案,南投縣,中寮鄉,福盛村,359,307,101,39,140,20,160
公投第８案,南投縣,中寮鄉,和興村,360,661,290,75,365,36,401
公投第８案,南投縣,中寮鄉,復興村,361,290,137,36,173,20,193
公投第８案,南投縣,中寮鄉,永平村,362,973,400,129,529,41,570
公投第８案,南投縣,中寮鄉,永平村,363,754,328,92,420,32,452
公投第８案,南投縣,中寮鄉,中寮村,364,662,267,75,342,26,368
公投第８案,南投縣,中寮鄉,廣福村,365,490,172,44,216,11,227
公投第８案,南投縣,中寮鄉,永福村,366,335,120,39,159,16,175
公投第８案,南投縣,中寮鄉,永福村,367,990,434,97,531,44,575
公投第８案,南投縣,中寮鄉,義和村,368,461,202,67,269,20,289
公投第８案,南投縣,中寮鄉,義和村,369,614,262,87,349,32,381
公投第８案,南投縣,中寮鄉,清水村,370,895,336,112,448,67,515
公投第８案,南投縣,中寮鄉,內城村,371,465,172,53,225,40,265
公投第８案,南投縣,中寮鄉,龍安村,372,682,267,78,345,57,402
公投第８案,南投縣,中寮鄉,爽文村,373,490,208,50,258,45,303
公投第８案,南投縣,中寮鄉,龍岩村,374,643,260,79,339,56,395
公投第８案,南投縣,中寮鄉,永芳村,375,459,210,54,264,20,284
公投第８案,南投縣,中寮鄉,永和村,376,528,182,58,240,25,265
公投第８案,南投縣,魚池鄉,魚池村,377,922,382,109,491,41,532
公投第８案,南投縣,魚池鄉,魚池村,378,1098,465,124,589,54,643
公投第８案,南投縣,魚池鄉,東池村,379,720,275,73,348,36,384
公投第８案,南投縣,魚池鄉,東池村,380,860,369,95,464,44,508
公投第８案,南投縣,魚池鄉,大林村,381,514,170,51,221,40,261
公投第８案,南投縣,魚池鄉,大林村,382,574,215,60,275,10,285
公投第８案,南投縣,魚池鄉,東光村,383,1249,469,147,616,56,672
公投第８案,南投縣,魚池鄉,共和村,384,293,142,35,177,15,192
公投第８案,南投縣,魚池鄉,共和村,385,513,183,68,251,27,278
公投第８案,南投縣,魚池鄉,共和村,386,186,69,25,94,8,102
公投第８案,南投縣,魚池鄉,新城村,387,841,308,93,401,29,430
公投第８案,南投縣,魚池鄉,新城村,388,270,115,33,148,21,169
公投第８案,南投縣,魚池鄉,新城村,389,275,102,31,133,19,152
公投第８案,南投縣,魚池鄉,大雁村,390,282,89,26,115,14,129
公投第８案,南投縣,魚池鄉,大雁村,391,392,133,36,169,15,184
公投第８案,南投縣,魚池鄉,五城村,392,556,215,62,277,27,304
公投第８案,南投縣,魚池鄉,五城村,393,176,71,15,86,10,96
公投第８案,南投縣,魚池鄉,中明村,394,578,202,47,249,24,273
公投第８案,南投縣,魚池鄉,中明村,395,439,147,57,204,19,223
公投第８案,南投縣,魚池鄉,水社村,396,844,392,73,465,32,497
公投第８案,南投縣,魚池鄉,日月村,397,868,340,88,428,38,466
公投第８案,南投縣,魚池鄉,頭社村,398,405,144,28,172,18,190
公投第８案,南投縣,魚池鄉,頭社村,399,537,216,68,284,21,305
公投第８案,南投縣,魚池鄉,武登村,400,335,131,29,160,24,184
公投第８案,南投縣,魚池鄉,武登村,401,231,74,15,89,15,104
公投第８案,南投縣,國姓鄉,國姓村,402,964,433,95,528,73,601
公投第８案,南投縣,國姓鄉,國姓村,403,736,308,84,392,23,415
公投第８案,南投縣,國姓鄉,石門村,404,801,347,68,415,54,469
公投第８案,南投縣,國姓鄉,石門村,405,964,411,89,500,27,527
公投第８案,南投縣,國姓鄉,大旗村,406,686,286,69,355,29,384
公投第８案,南投縣,國姓鄉,長流村,407,661,277,52,329,33,362
公投第８案,南投縣,國姓鄉,長流村,408,730,281,51,332,50,382
公投第８案,南投縣,國姓鄉,長豐村,409,774,272,101,373,61,434
公投第８案,南投縣,國姓鄉,長福村,410,706,315,93,408,15,423
公投第８案,南投縣,國姓鄉,北港村,411,1012,405,134,539,43,582
公投第８案,南投縣,國姓鄉,北港村,412,868,274,89,363,29,392
公投第８案,南投縣,國姓鄉,福龜村,413,918,462,74,536,26,562
公投第８案,南投縣,國姓鄉,福龜村,414,937,380,102,482,52,534
公投第８案,南投縣,國姓鄉,乾溝村,415,815,311,93,404,55,459
公投第８案,南投縣,國姓鄉,柑林村,416,1134,352,278,630,50,680
公投第８案,南投縣,國姓鄉,大石村,417,714,257,77,334,25,359
公投第８案,南投縣,國姓鄉,北山村,418,1095,438,119,557,57,614
公投第８案,南投縣,國姓鄉,北山村,419,448,162,49,211,26,237
公投第８案,南投縣,國姓鄉,南港村,420,1064,424,99,523,48,571
公投第８案,南投縣,國姓鄉,南港村,421,570,226,45,271,26,297
公投第８案,南投縣,水里鄉,水里村,422,757,310,79,389,34,423
公投第８案,南投縣,水里鄉,新城村,423,554,222,58,280,34,314
公投第８案,南投縣,水里鄉,新城村,424,999,389,141,530,47,577
公投第８案,南投縣,水里鄉,中央村,425,616,235,59,294,20,314
公投第８案,南投縣,水里鄉,城中村,426,875,389,89,478,32,510
公投第８案,南投縣,水里鄉,農富村,427,480,214,58,272,10,282
公投第８案,南投縣,水里鄉,車埕村,428,450,183,39,222,24,246
公投第８案,南投縣,水里鄉,新興村,429,643,250,65,315,39,354
公投第８案,南投縣,水里鄉,北埔村,430,1004,435,122,557,29,586
公投第８案,南投縣,水里鄉,南光村,431,741,304,67,371,25,396
公投第８案,南投縣,水里鄉,南光村,432,802,324,124,448,22,470
公投第８案,南投縣,水里鄉,鉅工村,433,998,453,139,592,48,640
公投第８案,南投縣,水里鄉,永豐村,434,800,288,91,379,60,439
公投第８案,南投縣,水里鄉,永豐村,435,589,249,91,340,24,364
公投第８案,南投縣,水里鄉,民和村,436,887,316,101,417,48,465
公投第８案,南投縣,水里鄉,頂崁村,437,1217,463,115,578,54,632
公投第８案,南投縣,水里鄉,新山村,438,205,55,11,66,7,73
公投第８案,南投縣,水里鄉,郡坑村,439,330,161,27,188,21,209
公投第８案,南投縣,水里鄉,上安村,440,1100,420,109,529,32,561
公投第８案,南投縣,水里鄉,興隆村,441,275,68,18,86,5,91
公投第８案,南投縣,水里鄉,永興村,442,318,98,25,123,5,128
公投第８案,南投縣,水里鄉,玉峰村,443,818,289,100,389,54,443
公投第８案,南投縣,信義鄉,明德村,444,1201,457,117,574,107,681
公投第８案,南投縣,信義鄉,明德村,445,329,116,29,145,20,165
公投第８案,南投縣,信義鄉,愛國村,446,516,173,67,240,24,264
公投第８案,南投縣,信義鄉,自強村,447,424,136,33,169,22,191
公投第８案,南投縣,信義鄉,自強村,448,321,121,23,144,7,151
公投第８案,南投縣,信義鄉,豐丘村,449,648,281,65,346,33,379
公投第８案,南投縣,信義鄉,新鄉村,450,584,261,67,328,96,424
公投第８案,南投縣,信義鄉,羅娜村,451,1376,277,54,331,15,346
公投第８案,南投縣,信義鄉,望美村,452,979,306,81,387,32,419
公投第８案,南投縣,信義鄉,望美村,453,530,225,83,308,82,390
公投第８案,南投縣,信義鄉,同富村,454,961,342,94,436,47,483
公投第８案,南投縣,信義鄉,同富村,455,464,198,38,236,19,255
公投第８案,南投縣,信義鄉,神木村,456,517,209,60,269,34,303
公投第８案,南投縣,信義鄉,神木村,457,149,62,17,79,8,87
公投第８案,南投縣,信義鄉,東埔村,458,1020,458,143,601,159,760
公投第８案,南投縣,信義鄉,人和村,459,929,367,98,465,172,637
公投第８案,南投縣,信義鄉,人和村,460,274,81,27,108,15,123
公投第８案,南投縣,信義鄉,地利村,461,900,469,93,562,69,631
公投第８案,南投縣,信義鄉,雙龍村,462,617,297,94,391,60,451
公投第８案,南投縣,信義鄉,潭南村,463,560,242,70,312,34,346
公投第８案,南投縣,仁愛鄉,南豐村,464,973,400,92,492,29,521
公投第８案,南投縣,仁愛鄉,南豐村,465,296,111,29,140,10,150
公投第８案,南投縣,仁愛鄉,大同村,466,900,325,61,386,15,401
公投第８案,南投縣,仁愛鄉,大同村,467,460,223,55,278,20,298
公投第８案,南投縣,仁愛鄉,大同村,468,305,135,36,171,12,183
公投第８案,南投縣,仁愛鄉,榮興村,469,58,15,2,17,3,20
公投第８案,南投縣,仁愛鄉,春陽村,470,952,288,63,351,15,366
公投第８案,南投縣,仁愛鄉,精英村,471,679,195,35,230,6,236
公投第８案,南投縣,仁愛鄉,都達村,472,623,251,62,313,56,369
公投第８案,南投縣,仁愛鄉,合作村,473,597,123,34,157,5,162
公投第８案,南投縣,仁愛鄉,發祥村,474,384,188,34,222,25,247
公投第８案,南投縣,仁愛鄉,發祥村,475,121,47,10,57,5,62
公投第８案,南投縣,仁愛鄉,發祥村,476,264,109,15,124,6,130
公投第８案,南投縣,仁愛鄉,力行村,477,509,271,71,342,39,381
公投第８案,南投縣,仁愛鄉,翠華村,478,338,122,53,175,32,207
公投第８案,南投縣,仁愛鄉,翠華村,479,169,71,12,83,9,92
公投第８案,南投縣,仁愛鄉,親愛村,480,613,219,47,266,27,293
公投第８案,南投縣,仁愛鄉,親愛村,481,404,133,41,174,16,190
公投第８案,南投縣,仁愛鄉,親愛村,482,134,59,14,73,4,77
公投第８案,南投縣,仁愛鄉,萬豐村,483,630,232,96,328,62,390
公投第８案,南投縣,仁愛鄉,法治村,484,763,221,59,280,15,295
公投第８案,南投縣,仁愛鄉,中正村,485,889,458,66,524,40,564
公投第８案,南投縣,仁愛鄉,互助村,486,672,306,83,389,49,438
公投第８案,南投縣,仁愛鄉,互助村,487,447,200,49,249,23,272
公投第８案,南投縣,仁愛鄉,新生村,488,409,251,39,290,12,302
公投第８案,雲林縣,麥寮鄉,麥豐村,1,1497,407,154,561,72,633
公投第８案,雲林縣,麥寮鄉,麥豐村,2,1738,579,230,809,63,872
公投第８案,雲林縣,麥寮鄉,麥豐村,3,1921,634,225,859,98,957
公投第８案,雲林縣,麥寮鄉,麥豐村,4,1832,582,190,772,72,844
公投第８案,雲林縣,麥寮鄉,麥津村,5,1340,410,123,533,73,606
公投第８案,雲林縣,麥寮鄉,麥津村,6,1138,343,133,476,75,551
公投第８案,雲林縣,麥寮鄉,麥津村,7,1551,489,187,676,71,747
公投第８案,雲林縣,麥寮鄉,瓦磘村,8,715,190,74,264,47,311
公投第８案,雲林縣,麥寮鄉,瓦磘村,9,1194,313,124,437,54,491
公投第８案,雲林縣,麥寮鄉,興華村,10,1023,316,104,420,68,488
公投第８案,雲林縣,麥寮鄉,興華村,11,1558,400,144,544,44,588
公投第８案,雲林縣,麥寮鄉,海豐村,12,1187,308,127,435,37,472
公投第８案,雲林縣,麥寮鄉,海豐村,13,983,281,108,389,31,420
公投第８案,雲林縣,麥寮鄉,後安村,14,1363,432,151,583,85,668
公投第８案,雲林縣,麥寮鄉,後安村,15,1596,487,181,668,93,761
公投第８案,雲林縣,麥寮鄉,中興村,16,1469,576,163,739,123,862
公投第８案,雲林縣,麥寮鄉,三盛村,17,964,261,96,357,62,419
公投第８案,雲林縣,麥寮鄉,三盛村,18,1038,276,102,378,52,430
公投第８案,雲林縣,麥寮鄉,崙後村,19,1230,431,114,545,75,620
公投第８案,雲林縣,麥寮鄉,崙後村,20,1329,438,146,584,57,641
公投第８案,雲林縣,麥寮鄉,橋頭村,21,1129,364,148,512,88,600
公投第８案,雲林縣,麥寮鄉,橋頭村,22,1241,444,149,593,100,693
公投第８案,雲林縣,麥寮鄉,橋頭村,23,1471,541,160,701,102,803
公投第８案,雲林縣,麥寮鄉,新吉村,24,1107,384,165,549,81,630
公投第８案,雲林縣,麥寮鄉,施厝村,25,1636,554,252,806,95,901
公投第８案,雲林縣,麥寮鄉,施厝村,26,1755,590,168,758,64,822
公投第８案,雲林縣,麥寮鄉,雷厝村,27,1158,435,117,552,45,597
公投第８案,雲林縣,麥寮鄉,雷厝村,28,956,358,117,475,40,515
公投第８案,雲林縣,臺西鄉,臺西村,29,1238,500,108,608,69,677
公投第８案,雲林縣,臺西鄉,海南村,30,1091,350,111,461,54,515
公投第８案,雲林縣,臺西鄉,海北村,31,1098,385,123,508,70,578
公投第８案,雲林縣,臺西鄉,海口村,32,1048,285,103,388,49,437
公投第８案,雲林縣,臺西鄉,海口村,33,1025,326,94,420,71,491
公投第８案,雲林縣,臺西鄉,山寮村,34,850,285,89,374,57,431
公投第８案,雲林縣,臺西鄉,溪頂村,35,1460,402,145,547,94,641
公投第８案,雲林縣,臺西鄉,牛厝村,36,1180,250,95,345,92,437
公投第８案,雲林縣,臺西鄉,牛厝村,37,710,162,38,200,35,235
公投第８案,雲林縣,臺西鄉,泉州村,38,620,143,52,195,16,211
公投第８案,雲林縣,臺西鄉,五榔村,39,449,132,50,182,31,213
公投第８案,雲林縣,臺西鄉,光華村,40,687,161,56,217,59,276
公投第８案,雲林縣,臺西鄉,五港村,41,1247,366,116,482,75,557
公投第８案,雲林縣,臺西鄉,五港村,42,583,147,37,184,22,206
公投第８案,雲林縣,臺西鄉,富琦村,43,1042,355,107,462,64,526
公投第８案,雲林縣,臺西鄉,富琦村,44,472,140,52,192,27,219
公投第８案,雲林縣,臺西鄉,永豐村,45,1409,397,105,502,35,537
公投第８案,雲林縣,臺西鄉,和豐村,46,1061,337,119,456,104,560
公投第８案,雲林縣,臺西鄉,和豐村,47,993,267,89,356,43,399
公投第８案,雲林縣,臺西鄉,和豐村,48,1013,295,111,406,86,492
公投第８案,雲林縣,臺西鄉,蚊港村,49,1233,403,130,533,50,583
公投第８案,雲林縣,臺西鄉,蚊港村,50,616,184,52,236,28,264
公投第８案,雲林縣,東勢鄉,月眉村,51,1207,347,122,469,66,535
公投第８案,雲林縣,東勢鄉,復興村,52,540,224,73,297,29,326
公投第８案,雲林縣,東勢鄉,嘉隆村,53,896,248,91,339,33,372
公投第８案,雲林縣,東勢鄉,嘉隆村,54,728,248,86,334,59,393
公投第８案,雲林縣,東勢鄉,東南村,55,1533,581,191,772,96,868
公投第８案,雲林縣,東勢鄉,東北村,56,1203,456,154,610,103,713
公投第８案,雲林縣,東勢鄉,龍潭村,57,817,226,92,318,67,385
公投第８案,雲林縣,東勢鄉,程海村,58,546,245,49,294,31,325
公投第８案,雲林縣,東勢鄉,昌南村,59,853,252,106,358,80,438
公投第８案,雲林縣,東勢鄉,安南村,60,856,199,89,288,71,359
公投第８案,雲林縣,東勢鄉,同安村,61,923,289,100,389,56,445
公投第８案,雲林縣,東勢鄉,同安村,62,1022,325,107,432,55,487
公投第８案,雲林縣,東勢鄉,四美村,63,634,176,38,214,27,241
公投第８案,雲林縣,東勢鄉,四美村,64,394,101,33,134,27,161
公投第８案,雲林縣,東勢鄉,新坤村,65,1087,273,88,361,43,404
公投第８案,雲林縣,褒忠鄉,中民村,66,923,333,107,440,69,509
公投第８案,雲林縣,褒忠鄉,中民村,67,993,415,121,536,48,584
公投第８案,雲林縣,褒忠鄉,埔姜村,68,748,278,84,362,29,391
公投第８案,雲林縣,褒忠鄉,埔姜村,69,702,242,80,322,21,343
公投第８案,雲林縣,褒忠鄉,中勝村,70,752,271,64,335,20,355
公投第８案,雲林縣,褒忠鄉,中勝村,71,756,290,84,374,27,401
公投第８案,雲林縣,褒忠鄉,馬鳴村,72,490,174,60,234,17,251
公投第８案,雲林縣,褒忠鄉,馬鳴村,73,1034,287,104,391,35,426
公投第８案,雲林縣,褒忠鄉,新湖村,74,470,139,66,205,26,231
公投第８案,雲林縣,褒忠鄉,新湖村,75,737,252,92,344,33,377
公投第８案,雲林縣,褒忠鄉,有才村,76,878,314,92,406,32,438
公投第８案,雲林縣,褒忠鄉,田洋村,77,778,255,83,338,52,390
公投第８案,雲林縣,褒忠鄉,龍岩村,78,1224,383,141,524,58,582
公投第８案,雲林縣,褒忠鄉,潮厝村,79,896,229,114,343,74,417
公投第８案,雲林縣,土庫鎮,忠正里,80,809,336,119,455,58,513
公投第８案,雲林縣,土庫鎮,順天里,81,896,347,131,478,58,536
公投第８案,雲林縣,土庫鎮,宮北里,82,687,252,96,348,48,396
公投第８案,雲林縣,土庫鎮,宮北里,83,702,337,99,436,34,470
公投第８案,雲林縣,土庫鎮,越港里,84,1032,466,127,593,42,635
公投第８案,雲林縣,土庫鎮,溪邊里,85,697,222,77,299,70,369
公投第８案,雲林縣,土庫鎮,溪邊里,86,427,146,46,192,32,224
公投第８案,雲林縣,土庫鎮,石廟里,87,1451,580,189,769,71,840
公投第８案,雲林縣,土庫鎮,石廟里,88,1283,517,166,683,36,719
公投第８案,雲林縣,土庫鎮,興新里,89,634,192,73,265,14,279
公投第８案,雲林縣,土庫鎮,興新里,90,796,275,101,376,45,421
公投第８案,雲林縣,土庫鎮,奮起里,91,745,200,85,285,48,333
公投第８案,雲林縣,土庫鎮,奮起里,92,576,190,78,268,20,288
公投第８案,雲林縣,土庫鎮,埤腳里,93,743,227,70,297,59,356
公投第８案,雲林縣,土庫鎮,埤腳里,94,534,166,56,222,15,237
公投第８案,雲林縣,土庫鎮,後埔里,95,1199,330,133,463,83,546
公投第８案,雲林縣,土庫鎮,後埔里,96,1077,335,130,465,74,539
公投第８案,雲林縣,土庫鎮,崙內里,97,819,232,67,299,34,333
公投第８案,雲林縣,土庫鎮,崙內里,98,684,239,83,322,44,366
公投第８案,雲林縣,土庫鎮,大荖里,99,843,300,95,395,61,456
公投第８案,雲林縣,土庫鎮,東平里,100,916,305,99,404,82,486
公投第８案,雲林縣,土庫鎮,東平里,101,948,291,111,402,63,465
公投第８案,雲林縣,土庫鎮,南平里,102,914,316,95,411,40,451
公投第８案,雲林縣,土庫鎮,南平里,103,860,312,75,387,76,463
公投第８案,雲林縣,土庫鎮,西平里,104,929,296,112,408,63,471
公投第８案,雲林縣,土庫鎮,西平里,105,875,259,89,348,69,417
公投第８案,雲林縣,土庫鎮,北平里,106,896,249,65,314,46,360
公投第８案,雲林縣,土庫鎮,新庄里,107,757,214,69,283,58,341
公投第８案,雲林縣,土庫鎮,新庄里,108,683,198,81,279,47,326
公投第８案,雲林縣,虎尾鎮,東仁里,109,1347,549,140,689,55,744
公投第８案,雲林縣,虎尾鎮,東仁里,110,1258,513,178,691,48,739
公投第８案,雲林縣,虎尾鎮,新興里,111,785,288,108,396,30,426
公投第８案,雲林縣,虎尾鎮,新興里,112,890,295,97,392,46,438
公投第８案,雲林縣,虎尾鎮,公安里,113,1413,571,186,757,53,810
公投第８案,雲林縣,虎尾鎮,公安里,114,1431,634,181,815,56,871
公投第８案,雲林縣,虎尾鎮,德興里,115,1224,439,152,591,66,657
公投第８案,雲林縣,虎尾鎮,德興里,116,1325,532,70,602,42,644
公投第８案,雲林縣,虎尾鎮,中山里,117,941,372,125,497,71,568
公投第８案,雲林縣,虎尾鎮,西安里,118,1613,686,142,828,27,855
公投第８案,雲林縣,虎尾鎮,西安里,119,1641,579,198,777,44,821
公投第８案,雲林縣,虎尾鎮,立仁里,120,1200,539,126,665,46,711
公投第８案,雲林縣,虎尾鎮,立仁里,121,1294,489,186,675,78,753
公投第８案,雲林縣,虎尾鎮,立仁里,122,1273,516,154,670,43,713
公投第８案,雲林縣,虎尾鎮,安慶里,123,1438,640,173,813,41,854
公投第８案,雲林縣,虎尾鎮,平和里,124,1361,591,148,739,39,778
公投第８案,雲林縣,虎尾鎮,平和里,125,1444,628,197,825,45,870
公投第８案,雲林縣,虎尾鎮,平和里,126,1490,667,216,883,45,928
公投第８案,雲林縣,虎尾鎮,興南里,127,1307,605,186,791,44,835
公投第８案,雲林縣,虎尾鎮,興南里,128,967,345,117,462,22,484
公投第８案,雲林縣,虎尾鎮,新吉里,129,1865,713,199,912,41,953
公投第８案,雲林縣,虎尾鎮,新吉里,130,1880,724,243,967,51,1018
公投第８案,雲林縣,虎尾鎮,穎川里,131,1099,381,138,519,48,567
公投第８案,雲林縣,虎尾鎮,穎川里,132,901,356,113,469,19,488
公投第８案,雲林縣,虎尾鎮,延平里,133,1120,427,114,541,30,571
公投第８案,雲林縣,虎尾鎮,建國里,134,545,185,46,231,11,242
公投第８案,雲林縣,虎尾鎮,埒內里,135,1420,512,170,682,67,749
公投第８案,雲林縣,虎尾鎮,埒內里,136,1248,424,133,557,6,563
公投第８案,雲林縣,虎尾鎮,堀頭里,137,799,292,97,389,28,417
公投第８案,雲林縣,虎尾鎮,安溪里,138,836,275,106,381,64,445
公投第８案,雲林縣,虎尾鎮,安溪里,139,924,296,94,390,56,446
公投第８案,雲林縣,虎尾鎮,興中里,140,1648,486,171,657,38,695
公投第８案,雲林縣,虎尾鎮,廉使里,141,1616,466,195,661,111,772
公投第８案,雲林縣,虎尾鎮,廉使里,142,1546,520,199,719,58,777
公投第８案,雲林縣,虎尾鎮,惠來里,143,1283,459,126,585,42,627
公投第８案,雲林縣,虎尾鎮,惠來里,144,1078,360,121,481,36,517
公投第８案,雲林縣,虎尾鎮,頂溪里,145,1313,418,133,551,48,599
公投第８案,雲林縣,虎尾鎮,頂溪里,146,1284,410,141,551,44,595
公投第８案,雲林縣,虎尾鎮,中溪里,147,1356,477,156,633,95,728
公投第８案,雲林縣,虎尾鎮,下溪里,148,1504,567,145,712,97,809
公投第８案,雲林縣,虎尾鎮,東屯里,149,1224,391,112,503,39,542
公投第８案,雲林縣,虎尾鎮,西屯里,150,1509,509,139,648,59,707
公投第８案,雲林縣,虎尾鎮,芳草里,151,855,189,109,298,65,363
公投第８案,雲林縣,虎尾鎮,墾地里,152,1549,460,170,630,88,718
公投第８案,雲林縣,虎尾鎮,北溪里,153,851,273,84,357,30,387
公投第８案,雲林縣,虎尾鎮,三合里,154,1272,450,107,557,76,633
公投第８案,雲林縣,四湖鄉,四湖村,155,1082,301,108,409,68,477
公投第８案,雲林縣,四湖鄉,四湖村,156,676,237,76,313,50,363
公投第８案,雲林縣,四湖鄉,湖西村,157,862,291,87,378,25,403
公投第８案,雲林縣,四湖鄉,湖西村,158,477,105,34,139,22,161
公投第８案,雲林縣,四湖鄉,湖西村,159,952,361,106,467,34,501
公投第８案,雲林縣,四湖鄉,新庄村,160,650,167,50,217,19,236
公投第８案,雲林縣,四湖鄉,溪底村,161,969,284,98,382,22,404
公投第８案,雲林縣,四湖鄉,鹿場村,162,925,221,99,320,52,372
公投第８案,雲林縣,四湖鄉,蔡厝村,163,914,282,67,349,30,379
公投第８案,雲林縣,四湖鄉,湖寮村,164,759,137,54,191,50,241
公投第８案,雲林縣,四湖鄉,施湖村,165,1219,277,111,388,57,445
公投第８案,雲林縣,四湖鄉,羊調村,166,937,201,67,268,51,319
公投第８案,雲林縣,四湖鄉,內湖村,167,773,154,48,202,16,218
公投第８案,雲林縣,四湖鄉,飛東村,168,555,128,52,180,45,225
公投第８案,雲林縣,四湖鄉,飛沙村,169,876,193,73,266,31,297
公投第８案,雲林縣,四湖鄉,三姓村,170,360,87,27,114,25,139
公投第８案,雲林縣,四湖鄉,崙北村,171,885,160,48,208,54,262
公投第８案,雲林縣,四湖鄉,崙北村,172,833,195,53,248,38,286
公投第８案,雲林縣,四湖鄉,崙南村,173,785,206,73,279,45,324
公投第８案,雲林縣,四湖鄉,廣溝村,174,705,215,71,286,49,335
公投第８案,雲林縣,四湖鄉,箔子村,175,927,198,55,253,28,281
公投第８案,雲林縣,四湖鄉,箔東村,176,1058,226,69,295,81,376
公投第８案,雲林縣,四湖鄉,林厝村,177,1071,251,96,347,58,405
公投第８案,雲林縣,四湖鄉,林東村,178,1022,186,59,245,21,266
公投第８案,雲林縣,四湖鄉,溪尾村,179,711,170,67,237,40,277
公投第８案,雲林縣,元長鄉,長南村,180,915,308,90,398,45,443
公投第８案,雲林縣,元長鄉,長南村,181,1284,385,140,525,40,565
公投第８案,雲林縣,元長鄉,長南村,182,1150,330,128,458,50,508
公投第８案,雲林縣,元長鄉,長北村,183,744,195,73,268,52,320
公投第８案,雲林縣,元長鄉,長北村,184,790,257,74,331,59,390
公投第８案,雲林縣,元長鄉,子茂村,185,1356,350,121,471,85,556
公投第８案,雲林縣,元長鄉,後湖村,186,739,193,98,291,66,357
公投第８案,雲林縣,元長鄉,山內村,187,965,227,97,324,44,368
公投第８案,雲林縣,元長鄉,合和村,188,1080,276,111,387,77,464
公投第８案,雲林縣,元長鄉,五塊村,189,948,237,82,319,54,373
公投第８案,雲林縣,元長鄉,潭西村,190,762,151,61,212,33,245
公投第８案,雲林縣,元長鄉,潭東村,191,582,175,56,231,32,263
公投第８案,雲林縣,元長鄉,客厝村,192,865,225,63,288,17,305
公投第８案,雲林縣,元長鄉,卓運村,193,362,63,7,70,7,77
公投第８案,雲林縣,元長鄉,頂寮村,194,1162,284,105,389,36,425
公投第８案,雲林縣,元長鄉,下寮村,195,1527,438,134,572,50,622
公投第８案,雲林縣,元長鄉,龍岩村,196,1006,289,127,416,71,487
公投第８案,雲林縣,元長鄉,西莊村,197,855,241,82,323,22,345
公投第８案,雲林縣,元長鄉,鹿北村,198,1181,362,111,473,84,557
公投第８案,雲林縣,元長鄉,鹿南村,199,864,234,74,308,47,355
公投第８案,雲林縣,元長鄉,瓦磘村,200,667,155,68,223,41,264
公投第８案,雲林縣,元長鄉,瓦磘村,201,878,213,84,297,45,342
公投第８案,雲林縣,元長鄉,內寮村,202,610,120,38,158,11,169
公投第８案,雲林縣,元長鄉,崙仔村,203,837,235,91,326,73,399
公投第８案,雲林縣,元長鄉,新吉村,204,701,231,79,310,44,354
公投第８案,雲林縣,口湖鄉,口湖村,205,1134,361,144,505,70,575
公投第８案,雲林縣,口湖鄉,湖東村,206,1225,418,130,548,116,664
公投第８案,雲林縣,口湖鄉,頂湖村,207,647,176,50,226,45,271
公投第８案,雲林縣,口湖鄉,埔南村,208,709,234,74,308,28,336
公投第８案,雲林縣,口湖鄉,埔北村,209,900,264,80,344,81,425
公投第８案,雲林縣,口湖鄉,謝厝村,210,1011,307,108,415,81,496
公投第８案,雲林縣,口湖鄉,蚵寮村,211,1437,381,107,488,34,522
公投第８案,雲林縣,口湖鄉,下崙村,212,848,174,63,237,8,245
公投第８案,雲林縣,口湖鄉,下崙村,213,1193,304,108,412,39,451
公投第８案,雲林縣,口湖鄉,崙中村,214,759,168,63,231,57,288
公投第８案,雲林縣,口湖鄉,崙中村,215,815,223,85,308,59,367
公投第８案,雲林縣,口湖鄉,崙東村,216,1460,460,160,620,96,716
公投第８案,雲林縣,口湖鄉,青蚶村,217,556,104,47,151,13,164
公投第８案,雲林縣,口湖鄉,港東村,218,1532,480,126,606,85,691
公投第８案,雲林縣,口湖鄉,港西村,219,847,246,96,342,18,360
公投第８案,雲林縣,口湖鄉,台子村,220,374,122,31,153,29,182
公投第８案,雲林縣,口湖鄉,台子村,221,1508,482,159,641,189,830
公投第８案,雲林縣,口湖鄉,成龍村,222,951,348,95,443,76,519
公投第８案,雲林縣,口湖鄉,梧南村,223,910,300,122,422,95,517
公投第８案,雲林縣,口湖鄉,梧南村,224,879,351,111,462,50,512
公投第８案,雲林縣,口湖鄉,梧北村,225,1213,346,99,445,140,585
公投第８案,雲林縣,口湖鄉,水井村,226,952,319,79,398,59,457
公投第８案,雲林縣,口湖鄉,後厝村,227,720,234,92,326,63,389
公投第８案,雲林縣,口湖鄉,湖口村,228,1006,237,93,330,36,366
公投第８案,雲林縣,口湖鄉,過港村,229,607,153,45,198,11,209
公投第８案,雲林縣,水林鄉,水北村,230,1355,407,129,536,69,605
公投第８案,雲林縣,水林鄉,水北村,231,887,274,100,374,28,402
公投第８案,雲林縣,水林鄉,水南村,232,1234,456,138,594,66,660
公投第８案,雲林縣,水林鄉,水南村,233,763,248,77,325,21,346
公投第８案,雲林縣,水林鄉,萬興村,234,721,136,126,262,41,303
公投第８案,雲林縣,水林鄉,尖山村,235,647,168,41,209,13,222
公投第８案,雲林縣,水林鄉,大溝村,236,989,274,89,363,65,428
公投第８案,雲林縣,水林鄉,順興村,237,837,193,81,274,29,303
公投第８案,雲林縣,水林鄉,大山村,238,1081,270,75,345,23,368
公投第８案,雲林縣,水林鄉,後寮村,239,704,196,74,270,46,316
公投第８案,雲林縣,水林鄉,春埔村,240,1006,287,109,396,94,490
公投第８案,雲林縣,水林鄉,西井村,241,651,188,57,245,13,258
公投第８案,雲林縣,水林鄉,車港村,242,607,157,57,214,23,237
公投第８案,雲林縣,水林鄉,蘇秦村,243,1033,253,103,356,73,429
公投第８案,雲林縣,水林鄉,灣東村,244,631,141,42,183,14,197
公投第８案,雲林縣,水林鄉,灣西村,245,961,250,90,340,65,405
公投第８案,雲林縣,水林鄉,蕃薯村,246,951,242,92,334,84,418
公投第８案,雲林縣,水林鄉,山腳村,247,838,221,98,319,40,359
公投第８案,雲林縣,水林鄉,松北村,248,1055,319,84,403,97,500
公投第８案,雲林縣,水林鄉,松中村,249,512,102,30,132,35,167
公投第８案,雲林縣,水林鄉,松西村,250,671,155,54,209,20,229
公投第８案,雲林縣,水林鄉,欍埔村,251,693,119,49,168,45,213
公投第８案,雲林縣,水林鄉,塭底村,252,689,136,58,194,45,239
公投第８案,雲林縣,水林鄉,海埔村,253,1022,314,102,416,78,494
公投第８案,雲林縣,水林鄉,土厝村,254,1191,323,101,424,45,469
公投第８案,雲林縣,水林鄉,溪墘村,255,779,281,81,362,42,404
公投第８案,雲林縣,北港鎮,東陽里,256,724,257,95,352,75,427
公投第８案,雲林縣,北港鎮,光民里,257,688,274,91,365,68,433
公投第８案,雲林縣,北港鎮,東華里,258,452,164,53,217,48,265
公投第８案,雲林縣,北港鎮,南安里,259,866,323,108,431,78,509
公投第８案,雲林縣,北港鎮,中和里,260,336,104,47,151,26,177
公投第８案,雲林縣,北港鎮,義民里,261,395,147,34,181,34,215
公投第８案,雲林縣,北港鎮,共榮里,262,376,160,44,204,33,237
公投第８案,雲林縣,北港鎮,西勢里,263,950,361,126,487,58,545
公投第８案,雲林縣,北港鎮,仁和里,264,512,197,72,269,50,319
公投第８案,雲林縣,北港鎮,賜福里,265,324,130,35,165,33,198
公投第８案,雲林縣,北港鎮,公舘里,266,546,188,74,262,36,298
公投第８案,雲林縣,北港鎮,大同里,267,433,171,57,228,30,258
公投第８案,雲林縣,北港鎮,大同里,268,751,263,102,365,66,431
公投第８案,雲林縣,北港鎮,仁安里,269,442,189,49,238,35,273
公投第８案,雲林縣,北港鎮,華勝里,270,1151,442,152,594,72,666
公投第８案,雲林縣,北港鎮,華勝里,271,1224,480,163,643,56,699
公投第８案,雲林縣,北港鎮,華勝里,272,1211,444,139,583,63,646
公投第８案,雲林縣,北港鎮,華勝里,273,1326,499,166,665,91,756
公投第８案,雲林縣,北港鎮,光復里,274,744,331,100,431,47,478
公投第８案,雲林縣,北港鎮,光復里,275,977,453,114,567,60,627
公投第８案,雲林縣,北港鎮,扶朝里,276,960,340,119,459,66,525
公投第８案,雲林縣,北港鎮,水埔里,277,494,115,47,162,9,171
公投第８案,雲林縣,北港鎮,新街里,278,1364,565,162,727,59,786
公投第８案,雲林縣,北港鎮,新街里,279,1123,454,127,581,71,652
公投第８案,雲林縣,北港鎮,新街里,280,1451,567,186,753,66,819
公投第８案,雲林縣,北港鎮,新街里,281,1162,457,145,602,90,692
公投第８案,雲林縣,北港鎮,新街里,282,1130,374,162,536,50,586
公投第８案,雲林縣,北港鎮,劉厝里,283,1149,398,119,517,51,568
公投第８案,雲林縣,北港鎮,後溝里,284,533,148,53,201,39,240
公投第８案,雲林縣,北港鎮,後溝里,285,433,177,69,246,25,271
公投第８案,雲林縣,北港鎮,新厝里,286,377,135,25,160,18,178
公投第８案,雲林縣,北港鎮,府番里,287,809,241,83,324,24,348
公投第８案,雲林縣,北港鎮,草湖里,288,1397,426,128,554,88,642
公投第８案,雲林縣,北港鎮,溝皂里,289,1145,320,111,431,100,531
公投第８案,雲林縣,北港鎮,番溝里,290,828,173,66,239,75,314
公投第８案,雲林縣,北港鎮,大北里,291,557,148,47,195,24,219
公投第８案,雲林縣,北港鎮,好收里,292,1060,300,147,447,52,499
公投第８案,雲林縣,北港鎮,好收里,293,577,174,70,244,34,278
公投第８案,雲林縣,北港鎮,樹腳里,294,931,249,85,334,72,406
公投第８案,雲林縣,北港鎮,樹腳里,295,1018,375,119,494,45,539
公投第８案,雲林縣,北港鎮,樹腳里,296,1032,384,135,519,29,548
公投第８案,雲林縣,崙背鄉,東明村,297,1176,423,145,568,86,654
公投第８案,雲林縣,崙背鄉,西榮村,298,1439,476,166,642,50,692
公投第８案,雲林縣,崙背鄉,南陽村,299,1027,431,117,548,66,614
公投第８案,雲林縣,崙背鄉,南陽村,300,1259,487,147,634,56,690
公投第８案,雲林縣,崙背鄉,崙前村,301,1058,356,131,487,32,519
公投第８案,雲林縣,崙背鄉,崙前村,302,998,317,94,411,34,445
公投第８案,雲林縣,崙背鄉,羅厝村,303,968,314,107,421,28,449
公投第８案,雲林縣,崙背鄉,羅厝村,304,1055,362,138,500,53,553
公投第８案,雲林縣,崙背鄉,港尾村,305,1315,389,148,537,87,624
公投第８案,雲林縣,崙背鄉,阿勸村,306,1027,203,84,287,35,322
公投第８案,雲林縣,崙背鄉,阿勸村,307,997,368,123,491,96,587
公投第８案,雲林縣,崙背鄉,五魁村,308,807,298,86,384,36,420
公投第８案,雲林縣,崙背鄉,大有村,309,698,179,80,259,24,283
公投第８案,雲林縣,崙背鄉,大有村,310,804,208,104,312,55,367
公投第８案,雲林縣,崙背鄉,豐榮村,311,867,274,95,369,34,403
公投第８案,雲林縣,崙背鄉,豐榮村,312,886,236,75,311,28,339
公投第８案,雲林縣,崙背鄉,草湖村,313,1476,381,134,515,96,611
公投第８案,雲林縣,崙背鄉,舊庄村,314,1159,243,80,323,49,372
公投第８案,雲林縣,崙背鄉,水尾村,315,1220,409,164,573,101,674
公投第８案,雲林縣,崙背鄉,枋南村,316,814,271,100,371,37,408
公投第８案,雲林縣,二崙鄉,崙東村,317,1463,446,161,607,40,647
公投第８案,雲林縣,二崙鄉,崙西村,318,1738,545,150,695,74,769
公投第８案,雲林縣,二崙鄉,來惠村,319,625,180,58,238,59,297
公投第８案,雲林縣,二崙鄉,來惠村,320,1018,329,93,422,74,496
公投第８案,雲林縣,二崙鄉,三和村,321,448,120,26,146,9,155
公投第８案,雲林縣,二崙鄉,三和村,322,1048,257,92,349,47,396
公投第８案,雲林縣,二崙鄉,湳仔村,323,1161,396,150,546,83,629
公投第８案,雲林縣,二崙鄉,田尾村,324,991,323,130,453,52,505
公投第８案,雲林縣,二崙鄉,田尾村,325,849,306,119,425,74,499
公投第８案,雲林縣,二崙鄉,定安村,326,890,306,95,401,49,450
公投第８案,雲林縣,二崙鄉,永定村,327,1427,455,146,601,101,702
公投第８案,雲林縣,二崙鄉,大華村,328,891,282,98,380,37,417
公投第８案,雲林縣,二崙鄉,義庄村,329,757,213,76,289,26,315
公投第８案,雲林縣,二崙鄉,楊賢村,330,1497,446,163,609,117,726
公投第８案,雲林縣,二崙鄉,港後村,331,1171,334,135,469,74,543
公投第８案,雲林縣,二崙鄉,港後村,332,686,245,98,343,57,400
公投第８案,雲林縣,二崙鄉,大義村,333,864,209,79,288,98,386
公投第８案,雲林縣,二崙鄉,油車村,334,1073,390,141,531,84,615
公投第８案,雲林縣,二崙鄉,油車村,335,696,187,58,245,30,275
公投第８案,雲林縣,二崙鄉,大庄村,336,1271,300,107,407,63,470
公投第８案,雲林縣,二崙鄉,庄西村,337,912,252,101,353,53,406
公投第８案,雲林縣,二崙鄉,大同村,338,861,222,110,332,43,375
公投第８案,雲林縣,二崙鄉,復興村,339,1030,271,111,382,66,448
公投第８案,雲林縣,西螺鎮,振興里,340,1590,547,185,732,68,800
公投第８案,雲林縣,西螺鎮,大園里,341,1741,691,189,880,101,981
公投第８案,雲林縣,西螺鎮,廣福里,342,1080,502,127,629,68,697
公投第８案,雲林縣,西螺鎮,廣福里,343,1040,447,136,583,65,648
公投第８案,雲林縣,西螺鎮,正興里,344,1346,541,162,703,39,742
公投第８案,雲林縣,西螺鎮,正興里,345,1625,621,201,822,57,879
公投第８案,雲林縣,西螺鎮,永安里,346,354,156,35,191,27,218
公投第８案,雲林縣,西螺鎮,中和里,347,580,196,78,274,45,319
公投第８案,雲林縣,西螺鎮,福興里,348,591,243,93,336,37,373
公投第８案,雲林縣,西螺鎮,光華里,349,1050,413,139,552,67,619
公投第８案,雲林縣,西螺鎮,中興里,350,1147,460,180,640,66,706
公投第８案,雲林縣,西螺鎮,中興里,351,1602,584,196,780,81,861
公投第８案,雲林縣,西螺鎮,漢光里,352,1452,520,171,691,60,751
公投第８案,雲林縣,西螺鎮,漢光里,353,1578,575,204,779,107,886
公投第８案,雲林縣,西螺鎮,漢光里,354,1305,492,125,617,32,649
公投第８案,雲林縣,西螺鎮,新安里,355,1327,430,124,554,46,600
公投第８案,雲林縣,西螺鎮,新豐里,356,1516,523,188,711,70,781
公投第８案,雲林縣,西螺鎮,大新里,357,828,227,75,302,26,328
公投第８案,雲林縣,西螺鎮,大新里,358,788,190,64,254,26,280
公投第８案,雲林縣,西螺鎮,埤頭里,359,863,261,112,373,76,449
公投第８案,雲林縣,西螺鎮,東興里,360,984,294,131,425,93,518
公投第８案,雲林縣,西螺鎮,鹿場里,361,1514,470,176,646,164,810
公投第８案,雲林縣,西螺鎮,廣興里,362,870,269,123,392,71,463
公投第８案,雲林縣,西螺鎮,頂湳里,363,971,350,105,455,61,516
公投第８案,雲林縣,西螺鎮,吳厝里,364,1304,385,144,529,54,583
公投第８案,雲林縣,西螺鎮,九隆里,365,726,247,62,309,36,345
公投第８案,雲林縣,西螺鎮,下湳里,366,823,308,89,397,52,449
公投第８案,雲林縣,西螺鎮,七座里,367,886,250,74,324,21,345
公投第８案,雲林縣,西螺鎮,公舘里,368,1373,432,150,582,102,684
公投第８案,雲林縣,西螺鎮,詔安里,369,983,345,121,466,68,534
公投第８案,雲林縣,西螺鎮,河南里,370,1014,382,109,491,54,545
公投第８案,雲林縣,西螺鎮,安定里,371,939,276,110,386,87,473
公投第８案,雲林縣,西螺鎮,安定里,372,866,274,103,377,47,424
公投第８案,雲林縣,西螺鎮,福田里,373,1486,451,166,617,112,729
公投第８案,雲林縣,莿桐鄉,莿桐村,374,1507,546,197,743,103,846
公投第８案,雲林縣,莿桐鄉,莿桐村,375,1300,516,132,648,48,696
公投第８案,雲林縣,莿桐鄉,莿桐村,376,1272,477,150,627,90,717
公投第８案,雲林縣,莿桐鄉,甘厝村,377,861,276,112,388,71,459
公投第８案,雲林縣,莿桐鄉,甘西村,378,1565,477,171,648,77,725
公投第８案,雲林縣,莿桐鄉,興桐村,379,577,192,66,258,19,277
公投第８案,雲林縣,莿桐鄉,興桐村,380,636,164,87,251,48,299
公投第８案,雲林縣,莿桐鄉,義和村,381,1110,359,135,494,79,573
公投第８案,雲林縣,莿桐鄉,埔子村,382,973,380,143,523,72,595
公投第８案,雲林縣,莿桐鄉,埔子村,383,985,351,127,478,76,554
公投第８案,雲林縣,莿桐鄉,大美村,384,1707,659,237,896,116,1012
公投第８案,雲林縣,莿桐鄉,大美村,385,1284,470,160,630,88,718
公投第８案,雲林縣,莿桐鄉,埔尾村,386,1293,444,183,627,79,706
公投第８案,雲林縣,莿桐鄉,興貴村,387,900,334,114,448,62,510
公投第８案,雲林縣,莿桐鄉,興貴村,388,1040,374,126,500,119,619
公投第８案,雲林縣,莿桐鄉,饒平村,389,1165,427,115,542,42,584
公投第８案,雲林縣,莿桐鄉,四合村,390,871,318,111,429,64,493
公投第８案,雲林縣,莿桐鄉,四合村,391,885,365,112,477,58,535
公投第８案,雲林縣,莿桐鄉,麻園村,392,1489,491,155,646,78,724
公投第８案,雲林縣,莿桐鄉,五華村,393,1347,426,136,562,104,666
公投第８案,雲林縣,莿桐鄉,六合村,394,1150,429,165,594,73,667
公投第８案,雲林縣,莿桐鄉,六合村,395,653,260,78,338,48,386
公投第８案,雲林縣,林內鄉,林南村,396,1036,440,138,578,77,655
公投第８案,雲林縣,林內鄉,林中村,397,1490,572,175,747,89,836
公投第８案,雲林縣,林內鄉,林中村,398,1491,543,165,708,87,795
公投第８案,雲林縣,林內鄉,林中村,399,671,237,50,287,66,353
公投第８案,雲林縣,林內鄉,林北村,400,1436,562,189,751,114,865
公投第８案,雲林縣,林內鄉,林北村,401,751,303,80,383,59,442
公投第８案,雲林縣,林內鄉,坪頂村,402,535,197,71,268,25,293
公投第８案,雲林縣,林內鄉,林茂村,403,811,258,79,337,48,385
公投第８案,雲林縣,林內鄉,九芎村,404,1339,490,172,662,103,765
公投第８案,雲林縣,林內鄉,九芎村,405,1286,482,120,602,91,693
公投第８案,雲林縣,林內鄉,湖本村,406,646,239,78,317,38,355
公投第８案,雲林縣,林內鄉,烏塗村,407,1158,411,153,564,85,649
公投第８案,雲林縣,林內鄉,烏麻村,408,1090,434,116,550,66,616
公投第８案,雲林縣,林內鄉,重興村,409,950,381,122,503,78,581
公投第８案,雲林縣,林內鄉,重興村,410,861,303,97,400,46,446
公投第８案,雲林縣,斗六市,信義里,411,644,240,81,321,14,335
公投第８案,雲林縣,斗六市,四維里,412,617,226,85,311,30,341
公投第８案,雲林縣,斗六市,太平里,413,764,362,106,468,35,503
公投第８案,雲林縣,斗六市,中和里,414,784,319,134,453,34,487
公投第８案,雲林縣,斗六市,光興里,415,760,284,126,410,29,439
公投第８案,雲林縣,斗六市,鎮西里,416,1881,817,240,1057,78,1135
公投第８案,雲林縣,斗六市,鎮西里,417,1829,695,235,930,67,997
公投第８案,雲林縣,斗六市,鎮東里,418,1255,565,166,731,40,771
公投第８案,雲林縣,斗六市,鎮東里,419,1090,563,105,668,35,703
公投第８案,雲林縣,斗六市,文化里,420,1103,502,125,627,46,673
公投第８案,雲林縣,斗六市,文化里,421,1176,530,127,657,47,704
公投第８案,雲林縣,斗六市,三平里,422,1529,640,180,820,28,848
公投第８案,雲林縣,斗六市,三平里,423,1335,613,139,752,43,795
公投第８案,雲林縣,斗六市,三平里,424,1770,747,222,969,70,1039
公投第８案,雲林縣,斗六市,明德里,425,1308,523,187,710,34,744
公投第８案,雲林縣,斗六市,明德里,426,2171,825,261,1086,87,1173
公投第８案,雲林縣,斗六市,鎮北里,427,1193,513,146,659,44,703
公投第８案,雲林縣,斗六市,鎮北里,428,1572,708,204,912,66,978
公投第８案,雲林縣,斗六市,公誠里,429,1009,415,105,520,34,554
公投第８案,雲林縣,斗六市,公誠里,430,1195,553,145,698,44,742
公投第８案,雲林縣,斗六市,忠孝里,431,1415,489,300,789,72,861
公投第８案,雲林縣,斗六市,仁愛里,432,1101,470,163,633,32,665
公投第８案,雲林縣,斗六市,八德里,433,1648,642,193,835,34,869
公投第８案,雲林縣,斗六市,八德里,434,1588,614,150,764,37,801
公投第８案,雲林縣,斗六市,公正里,435,1392,625,156,781,38,819
公投第８案,雲林縣,斗六市,公正里,436,1422,634,159,793,38,831
公投第８案,雲林縣,斗六市,重光里,437,1187,422,105,527,33,560
公投第８案,雲林縣,斗六市,重光里,438,1142,430,150,580,37,617
公投第８案,雲林縣,斗六市,林頭里,439,1421,651,177,828,47,875
公投第８案,雲林縣,斗六市,林頭里,440,1261,523,165,688,29,717
公投第８案,雲林縣,斗六市,林頭里,441,1506,554,194,748,38,786
公投第８案,雲林縣,斗六市,成功里,442,1214,529,143,672,37,709
公投第８案,雲林縣,斗六市,成功里,443,1362,708,194,902,66,968
公投第８案,雲林縣,斗六市,鎮南里,444,1097,447,122,569,24,593
公投第８案,雲林縣,斗六市,鎮南里,445,1262,538,145,683,36,719
公投第８案,雲林縣,斗六市,鎮南里,446,1154,476,121,597,36,633
公投第８案,雲林縣,斗六市,社口里,447,847,362,99,461,44,505
公投第８案,雲林縣,斗六市,社口里,448,1439,621,172,793,32,825
公投第８案,雲林縣,斗六市,龍潭里,449,1747,766,223,989,73,1062
公投第８案,雲林縣,斗六市,嘉東里,450,1418,604,162,766,48,814
公投第８案,雲林縣,斗六市,崙峰里,451,1112,453,132,585,45,630
公投第８案,雲林縣,斗六市,崙峰里,452,1302,568,135,703,50,753
公投第８案,雲林縣,斗六市,溝埧里,453,669,298,101,399,27,426
公投第８案,雲林縣,斗六市,江厝里,454,752,316,73,389,37,426
公投第８案,雲林縣,斗六市,江厝里,455,1450,582,159,741,28,769
公投第８案,雲林縣,斗六市,三光里,456,555,212,65,277,42,319
公投第８案,雲林縣,斗六市,久安里,457,1470,571,147,718,47,765
公投第８案,雲林縣,斗六市,久安里,458,927,417,125,542,24,566
公投第８案,雲林縣,斗六市,虎溪里,459,1893,835,212,1047,58,1105
公投第８案,雲林縣,斗六市,虎溪里,460,1708,645,228,873,109,982
公投第８案,雲林縣,斗六市,虎溪里,461,1773,637,184,821,51,872
公投第８案,雲林縣,斗六市,保庄里,462,1412,616,170,786,51,837
公投第８案,雲林縣,斗六市,保庄里,463,1354,701,94,795,36,831
公投第８案,雲林縣,斗六市,保庄里,464,1267,502,156,658,35,693
公投第８案,雲林縣,斗六市,保庄里,465,1273,485,164,649,31,680
公投第８案,雲林縣,斗六市,長平里,466,1748,652,167,819,90,909
公投第８案,雲林縣,斗六市,榴中里,467,1238,503,154,657,70,727
公投第８案,雲林縣,斗六市,榴中里,468,1648,635,181,816,96,912
公投第８案,雲林縣,斗六市,榴中里,469,1520,632,219,851,65,916
公投第８案,雲林縣,斗六市,榴北里,470,1087,407,114,521,38,559
公投第８案,雲林縣,斗六市,榴南里,471,1904,792,219,1011,77,1088
公投第８案,雲林縣,斗六市,梅林里,472,702,305,80,385,39,424
公投第８案,雲林縣,斗六市,梅林里,473,1111,443,157,600,46,646
公投第８案,雲林縣,斗六市,湖山里,474,1123,374,127,501,33,534
公投第８案,雲林縣,斗六市,長安里,475,1146,434,115,549,32,581
公投第８案,雲林縣,斗六市,長安里,476,1786,677,209,886,47,933
公投第８案,雲林縣,斗六市,溪洲里,477,1023,383,152,535,51,586
公投第８案,雲林縣,斗六市,溪洲里,478,2072,788,261,1049,94,1143
公投第８案,雲林縣,斗六市,十三里,479,1128,405,142,547,27,574
公投第８案,雲林縣,大埤鄉,北和村,480,750,279,80,359,41,400
公投第８案,雲林縣,大埤鄉,吉田村,481,719,249,76,325,27,352
公投第８案,雲林縣,大埤鄉,豐岡村,482,603,232,52,284,28,312
公投第８案,雲林縣,大埤鄉,聯美村,483,1106,316,139,455,64,519
公投第８案,雲林縣,大埤鄉,南和村,484,1495,504,190,694,78,772
公投第８案,雲林縣,大埤鄉,南和村,485,600,231,93,324,32,356
公投第８案,雲林縣,大埤鄉,大德村,486,1004,392,141,533,56,589
公投第８案,雲林縣,大埤鄉,松竹村,487,948,242,97,339,23,362
公投第８案,雲林縣,大埤鄉,豐田村,488,1539,680,74,754,77,831
公投第８案,雲林縣,大埤鄉,尚義村,489,1430,485,145,630,73,703
公投第８案,雲林縣,大埤鄉,尚義村,490,465,148,50,198,35,233
公投第８案,雲林縣,大埤鄉,嘉興村,491,1307,439,154,593,54,647
公投第８案,雲林縣,大埤鄉,嘉興村,492,474,156,56,212,28,240
公投第８案,雲林縣,大埤鄉,三結村,493,1220,449,176,625,99,724
公投第８案,雲林縣,大埤鄉,怡然村,494,733,248,75,323,22,345
公投第８案,雲林縣,大埤鄉,北鎮村,495,681,248,85,333,35,368
公投第８案,雲林縣,大埤鄉,興安村,496,712,200,63,263,33,296
公投第８案,雲林縣,大埤鄉,西鎮村,497,723,216,89,305,43,348
公投第８案,雲林縣,斗南鎮,東仁里,498,1166,508,134,642,45,687
公投第８案,雲林縣,斗南鎮,西岐里,499,1135,494,151,645,38,683
公投第８案,雲林縣,斗南鎮,西岐里,500,975,447,117,564,38,602
公投第８案,雲林縣,斗南鎮,大同里,501,1459,629,177,806,49,855
公投第８案,雲林縣,斗南鎮,大同里,502,1351,559,180,739,53,792
公投第８案,雲林縣,斗南鎮,南昌里,503,1321,527,148,675,58,733
公投第８案,雲林縣,斗南鎮,南昌里,504,907,342,104,446,51,497
公投第８案,雲林縣,斗南鎮,北銘里,505,1473,651,189,840,83,923
公投第８案,雲林縣,斗南鎮,中天里,506,1277,523,212,735,67,802
公投第８案,雲林縣,斗南鎮,林子里,507,1333,475,161,636,98,734
公投第８案,雲林縣,斗南鎮,石龜里,508,777,296,72,368,41,409
公投第８案,雲林縣,斗南鎮,石溪里,509,877,327,112,439,40,479
公投第８案,雲林縣,斗南鎮,靖興里,510,899,338,105,443,50,493
公投第８案,雲林縣,斗南鎮,新南里,511,688,197,75,272,41,313
公投第８案,雲林縣,斗南鎮,阿丹里,512,1147,397,112,509,29,538
公投第８案,雲林縣,斗南鎮,將軍里,513,1709,619,235,854,91,945
公投第８案,雲林縣,斗南鎮,舊社里,514,1042,445,143,588,45,633
公投第８案,雲林縣,斗南鎮,舊社里,515,1631,591,214,805,70,875
公投第８案,雲林縣,斗南鎮,明昌里,516,1702,716,217,933,94,1027
公投第８案,雲林縣,斗南鎮,明昌里,517,1564,625,218,843,69,912
公投第８案,雲林縣,斗南鎮,僑真里,518,910,304,81,385,34,419
公投第８案,雲林縣,斗南鎮,僑真里,519,1276,549,171,720,50,770
公投第８案,雲林縣,斗南鎮,大東里,520,897,300,68,368,23,391
公投第８案,雲林縣,斗南鎮,埤麻里,521,803,305,79,384,44,428
公投第８案,雲林縣,斗南鎮,西伯里,522,866,355,102,457,46,503
公投第８案,雲林縣,斗南鎮,新崙里,523,852,319,123,442,60,502
公投第８案,雲林縣,斗南鎮,新崙里,524,671,243,84,327,52,379
公投第８案,雲林縣,斗南鎮,東明里,525,981,357,121,478,29,507
公投第８案,雲林縣,斗南鎮,新光里,526,1129,362,131,493,35,528
公投第８案,雲林縣,斗南鎮,新光里,527,1586,647,184,831,106,937
公投第８案,雲林縣,斗南鎮,田頭里,528,1243,530,155,685,72,757
公投第８案,雲林縣,斗南鎮,田頭里,529,984,338,108,446,25,471
公投第８案,雲林縣,斗南鎮,小東里,530,1507,554,180,734,77,811
公投第８案,雲林縣,古坑鄉,棋盤村,531,1126,407,134,541,76,617
公投第８案,雲林縣,古坑鄉,棋盤村,532,994,359,101,460,62,522
公投第８案,雲林縣,古坑鄉,新庄村,533,1517,498,196,694,59,753
公投第８案,雲林縣,古坑鄉,東和村,534,1302,479,156,635,57,692
公投第８案,雲林縣,古坑鄉,東和村,535,1772,652,159,811,56,867
公投第８案,雲林縣,古坑鄉,荷苞村,536,1122,442,120,562,84,646
公投第８案,雲林縣,古坑鄉,荷苞村,537,304,64,24,88,5,93
公投第８案,雲林縣,古坑鄉,高林村,538,1169,472,123,595,84,679
公投第８案,雲林縣,古坑鄉,水碓村,539,1255,407,148,555,100,655
公投第８案,雲林縣,古坑鄉,田心村,540,1078,455,141,596,56,652
公投第８案,雲林縣,古坑鄉,古坑村,541,943,330,84,414,26,440
公投第８案,雲林縣,古坑鄉,古坑村,542,1300,460,129,589,79,668
公投第８案,雲林縣,古坑鄉,朝陽村,543,964,323,99,422,59,481
公投第８案,雲林縣,古坑鄉,朝陽村,544,1144,439,120,559,58,617
公投第８案,雲林縣,古坑鄉,西平村,545,1482,563,145,708,78,786
公投第８案,雲林縣,古坑鄉,湳仔村,546,688,277,69,346,39,385
公投第８案,雲林縣,古坑鄉,永光村,547,998,341,103,444,45,489
公投第８案,雲林縣,古坑鄉,永光村,548,1140,463,130,593,58,651
公投第８案,雲林縣,古坑鄉,永昌村,549,1102,404,129,533,56,589
公投第８案,雲林縣,古坑鄉,永昌村,550,956,345,121,466,31,497
公投第８案,雲林縣,古坑鄉,麻園村,551,695,236,94,330,31,361
公投第８案,雲林縣,古坑鄉,崁腳村,552,1233,420,119,539,29,568
公投第８案,雲林縣,古坑鄉,華南村,553,285,65,33,98,9,107
公投第８案,雲林縣,古坑鄉,華山村,554,734,198,51,249,16,265
公投第８案,雲林縣,古坑鄉,桂林村,555,1150,390,163,553,80,633
公投第８案,雲林縣,古坑鄉,樟湖村,556,453,149,56,205,25,230
公投第８案,雲林縣,古坑鄉,草嶺村,557,571,192,54,246,31,277
公投第８案,嘉義縣,太保市,太保里,1,1210,463,130,593,84,677
公投第８案,嘉義縣,太保市,太保里,2,1076,410,124,534,45,579
公投第８案,嘉義縣,太保市,後庄里,3,488,152,53,205,29,234
公投第８案,嘉義縣,太保市,前潭里,4,1475,450,191,641,73,714
公投第８案,嘉義縣,太保市,後潭里,5,790,238,83,321,38,359
公投第８案,嘉義縣,太保市,後潭里,6,883,311,92,403,47,450
公投第８案,嘉義縣,太保市,梅埔里,7,758,267,67,334,57,391
公投第８案,嘉義縣,太保市,梅埔里,8,389,111,34,145,6,151
公投第８案,嘉義縣,太保市,春珠里,9,1101,313,134,447,64,511
公投第８案,嘉義縣,太保市,崙頂里,10,853,305,90,395,15,410
公投第８案,嘉義縣,太保市,安仁里,11,224,54,25,79,13,92
公投第８案,嘉義縣,太保市,安仁里,12,662,198,61,259,59,318
公投第８案,嘉義縣,太保市,安仁里,13,1630,736,187,923,39,962
公投第８案,嘉義縣,太保市,東勢里,14,913,287,102,389,31,420
公投第８案,嘉義縣,太保市,東勢里,15,779,320,90,410,23,433
公投第８案,嘉義縣,太保市,新埤里,16,1278,415,175,590,113,703
公投第８案,嘉義縣,太保市,舊埤里,17,819,252,95,347,37,384
公投第８案,嘉義縣,太保市,舊埤里,18,1573,538,187,725,41,766
公投第８案,嘉義縣,太保市,田尾里,19,481,177,55,232,27,259
公投第８案,嘉義縣,太保市,田尾里,20,245,104,31,135,6,141
公投第８案,嘉義縣,太保市,港尾里,21,317,116,31,147,22,169
公投第８案,嘉義縣,太保市,港尾里,22,258,85,25,110,10,120
公投第８案,嘉義縣,太保市,過溝里,23,611,200,73,273,60,333
公投第８案,嘉義縣,太保市,過溝里,24,1526,543,217,760,68,828
公投第８案,嘉義縣,太保市,過溝里,25,1196,424,186,610,33,643
公投第８案,嘉義縣,太保市,麻寮里,26,1536,536,197,733,104,837
公投第８案,嘉義縣,太保市,麻寮里,27,1481,524,211,735,90,825
公投第８案,嘉義縣,太保市,麻寮里,28,1450,546,183,729,62,791
公投第８案,嘉義縣,太保市,南新里,29,840,267,95,362,25,387
公投第８案,嘉義縣,太保市,南新里,30,989,331,135,466,34,500
公投第８案,嘉義縣,太保市,北新里,31,1529,566,177,743,103,846
公投第８案,嘉義縣,太保市,北新里,32,1511,524,225,749,96,845
公投第８案,嘉義縣,太保市,埤鄉里,33,697,199,75,274,47,321
公投第８案,嘉義縣,鹿草鄉,後寮村,34,522,132,56,188,52,240
公投第８案,嘉義縣,鹿草鄉,鹿東村,35,563,182,70,252,47,299
公投第８案,嘉義縣,鹿草鄉,鹿草村,36,1304,405,138,543,95,638
公投第８案,嘉義縣,鹿草鄉,西井村,37,1312,424,159,583,74,657
公投第８案,嘉義縣,鹿草鄉,豊稠村,38,320,94,29,123,5,128
公投第８案,嘉義縣,鹿草鄉,豊稠村,39,418,89,16,105,5,110
公投第８案,嘉義縣,鹿草鄉,重寮村,40,1025,279,85,364,73,437
公投第８案,嘉義縣,鹿草鄉,施家村,41,451,113,49,162,23,185
公投第８案,嘉義縣,鹿草鄉,下潭村,42,830,258,75,333,110,443
公投第８案,嘉義縣,鹿草鄉,光潭村,43,1050,290,114,404,85,489
公投第８案,嘉義縣,鹿草鄉,碧潭村,44,972,256,69,325,74,399
公投第８案,嘉義縣,鹿草鄉,松竹村,45,962,283,87,370,70,440
公投第８案,嘉義縣,鹿草鄉,竹山村,46,678,205,80,285,57,342
公投第８案,嘉義縣,鹿草鄉,竹山村,47,262,77,25,102,35,137
公投第８案,嘉義縣,鹿草鄉,後堀村,48,906,252,77,329,61,390
公投第８案,嘉義縣,鹿草鄉,後堀村,49,306,71,20,91,14,105
公投第８案,嘉義縣,鹿草鄉,三角村,50,1062,353,101,454,80,534
公投第８案,嘉義縣,鹿草鄉,三角村,51,373,119,46,165,30,195
公投第８案,嘉義縣,鹿草鄉,下麻村,52,324,114,32,146,29,175
公投第８案,嘉義縣,鹿草鄉,下麻村,53,297,102,21,123,23,146
公投第８案,嘉義縣,水上鄉,水上村,54,1024,349,129,478,24,502
公投第８案,嘉義縣,水上鄉,水上村,55,1015,397,150,547,65,612
公投第８案,嘉義縣,水上鄉,水上村,56,1932,646,215,861,79,940
公投第８案,嘉義縣,水上鄉,水頭村,57,1170,462,160,622,55,677
公投第８案,嘉義縣,水上鄉,水頭村,58,1305,497,179,676,89,765
公投第８案,嘉義縣,水上鄉,粗溪村,59,1242,412,138,550,64,614
公投第８案,嘉義縣,水上鄉,粗溪村,60,324,98,46,144,17,161
公投第８案,嘉義縣,水上鄉,下寮村,61,622,225,78,303,21,324
公投第８案,嘉義縣,水上鄉,下寮村,62,1216,423,121,544,92,636
公投第８案,嘉義縣,水上鄉,三和村,63,1020,400,124,524,34,558
公投第８案,嘉義縣,水上鄉,三和村,64,771,322,119,441,39,480
公投第８案,嘉義縣,水上鄉,回歸村,65,441,186,63,249,27,276
公投第８案,嘉義縣,水上鄉,大堀村,66,626,268,89,357,49,406
公投第８案,嘉義縣,水上鄉,大堀村,67,570,231,74,305,32,337
公投第８案,嘉義縣,水上鄉,大堀村,68,368,117,50,167,25,192
公投第８案,嘉義縣,水上鄉,大崙村,69,1037,303,129,432,103,535
公投第８案,嘉義縣,水上鄉,大崙村,70,1065,368,134,502,72,574
公投第８案,嘉義縣,水上鄉,塗溝村,71,802,309,118,427,80,507
公投第８案,嘉義縣,水上鄉,龍德村,72,1948,639,225,864,48,912
公投第８案,嘉義縣,水上鄉,溪洲村,73,1028,334,124,458,65,523
公投第８案,嘉義縣,水上鄉,三鎮村,74,641,262,82,344,27,371
公投第８案,嘉義縣,水上鄉,靖和村,75,408,167,44,211,13,224
公投第８案,嘉義縣,水上鄉,南和村,76,794,300,112,412,45,457
公投第８案,嘉義縣,水上鄉,南和村,77,569,162,68,230,39,269
公投第８案,嘉義縣,水上鄉,柳新村,78,806,312,96,408,43,451
公投第８案,嘉義縣,水上鄉,柳新村,79,960,382,127,509,43,552
公投第８案,嘉義縣,水上鄉,柳林村,80,2035,704,295,999,111,1110
公投第８案,嘉義縣,水上鄉,柳鄉村,81,1987,663,237,900,113,1013
公投第８案,嘉義縣,水上鄉,內溪村,82,1154,441,123,564,36,600
公投第８案,嘉義縣,水上鄉,寬士村,83,2208,770,265,1035,83,1118
公投第８案,嘉義縣,水上鄉,寬士村,84,2102,625,231,856,76,932
公投第８案,嘉義縣,水上鄉,民生村,85,1309,426,152,578,77,655
公投第８案,嘉義縣,水上鄉,民生村,86,1671,585,235,820,87,907
公投第８案,嘉義縣,水上鄉,義興村,87,822,297,93,390,50,440
公投第８案,嘉義縣,水上鄉,中庄村,88,1772,578,206,784,55,839
公投第８案,嘉義縣,水上鄉,忠和村,89,1919,635,255,890,100,990
公投第８案,嘉義縣,水上鄉,南鄉村,90,912,249,94,343,26,369
公投第８案,嘉義縣,水上鄉,三界村,91,992,323,116,439,31,470
公投第８案,嘉義縣,水上鄉,國姓村,92,1270,382,111,493,70,563
公投第８案,嘉義縣,民雄鄉,東榮村,93,1267,514,154,668,62,730
公投第８案,嘉義縣,民雄鄉,東榮村,94,1030,366,117,483,42,525
公投第８案,嘉義縣,民雄鄉,中樂村,95,1590,620,273,893,46,939
公投第８案,嘉義縣,民雄鄉,西安村,96,1673,599,170,769,46,815
公投第８案,嘉義縣,民雄鄉,西安村,97,1718,636,241,877,91,968
公投第８案,嘉義縣,民雄鄉,寮頂村,98,1040,440,116,556,58,614
公投第８案,嘉義縣,民雄鄉,寮頂村,99,1100,389,136,525,68,593
公投第８案,嘉義縣,民雄鄉,福權村,100,1559,510,195,705,90,795
公投第８案,嘉義縣,民雄鄉,東湖村,101,1862,597,244,841,96,937
公投第８案,嘉義縣,民雄鄉,頂崙村,102,1435,538,196,734,74,808
公投第８案,嘉義縣,民雄鄉,菁埔村,103,1751,509,226,735,171,906
公投第８案,嘉義縣,民雄鄉,中和村,104,933,340,112,452,68,520
公投第８案,嘉義縣,民雄鄉,平和村,105,827,311,143,454,62,516
公投第８案,嘉義縣,民雄鄉,西昌村,106,843,226,101,327,64,391
公投第８案,嘉義縣,民雄鄉,豊收村,107,1774,635,212,847,90,937
公投第８案,嘉義縣,民雄鄉,豊收村,108,385,110,49,159,23,182
公投第８案,嘉義縣,民雄鄉,三興村,109,1306,519,177,696,49,745
公投第８案,嘉義縣,民雄鄉,東興村,110,535,193,79,272,48,320
公投第８案,嘉義縣,民雄鄉,鎮北村,111,1055,387,142,529,83,612
公投第８案,嘉義縣,民雄鄉,北斗村,112,1476,545,182,727,67,794
公投第８案,嘉義縣,民雄鄉,北斗村,113,1583,547,181,728,66,794
公投第８案,嘉義縣,民雄鄉,北斗村,114,758,223,79,302,39,341
公投第８案,嘉義縣,民雄鄉,北斗村,115,1354,456,156,612,62,674
公投第８案,嘉義縣,民雄鄉,双福村,116,1202,436,152,588,96,684
公投第８案,嘉義縣,民雄鄉,双福村,117,1175,440,146,586,60,646
公投第８案,嘉義縣,民雄鄉,福樂村,118,1423,506,151,657,65,722
公投第８案,嘉義縣,民雄鄉,福樂村,119,1612,609,179,788,59,847
公投第８案,嘉義縣,民雄鄉,福樂村,120,1695,651,230,881,41,922
公投第８案,嘉義縣,民雄鄉,福樂村,121,1665,518,174,692,62,754
公投第８案,嘉義縣,民雄鄉,大崎村,122,1019,334,93,427,62,489
公投第８案,嘉義縣,民雄鄉,大崎村,123,1352,467,167,634,72,706
公投第８案,嘉義縣,民雄鄉,秀林村,124,1620,578,215,793,96,889
公投第８案,嘉義縣,民雄鄉,秀林村,125,943,320,107,427,46,473
公投第８案,嘉義縣,民雄鄉,松山村,126,1720,511,210,721,72,793
公投第８案,嘉義縣,民雄鄉,興中村,127,1875,608,231,839,114,953
公投第８案,嘉義縣,民雄鄉,興南村,128,1305,495,174,669,64,733
公投第８案,嘉義縣,民雄鄉,興南村,129,1441,500,156,656,82,738
公投第８案,嘉義縣,民雄鄉,金興村,130,1413,499,173,672,79,751
公投第８案,嘉義縣,民雄鄉,金興村,131,1560,541,192,733,99,832
公投第８案,嘉義縣,民雄鄉,福興村,132,2004,702,281,983,132,1115
公投第８案,嘉義縣,民雄鄉,文隆村,133,1354,563,157,720,75,795
公投第８案,嘉義縣,民雄鄉,文隆村,134,1076,419,134,553,45,598
公投第８案,嘉義縣,民雄鄉,山中村,135,1629,560,209,769,139,908
公投第８案,嘉義縣,民雄鄉,山中村,136,1977,673,227,900,90,990
公投第８案,嘉義縣,民雄鄉,中央村,137,1295,398,187,585,98,683
公投第８案,嘉義縣,新港鄉,宮前村,138,1087,398,119,517,40,557
公投第８案,嘉義縣,新港鄉,宮前村,139,1116,511,154,665,70,735
公投第８案,嘉義縣,新港鄉,宮後村,140,740,272,79,351,57,408
公投第８案,嘉義縣,新港鄉,宮後村,141,827,266,92,358,79,437
公投第８案,嘉義縣,新港鄉,大興村,142,704,273,96,369,62,431
公投第８案,嘉義縣,新港鄉,大興村,143,768,283,126,409,64,473
公投第８案,嘉義縣,新港鄉,福德村,144,761,292,117,409,46,455
公投第８案,嘉義縣,新港鄉,福德村,145,850,268,89,357,72,429
公投第８案,嘉義縣,新港鄉,古民村,146,1327,451,150,601,94,695
公投第８案,嘉義縣,新港鄉,中庄村,147,756,265,84,349,68,417
公投第８案,嘉義縣,新港鄉,中庄村,148,816,275,88,363,98,461
公投第８案,嘉義縣,新港鄉,大潭村,149,667,188,78,266,36,302
公投第８案,嘉義縣,新港鄉,大潭村,150,942,304,118,422,58,480
公投第８案,嘉義縣,新港鄉,西庄村,151,918,256,105,361,77,438
公投第８案,嘉義縣,新港鄉,埤子村,152,554,168,44,212,11,223
公投第８案,嘉義縣,新港鄉,南崙村,153,929,281,93,374,61,435
公投第８案,嘉義縣,新港鄉,北崙村,154,487,122,38,160,44,204
公投第８案,嘉義縣,新港鄉,海瀛村,155,487,160,61,221,49,270
公投第８案,嘉義縣,新港鄉,月眉村,156,836,210,123,333,61,394
公投第８案,嘉義縣,新港鄉,月眉村,157,845,262,124,386,78,464
公投第８案,嘉義縣,新港鄉,月潭村,158,834,303,91,394,58,452
公投第８案,嘉義縣,新港鄉,月潭村,159,753,278,88,366,59,425
公投第８案,嘉義縣,新港鄉,溪北村,160,1328,425,195,620,81,701
公投第８案,嘉義縣,新港鄉,菜公村,161,969,371,116,487,65,552
公投第８案,嘉義縣,新港鄉,中洋村,162,1043,394,134,528,88,616
公投第８案,嘉義縣,新港鄉,三間村,163,1400,569,184,753,88,841
公投第８案,嘉義縣,新港鄉,安和村,164,1017,231,75,306,33,339
公投第８案,嘉義縣,新港鄉,潭大村,165,1132,320,123,443,66,509
公投第８案,嘉義縣,新港鄉,南港村,166,1037,332,124,456,81,537
公投第８案,嘉義縣,新港鄉,板頭村,167,563,201,71,272,59,331
公投第８案,嘉義縣,新港鄉,共和村,168,849,260,115,375,32,407
公投第８案,嘉義縣,大林鎮,東林里,169,483,158,63,221,43,264
公投第８案,嘉義縣,大林鎮,西林里,170,1823,704,218,922,89,1011
公投第８案,嘉義縣,大林鎮,吉林里,171,955,342,135,477,35,512
公投第８案,嘉義縣,大林鎮,平林里,172,1436,508,158,666,49,715
公投第８案,嘉義縣,大林鎮,平林里,173,1390,476,172,648,71,719
公投第８案,嘉義縣,大林鎮,平林里,174,1512,558,188,746,97,843
公投第８案,嘉義縣,大林鎮,平林里,175,1536,582,208,790,68,858
公投第８案,嘉義縣,大林鎮,明華里,176,1165,387,111,498,49,547
公投第８案,嘉義縣,大林鎮,明和里,177,1730,694,233,927,82,1009
公投第８案,嘉義縣,大林鎮,排路里,178,602,169,49,218,20,238
公投第８案,嘉義縣,大林鎮,西結里,179,716,200,76,276,81,357
公投第８案,嘉義縣,大林鎮,湖北里,180,625,143,42,185,17,202
公投第８案,嘉義縣,大林鎮,大糖里,181,193,49,18,67,1,68
公投第８案,嘉義縣,大林鎮,大美里,182,1642,489,178,667,84,751
公投第８案,嘉義縣,大林鎮,過溪里,183,1465,505,168,673,83,756
公投第８案,嘉義縣,大林鎮,中坑里,184,928,266,84,350,60,410
公投第８案,嘉義縣,大林鎮,中坑里,185,361,98,31,129,30,159
公投第８案,嘉義縣,大林鎮,上林里,186,814,239,66,305,34,339
公投第８案,嘉義縣,大林鎮,中林里,187,1579,497,175,672,45,717
公投第８案,嘉義縣,大林鎮,三和里,188,2041,706,223,929,117,1046
公投第８案,嘉義縣,大林鎮,溝背里,189,931,289,118,407,67,474
公投第８案,嘉義縣,大林鎮,義和里,190,675,234,64,298,45,343
公投第８案,嘉義縣,大林鎮,內林里,191,655,216,63,279,32,311
公投第８案,嘉義縣,大林鎮,三角里,192,833,289,62,351,52,403
公投第８案,嘉義縣,大林鎮,三村里,193,832,313,129,442,57,499
公投第８案,嘉義縣,溪口鄉,溪東村,194,1318,484,149,633,115,748
公投第８案,嘉義縣,溪口鄉,溪西村,195,677,248,88,336,54,390
公投第８案,嘉義縣,溪口鄉,溪北村,196,417,138,42,180,19,199
公投第８案,嘉義縣,溪口鄉,溪北村,197,273,91,38,129,19,148
公投第８案,嘉義縣,溪口鄉,柳溝村,198,908,333,132,465,63,528
公投第８案,嘉義縣,溪口鄉,柳溝村,199,386,112,33,145,16,161
公投第８案,嘉義縣,溪口鄉,疊溪村,200,1039,354,143,497,80,577
公投第８案,嘉義縣,溪口鄉,妙崙村,201,708,201,69,270,58,328
公投第８案,嘉義縣,溪口鄉,坪頂村,202,909,267,100,367,23,390
公投第８案,嘉義縣,溪口鄉,柴林村,203,786,276,87,363,66,429
公投第８案,嘉義縣,溪口鄉,林腳村,204,807,241,83,324,58,382
公投第８案,嘉義縣,溪口鄉,美南村,205,1168,301,93,394,29,423
公投第８案,嘉義縣,溪口鄉,美北村,206,1052,343,142,485,100,585
公投第８案,嘉義縣,溪口鄉,本厝村,207,565,157,65,222,63,285
公投第８案,嘉義縣,溪口鄉,本厝村,208,388,139,37,176,28,204
公投第８案,嘉義縣,溪口鄉,游西村,209,701,185,59,244,37,281
公投第８案,嘉義縣,溪口鄉,游東村,210,1003,255,95,350,47,397
公投第８案,嘉義縣,梅山鄉,梅東村,211,1041,338,130,468,44,512
公投第８案,嘉義縣,梅山鄉,梅東村,212,1245,463,175,638,96,734
公投第８案,嘉義縣,梅山鄉,梅南村,213,917,380,129,509,54,563
公投第８案,嘉義縣,梅山鄉,梅北村,214,1189,432,130,562,63,625
公投第８案,嘉義縣,梅山鄉,梅北村,215,1388,541,160,701,81,782
公投第８案,嘉義縣,梅山鄉,梅北村,216,1827,663,213,876,71,947
公投第８案,嘉義縣,梅山鄉,過山村,217,545,231,62,293,44,337
公投第８案,嘉義縣,梅山鄉,圳南村,218,407,112,38,150,33,183
公投第８案,嘉義縣,梅山鄉,圳北村,219,636,215,81,296,39,335
公投第８案,嘉義縣,梅山鄉,双溪村,220,576,202,71,273,57,330
公投第８案,嘉義縣,梅山鄉,大南村,221,1674,608,222,830,82,912
公投第８案,嘉義縣,梅山鄉,安靖村,222,858,253,83,336,21,357
公投第８案,嘉義縣,梅山鄉,永興村,223,526,202,91,293,37,330
公投第８案,嘉義縣,梅山鄉,半天村,224,372,101,40,141,39,180
公投第８案,嘉義縣,梅山鄉,太平村,225,506,175,52,227,27,254
公投第８案,嘉義縣,梅山鄉,太興村,226,433,213,36,249,54,303
公投第８案,嘉義縣,梅山鄉,龍眼村,227,404,109,34,143,17,160
公投第８案,嘉義縣,梅山鄉,碧湖村,228,293,88,36,124,21,145
公投第８案,嘉義縣,梅山鄉,瑞峯村,229,712,292,82,374,73,447
公投第８案,嘉義縣,梅山鄉,瑞里村,230,602,259,74,333,40,373
公投第８案,嘉義縣,梅山鄉,太和村,231,515,171,50,221,29,250
公投第８案,嘉義縣,梅山鄉,太和村,232,417,121,30,151,13,164
公投第８案,嘉義縣,朴子市,安福里,233,1183,457,133,590,54,644
公投第８案,嘉義縣,朴子市,安福里,234,755,256,101,357,55,412
公投第８案,嘉義縣,朴子市,平和里,235,1253,473,149,622,44,666
公投第８案,嘉義縣,朴子市,平和里,236,1078,424,149,573,77,650
公投第８案,嘉義縣,朴子市,內厝里,237,1117,484,110,594,91,685
公投第８案,嘉義縣,朴子市,開元里,238,387,149,55,204,26,230
公投第８案,嘉義縣,朴子市,順天里,239,633,243,68,311,48,359
公投第８案,嘉義縣,朴子市,中正里,240,650,280,40,320,40,360
公投第８案,嘉義縣,朴子市,博厚里,241,825,358,101,459,57,516
公投第８案,嘉義縣,朴子市,文化里,242,810,298,83,381,63,444
公投第８案,嘉義縣,朴子市,文化里,243,940,369,102,471,76,547
公投第８案,嘉義縣,朴子市,永和里,244,905,301,113,414,66,480
公投第８案,嘉義縣,朴子市,永和里,245,1605,504,191,695,67,762
公投第８案,嘉義縣,朴子市,竹圍里,246,1479,599,174,773,69,842
公投第８案,嘉義縣,朴子市,竹圍里,247,1218,448,169,617,82,699
公投第８案,嘉義縣,朴子市,竹圍里,248,1496,601,178,779,77,856
公投第８案,嘉義縣,朴子市,新寮里,249,667,215,90,305,45,350
公投第８案,嘉義縣,朴子市,双溪里,250,627,152,59,211,33,244
公投第８案,嘉義縣,朴子市,溪口里,251,791,260,79,339,57,396
公投第８案,嘉義縣,朴子市,德興里,252,1034,345,116,461,112,573
公投第８案,嘉義縣,朴子市,仁和里,253,1710,574,188,762,35,797
公投第８案,嘉義縣,朴子市,大鄉里,254,1671,548,151,699,54,753
公投第８案,嘉義縣,朴子市,大鄉里,255,1547,422,133,555,57,612
公投第８案,嘉義縣,朴子市,大葛里,256,1602,400,156,556,85,641
公投第８案,嘉義縣,朴子市,大葛里,257,1302,544,151,695,40,735
公投第８案,嘉義縣,朴子市,佳禾里,258,740,245,70,315,61,376
公投第８案,嘉義縣,朴子市,竹村里,259,1054,408,129,537,82,619
公投第８案,嘉義縣,朴子市,崁前里,260,907,241,82,323,23,346
公投第８案,嘉義縣,朴子市,崁後里,261,720,186,72,258,46,304
公投第８案,嘉義縣,朴子市,順安里,262,251,84,32,116,30,146
公投第８案,嘉義縣,朴子市,德家里,263,767,199,73,272,62,334
公投第８案,嘉義縣,朴子市,新庄里,264,702,227,99,326,63,389
公投第８案,嘉義縣,朴子市,梅華里,265,1038,304,110,414,71,485
公投第８案,嘉義縣,朴子市,松華里,266,1228,272,76,348,40,388
公投第８案,嘉義縣,朴子市,南竹里,267,499,139,53,192,65,257
公投第８案,嘉義縣,六腳鄉,蒜頭村,268,1165,321,118,439,40,479
公投第８案,嘉義縣,六腳鄉,蒜東村,269,825,186,58,244,20,264
公投第８案,嘉義縣,六腳鄉,蒜南村,270,850,244,83,327,33,360
公投第８案,嘉義縣,六腳鄉,工廠村,271,222,80,31,111,21,132
公投第８案,嘉義縣,六腳鄉,灣南村,272,1216,385,134,519,66,585
公投第８案,嘉義縣,六腳鄉,灣北村,273,1200,303,80,383,52,435
公投第８案,嘉義縣,六腳鄉,雙涵村,274,877,269,85,354,55,409
公投第８案,嘉義縣,六腳鄉,塗師村,275,644,170,51,221,52,273
公投第８案,嘉義縣,六腳鄉,三義村,276,594,134,50,184,19,203
公投第８案,嘉義縣,六腳鄉,三義村,277,167,30,7,37,2,39
公投第８案,嘉義縣,六腳鄉,正義村,278,204,39,27,66,1,67
公投第８案,嘉義縣,六腳鄉,正義村,279,234,58,23,81,8,89
公投第８案,嘉義縣,六腳鄉,正義村,280,361,82,30,112,9,121
公投第８案,嘉義縣,六腳鄉,正義村,281,592,199,73,272,53,325
公投第８案,嘉義縣,六腳鄉,溪厝村,282,619,182,80,262,48,310
公投第８案,嘉義縣,六腳鄉,港美村,283,714,163,55,218,51,269
公投第８案,嘉義縣,六腳鄉,豐美村,284,1051,329,94,423,60,483
公投第８案,嘉義縣,六腳鄉,六斗村,285,934,301,109,410,72,482
公投第８案,嘉義縣,六腳鄉,崙陽村,286,1044,346,101,447,64,511
公投第８案,嘉義縣,六腳鄉,蘇厝村,287,1476,410,129,539,42,581
公投第８案,嘉義縣,六腳鄉,竹本村,288,618,145,46,191,24,215
公投第８案,嘉義縣,六腳鄉,永賢村,289,478,84,26,110,52,162
公投第８案,嘉義縣,六腳鄉,魚寮村,290,642,133,55,188,44,232
公投第８案,嘉義縣,六腳鄉,潭墘村,291,883,176,69,245,15,260
公投第８案,嘉義縣,六腳鄉,六腳村,292,739,157,47,204,7,211
公投第８案,嘉義縣,六腳鄉,六南村,293,554,131,51,182,33,215
公投第８案,嘉義縣,六腳鄉,崩山村,294,649,132,45,177,24,201
公投第８案,嘉義縣,六腳鄉,古林村,295,689,158,48,206,24,230
公投第８案,嘉義縣,六腳鄉,更寮村,296,455,102,45,147,24,171
公投第８案,嘉義縣,六腳鄉,更寮村,297,125,24,9,33,4,37
公投第８案,嘉義縣,東石鄉,東石村,298,1915,494,195,689,111,800
公投第８案,嘉義縣,東石鄉,猿樹村,299,938,213,85,298,69,367
公投第８案,嘉義縣,東石鄉,型厝村,300,1366,238,105,343,31,374
公投第８案,嘉義縣,東石鄉,塭港村,301,1676,413,144,557,5,562
公投第８案,嘉義縣,東石鄉,三家村,302,1151,278,92,370,95,465
公投第８案,嘉義縣,東石鄉,永屯村,303,716,172,66,238,82,320
公投第８案,嘉義縣,東石鄉,海埔村,304,387,88,28,116,8,124
公投第８案,嘉義縣,東石鄉,龍港村,305,864,173,46,219,12,231
公投第８案,嘉義縣,東石鄉,副瀨村,306,910,181,64,245,21,266
公投第８案,嘉義縣,東石鄉,下揖村,307,760,174,48,222,16,238
公投第８案,嘉義縣,東石鄉,頂揖村,308,166,48,22,70,15,85
公投第８案,嘉義縣,東石鄉,頂揖村,309,212,47,14,61,16,77
公投第８案,嘉義縣,東石鄉,溪下村,310,993,218,60,278,44,322
公投第８案,嘉義縣,東石鄉,港口村,311,306,72,25,97,14,111
公投第８案,嘉義縣,東石鄉,鰲鼓村,312,1046,217,84,301,110,411
公投第８案,嘉義縣,東石鄉,鰲鼓村,313,235,48,13,61,29,90
公投第８案,嘉義縣,東石鄉,港墘村,314,1226,341,107,448,104,552
公投第８案,嘉義縣,東石鄉,蔦松村,315,843,211,85,296,66,362
公投第８案,嘉義縣,東石鄉,圍潭村,316,693,190,57,247,34,281
公投第８案,嘉義縣,東石鄉,洲仔村,317,839,264,83,347,65,412
公投第８案,嘉義縣,東石鄉,東崙村,318,363,108,21,129,16,145
公投第８案,嘉義縣,東石鄉,東崙村,319,321,77,21,98,10,108
公投第８案,嘉義縣,東石鄉,西崙村,320,1083,347,141,488,108,596
公投第８案,嘉義縣,東石鄉,塭仔村,321,901,253,102,355,55,410
公投第８案,嘉義縣,東石鄉,網寮村,322,1216,262,67,329,36,365
公投第８案,嘉義縣,東石鄉,掌潭村,323,418,137,65,202,47,249
公投第８案,嘉義縣,東石鄉,掌潭村,324,371,117,24,141,14,155
公投第８案,嘉義縣,布袋鎮,岱江里,325,614,203,50,253,39,292
公投第８案,嘉義縣,布袋鎮,九龍里,326,372,113,37,150,16,166
公投第８案,嘉義縣,布袋鎮,岑海里,327,914,311,95,406,99,505
公投第８案,嘉義縣,布袋鎮,岑海里,328,1198,408,120,528,103,631
公投第８案,嘉義縣,布袋鎮,興中里,329,1113,342,94,436,86,522
公投第８案,嘉義縣,布袋鎮,光復里,330,992,341,104,445,91,536
公投第８案,嘉義縣,布袋鎮,光復里,331,689,239,69,308,16,324
公投第８案,嘉義縣,布袋鎮,見龍里,332,882,285,88,373,78,451
公投第８案,嘉義縣,布袋鎮,新厝里,333,731,265,69,334,45,379
公投第８案,嘉義縣,布袋鎮,龍江里,334,779,293,74,367,51,418
公投第８案,嘉義縣,布袋鎮,振寮里,335,762,229,66,295,45,340
公投第８案,嘉義縣,布袋鎮,西安里,336,1184,350,104,454,66,520
公投第８案,嘉義縣,布袋鎮,中安里,337,1423,365,120,485,73,558
公投第８案,嘉義縣,布袋鎮,東安里,338,1351,337,123,460,79,539
公投第８案,嘉義縣,布袋鎮,樹林里,339,275,69,31,100,6,106
公投第８案,嘉義縣,布袋鎮,樹林里,340,243,61,28,89,20,109
公投第８案,嘉義縣,布袋鎮,貴舍里,341,661,201,63,264,99,363
公投第８案,嘉義縣,布袋鎮,永安里,342,1145,352,105,457,75,532
公投第８案,嘉義縣,布袋鎮,東港里,343,936,269,103,372,42,414
公投第８案,嘉義縣,布袋鎮,東港里,344,958,300,101,401,52,453
公投第８案,嘉義縣,布袋鎮,江山里,345,298,93,25,118,16,134
公投第８案,嘉義縣,布袋鎮,菜舖里,346,428,44,162,206,37,243
公投第８案,嘉義縣,布袋鎮,考試里,347,121,31,13,44,6,50
公投第８案,嘉義縣,布袋鎮,考試里,348,174,34,10,44,5,49
公投第８案,嘉義縣,布袋鎮,新岑里,349,953,294,94,388,63,451
公投第８案,嘉義縣,布袋鎮,新民里,350,1292,447,161,608,79,687
公投第８案,嘉義縣,布袋鎮,復興里,351,1127,395,133,528,72,600
公投第８案,嘉義縣,布袋鎮,復興里,352,1244,410,127,537,38,575
公投第８案,嘉義縣,布袋鎮,好美里,353,1106,304,121,425,28,453
公投第８案,嘉義縣,義竹鄉,岸腳村,354,482,154,45,199,31,230
公投第８案,嘉義縣,義竹鄉,岸腳村,355,223,83,27,110,20,130
公投第８案,嘉義縣,義竹鄉,義竹村,356,1529,538,184,722,87,809
公投第８案,嘉義縣,義竹鄉,六桂村,357,1175,443,131,574,77,651
公投第８案,嘉義縣,義竹鄉,仁里村,358,886,348,134,482,61,543
公投第８案,嘉義縣,義竹鄉,傳芳村,359,743,207,83,290,44,334
公投第８案,嘉義縣,義竹鄉,頭竹村,360,1236,419,155,574,100,674
公投第８案,嘉義縣,義竹鄉,五厝村,361,377,134,34,168,26,194
公投第８案,嘉義縣,義竹鄉,中平村,362,338,100,29,129,23,152
公投第８案,嘉義縣,義竹鄉,中平村,363,102,45,10,55,4,59
公投第８案,嘉義縣,義竹鄉,埤前村,364,763,240,64,304,23,327
公投第８案,嘉義縣,義竹鄉,平溪村,365,429,152,58,210,29,239
公投第８案,嘉義縣,義竹鄉,後鎮村,366,427,144,38,182,24,206
公投第８案,嘉義縣,義竹鄉,北華村,367,607,205,74,279,50,329
公投第８案,嘉義縣,義竹鄉,新店村,368,1486,458,141,599,60,659
公投第８案,嘉義縣,義竹鄉,東過村,369,835,299,105,404,72,476
公投第８案,嘉義縣,義竹鄉,西過村,370,816,218,66,284,69,353
公投第８案,嘉義縣,義竹鄉,官和村,371,833,229,86,315,66,381
公投第８案,嘉義縣,義竹鄉,官順村,372,433,145,50,195,16,211
公投第８案,嘉義縣,義竹鄉,新富村,373,558,187,44,231,7,238
公投第８案,嘉義縣,義竹鄉,東光村,374,602,189,72,261,49,310
公投第８案,嘉義縣,義竹鄉,東光村,375,140,36,13,49,2,51
公投第８案,嘉義縣,義竹鄉,東榮村,376,393,110,39,149,26,175
公投第８案,嘉義縣,義竹鄉,龍蛟村,377,585,194,62,256,28,284
公投第８案,嘉義縣,義竹鄉,溪洲村,378,526,119,32,151,8,159
公投第８案,嘉義縣,義竹鄉,溪洲村,379,123,35,20,55,12,67
公投第８案,嘉義縣,中埔鄉,富收村,380,1046,294,94,388,16,404
公投第８案,嘉義縣,中埔鄉,富收村,381,1788,540,199,739,98,837
公投第８案,嘉義縣,中埔鄉,和睦村,382,1730,495,209,704,61,765
公投第８案,嘉義縣,中埔鄉,和睦村,383,1581,530,179,709,63,772
公投第８案,嘉義縣,中埔鄉,和美村,384,1594,486,150,636,45,681
公投第８案,嘉義縣,中埔鄉,和美村,385,1801,619,207,826,55,881
公投第８案,嘉義縣,中埔鄉,和美村,386,1862,639,191,830,81,911
公投第８案,嘉義縣,中埔鄉,和美村,387,1803,548,183,731,39,770
公投第８案,嘉義縣,中埔鄉,和興村,388,1481,541,162,703,65,768
公投第８案,嘉義縣,中埔鄉,和興村,389,1366,502,143,645,75,720
公投第８案,嘉義縣,中埔鄉,和興村,390,1599,441,182,623,87,710
公投第８案,嘉義縣,中埔鄉,和興村,391,1196,388,142,530,50,580
公投第８案,嘉義縣,中埔鄉,中埔村,392,1809,528,192,720,99,819
公投第８案,嘉義縣,中埔鄉,塩舘村,393,953,302,115,417,34,451
公投第８案,嘉義縣,中埔鄉,金蘭村,394,1441,434,160,594,73,667
公投第８案,嘉義縣,中埔鄉,隆興村,395,1882,597,198,795,70,865
公投第８案,嘉義縣,中埔鄉,義仁村,396,1470,355,117,472,28,500
公投第８案,嘉義縣,中埔鄉,社口村,397,1699,514,141,655,95,750
公投第８案,嘉義縣,中埔鄉,社口村,398,422,125,30,155,18,173
公投第８案,嘉義縣,中埔鄉,灣潭村,399,1030,327,118,445,69,514
公投第８案,嘉義縣,中埔鄉,裕民村,400,879,245,97,342,49,391
公投第８案,嘉義縣,中埔鄉,龍門村,401,828,228,76,304,14,318
公投第８案,嘉義縣,中埔鄉,石硦村,402,881,344,95,439,60,499
公投第８案,嘉義縣,中埔鄉,石硦村,403,296,92,39,131,17,148
公投第８案,嘉義縣,中埔鄉,頂埔村,404,979,275,103,378,101,479
公投第８案,嘉義縣,中埔鄉,同仁村,405,1268,356,124,480,42,522
公投第８案,嘉義縣,中埔鄉,同仁村,406,670,132,42,174,14,188
公投第８案,嘉義縣,中埔鄉,深坑村,407,754,271,96,367,64,431
公投第８案,嘉義縣,中埔鄉,三層村,408,648,238,73,311,44,355
公投第８案,嘉義縣,中埔鄉,瑞豐村,409,741,202,60,262,29,291
公投第８案,嘉義縣,中埔鄉,沄水村,410,518,160,42,202,6,208
公投第８案,嘉義縣,中埔鄉,沄水村,411,482,141,64,205,36,241
公投第８案,嘉義縣,中埔鄉,東興村,412,348,98,37,135,8,143
公投第８案,嘉義縣,中埔鄉,中崙村,413,294,105,30,135,14,149
公投第８案,嘉義縣,竹崎鄉,竹崎村,414,1312,455,148,603,38,641
公投第８案,嘉義縣,竹崎鄉,竹崎村,415,1210,470,133,603,19,622
公投第８案,嘉義縣,竹崎鄉,和平村,416,991,389,114,503,50,553
公投第８案,嘉義縣,竹崎鄉,和平村,417,1207,421,126,547,48,595
公投第８案,嘉義縣,竹崎鄉,坑頭村,418,752,200,86,286,16,302
公投第８案,嘉義縣,竹崎鄉,沙坑村,419,833,310,116,426,56,482
公投第８案,嘉義縣,竹崎鄉,獅埜村,420,1220,405,195,600,89,689
公投第８案,嘉義縣,竹崎鄉,義和村,421,616,248,71,319,18,337
公投第８案,嘉義縣,竹崎鄉,義仁村,422,1031,348,115,463,65,528
公投第８案,嘉義縣,竹崎鄉,灣橋村,423,1292,446,137,583,84,667
公投第８案,嘉義縣,竹崎鄉,灣橋村,424,1995,781,237,1018,76,1094
公投第８案,嘉義縣,竹崎鄉,灣橋村,425,1996,664,182,846,29,875
公投第８案,嘉義縣,竹崎鄉,鹿滿村,426,1449,520,159,679,77,756
公投第８案,嘉義縣,竹崎鄉,紫雲村,427,1420,518,146,664,28,692
公投第８案,嘉義縣,竹崎鄉,內埔村,428,1590,559,211,770,63,833
公投第８案,嘉義縣,竹崎鄉,昇平村,429,771,269,85,354,32,386
公投第８案,嘉義縣,竹崎鄉,昇平村,430,1014,296,129,425,56,481
公投第８案,嘉義縣,竹崎鄉,桃源村,431,327,72,25,97,10,107
公投第８案,嘉義縣,竹崎鄉,桃源村,432,687,250,75,325,31,356
公投第８案,嘉義縣,竹崎鄉,白杞村,433,641,193,71,264,27,291
公投第８案,嘉義縣,竹崎鄉,塘興村,434,474,167,44,211,13,224
公投第８案,嘉義縣,竹崎鄉,塘興村,435,383,134,26,160,27,187
公投第８案,嘉義縣,竹崎鄉,義隆村,436,619,243,73,316,57,373
公投第８案,嘉義縣,竹崎鄉,龍山村,437,214,70,22,92,6,98
公投第８案,嘉義縣,竹崎鄉,龍山村,438,1568,515,189,704,112,816
公投第８案,嘉義縣,竹崎鄉,文峯村,439,658,190,54,244,45,289
公投第８案,嘉義縣,竹崎鄉,金獅村,440,434,163,53,216,37,253
公投第８案,嘉義縣,竹崎鄉,復金村,441,917,343,84,427,63,490
公投第８案,嘉義縣,竹崎鄉,復金村,442,981,310,120,430,53,483
公投第８案,嘉義縣,竹崎鄉,緞繻村,443,789,208,83,291,22,313
公投第８案,嘉義縣,竹崎鄉,緞繻村,444,108,23,3,26,2,28
公投第８案,嘉義縣,竹崎鄉,仁壽村,445,235,36,10,46,4,50
公投第８案,嘉義縣,竹崎鄉,中和村,446,331,97,32,129,6,135
公投第８案,嘉義縣,竹崎鄉,中和村,447,450,180,74,254,19,273
公投第８案,嘉義縣,竹崎鄉,光華村,448,462,135,31,166,6,172
公投第８案,嘉義縣,竹崎鄉,光華村,449,251,72,15,87,17,104
公投第８案,嘉義縣,番路鄉,江西村,450,1174,490,137,627,78,705
公投第８案,嘉義縣,番路鄉,內甕村,451,449,196,48,244,13,257
公投第８案,嘉義縣,番路鄉,新福村,452,753,317,83,400,42,442
公投第８案,嘉義縣,番路鄉,新福村,453,551,170,53,223,35,258
公投第８案,嘉義縣,番路鄉,下坑村,454,1791,710,198,908,93,1001
公投第８案,嘉義縣,番路鄉,番路村,455,849,326,141,467,71,538
公投第８案,嘉義縣,番路鄉,民和村,456,866,332,109,441,48,489
公投第８案,嘉義縣,番路鄉,觸口村,457,800,335,67,402,37,439
公投第８案,嘉義縣,番路鄉,觸口村,458,444,155,59,214,36,250
公投第８案,嘉義縣,番路鄉,大湖村,459,635,170,54,224,20,244
公投第８案,嘉義縣,番路鄉,公田村,460,319,96,29,125,18,143
公投第８案,嘉義縣,番路鄉,公田村,461,642,290,51,341,34,375
公投第８案,嘉義縣,番路鄉,公興村,462,509,160,35,195,33,228
公投第８案,嘉義縣,番路鄉,草山村,463,162,61,16,77,0,77
公投第８案,嘉義縣,番路鄉,草山村,464,212,80,22,102,11,113
公投第８案,嘉義縣,大埔鄉,大埔村,465,1468,545,167,712,89,801
公投第８案,嘉義縣,大埔鄉,和平村,466,320,89,13,102,9,111
公投第８案,嘉義縣,大埔鄉,和平村,467,304,118,41,159,9,168
公投第８案,嘉義縣,大埔鄉,永樂村,468,184,65,23,88,5,93
公投第８案,嘉義縣,大埔鄉,永樂村,469,234,108,33,141,13,154
公投第８案,嘉義縣,大埔鄉,茄苳村,470,495,179,44,223,12,235
公投第８案,嘉義縣,大埔鄉,茄苳村,471,199,70,30,100,2,102
公投第８案,嘉義縣,大埔鄉,茄苳村,472,226,58,29,87,14,101
公投第８案,嘉義縣,大埔鄉,西興村,473,569,256,68,324,24,348
公投第８案,嘉義縣,阿里山鄉,中山村,474,371,127,33,160,9,169
公投第８案,嘉義縣,阿里山鄉,中正村,475,197,60,13,73,11,84
公投第８案,嘉義縣,阿里山鄉,香林村,476,152,54,13,67,1,68
公投第８案,嘉義縣,阿里山鄉,十字村,477,231,55,14,69,5,74
公投第８案,嘉義縣,阿里山鄉,十字村,478,72,12,5,17,4,21
公投第８案,嘉義縣,阿里山鄉,豐山村,479,311,97,14,111,3,114
公投第８案,嘉義縣,阿里山鄉,來吉村,480,306,121,26,147,17,164
公投第８案,嘉義縣,阿里山鄉,樂野村,481,970,321,78,399,12,411
公投第８案,嘉義縣,阿里山鄉,達邦村,482,827,340,83,423,31,454
公投第８案,嘉義縣,阿里山鄉,里佳村,483,238,91,21,112,2,114
公投第８案,嘉義縣,阿里山鄉,山美村,484,479,87,21,108,9,117
公投第８案,嘉義縣,阿里山鄉,新美村,485,291,67,20,87,7,94
公投第８案,嘉義縣,阿里山鄉,茶山村,486,246,107,28,135,22,157
公投第８案,屏東縣,屏東市,端正里,1,237,81,39,120,8,128
公投第８案,屏東縣,屏東市,武廟里,2,294,91,43,134,31,165
公投第８案,屏東縣,屏東市,大同里,3,582,185,88,273,24,297
公投第８案,屏東縣,屏東市,光榮里,4,713,277,96,373,24,397
公投第８案,屏東縣,屏東市,民權里,5,572,194,84,278,37,315
公投第８案,屏東縣,屏東市,泰安里,6,455,195,66,261,19,280
公投第８案,屏東縣,屏東市,文明里,7,249,108,32,140,0,140
公投第８案,屏東縣,屏東市,維新里,8,1315,406,134,540,36,576
公投第８案,屏東縣,屏東市,維新里,9,1373,404,170,574,47,621
公投第８案,屏東縣,屏東市,大埔里,10,713,282,102,384,52,436
公投第８案,屏東縣,屏東市,必信里,11,573,233,79,312,52,364
公投第８案,屏東縣,屏東市,崇禮里,12,297,121,56,177,22,199
公投第８案,屏東縣,屏東市,崇智里,13,409,178,85,263,18,281
公投第８案,屏東縣,屏東市,慶春里,14,286,98,45,143,17,160
公投第８案,屏東縣,屏東市,楠樹里,15,421,148,55,203,23,226
公投第８案,屏東縣,屏東市,扶風里,16,569,214,95,309,13,322
公投第８案,屏東縣,屏東市,安樂里,17,459,152,77,229,18,247
公投第８案,屏東縣,屏東市,平和里,18,672,275,113,388,26,414
公投第８案,屏東縣,屏東市,金泉里,19,668,246,123,369,53,422
公投第８案,屏東縣,屏東市,勝豐里,20,411,159,59,218,18,236
公投第８案,屏東縣,屏東市,橋南里,21,768,283,118,401,38,439
公投第８案,屏東縣,屏東市,橋南里,22,786,309,93,402,31,433
公投第８案,屏東縣,屏東市,橋北里,23,890,354,124,478,42,520
公投第８案,屏東縣,屏東市,大連里,24,1353,558,155,713,47,760
公投第８案,屏東縣,屏東市,大連里,25,1386,531,158,689,36,725
公投第８案,屏東縣,屏東市,大連里,26,1413,597,128,725,37,762
公投第８案,屏東縣,屏東市,大連里,27,1272,454,191,645,43,688
公投第８案,屏東縣,屏東市,大連里,28,1287,533,128,661,31,692
公投第８案,屏東縣,屏東市,大連里,29,1311,540,167,707,50,757
公投第８案,屏東縣,屏東市,大連里,30,1285,490,179,669,24,693
公投第８案,屏東縣,屏東市,豐田里,31,1297,519,138,657,62,719
公投第８案,屏東縣,屏東市,豐田里,32,1361,530,155,685,32,717
公投第８案,屏東縣,屏東市,豐田里,33,1381,504,153,657,49,706
公投第８案,屏東縣,屏東市,豐榮里,34,1258,501,187,688,55,743
公投第８案,屏東縣,屏東市,豐榮里,35,1259,468,175,643,65,708
公投第８案,屏東縣,屏東市,豐源里,36,1076,430,103,533,47,580
公投第８案,屏東縣,屏東市,豐源里,37,1162,482,138,620,44,664
公投第８案,屏東縣,屏東市,豐源里,38,1318,554,163,717,31,748
公投第８案,屏東縣,屏東市,長春里,39,939,354,125,479,46,525
公投第８案,屏東縣,屏東市,長春里,40,972,419,107,526,35,561
公投第８案,屏東縣,屏東市,瑞光里,41,1535,625,194,819,44,863
公投第８案,屏東縣,屏東市,瑞光里,42,1419,477,151,628,44,672
公投第８案,屏東縣,屏東市,瑞光里,43,1398,513,118,631,37,668
公投第８案,屏東縣,屏東市,瑞光里,44,1405,525,145,670,63,733
公投第８案,屏東縣,屏東市,瑞光里,45,1486,596,177,773,42,815
公投第８案,屏東縣,屏東市,湖南里,46,1061,391,133,524,67,591
公投第８案,屏東縣,屏東市,湖西里,47,1540,465,166,631,109,740
公投第８案,屏東縣,屏東市,歸心里,48,1141,350,135,485,22,507
公投第８案,屏東縣,屏東市,清溪里,49,1247,442,130,572,40,612
公投第８案,屏東縣,屏東市,清溪里,50,1446,541,148,689,43,732
公投第８案,屏東縣,屏東市,清溪里,51,1303,517,179,696,47,743
公投第８案,屏東縣,屏東市,大武里,52,1253,495,133,628,54,682
公投第８案,屏東縣,屏東市,大武里,53,1315,556,100,656,56,712
公投第８案,屏東縣,屏東市,大武里,54,1425,499,181,680,48,728
公投第８案,屏東縣,屏東市,大武里,55,1423,507,174,681,24,705
公投第８案,屏東縣,屏東市,大武里,56,1400,547,176,723,52,775
公投第８案,屏東縣,屏東市,大武里,57,1359,525,208,733,50,783
公投第８案,屏東縣,屏東市,崇武里,58,1328,581,96,677,38,715
公投第８案,屏東縣,屏東市,崇武里,59,1539,627,147,774,41,815
公投第８案,屏東縣,屏東市,凌雲里,60,391,105,25,130,5,135
公投第８案,屏東縣,屏東市,永昌里,61,200,71,31,102,14,116
公投第８案,屏東縣,屏東市,永順里,62,328,100,35,135,31,166
公投第８案,屏東縣,屏東市,鵬程里,63,231,97,19,116,5,121
公投第８案,屏東縣,屏東市,安鎮里,64,945,332,129,461,61,522
公投第８案,屏東縣,屏東市,安鎮里,65,1053,375,109,484,61,545
公投第８案,屏東縣,屏東市,永光里,66,1043,348,111,459,65,524
公投第８案,屏東縣,屏東市,長安里,67,1061,374,131,505,50,555
公投第８案,屏東縣,屏東市,長安里,68,876,278,130,408,42,450
公投第８案,屏東縣,屏東市,前進里,69,1468,483,175,658,109,767
公投第８案,屏東縣,屏東市,前進里,70,1454,468,172,640,74,714
公投第８案,屏東縣,屏東市,大洲里,71,1205,438,149,587,36,623
公投第８案,屏東縣,屏東市,新興里,72,1284,443,152,595,36,631
公投第８案,屏東縣,屏東市,新興里,73,1219,459,118,577,37,614
公投第８案,屏東縣,屏東市,公館里,74,1544,573,195,768,90,858
公投第８案,屏東縣,屏東市,新生里,75,1485,531,180,711,96,807
公投第８案,屏東縣,屏東市,新生里,76,1387,538,161,699,69,768
公投第８案,屏東縣,屏東市,新生里,77,953,338,107,445,35,480
公投第８案,屏東縣,屏東市,新生里,78,1603,607,214,821,57,878
公投第８案,屏東縣,屏東市,頂宅里,79,535,182,68,250,35,285
公投第８案,屏東縣,屏東市,頂柳里,80,1119,417,115,532,43,575
公投第８案,屏東縣,屏東市,大湖里,81,847,341,87,428,43,471
公投第８案,屏東縣,屏東市,大湖里,82,923,334,135,469,73,542
公投第８案,屏東縣,屏東市,龍華里,83,1227,402,161,563,46,609
公投第８案,屏東縣,屏東市,龍華里,84,1039,387,116,503,61,564
公投第８案,屏東縣,屏東市,玉成里,85,1485,501,174,675,110,785
公投第８案,屏東縣,屏東市,擇仁里,86,867,116,95,211,62,273
公投第８案,屏東縣,屏東市,建國里,87,918,355,130,485,37,522
公投第８案,屏東縣,屏東市,萬年里,88,663,217,77,294,49,343
公投第８案,屏東縣,屏東市,厚生里,89,1215,385,131,516,26,542
公投第８案,屏東縣,屏東市,厚生里,90,1628,524,179,703,87,790
公投第８案,屏東縣,屏東市,一心里,91,1209,503,121,624,46,670
公投第８案,屏東縣,屏東市,義勇里,92,1110,537,134,671,22,693
公投第８案,屏東縣,屏東市,光華里,93,684,219,85,304,19,323
公投第８案,屏東縣,屏東市,永安里,94,1349,417,113,530,32,562
公投第８案,屏東縣,屏東市,永安里,95,1457,493,149,642,68,710
公投第８案,屏東縣,屏東市,永安里,96,1447,557,189,746,51,797
公投第８案,屏東縣,屏東市,永安里,97,1354,468,154,622,37,659
公投第８案,屏東縣,屏東市,永安里,98,1583,609,197,806,76,882
公投第８案,屏東縣,屏東市,崇蘭里,99,1707,673,158,831,24,855
公投第８案,屏東縣,屏東市,崇蘭里,100,1637,598,151,749,31,780
公投第８案,屏東縣,屏東市,崇蘭里,101,1459,522,176,698,10,708
公投第８案,屏東縣,屏東市,崇蘭里,102,1759,723,173,896,48,944
公投第８案,屏東縣,屏東市,崇蘭里,103,1950,772,180,952,48,1000
公投第８案,屏東縣,屏東市,崇蘭里,104,1729,683,176,859,58,917
公投第８案,屏東縣,屏東市,崇蘭里,105,1592,619,132,751,34,785
公投第８案,屏東縣,屏東市,潭墘里,106,1437,543,122,665,54,719
公投第８案,屏東縣,屏東市,潭墘里,107,1204,471,97,568,34,602
公投第８案,屏東縣,屏東市,潭墘里,108,1340,553,130,683,49,732
公投第８案,屏東縣,屏東市,潭墘里,109,1322,522,151,673,44,717
公投第８案,屏東縣,屏東市,潭墘里,110,1462,513,151,664,34,698
公投第８案,屏東縣,屏東市,潭墘里,111,3241,1247,271,1518,54,1572
公投第８案,屏東縣,屏東市,潭墘里,112,1477,563,124,687,31,718
公投第８案,屏東縣,屏東市,永城里,113,821,294,62,356,32,388
公投第８案,屏東縣,屏東市,永城里,114,1099,349,73,422,27,449
公投第８案,屏東縣,屏東市,空翔里,115,1688,682,135,817,53,870
公投第８案,屏東縣,屏東市,廣興里,116,1167,410,124,534,48,582
公投第８案,屏東縣,屏東市,廣興里,117,915,327,105,432,56,488
公投第８案,屏東縣,屏東市,勝利里,118,1683,380,103,483,44,527
公投第８案,屏東縣,屏東市,勝利里,119,1497,683,26,709,23,732
公投第８案,屏東縣,屏東市,勝利里,120,1129,385,143,528,34,562
公投第８案,屏東縣,屏東市,勝利里,121,1232,498,116,614,51,665
公投第８案,屏東縣,屏東市,斯文里,122,853,319,107,426,33,459
公投第８案,屏東縣,屏東市,斯文里,123,869,363,115,478,25,503
公投第８案,屏東縣,屏東市,華山里,124,1169,484,138,622,47,669
公投第８案,屏東縣,屏東市,華山里,125,1058,427,121,548,37,585
公投第８案,屏東縣,屏東市,華山里,126,1344,480,132,612,56,668
公投第８案,屏東縣,屏東市,華山里,127,1299,502,158,660,30,690
公投第８案,屏東縣,屏東市,溝美里,128,1204,400,115,515,50,565
公投第８案,屏東縣,屏東市,溝美里,129,1123,421,119,540,43,583
公投第８案,屏東縣,屏東市,三山里,130,1318,402,134,536,45,581
公投第８案,屏東縣,屏東市,海豐里,131,865,352,103,455,59,514
公投第８案,屏東縣,屏東市,仁義里,132,1100,337,98,435,35,470
公投第８案,屏東縣,屏東市,北興里,133,1215,427,113,540,24,564
公投第８案,屏東縣,屏東市,北興里,134,1370,544,134,678,47,725
公投第８案,屏東縣,屏東市,北興里,135,1240,460,141,601,21,622
公投第８案,屏東縣,屏東市,北興里,136,1168,454,150,604,58,662
公投第８案,屏東縣,屏東市,北興里,137,1079,438,108,546,30,576
公投第８案,屏東縣,屏東市,北勢里,138,1289,535,139,674,63,737
公投第８案,屏東縣,屏東市,北勢里,139,1115,415,128,543,35,578
公投第８案,屏東縣,屏東市,中正里,140,1491,566,211,777,58,835
公投第８案,屏東縣,屏東市,中正里,141,1411,494,139,633,44,677
公投第８案,屏東縣,屏東市,中正里,142,1803,655,195,850,40,890
公投第８案,屏東縣,屏東市,興樂里,143,744,312,83,395,31,426
公投第８案,屏東縣,屏東市,明正里,144,678,247,89,336,29,365
公投第８案,屏東縣,屏東市,太平里,145,681,267,93,360,34,394
公投第８案,屏東縣,屏東市,信和里,146,1535,464,148,612,37,649
公投第８案,屏東縣,屏東市,和興里,147,954,355,123,478,62,540
公投第８案,屏東縣,屏東市,仁愛里,148,1018,433,131,564,51,615
公投第８案,屏東縣,屏東市,仁愛里,149,1154,455,156,611,38,649
公投第８案,屏東縣,潮州鎮,潮州里,150,504,189,67,256,49,305
公投第８案,屏東縣,潮州鎮,光華里,151,1711,574,167,741,63,804
公投第８案,屏東縣,潮州鎮,光華里,152,1634,586,187,773,35,808
公投第８案,屏東縣,潮州鎮,光華里,153,1414,483,117,600,41,641
公投第８案,屏東縣,潮州鎮,同榮里,154,603,212,102,314,62,376
公投第８案,屏東縣,潮州鎮,彭城里,155,896,315,100,415,72,487
公投第８案,屏東縣,潮州鎮,三星里,156,1285,443,152,595,73,668
公投第８案,屏東縣,潮州鎮,三星里,157,1744,629,172,801,70,871
公投第８案,屏東縣,潮州鎮,三星里,158,1071,442,119,561,53,614
公投第８案,屏東縣,潮州鎮,三星里,159,1209,485,149,634,72,706
公投第８案,屏東縣,潮州鎮,三共里,160,1159,433,116,549,55,604
公投第８案,屏東縣,潮州鎮,三共里,161,1296,454,141,595,55,650
公投第８案,屏東縣,潮州鎮,三共里,162,1466,573,157,730,57,787
公投第８案,屏東縣,潮州鎮,三共里,163,1130,420,161,581,64,645
公投第８案,屏東縣,潮州鎮,三共里,164,1439,551,164,715,58,773
公投第８案,屏東縣,潮州鎮,三和里,165,897,358,106,464,58,522
公投第８案,屏東縣,潮州鎮,三和里,166,1225,499,134,633,53,686
公投第８案,屏東縣,潮州鎮,九塊里,167,1158,413,119,532,53,585
公投第８案,屏東縣,潮州鎮,九塊里,168,481,131,49,180,37,217
公投第８案,屏東縣,潮州鎮,新生里,169,972,399,136,535,10,545
公投第８案,屏東縣,潮州鎮,新榮里,170,1245,485,179,664,60,724
公投第８案,屏東縣,潮州鎮,五魁里,171,1415,514,160,674,68,742
公投第８案,屏東縣,潮州鎮,蓬萊里,172,1255,385,126,511,19,530
公投第８案,屏東縣,潮州鎮,蓬萊里,173,1058,285,84,369,39,408
公投第８案,屏東縣,潮州鎮,八爺里,174,1187,424,137,561,51,612
公投第８案,屏東縣,潮州鎮,八爺里,175,1083,420,103,523,73,596
公投第８案,屏東縣,潮州鎮,永春里,176,1590,515,178,693,52,745
公投第８案,屏東縣,潮州鎮,永春里,177,1543,594,178,772,79,851
公投第８案,屏東縣,潮州鎮,永春里,178,1631,568,183,751,56,807
公投第８案,屏東縣,潮州鎮,永春里,179,1159,477,109,586,35,621
公投第８案,屏東縣,潮州鎮,永春里,180,1099,425,148,573,46,619
公投第８案,屏東縣,潮州鎮,富春里,181,1200,411,123,534,55,589
公投第８案,屏東縣,潮州鎮,光春里,182,1391,487,139,626,78,704
公投第８案,屏東縣,潮州鎮,興美里,183,881,348,100,448,61,509
公投第８案,屏東縣,潮州鎮,檨子里,184,454,120,48,168,25,193
公投第８案,屏東縣,潮州鎮,泗林里,185,1658,581,192,773,100,873
公投第８案,屏東縣,潮州鎮,四春里,186,822,251,92,343,39,382
公投第８案,屏東縣,潮州鎮,四春里,187,948,261,102,363,25,388
公投第８案,屏東縣,潮州鎮,崙東里,188,1194,321,118,439,37,476
公投第８案,屏東縣,潮州鎮,崙東里,189,337,119,37,156,35,191
公投第８案,屏東縣,東港鎮,新勝里,190,981,369,148,517,69,586
公投第８案,屏東縣,東港鎮,新勝里,191,1070,403,158,561,70,631
公投第８案,屏東縣,東港鎮,頂新里,192,527,216,76,292,49,341
公投第８案,屏東縣,東港鎮,頂中里,193,395,134,58,192,44,236
公投第８案,屏東縣,東港鎮,東和里,194,659,208,83,291,47,338
公投第８案,屏東縣,東港鎮,興台里,195,513,178,64,242,34,276
公投第８案,屏東縣,東港鎮,興東里,196,1732,614,202,816,64,880
公投第８案,屏東縣,東港鎮,興東里,197,1779,692,193,885,64,949
公投第８案,屏東縣,東港鎮,興東里,198,1270,435,150,585,59,644
公投第８案,屏東縣,東港鎮,興東里,199,1327,458,158,616,78,694
公投第８案,屏東縣,東港鎮,興東里,200,1242,460,154,614,80,694
公投第８案,屏東縣,東港鎮,興東里,201,1607,577,189,766,113,879
公投第８案,屏東縣,東港鎮,興農里,202,1305,433,138,571,45,616
公投第８案,屏東縣,東港鎮,中興里,203,695,254,91,345,46,391
公投第８案,屏東縣,東港鎮,朝安里,204,1076,468,79,547,113,660
公投第８案,屏東縣,東港鎮,朝安里,205,567,173,76,249,39,288
公投第８案,屏東縣,東港鎮,八德里,206,806,268,82,350,48,398
公投第８案,屏東縣,東港鎮,東隆里,207,1227,441,157,598,85,683
公投第８案,屏東縣,東港鎮,豐漁里,208,599,179,79,258,66,324
公投第８案,屏東縣,東港鎮,盛漁里,209,1354,363,134,497,52,549
公投第８案,屏東縣,東港鎮,興漁里,210,734,240,83,323,65,388
公投第８案,屏東縣,東港鎮,興漁里,211,1107,381,120,501,134,635
公投第８案,屏東縣,東港鎮,鎮海里,212,1198,371,113,484,106,590
公投第８案,屏東縣,東港鎮,鎮海里,213,1614,500,169,669,197,866
公投第８案,屏東縣,東港鎮,嘉蓮里,214,826,250,117,367,52,419
公投第８案,屏東縣,東港鎮,嘉蓮里,215,912,337,104,441,75,516
公投第８案,屏東縣,東港鎮,南平里,216,432,119,53,172,51,223
公投第８案,屏東縣,東港鎮,南平里,217,1204,419,131,550,130,680
公投第８案,屏東縣,東港鎮,船頭里,218,1304,471,168,639,79,718
公投第８案,屏東縣,東港鎮,船頭里,219,1317,504,158,662,83,745
公投第８案,屏東縣,東港鎮,船頭里,220,1387,493,166,659,48,707
公投第８案,屏東縣,東港鎮,船頭里,221,1310,426,126,552,43,595
公投第８案,屏東縣,東港鎮,下廍里,222,1228,383,136,519,63,582
公投第８案,屏東縣,東港鎮,下廍里,223,766,210,98,308,65,373
公投第８案,屏東縣,東港鎮,大潭里,224,823,287,114,401,71,472
公投第８案,屏東縣,東港鎮,大潭里,225,755,200,44,244,22,266
公投第８案,屏東縣,東港鎮,興和里,226,1094,383,147,530,91,621
公投第８案,屏東縣,東港鎮,共和里,227,753,275,63,338,31,369
公投第８案,屏東縣,恆春鎮,城南里,228,902,313,92,405,30,435
公投第８案,屏東縣,恆春鎮,城北里,229,969,387,120,507,46,553
公投第８案,屏東縣,恆春鎮,城北里,230,1280,458,117,575,50,625
公投第８案,屏東縣,恆春鎮,城西里,231,1133,431,131,562,43,605
公投第８案,屏東縣,恆春鎮,網紗里,232,1552,492,112,604,14,618
公投第８案,屏東縣,恆春鎮,網紗里,233,1485,443,114,557,63,620
公投第８案,屏東縣,恆春鎮,仁壽里,234,896,339,104,443,38,481
公投第８案,屏東縣,恆春鎮,茄湖里,235,531,161,54,215,30,245
公投第８案,屏東縣,恆春鎮,頭溝里,236,478,142,58,200,9,209
公投第８案,屏東縣,恆春鎮,四溝里,237,1020,332,112,444,45,489
公投第８案,屏東縣,恆春鎮,德和里,238,924,293,113,406,27,433
公投第８案,屏東縣,恆春鎮,龍水里,239,1079,324,101,425,25,450
公投第８案,屏東縣,恆春鎮,山海里,240,775,198,54,252,25,277
公投第８案,屏東縣,恆春鎮,山海里,241,813,311,75,386,51,437
公投第８案,屏東縣,恆春鎮,大光里,242,1104,367,103,470,50,520
公投第８案,屏東縣,恆春鎮,大光里,243,1110,311,126,437,60,497
公投第８案,屏東縣,恆春鎮,水泉里,244,692,163,67,230,67,297
公投第８案,屏東縣,恆春鎮,水泉里,245,708,185,41,226,10,236
公投第８案,屏東縣,恆春鎮,山腳里,246,1505,502,154,656,44,700
公投第８案,屏東縣,恆春鎮,山腳里,247,1111,353,99,452,61,513
公投第８案,屏東縣,恆春鎮,山腳里,248,1543,512,144,656,48,704
公投第８案,屏東縣,恆春鎮,南灣里,249,828,220,79,299,19,318
公投第８案,屏東縣,恆春鎮,南灣里,250,844,307,102,409,30,439
公投第８案,屏東縣,恆春鎮,墾丁里,251,1253,422,129,551,52,603
公投第８案,屏東縣,恆春鎮,鵝鑾里,252,1126,379,89,468,45,513
公投第８案,屏東縣,萬丹鄉,香社村,253,1527,425,148,573,71,644
公投第８案,屏東縣,萬丹鄉,新庄村,254,1147,374,110,484,79,563
公投第８案,屏東縣,萬丹鄉,新庄村,255,949,286,112,398,47,445
公投第８案,屏東縣,萬丹鄉,新鐘村,256,990,329,111,440,36,476
公投第８案,屏東縣,萬丹鄉,新鐘村,257,1022,305,95,400,17,417
公投第８案,屏東縣,萬丹鄉,水仙村,258,545,231,72,303,64,367
公投第８案,屏東縣,萬丹鄉,興全村,259,1159,425,154,579,101,680
公投第８案,屏東縣,萬丹鄉,興安村,260,837,292,123,415,81,496
公投第８案,屏東縣,萬丹鄉,甘棠村,261,392,138,42,180,16,196
公投第８案,屏東縣,萬丹鄉,萬惠村,262,847,327,112,439,45,484
公投第８案,屏東縣,萬丹鄉,萬全村,263,1149,400,118,518,62,580
公投第８案,屏東縣,萬丹鄉,萬全村,264,1131,420,129,549,57,606
公投第８案,屏東縣,萬丹鄉,萬全村,265,1178,399,154,553,54,607
公投第８案,屏東縣,萬丹鄉,萬後村,266,711,331,54,385,39,424
公投第８案,屏東縣,萬丹鄉,萬安村,267,595,219,88,307,36,343
公投第８案,屏東縣,萬丹鄉,萬生村,268,1403,561,176,737,65,802
公投第８案,屏東縣,萬丹鄉,寶厝村,269,1094,398,98,496,37,533
公投第８案,屏東縣,萬丹鄉,寶厝村,270,1158,436,145,581,50,631
公投第８案,屏東縣,萬丹鄉,四維村,271,963,380,148,528,66,594
公投第８案,屏東縣,萬丹鄉,四維村,272,1062,359,135,494,54,548
公投第８案,屏東縣,萬丹鄉,竹林村,273,1684,563,212,775,91,866
公投第８案,屏東縣,萬丹鄉,水泉村,274,1702,559,183,742,49,791
公投第８案,屏東縣,萬丹鄉,田厝村,275,976,316,128,444,63,507
公投第８案,屏東縣,萬丹鄉,崙頂村,276,1013,340,142,482,75,557
公投第８案,屏東縣,萬丹鄉,崙頂村,277,847,232,115,347,35,382
公投第８案,屏東縣,萬丹鄉,厦北村,278,1570,432,326,758,154,912
公投第８案,屏東縣,萬丹鄉,厦南村,279,1411,404,225,629,61,690
公投第８案,屏東縣,萬丹鄉,後村村,280,1046,379,123,502,98,600
公投第８案,屏東縣,萬丹鄉,灣內村,281,1385,432,144,576,53,629
公投第８案,屏東縣,萬丹鄉,上村村,282,804,265,108,373,72,445
公投第８案,屏東縣,萬丹鄉,加興村,283,1284,444,157,601,94,695
公投第８案,屏東縣,萬丹鄉,社口村,284,1430,478,162,640,59,699
公投第８案,屏東縣,萬丹鄉,磚寮村,285,960,388,137,525,72,597
公投第８案,屏東縣,萬丹鄉,社皮村,286,786,306,106,412,64,476
公投第８案,屏東縣,萬丹鄉,社皮村,287,1158,485,81,566,84,650
公投第８案,屏東縣,萬丹鄉,社中村,288,1647,460,171,631,71,702
公投第８案,屏東縣,萬丹鄉,社上村,289,1666,533,153,686,86,772
公投第８案,屏東縣,萬丹鄉,廣安村,290,1023,396,145,541,81,622
公投第８案,屏東縣,萬丹鄉,廣安村,291,1227,473,169,642,72,714
公投第８案,屏東縣,長治鄉,進興村,292,1018,356,134,490,75,565
公投第８案,屏東縣,長治鄉,進興村,293,1614,598,195,793,85,878
公投第８案,屏東縣,長治鄉,新潭村,294,1848,753,195,948,106,1054
公投第８案,屏東縣,長治鄉,新潭村,295,1707,631,201,832,81,913
公投第８案,屏東縣,長治鄉,潭頭村,296,972,399,121,520,30,550
公投第８案,屏東縣,長治鄉,潭頭村,297,989,365,136,501,66,567
公投第８案,屏東縣,長治鄉,香楊村,298,735,287,103,390,55,445
公投第８案,屏東縣,長治鄉,香楊村,299,1813,589,226,815,79,894
公投第８案,屏東縣,長治鄉,長興村,300,1073,467,130,597,51,648
公投第８案,屏東縣,長治鄉,崙上村,301,1654,597,200,797,81,878
公投第８案,屏東縣,長治鄉,德榮村,302,1205,435,165,600,77,677
公投第８案,屏東縣,長治鄉,德和村,303,758,291,89,380,51,431
公投第８案,屏東縣,長治鄉,復興村,304,1492,483,206,689,112,801
公投第８案,屏東縣,長治鄉,德成村,305,884,342,94,436,62,498
公投第８案,屏東縣,長治鄉,德協村,306,1090,421,124,545,70,615
公投第８案,屏東縣,長治鄉,繁榮村,307,1422,433,140,573,110,683
公投第８案,屏東縣,長治鄉,繁昌村,308,845,282,112,394,68,462
公投第８案,屏東縣,長治鄉,繁昌村,309,925,304,126,430,110,540
公投第８案,屏東縣,長治鄉,繁隆村,310,1138,387,114,501,113,614
公投第８案,屏東縣,長治鄉,繁華村,311,1242,399,178,577,117,694
公投第８案,屏東縣,長治鄉,繁華村,312,1159,333,104,437,29,466
公投第８案,屏東縣,長治鄉,榮華村,313,673,281,81,362,39,401
公投第８案,屏東縣,麟洛鄉,新田村,314,788,298,101,399,46,445
公投第８案,屏東縣,麟洛鄉,新田村,315,1386,589,177,766,27,793
公投第８案,屏東縣,麟洛鄉,麟頂村,316,957,411,127,538,42,580
公投第８案,屏東縣,麟洛鄉,麟蹄村,317,731,288,102,390,54,444
公投第８案,屏東縣,麟洛鄉,麟蹄村,318,806,327,114,441,63,504
公投第８案,屏東縣,麟洛鄉,麟趾村,319,1207,383,142,525,27,552
公投第８案,屏東縣,麟洛鄉,麟趾村,320,1340,548,176,724,85,809
公投第８案,屏東縣,麟洛鄉,田中村,321,1221,455,176,631,73,704
公投第８案,屏東縣,麟洛鄉,田心村,322,851,305,104,409,16,425
公投第８案,屏東縣,麟洛鄉,田道村,323,683,234,70,304,18,322
公投第８案,屏東縣,九如鄉,九清村,324,1491,528,204,732,105,837
公投第８案,屏東縣,九如鄉,九塊村,325,1375,467,183,650,81,731
公投第８案,屏東縣,九如鄉,九明村,326,1678,558,173,731,57,788
公投第８案,屏東縣,九如鄉,大坵村,327,1166,434,156,590,89,679
公投第８案,屏東縣,九如鄉,玉水村,328,1276,352,144,496,56,552
公投第８案,屏東縣,九如鄉,玉泉村,329,1033,379,127,506,72,578
公投第８案,屏東縣,九如鄉,玉泉村,330,577,273,89,362,35,397
公投第８案,屏東縣,九如鄉,東寧村,331,649,255,75,330,70,400
公投第８案,屏東縣,九如鄉,東寧村,332,1999,682,250,932,156,1088
公投第８案,屏東縣,九如鄉,東寧村,333,1766,628,204,832,88,920
公投第８案,屏東縣,九如鄉,三塊村,334,1600,505,197,702,125,827
公投第８案,屏東縣,九如鄉,耆老村,335,1248,425,162,587,93,680
公投第８案,屏東縣,九如鄉,後庄村,336,1792,570,262,832,208,1040
公投第８案,屏東縣,九如鄉,洽興村,337,1482,545,143,688,122,810
公投第８案,屏東縣,里港鄉,玉田村,338,1552,618,201,819,97,916
公投第８案,屏東縣,里港鄉,玉田村,339,1480,501,190,691,97,788
公投第８案,屏東縣,里港鄉,塔樓村,340,1534,428,187,615,62,677
公投第８案,屏東縣,里港鄉,潮厝村,341,1578,537,183,720,130,850
公投第８案,屏東縣,里港鄉,大平村,342,1127,429,168,597,69,666
公投第８案,屏東縣,里港鄉,永春村,343,845,328,108,436,60,496
公投第８案,屏東縣,里港鄉,春林村,344,1282,439,155,594,75,669
公投第８案,屏東縣,里港鄉,過江村,345,981,372,128,500,68,568
公投第８案,屏東縣,里港鄉,過江村,346,1031,381,128,509,86,595
公投第８案,屏東縣,里港鄉,鐵店村,347,1423,488,196,684,114,798
公投第８案,屏東縣,里港鄉,茄苳村,348,363,95,38,133,33,166
公投第８案,屏東縣,里港鄉,茄苳村,349,1203,408,156,564,133,697
公投第８案,屏東縣,里港鄉,載興村,350,1027,381,164,545,87,632
公投第８案,屏東縣,里港鄉,載興村,351,1384,431,154,585,66,651
公投第８案,屏東縣,里港鄉,土庫村,352,1512,531,169,700,94,794
公投第８案,屏東縣,里港鄉,土庫村,353,522,244,45,289,19,308
公投第８案,屏東縣,里港鄉,三廍村,354,822,283,106,389,70,459
公投第８案,屏東縣,里港鄉,三廍村,355,1007,305,123,428,99,527
公投第８案,屏東縣,里港鄉,中和村,356,956,316,135,451,86,537
公投第８案,屏東縣,里港鄉,瀰力村,357,499,186,65,251,31,282
公投第８案,屏東縣,鹽埔鄉,鹽北村,358,951,334,102,436,40,476
公投第８案,屏東縣,鹽埔鄉,鹽北村,359,899,288,99,387,35,422
公投第８案,屏東縣,鹽埔鄉,鹽中村,360,1116,327,102,429,36,465
公投第８案,屏東縣,鹽埔鄉,鹽中村,361,1241,424,140,564,57,621
公投第８案,屏東縣,鹽埔鄉,鹽南村,362,770,239,86,325,62,387
公投第８案,屏東縣,鹽埔鄉,鹽南村,363,962,351,95,446,56,502
公投第８案,屏東縣,鹽埔鄉,仕絨村,364,1041,402,151,553,74,627
公投第８案,屏東縣,鹽埔鄉,高朗村,365,1367,456,163,619,87,706
公投第８案,屏東縣,鹽埔鄉,高朗村,366,1465,459,127,586,67,653
公投第８案,屏東縣,鹽埔鄉,振興村,367,894,268,100,368,54,422
公投第８案,屏東縣,鹽埔鄉,振興村,368,958,308,80,388,6,394
公投第８案,屏東縣,鹽埔鄉,久愛村,369,924,309,94,403,91,494
公投第８案,屏東縣,鹽埔鄉,新圍村,370,1598,487,144,631,48,679
公投第８案,屏東縣,鹽埔鄉,新圍村,371,1550,483,213,696,133,829
公投第８案,屏東縣,鹽埔鄉,新二村,372,1127,403,117,520,81,601
公投第８案,屏東縣,鹽埔鄉,新二村,373,1150,440,132,572,96,668
公投第８案,屏東縣,鹽埔鄉,新二村,374,1233,432,166,598,75,673
公投第８案,屏東縣,鹽埔鄉,彭厝村,375,984,385,114,499,92,591
公投第８案,屏東縣,鹽埔鄉,洛陽村,376,1619,564,224,788,65,853
公投第８案,屏東縣,鹽埔鄉,永隆村,377,553,201,65,266,39,305
公投第８案,屏東縣,高樹鄉,高樹村,378,883,314,140,454,91,545
公投第８案,屏東縣,高樹鄉,高樹村,379,1255,296,132,428,27,455
公投第８案,屏東縣,高樹鄉,長榮村,380,1278,417,141,558,26,584
公投第８案,屏東縣,高樹鄉,東興村,381,738,207,80,287,27,314
公投第８案,屏東縣,高樹鄉,東振村,382,585,154,79,233,14,247
公投第８案,屏東縣,高樹鄉,源泉村,383,1012,323,137,460,135,595
公投第８案,屏東縣,高樹鄉,建興村,384,1148,347,125,472,90,562
公投第８案,屏東縣,高樹鄉,大埔村,385,591,172,83,255,35,290
公投第８案,屏東縣,高樹鄉,菜寮村,386,786,218,89,307,47,354
公投第８案,屏東縣,高樹鄉,司馬村,387,649,172,68,240,22,262
公投第８案,屏東縣,高樹鄉,舊寮村,388,1229,297,119,416,82,498
公投第８案,屏東縣,高樹鄉,新豐村,389,1446,385,131,516,65,581
公投第８案,屏東縣,高樹鄉,泰山村,390,899,219,104,323,19,342
公投第８案,屏東縣,高樹鄉,泰山村,391,922,303,113,416,55,471
公投第８案,屏東縣,高樹鄉,南華村,392,1259,374,132,506,83,589
公投第８案,屏東縣,高樹鄉,廣福村,393,1056,262,85,347,34,381
公投第８案,屏東縣,高樹鄉,廣興村,394,1116,394,139,533,72,605
公投第８案,屏東縣,高樹鄉,舊庄村,395,1020,325,143,468,91,559
公投第８案,屏東縣,高樹鄉,田子村,396,1055,348,129,477,96,573
公投第８案,屏東縣,高樹鄉,鹽樹村,397,738,276,92,368,52,420
公投第８案,屏東縣,高樹鄉,鹽樹村,398,493,146,45,191,29,220
公投第８案,屏東縣,高樹鄉,新南村,399,1539,533,207,740,116,856
公投第８案,屏東縣,萬巒鄉,萬巒村,400,1239,375,165,540,40,580
公投第８案,屏東縣,萬巒鄉,萬全村,401,759,258,105,363,61,424
公投第８案,屏東縣,萬巒鄉,萬和村,402,932,346,110,456,96,552
公投第８案,屏東縣,萬巒鄉,萬和村,403,769,283,111,394,69,463
公投第８案,屏東縣,萬巒鄉,鹿寮村,404,920,326,96,422,83,505
公投第８案,屏東縣,萬巒鄉,硫黃村,405,560,209,76,285,37,322
公投第８案,屏東縣,萬巒鄉,泗溝村,406,1120,365,107,472,24,496
公投第８案,屏東縣,萬巒鄉,五溝村,407,1048,328,112,440,41,481
公投第８案,屏東縣,萬巒鄉,成德村,408,1438,422,141,563,52,615
公投第８案,屏東縣,萬巒鄉,赤山村,409,834,242,106,348,67,415
公投第８案,屏東縣,萬巒鄉,赤山村,410,813,258,94,352,71,423
公投第８案,屏東縣,萬巒鄉,萬金村,411,1020,296,81,377,81,458
公投第８案,屏東縣,萬巒鄉,萬金村,412,1007,342,153,495,77,572
公投第８案,屏東縣,萬巒鄉,佳佐村,413,1648,417,205,622,107,729
公投第８案,屏東縣,萬巒鄉,佳和村,414,1437,470,173,643,73,716
公投第８案,屏東縣,萬巒鄉,新厝村,415,1228,340,133,473,25,498
公投第８案,屏東縣,萬巒鄉,新置村,416,597,241,60,301,58,359
公投第８案,屏東縣,萬巒鄉,新置村,417,576,179,77,256,58,314
公投第８案,屏東縣,內埔鄉,內埔村,418,1305,412,140,552,47,599
公投第８案,屏東縣,內埔鄉,內埔村,419,1287,405,117,522,47,569
公投第８案,屏東縣,內埔鄉,內埔村,420,1387,466,130,596,24,620
公投第８案,屏東縣,內埔鄉,內田村,421,1540,477,166,643,67,710
公投第８案,屏東縣,內埔鄉,內田村,422,1605,511,189,700,61,761
公投第８案,屏東縣,內埔鄉,興南村,423,1326,432,145,577,71,648
公投第８案,屏東縣,內埔鄉,義亭村,424,591,201,80,281,53,334
公投第８案,屏東縣,內埔鄉,美和村,425,1123,367,108,475,52,527
公投第８案,屏東縣,內埔鄉,美和村,426,1079,381,101,482,25,507
公投第８案,屏東縣,內埔鄉,和興村,427,1485,534,166,700,68,768
公投第８案,屏東縣,內埔鄉,和興村,428,1248,501,141,642,54,696
公投第８案,屏東縣,內埔鄉,東寧村,429,1569,568,145,713,56,769
公投第８案,屏東縣,內埔鄉,東寧村,430,1493,472,163,635,77,712
公投第８案,屏東縣,內埔鄉,東寧村,431,1420,456,140,596,18,614
公投第８案,屏東縣,內埔鄉,豐田村,432,1334,454,149,603,89,692
公投第８案,屏東縣,內埔鄉,豐田村,433,1519,498,155,653,84,737
公投第８案,屏東縣,內埔鄉,振豐村,434,784,276,91,367,53,420
公投第８案,屏東縣,內埔鄉,振豐村,435,888,332,101,433,69,502
公投第８案,屏東縣,內埔鄉,富田村,436,747,170,63,233,21,254
公投第８案,屏東縣,內埔鄉,富田村,437,1168,320,104,424,30,454
公投第８案,屏東縣,內埔鄉,竹圍村,438,546,188,83,271,41,312
公投第８案,屏東縣,內埔鄉,竹圍村,439,1278,415,57,472,69,541
公投第８案,屏東縣,內埔鄉,東勢村,440,1348,278,227,505,76,581
公投第８案,屏東縣,內埔鄉,東勢村,441,1550,423,136,559,84,643
公投第８案,屏東縣,內埔鄉,東片村,442,947,356,132,488,85,573
公投第８案,屏東縣,內埔鄉,上樹村,443,1097,349,122,471,89,560
公投第８案,屏東縣,內埔鄉,老埤村,444,1128,303,111,414,61,475
公投第８案,屏東縣,內埔鄉,老埤村,445,1253,267,106,373,31,404
公投第８案,屏東縣,內埔鄉,中林村,446,1525,365,141,506,36,542
公投第８案,屏東縣,內埔鄉,龍泉村,447,1215,419,118,537,95,632
公投第８案,屏東縣,內埔鄉,龍泉村,448,1216,353,109,462,26,488
公投第８案,屏東縣,內埔鄉,龍潭村,449,1353,440,111,551,35,586
公投第８案,屏東縣,內埔鄉,龍潭村,450,1026,351,93,444,44,488
公投第８案,屏東縣,內埔鄉,建興村,451,862,259,87,346,32,378
公投第８案,屏東縣,內埔鄉,大新村,452,921,218,96,314,38,352
公投第８案,屏東縣,內埔鄉,大新村,453,854,295,80,375,27,402
公投第８案,屏東縣,內埔鄉,黎明村,454,1230,369,113,482,41,523
公投第８案,屏東縣,內埔鄉,黎明村,455,1204,337,100,437,32,469
公投第８案,屏東縣,內埔鄉,隘寮村,456,1301,358,124,482,50,532
公投第８案,屏東縣,內埔鄉,水門村,457,806,314,76,390,53,443
公投第８案,屏東縣,竹田鄉,竹田村,458,1503,547,192,739,96,835
公投第８案,屏東縣,竹田鄉,竹南村,459,899,386,125,511,50,561
公投第８案,屏東縣,竹田鄉,糶糴村,460,716,305,94,399,51,450
公投第８案,屏東縣,竹田鄉,履豐村,461,581,238,95,333,49,382
公投第８案,屏東縣,竹田鄉,頭崙村,462,1327,477,161,638,102,740
公投第８案,屏東縣,竹田鄉,二崙村,463,997,360,175,535,85,620
公投第８案,屏東縣,竹田鄉,美崙村,464,649,236,72,308,33,341
公投第８案,屏東縣,竹田鄉,南勢村,465,476,246,73,319,27,346
公投第８案,屏東縣,竹田鄉,西勢村,466,1259,503,167,670,69,739
公投第８案,屏東縣,竹田鄉,西勢村,467,1227,427,142,569,72,641
公投第８案,屏東縣,竹田鄉,福田村,468,504,194,89,283,39,322
公投第８案,屏東縣,竹田鄉,永豐村,469,860,321,88,409,52,461
公投第８案,屏東縣,竹田鄉,六巷村,470,800,280,104,384,23,407
公投第８案,屏東縣,竹田鄉,泗洲村,471,1134,419,165,584,69,653
公投第８案,屏東縣,竹田鄉,大湖村,472,1229,421,170,591,72,663
公投第８案,屏東縣,竹田鄉,鳳明村,473,1192,417,134,551,73,624
公投第８案,屏東縣,新埤鄉,新埤村,474,1712,524,200,724,49,773
公投第８案,屏東縣,新埤鄉,新埤村,475,314,102,37,139,34,173
公投第８案,屏東縣,新埤鄉,建功村,476,752,259,103,362,44,406
公投第８案,屏東縣,新埤鄉,建功村,477,334,121,35,156,27,183
公投第８案,屏東縣,新埤鄉,打鐵村,478,957,353,66,419,68,487
公投第８案,屏東縣,新埤鄉,南豐村,479,764,280,102,382,71,453
公投第８案,屏東縣,新埤鄉,萬隆村,480,373,119,60,179,34,213
公投第８案,屏東縣,新埤鄉,萬隆村,481,678,200,80,280,34,314
公投第８案,屏東縣,新埤鄉,萬隆村,482,701,208,71,279,32,311
公投第８案,屏東縣,新埤鄉,餉潭村,483,1323,337,121,458,77,535
公投第８案,屏東縣,新埤鄉,箕湖村,484,541,195,71,266,43,309
公投第８案,屏東縣,新埤鄉,箕湖村,485,584,182,44,226,35,261
公投第８案,屏東縣,枋寮鄉,枋寮村,486,1213,449,138,587,84,671
公投第８案,屏東縣,枋寮鄉,新龍村,487,891,319,121,440,72,512
公投第８案,屏東縣,枋寮鄉,保生村,488,970,299,102,401,94,495
公投第８案,屏東縣,枋寮鄉,中寮村,489,629,237,60,297,37,334
公投第８案,屏東縣,枋寮鄉,安樂村,490,840,322,105,427,47,474
公投第８案,屏東縣,枋寮鄉,安樂村,491,774,306,88,394,43,437
公投第８案,屏東縣,枋寮鄉,隆山村,492,1379,447,171,618,88,706
公投第８案,屏東縣,枋寮鄉,隆山村,493,1502,578,160,738,70,808
公投第８案,屏東縣,枋寮鄉,隆山村,494,1276,419,137,556,98,654
公投第８案,屏東縣,枋寮鄉,天時村,495,964,327,115,442,74,516
公投第８案,屏東縣,枋寮鄉,天時村,496,1005,385,123,508,96,604
公投第８案,屏東縣,枋寮鄉,地利村,497,734,238,65,303,25,328
公投第８案,屏東縣,枋寮鄉,地利村,498,725,262,80,342,66,408
公投第８案,屏東縣,枋寮鄉,人和村,499,1046,310,125,435,76,511
公投第８案,屏東縣,枋寮鄉,人和村,500,1067,406,126,532,82,614
公投第８案,屏東縣,枋寮鄉,內寮村,501,718,145,63,208,69,277
公投第８案,屏東縣,枋寮鄉,新開村,502,903,278,93,371,53,424
公投第８案,屏東縣,枋寮鄉,東海村,503,1387,431,169,600,89,689
公投第８案,屏東縣,枋寮鄉,東海村,504,1367,474,180,654,86,740
公投第８案,屏東縣,枋寮鄉,大庄村,505,618,236,98,334,51,385
公投第８案,屏東縣,枋寮鄉,太源村,506,959,265,85,350,40,390
公投第８案,屏東縣,枋寮鄉,玉泉村,507,427,159,47,206,29,235
公投第８案,屏東縣,新園鄉,瓦磘村,508,820,294,124,418,54,472
公投第８案,屏東縣,新園鄉,瓦磘村,509,843,353,92,445,60,505
公投第８案,屏東縣,新園鄉,仙吉村,510,1242,443,134,577,66,643
公投第８案,屏東縣,新園鄉,仙吉村,511,1290,519,157,676,64,740
公投第８案,屏東縣,新園鄉,田洋村,512,1073,383,127,510,52,562
公投第８案,屏東縣,新園鄉,田洋村,513,1088,375,149,524,104,628
公投第８案,屏東縣,新園鄉,港墘村,514,845,288,85,373,48,421
公投第８案,屏東縣,新園鄉,內庄村,515,862,297,113,410,14,424
公投第８案,屏東縣,新園鄉,新東村,516,1183,361,155,516,82,598
公投第８案,屏東縣,新園鄉,新東村,517,1109,421,94,515,95,610
公投第８案,屏東縣,新園鄉,新園村,518,1119,357,106,463,17,480
公投第８案,屏東縣,新園鄉,新園村,519,1152,378,140,518,47,565
公投第８案,屏東縣,新園鄉,港西村,520,1030,377,130,507,61,568
公投第８案,屏東縣,新園鄉,港西村,521,1104,364,115,479,110,589
公投第８案,屏東縣,新園鄉,烏龍村,522,1240,361,130,491,0,491
公投第８案,屏東縣,新園鄉,興龍村,523,1120,268,122,390,31,421
公投第８案,屏東縣,新園鄉,興龍村,524,1074,397,145,542,82,624
公投第８案,屏東縣,新園鄉,中洲村,525,849,258,87,345,52,397
公投第８案,屏東縣,新園鄉,中洲村,526,749,227,118,345,67,412
公投第８案,屏東縣,新園鄉,南龍村,527,1416,449,174,623,92,715
公投第８案,屏東縣,新園鄉,五房村,528,895,303,103,406,74,480
公投第８案,屏東縣,新園鄉,五房村,529,933,336,113,449,71,520
公投第８案,屏東縣,新園鄉,五房村,530,972,336,115,451,60,511
公投第８案,屏東縣,新園鄉,鹽埔村,531,1454,372,135,507,95,602
公投第８案,屏東縣,新園鄉,鹽埔村,532,1653,588,208,796,169,965
公投第８案,屏東縣,新園鄉,鹽埔村,533,1270,394,120,514,122,636
公投第８案,屏東縣,新園鄉,共和村,534,1123,419,150,569,157,726
公投第８案,屏東縣,新園鄉,共和村,535,1198,351,136,487,126,613
公投第８案,屏東縣,崁頂鄉,崁頂村,536,1190,418,101,519,47,566
公投第８案,屏東縣,崁頂鄉,崁頂村,537,1044,387,123,510,69,579
公投第８案,屏東縣,崁頂鄉,園寮村,538,818,286,113,399,52,451
公投第８案,屏東縣,崁頂鄉,園寮村,539,1214,423,139,562,61,623
公投第８案,屏東縣,崁頂鄉,力社村,540,1325,425,129,554,43,597
公投第８案,屏東縣,崁頂鄉,圍內村,541,1253,495,134,629,69,698
公投第８案,屏東縣,崁頂鄉,洲子村,542,1039,358,114,472,56,528
公投第８案,屏東縣,崁頂鄉,北勢村,543,813,242,88,330,54,384
公投第８案,屏東縣,崁頂鄉,北勢村,544,736,229,71,300,30,330
公投第８案,屏東縣,崁頂鄉,越溪村,545,934,329,145,474,48,522
公投第８案,屏東縣,崁頂鄉,港東村,546,900,279,129,408,63,471
公投第８案,屏東縣,崁頂鄉,港東村,547,1004,356,114,470,57,527
公投第８案,屏東縣,林邊鄉,林邊村,548,1458,561,189,750,122,872
公投第８案,屏東縣,林邊鄉,光林村,549,891,336,110,446,59,505
公投第８案,屏東縣,林邊鄉,光林村,550,695,293,75,368,48,416
公投第８案,屏東縣,林邊鄉,永樂村,551,1015,375,148,523,80,603
公投第８案,屏東縣,林邊鄉,永樂村,552,1171,470,142,612,60,672
公投第８案,屏東縣,林邊鄉,永樂村,553,1003,354,109,463,60,523
公投第８案,屏東縣,林邊鄉,中林村,554,725,287,124,411,48,459
公投第８案,屏東縣,林邊鄉,仁和村,555,841,282,123,405,85,490
公投第８案,屏東縣,林邊鄉,仁和村,556,793,304,102,406,65,471
公投第８案,屏東縣,林邊鄉,田厝村,557,919,378,103,481,64,545
公投第８案,屏東縣,林邊鄉,崎峯村,558,1283,424,143,567,73,640
公投第８案,屏東縣,林邊鄉,水利村,559,783,214,101,315,55,370
公投第８案,屏東縣,林邊鄉,水利村,560,1033,305,76,381,63,444
公投第８案,屏東縣,林邊鄉,竹林村,561,1186,387,139,526,109,635
公投第８案,屏東縣,林邊鄉,竹林村,562,773,241,101,342,78,420
公投第８案,屏東縣,林邊鄉,鎮安村,563,1122,342,123,465,39,504
公投第８案,屏東縣,南州鄉,溪洲村,564,872,306,76,382,54,436
公投第８案,屏東縣,南州鄉,溪洲村,565,794,288,93,381,54,435
公投第８案,屏東縣,南州鄉,溪南村,566,962,361,134,495,61,556
公投第８案,屏東縣,南州鄉,七塊村,567,1033,369,128,497,72,569
公投第８案,屏東縣,南州鄉,萬華村,568,1007,329,128,457,59,516
公投第８案,屏東縣,南州鄉,仁里村,569,466,177,70,247,25,272
公投第８案,屏東縣,南州鄉,溪北村,570,708,291,80,371,43,414
公投第８案,屏東縣,南州鄉,米崙村,571,1044,383,135,518,73,591
公投第８案,屏東縣,南州鄉,壽元村,572,1071,300,86,386,42,428
公投第８案,屏東縣,南州鄉,同安村,573,979,294,113,407,35,442
公投第８案,屏東縣,南州鄉,南安村,574,543,181,55,236,37,273
公投第８案,屏東縣,佳冬鄉,佳冬村,575,1472,460,151,611,76,687
公投第８案,屏東縣,佳冬鄉,六根村,576,1360,383,122,505,86,591
公投第８案,屏東縣,佳冬鄉,賴家村,577,804,274,114,388,74,462
公投第８案,屏東縣,佳冬鄉,萬建村,578,925,294,112,406,80,486
公投第８案,屏東縣,佳冬鄉,萬建村,579,855,242,97,339,24,363
公投第８案,屏東縣,佳冬鄉,石光村,580,981,320,99,419,41,460
公投第８案,屏東縣,佳冬鄉,石光村,581,1007,321,105,426,69,495
公投第８案,屏東縣,佳冬鄉,玉光村,582,872,234,102,336,62,398
公投第８案,屏東縣,佳冬鄉,玉光村,583,1255,389,107,496,72,568
公投第８案,屏東縣,佳冬鄉,昌隆村,584,995,353,87,440,105,545
公投第８案,屏東縣,佳冬鄉,豐隆村,585,734,181,70,251,25,276
公投第８案,屏東縣,佳冬鄉,大同村,586,1178,337,114,451,43,494
公投第８案,屏東縣,佳冬鄉,羌園村,587,1095,317,115,432,63,495
公投第８案,屏東縣,佳冬鄉,燄溫村,588,1097,371,140,511,128,639
公投第８案,屏東縣,佳冬鄉,塭豐村,589,1273,427,152,579,78,657
公投第８案,屏東縣,佳冬鄉,塭豐村,590,1160,414,167,581,75,656
公投第８案,屏東縣,琉球鄉,本福村,591,1111,303,83,386,53,439
公投第８案,屏東縣,琉球鄉,本福村,592,972,293,76,369,60,429
公投第８案,屏東縣,琉球鄉,中福村,593,1278,447,114,561,88,649
公投第８案,屏東縣,琉球鄉,漁福村,594,976,326,78,404,91,495
公投第８案,屏東縣,琉球鄉,大福村,595,1658,526,167,693,93,786
公投第８案,屏東縣,琉球鄉,南福村,596,1146,299,80,379,57,436
公投第８案,屏東縣,琉球鄉,天福村,597,1079,90,75,165,53,218
公投第８案,屏東縣,琉球鄉,上福村,598,1613,379,81,460,35,495
公投第８案,屏東縣,琉球鄉,杉福村,599,873,299,73,372,72,444
公投第８案,屏東縣,車城鄉,海口村,600,737,193,67,260,49,309
公投第８案,屏東縣,車城鄉,田中村,601,647,151,55,206,35,241
公投第８案,屏東縣,車城鄉,福興村,602,491,156,40,196,20,216
公投第８案,屏東縣,車城鄉,福興村,603,856,279,85,364,33,397
公投第８案,屏東縣,車城鄉,福安村,604,554,151,61,212,11,223
公投第８案,屏東縣,車城鄉,統埔村,605,388,101,32,133,6,139
公投第８案,屏東縣,車城鄉,溫泉村,606,922,218,97,315,50,365
公投第８案,屏東縣,車城鄉,保力村,607,597,132,37,169,9,178
公投第８案,屏東縣,車城鄉,保力村,608,623,117,51,168,11,179
公投第８案,屏東縣,車城鄉,新街村,609,425,126,40,166,25,191
公投第８案,屏東縣,車城鄉,埔墘村,610,428,155,41,196,20,216
公投第８案,屏東縣,車城鄉,射寮村,611,504,115,35,150,14,164
公投第８案,屏東縣,車城鄉,後灣村,612,423,129,53,182,23,205
公投第８案,屏東縣,滿州鄉,滿州村,613,1575,520,153,673,51,724
公投第８案,屏東縣,滿州鄉,里德村,614,420,131,40,171,13,184
公投第８案,屏東縣,滿州鄉,响林村,615,602,226,90,316,33,349
公投第８案,屏東縣,滿州鄉,永靖村,616,1302,331,102,433,23,456
公投第８案,屏東縣,滿州鄉,港口村,617,1314,440,140,580,57,637
公投第８案,屏東縣,滿州鄉,長樂村,618,1308,282,72,354,36,390
公投第８案,屏東縣,滿州鄉,九棚村,619,367,84,36,120,15,135
公投第８案,屏東縣,滿州鄉,港仔村,620,318,109,30,139,27,166
公投第８案,屏東縣,枋山鄉,枋山村,621,604,258,73,331,34,365
公投第８案,屏東縣,枋山鄉,枋山村,622,428,173,50,223,35,258
公投第８案,屏東縣,枋山鄉,加祿村,623,928,389,113,502,75,577
公投第８案,屏東縣,枋山鄉,加祿村,624,972,323,112,435,24,459
公投第８案,屏東縣,枋山鄉,楓港村,625,1041,286,100,386,67,453
公投第８案,屏東縣,枋山鄉,善餘村,626,883,187,82,269,21,290
公投第８案,屏東縣,三地門鄉,大社村,627,616,186,49,235,22,257
公投第８案,屏東縣,三地門鄉,德文村,628,572,199,69,268,76,344
公投第８案,屏東縣,三地門鄉,達來村,629,323,101,26,127,14,141
公投第８案,屏東縣,三地門鄉,三地村,630,1448,564,161,725,68,793
公投第８案,屏東縣,三地門鄉,賽嘉村,631,726,164,44,208,6,214
公投第８案,屏東縣,三地門鄉,口社村,632,554,193,60,253,31,284
公投第８案,屏東縣,三地門鄉,馬兒村,633,346,114,50,164,16,180
公投第８案,屏東縣,三地門鄉,安坡村,634,458,111,44,155,1,156
公投第８案,屏東縣,三地門鄉,青山村,635,692,264,77,341,16,357
公投第８案,屏東縣,三地門鄉,青葉村,636,638,312,64,376,70,446
公投第８案,屏東縣,霧臺鄉,霧台村,637,346,183,53,236,30,266
公投第８案,屏東縣,霧臺鄉,霧台村,638,677,257,69,326,12,338
公投第８案,屏東縣,霧臺鄉,霧台村,639,162,40,9,49,1,50
公投第８案,屏東縣,霧臺鄉,吉露村,640,189,71,15,86,4,90
公投第８案,屏東縣,霧臺鄉,阿禮村,641,296,145,27,172,38,210
公投第８案,屏東縣,霧臺鄉,好茶村,642,483,174,79,253,12,265
公投第８案,屏東縣,霧臺鄉,佳暮村,643,347,93,37,130,3,133
公投第８案,屏東縣,霧臺鄉,大武村,644,450,143,51,194,12,206
公投第８案,屏東縣,瑪家鄉,瑪家村,645,455,168,44,212,5,217
公投第８案,屏東縣,瑪家鄉,北葉村,646,821,345,144,489,54,543
公投第８案,屏東縣,瑪家鄉,三和村,647,635,291,95,386,74,460
公投第８案,屏東縣,瑪家鄉,三和村,648,695,376,102,478,39,517
公投第８案,屏東縣,瑪家鄉,三和村,649,671,330,62,392,32,424
公投第８案,屏東縣,瑪家鄉,凉山村,650,1057,303,102,405,22,427
公投第８案,屏東縣,瑪家鄉,佳義村,651,900,372,96,468,19,487
公投第８案,屏東縣,瑪家鄉,排灣村,652,429,161,36,197,7,204
公投第８案,屏東縣,泰武鄉,佳平村,653,669,273,65,338,19,357
公投第８案,屏東縣,泰武鄉,佳平村,654,190,62,24,86,7,93
公投第８案,屏東縣,泰武鄉,武潭村,655,922,386,143,529,78,607
公投第８案,屏東縣,泰武鄉,平和村,656,598,283,92,375,67,442
公投第８案,屏東縣,泰武鄉,萬安村,657,771,356,86,442,61,503
公投第８案,屏東縣,泰武鄉,佳興村,658,414,183,67,250,52,302
公投第８案,屏東縣,泰武鄉,泰武村,659,780,248,103,351,41,392
公投第８案,屏東縣,來義鄉,來義村,660,917,404,77,481,108,589
公投第８案,屏東縣,來義鄉,義林村,661,361,131,36,167,13,180
公投第８案,屏東縣,來義鄉,義林村,662,216,63,11,74,0,74
公投第８案,屏東縣,來義鄉,丹林村,663,445,271,39,310,26,336
公投第８案,屏東縣,來義鄉,丹林村,664,280,126,28,154,28,182
公投第８案,屏東縣,來義鄉,古樓村,665,1097,500,99,599,50,649
公投第８案,屏東縣,來義鄉,文樂村,666,840,393,96,489,70,559
公投第８案,屏東縣,來義鄉,望嘉村,667,889,302,98,400,21,421
公投第８案,屏東縣,來義鄉,南和村,668,1212,386,158,544,33,577
公投第８案,屏東縣,春日鄉,春日村,669,909,140,45,185,7,192
公投第８案,屏東縣,春日鄉,古華村,670,663,118,61,179,20,199
公投第８案,屏東縣,春日鄉,士文村,671,304,33,7,40,0,40
公投第８案,屏東縣,春日鄉,七佳村,672,928,251,63,314,22,336
公投第８案,屏東縣,春日鄉,歸崇村,673,641,118,35,153,9,162
公投第８案,屏東縣,春日鄉,力里村,674,478,79,22,101,3,104
公投第８案,屏東縣,獅子鄉,楓林村,675,751,293,45,338,17,355
公投第８案,屏東縣,獅子鄉,丹路村,676,776,268,52,320,33,353
公投第８案,屏東縣,獅子鄉,草埔村,677,711,216,41,257,14,271
公投第８案,屏東縣,獅子鄉,內文村,678,243,106,48,154,27,181
公投第８案,屏東縣,獅子鄉,竹坑村,679,325,128,37,165,13,178
公投第８案,屏東縣,獅子鄉,獅子村,680,476,99,25,124,6,130
公投第８案,屏東縣,獅子鄉,內獅村,681,602,182,42,224,10,234
公投第８案,屏東縣,獅子鄉,南世村,682,346,90,24,114,7,121
公投第８案,屏東縣,牡丹鄉,石門村,683,342,104,26,130,12,142
公投第８案,屏東縣,牡丹鄉,石門村,684,1306,498,110,608,55,663
公投第８案,屏東縣,牡丹鄉,牡丹村,685,693,138,22,160,6,166
公投第８案,屏東縣,牡丹鄉,東源村,686,437,109,39,148,12,160
公投第８案,屏東縣,牡丹鄉,旭海村,687,392,140,44,184,10,194
公投第８案,屏東縣,牡丹鄉,高士村,688,593,208,56,264,11,275
公投第８案,屏東縣,牡丹鄉,四林村,689,551,108,17,125,6,131
公投第８案,臺東縣,臺東市,文化里,1,874,313,89,402,26,428
公投第８案,臺東縣,臺東市,民族里,2,1469,760,64,824,77,901
公投第８案,臺東縣,臺東市,自強里,3,1259,521,137,658,37,695
公投第８案,臺東縣,臺東市,自強里,4,1399,558,164,722,44,766
公投第８案,臺東縣,臺東市,自強里,5,1363,639,153,792,49,841
公投第８案,臺東縣,臺東市,民生里,6,1651,671,174,845,45,890
公投第８案,臺東縣,臺東市,民生里,7,1490,687,178,865,60,925
公投第８案,臺東縣,臺東市,寶桑里,8,859,343,70,413,32,445
公投第８案,臺東縣,臺東市,民權里,9,890,394,107,501,34,535
公投第８案,臺東縣,臺東市,四維里,10,651,251,79,330,46,376
公投第８案,臺東縣,臺東市,中華里,11,1650,579,167,746,76,822
公投第８案,臺東縣,臺東市,仁愛里,12,724,304,109,413,36,449
公投第８案,臺東縣,臺東市,強國里,13,632,276,74,350,31,381
公投第８案,臺東縣,臺東市,大同里,14,771,324,97,421,41,462
公投第８案,臺東縣,臺東市,成功里,15,798,280,99,379,28,407
公投第８案,臺東縣,臺東市,建國里,16,1299,471,151,622,98,720
公投第８案,臺東縣,臺東市,中正里,17,811,344,105,449,36,485
公投第８案,臺東縣,臺東市,中山里,18,764,350,102,452,37,489
公投第８案,臺東縣,臺東市,興國里,19,784,267,109,376,20,396
公投第８案,臺東縣,臺東市,鐵花里,20,427,149,42,191,15,206
公投第８案,臺東縣,臺東市,東海里,21,1292,480,119,599,36,635
公投第８案,臺東縣,臺東市,東海里,22,1501,654,150,804,28,832
公投第８案,臺東縣,臺東市,復國里,23,601,227,51,278,19,297
公投第８案,臺東縣,臺東市,復興里,24,417,154,39,193,9,202
公投第８案,臺東縣,臺東市,新興里,25,1001,413,99,512,47,559
公投第８案,臺東縣,臺東市,新生里,26,1638,702,197,899,51,950
公投第８案,臺東縣,臺東市,新生里,27,1576,651,161,812,58,870
公投第８案,臺東縣,臺東市,新生里,28,1595,669,156,825,67,892
公投第８案,臺東縣,臺東市,新生里,29,1734,729,178,907,54,961
公投第８案,臺東縣,臺東市,中心里,30,1476,629,152,781,61,842
公投第８案,臺東縣,臺東市,中心里,31,1545,690,185,875,51,926
公投第８案,臺東縣,臺東市,馬蘭里,32,1313,591,138,729,62,791
公投第８案,臺東縣,臺東市,馬蘭里,33,1338,629,139,768,52,820
公投第８案,臺東縣,臺東市,光明里,34,1312,566,112,678,24,702
公投第８案,臺東縣,臺東市,光明里,35,1265,531,151,682,51,733
公投第８案,臺東縣,臺東市,豐年里,36,1407,450,162,612,65,677
公投第８案,臺東縣,臺東市,豐年里,37,1552,574,131,705,51,756
公投第８案,臺東縣,臺東市,豐樂里,38,1445,593,131,724,88,812
公投第８案,臺東縣,臺東市,永樂里,39,2098,879,233,1112,67,1179
公投第８案,臺東縣,臺東市,康樂里,40,1324,541,149,690,86,776
公投第８案,臺東縣,臺東市,豐榮里,41,1598,664,130,794,46,840
公投第８案,臺東縣,臺東市,豐榮里,42,1513,626,116,742,31,773
公投第８案,臺東縣,臺東市,豐榮里,43,1679,644,173,817,37,854
公投第８案,臺東縣,臺東市,豐榮里,44,1414,501,164,665,72,737
公投第８案,臺東縣,臺東市,豐榮里,45,1798,713,173,886,62,948
公投第８案,臺東縣,臺東市,豐谷里,46,1749,572,148,720,80,800
公投第８案,臺東縣,臺東市,豐谷里,47,1709,647,191,838,92,930
公投第８案,臺東縣,臺東市,豐谷里,48,1629,625,137,762,63,825
公投第８案,臺東縣,臺東市,豐里里,49,1116,404,115,519,71,590
公投第８案,臺東縣,臺東市,豐里里,50,1259,402,108,510,29,539
公投第８案,臺東縣,臺東市,豐原里,51,1232,384,123,507,44,551
公投第８案,臺東縣,臺東市,富岡里,52,1505,482,180,662,109,771
公投第８案,臺東縣,臺東市,富豐里,53,836,271,76,347,57,404
公投第８案,臺東縣,臺東市,南榮里,54,1294,547,136,683,49,732
公投第８案,臺東縣,臺東市,南榮里,55,1350,502,148,650,72,722
公投第８案,臺東縣,臺東市,岩灣里,56,2162,923,197,1120,77,1197
公投第８案,臺東縣,臺東市,卑南里,57,1627,641,298,939,25,964
公投第８案,臺東縣,臺東市,卑南里,58,1140,475,130,605,58,663
公投第８案,臺東縣,臺東市,南王里,59,1359,544,109,653,46,699
公投第８案,臺東縣,臺東市,南王里,60,1329,520,163,683,56,739
公投第８案,臺東縣,臺東市,豐田里,61,990,365,107,472,43,515
公投第８案,臺東縣,臺東市,豐田里,62,1038,396,123,519,68,587
公投第８案,臺東縣,臺東市,新園里,63,1597,573,176,749,81,830
公投第８案,臺東縣,臺東市,建和里,64,1385,517,149,666,78,744
公投第８案,臺東縣,臺東市,建興里,65,939,305,85,390,18,408
公投第８案,臺東縣,臺東市,建業里,66,1258,382,104,486,62,548
公投第８案,臺東縣,臺東市,知本里,67,1350,463,152,615,10,625
公投第８案,臺東縣,臺東市,建農里,68,1058,354,84,438,36,474
公投第８案,臺東縣,臺東市,建農里,69,895,256,75,331,34,365
公投第８案,臺東縣,成功鎮,信義里,70,516,171,44,215,45,260
公投第８案,臺東縣,成功鎮,信義里,71,960,342,168,510,74,584
公投第８案,臺東縣,成功鎮,信義里,72,365,86,16,102,17,119
公投第８案,臺東縣,成功鎮,和平里,73,747,206,71,277,68,345
公投第８案,臺東縣,成功鎮,忠仁里,74,339,108,27,135,24,159
公投第８案,臺東縣,成功鎮,忠仁里,75,995,335,86,421,29,450
公投第８案,臺東縣,成功鎮,忠仁里,76,863,331,93,424,59,483
公投第８案,臺東縣,成功鎮,忠智里,77,931,356,103,459,47,506
公投第８案,臺東縣,成功鎮,忠智里,78,970,365,92,457,35,492
公投第８案,臺東縣,成功鎮,三民里,79,1365,465,115,580,110,690
公投第８案,臺東縣,成功鎮,三民里,80,1366,503,118,621,98,719
公投第８案,臺東縣,成功鎮,三仙里,81,516,154,44,198,64,262
公投第８案,臺東縣,成功鎮,三仙里,82,887,216,71,287,85,372
公投第８案,臺東縣,成功鎮,忠孝里,83,488,125,49,174,44,218
公投第８案,臺東縣,成功鎮,忠孝里,84,481,106,47,153,41,194
公投第８案,臺東縣,成功鎮,博愛里,85,373,56,14,70,3,73
公投第８案,臺東縣,成功鎮,博愛里,86,264,85,35,120,26,146
公投第８案,臺東縣,關山鎮,里壠里,87,909,408,102,510,26,536
公投第８案,臺東縣,關山鎮,里壠里,88,790,246,62,308,29,337
公投第８案,臺東縣,關山鎮,中福里,89,828,358,102,460,40,500
公投第８案,臺東縣,關山鎮,新福里,90,887,252,80,332,35,367
公投第８案,臺東縣,關山鎮,豐泉里,91,1137,477,100,577,36,613
公投第８案,臺東縣,關山鎮,月眉里,92,732,233,80,313,37,350
公投第８案,臺東縣,關山鎮,德高里,93,912,322,93,415,56,471
公投第８案,臺東縣,關山鎮,德高里,94,779,216,50,266,33,299
公投第８案,臺東縣,關山鎮,電光里,95,535,150,32,182,21,203
公投第８案,臺東縣,卑南鄉,賓朗村,96,1041,376,159,535,64,599
公投第８案,臺東縣,卑南鄉,賓朗村,97,1165,425,99,524,42,566
公投第８案,臺東縣,卑南鄉,美農村,98,219,47,27,74,22,96
公投第８案,臺東縣,卑南鄉,美農村,99,460,136,37,173,41,214
公投第８案,臺東縣,卑南鄉,美農村,100,387,109,32,141,14,155
公投第８案,臺東縣,卑南鄉,初鹿村,101,767,235,66,301,29,330
公投第８案,臺東縣,卑南鄉,初鹿村,102,503,188,48,236,34,270
公投第８案,臺東縣,卑南鄉,明峰村,103,727,227,71,298,48,346
公投第８案,臺東縣,卑南鄉,明峰村,104,436,151,44,195,33,228
公投第８案,臺東縣,卑南鄉,嘉豐村,105,261,51,32,83,13,96
公投第８案,臺東縣,卑南鄉,嘉豐村,106,215,70,32,102,13,115
公投第８案,臺東縣,卑南鄉,太平村,107,1442,577,157,734,8,742
公投第８案,臺東縣,卑南鄉,太平村,108,527,200,46,246,16,262
公投第８案,臺東縣,卑南鄉,太平村,109,1046,395,121,516,63,579
公投第８案,臺東縣,卑南鄉,泰安村,110,1110,369,145,514,80,594
公投第８案,臺東縣,卑南鄉,利嘉村,111,1105,444,131,575,53,628
公投第８案,臺東縣,卑南鄉,東興村,112,1167,455,132,587,138,725
公投第８案,臺東縣,卑南鄉,溫泉村,113,968,290,124,414,56,470
公投第８案,臺東縣,卑南鄉,溫泉村,114,159,43,11,54,4,58
公投第８案,臺東縣,卑南鄉,富山村,115,488,158,38,196,23,219
公投第８案,臺東縣,卑南鄉,富源村,116,347,150,39,189,15,204
公投第８案,臺東縣,卑南鄉,利吉村,117,436,159,40,199,26,225
公投第８案,臺東縣,鹿野鄉,鹿野村,118,522,136,43,179,10,189
公投第８案,臺東縣,鹿野鄉,鹿野村,119,574,199,71,270,37,307
公投第８案,臺東縣,鹿野鄉,龍田村,120,1055,286,90,376,37,413
公投第８案,臺東縣,鹿野鄉,永安村,121,1104,337,133,470,40,510
公投第８案,臺東縣,鹿野鄉,永安村,122,342,114,24,138,16,154
公投第８案,臺東縣,鹿野鄉,瑞隆村,123,895,276,88,364,55,419
公投第８案,臺東縣,鹿野鄉,瑞源村,124,864,251,104,355,53,408
公投第８案,臺東縣,鹿野鄉,瑞和村,125,675,164,76,240,48,288
公投第８案,臺東縣,鹿野鄉,瑞豐村,126,435,138,54,192,21,213
公投第８案,臺東縣,鹿野鄉,瑞豐村,127,470,110,44,154,26,180
公投第８案,臺東縣,池上鄉,福原村,128,992,329,97,426,34,460
公投第８案,臺東縣,池上鄉,福原村,129,929,357,97,454,53,507
公投第８案,臺東縣,池上鄉,福文村,130,434,136,46,182,28,210
公投第８案,臺東縣,池上鄉,福文村,131,703,196,74,270,36,306
公投第８案,臺東縣,池上鄉,慶豐村,132,654,191,49,240,23,263
公投第８案,臺東縣,池上鄉,大坡村,133,324,81,27,108,20,128
公投第８案,臺東縣,池上鄉,大埔村,134,794,236,81,317,41,358
公投第８案,臺東縣,池上鄉,新興村,135,856,281,82,363,52,415
公投第８案,臺東縣,池上鄉,錦園村,136,344,105,21,126,13,139
公投第８案,臺東縣,池上鄉,萬安村,137,311,121,29,150,21,171
公投第８案,臺東縣,池上鄉,富興村,138,386,83,36,119,17,136
公投第８案,臺東縣,池上鄉,振興村,139,435,93,34,127,24,151
公投第８案,臺東縣,東河鄉,都蘭村,140,290,85,13,98,24,122
公投第８案,臺東縣,東河鄉,都蘭村,141,620,227,67,294,43,337
公投第８案,臺東縣,東河鄉,都蘭村,142,1196,456,163,619,121,740
公投第８案,臺東縣,東河鄉,興昌村,143,918,259,86,345,93,438
公投第８案,臺東縣,東河鄉,隆昌村,144,555,172,42,214,42,256
公投第８案,臺東縣,東河鄉,東河村,145,977,261,96,357,36,393
公投第８案,臺東縣,東河鄉,泰源村,146,1197,210,66,276,12,288
公投第８案,臺東縣,東河鄉,北源村,147,867,130,44,174,35,209
公投第８案,臺東縣,東河鄉,北源村,148,345,94,31,125,23,148
公投第８案,臺東縣,東河鄉,北源村,149,408,111,32,143,25,168
公投第８案,臺東縣,東河鄉,尚德村,150,262,82,23,105,9,114
公投第８案,臺東縣,長濱鄉,寧埔村,151,536,177,75,252,57,309
公投第８案,臺東縣,長濱鄉,寧埔村,152,689,142,40,182,36,218
公投第８案,臺東縣,長濱鄉,竹湖村,153,913,279,97,376,123,499
公投第８案,臺東縣,長濱鄉,長濱村,154,1268,321,70,391,32,423
公投第８案,臺東縣,長濱鄉,長濱村,155,725,187,78,265,70,335
公投第８案,臺東縣,長濱鄉,忠勇村,156,532,91,31,122,10,132
公投第８案,臺東縣,長濱鄉,三間村,157,660,152,51,203,76,279
公投第８案,臺東縣,長濱鄉,三間村,158,336,52,8,60,3,63
公投第８案,臺東縣,長濱鄉,三間村,159,195,38,12,50,14,64
公投第８案,臺東縣,長濱鄉,樟原村,160,25,9,2,11,2,13
公投第８案,臺東縣,長濱鄉,樟原村,161,605,142,47,189,61,250
公投第８案,臺東縣,太麻里鄉,美和村,162,722,264,69,333,51,384
公投第８案,臺東縣,太麻里鄉,美和村,163,575,199,64,263,24,287
公投第８案,臺東縣,太麻里鄉,三和村,164,623,199,75,274,36,310
公投第８案,臺東縣,太麻里鄉,華源村,165,622,184,55,239,56,295
公投第８案,臺東縣,太麻里鄉,北里村,166,560,149,38,187,14,201
公投第８案,臺東縣,太麻里鄉,大王村,167,957,317,97,414,109,523
公投第８案,臺東縣,太麻里鄉,大王村,168,809,214,103,317,39,356
公投第８案,臺東縣,太麻里鄉,泰和村,169,673,282,82,364,50,414
公投第８案,臺東縣,太麻里鄉,泰和村,170,737,251,76,327,52,379
公投第８案,臺東縣,太麻里鄉,香蘭村,171,424,146,58,204,34,238
公投第８案,臺東縣,太麻里鄉,香蘭村,172,374,101,56,157,22,179
公投第８案,臺東縣,太麻里鄉,金崙村,173,829,193,63,256,21,277
公投第８案,臺東縣,太麻里鄉,金崙村,174,869,214,47,261,8,269
公投第８案,臺東縣,太麻里鄉,多良村,175,223,48,10,58,5,63
公投第８案,臺東縣,太麻里鄉,多良村,176,669,236,78,314,48,362
公投第８案,臺東縣,大武鄉,南興村,177,568,195,65,260,71,331
公投第８案,臺東縣,大武鄉,尚武村,178,1474,430,133,563,157,720
公投第８案,臺東縣,大武鄉,大武村,179,1327,442,149,591,118,709
公投第８案,臺東縣,大武鄉,大鳥村,180,1134,307,113,420,114,534
公投第８案,臺東縣,大武鄉,大竹村,181,386,110,39,149,64,213
公投第８案,臺東縣,大武鄉,大竹村,182,377,93,43,136,31,167
公投第８案,臺東縣,綠島鄉,南寮村,183,1474,462,106,568,30,598
公投第８案,臺東縣,綠島鄉,中寮村,184,1082,346,89,435,38,473
公投第８案,臺東縣,綠島鄉,公舘村,185,813,270,81,351,30,381
公投第８案,臺東縣,綠島鄉,公舘村,186,210,69,24,93,3,96
公投第８案,臺東縣,海端鄉,加拿村,187,497,168,54,222,41,263
公投第８案,臺東縣,海端鄉,崁頂村,188,569,226,67,293,37,330
公投第８案,臺東縣,海端鄉,海端村,189,971,311,109,420,60,480
公投第８案,臺東縣,海端鄉,廣原村,190,728,256,97,353,40,393
公投第８案,臺東縣,海端鄉,霧鹿村,191,259,89,30,119,21,140
公投第８案,臺東縣,海端鄉,利稻村,192,254,79,34,113,13,126
公投第８案,臺東縣,延平鄉,桃源村,193,1014,340,105,445,56,501
公投第８案,臺東縣,延平鄉,紅葉村,194,426,161,69,230,66,296
公投第８案,臺東縣,延平鄉,永康村,195,315,144,36,180,29,209
公投第８案,臺東縣,延平鄉,武陵村,196,579,154,56,210,20,230
公投第８案,臺東縣,延平鄉,鸞山村,197,596,175,71,246,28,274
公投第８案,臺東縣,金峰鄉,嘉蘭村,198,1241,346,124,470,64,534
公投第８案,臺東縣,金峰鄉,正興村,199,601,245,63,308,36,344
公投第８案,臺東縣,金峰鄉,新興村,200,520,266,75,341,52,393
公投第８案,臺東縣,金峰鄉,賓茂村,201,336,124,39,163,26,189
公投第８案,臺東縣,金峰鄉,歷坵村,202,330,79,39,118,34,152
公投第８案,臺東縣,達仁鄉,安朔村,203,246,97,31,128,26,154
公投第８案,臺東縣,達仁鄉,安朔村,204,340,169,39,208,10,218
公投第８案,臺東縣,達仁鄉,南田村,205,296,143,39,182,13,195
公投第８案,臺東縣,達仁鄉,森永村,206,429,178,49,227,37,264
公投第８案,臺東縣,達仁鄉,新化村,207,331,139,43,182,29,211
公投第８案,臺東縣,達仁鄉,台坂村,208,628,164,66,230,25,255
公投第８案,臺東縣,達仁鄉,土坂村,209,867,401,3,404,58,462
公投第８案,臺東縣,蘭嶼鄉,椰油村,210,943,237,102,339,28,367
公投第８案,臺東縣,蘭嶼鄉,紅頭村,211,1238,353,124,477,47,524
公投第８案,臺東縣,蘭嶼鄉,東清村,212,1240,228,108,336,26,362
公投第８案,臺東縣,蘭嶼鄉,朗島村,213,760,173,67,240,39,279
公投第８案,花蓮縣,花蓮市,民德里,1,1522,660,165,825,35,860
公投第８案,花蓮縣,花蓮市,民勤里,2,1114,493,122,615,36,651
公投第８案,花蓮縣,花蓮市,民勤里,3,670,272,78,350,26,376
公投第８案,花蓮縣,花蓮市,民勤里,4,1397,575,142,717,21,738
公投第８案,花蓮縣,花蓮市,民意里,5,470,165,46,211,27,238
公投第８案,花蓮縣,花蓮市,民意里,6,838,332,59,391,41,432
公投第８案,花蓮縣,花蓮市,民意里,7,721,242,42,284,16,300
公投第８案,花蓮縣,花蓮市,民心里,8,918,372,113,485,42,527
公投第８案,花蓮縣,花蓮市,民享里,9,1539,614,152,766,44,810
公投第８案,花蓮縣,花蓮市,民享里,10,1403,557,124,681,64,745
公投第８案,花蓮縣,花蓮市,民孝里,11,1068,427,107,534,30,564
公投第８案,花蓮縣,花蓮市,民孝里,12,1167,501,109,610,31,641
公投第８案,花蓮縣,花蓮市,民孝里,13,1259,559,130,689,62,751
公投第８案,花蓮縣,花蓮市,民運里,14,1071,382,135,517,66,583
公投第８案,花蓮縣,花蓮市,民運里,15,925,374,113,487,40,527
公投第８案,花蓮縣,花蓮市,民政里,16,1141,521,129,650,60,710
公投第８案,花蓮縣,花蓮市,民政里,17,1163,451,117,568,29,597
公投第８案,花蓮縣,花蓮市,民政里,18,1279,556,144,700,40,740
公投第８案,花蓮縣,花蓮市,民立里,19,1512,540,142,682,33,715
公投第８案,花蓮縣,花蓮市,民樂里,20,615,245,63,308,25,333
公投第８案,花蓮縣,花蓮市,民有里,21,606,238,86,324,23,347
公投第８案,花蓮縣,花蓮市,民主里,22,559,212,47,259,14,273
公投第８案,花蓮縣,花蓮市,民族里,23,442,191,33,224,20,244
公投第８案,花蓮縣,花蓮市,民生里,24,1114,428,103,531,31,562
公投第８案,花蓮縣,花蓮市,民權里,25,416,169,44,213,21,234
公投第８案,花蓮縣,花蓮市,主商里,26,577,242,73,315,34,349
公投第８案,花蓮縣,花蓮市,主勤里,27,810,367,100,467,26,493
公投第８案,花蓮縣,花蓮市,主工里,28,538,224,56,280,29,309
公投第８案,花蓮縣,花蓮市,主信里,29,566,212,67,279,30,309
公投第８案,花蓮縣,花蓮市,主義里,30,469,180,49,229,15,244
公投第８案,花蓮縣,花蓮市,主睦里,31,565,252,53,305,18,323
公投第８案,花蓮縣,花蓮市,主計里,32,816,301,64,365,36,401
公投第８案,花蓮縣,花蓮市,主和里,33,911,343,87,430,49,479
公投第８案,花蓮縣,花蓮市,主和里,34,1029,391,96,487,50,537
公投第８案,花蓮縣,花蓮市,主和里,35,1043,447,115,562,50,612
公投第８案,花蓮縣,花蓮市,主學里,36,856,366,92,458,29,487
公投第８案,花蓮縣,花蓮市,主學里,37,979,394,109,503,35,538
公投第８案,花蓮縣,花蓮市,主農里,38,1331,549,152,701,48,749
公投第８案,花蓮縣,花蓮市,主農里,39,1228,427,231,658,35,693
公投第８案,花蓮縣,花蓮市,主農里,40,955,406,98,504,40,544
公投第８案,花蓮縣,花蓮市,主安里,41,1268,499,108,607,33,640
公投第８案,花蓮縣,花蓮市,主安里,42,1230,478,134,612,35,647
公投第８案,花蓮縣,花蓮市,主權里,43,1369,596,118,714,58,772
公投第８案,花蓮縣,花蓮市,主權里,44,1435,477,130,607,33,640
公投第８案,花蓮縣,花蓮市,主權里,45,1164,482,115,597,43,640
公投第８案,花蓮縣,花蓮市,主權里,46,1249,552,127,679,55,734
公投第８案,花蓮縣,花蓮市,主力里,47,1184,477,125,602,55,657
公投第８案,花蓮縣,花蓮市,主力里,48,1490,594,140,734,48,782
公投第８案,花蓮縣,花蓮市,國風里,49,1022,493,110,603,37,640
公投第８案,花蓮縣,花蓮市,國風里,50,1135,469,116,585,47,632
公投第８案,花蓮縣,花蓮市,國風里,51,1084,476,96,572,37,609
公投第８案,花蓮縣,花蓮市,國威里,52,1339,359,103,462,37,499
公投第８案,花蓮縣,花蓮市,國威里,53,501,225,57,282,18,300
公投第８案,花蓮縣,花蓮市,國治里,54,904,372,99,471,26,497
公投第８案,花蓮縣,花蓮市,國安里,55,490,214,69,283,19,302
公投第８案,花蓮縣,花蓮市,國光里,56,1192,442,94,536,28,564
公投第８案,花蓮縣,花蓮市,國防里,57,869,320,89,409,26,435
公投第８案,花蓮縣,花蓮市,國華里,58,1267,530,108,638,39,677
公投第８案,花蓮縣,花蓮市,國華里,59,959,400,102,502,50,552
公投第８案,花蓮縣,花蓮市,國魂里,60,993,426,85,511,28,539
公投第８案,花蓮縣,花蓮市,國魂里,61,982,389,105,494,58,552
公投第８案,花蓮縣,花蓮市,國聯里,62,1311,478,124,602,18,620
公投第８案,花蓮縣,花蓮市,國聯里,63,1455,534,159,693,55,748
公投第８案,花蓮縣,花蓮市,國盛里,64,1151,395,104,499,37,536
公投第８案,花蓮縣,花蓮市,國盛里,65,1237,460,113,573,37,610
公投第８案,花蓮縣,花蓮市,國盛里,66,1339,491,110,601,43,644
公投第８案,花蓮縣,花蓮市,國強里,67,715,309,79,388,26,414
公投第８案,花蓮縣,花蓮市,國強里,68,1000,414,99,513,40,553
公投第８案,花蓮縣,花蓮市,國富里,69,1410,505,138,643,55,698
公投第８案,花蓮縣,花蓮市,國富里,70,1303,537,122,659,20,679
公投第８案,花蓮縣,花蓮市,國富里,71,1256,496,143,639,33,672
公投第８案,花蓮縣,花蓮市,國富里,72,1105,468,123,591,45,636
公投第８案,花蓮縣,花蓮市,國裕里,73,1089,402,125,527,30,557
公投第８案,花蓮縣,花蓮市,國裕里,74,1043,397,86,483,24,507
公投第８案,花蓮縣,花蓮市,國裕里,75,1080,491,92,583,33,616
公投第８案,花蓮縣,花蓮市,國裕里,76,971,439,80,519,30,549
公投第８案,花蓮縣,花蓮市,國慶里,77,1068,439,132,571,39,610
公投第８案,花蓮縣,花蓮市,國興里,78,1379,528,133,661,31,692
公投第８案,花蓮縣,花蓮市,國興里,79,1362,522,137,659,58,717
公投第８案,花蓮縣,花蓮市,國興里,80,1323,583,135,718,40,758
公投第８案,花蓮縣,花蓮市,國福里,81,1482,493,139,632,43,675
公投第８案,花蓮縣,新城鄉,新城村,82,367,157,42,199,17,216
公投第８案,花蓮縣,新城鄉,新城村,83,929,343,82,425,11,436
公投第８案,花蓮縣,新城鄉,順安村,84,590,218,91,309,45,354
公投第８案,花蓮縣,新城鄉,順安村,85,307,99,49,148,25,173
公投第８案,花蓮縣,新城鄉,康樂村,86,260,108,30,138,22,160
公投第８案,花蓮縣,新城鄉,康樂村,87,1283,527,150,677,58,735
公投第８案,花蓮縣,新城鄉,康樂村,88,885,343,77,420,23,443
公投第８案,花蓮縣,新城鄉,大漢村,89,770,312,91,403,35,438
公投第８案,花蓮縣,新城鄉,大漢村,90,1363,526,146,672,67,739
公投第８案,花蓮縣,新城鄉,大漢村,91,366,144,36,180,12,192
公投第８案,花蓮縣,新城鄉,北埔村,92,1163,422,120,542,48,590
公投第８案,花蓮縣,新城鄉,北埔村,93,1605,607,184,791,46,837
公投第８案,花蓮縣,新城鄉,北埔村,94,1194,476,115,591,46,637
公投第８案,花蓮縣,新城鄉,佳林村,95,979,423,80,503,49,552
公投第８案,花蓮縣,新城鄉,嘉里村,96,1485,605,166,771,49,820
公投第８案,花蓮縣,新城鄉,嘉里村,97,1070,418,102,520,38,558
公投第８案,花蓮縣,新城鄉,嘉里村,98,1164,491,110,601,32,633
公投第８案,花蓮縣,新城鄉,嘉新村,99,880,321,86,407,59,466
公投第８案,花蓮縣,新城鄉,嘉新村,100,369,128,41,169,17,186
公投第８案,花蓮縣,秀林鄉,和平村,101,867,313,95,408,33,441
公投第８案,花蓮縣,秀林鄉,和平村,102,575,193,74,267,29,296
公投第８案,花蓮縣,秀林鄉,崇德村,103,1373,330,130,460,58,518
公投第８案,花蓮縣,秀林鄉,富世村,104,1644,488,139,627,76,703
公投第８案,花蓮縣,秀林鄉,富世村,105,162,69,12,81,8,89
公投第８案,花蓮縣,秀林鄉,秀林村,106,384,115,50,165,28,193
公投第８案,花蓮縣,秀林鄉,秀林村,107,1382,423,109,532,39,571
公投第８案,花蓮縣,秀林鄉,景美村,108,1125,383,103,486,23,509
公投第８案,花蓮縣,秀林鄉,景美村,109,627,205,63,268,17,285
公投第８案,花蓮縣,秀林鄉,佳民村,110,987,445,122,567,51,618
公投第８案,花蓮縣,秀林鄉,水源村,111,1139,442,147,589,102,691
公投第８案,花蓮縣,秀林鄉,銅門村,112,1213,447,116,563,8,571
公投第８案,花蓮縣,秀林鄉,文蘭村,113,754,294,64,358,32,390
公投第８案,花蓮縣,秀林鄉,文蘭村,114,330,107,22,129,14,143
公投第８案,花蓮縣,吉安鄉,永安村,115,1059,407,109,516,37,553
公投第８案,花蓮縣,吉安鄉,永安村,116,983,418,93,511,34,545
公投第８案,花蓮縣,吉安鄉,永安村,117,1031,434,92,526,33,559
公投第８案,花蓮縣,吉安鄉,永安村,118,1105,408,114,522,41,563
公投第８案,花蓮縣,吉安鄉,太昌村,119,1107,420,115,535,39,574
公投第８案,花蓮縣,吉安鄉,太昌村,120,1179,412,127,539,48,587
公投第８案,花蓮縣,吉安鄉,太昌村,121,1453,464,142,606,59,665
公投第８案,花蓮縣,吉安鄉,慶豐村,122,1432,639,154,793,48,841
公投第８案,花蓮縣,吉安鄉,慶豐村,123,1320,560,132,692,36,728
公投第８案,花蓮縣,吉安鄉,慶豐村,124,1356,525,130,655,28,683
公投第８案,花蓮縣,吉安鄉,慶豐村,125,1295,513,108,621,40,661
公投第８案,花蓮縣,吉安鄉,慶豐村,126,1467,597,144,741,56,797
公投第８案,花蓮縣,吉安鄉,吉安村,127,1515,591,158,749,35,784
公投第８案,花蓮縣,吉安鄉,吉安村,128,1063,459,119,578,49,627
公投第８案,花蓮縣,吉安鄉,吉安村,129,1284,430,105,535,26,561
公投第８案,花蓮縣,吉安鄉,吉安村,130,1380,587,142,729,44,773
公投第８案,花蓮縣,吉安鄉,福興村,131,1297,527,148,675,56,731
公投第８案,花蓮縣,吉安鄉,福興村,132,1662,609,159,768,83,851
公投第８案,花蓮縣,吉安鄉,南華村,133,1563,476,178,654,94,748
公投第８案,花蓮縣,吉安鄉,干城村,134,1288,455,116,571,50,621
公投第８案,花蓮縣,吉安鄉,永興村,135,907,364,102,466,38,504
公投第８案,花蓮縣,吉安鄉,永興村,136,917,354,85,439,35,474
公投第８案,花蓮縣,吉安鄉,永興村,137,1021,386,110,496,30,526
公投第８案,花蓮縣,吉安鄉,稻香村,138,1033,459,116,575,39,614
公投第８案,花蓮縣,吉安鄉,稻香村,139,966,398,99,497,53,550
公投第８案,花蓮縣,吉安鄉,稻香村,140,1188,465,96,561,61,622
公投第８案,花蓮縣,吉安鄉,南昌村,141,1480,608,122,730,30,760
公投第８案,花蓮縣,吉安鄉,南昌村,142,1393,521,113,634,39,673
公投第８案,花蓮縣,吉安鄉,南昌村,143,1193,456,106,562,32,594
公投第８案,花蓮縣,吉安鄉,宜昌村,144,1445,529,124,653,41,694
公投第８案,花蓮縣,吉安鄉,宜昌村,145,1301,492,143,635,86,721
公投第８案,花蓮縣,吉安鄉,宜昌村,146,1215,500,138,638,54,692
公投第８案,花蓮縣,吉安鄉,北昌村,147,1135,455,117,572,37,609
公投第８案,花蓮縣,吉安鄉,北昌村,148,1223,550,108,658,34,692
公投第８案,花蓮縣,吉安鄉,北昌村,149,1274,533,119,652,45,697
公投第８案,花蓮縣,吉安鄉,北昌村,150,1124,437,118,555,37,592
公投第８案,花蓮縣,吉安鄉,北昌村,151,1158,492,124,616,35,651
公投第８案,花蓮縣,吉安鄉,北昌村,152,1157,500,119,619,26,645
公投第８案,花蓮縣,吉安鄉,勝安村,153,1258,530,120,650,36,686
公投第８案,花蓮縣,吉安鄉,勝安村,154,1257,497,141,638,30,668
公投第８案,花蓮縣,吉安鄉,勝安村,155,1245,486,125,611,32,643
公投第８案,花蓮縣,吉安鄉,勝安村,156,1166,485,148,633,14,647
公投第８案,花蓮縣,吉安鄉,仁里村,157,1358,528,131,659,51,710
公投第８案,花蓮縣,吉安鄉,仁里村,158,1214,496,100,596,34,630
公投第８案,花蓮縣,吉安鄉,仁里村,159,1151,458,103,561,55,616
公投第８案,花蓮縣,吉安鄉,仁里村,160,1157,465,137,602,32,634
公投第８案,花蓮縣,吉安鄉,仁里村,161,1161,500,112,612,40,652
公投第８案,花蓮縣,吉安鄉,東昌村,162,1304,543,144,687,49,736
公投第８案,花蓮縣,吉安鄉,東昌村,163,1367,527,134,661,53,714
公投第８案,花蓮縣,吉安鄉,東昌村,164,1411,479,144,623,42,665
公投第８案,花蓮縣,吉安鄉,東昌村,165,1409,515,107,622,40,662
公投第８案,花蓮縣,吉安鄉,仁安村,166,1125,392,95,487,43,530
公投第８案,花蓮縣,吉安鄉,仁安村,167,1213,459,135,594,79,673
公投第８案,花蓮縣,吉安鄉,仁和村,168,1141,456,135,591,33,624
公投第８案,花蓮縣,吉安鄉,仁和村,169,1156,414,91,505,23,528
公投第８案,花蓮縣,吉安鄉,仁和村,170,1092,427,85,512,50,562
公投第８案,花蓮縣,吉安鄉,仁和村,171,1026,311,116,427,37,464
公投第８案,花蓮縣,吉安鄉,光華村,172,804,328,73,401,16,417
公投第８案,花蓮縣,吉安鄉,光華村,173,1132,483,104,587,38,625
公投第８案,花蓮縣,壽豐鄉,溪口村,174,1052,353,109,462,39,501
公投第８案,花蓮縣,壽豐鄉,樹湖村,175,357,148,41,189,29,218
公投第８案,花蓮縣,壽豐鄉,豐山村,176,1022,360,101,461,54,515
公投第８案,花蓮縣,壽豐鄉,豐山村,177,875,377,117,494,53,547
公投第８案,花蓮縣,壽豐鄉,豐裡村,178,691,279,98,377,46,423
公投第８案,花蓮縣,壽豐鄉,豐裡村,179,708,233,65,298,24,322
公投第８案,花蓮縣,壽豐鄉,豐坪村,180,894,324,98,422,52,474
公投第８案,花蓮縣,壽豐鄉,壽豐村,181,746,295,73,368,40,408
公投第８案,花蓮縣,壽豐鄉,壽豐村,182,881,324,104,428,39,467
公投第８案,花蓮縣,壽豐鄉,共和村,183,695,315,77,392,39,431
公投第８案,花蓮縣,壽豐鄉,光榮村,184,816,311,117,428,83,511
公投第８案,花蓮縣,壽豐鄉,池南村,185,773,266,86,352,43,395
公投第８案,花蓮縣,壽豐鄉,平和村,186,1029,396,126,522,65,587
公投第８案,花蓮縣,壽豐鄉,平和村,187,407,184,42,226,31,257
公投第８案,花蓮縣,壽豐鄉,志學村,188,1139,444,147,591,55,646
公投第８案,花蓮縣,壽豐鄉,志學村,189,996,380,154,534,38,572
公投第８案,花蓮縣,壽豐鄉,志學村,190,414,128,46,174,13,187
公投第８案,花蓮縣,壽豐鄉,米棧村,191,270,103,41,144,13,157
公投第８案,花蓮縣,壽豐鄉,月眉村,192,836,336,92,428,60,488
公投第８案,花蓮縣,壽豐鄉,鹽寮村,193,507,206,77,283,23,306
公投第８案,花蓮縣,壽豐鄉,水璉村,194,739,201,68,269,43,312
公投第８案,花蓮縣,鳳林鎮,鳳仁里,195,1192,560,108,668,70,738
公投第８案,花蓮縣,鳳林鎮,鳳義里,196,639,230,62,292,31,323
公投第８案,花蓮縣,鳳林鎮,鳳禮里,197,601,284,69,353,47,400
公投第８案,花蓮縣,鳳林鎮,鳳智里,198,1137,552,117,669,56,725
公投第８案,花蓮縣,鳳林鎮,鳳信里,199,742,281,82,363,54,417
公投第８案,花蓮縣,鳳林鎮,鳳信里,200,610,265,50,315,34,349
公投第８案,花蓮縣,鳳林鎮,山興里,201,295,104,49,153,39,192
公投第８案,花蓮縣,鳳林鎮,山興里,202,218,53,10,63,3,66
公投第８案,花蓮縣,鳳林鎮,大榮里,203,720,221,54,275,22,297
公投第８案,花蓮縣,鳳林鎮,大榮里,204,528,201,58,259,27,286
公投第８案,花蓮縣,鳳林鎮,北林里,205,560,198,71,269,19,288
公投第８案,花蓮縣,鳳林鎮,南平里,206,541,201,36,237,54,291
公投第８案,花蓮縣,鳳林鎮,林榮里,207,818,321,81,402,62,464
公投第８案,花蓮縣,鳳林鎮,長橋里,208,984,281,77,358,47,405
公投第８案,花蓮縣,鳳林鎮,森榮里,209,91,31,10,41,8,49
公投第８案,花蓮縣,光復鄉,大華村,210,1295,491,144,635,84,719
公投第８案,花蓮縣,光復鄉,大安村,211,859,380,84,464,35,499
公投第８案,花蓮縣,光復鄉,大平村,212,958,340,105,445,126,571
公投第８案,花蓮縣,光復鄉,大馬村,213,1011,355,127,482,105,587
公投第８案,花蓮縣,光復鄉,大同村,214,1041,417,119,536,67,603
公投第８案,花蓮縣,光復鄉,東富村,215,821,285,85,370,78,448
公投第８案,花蓮縣,光復鄉,東富村,216,188,30,7,37,0,37
公投第８案,花蓮縣,光復鄉,西富村,217,514,201,49,250,32,282
公投第８案,花蓮縣,光復鄉,西富村,218,446,101,43,144,14,158
公投第８案,花蓮縣,光復鄉,南富村,219,851,291,91,382,49,431
公投第８案,花蓮縣,光復鄉,北富村,220,932,228,92,320,26,346
公投第８案,花蓮縣,光復鄉,大進村,221,471,211,33,244,24,268
公投第８案,花蓮縣,光復鄉,大全村,222,640,232,77,309,48,357
公投第８案,花蓮縣,光復鄉,大全村,223,116,32,8,40,5,45
公投第８案,花蓮縣,光復鄉,大興村,224,496,109,25,134,11,145
公投第８案,花蓮縣,光復鄉,大富村,225,324,97,34,131,15,146
公投第８案,花蓮縣,光復鄉,大豐村,226,454,125,32,157,19,176
公投第８案,花蓮縣,豐濱鄉,靜浦村,227,717,185,70,255,87,342
公投第８案,花蓮縣,豐濱鄉,港口村,228,751,166,80,246,57,303
公投第８案,花蓮縣,豐濱鄉,豐濱村,229,613,161,77,238,49,287
公投第８案,花蓮縣,豐濱鄉,豐濱村,230,809,271,63,334,30,364
公投第８案,花蓮縣,豐濱鄉,豐濱村,231,357,44,8,52,4,56
公投第８案,花蓮縣,豐濱鄉,新社村,232,669,192,70,262,78,340
公投第８案,花蓮縣,豐濱鄉,磯崎村,233,479,153,35,188,9,197
公投第８案,花蓮縣,萬榮鄉,西林村,234,1072,376,135,511,82,593
公投第８案,花蓮縣,萬榮鄉,見晴村,235,560,160,44,204,13,217
公投第８案,花蓮縣,萬榮鄉,萬榮村,236,773,325,97,422,36,458
公投第８案,花蓮縣,萬榮鄉,明利村,237,661,176,61,237,13,250
公投第８案,花蓮縣,萬榮鄉,馬遠村,238,442,158,50,208,16,224
公投第８案,花蓮縣,萬榮鄉,馬遠村,239,675,203,71,274,73,347
公投第８案,花蓮縣,萬榮鄉,紅葉村,240,1086,404,209,613,122,735
公投第８案,花蓮縣,瑞穗鄉,瑞穗村,241,813,345,76,421,48,469
公投第８案,花蓮縣,瑞穗鄉,瑞穗村,242,1091,426,109,535,73,608
公投第８案,花蓮縣,瑞穗鄉,瑞美村,243,839,355,80,435,44,479
公投第８案,花蓮縣,瑞穗鄉,瑞美村,244,975,377,119,496,61,557
公投第８案,花蓮縣,瑞穗鄉,瑞良村,245,546,169,61,230,24,254
公投第８案,花蓮縣,瑞穗鄉,瑞祥村,246,1002,391,116,507,62,569
公投第８案,花蓮縣,瑞穗鄉,瑞北村,247,593,176,61,237,39,276
公投第８案,花蓮縣,瑞穗鄉,舞鶴村,248,965,347,121,468,82,550
公投第８案,花蓮縣,瑞穗鄉,鶴岡村,249,863,305,100,405,70,475
公投第８案,花蓮縣,瑞穗鄉,奇美村,250,340,53,18,71,7,78
公投第８案,花蓮縣,瑞穗鄉,富源村,251,764,239,75,314,39,353
公投第８案,花蓮縣,瑞穗鄉,富民村,252,868,116,38,154,11,165
公投第８案,花蓮縣,瑞穗鄉,富興村,253,620,130,32,162,16,178
公投第８案,花蓮縣,玉里鎮,中城里,254,1008,397,99,496,47,543
公投第８案,花蓮縣,玉里鎮,中城里,255,939,417,96,513,43,556
公投第８案,花蓮縣,玉里鎮,中城里,256,1256,502,93,595,61,656
公投第８案,花蓮縣,玉里鎮,中城里,257,929,362,91,453,52,505
公投第８案,花蓮縣,玉里鎮,中城里,258,979,390,96,486,45,531
公投第８案,花蓮縣,玉里鎮,國武里,259,1244,551,136,687,43,730
公投第８案,花蓮縣,玉里鎮,啟模里,260,847,292,83,375,41,416
公投第８案,花蓮縣,玉里鎮,啟模里,261,772,244,81,325,55,380
公投第８案,花蓮縣,玉里鎮,泰昌里,262,558,200,54,254,23,277
公投第８案,花蓮縣,玉里鎮,泰昌里,263,800,176,56,232,28,260
公投第８案,花蓮縣,玉里鎮,永昌里,264,1286,412,113,525,70,595
公投第８案,花蓮縣,玉里鎮,源城里,265,1246,397,117,514,85,599
公投第８案,花蓮縣,玉里鎮,長良里,266,647,183,90,273,72,345
公投第８案,花蓮縣,玉里鎮,樂合里,267,990,164,41,205,17,222
公投第８案,花蓮縣,玉里鎮,東豐里,268,530,148,62,210,53,263
公投第８案,花蓮縣,玉里鎮,觀音里,269,979,213,90,303,56,359
公投第８案,花蓮縣,玉里鎮,觀音里,270,557,174,49,223,97,320
公投第８案,花蓮縣,玉里鎮,松浦里,271,434,112,24,136,21,157
公投第８案,花蓮縣,玉里鎮,松浦里,272,1065,207,74,281,80,361
公投第８案,花蓮縣,玉里鎮,春日里,273,866,246,110,356,105,461
公投第８案,花蓮縣,玉里鎮,德武里,274,769,198,75,273,42,315
公投第８案,花蓮縣,玉里鎮,三民里,275,869,248,80,328,42,370
公投第８案,花蓮縣,玉里鎮,大禹里,276,1080,286,106,392,54,446
公投第８案,花蓮縣,富里鄉,吳江村,277,467,142,35,177,21,198
公投第８案,花蓮縣,富里鄉,東里村,278,1032,266,81,347,60,407
公投第８案,花蓮縣,富里鄉,萬寧村,279,638,198,41,239,38,277
公投第８案,花蓮縣,富里鄉,新興村,280,591,179,64,243,79,322
公投第８案,花蓮縣,富里鄉,竹田村,281,1087,420,116,536,56,592
公投第８案,花蓮縣,富里鄉,羅山村,282,431,152,53,205,19,224
公投第８案,花蓮縣,富里鄉,石牌村,283,893,330,64,394,40,434
公投第８案,花蓮縣,富里鄉,明里村,284,361,92,37,129,20,149
公投第８案,花蓮縣,富里鄉,富里村,285,1362,361,126,487,51,538
公投第８案,花蓮縣,富里鄉,永豐村,286,458,162,46,208,29,237
公投第８案,花蓮縣,富里鄉,豐南村,287,621,124,34,158,36,194
公投第８案,花蓮縣,富里鄉,富南村,288,493,149,63,212,31,243
公投第８案,花蓮縣,富里鄉,學田村,289,631,207,62,269,29,298
公投第８案,花蓮縣,卓溪鄉,崙山村,290,533,200,65,265,17,282
公投第８案,花蓮縣,卓溪鄉,立山村,291,522,203,81,284,42,326
公投第８案,花蓮縣,卓溪鄉,立山村,292,493,125,37,162,18,180
公投第８案,花蓮縣,卓溪鄉,太平村,293,701,307,89,396,42,438
公投第８案,花蓮縣,卓溪鄉,卓溪村,294,746,308,82,390,53,443
公投第８案,花蓮縣,卓溪鄉,卓清村,295,616,211,106,317,69,386
公投第８案,花蓮縣,卓溪鄉,卓清村,296,405,88,26,114,16,130
公投第８案,花蓮縣,卓溪鄉,古風村,297,329,131,29,160,17,177
公投第８案,花蓮縣,卓溪鄉,古風村,298,428,166,31,197,21,218
公投第８案,花蓮縣,卓溪鄉,古風村,299,174,80,9,89,9,98
公投第８案,澎湖縣,馬公市,復興里,1,481,152,59,211,12,223
公投第８案,澎湖縣,馬公市,長安里,2,558,218,47,265,17,282
公投第８案,澎湖縣,馬公市,中央里,3,533,161,56,217,46,263
公投第８案,澎湖縣,馬公市,啟明里,4,922,300,110,410,31,441
公投第８案,澎湖縣,馬公市,重慶里,5,1021,367,126,493,40,533
公投第８案,澎湖縣,馬公市,中興里,6,793,275,92,367,34,401
公投第８案,澎湖縣,馬公市,光復里,7,954,350,110,460,48,508
公投第８案,澎湖縣,馬公市,光復里,8,1001,263,201,464,27,491
公投第８案,澎湖縣,馬公市,光明里,9,1192,369,123,492,36,528
公投第８案,澎湖縣,馬公市,光榮里,10,1402,498,112,610,46,656
公投第８案,澎湖縣,馬公市,光榮里,11,1389,547,117,664,34,698
公投第８案,澎湖縣,馬公市,光榮里,12,1339,507,136,643,45,688
公投第８案,澎湖縣,馬公市,朝陽里,13,1254,400,129,529,55,584
公投第８案,澎湖縣,馬公市,朝陽里,14,1194,436,106,542,57,599
公投第８案,澎湖縣,馬公市,朝陽里,15,1393,467,142,609,63,672
公投第８案,澎湖縣,馬公市,朝陽里,16,1440,558,142,700,47,747
公投第８案,澎湖縣,馬公市,陽明里,17,1215,396,135,531,55,586
公投第８案,澎湖縣,馬公市,陽明里,18,1284,465,110,575,56,631
公投第８案,澎湖縣,馬公市,重光里,19,1512,525,150,675,76,751
公投第８案,澎湖縣,馬公市,西衛里,20,1181,242,60,302,62,364
公投第８案,澎湖縣,馬公市,西衛里,21,1348,494,127,621,47,668
公投第８案,澎湖縣,馬公市,西衛里,22,1391,528,154,682,32,714
公投第８案,澎湖縣,馬公市,西衛里,23,2124,644,254,898,41,939
公投第８案,澎湖縣,馬公市,西文里,24,1500,530,140,670,69,739
公投第８案,澎湖縣,馬公市,西文里,25,1582,598,139,737,38,775
公投第８案,澎湖縣,馬公市,東文里,26,1638,590,162,752,42,794
公投第８案,澎湖縣,馬公市,東文里,27,1554,597,152,749,55,804
公投第８案,澎湖縣,馬公市,案山里,28,980,279,70,349,26,375
公投第８案,澎湖縣,馬公市,案山里,29,892,340,78,418,27,445
公投第８案,澎湖縣,馬公市,光華里,30,778,247,58,305,16,321
公投第８案,澎湖縣,馬公市,前寮里,31,930,362,78,440,31,471
公投第８案,澎湖縣,馬公市,石泉里,32,1481,680,130,810,45,855
公投第８案,澎湖縣,馬公市,石泉里,33,1128,474,92,566,26,592
公投第８案,澎湖縣,馬公市,菜園里,34,415,159,32,191,25,216
公投第８案,澎湖縣,馬公市,東衛里,35,1120,433,81,514,43,557
公投第８案,澎湖縣,馬公市,東衛里,36,950,400,81,481,34,515
公投第８案,澎湖縣,馬公市,安宅里,37,627,204,53,257,23,280
公投第８案,澎湖縣,馬公市,興仁里,38,1055,395,87,482,30,512
公投第８案,澎湖縣,馬公市,烏崁里,39,989,372,94,466,48,514
公投第８案,澎湖縣,馬公市,鐵線里,40,591,229,68,297,32,329
公投第８案,澎湖縣,馬公市,鎖港里,41,1387,440,150,590,67,657
公投第８案,澎湖縣,馬公市,鎖港里,42,1079,303,95,398,65,463
公投第８案,澎湖縣,馬公市,山水里,43,797,283,68,351,46,397
公投第８案,澎湖縣,馬公市,山水里,44,903,292,62,354,25,379
公投第８案,澎湖縣,馬公市,五德里,45,376,105,45,150,24,174
公投第８案,澎湖縣,馬公市,井垵里,46,371,131,41,172,22,194
公投第８案,澎湖縣,馬公市,嵵裡里,47,1173,339,84,423,17,440
公投第８案,澎湖縣,馬公市,風櫃里,48,1389,315,98,413,31,444
公投第８案,澎湖縣,馬公市,虎井里,49,761,112,40,152,61,213
公投第８案,澎湖縣,馬公市,桶盤里,50,288,116,38,154,22,176
公投第８案,澎湖縣,湖西鄉,湖西村,51,1120,427,87,514,58,572
公投第８案,澎湖縣,湖西鄉,湖東村,52,332,99,28,127,13,140
公投第８案,澎湖縣,湖西鄉,青螺村,53,242,63,21,84,3,87
公投第８案,澎湖縣,湖西鄉,白坑村,54,293,64,26,90,9,99
公投第８案,澎湖縣,湖西鄉,南寮村,55,666,173,51,224,49,273
公投第８案,澎湖縣,湖西鄉,北寮村,56,326,115,29,144,18,162
公投第８案,澎湖縣,湖西鄉,紅羅村,57,732,191,55,246,17,263
公投第８案,澎湖縣,湖西鄉,西溪村,58,651,222,50,272,25,297
公投第８案,澎湖縣,湖西鄉,成功村,59,744,240,53,293,15,308
公投第８案,澎湖縣,湖西鄉,東石村,60,134,53,16,69,5,74
公投第８案,澎湖縣,湖西鄉,沙港村,61,794,189,49,238,21,259
公投第８案,澎湖縣,湖西鄉,中西村,62,216,65,12,77,1,78
公投第８案,澎湖縣,湖西鄉,鼎灣村,63,664,153,31,184,9,193
公投第８案,澎湖縣,湖西鄉,潭邊村,64,279,98,22,120,10,130
公投第８案,澎湖縣,湖西鄉,許家村,65,296,108,30,138,7,145
公投第８案,澎湖縣,湖西鄉,城北村,66,257,96,17,113,5,118
公投第８案,澎湖縣,湖西鄉,太武村,67,89,22,4,26,1,27
公投第８案,澎湖縣,湖西鄉,隘門村,68,815,254,97,351,31,382
公投第８案,澎湖縣,湖西鄉,林投村,69,975,278,73,351,28,379
公投第８案,澎湖縣,湖西鄉,尖山村,70,648,201,76,277,39,316
公投第８案,澎湖縣,湖西鄉,龍門村,71,893,262,69,331,24,355
公投第８案,澎湖縣,湖西鄉,龍門村,72,846,274,86,360,78,438
公投第８案,澎湖縣,湖西鄉,菓葉村,73,729,178,53,231,19,250
公投第８案,澎湖縣,白沙鄉,中屯村,74,514,158,77,235,20,255
公投第８案,澎湖縣,白沙鄉,講美村,75,657,252,56,308,19,327
公投第８案,澎湖縣,白沙鄉,城前村,76,109,53,15,68,4,72
公投第８案,澎湖縣,白沙鄉,鎮海村,77,156,51,8,59,6,65
公投第８案,澎湖縣,白沙鄉,港子村,78,293,83,32,115,5,120
公投第８案,澎湖縣,白沙鄉,岐頭村,79,231,49,16,65,2,67
公投第８案,澎湖縣,白沙鄉,小赤村,80,161,49,25,74,12,86
公投第８案,澎湖縣,白沙鄉,赤崁村,81,1705,572,150,722,58,780
公投第８案,澎湖縣,白沙鄉,瓦硐村,82,285,80,32,112,9,121
公投第８案,澎湖縣,白沙鄉,後寮村,83,723,142,59,201,10,211
公投第８案,澎湖縣,白沙鄉,通梁村,84,774,201,52,253,33,286
公投第８案,澎湖縣,白沙鄉,吉貝村,85,1429,261,113,374,113,487
公投第８案,澎湖縣,白沙鄉,鳥嶼村,86,1084,351,74,425,73,498
公投第８案,澎湖縣,白沙鄉,員貝村,87,251,96,23,119,6,125
公投第８案,澎湖縣,白沙鄉,大倉村,88,253,45,24,69,19,88
公投第８案,澎湖縣,西嶼鄉,橫礁村,89,283,29,12,41,0,41
公投第８案,澎湖縣,西嶼鄉,合界村,90,424,84,20,104,17,121
公投第８案,澎湖縣,西嶼鄉,竹灣村,91,826,173,55,228,56,284
公投第８案,澎湖縣,西嶼鄉,小門村,92,282,71,22,93,10,103
公投第８案,澎湖縣,西嶼鄉,大池村,93,661,150,45,195,55,250
公投第８案,澎湖縣,西嶼鄉,二崁村,94,141,13,9,22,5,27
公投第８案,澎湖縣,西嶼鄉,池東村,95,635,137,28,165,8,173
公投第８案,澎湖縣,西嶼鄉,池西村,96,216,46,16,62,4,66
公投第８案,澎湖縣,西嶼鄉,赤馬村,97,572,78,28,106,23,129
公投第８案,澎湖縣,西嶼鄉,內垵村,98,1267,320,83,403,93,496
公投第８案,澎湖縣,西嶼鄉,外垵村,99,942,264,51,315,30,345
公投第８案,澎湖縣,西嶼鄉,外垵村,100,1133,253,92,345,81,426
公投第８案,澎湖縣,望安鄉,東安村,101,734,233,57,290,37,327
公投第８案,澎湖縣,望安鄉,西安村,102,454,141,23,164,26,190
公投第８案,澎湖縣,望安鄉,中社村,103,300,63,16,79,13,92
公投第８案,澎湖縣,望安鄉,水垵村,104,471,151,42,193,44,237
公投第８案,澎湖縣,望安鄉,將軍村,105,672,144,37,181,22,203
公投第８案,澎湖縣,望安鄉,將軍村,106,742,175,73,248,50,298
公投第８案,澎湖縣,望安鄉,東吉村,107,264,63,26,89,19,108
公投第８案,澎湖縣,望安鄉,東坪村,108,476,127,34,161,8,169
公投第８案,澎湖縣,望安鄉,西坪村,109,208,26,10,36,5,41
公投第８案,澎湖縣,望安鄉,花嶼村,110,307,69,15,84,8,92
公投第８案,澎湖縣,七美鄉,東湖村,111,248,50,12,62,4,66
公投第８案,澎湖縣,七美鄉,西湖村,112,581,131,40,171,33,204
公投第８案,澎湖縣,七美鄉,中和村,113,641,138,52,190,34,224
公投第８案,澎湖縣,七美鄉,平和村,114,382,76,28,104,7,111
公投第８案,澎湖縣,七美鄉,海豐村,115,351,51,15,66,6,72
公投第８案,澎湖縣,七美鄉,南港村,116,1171,221,64,285,30,315
公投第８案,基隆市,中正區,長潭里,1,466,175,53,228,17,245
公投第８案,基隆市,中正區,砂子里,2,1262,372,126,498,25,523
公投第８案,基隆市,中正區,砂子里,3,1171,343,146,489,66,555
公投第８案,基隆市,中正區,砂子里,4,2823,846,179,1025,30,1055
公投第８案,基隆市,中正區,八斗里,5,1474,437,141,578,51,629
公投第８案,基隆市,中正區,碧砂里,6,1271,395,90,485,63,548
公投第８案,基隆市,中正區,新富里,7,2707,829,255,1084,73,1157
公投第８案,基隆市,中正區,新富里,8,1545,562,117,679,71,750
公投第８案,基隆市,中正區,新富里,9,761,220,39,259,13,272
公投第８案,基隆市,中正區,新豐里,10,1352,500,124,624,18,642
公投第８案,基隆市,中正區,新豐里,11,1413,513,111,624,19,643
公投第８案,基隆市,中正區,新豐里,12,2665,883,213,1096,48,1144
公投第８案,基隆市,中正區,平寮里,13,1261,364,145,509,76,585
公投第８案,基隆市,中正區,社寮里,14,1753,590,198,788,86,874
公投第８案,基隆市,中正區,和憲里,15,984,301,99,400,42,442
公投第８案,基隆市,中正區,海濱里,16,1166,385,92,477,28,505
公投第８案,基隆市,中正區,正濱里,17,973,342,100,442,29,471
公投第８案,基隆市,中正區,中正里,18,1694,447,142,589,21,610
公投第８案,基隆市,中正區,中濱里,19,1270,464,133,597,34,631
公投第８案,基隆市,中正區,建國里,20,1090,419,119,538,26,564
公投第８案,基隆市,中正區,建國里,21,870,331,91,422,24,446
公投第８案,基隆市,中正區,砂灣里,22,1138,411,110,521,50,571
公投第８案,基隆市,中正區,砂灣里,23,862,292,40,332,48,380
公投第８案,基隆市,中正區,真砂里,24,1341,526,90,616,68,684
公投第８案,基隆市,中正區,正砂里,25,859,315,107,422,40,462
公投第８案,基隆市,中正區,正砂里,26,1457,496,135,631,32,663
公投第８案,基隆市,中正區,中砂里,27,1594,458,128,586,64,650
公投第８案,基隆市,中正區,入船里,28,802,293,89,382,45,427
公投第８案,基隆市,中正區,正船里,29,1267,441,128,569,47,616
公投第８案,基隆市,中正區,中船里,30,1175,417,131,548,70,618
公投第８案,基隆市,中正區,港通里,31,1210,492,135,627,47,674
公投第８案,基隆市,中正區,義重里,32,1037,351,131,482,58,540
公投第８案,基隆市,中正區,正義里,33,1219,444,132,576,57,633
公投第８案,基隆市,中正區,信義里,34,904,306,108,414,18,432
公投第８案,基隆市,中正區,德義里,35,709,315,90,405,34,439
公投第８案,基隆市,信義區,仁壽里,36,1096,423,122,545,42,587
公投第８案,基隆市,信義區,仁義里,37,1232,525,142,667,47,714
公投第８案,基隆市,信義區,義昭里,38,1184,483,135,618,19,637
公投第８案,基隆市,信義區,義幸里,39,1133,494,108,602,62,664
公投第８案,基隆市,信義區,義幸里,40,1188,473,140,613,45,658
公投第８案,基隆市,信義區,義民里,41,725,287,98,385,37,422
公投第８案,基隆市,信義區,義和里,42,1524,511,157,668,52,720
公投第８案,基隆市,信義區,智慧里,43,736,285,85,370,31,401
公投第８案,基隆市,信義區,智誠里,44,611,215,70,285,23,308
公投第８案,基隆市,信義區,智誠里,45,951,323,85,408,20,428
公投第８案,基隆市,信義區,禮儀里,46,1616,621,170,791,41,832
公投第８案,基隆市,信義區,禮東里,47,1516,621,152,773,42,815
公投第８案,基隆市,信義區,信綠里,48,1049,301,107,408,29,437
公投第８案,基隆市,信義區,信綠里,49,1069,403,118,521,30,551
公投第８案,基隆市,信義區,東信里,50,727,306,79,385,35,420
公投第８案,基隆市,信義區,東信里,51,929,425,96,521,22,543
公投第８案,基隆市,信義區,東信里,52,1118,510,143,653,37,690
公投第８案,基隆市,信義區,東信里,53,1339,569,133,702,49,751
公投第８案,基隆市,信義區,東光里,54,999,394,87,481,25,506
公投第８案,基隆市,信義區,東光里,55,764,291,71,362,16,378
公投第８案,基隆市,信義區,東明里,56,1555,565,146,711,36,747
公投第８案,基隆市,信義區,東明里,57,2015,768,65,833,37,870
公投第８案,基隆市,信義區,東安里,58,1268,538,133,671,47,718
公投第８案,基隆市,信義區,東安里,59,1569,610,162,772,54,826
公投第８案,基隆市,信義區,孝賢里,60,1985,722,164,886,67,953
公投第８案,基隆市,信義區,孝賢里,61,1476,640,129,769,31,800
公投第８案,基隆市,信義區,孝忠里,62,1493,651,151,802,34,836
公投第８案,基隆市,信義區,孝忠里,63,1249,599,127,726,25,751
公投第８案,基隆市,信義區,孝忠里,64,1559,627,136,763,25,788
公投第８案,基隆市,信義區,孝忠里,65,1168,452,87,539,16,555
公投第８案,基隆市,信義區,孝忠里,66,1602,655,133,788,36,824
公投第８案,基隆市,信義區,孝德里,67,1485,516,128,644,39,683
公投第８案,基隆市,信義區,孝德里,68,1009,398,81,479,26,505
公投第８案,基隆市,信義區,孝深里,69,2016,669,146,815,41,856
公投第８案,基隆市,信義區,孝深里,70,1764,577,110,687,39,726
公投第８案,基隆市,信義區,孝岡里,71,1295,511,136,647,45,692
公投第８案,基隆市,仁愛區,林泉里,72,1782,568,144,712,106,818
公投第８案,基隆市,仁愛區,花崗里,73,1055,397,133,530,64,594
公投第８案,基隆市,仁愛區,虹橋里,74,1558,545,147,692,39,731
公投第８案,基隆市,仁愛區,水錦里,75,1736,654,191,845,48,893
公投第８案,基隆市,仁愛區,智仁里,76,1243,504,177,681,52,733
公投第８案,基隆市,仁愛區,智仁里,77,1109,438,137,575,45,620
公投第８案,基隆市,仁愛區,和明里,78,1684,763,161,924,39,963
公投第８案,基隆市,仁愛區,忠勇里,79,919,339,111,450,40,490
公投第８案,基隆市,仁愛區,玉田里,80,991,347,116,463,25,488
公投第８案,基隆市,仁愛區,仁德里,81,876,346,96,442,19,461
公投第８案,基隆市,仁愛區,博愛里,82,1046,423,131,554,52,606
公投第８案,基隆市,仁愛區,博愛里,83,434,189,51,240,23,263
公投第８案,基隆市,仁愛區,福仁里,84,764,300,91,391,58,449
公投第８案,基隆市,仁愛區,誠仁里,85,968,337,126,463,28,491
公投第８案,基隆市,仁愛區,吉仁里,86,1326,439,165,604,72,676
公投第８案,基隆市,仁愛區,吉仁里,87,1315,383,126,509,35,544
公投第８案,基隆市,仁愛區,育仁里,88,775,292,104,396,51,447
公投第８案,基隆市,仁愛區,英仁里,89,652,234,84,318,55,373
公投第８案,基隆市,仁愛區,英仁里,90,674,270,71,341,36,377
公投第８案,基隆市,仁愛區,龍門里,91,789,288,82,370,41,411
公投第８案,基隆市,仁愛區,德厚里,92,1715,630,195,825,76,901
公投第８案,基隆市,仁愛區,曲水里,93,849,295,109,404,48,452
公投第８案,基隆市,仁愛區,崇文里,94,875,342,85,427,38,465
公投第８案,基隆市,仁愛區,文安里,95,851,292,99,391,42,433
公投第８案,基隆市,仁愛區,兆連里,96,735,308,90,398,28,426
公投第８案,基隆市,仁愛區,獅球里,97,1009,337,124,461,73,534
公投第８案,基隆市,仁愛區,書院里,98,1082,338,139,477,51,528
公投第８案,基隆市,仁愛區,朝棟里,99,1278,433,147,580,80,660
公投第８案,基隆市,仁愛區,朝棟里,100,1519,667,147,814,50,864
公投第８案,基隆市,仁愛區,光華里,101,1336,419,128,547,47,594
公投第８案,基隆市,仁愛區,光華里,102,1178,481,158,639,61,700
公投第８案,基隆市,仁愛區,明德里,103,708,268,68,336,42,378
公投第８案,基隆市,仁愛區,同風里,104,567,231,93,324,30,354
公投第８案,基隆市,仁愛區,文昌里,105,751,240,111,351,59,410
公投第８案,基隆市,仁愛區,新店里,106,589,236,88,324,29,353
公投第８案,基隆市,中山區,新建里,107,796,279,107,386,20,406
公投第８案,基隆市,中山區,安民里,108,1036,461,127,588,49,637
公投第８案,基隆市,中山區,安平里,109,756,274,115,389,43,432
公投第８案,基隆市,中山區,中山里,110,957,281,101,382,21,403
公投第８案,基隆市,中山區,民治里,111,802,299,94,393,11,404
公投第８案,基隆市,中山區,中興里,112,1263,488,122,610,52,662
公投第８案,基隆市,中山區,仁正里,113,778,324,98,422,20,442
公投第８案,基隆市,中山區,健民里,114,1180,423,150,573,87,660
公投第８案,基隆市,中山區,通化里,115,990,341,85,426,34,460
公投第８案,基隆市,中山區,居仁里,116,1332,386,129,515,32,547
公投第８案,基隆市,中山區,通明里,117,848,274,89,363,29,392
公投第８案,基隆市,中山區,通明里,118,922,312,92,404,22,426
公投第８案,基隆市,中山區,和平里,119,459,180,72,252,19,271
公投第８案,基隆市,中山區,仙洞里,120,574,194,57,251,28,279
公投第８案,基隆市,中山區,太白里,121,877,312,92,404,50,454
公投第８案,基隆市,中山區,協和里,122,1584,480,188,668,39,707
公投第８案,基隆市,中山區,文化里,123,1319,340,109,449,36,485
公投第８案,基隆市,中山區,德安里,124,1938,676,230,906,76,982
公投第８案,基隆市,中山區,德安里,125,1877,639,210,849,53,902
公投第８案,基隆市,中山區,德和里,126,2088,814,144,958,33,991
公投第８案,基隆市,中山區,德和里,127,1946,861,114,975,43,1018
公投第８案,基隆市,中山區,德和里,128,1353,532,172,704,60,764
公投第８案,基隆市,中山區,中和里,129,1317,471,148,619,153,772
公投第８案,基隆市,中山區,中和里,130,870,315,146,461,35,496
公投第８案,基隆市,中山區,中和里,131,1322,565,122,687,35,722
公投第８案,基隆市,中山區,中和里,132,1295,445,130,575,17,592
公投第８案,基隆市,中山區,中和里,133,756,323,106,429,30,459
公投第８案,基隆市,中山區,和慶里,134,1602,515,167,682,26,708
公投第８案,基隆市,中山區,和慶里,135,1568,538,162,700,46,746
公投第８案,基隆市,中山區,和慶里,136,1404,502,192,694,43,737
公投第８案,基隆市,中山區,和慶里,137,1909,650,184,834,25,859
公投第８案,基隆市,中山區,西康里,138,1642,490,181,671,80,751
公投第８案,基隆市,中山區,西定里,139,932,319,90,409,21,430
公投第８案,基隆市,中山區,西華里,140,849,341,123,464,49,513
公投第８案,基隆市,中山區,西榮里,141,715,280,102,382,46,428
公投第８案,基隆市,安樂區,新西里,142,1361,447,142,589,67,656
公投第８案,基隆市,安樂區,西川里,143,1213,419,117,536,43,579
公投第８案,基隆市,安樂區,定國里,144,1026,306,101,407,44,451
公投第８案,基隆市,安樂區,定邦里,145,1038,424,113,537,89,626
公投第８案,基隆市,安樂區,慈仁里,146,897,338,141,479,64,543
公投第８案,基隆市,安樂區,干城里,147,1401,514,158,672,63,735
公投第８案,基隆市,安樂區,干城里,148,641,162,42,204,11,215
公投第８案,基隆市,安樂區,永康里,149,1472,603,84,687,58,745
公投第８案,基隆市,安樂區,永康里,150,472,183,50,233,22,255
公投第８案,基隆市,安樂區,安和里,151,841,354,108,462,28,490
公投第８案,基隆市,安樂區,樂一里,152,571,204,69,273,30,303
公投第８案,基隆市,安樂區,嘉仁里,153,1901,712,121,833,45,878
公投第８案,基隆市,安樂區,嘉仁里,154,1349,462,184,646,49,695
公投第８案,基隆市,安樂區,三民里,155,1225,433,147,580,42,622
公投第８案,基隆市,安樂區,三民里,156,1351,530,166,696,47,743
公投第８案,基隆市,安樂區,壯觀里,157,1601,679,179,858,46,904
公投第８案,基隆市,安樂區,壯觀里,158,2513,1067,211,1278,50,1328
公投第８案,基隆市,安樂區,四維里,159,1613,658,166,824,48,872
公投第８案,基隆市,安樂區,四維里,160,1731,723,179,902,34,936
公投第８案,基隆市,安樂區,四維里,161,1424,617,194,811,27,838
公投第８案,基隆市,安樂區,五福里,162,1806,668,174,842,60,902
公投第８案,基隆市,安樂區,五福里,163,1679,685,196,881,59,940
公投第８案,基隆市,安樂區,六合里,164,1902,718,224,942,40,982
公投第８案,基隆市,安樂區,六合里,165,2040,808,178,986,12,998
公投第８案,基隆市,安樂區,七賢里,166,1313,501,154,655,54,709
公投第８案,基隆市,安樂區,七賢里,167,1243,433,149,582,20,602
公投第８案,基隆市,安樂區,長樂里,168,1759,677,176,853,34,887
公投第８案,基隆市,安樂區,長樂里,169,694,320,99,419,18,437
公投第８案,基隆市,安樂區,長樂里,170,866,397,123,520,29,549
公投第８案,基隆市,安樂區,鶯歌里,171,1557,486,145,631,27,658
公投第８案,基隆市,安樂區,鶯歌里,172,1411,525,158,683,26,709
公投第８案,基隆市,安樂區,鶯安里,173,1568,687,174,861,28,889
公投第８案,基隆市,安樂區,鶯安里,174,1400,532,151,683,42,725
公投第８案,基隆市,安樂區,鶯安里,175,1531,640,124,764,8,772
公投第８案,基隆市,安樂區,興寮里,176,1673,619,144,763,29,792
公投第８案,基隆市,安樂區,興寮里,177,1054,391,118,509,49,558
公投第８案,基隆市,安樂區,興寮里,178,1923,619,155,774,33,807
公投第８案,基隆市,安樂區,外寮里,179,1960,765,224,989,57,1046
公投第８案,基隆市,安樂區,外寮里,180,1962,706,215,921,61,982
公投第８案,基隆市,安樂區,新崙里,181,2117,808,228,1036,59,1095
公投第８案,基隆市,安樂區,新崙里,182,1829,652,187,839,43,882
公投第８案,基隆市,安樂區,武崙里,183,1529,576,127,703,33,736
公投第８案,基隆市,安樂區,武崙里,184,1869,736,188,924,40,964
公投第８案,基隆市,安樂區,武崙里,185,1140,497,107,604,17,621
公投第８案,基隆市,安樂區,中崙里,186,1641,603,200,803,44,847
公投第８案,基隆市,安樂區,內寮里,187,1279,472,150,622,39,661
公投第８案,基隆市,安樂區,內寮里,188,1360,531,135,666,28,694
公投第８案,基隆市,安樂區,內寮里,189,1399,551,164,715,45,760
公投第８案,基隆市,安樂區,內寮里,190,1251,457,141,598,29,627
公投第８案,基隆市,暖暖區,八西里,191,1431,506,146,652,46,698
公投第８案,基隆市,暖暖區,八中里,192,456,145,42,187,11,198
公投第８案,基隆市,暖暖區,八堵里,193,637,245,81,326,24,350
公投第８案,基隆市,暖暖區,八南里,194,735,302,94,396,28,424
公投第８案,基隆市,暖暖區,過港里,195,1078,377,97,474,30,504
公投第８案,基隆市,暖暖區,過港里,196,1238,435,146,581,44,625
公投第８案,基隆市,暖暖區,過港里,197,1325,490,138,628,44,672
公投第８案,基隆市,暖暖區,暖暖里,198,1475,575,154,729,43,772
公投第８案,基隆市,暖暖區,暖暖里,199,1179,383,112,495,34,529
公投第８案,基隆市,暖暖區,暖同里,200,1110,478,129,607,41,648
公投第８案,基隆市,暖暖區,暖同里,201,1443,465,150,615,34,649
公投第８案,基隆市,暖暖區,暖東里,202,415,140,59,199,23,222
公投第８案,基隆市,暖暖區,暖西里,203,1378,515,122,637,20,657
公投第８案,基隆市,暖暖區,暖西里,204,1570,605,182,787,28,815
公投第８案,基隆市,暖暖區,暖西里,205,1603,693,186,879,61,940
公投第８案,基隆市,暖暖區,碇內里,206,1267,517,143,660,50,710
公投第８案,基隆市,暖暖區,碇內里,207,1359,547,133,680,34,714
公投第８案,基隆市,暖暖區,碇和里,208,970,455,82,537,22,559
公投第８案,基隆市,暖暖區,碇和里,209,1002,405,83,488,20,508
公投第８案,基隆市,暖暖區,碇和里,210,944,352,87,439,28,467
公投第８案,基隆市,暖暖區,碇祥里,211,1500,623,174,797,43,840
公投第８案,基隆市,暖暖區,碇祥里,212,1442,448,100,548,28,576
公投第８案,基隆市,暖暖區,碇祥里,213,1165,473,124,597,26,623
公投第８案,基隆市,暖暖區,碇祥里,214,1610,529,248,777,24,801
公投第８案,基隆市,暖暖區,碇安里,215,1328,544,149,693,29,722
公投第８案,基隆市,暖暖區,碇安里,216,1173,438,125,563,23,586
公投第８案,基隆市,暖暖區,碇安里,217,1019,454,109,563,36,599
公投第８案,基隆市,暖暖區,碇安里,218,1373,564,132,696,19,715
公投第８案,基隆市,七堵區,長興里,219,1258,477,167,644,61,705
公投第８案,基隆市,七堵區,長興里,220,1237,499,140,639,45,684
公投第８案,基隆市,七堵區,長興里,221,1259,466,140,606,33,639
公投第８案,基隆市,七堵區,正光里,222,1120,358,144,502,53,555
公投第８案,基隆市,七堵區,正光里,223,1344,449,138,587,52,639
公投第８案,基隆市,七堵區,正明里,224,1011,427,142,569,47,616
公投第８案,基隆市,七堵區,正明里,225,925,329,111,440,23,463
公投第８案,基隆市,七堵區,富民里,226,1735,713,189,902,66,968
公投第８案,基隆市,七堵區,富民里,227,1833,732,239,971,62,1033
公投第８案,基隆市,七堵區,永平里,228,938,339,124,463,24,487
公投第８案,基隆市,七堵區,永平里,229,962,395,126,521,51,572
公投第８案,基隆市,七堵區,永安里,230,1191,481,144,625,45,670
公投第８案,基隆市,七堵區,永安里,231,999,422,95,517,48,565
公投第８案,基隆市,七堵區,八德里,232,282,105,21,126,12,138
公投第８案,基隆市,七堵區,八德里,233,1243,437,153,590,55,645
公投第８案,基隆市,七堵區,自強里,234,1092,389,130,519,40,559
公投第８案,基隆市,七堵區,泰安里,235,1246,470,154,624,44,668
公投第８案,基隆市,七堵區,泰安里,236,1722,636,186,822,53,875
公投第８案,基隆市,七堵區,泰安里,237,1318,508,131,639,41,680
公投第８案,基隆市,七堵區,六堵里,238,975,330,101,431,21,452
公投第８案,基隆市,七堵區,六堵里,239,1285,473,168,641,30,671
公投第８案,基隆市,七堵區,堵南里,240,1077,352,113,465,52,517
公投第８案,基隆市,七堵區,堵南里,241,989,322,110,432,36,468
公投第８案,基隆市,七堵區,長安里,242,1193,398,152,550,43,593
公投第８案,基隆市,七堵區,長安里,243,1273,442,168,610,57,667
公投第８案,基隆市,七堵區,堵北里,244,1774,660,206,866,80,946
公投第８案,基隆市,七堵區,堵北里,245,1689,639,204,843,104,947
公投第８案,基隆市,七堵區,百福里,246,1355,480,145,625,61,686
公投第８案,基隆市,七堵區,百福里,247,1512,533,169,702,61,763
公投第８案,基隆市,七堵區,百福里,248,1486,505,165,670,26,696
公投第８案,基隆市,七堵區,百福里,249,1706,651,172,823,25,848
公投第８案,基隆市,七堵區,實踐里,250,1384,624,50,674,63,737
公投第８案,基隆市,七堵區,實踐里,251,1045,408,169,577,48,625
公投第８案,基隆市,七堵區,實踐里,252,1374,538,155,693,38,731
公投第８案,基隆市,七堵區,瑪南里,253,428,154,51,205,12,217
公投第８案,基隆市,七堵區,瑪東里,254,326,119,54,173,23,196
公投第８案,基隆市,七堵區,瑪西里,255,351,178,50,228,18,246
公投第８案,基隆市,七堵區,友一里,256,1871,660,166,826,38,864
公投第８案,基隆市,七堵區,友二里,257,448,144,47,191,7,198
公投第８案,新竹市,東區,育賢里,1,1512,362,128,490,21,511
公投第８案,新竹市,東區,親仁里,2,953,446,111,557,25,582
公投第８案,新竹市,東區,親仁里,3,729,308,83,391,29,420
公投第８案,新竹市,東區,東門里,4,566,225,100,325,27,352
公投第８案,新竹市,東區,成功里,5,640,239,99,338,26,364
公投第８案,新竹市,東區,榮光里,6,305,96,50,146,24,170
公投第８案,新竹市,東區,中正里,7,563,229,84,313,24,337
公投第８案,新竹市,東區,錦華里,8,741,290,95,385,19,404
公投第８案,新竹市,東區,錦華里,9,1041,439,138,577,23,600
公投第８案,新竹市,東區,文華里,10,1615,658,175,833,37,870
公投第８案,新竹市,東區,文華里,11,1287,546,147,693,44,737
公投第８案,新竹市,東區,文華里,12,1554,640,212,852,23,875
公投第８案,新竹市,東區,復中里,13,1388,605,177,782,19,801
公投第８案,新竹市,東區,復中里,14,1419,591,201,792,38,830
公投第８案,新竹市,東區,復中里,15,1355,517,172,689,64,753
公投第８案,新竹市,東區,復興里,16,1490,591,191,782,38,820
公投第８案,新竹市,東區,復興里,17,1615,683,186,869,28,897
公投第８案,新竹市,東區,復興里,18,1672,638,208,846,48,894
公投第８案,新竹市,東區,三民里,19,1062,454,126,580,31,611
公投第８案,新竹市,東區,三民里,20,1315,545,162,707,44,751
公投第８案,新竹市,東區,三民里,21,1000,414,133,547,47,594
公投第８案,新竹市,東區,三民里,22,1337,560,189,749,42,791
公投第８案,新竹市,東區,東園里,23,1747,718,197,915,36,951
公投第８案,新竹市,東區,東園里,24,1600,679,239,918,39,957
公投第８案,新竹市,東區,東園里,25,1158,479,145,624,33,657
公投第８案,新竹市,東區,東園里,26,828,368,140,508,33,541
公投第８案,新竹市,東區,公園里,27,1573,633,184,817,53,870
公投第８案,新竹市,東區,公園里,28,1550,641,192,833,53,886
公投第８案,新竹市,東區,建華里,29,1317,499,192,691,30,721
公投第８案,新竹市,東區,建華里,30,1040,424,174,598,44,642
公投第８案,新竹市,東區,東山里,31,935,417,100,517,23,540
公投第８案,新竹市,東區,東山里,32,1074,444,126,570,23,593
公投第８案,新竹市,東區,東山里,33,1133,500,144,644,44,688
公投第８案,新竹市,東區,綠水里,34,1262,551,153,704,52,756
公投第８案,新竹市,東區,綠水里,35,1199,506,148,654,25,679
公投第８案,新竹市,東區,綠水里,36,1226,553,165,718,32,750
公投第８案,新竹市,東區,綠水里,37,1377,629,192,821,54,875
公投第８案,新竹市,東區,綠水里,38,991,454,146,600,29,629
公投第８案,新竹市,東區,東勢里,39,1271,489,193,682,79,761
公投第８案,新竹市,東區,東勢里,40,1012,502,122,624,26,650
公投第８案,新竹市,東區,光復里,41,1001,405,124,529,59,588
公投第８案,新竹市,東區,光復里,42,1603,604,194,798,56,854
公投第８案,新竹市,東區,前溪里,43,1236,460,183,643,41,684
公投第８案,新竹市,東區,前溪里,44,1532,525,152,677,49,726
公投第８案,新竹市,東區,水源里,45,1306,513,157,670,46,716
公投第８案,新竹市,東區,水源里,46,1073,424,137,561,69,630
公投第８案,新竹市,東區,水源里,47,952,360,135,495,18,513
公投第８案,新竹市,東區,千甲里,48,1298,428,136,564,36,600
公投第８案,新竹市,東區,千甲里,49,778,322,75,397,15,412
公投第８案,新竹市,東區,豐功里,50,1195,478,189,667,38,705
公投第８案,新竹市,東區,豐功里,51,1569,584,215,799,67,866
公投第８案,新竹市,東區,豐功里,52,1533,726,191,917,41,958
公投第８案,新竹市,東區,武功里,53,1336,629,132,761,51,812
公投第８案,新竹市,東區,武功里,54,1367,652,102,754,52,806
公投第８案,新竹市,東區,武功里,55,1289,609,142,751,36,787
公投第８案,新竹市,東區,軍功里,56,960,385,115,500,26,526
公投第８案,新竹市,東區,軍功里,57,843,395,112,507,27,534
公投第８案,新竹市,東區,軍功里,58,948,445,97,542,48,590
公投第８案,新竹市,東區,立功里,59,915,393,87,480,36,516
公投第８案,新竹市,東區,建功里,60,1801,833,155,988,45,1033
公投第８案,新竹市,東區,建功里,61,1079,439,121,560,37,597
公投第８案,新竹市,東區,建功里,62,676,337,62,399,14,413
公投第８案,新竹市,東區,光明里,63,1132,475,145,620,54,674
公投第８案,新竹市,東區,光明里,64,251,93,44,137,13,150
公投第８案,新竹市,東區,光明里,65,1620,655,210,865,59,924
公投第８案,新竹市,東區,龍山里,66,1479,576,184,760,40,800
公投第８案,新竹市,東區,龍山里,67,1402,528,194,722,32,754
公投第８案,新竹市,東區,龍山里,68,1280,513,169,682,51,733
公投第８案,新竹市,東區,龍山里,69,1228,530,172,702,23,725
公投第８案,新竹市,東區,龍山里,70,1157,456,155,611,7,618
公投第８案,新竹市,東區,龍山里,71,1354,562,178,740,29,769
公投第８案,新竹市,東區,科園里,72,1334,615,210,825,43,868
公投第８案,新竹市,東區,科園里,73,1234,561,128,689,34,723
公投第８案,新竹市,東區,科園里,74,1398,673,167,840,42,882
公投第８案,新竹市,東區,科園里,75,928,383,156,539,29,568
公投第８案,新竹市,東區,科園里,76,1368,647,161,808,32,840
公投第８案,新竹市,東區,埔頂里,77,1215,465,134,599,27,626
公投第８案,新竹市,東區,埔頂里,78,1067,364,129,493,39,532
公投第８案,新竹市,東區,埔頂里,79,1194,449,181,630,21,651
公投第８案,新竹市,東區,埔頂里,80,1193,446,167,613,28,641
公投第８案,新竹市,東區,新莊里,81,1388,564,169,733,72,805
公投第８案,新竹市,東區,新莊里,82,1267,543,158,701,32,733
公投第８案,新竹市,東區,新莊里,83,1299,569,129,698,27,725
公投第８案,新竹市,東區,新莊里,84,1288,504,191,695,44,739
公投第８案,新竹市,東區,關新里,85,1228,526,192,718,26,744
公投第８案,新竹市,東區,關新里,86,1135,503,166,669,17,686
公投第８案,新竹市,東區,關新里,87,1237,564,199,763,25,788
公投第８案,新竹市,東區,關東里,88,1135,437,126,563,46,609
公投第８案,新竹市,東區,關東里,89,1165,458,108,566,20,586
公投第８案,新竹市,東區,關東里,90,1124,450,139,589,27,616
公投第８案,新竹市,東區,關東里,91,1210,508,165,673,42,715
公投第８案,新竹市,東區,金山里,92,1323,522,146,668,46,714
公投第８案,新竹市,東區,金山里,93,1207,494,116,610,17,627
公投第８案,新竹市,東區,金山里,94,1264,452,123,575,39,614
公投第８案,新竹市,東區,金山里,95,1248,503,152,655,26,681
公投第８案,新竹市,東區,仙水里,96,1400,645,170,815,35,850
公投第８案,新竹市,東區,仙水里,97,1473,630,207,837,28,865
公投第８案,新竹市,東區,仙水里,98,1367,577,144,721,50,771
公投第８案,新竹市,東區,仙宮里,99,1233,521,152,673,25,698
公投第８案,新竹市,東區,關帝里,100,507,180,69,249,20,269
公投第８案,新竹市,東區,南門里,101,714,289,95,384,36,420
公投第８案,新竹市,東區,南市里,102,875,334,139,473,53,526
公投第８案,新竹市,東區,福德里,103,1396,558,181,739,53,792
公投第８案,新竹市,東區,振興里,104,1232,457,149,606,43,649
公投第８案,新竹市,東區,振興里,105,1323,480,186,666,47,713
公投第８案,新竹市,東區,振興里,106,1516,511,158,669,25,694
公投第８案,新竹市,東區,振興里,107,1453,561,141,702,43,745
公投第８案,新竹市,東區,新興里,108,880,325,146,471,46,517
公投第８案,新竹市,東區,新興里,109,1058,416,115,531,26,557
公投第８案,新竹市,東區,新興里,110,1061,408,152,560,37,597
公投第８案,新竹市,東區,寺前里,111,710,264,97,361,40,401
公投第８案,新竹市,東區,竹蓮里,112,752,293,109,402,51,453
公投第８案,新竹市,東區,下竹里,113,475,219,61,280,20,300
公投第８案,新竹市,東區,頂竹里,114,880,335,114,449,35,484
公投第８案,新竹市,東區,頂竹里,115,989,398,137,535,38,573
公投第８案,新竹市,東區,頂竹里,116,1059,427,142,569,42,611
公投第８案,新竹市,東區,南大里,117,607,223,104,327,43,370
公投第８案,新竹市,東區,南大里,118,815,317,126,443,32,475
公投第８案,新竹市,東區,新光里,119,777,348,92,440,40,480
公投第８案,新竹市,東區,新光里,120,1399,479,161,640,35,675
公投第８案,新竹市,東區,新光里,121,1216,467,171,638,40,678
公投第８案,新竹市,東區,光鎮里,122,1062,372,136,508,42,550
公投第８案,新竹市,東區,光鎮里,123,1046,430,132,562,30,592
公投第８案,新竹市,東區,光鎮里,124,1332,516,144,660,21,681
公投第８案,新竹市,東區,高峰里,125,1350,539,188,727,50,777
公投第８案,新竹市,東區,高峰里,126,1438,554,148,702,21,723
公投第８案,新竹市,東區,高峰里,127,1414,504,159,663,55,718
公投第８案,新竹市,東區,高峰里,128,1476,604,199,803,31,834
公投第８案,新竹市,東區,湖濱里,129,1326,585,180,765,47,812
公投第８案,新竹市,東區,湖濱里,130,927,435,117,552,22,574
公投第８案,新竹市,東區,湖濱里,131,1273,479,201,680,28,708
公投第８案,新竹市,東區,柴橋里,132,1315,498,152,650,37,687
公投第８案,新竹市,東區,柴橋里,133,1413,580,172,752,37,789
公投第８案,新竹市,東區,柴橋里,134,1064,450,128,578,25,603
公投第８案,新竹市,東區,柴橋里,135,1244,566,192,758,24,782
公投第８案,新竹市,東區,明湖里,136,1160,438,138,576,6,582
公投第８案,新竹市,東區,明湖里,137,1398,509,150,659,24,683
公投第８案,新竹市,東區,明湖里,138,1384,428,120,548,21,569
公投第８案,新竹市,東區,明湖里,139,874,386,115,501,32,533
公投第８案,新竹市,北區,中央里,140,477,152,70,222,11,233
公投第８案,新竹市,北區,西門里,141,535,205,89,294,27,321
公投第８案,新竹市,北區,潛園里,142,746,249,137,386,58,444
公投第８案,新竹市,北區,石坊里,143,546,192,62,254,21,275
公投第８案,新竹市,北區,仁德里,144,711,308,98,406,35,441
公投第８案,新竹市,北區,崇禮里,145,1143,394,128,522,42,564
公投第８案,新竹市,北區,興南里,146,1370,502,169,671,40,711
公投第８案,新竹市,北區,育英里,147,1390,526,190,716,37,753
公投第８案,新竹市,北區,育英里,148,962,385,120,505,8,513
公投第８案,新竹市,北區,育英里,149,1237,471,163,634,27,661
公投第８案,新竹市,北區,台溪里,150,1604,565,177,742,50,792
公投第８案,新竹市,北區,曲溪里,151,758,270,75,345,16,361
公投第８案,新竹市,北區,曲溪里,152,1320,505,127,632,30,662
公投第８案,新竹市,北區,曲溪里,153,1519,533,162,695,60,755
公投第８案,新竹市,北區,曲溪里,154,347,86,36,122,10,132
公投第８案,新竹市,北區,曲溪里,155,1212,513,150,663,49,712
公投第８案,新竹市,北區,西雅里,156,1484,555,170,725,44,769
公投第８案,新竹市,北區,西雅里,157,1428,501,197,698,72,770
公投第８案,新竹市,北區,客雅里,158,1128,454,147,601,26,627
公投第８案,新竹市,北區,客雅里,159,638,248,76,324,17,341
公投第８案,新竹市,北區,中雅里,160,1222,573,91,664,44,708
公投第８案,新竹市,北區,中雅里,161,1076,438,119,557,24,581
公投第８案,新竹市,北區,中雅里,162,937,436,133,569,29,598
公投第８案,新竹市,北區,南勢里,163,1394,541,152,693,50,743
公投第８案,新竹市,北區,南勢里,164,1568,536,185,721,42,763
公投第８案,新竹市,北區,南勢里,165,1159,474,176,650,55,705
公投第８案,新竹市,北區,大鵬里,166,252,85,17,102,3,105
公投第８案,新竹市,北區,大同里,167,761,331,104,435,30,465
公投第８案,新竹市,北區,中山里,168,788,316,118,434,35,469
公投第８案,新竹市,北區,中興里,169,561,232,83,315,44,359
公投第８案,新竹市,北區,新民里,170,1558,561,167,728,94,822
公投第８案,新竹市,北區,長和里,171,1398,465,164,629,41,670
公投第８案,新竹市,北區,北門里,172,957,380,116,496,37,533
公投第８案,新竹市,北區,民富里,173,1195,503,129,632,49,681
公投第８案,新竹市,北區,民富里,174,1236,416,147,563,45,608
公投第８案,新竹市,北區,民富里,175,1255,438,167,605,54,659
公投第８案,新竹市,北區,民富里,176,1114,451,144,595,27,622
公投第８案,新竹市,北區,磐石里,177,1396,541,180,721,32,753
公投第８案,新竹市,北區,磐石里,178,1456,556,216,772,62,834
公投第８案,新竹市,北區,磐石里,179,1374,541,165,706,34,740
公投第８案,新竹市,北區,磐石里,180,1070,413,111,524,48,572
公投第８案,新竹市,北區,新雅里,181,1142,431,141,572,67,639
公投第８案,新竹市,北區,新雅里,182,1103,417,117,534,21,555
公投第８案,新竹市,北區,新雅里,183,1190,428,173,601,76,677
公投第８案,新竹市,北區,新雅里,184,1089,527,116,643,28,671
公投第８案,新竹市,北區,文雅里,185,1272,437,123,560,18,578
公投第８案,新竹市,北區,文雅里,186,1306,516,177,693,60,753
公投第８案,新竹市,北區,文雅里,187,1328,539,155,694,48,742
公投第８案,新竹市,北區,水田里,188,1457,564,144,708,44,752
公投第８案,新竹市,北區,水田里,189,1492,558,211,769,58,827
公投第８案,新竹市,北區,光田里,190,1160,491,154,645,55,700
公投第８案,新竹市,北區,光田里,191,971,388,134,522,49,571
公投第８案,新竹市,北區,光華里,192,1401,307,108,415,21,436
公投第８案,新竹市,北區,光華里,193,1340,545,179,724,40,764
公投第８案,新竹市,北區,光華里,194,1371,586,163,749,45,794
公投第８案,新竹市,北區,金華里,195,1267,474,96,570,25,595
公投第８案,新竹市,北區,金華里,196,1073,463,159,622,41,663
公投第８案,新竹市,北區,金華里,197,1159,483,159,642,36,678
公投第８案,新竹市,北區,金華里,198,1294,518,147,665,23,688
公投第８案,新竹市,北區,湳雅里,199,1442,581,168,749,47,796
公投第８案,新竹市,北區,湳雅里,200,1270,513,183,696,29,725
公投第８案,新竹市,北區,金雅里,201,1179,533,180,713,37,750
公投第８案,新竹市,北區,金雅里,202,949,440,118,558,36,594
公投第８案,新竹市,北區,湳中里,203,1163,470,166,636,40,676
公投第８案,新竹市,北區,湳中里,204,1334,520,174,694,22,716
公投第８案,新竹市,北區,湳中里,205,1415,565,178,743,45,788
公投第８案,新竹市,北區,湳中里,206,1305,564,184,748,40,788
公投第８案,新竹市,北區,湳中里,207,1200,533,113,646,36,682
公投第８案,新竹市,北區,舊社里,208,1106,454,136,590,24,614
公投第８案,新竹市,北區,舊社里,209,1044,463,80,543,31,574
公投第８案,新竹市,北區,舊社里,210,1061,426,163,589,38,627
公投第８案,新竹市,北區,舊社里,211,1518,627,195,822,71,893
公投第８案,新竹市,北區,舊社里,212,1220,524,179,703,53,756
公投第８案,新竹市,北區,金竹里,213,1475,633,190,823,14,837
公投第８案,新竹市,北區,金竹里,214,1373,513,175,688,55,743
公投第８案,新竹市,北區,金竹里,215,1450,601,187,788,29,817
公投第８案,新竹市,北區,金竹里,216,1423,642,144,786,40,826
公投第８案,新竹市,北區,武陵里,217,1059,474,101,575,21,596
公投第８案,新竹市,北區,武陵里,218,1130,544,103,647,38,685
公投第８案,新竹市,北區,武陵里,219,1208,589,126,715,32,747
公投第８案,新竹市,北區,武陵里,220,1226,625,109,734,26,760
公投第８案,新竹市,北區,福林里,221,1175,452,181,633,30,663
公投第８案,新竹市,北區,福林里,222,1371,571,157,728,27,755
公投第８案,新竹市,北區,福林里,223,1306,507,158,665,51,716
公投第８案,新竹市,北區,境福里,224,1340,500,165,665,32,697
公投第８案,新竹市,北區,境福里,225,1111,461,152,613,67,680
公投第８案,新竹市,北區,境福里,226,1197,551,148,699,54,753
公投第８案,新竹市,北區,境福里,227,1008,429,104,533,41,574
公投第８案,新竹市,北區,士林里,228,946,361,115,476,23,499
公投第８案,新竹市,北區,士林里,229,705,284,97,381,42,423
公投第８案,新竹市,北區,古賢里,230,848,317,129,446,60,506
公投第８案,新竹市,北區,南寮里,231,1295,506,151,657,28,685
公投第８案,新竹市,北區,南寮里,232,1467,543,153,696,43,739
公投第８案,新竹市,北區,南寮里,233,1659,535,157,692,46,738
公投第８案,新竹市,北區,南寮里,234,1297,486,147,633,52,685
公投第８案,新竹市,北區,康樂里,235,1374,540,174,714,75,789
公投第８案,新竹市,北區,康樂里,236,1457,577,170,747,76,823
公投第８案,新竹市,北區,中寮里,237,1072,469,128,597,36,633
公投第８案,新竹市,北區,中寮里,238,1350,499,167,666,53,719
公投第８案,新竹市,北區,中寮里,239,971,421,138,559,42,601
公投第８案,新竹市,北區,海濱里,240,1450,600,175,775,73,848
公投第８案,新竹市,北區,海濱里,241,895,365,107,472,34,506
公投第８案,新竹市,北區,海濱里,242,1378,577,143,720,36,756
公投第８案,新竹市,北區,港北里,243,1609,548,200,748,87,835
公投第８案,新竹市,北區,舊港里,244,594,222,84,306,40,346
公投第８案,新竹市,香山區,頂埔里,245,1443,561,163,724,54,778
公投第８案,新竹市,香山區,頂埔里,246,1241,489,149,638,47,685
公投第８案,新竹市,香山區,頂埔里,247,1194,481,130,611,29,640
公投第８案,新竹市,香山區,頂埔里,248,1081,460,120,580,15,595
公投第８案,新竹市,香山區,頂福里,249,807,333,94,427,27,454
公投第８案,新竹市,香山區,頂福里,250,1760,701,197,898,55,953
公投第８案,新竹市,香山區,頂福里,251,1635,700,175,875,40,915
公投第８案,新竹市,香山區,中埔里,252,1473,695,100,795,56,851
公投第８案,新竹市,香山區,中埔里,253,1408,620,154,774,23,797
公投第８案,新竹市,香山區,牛埔里,254,1318,463,131,594,22,616
公投第８案,新竹市,香山區,牛埔里,255,1337,604,150,754,50,804
公投第８案,新竹市,香山區,牛埔里,256,1862,731,183,914,39,953
公投第８案,新竹市,香山區,埔前里,257,1067,439,125,564,22,586
公投第８案,新竹市,香山區,埔前里,258,863,385,107,492,36,528
公投第８案,新竹市,香山區,埔前里,259,1198,495,175,670,66,736
公投第８案,新竹市,香山區,樹下里,260,1138,450,174,624,63,687
公投第８案,新竹市,香山區,樹下里,261,957,405,146,551,66,617
公投第８案,新竹市,香山區,浸水里,262,1348,544,170,714,85,799
公投第８案,新竹市,香山區,浸水里,263,1023,487,140,627,59,686
公投第８案,新竹市,香山區,虎林里,264,970,412,104,516,28,544
公投第８案,新竹市,香山區,虎林里,265,1318,516,176,692,53,745
公投第８案,新竹市,香山區,虎山里,266,1088,410,147,557,49,606
公投第８案,新竹市,香山區,虎山里,267,903,316,91,407,22,429
公投第８案,新竹市,香山區,虎山里,268,1012,385,158,543,44,587
公投第８案,新竹市,香山區,虎山里,269,1014,408,128,536,33,569
公投第８案,新竹市,香山區,虎山里,270,1238,522,151,673,24,697
公投第８案,新竹市,香山區,港南里,271,1182,472,123,595,60,655
公投第８案,新竹市,香山區,港南里,272,1331,575,196,771,78,849
公投第８案,新竹市,香山區,東香里,273,976,475,117,592,25,617
公投第８案,新竹市,香山區,東香里,274,834,330,92,422,22,444
公投第８案,新竹市,香山區,東香里,275,919,388,97,485,44,529
公投第８案,新竹市,香山區,東香里,276,1188,510,154,664,36,700
公投第８案,新竹市,香山區,香村里,277,1086,439,135,574,51,625
公投第８案,新竹市,香山區,香村里,278,1144,501,166,667,49,716
公投第８案,新竹市,香山區,香村里,279,1112,496,119,615,41,656
公投第８案,新竹市,香山區,香山里,280,1476,636,171,807,44,851
公投第８案,新竹市,香山區,香山里,281,1291,534,148,682,35,717
公投第８案,新竹市,香山區,香山里,282,1464,751,103,854,50,904
公投第８案,新竹市,香山區,大庄里,283,1427,614,150,764,80,844
公投第８案,新竹市,香山區,大庄里,284,1336,525,183,708,33,741
公投第８案,新竹市,香山區,美山里,285,1131,380,177,557,37,594
公投第８案,新竹市,香山區,朝山里,286,1070,448,132,580,69,649
公投第８案,新竹市,香山區,朝山里,287,1006,426,129,555,60,615
公投第８案,新竹市,香山區,海山里,288,1223,422,98,520,41,561
公投第８案,新竹市,香山區,海山里,289,1119,460,116,576,29,605
公投第８案,新竹市,香山區,鹽水里,290,1400,491,158,649,34,683
公投第８案,新竹市,香山區,內湖里,291,1627,564,148,712,37,749
公投第８案,新竹市,香山區,內湖里,292,1289,457,145,602,42,644
公投第８案,新竹市,香山區,內湖里,293,1409,516,145,661,54,715
公投第８案,新竹市,香山區,南港里,294,814,278,118,396,19,415
公投第８案,新竹市,香山區,中隘里,295,719,279,83,362,36,398
公投第８案,新竹市,香山區,中隘里,296,1065,356,120,476,24,500
公投第８案,新竹市,香山區,南隘里,297,776,318,80,398,30,428
公投第８案,新竹市,香山區,大湖里,298,890,369,102,471,35,506
公投第８案,新竹市,香山區,茄苳里,299,896,319,99,418,27,445
公投第８案,嘉義市,東區,短竹里,1,1025,406,130,536,36,572
公投第８案,嘉義市,東區,短竹里,2,1276,487,147,634,28,662
公投第８案,嘉義市,東區,蘭潭里,3,974,336,110,446,46,492
公投第８案,嘉義市,東區,蘭潭里,4,1175,517,152,669,49,718
公投第８案,嘉義市,東區,東川里,5,702,307,89,396,35,431
公投第８案,嘉義市,東區,東川里,6,1092,437,118,555,21,576
公投第８案,嘉義市,東區,鹿寮里,7,1023,316,120,436,16,452
公投第８案,嘉義市,東區,盧厝里,8,1816,662,195,857,75,932
公投第８案,嘉義市,東區,文雅里,9,1936,350,640,990,72,1062
公投第８案,嘉義市,東區,文雅里,10,1698,698,197,895,35,930
公投第８案,嘉義市,東區,王田里,11,1221,499,158,657,33,690
公投第８案,嘉義市,東區,王田里,12,1113,430,135,565,32,597
公投第８案,嘉義市,東區,長竹里,13,1452,561,214,775,44,819
公投第８案,嘉義市,東區,長竹里,14,1395,581,217,798,53,851
公投第８案,嘉義市,東區,後庄里,15,1453,477,168,645,54,699
公投第８案,嘉義市,東區,後庄里,16,1094,409,121,530,22,552
公投第８案,嘉義市,東區,後庄里,17,1420,574,167,741,43,784
公投第８案,嘉義市,東區,新店里,18,1552,618,239,857,50,907
公投第８案,嘉義市,東區,新店里,19,1558,595,223,818,69,887
公投第８案,嘉義市,東區,新店里,20,1062,412,160,572,44,616
公投第８案,嘉義市,東區,圳頭里,21,1199,444,151,595,58,653
公投第８案,嘉義市,東區,圳頭里,22,1236,497,141,638,31,669
公投第８案,嘉義市,東區,圳頭里,23,890,325,114,439,26,465
公投第８案,嘉義市,東區,圳頭里,24,880,363,127,490,44,534
公投第８案,嘉義市,東區,中山里,25,1189,441,161,602,24,626
公投第８案,嘉義市,東區,中山里,26,669,257,100,357,18,375
公投第８案,嘉義市,東區,太平里,27,1435,552,171,723,52,775
公投第８案,嘉義市,東區,太平里,28,1349,579,195,774,42,816
公投第８案,嘉義市,東區,太平里,29,1455,529,201,730,29,759
公投第８案,嘉義市,東區,東興里,30,915,361,124,485,40,525
公投第８案,嘉義市,東區,東興里,31,952,313,164,477,32,509
公投第８案,嘉義市,東區,華南里,32,941,346,131,477,49,526
公投第８案,嘉義市,東區,華南里,33,1080,361,158,519,29,548
公投第８案,嘉義市,東區,中央里,34,1157,376,128,504,34,538
公投第８案,嘉義市,東區,中央里,35,1053,395,175,570,30,600
公投第８案,嘉義市,東區,朝陽里,36,967,314,116,430,25,455
公投第８案,嘉義市,東區,朝陽里,37,1091,366,146,512,31,543
公投第８案,嘉義市,東區,民族里,38,961,369,133,502,63,565
公投第８案,嘉義市,東區,民族里,39,863,232,91,323,31,354
公投第８案,嘉義市,東區,過溝里,40,1023,437,123,560,52,612
公投第８案,嘉義市,東區,過溝里,41,1078,393,169,562,82,644
公投第８案,嘉義市,東區,新開里,42,938,348,116,464,17,481
公投第８案,嘉義市,東區,新開里,43,1049,398,126,524,39,563
公投第８案,嘉義市,東區,宣信里,44,1360,463,162,625,78,703
公投第８案,嘉義市,東區,興南里,45,1615,461,209,670,111,781
公投第８案,嘉義市,東區,豐年里,46,1267,432,185,617,55,672
公投第８案,嘉義市,東區,芳草里,47,1579,519,158,677,77,754
公投第８案,嘉義市,東區,芳草里,48,1831,646,206,852,89,941
公投第８案,嘉義市,東區,芳安里,49,977,394,116,510,43,553
公投第８案,嘉義市,東區,芳安里,50,1169,384,166,550,41,591
公投第８案,嘉義市,東區,頂寮里,51,1238,465,181,646,91,737
公投第８案,嘉義市,東區,頂寮里,52,1266,606,50,656,22,678
公投第８案,嘉義市,東區,安寮里,53,1429,469,145,614,47,661
公投第８案,嘉義市,東區,安寮里,54,1288,516,162,678,21,699
公投第８案,嘉義市,東區,安業里,55,980,360,141,501,37,538
公投第８案,嘉義市,東區,安業里,56,922,326,120,446,22,468
公投第８案,嘉義市,東區,興村里,57,1133,457,150,607,55,662
公投第８案,嘉義市,東區,興村里,58,1235,493,147,640,53,693
公投第８案,嘉義市,東區,興村里,59,1525,593,162,755,22,777
公投第８案,嘉義市,東區,興安里,60,1170,412,135,547,58,605
公投第８案,嘉義市,東區,興安里,61,1177,499,165,664,75,739
公投第８案,嘉義市,東區,興仁里,62,1207,459,141,600,74,674
公投第８案,嘉義市,東區,興仁里,63,1272,500,165,665,56,721
公投第８案,嘉義市,東區,興仁里,64,1188,418,169,587,87,674
公投第８案,嘉義市,東區,北門里,65,1172,415,131,546,32,578
公投第８案,嘉義市,東區,北門里,66,1020,405,147,552,43,595
公投第８案,嘉義市,東區,林森里,67,1332,531,171,702,59,761
公投第８案,嘉義市,東區,林森里,68,1011,414,161,575,45,620
公投第８案,嘉義市,東區,中庄里,69,1682,586,216,802,72,874
公投第８案,嘉義市,東區,中庄里,70,1567,584,196,780,77,857
公投第８案,嘉義市,東區,頂庄里,71,1207,484,126,610,28,638
公投第８案,嘉義市,東區,頂庄里,72,981,415,115,530,26,556
公投第８案,嘉義市,東區,義教里,73,1395,516,150,666,47,713
公投第８案,嘉義市,東區,義教里,74,1434,458,173,631,17,648
公投第８案,嘉義市,東區,仁義里,75,1404,536,44,580,34,614
公投第８案,嘉義市,東區,仁義里,76,1428,581,149,730,50,780
公投第８案,嘉義市,東區,後湖里,77,1823,546,178,724,24,748
公投第８案,嘉義市,東區,後湖里,78,1570,509,201,710,43,753
公投第８案,嘉義市,東區,荖藤里,79,1282,417,160,577,65,642
公投第８案,嘉義市,東區,荖藤里,80,1571,697,165,862,65,927
公投第８案,嘉義市,東區,荖藤里,81,1533,560,164,724,29,753
公投第８案,嘉義市,西區,書院里,82,885,322,109,431,19,450
公投第８案,嘉義市,西區,書院里,83,1109,401,139,540,63,603
公投第８案,嘉義市,西區,永和里,84,1020,308,139,447,49,496
公投第８案,嘉義市,西區,永和里,85,925,395,125,520,57,577
公投第８案,嘉義市,西區,新富里,86,1671,445,232,677,33,710
公投第８案,嘉義市,西區,文化里,87,1215,443,160,603,40,643
公投第８案,嘉義市,西區,文化里,88,1036,355,130,485,33,518
公投第８案,嘉義市,西區,西榮里,89,1129,352,164,516,40,556
公投第８案,嘉義市,西區,西榮里,90,1127,381,150,531,34,565
公投第８案,嘉義市,西區,番社里,91,1415,480,199,679,56,735
公投第８案,嘉義市,西區,國華里,92,1366,495,152,647,31,678
公投第８案,嘉義市,西區,大溪里,93,1053,415,158,573,68,641
公投第８案,嘉義市,西區,大溪里,94,1067,403,124,527,27,554
公投第８案,嘉義市,西區,磚磘里,95,1575,510,207,717,34,751
公投第８案,嘉義市,西區,磚磘里,96,1865,662,241,903,57,960
公投第８案,嘉義市,西區,福全里,97,1196,401,132,533,49,582
公投第８案,嘉義市,西區,福全里,98,1280,407,147,554,34,588
公投第８案,嘉義市,西區,福全里,99,1629,619,183,802,69,871
公投第８案,嘉義市,西區,福安里,100,1393,519,191,710,88,798
公投第８案,嘉義市,西區,福安里,101,1077,435,148,583,41,624
公投第８案,嘉義市,西區,福安里,102,1694,572,181,753,44,797
公投第８案,嘉義市,西區,新西里,103,841,325,117,442,83,525
公投第８案,嘉義市,西區,新西里,104,1183,405,142,547,6,553
公投第８案,嘉義市,西區,港坪里,105,1000,432,131,563,34,597
公投第８案,嘉義市,西區,港坪里,106,1095,444,151,595,29,624
公投第８案,嘉義市,西區,港坪里,107,1256,497,189,686,36,722
公投第８案,嘉義市,西區,頭港里,108,962,396,107,503,57,560
公投第８案,嘉義市,西區,頭港里,109,865,376,140,516,20,536
公投第８案,嘉義市,西區,西平里,110,1396,479,172,651,67,718
公投第８案,嘉義市,西區,西平里,111,1799,688,213,901,73,974
公投第８案,嘉義市,西區,劉厝里,112,1505,546,147,693,34,727
公投第８案,嘉義市,西區,劉厝里,113,1698,612,190,802,79,881
公投第８案,嘉義市,西區,劉厝里,114,1854,697,217,914,30,944
公投第８案,嘉義市,西區,劉厝里,115,1537,502,142,644,17,661
公投第８案,嘉義市,西區,自強里,116,1604,507,215,722,94,816
公投第８案,嘉義市,西區,美源里,117,944,379,136,515,77,592
公投第８案,嘉義市,西區,美源里,118,1627,632,204,836,87,923
公投第８案,嘉義市,西區,美源里,119,1144,449,165,614,58,672
公投第８案,嘉義市,西區,湖內里,120,1362,509,178,687,53,740
公投第８案,嘉義市,西區,湖內里,121,1279,504,173,677,43,720
公投第８案,嘉義市,西區,湖內里,122,1702,472,214,686,280,966
公投第８案,嘉義市,西區,獅子里,123,1358,564,172,736,60,796
公投第８案,嘉義市,西區,獅子里,124,1360,573,181,754,79,833
公投第８案,嘉義市,西區,紅瓦里,125,1589,607,210,817,76,893
公投第８案,嘉義市,西區,光路里,126,1280,535,172,707,52,759
公投第８案,嘉義市,西區,光路里,127,1220,396,136,532,52,584
公投第８案,嘉義市,西區,光路里,128,1172,387,142,529,43,572
公投第８案,嘉義市,西區,光路里,129,1320,528,149,677,54,731
公投第８案,嘉義市,西區,福民里,130,1185,544,169,713,38,751
公投第８案,嘉義市,西區,福民里,131,1278,499,202,701,64,765
公投第８案,嘉義市,西區,福民里,132,1394,432,153,585,35,620
公投第８案,嘉義市,西區,福民里,133,1540,612,183,795,165,960
公投第８案,嘉義市,西區,車店里,134,1548,612,170,782,86,868
公投第８案,嘉義市,西區,車店里,135,1295,491,149,640,43,683
公投第８案,嘉義市,西區,車店里,136,1318,564,175,739,58,797
公投第８案,嘉義市,西區,車店里,137,1545,609,184,793,61,854
公投第８案,嘉義市,西區,垂楊里,138,736,233,103,336,17,353
公投第８案,嘉義市,西區,垂楊里,139,1168,408,152,560,22,582
公投第８案,嘉義市,西區,培元里,140,756,322,114,436,37,473
公投第８案,嘉義市,西區,培元里,141,869,383,77,460,13,473
公投第８案,嘉義市,西區,育英里,142,983,393,134,527,52,579
公投第８案,嘉義市,西區,育英里,143,828,320,97,417,50,467
公投第８案,嘉義市,西區,致遠里,144,1775,775,160,935,43,978
公投第８案,嘉義市,西區,翠岱里,145,1419,602,113,715,53,768
公投第８案,嘉義市,西區,導明里,146,779,269,103,372,18,390
公投第８案,嘉義市,西區,導明里,147,855,310,78,388,20,408
公投第８案,嘉義市,西區,北榮里,148,1146,450,142,592,81,673
公投第８案,嘉義市,西區,北榮里,149,1111,420,161,581,35,616
公投第８案,嘉義市,西區,慶安里,150,767,319,115,434,58,492
公投第８案,嘉義市,西區,慶安里,151,817,264,93,357,26,383
公投第８案,嘉義市,西區,香湖里,152,770,272,116,388,59,447
公投第８案,嘉義市,西區,重興里,153,1135,324,127,451,25,476
公投第８案,嘉義市,西區,重興里,154,835,266,103,369,86,455
公投第８案,嘉義市,西區,後驛里,155,1182,397,119,516,40,556
公投第８案,嘉義市,西區,後驛里,156,944,272,125,397,42,439
公投第８案,嘉義市,西區,湖邊里,157,997,334,122,456,41,497
公投第８案,嘉義市,西區,湖邊里,158,1074,372,146,518,38,556
公投第８案,嘉義市,西區,竹圍里,159,1460,418,178,596,24,620
公投第８案,嘉義市,西區,竹圍里,160,1352,490,160,650,27,677
公投第８案,嘉義市,西區,竹圍里,161,1499,542,196,738,56,794
公投第８案,嘉義市,西區,保生里,162,1262,428,163,591,108,699
公投第８案,嘉義市,西區,保生里,163,1299,450,173,623,38,661
公投第８案,嘉義市,西區,保生里,164,1734,579,209,788,95,883
公投第８案,嘉義市,西區,保安里,165,1674,627,126,753,32,785
公投第８案,嘉義市,西區,保安里,166,1540,572,159,731,34,765
公投第８案,嘉義市,西區,北新里,167,1056,417,151,568,28,596
公投第８案,嘉義市,西區,新厝里,168,1467,537,208,745,107,852
公投第８案,嘉義市,西區,新厝里,169,1431,495,175,670,74,744
公投第８案,嘉義市,西區,新厝里,170,1234,517,168,685,87,772
公投第８案,嘉義市,西區,保福里,171,1266,472,147,619,23,642
公投第８案,嘉義市,西區,保福里,172,1211,464,160,624,34,658
公投第８案,嘉義市,西區,保福里,173,1121,464,147,611,25,636
公投第８案,嘉義市,西區,竹村里,174,1155,368,127,495,30,525
公投第８案,嘉義市,西區,北湖里,175,1546,585,215,800,105,905
公投第８案,嘉義市,西區,北湖里,176,1322,475,140,615,35,650
公投第８案,嘉義市,西區,下埤里,177,1549,583,207,790,88,878
公投第８案,臺北市,北投區,建民里,1,1313,540,193,733,65,798
公投第８案,臺北市,北投區,建民里,2,1403,568,248,816,48,864
公投第８案,臺北市,北投區,建民里,3,1081,431,175,606,59,665
公投第８案,臺北市,北投區,文林里,4,1209,487,181,668,58,726
公投第８案,臺北市,北投區,文林里,5,1326,524,197,721,50,771
公投第８案,臺北市,北投區,文林里,6,1263,495,203,698,64,762
公投第８案,臺北市,北投區,石牌里,7,1580,643,237,880,64,944
公投第８案,臺北市,北投區,石牌里,8,1577,642,234,876,49,925
公投第８案,臺北市,北投區,石牌里,9,1483,699,104,803,75,878
公投第８案,臺北市,北投區,福興里,10,1461,586,180,766,45,811
公投第８案,臺北市,北投區,福興里,11,1466,549,198,747,84,831
公投第８案,臺北市,北投區,福興里,12,1620,650,218,868,70,938
公投第８案,臺北市,北投區,福興里,13,1543,570,201,771,39,810
公投第８案,臺北市,北投區,榮光里,14,1513,530,210,740,79,819
公投第８案,臺北市,北投區,榮光里,15,1534,618,194,812,53,865
公投第８案,臺北市,北投區,榮光里,16,1650,690,212,902,80,982
公投第８案,臺北市,北投區,榮光里,17,1533,619,201,820,48,868
公投第８案,臺北市,北投區,榮華里,18,1702,645,225,870,62,932
公投第８案,臺北市,北投區,榮華里,19,1721,678,236,914,55,969
公投第８案,臺北市,北投區,榮華里,20,1575,608,274,882,70,952
公投第８案,臺北市,北投區,榮華里,21,1530,601,214,815,76,891
公投第８案,臺北市,北投區,裕民里,22,1728,645,213,858,87,945
公投第８案,臺北市,北投區,裕民里,23,1702,660,225,885,86,971
公投第８案,臺北市,北投區,裕民里,24,1696,620,248,868,81,949
公投第８案,臺北市,北投區,裕民里,25,1684,563,187,750,45,795
公投第８案,臺北市,北投區,振華里,26,1717,704,246,950,75,1025
公投第８案,臺北市,北投區,振華里,27,1605,643,223,866,52,918
公投第８案,臺北市,北投區,振華里,28,1723,706,217,923,64,987
公投第８案,臺北市,北投區,振華里,29,1597,683,229,912,66,978
公投第８案,臺北市,北投區,永和里,30,1700,653,251,904,59,963
公投第８案,臺北市,北投區,永和里,31,1544,599,164,763,41,804
公投第８案,臺北市,北投區,永和里,32,1635,584,228,812,61,873
公投第８案,臺北市,北投區,永和里,33,1495,624,195,819,37,856
公投第８案,臺北市,北投區,永和里,34,1619,656,248,904,36,940
公投第８案,臺北市,北投區,永欣里,35,1683,632,267,899,54,953
公投第８案,臺北市,北投區,永欣里,36,1662,624,203,827,59,886
公投第８案,臺北市,北投區,永欣里,37,1850,638,218,856,48,904
公投第８案,臺北市,北投區,永欣里,38,1674,611,207,818,25,843
公投第８案,臺北市,北投區,永明里,39,1511,682,179,861,56,917
公投第８案,臺北市,北投區,永明里,40,1393,551,179,730,26,756
公投第８案,臺北市,北投區,永明里,41,1279,569,183,752,58,810
公投第８案,臺北市,北投區,東華里,42,1122,464,120,584,38,622
公投第８案,臺北市,北投區,東華里,43,1238,615,173,788,65,853
公投第８案,臺北市,北投區,東華里,44,1477,645,199,844,68,912
公投第８案,臺北市,北投區,吉利里,45,1495,637,196,833,78,911
公投第８案,臺北市,北投區,吉利里,46,1469,653,205,858,61,919
公投第８案,臺北市,北投區,吉利里,47,1462,617,182,799,63,862
公投第８案,臺北市,北投區,吉利里,48,1431,600,177,777,73,850
公投第８案,臺北市,北投區,吉慶里,49,1486,580,217,797,43,840
公投第８案,臺北市,北投區,吉慶里,50,1449,592,226,818,62,880
公投第８案,臺北市,北投區,吉慶里,51,1456,572,211,783,47,830
公投第８案,臺北市,北投區,尊賢里,52,1311,506,178,684,42,726
公投第８案,臺北市,北投區,尊賢里,53,1356,531,187,718,67,785
公投第８案,臺北市,北投區,尊賢里,54,1338,546,174,720,42,762
公投第８案,臺北市,北投區,立賢里,55,1525,608,207,815,33,848
公投第８案,臺北市,北投區,立賢里,56,1620,615,200,815,50,865
公投第８案,臺北市,北投區,立賢里,57,1499,568,173,741,33,774
公投第８案,臺北市,北投區,立農里,58,1497,663,164,827,50,877
公投第８案,臺北市,北投區,立農里,59,1624,625,222,847,69,916
公投第８案,臺北市,北投區,立農里,60,1536,565,178,743,94,837
公投第８案,臺北市,北投區,立農里,61,1469,596,219,815,86,901
公投第８案,臺北市,北投區,立農里,62,1598,612,213,825,63,888
公投第８案,臺北市,北投區,八仙里,63,1690,651,218,869,41,910
公投第８案,臺北市,北投區,八仙里,64,1599,597,213,810,107,917
公投第８案,臺北市,北投區,八仙里,65,1634,626,209,835,79,914
公投第８案,臺北市,北投區,洲美里,66,1660,568,231,799,78,877
公投第８案,臺北市,北投區,奇岩里,67,1900,682,241,923,71,994
公投第８案,臺北市,北投區,奇岩里,68,1797,712,258,970,58,1028
公投第８案,臺北市,北投區,奇岩里,69,1832,708,260,968,87,1055
公投第８案,臺北市,北投區,奇岩里,70,1784,714,257,971,75,1046
公投第８案,臺北市,北投區,奇岩里,71,1732,690,243,933,57,990
公投第８案,臺北市,北投區,清江里,72,2035,372,121,493,61,554
公投第８案,臺北市,北投區,清江里,73,1504,580,212,792,73,865
公投第８案,臺北市,北投區,清江里,74,1683,693,215,908,94,1002
公投第８案,臺北市,北投區,清江里,75,1635,580,230,810,95,905
公投第８案,臺北市,北投區,清江里,76,1613,614,205,819,85,904
公投第８案,臺北市,北投區,中央里,77,1483,602,161,763,39,802
公投第８案,臺北市,北投區,中央里,78,1500,555,231,786,57,843
公投第８案,臺北市,北投區,中央里,79,1483,583,201,784,83,867
公投第８案,臺北市,北投區,中央里,80,1544,562,233,795,75,870
公投第８案,臺北市,北投區,中央里,81,1532,512,171,683,78,761
公投第８案,臺北市,北投區,長安里,82,1819,688,250,938,79,1017
公投第８案,臺北市,北投區,長安里,83,1863,612,262,874,84,958
公投第８案,臺北市,北投區,長安里,84,1872,611,251,862,39,901
公投第８案,臺北市,北投區,大同里,85,1627,605,223,828,65,893
公投第８案,臺北市,北投區,大同里,86,1696,635,198,833,44,877
公投第８案,臺北市,北投區,大同里,87,1841,678,260,938,65,1003
公投第８案,臺北市,北投區,溫泉里,88,1324,514,166,680,70,750
公投第８案,臺北市,北投區,溫泉里,89,1504,570,182,752,51,803
公投第８案,臺北市,北投區,溫泉里,90,1511,595,193,788,56,844
公投第８案,臺北市,北投區,溫泉里,91,1615,643,251,894,53,947
公投第８案,臺北市,北投區,林泉里,92,1270,500,127,627,48,675
公投第８案,臺北市,北投區,林泉里,93,1492,525,168,693,40,733
公投第８案,臺北市,北投區,中心里,94,1429,521,197,718,45,763
公投第８案,臺北市,北投區,中心里,95,1567,594,174,768,27,795
公投第８案,臺北市,北投區,中心里,96,1388,527,197,724,51,775
公投第８案,臺北市,北投區,中心里,97,1448,520,179,699,27,726
公投第８案,臺北市,北投區,中庸里,98,1356,479,180,659,61,720
公投第８案,臺北市,北投區,中庸里,99,1308,511,164,675,57,732
公投第８案,臺北市,北投區,中庸里,100,1165,484,163,647,56,703
公投第８案,臺北市,北投區,開明里,101,1429,587,192,779,73,852
公投第８案,臺北市,北投區,開明里,102,1472,596,151,747,33,780
公投第８案,臺北市,北投區,開明里,103,1508,642,223,865,73,938
公投第８案,臺北市,北投區,開明里,104,1480,553,226,779,71,850
公投第８案,臺北市,北投區,中和里,105,1142,408,164,572,49,621
公投第８案,臺北市,北投區,中和里,106,1554,604,171,775,45,820
公投第８案,臺北市,北投區,中和里,107,1669,684,215,899,92,991
公投第８案,臺北市,北投區,智仁里,108,1823,744,198,942,80,1022
公投第８案,臺北市,北投區,智仁里,109,1739,684,187,871,86,957
公投第８案,臺北市,北投區,智仁里,110,1771,648,224,872,72,944
公投第８案,臺北市,北投區,秀山里,111,1468,590,159,749,46,795
公投第８案,臺北市,北投區,秀山里,112,1469,565,191,756,49,805
公投第８案,臺北市,北投區,文化里,113,1094,550,114,664,45,709
公投第８案,臺北市,北投區,文化里,114,1101,540,117,657,49,706
公投第８案,臺北市,北投區,文化里,115,1422,634,166,800,69,869
公投第８案,臺北市,北投區,豐年里,116,1390,578,132,710,64,774
公投第８案,臺北市,北投區,豐年里,117,1307,532,172,704,73,777
公投第８案,臺北市,北投區,豐年里,118,1215,488,192,680,89,769
公投第８案,臺北市,北投區,稻香里,119,1642,610,182,792,47,839
公投第８案,臺北市,北投區,稻香里,120,1623,620,169,789,37,826
公投第８案,臺北市,北投區,稻香里,121,1621,649,183,832,73,905
公投第８案,臺北市,北投區,桃源里,122,1367,520,190,710,25,735
公投第８案,臺北市,北投區,桃源里,123,1309,431,215,646,64,710
公投第８案,臺北市,北投區,桃源里,124,1356,568,168,736,34,770
公投第８案,臺北市,北投區,桃源里,125,1365,539,160,699,50,749
公投第８案,臺北市,北投區,一德里,126,1613,588,219,807,50,857
公投第８案,臺北市,北投區,一德里,127,1590,541,176,717,43,760
公投第８案,臺北市,北投區,一德里,128,1662,650,232,882,82,964
公投第８案,臺北市,北投區,一德里,129,1622,626,242,868,67,935
公投第８案,臺北市,北投區,關渡里,130,1820,641,289,930,40,970
公投第８案,臺北市,北投區,關渡里,131,1615,672,194,866,77,943
公投第８案,臺北市,北投區,關渡里,132,1612,489,182,671,78,749
公投第８案,臺北市,北投區,關渡里,133,1652,608,221,829,74,903
公投第８案,臺北市,北投區,關渡里,134,1666,677,200,877,35,912
公投第８案,臺北市,北投區,關渡里,135,1641,602,223,825,55,880
公投第８案,臺北市,北投區,泉源里,136,528,205,74,279,40,319
公投第８案,臺北市,北投區,泉源里,137,1642,507,194,701,83,784
公投第８案,臺北市,北投區,湖山里,138,829,326,105,431,38,469
公投第８案,臺北市,北投區,湖山里,139,690,273,69,342,40,382
公投第８案,臺北市,北投區,大屯里,140,1067,400,133,533,52,585
公投第８案,臺北市,北投區,湖田里,141,892,341,104,445,62,507
公投第８案,臺北市,士林區,仁勇里,142,1695,498,262,760,88,848
公投第８案,臺北市,士林區,仁勇里,143,1720,668,237,905,104,1009
公投第８案,臺北市,士林區,義信里,144,1288,494,171,665,78,743
公投第８案,臺北市,士林區,義信里,145,1546,567,219,786,77,863
公投第８案,臺北市,士林區,福林里,146,652,295,83,378,34,412
公投第８案,臺北市,士林區,福林里,147,870,322,114,436,45,481
公投第８案,臺北市,士林區,福林里,148,1137,424,223,647,59,706
公投第８案,臺北市,士林區,福德里,149,1050,435,160,595,68,663
公投第８案,臺北市,士林區,福德里,150,1031,429,151,580,62,642
公投第８案,臺北市,士林區,福德里,151,1075,439,165,604,34,638
公投第８案,臺北市,士林區,福德里,152,2175,346,115,461,59,520
公投第８案,臺北市,士林區,福志里,153,1775,659,218,877,76,953
公投第８案,臺北市,士林區,福志里,154,1669,710,212,922,56,978
公投第８案,臺北市,士林區,福志里,155,1665,660,275,935,75,1010
公投第８案,臺北市,士林區,福志里,156,1648,659,270,929,87,1016
公投第８案,臺北市,士林區,舊佳里,157,1246,498,177,675,32,707
公投第８案,臺北市,士林區,舊佳里,158,1419,503,226,729,89,818
公投第８案,臺北市,士林區,舊佳里,159,1327,493,192,685,87,772
公投第８案,臺北市,士林區,舊佳里,160,1573,612,283,895,76,971
公投第８案,臺北市,士林區,福佳里,161,1470,593,192,785,86,871
公投第８案,臺北市,士林區,福佳里,162,1775,672,222,894,34,928
公投第８案,臺北市,士林區,福佳里,163,1692,689,228,917,71,988
公投第８案,臺北市,士林區,福佳里,164,1842,750,256,1006,63,1069
公投第８案,臺北市,士林區,後港里,165,1166,483,171,654,58,712
公投第８案,臺北市,士林區,後港里,166,1687,594,205,799,82,881
公投第８案,臺北市,士林區,後港里,167,1624,623,236,859,75,934
公投第８案,臺北市,士林區,後港里,168,1477,583,226,809,113,922
公投第８案,臺北市,士林區,後港里,169,1250,498,203,701,58,759
公投第８案,臺北市,士林區,福中里,170,1434,561,203,764,92,856
公投第８案,臺北市,士林區,福中里,171,1452,553,231,784,82,866
公投第８案,臺北市,士林區,福中里,172,1533,622,260,882,81,963
公投第８案,臺北市,士林區,福中里,173,1515,634,210,844,84,928
公投第８案,臺北市,士林區,前港里,174,1203,474,198,672,59,731
公投第８案,臺北市,士林區,前港里,175,1487,628,217,845,83,928
公投第８案,臺北市,士林區,前港里,176,1252,490,183,673,38,711
公投第８案,臺北市,士林區,百齡里,177,1536,574,218,792,64,856
公投第８案,臺北市,士林區,百齡里,178,1556,619,243,862,74,936
公投第８案,臺北市,士林區,百齡里,179,1511,603,220,823,56,879
公投第８案,臺北市,士林區,百齡里,180,1572,627,255,882,84,966
公投第８案,臺北市,士林區,承德里,181,1668,672,203,875,89,964
公投第８案,臺北市,士林區,承德里,182,1685,624,213,837,113,950
公投第８案,臺北市,士林區,承德里,183,1568,617,217,834,67,901
公投第８案,臺北市,士林區,福華里,184,1327,512,164,676,53,729
公投第８案,臺北市,士林區,福華里,185,1338,460,185,645,72,717
公投第８案,臺北市,士林區,福華里,186,1515,529,197,726,68,794
公投第８案,臺北市,士林區,福華里,187,1452,589,202,791,77,868
公投第８案,臺北市,士林區,明勝里,188,1448,590,186,776,65,841
公投第８案,臺北市,士林區,明勝里,189,1521,605,218,823,63,886
公投第８案,臺北市,士林區,明勝里,190,1461,527,242,769,48,817
公投第８案,臺北市,士林區,福順里,191,1541,516,235,751,80,831
公投第８案,臺北市,士林區,福順里,192,1611,517,175,692,62,754
公投第８案,臺北市,士林區,福順里,193,1595,589,227,816,82,898
公投第８案,臺北市,士林區,富光里,194,1685,610,201,811,56,867
公投第８案,臺北市,士林區,富光里,195,1816,668,233,901,82,983
公投第８案,臺北市,士林區,富光里,196,1687,619,245,864,102,966
公投第８案,臺北市,士林區,葫蘆里,197,1646,623,217,840,94,934
公投第８案,臺北市,士林區,葫蘆里,198,1643,621,191,812,68,880
公投第８案,臺北市,士林區,葫蘆里,199,1687,710,187,897,67,964
公投第８案,臺北市,士林區,葫蘆里,200,1655,629,250,879,92,971
公投第８案,臺北市,士林區,葫東里,201,1779,640,235,875,41,916
公投第８案,臺北市,士林區,葫東里,202,1855,713,282,995,74,1069
公投第８案,臺北市,士林區,社子里,203,1350,527,185,712,69,781
公投第８案,臺北市,士林區,社子里,204,1455,527,168,695,42,737
公投第８案,臺北市,士林區,社子里,205,1497,444,200,644,73,717
公投第８案,臺北市,士林區,社子里,206,1398,417,167,584,71,655
公投第８案,臺北市,士林區,社新里,207,1747,654,291,945,83,1028
公投第８案,臺北市,士林區,社新里,208,1465,551,182,733,95,828
公投第８案,臺北市,士林區,社新里,209,1530,553,229,782,79,861
公投第８案,臺北市,士林區,社新里,210,1855,616,253,869,97,966
公投第８案,臺北市,士林區,社新里,211,1444,522,220,742,79,821
公投第８案,臺北市,士林區,社園里,212,1563,554,192,746,86,832
公投第８案,臺北市,士林區,社園里,213,1482,538,212,750,94,844
公投第８案,臺北市,士林區,社園里,214,1552,524,223,747,109,856
公投第８案,臺北市,士林區,社園里,215,1790,678,241,919,92,1011
公投第８案,臺北市,士林區,永倫里,216,1628,566,194,760,94,854
公投第８案,臺北市,士林區,永倫里,217,1337,445,215,660,78,738
公投第８案,臺北市,士林區,永倫里,218,1750,675,229,904,93,997
公投第８案,臺北市,士林區,永倫里,219,1668,564,214,778,118,896
公投第８案,臺北市,士林區,福安里,220,1403,396,180,576,91,667
公投第８案,臺北市,士林區,福安里,221,1468,420,221,641,62,703
公投第８案,臺北市,士林區,福安里,222,1471,465,186,651,45,696
公投第８案,臺北市,士林區,富洲里,223,1666,574,192,766,103,869
公投第８案,臺北市,士林區,富洲里,224,1587,525,233,758,65,823
公投第８案,臺北市,士林區,富洲里,225,1987,629,235,864,89,953
公投第８案,臺北市,士林區,岩山里,226,1271,455,143,598,25,623
公投第８案,臺北市,士林區,岩山里,227,1728,735,219,954,81,1035
公投第８案,臺北市,士林區,名山里,228,1630,688,217,905,73,978
公投第８案,臺北市,士林區,名山里,229,1619,651,250,901,65,966
公投第８案,臺北市,士林區,名山里,230,1425,593,191,784,59,843
公投第８案,臺北市,士林區,名山里,231,1623,672,247,919,76,995
公投第８案,臺北市,士林區,聖山里,232,1564,620,248,868,61,929
公投第８案,臺北市,士林區,聖山里,233,1376,617,214,831,63,894
公投第８案,臺北市,士林區,聖山里,234,1517,722,175,897,43,940
公投第８案,臺北市,士林區,芝山里,235,1729,631,235,866,56,922
公投第８案,臺北市,士林區,芝山里,236,1511,656,217,873,53,926
公投第８案,臺北市,士林區,芝山里,237,1811,767,237,1004,64,1068
公投第８案,臺北市,士林區,芝山里,238,1533,593,242,835,53,888
公投第８案,臺北市,士林區,東山里,239,1657,764,247,1011,63,1074
公投第８案,臺北市,士林區,東山里,240,1499,629,175,804,52,856
公投第８案,臺北市,士林區,東山里,241,1402,595,146,741,69,810
公投第８案,臺北市,士林區,德行里,242,1273,546,214,760,71,831
公投第８案,臺北市,士林區,德行里,243,1273,513,190,703,54,757
公投第８案,臺北市,士林區,德行里,244,1316,514,211,725,57,782
公投第８案,臺北市,士林區,德華里,245,1659,649,237,886,71,957
公投第８案,臺北市,士林區,德華里,246,1749,679,227,906,48,954
公投第８案,臺北市,士林區,德華里,247,1552,574,234,808,74,882
公投第８案,臺北市,士林區,忠誠里,248,1529,664,176,840,66,906
公投第８案,臺北市,士林區,忠誠里,249,1644,715,153,868,50,918
公投第８案,臺北市,士林區,忠誠里,250,1779,699,237,936,69,1005
公投第８案,臺北市,士林區,蘭雅里,251,1597,637,217,854,53,907
公投第８案,臺北市,士林區,蘭雅里,252,1454,564,203,767,64,831
公投第８案,臺北市,士林區,蘭雅里,253,1582,649,255,904,62,966
公投第８案,臺北市,士林區,蘭雅里,254,1518,654,193,847,56,903
公投第８案,臺北市,士林區,蘭雅里,255,1501,542,200,742,30,772
公投第８案,臺北市,士林區,蘭興里,256,1420,599,203,802,54,856
公投第８案,臺北市,士林區,蘭興里,257,1494,584,210,794,76,870
公投第８案,臺北市,士林區,蘭興里,258,1568,641,242,883,70,953
公投第８案,臺北市,士林區,蘭興里,259,1208,497,217,714,51,765
公投第８案,臺北市,士林區,三玉里,260,1826,692,268,960,68,1028
公投第８案,臺北市,士林區,三玉里,261,1647,619,245,864,74,938
公投第８案,臺北市,士林區,三玉里,262,1654,633,229,862,72,934
公投第８案,臺北市,士林區,天福里,263,1550,647,211,858,65,923
公投第８案,臺北市,士林區,天福里,264,1298,548,106,654,60,714
公投第８案,臺北市,士林區,天福里,265,1297,536,186,722,60,782
公投第８案,臺北市,士林區,天福里,266,1352,525,192,717,53,770
公投第８案,臺北市,士林區,天祿里,267,1522,595,222,817,58,875
公投第８案,臺北市,士林區,天祿里,268,1602,561,248,809,103,912
公投第８案,臺北市,士林區,天祿里,269,1441,539,226,765,70,835
公投第８案,臺北市,士林區,天壽里,270,1325,484,189,673,30,703
公投第８案,臺北市,士林區,天壽里,271,1567,627,221,848,55,903
公投第８案,臺北市,士林區,天壽里,272,1518,593,213,806,33,839
公投第８案,臺北市,士林區,天和里,273,1549,647,238,885,59,944
公投第８案,臺北市,士林區,天和里,274,1652,651,234,885,36,921
公投第８案,臺北市,士林區,天和里,275,1766,735,247,982,73,1055
公投第８案,臺北市,士林區,天和里,276,1638,612,239,851,37,888
公投第８案,臺北市,士林區,天山里,277,1491,652,203,855,60,915
公投第８案,臺北市,士林區,天山里,278,1521,623,211,834,38,872
公投第８案,臺北市,士林區,天山里,279,1351,611,160,771,60,831
公投第８案,臺北市,士林區,天山里,280,1742,612,238,850,36,886
公投第８案,臺北市,士林區,天玉里,281,1585,634,256,890,62,952
公投第８案,臺北市,士林區,天玉里,282,1521,638,196,834,58,892
公投第８案,臺北市,士林區,天玉里,283,1543,610,205,815,46,861
公投第８案,臺北市,士林區,天玉里,284,1404,595,186,781,51,832
公投第８案,臺北市,士林區,天玉里,285,1541,617,221,838,54,892
公投第８案,臺北市,士林區,天母里,286,1584,630,186,816,68,884
公投第８案,臺北市,士林區,天母里,287,1519,612,230,842,66,908
公投第８案,臺北市,士林區,天母里,288,1482,546,183,729,40,769
公投第８案,臺北市,士林區,天母里,289,1243,481,163,644,67,711
公投第８案,臺北市,士林區,永福里,290,1156,433,176,609,57,666
公投第８案,臺北市,士林區,公館里,291,1262,407,173,580,85,665
公投第８案,臺北市,士林區,新安里,292,889,337,146,483,50,533
公投第８案,臺北市,士林區,新安里,293,858,308,155,463,0,463
公投第８案,臺北市,士林區,陽明里,294,945,298,167,465,69,534
公投第８案,臺北市,士林區,陽明里,295,960,356,115,471,60,531
公投第８案,臺北市,士林區,陽明里,296,876,342,95,437,58,495
公投第８案,臺北市,士林區,菁山里,297,556,217,108,325,38,363
公投第８案,臺北市,士林區,菁山里,298,919,368,125,493,82,575
公投第８案,臺北市,士林區,平等里,299,1360,549,243,792,108,900
公投第８案,臺北市,士林區,溪山里,300,1355,521,201,722,102,824
公投第８案,臺北市,士林區,翠山里,301,1252,550,140,690,53,743
公投第８案,臺北市,士林區,翠山里,302,1182,553,126,679,60,739
公投第８案,臺北市,士林區,臨溪里,303,1431,494,149,643,27,670
公投第８案,臺北市,士林區,臨溪里,304,1240,449,169,618,43,661
公投第８案,臺北市,內湖區,西湖里,305,1661,620,191,811,35,846
公投第８案,臺北市,內湖區,西湖里,306,1602,589,226,815,79,894
公投第８案,臺北市,內湖區,西湖里,307,1655,676,224,900,105,1005
公投第８案,臺北市,內湖區,西湖里,308,1582,678,224,902,46,948
公投第８案,臺北市,內湖區,西康里,309,1688,688,188,876,42,918
公投第８案,臺北市,內湖區,西康里,310,1737,691,244,935,54,989
公投第８案,臺北市,內湖區,西康里,311,1809,796,207,1003,75,1078
公投第８案,臺北市,內湖區,西康里,312,1376,543,186,729,57,786
公投第８案,臺北市,內湖區,西康里,313,1747,750,207,957,103,1060
公投第８案,臺北市,內湖區,西安里,314,1389,601,206,807,33,840
公投第８案,臺北市,內湖區,西安里,315,1454,669,185,854,52,906
公投第８案,臺北市,內湖區,西安里,316,1468,634,242,876,52,928
公投第８案,臺北市,內湖區,西安里,317,1603,734,220,954,50,1004
公投第８案,臺北市,內湖區,港墘里,318,1795,706,239,945,39,984
公投第８案,臺北市,內湖區,港墘里,319,1737,774,244,1018,67,1085
公投第８案,臺北市,內湖區,港墘里,320,1744,723,243,966,77,1043
公投第８案,臺北市,內湖區,港都里,321,1661,705,208,913,69,982
公投第８案,臺北市,內湖區,港都里,322,1577,634,233,867,52,919
公投第８案,臺北市,內湖區,港都里,323,1494,650,217,867,28,895
公投第８案,臺北市,內湖區,港富里,324,1626,691,196,887,72,959
公投第８案,臺北市,內湖區,港富里,325,1641,679,203,882,82,964
公投第８案,臺北市,內湖區,港富里,326,1554,662,186,848,53,901
公投第８案,臺北市,內湖區,港富里,327,1728,724,257,981,60,1041
公投第８案,臺北市,內湖區,港富里,328,1736,697,218,915,67,982
公投第８案,臺北市,內湖區,港華里,329,1461,682,203,885,51,936
公投第８案,臺北市,內湖區,港華里,330,1509,621,203,824,45,869
公投第８案,臺北市,內湖區,港華里,331,1358,527,201,728,35,763
公投第８案,臺北市,內湖區,港華里,332,1761,76,207,283,54,337
公投第８案,臺北市,內湖區,港華里,333,1651,701,108,809,28,837
公投第８案,臺北市,內湖區,內湖里,334,1809,755,228,983,80,1063
公投第８案,臺北市,內湖區,內湖里,335,1773,763,206,969,62,1031
公投第８案,臺北市,內湖區,內湖里,336,1890,769,218,987,45,1032
公投第８案,臺北市,內湖區,湖濱里,337,1760,810,255,1065,67,1132
公投第８案,臺北市,內湖區,湖濱里,338,1645,738,201,939,38,977
公投第８案,臺北市,內湖區,湖濱里,339,1324,606,178,784,29,813
公投第８案,臺北市,內湖區,湖濱里,340,1072,507,124,631,34,665
公投第８案,臺北市,內湖區,湖濱里,341,1509,606,187,793,40,833
公投第８案,臺北市,內湖區,紫星里,342,1715,719,243,962,33,995
公投第８案,臺北市,內湖區,紫星里,343,1774,729,243,972,64,1036
公投第８案,臺北市,內湖區,紫星里,344,1796,806,259,1065,72,1137
公投第８案,臺北市,內湖區,紫星里,345,1784,713,231,944,51,995
公投第８案,臺北市,內湖區,大湖里,346,1417,604,211,815,65,880
公投第８案,臺北市,內湖區,大湖里,347,1699,690,241,931,42,973
公投第８案,臺北市,內湖區,大湖里,348,1719,773,250,1023,56,1079
公投第８案,臺北市,內湖區,金龍里,349,1715,717,224,941,30,971
公投第８案,臺北市,內湖區,金龍里,350,1634,620,172,792,36,828
公投第８案,臺北市,內湖區,金龍里,351,1435,553,187,740,74,814
公投第８案,臺北市,內湖區,金瑞里,352,1440,597,167,764,32,796
公投第８案,臺北市,內湖區,金瑞里,353,1446,679,173,852,35,887
公投第８案,臺北市,內湖區,金瑞里,354,1657,635,189,824,69,893
公投第８案,臺北市,內湖區,金瑞里,355,1261,539,164,703,73,776
公投第８案,臺北市,內湖區,碧山里,356,456,138,65,203,33,236
公投第８案,臺北市,內湖區,碧山里,357,1433,689,207,896,43,939
公投第８案,臺北市,內湖區,碧山里,358,1485,608,236,844,43,887
公投第８案,臺北市,內湖區,碧山里,359,1590,651,221,872,41,913
公投第８案,臺北市,內湖區,碧山里,360,1219,567,158,725,58,783
公投第８案,臺北市,內湖區,紫雲里,361,1732,659,229,888,75,963
公投第８案,臺北市,內湖區,紫雲里,362,1727,792,173,965,38,1003
公投第８案,臺北市,內湖區,紫雲里,363,1637,675,221,896,64,960
公投第８案,臺北市,內湖區,清白里,364,1453,601,180,781,49,830
公投第８案,臺北市,內湖區,清白里,365,1617,679,179,858,40,898
公投第８案,臺北市,內湖區,清白里,366,1604,674,194,868,32,900
公投第８案,臺北市,內湖區,清白里,367,1406,646,198,844,41,885
公投第８案,臺北市,內湖區,清白里,368,1353,562,199,761,47,808
公投第８案,臺北市,內湖區,葫洲里,369,1724,767,218,985,60,1045
公投第８案,臺北市,內湖區,葫洲里,370,1378,596,180,776,50,826
公投第８案,臺北市,內湖區,葫洲里,371,1403,632,182,814,40,854
公投第８案,臺北市,內湖區,葫洲里,372,1547,647,172,819,43,862
公投第８案,臺北市,內湖區,紫陽里,373,1718,711,269,980,49,1029
公投第８案,臺北市,內湖區,紫陽里,374,1813,738,239,977,59,1036
公投第８案,臺北市,內湖區,紫陽里,375,1791,792,253,1045,67,1112
公投第８案,臺北市,內湖區,紫陽里,376,1855,793,265,1058,57,1115
公投第８案,臺北市,內湖區,瑞陽里,377,1731,778,197,975,31,1006
公投第８案,臺北市,內湖區,瑞陽里,378,1593,731,222,953,67,1020
公投第８案,臺北市,內湖區,瑞陽里,379,1869,745,191,936,60,996
公投第８案,臺北市,內湖區,瑞陽里,380,1687,741,211,952,62,1014
公投第８案,臺北市,內湖區,瑞光里,381,1530,656,197,853,37,890
公投第８案,臺北市,內湖區,瑞光里,382,1300,575,165,740,59,799
公投第８案,臺北市,內湖區,瑞光里,383,1314,650,139,789,53,842
公投第８案,臺北市,內湖區,五分里,384,1433,504,179,683,41,724
公投第８案,臺北市,內湖區,五分里,385,1450,601,147,748,43,791
公投第８案,臺北市,內湖區,五分里,386,1608,644,210,854,60,914
公投第８案,臺北市,內湖區,五分里,387,1414,591,190,781,53,834
公投第８案,臺北市,內湖區,五分里,388,1492,639,185,824,43,867
公投第８案,臺北市,內湖區,五分里,389,1528,595,178,773,33,806
公投第８案,臺北市,內湖區,東湖里,390,1692,696,220,916,63,979
公投第８案,臺北市,內湖區,東湖里,391,1556,629,214,843,54,897
公投第８案,臺北市,內湖區,東湖里,392,1637,656,211,867,27,894
公投第８案,臺北市,內湖區,東湖里,393,1749,676,215,891,50,941
公投第８案,臺北市,內湖區,樂康里,394,1220,485,153,638,36,674
公投第８案,臺北市,內湖區,樂康里,395,1600,635,207,842,79,921
公投第８案,臺北市,內湖區,樂康里,396,1473,610,188,798,51,849
公投第８案,臺北市,內湖區,樂康里,397,1498,585,209,794,68,862
公投第８案,臺北市,內湖區,樂康里,398,1557,663,181,844,47,891
公投第８案,臺北市,內湖區,內溝里,399,1674,651,198,849,53,902
公投第８案,臺北市,內湖區,內溝里,400,1728,736,237,973,61,1034
公投第８案,臺北市,內湖區,內溝里,401,788,251,116,367,51,418
公投第８案,臺北市,內湖區,週美里,402,1542,530,252,782,81,863
公投第８案,臺北市,內湖區,週美里,403,1676,603,191,794,57,851
公投第８案,臺北市,內湖區,週美里,404,1360,474,188,662,33,695
公投第８案,臺北市,內湖區,週美里,405,1259,594,160,754,35,789
公投第８案,臺北市,內湖區,週美里,406,1301,559,134,693,19,712
公投第８案,臺北市,內湖區,行善里,407,1251,429,167,596,43,639
公投第８案,臺北市,內湖區,行善里,408,1502,602,177,779,74,853
公投第８案,臺北市,內湖區,行善里,409,1596,669,171,840,49,889
公投第８案,臺北市,內湖區,行善里,410,1649,684,222,906,24,930
公投第８案,臺北市,內湖區,石潭里,411,1774,723,188,911,65,976
公投第８案,臺北市,內湖區,石潭里,412,1746,677,194,871,49,920
公投第８案,臺北市,內湖區,湖興里,413,1473,606,167,773,24,797
公投第８案,臺北市,內湖區,湖興里,414,2824,686,207,893,76,969
公投第８案,臺北市,內湖區,湖興里,415,1849,640,265,905,48,953
公投第８案,臺北市,內湖區,湖興里,416,1530,603,180,783,67,850
公投第８案,臺北市,內湖區,湖元里,417,1656,634,231,865,66,931
公投第８案,臺北市,內湖區,湖元里,418,1457,587,217,804,46,850
公投第８案,臺北市,內湖區,湖元里,419,1695,729,217,946,67,1013
公投第８案,臺北市,內湖區,安湖里,420,1663,720,215,935,49,984
公投第８案,臺北市,內湖區,安湖里,421,1654,677,203,880,65,945
公投第８案,臺北市,內湖區,安湖里,422,1642,714,208,922,64,986
公投第８案,臺北市,內湖區,安湖里,423,1685,688,218,906,48,954
公投第８案,臺北市,內湖區,秀湖里,424,1862,733,245,978,67,1045
公投第８案,臺北市,內湖區,秀湖里,425,1900,823,252,1075,58,1133
公投第８案,臺北市,內湖區,秀湖里,426,1790,850,247,1097,66,1163
公投第８案,臺北市,內湖區,安泰里,427,1417,588,162,750,63,813
公投第８案,臺北市,內湖區,安泰里,428,1694,700,213,913,54,967
公投第８案,臺北市,內湖區,安泰里,429,1676,663,181,844,66,910
公投第８案,臺北市,內湖區,金湖里,430,1643,666,215,881,31,912
公投第８案,臺北市,內湖區,金湖里,431,1588,674,208,882,53,935
公投第８案,臺北市,內湖區,金湖里,432,1603,704,190,894,62,956
公投第８案,臺北市,內湖區,金湖里,433,1629,707,190,897,52,949
公投第８案,臺北市,內湖區,金湖里,434,1646,750,205,955,59,1014
公投第８案,臺北市,內湖區,康寧里,435,1883,786,204,990,52,1042
公投第８案,臺北市,內湖區,康寧里,436,1434,578,182,760,56,816
公投第８案,臺北市,內湖區,康寧里,437,1418,603,154,757,38,795
公投第８案,臺北市,內湖區,康寧里,438,1373,586,162,748,72,820
公投第８案,臺北市,內湖區,康寧里,439,1349,572,174,746,71,817
公投第８案,臺北市,內湖區,明湖里,440,1511,632,227,859,60,919
公投第８案,臺北市,內湖區,明湖里,441,1563,694,191,885,78,963
公投第８案,臺北市,內湖區,明湖里,442,1550,650,200,850,55,905
公投第８案,臺北市,內湖區,蘆洲里,443,1157,460,150,610,60,670
公投第８案,臺北市,內湖區,麗山里,444,1768,719,249,968,52,1020
公投第８案,臺北市,內湖區,麗山里,445,1664,687,215,902,63,965
公投第８案,臺北市,內湖區,麗山里,446,1743,762,234,996,76,1072
公投第８案,臺北市,內湖區,寶湖里,447,1480,644,193,837,27,864
公投第８案,臺北市,內湖區,寶湖里,448,1589,680,235,915,70,985
公投第８案,臺北市,內湖區,寶湖里,449,1371,580,178,758,35,793
公投第８案,臺北市,內湖區,寶湖里,450,1575,723,205,928,52,980
公投第８案,臺北市,內湖區,寶湖里,451,1377,615,167,782,17,799
公投第８案,臺北市,內湖區,南湖里,452,1469,703,213,916,61,977
公投第８案,臺北市,內湖區,南湖里,453,1529,675,230,905,33,938
公投第８案,臺北市,內湖區,南湖里,454,1649,730,211,941,58,999
公投第８案,臺北市,南港區,南港里,455,1280,467,151,618,31,649
公投第８案,臺北市,南港區,南港里,456,1351,551,175,726,28,754
公投第８案,臺北市,南港區,南港里,457,1345,566,167,733,43,776
公投第８案,臺北市,南港區,南港里,458,1679,496,206,702,45,747
公投第８案,臺北市,南港區,中南里,459,1680,566,238,804,62,866
公投第８案,臺北市,南港區,中南里,460,1635,594,191,785,49,834
公投第８案,臺北市,南港區,三重里,461,1459,578,175,753,51,804
公投第８案,臺北市,南港區,三重里,462,1706,704,223,927,37,964
公投第８案,臺北市,南港區,三重里,463,1674,662,180,842,105,947
公投第８案,臺北市,南港區,三重里,464,1491,545,260,805,28,833
公投第８案,臺北市,南港區,新富里,465,1086,501,156,657,40,697
公投第８案,臺北市,南港區,新富里,466,1202,525,175,700,74,774
公投第８案,臺北市,南港區,新富里,467,1198,488,167,655,89,744
公投第８案,臺北市,南港區,中研里,468,1430,524,176,700,31,731
公投第８案,臺北市,南港區,中研里,469,1275,491,230,721,60,781
公投第８案,臺北市,南港區,中研里,470,1344,603,207,810,59,869
公投第８案,臺北市,南港區,中研里,471,1391,570,198,768,50,818
公投第８案,臺北市,南港區,中研里,472,1342,626,159,785,36,821
公投第８案,臺北市,南港區,中研里,473,1389,540,169,709,47,756
公投第８案,臺北市,南港區,九如里,474,1426,615,191,806,48,854
公投第８案,臺北市,南港區,九如里,475,1359,655,134,789,31,820
公投第８案,臺北市,南港區,九如里,476,1366,553,181,734,61,795
公投第８案,臺北市,南港區,九如里,477,1441,635,166,801,30,831
公投第８案,臺北市,南港區,舊莊里,478,1529,577,189,766,66,832
公投第８案,臺北市,南港區,舊莊里,479,1618,617,184,801,53,854
公投第８案,臺北市,南港區,舊莊里,480,1545,509,165,674,86,760
公投第８案,臺北市,南港區,舊莊里,481,1569,644,197,841,57,898
公投第８案,臺北市,南港區,舊莊里,482,1661,600,175,775,50,825
公投第８案,臺北市,南港區,東新里,483,1518,548,180,728,66,794
公投第８案,臺北市,南港區,東新里,484,1552,670,209,879,59,938
公投第８案,臺北市,南港區,東新里,485,1658,654,175,829,25,854
公投第８案,臺北市,南港區,東新里,486,1608,630,233,863,61,924
公投第８案,臺北市,南港區,重陽里,487,1475,578,169,747,42,789
公投第８案,臺北市,南港區,重陽里,488,1722,767,247,1014,52,1066
公投第８案,臺北市,南港區,重陽里,489,1383,634,210,844,41,885
公投第８案,臺北市,南港區,東明里,490,1397,606,171,777,45,822
公投第８案,臺北市,南港區,東明里,491,1352,575,176,751,55,806
公投第８案,臺北市,南港區,東明里,492,1344,569,183,752,55,807
公投第８案,臺北市,南港區,西新里,493,1385,505,184,689,33,722
公投第８案,臺北市,南港區,西新里,494,1399,552,182,734,60,794
公投第８案,臺北市,南港區,西新里,495,1381,523,164,687,44,731
公投第８案,臺北市,南港區,玉成里,496,1548,601,202,803,56,859
公投第８案,臺北市,南港區,玉成里,497,1190,485,140,625,30,655
公投第８案,臺北市,南港區,玉成里,498,1490,611,225,836,39,875
公投第８案,臺北市,南港區,合成里,499,1096,497,142,639,25,664
公投第８案,臺北市,南港區,合成里,500,1238,574,159,733,32,765
公投第８案,臺北市,南港區,合成里,501,1271,558,178,736,35,771
公投第８案,臺北市,南港區,合成里,502,1146,456,158,614,56,670
公投第８案,臺北市,南港區,合成里,503,1232,459,186,645,49,694
公投第８案,臺北市,南港區,新光里,504,1649,632,155,787,39,826
公投第８案,臺北市,南港區,新光里,505,1688,730,202,932,58,990
公投第８案,臺北市,南港區,聯成里,506,1503,664,197,861,33,894
公投第８案,臺北市,南港區,聯成里,507,1542,608,208,816,37,853
公投第８案,臺北市,南港區,聯成里,508,1463,612,192,804,48,852
公投第８案,臺北市,南港區,萬福里,509,1195,502,174,676,78,754
公投第８案,臺北市,南港區,萬福里,510,1254,502,212,714,20,734
公投第８案,臺北市,南港區,萬福里,511,1356,587,151,738,47,785
公投第８案,臺北市,南港區,鴻福里,512,1363,563,194,757,78,835
公投第８案,臺北市,南港區,鴻福里,513,1317,593,188,781,51,832
公投第８案,臺北市,南港區,鴻福里,514,1331,558,170,728,37,765
公投第８案,臺北市,南港區,百福里,515,1610,631,220,851,80,931
公投第８案,臺北市,南港區,百福里,516,1542,593,203,796,40,836
公投第８案,臺北市,南港區,百福里,517,1581,643,203,846,85,931
公投第８案,臺北市,南港區,成福里,518,1225,554,161,715,49,764
公投第８案,臺北市,南港區,成福里,519,1264,558,185,743,57,800
公投第８案,臺北市,南港區,成福里,520,1649,713,212,925,85,1010
公投第８案,臺北市,南港區,成福里,521,1267,566,162,728,23,751
公投第８案,臺北市,南港區,成福里,522,1336,569,154,723,43,766
公投第８案,臺北市,南港區,仁福里,523,1162,525,150,675,27,702
公投第８案,臺北市,南港區,仁福里,524,1045,462,120,582,24,606
公投第８案,臺北市,南港區,仁福里,525,1351,669,156,825,65,890
公投第８案,臺北市,南港區,仁福里,526,1358,608,116,724,33,757
公投第８案,臺北市,松山區,莊敬里,527,1583,663,198,861,57,918
公投第８案,臺北市,松山區,莊敬里,528,1691,668,227,895,78,973
公投第８案,臺北市,松山區,莊敬里,529,1386,683,57,740,53,793
公投第８案,臺北市,松山區,東榮里,530,1362,560,200,760,63,823
公投第８案,臺北市,松山區,東榮里,531,1399,588,195,783,59,842
公投第８案,臺北市,松山區,東榮里,532,1324,542,202,744,59,803
公投第８案,臺北市,松山區,東榮里,533,1296,542,226,768,63,831
公投第８案,臺北市,松山區,東榮里,534,1386,580,215,795,59,854
公投第８案,臺北市,松山區,三民里,535,1529,636,251,887,84,971
公投第８案,臺北市,松山區,三民里,536,1416,609,157,766,50,816
公投第８案,臺北市,松山區,三民里,537,1619,641,197,838,64,902
公投第８案,臺北市,松山區,三民里,538,1386,561,213,774,64,838
公投第８案,臺北市,松山區,新益里,539,1380,622,205,827,58,885
公投第８案,臺北市,松山區,新益里,540,1357,576,187,763,53,816
公投第８案,臺北市,松山區,新益里,541,1296,571,192,763,51,814
公投第８案,臺北市,松山區,富錦里,542,1632,721,177,898,85,983
公投第８案,臺北市,松山區,富錦里,543,1414,563,206,769,52,821
公投第８案,臺北市,松山區,富錦里,544,1404,595,209,804,53,857
公投第８案,臺北市,松山區,新東里,545,1365,585,181,766,83,849
公投第８案,臺北市,松山區,新東里,546,1431,600,187,787,73,860
公投第８案,臺北市,松山區,新東里,547,1483,629,215,844,58,902
公投第８案,臺北市,松山區,富泰里,548,1293,592,167,759,50,809
公投第８案,臺北市,松山區,富泰里,549,1410,597,158,755,50,805
公投第８案,臺北市,松山區,富泰里,550,1307,582,161,743,53,796
公投第８案,臺北市,松山區,介壽里,551,1242,545,184,729,60,789
公投第８案,臺北市,松山區,介壽里,552,1192,525,172,697,35,732
公投第８案,臺北市,松山區,介壽里,553,1276,556,185,741,59,800
公投第８案,臺北市,松山區,精忠里,554,1201,491,178,669,35,704
公投第８案,臺北市,松山區,精忠里,555,1318,570,179,749,44,793
公投第８案,臺北市,松山區,精忠里,556,1157,505,177,682,41,723
公投第８案,臺北市,松山區,東光里,557,1157,445,196,641,15,656
公投第８案,臺北市,松山區,東光里,558,1357,578,188,766,64,830
公投第８案,臺北市,松山區,東光里,559,1215,438,150,588,40,628
公投第８案,臺北市,松山區,東光里,560,1345,546,188,734,47,781
公投第８案,臺北市,松山區,東光里,561,1237,509,189,698,50,748
公投第８案,臺北市,松山區,龍田里,562,1393,592,145,737,37,774
公投第８案,臺北市,松山區,龍田里,563,1331,565,230,795,60,855
公投第８案,臺北市,松山區,龍田里,564,1550,676,228,904,60,964
公投第８案,臺北市,松山區,龍田里,565,1308,602,107,709,30,739
公投第８案,臺北市,松山區,龍田里,566,1490,699,131,830,44,874
公投第８案,臺北市,松山區,龍田里,567,1406,673,178,851,43,894
公投第８案,臺北市,松山區,東昌里,568,1191,521,205,726,44,770
公投第８案,臺北市,松山區,東昌里,569,1095,430,188,618,36,654
公投第８案,臺北市,松山區,東勢里,570,1198,481,174,655,50,705
公投第８案,臺北市,松山區,東勢里,571,1265,522,159,681,59,740
公投第８案,臺北市,松山區,東勢里,572,1225,496,182,678,52,730
公投第８案,臺北市,松山區,中華里,573,1698,738,250,988,61,1049
公投第８案,臺北市,松山區,中華里,574,1819,773,219,992,59,1051
公投第８案,臺北市,松山區,中華里,575,1754,710,275,985,70,1055
公投第８案,臺北市,松山區,民有里,576,1361,557,239,796,45,841
公投第８案,臺北市,松山區,民有里,577,1189,539,164,703,28,731
公投第８案,臺北市,松山區,民有里,578,1214,494,199,693,53,746
公投第８案,臺北市,松山區,民有里,579,1284,518,183,701,56,757
公投第８案,臺北市,松山區,民有里,580,1297,551,188,739,61,800
公投第８案,臺北市,松山區,民有里,581,1330,504,220,724,40,764
公投第８案,臺北市,松山區,民福里,582,1396,632,167,799,61,860
公投第８案,臺北市,松山區,民福里,583,1480,619,164,783,37,820
公投第８案,臺北市,松山區,民福里,584,1419,644,181,825,38,863
公投第８案,臺北市,松山區,民福里,585,1390,574,197,771,70,841
公投第８案,臺北市,松山區,松基里,586,1525,641,222,863,49,912
公投第８案,臺北市,松山區,松基里,587,1633,635,220,855,45,900
公投第８案,臺北市,松山區,慈祐里,588,2677,602,235,837,58,895
公投第８案,臺北市,松山區,慈祐里,589,1281,507,198,705,68,773
公投第８案,臺北市,松山區,慈祐里,590,1469,460,195,655,57,712
公投第８案,臺北市,松山區,慈祐里,591,1700,637,242,879,82,961
公投第８案,臺北市,松山區,安平里,592,1503,589,193,782,34,816
公投第８案,臺北市,松山區,安平里,593,1309,507,193,700,54,754
公投第８案,臺北市,松山區,安平里,594,1376,581,181,762,70,832
公投第８案,臺北市,松山區,安平里,595,1654,638,249,887,57,944
公投第８案,臺北市,松山區,安平里,596,1601,578,235,813,84,897
公投第８案,臺北市,松山區,鵬程里,597,1496,691,142,833,41,874
公投第８案,臺北市,松山區,鵬程里,598,1598,717,212,929,85,1014
公投第８案,臺北市,松山區,鵬程里,599,1751,770,221,991,64,1055
公投第８案,臺北市,松山區,自強里,600,1557,740,173,913,53,966
公投第８案,臺北市,松山區,自強里,601,1686,872,187,1059,55,1114
公投第８案,臺北市,松山區,自強里,602,1707,872,122,994,59,1053
公投第８案,臺北市,松山區,自強里,603,1854,923,209,1132,59,1191
公投第８案,臺北市,松山區,自強里,604,1740,704,221,925,51,976
公投第８案,臺北市,松山區,吉祥里,605,1494,590,214,804,83,887
公投第８案,臺北市,松山區,吉祥里,606,1453,636,187,823,50,873
公投第８案,臺北市,松山區,吉祥里,607,1458,604,212,816,56,872
公投第８案,臺北市,松山區,吉祥里,608,1536,646,197,843,57,900
公投第８案,臺北市,松山區,吉祥里,609,1463,625,212,837,45,882
公投第８案,臺北市,松山區,新聚里,610,1790,669,239,908,44,952
公投第８案,臺北市,松山區,新聚里,611,1679,662,277,939,59,998
公投第８案,臺北市,松山區,新聚里,612,1785,646,212,858,80,938
公投第８案,臺北市,松山區,新聚里,613,1793,678,264,942,76,1018
公投第８案,臺北市,松山區,復盛里,614,1381,597,157,754,67,821
公投第８案,臺北市,松山區,復盛里,615,1279,548,171,719,53,772
公投第８案,臺北市,松山區,復盛里,616,1681,700,238,938,75,1013
公投第８案,臺北市,松山區,復盛里,617,1232,538,182,720,54,774
公投第８案,臺北市,松山區,中正里,618,1533,808,11,819,63,882
公投第８案,臺北市,松山區,中正里,619,1540,632,255,887,58,945
公投第８案,臺北市,松山區,中正里,620,1716,645,256,901,51,952
公投第８案,臺北市,松山區,中正里,621,1664,606,260,866,55,921
公投第８案,臺北市,松山區,中正里,622,1350,553,185,738,40,778
公投第８案,臺北市,松山區,中崙里,623,1837,748,235,983,58,1041
公投第８案,臺北市,松山區,中崙里,624,1558,562,205,767,86,853
公投第８案,臺北市,松山區,美仁里,625,1420,604,213,817,61,878
公投第８案,臺北市,松山區,美仁里,626,1474,594,195,789,58,847
公投第８案,臺北市,松山區,吉仁里,627,1591,597,247,844,65,909
公投第８案,臺北市,松山區,吉仁里,628,1726,701,231,932,67,999
公投第８案,臺北市,松山區,敦化里,629,1452,575,222,797,49,846
公投第８案,臺北市,松山區,敦化里,630,1482,565,218,783,43,826
公投第８案,臺北市,松山區,敦化里,631,1460,584,226,810,56,866
公投第８案,臺北市,松山區,敦化里,632,1398,542,207,749,59,808
公投第８案,臺北市,松山區,復源里,633,1423,607,196,803,60,863
公投第８案,臺北市,松山區,復源里,634,1226,545,159,704,30,734
公投第８案,臺北市,松山區,復建里,635,1158,507,147,654,48,702
公投第８案,臺北市,松山區,復建里,636,1426,574,197,771,52,823
公投第８案,臺北市,松山區,復建里,637,1177,539,126,665,25,690
公投第８案,臺北市,松山區,復勢里,638,1363,533,206,739,55,794
公投第８案,臺北市,松山區,復勢里,639,1240,538,171,709,61,770
公投第８案,臺北市,松山區,復勢里,640,1375,575,213,788,64,852
公投第８案,臺北市,松山區,復勢里,641,1377,575,198,773,51,824
公投第８案,臺北市,松山區,福成里,642,1225,480,159,639,35,674
公投第８案,臺北市,松山區,福成里,643,1017,430,187,617,41,658
公投第８案,臺北市,信義區,西村里,644,2476,605,155,760,32,792
公投第８案,臺北市,信義區,西村里,645,1381,695,148,843,31,874
公投第８案,臺北市,信義區,西村里,646,1294,611,155,766,54,820
公投第８案,臺北市,信義區,正和里,647,1351,572,176,748,11,759
公投第８案,臺北市,信義區,正和里,648,1296,564,159,723,41,764
公投第８案,臺北市,信義區,正和里,649,1302,564,169,733,60,793
公投第８案,臺北市,信義區,興隆里,650,1025,403,110,513,69,582
公投第８案,臺北市,信義區,興隆里,651,1421,550,188,738,46,784
公投第８案,臺北市,信義區,中興里,652,1501,622,170,792,54,846
公投第８案,臺北市,信義區,中興里,653,1575,573,185,758,44,802
公投第８案,臺北市,信義區,新仁里,654,1516,661,177,838,35,873
公投第８案,臺北市,信義區,新仁里,655,1382,574,202,776,33,809
公投第８案,臺北市,信義區,興雅里,656,1128,464,140,604,52,656
公投第８案,臺北市,信義區,興雅里,657,1397,561,162,723,70,793
公投第８案,臺北市,信義區,興雅里,658,1161,500,176,676,51,727
公投第８案,臺北市,信義區,興雅里,659,1368,574,176,750,49,799
公投第８案,臺北市,信義區,敦厚里,660,1049,445,140,585,33,618
公投第８案,臺北市,信義區,敦厚里,661,1308,601,152,753,54,807
公投第８案,臺北市,信義區,敦厚里,662,1154,508,162,670,54,724
公投第８案,臺北市,信義區,敦厚里,663,1078,473,165,638,23,661
公投第８案,臺北市,信義區,廣居里,664,1375,590,167,757,50,807
公投第８案,臺北市,信義區,廣居里,665,1448,641,172,813,45,858
公投第８案,臺北市,信義區,廣居里,666,1250,532,182,714,29,743
公投第８案,臺北市,信義區,廣居里,667,1381,584,201,785,43,828
公投第８案,臺北市,信義區,廣居里,668,1213,523,168,691,62,753
公投第８案,臺北市,信義區,安康里,669,1373,627,214,841,57,898
公投第８案,臺北市,信義區,安康里,670,1226,523,180,703,44,747
公投第８案,臺北市,信義區,安康里,671,1117,466,167,633,26,659
公投第８案,臺北市,信義區,安康里,672,1123,489,151,640,55,695
公投第８案,臺北市,信義區,安康里,673,1200,520,156,676,51,727
公投第８案,臺北市,信義區,安康里,674,1335,515,163,678,32,710
公投第８案,臺北市,信義區,安康里,675,1332,532,159,691,38,729
公投第８案,臺北市,信義區,六藝里,676,1648,662,231,893,82,975
公投第８案,臺北市,信義區,六藝里,677,1542,509,301,810,73,883
公投第８案,臺北市,信義區,雅祥里,678,1228,507,164,671,59,730
公投第８案,臺北市,信義區,雅祥里,679,1731,671,258,929,71,1000
公投第８案,臺北市,信義區,雅祥里,680,1403,598,185,783,49,832
公投第８案,臺北市,信義區,五常里,681,1929,744,232,976,95,1071
公投第８案,臺北市,信義區,五常里,682,1300,563,185,748,54,802
公投第８案,臺北市,信義區,五全里,683,1486,556,185,741,39,780
公投第８案,臺北市,信義區,五全里,684,1532,532,170,702,73,775
公投第８案,臺北市,信義區,五全里,685,1387,595,209,804,62,866
公投第８案,臺北市,信義區,永吉里,686,1195,452,160,612,46,658
公投第８案,臺北市,信義區,永吉里,687,1068,420,127,547,40,587
公投第８案,臺北市,信義區,永吉里,688,1273,448,164,612,57,669
公投第８案,臺北市,信義區,長春里,689,1329,607,161,768,72,840
公投第８案,臺北市,信義區,長春里,690,1311,498,162,660,48,708
公投第８案,臺北市,信義區,長春里,691,1258,470,173,643,58,701
公投第８案,臺北市,信義區,四育里,692,1277,516,185,701,73,774
公投第８案,臺北市,信義區,四育里,693,1285,570,179,749,64,813
公投第８案,臺北市,信義區,四育里,694,1161,501,181,682,60,742
公投第８案,臺北市,信義區,四育里,695,1299,484,199,683,48,731
公投第８案,臺北市,信義區,四維里,696,1243,511,156,667,51,718
公投第８案,臺北市,信義區,四維里,697,1197,491,161,652,41,693
公投第８案,臺北市,信義區,四維里,698,1224,547,182,729,37,766
公投第８案,臺北市,信義區,四維里,699,1147,456,126,582,45,627
公投第８案,臺北市,信義區,永春里,700,1045,377,144,521,29,550
公投第８案,臺北市,信義區,永春里,701,1096,489,145,634,35,669
公投第８案,臺北市,信義區,永春里,702,1115,455,144,599,21,620
公投第８案,臺北市,信義區,永春里,703,1117,426,161,587,55,642
公投第８案,臺北市,信義區,富台里,704,1019,379,122,501,31,532
公投第８案,臺北市,信義區,富台里,705,1346,587,149,736,59,795
公投第８案,臺北市,信義區,富台里,706,1405,587,145,732,54,786
公投第８案,臺北市,信義區,國業里,707,1356,586,158,744,49,793
公投第８案,臺北市,信義區,國業里,708,1250,562,191,753,43,796
公投第８案,臺北市,信義區,國業里,709,1254,553,167,720,47,767
公投第８案,臺北市,信義區,國業里,710,1317,559,159,718,33,751
公投第８案,臺北市,信義區,國業里,711,1271,556,187,743,58,801
公投第８案,臺北市,信義區,松隆里,712,979,379,138,517,37,554
公投第８案,臺北市,信義區,松隆里,713,1025,391,135,526,48,574
公投第８案,臺北市,信義區,松友里,714,1512,560,151,711,41,752
公投第８案,臺北市,信義區,松友里,715,1483,648,206,854,36,890
公投第８案,臺北市,信義區,松友里,716,1359,605,174,779,48,827
公投第８案,臺北市,信義區,松友里,717,1387,577,212,789,28,817
公投第８案,臺北市,信義區,松光里,718,1455,551,194,745,39,784
公投第８案,臺北市,信義區,松光里,719,1461,565,231,796,39,835
公投第８案,臺北市,信義區,松光里,720,1532,661,178,839,54,893
公投第８案,臺北市,信義區,中坡里,721,1043,456,158,614,55,669
公投第８案,臺北市,信義區,中坡里,722,875,353,147,500,53,553
公投第８案,臺北市,信義區,中坡里,723,927,368,126,494,27,521
公投第８案,臺北市,信義區,中坡里,724,1119,436,174,610,72,682
公投第８案,臺北市,信義區,中行里,725,1463,568,226,794,61,855
公投第８案,臺北市,信義區,中行里,726,1293,552,204,756,63,819
公投第８案,臺北市,信義區,中行里,727,1553,623,198,821,59,880
公投第８案,臺北市,信義區,中行里,728,1360,537,199,736,44,780
公投第８案,臺北市,信義區,中行里,729,1392,574,181,755,80,835
公投第８案,臺北市,信義區,大道里,730,1377,545,194,739,31,770
公投第８案,臺北市,信義區,大道里,731,1377,587,176,763,17,780
公投第８案,臺北市,信義區,大道里,732,1269,448,215,663,39,702
公投第８案,臺北市,信義區,大道里,733,1407,586,177,763,82,845
公投第８案,臺北市,信義區,大仁里,734,1172,491,153,644,40,684
公投第８案,臺北市,信義區,大仁里,735,1182,501,146,647,27,674
公投第８案,臺北市,信義區,大仁里,736,1255,518,166,684,62,746
公投第８案,臺北市,信義區,景新里,737,1689,644,172,816,53,869
公投第８案,臺北市,信義區,景新里,738,1605,644,187,831,37,868
公投第８案,臺北市,信義區,景新里,739,1143,478,133,611,40,651
公投第８案,臺北市,信義區,惠安里,740,1440,560,172,732,45,777
公投第８案,臺北市,信義區,惠安里,741,1495,630,177,807,53,860
公投第８案,臺北市,信義區,惠安里,742,1514,625,201,826,61,887
公投第８案,臺北市,信義區,惠安里,743,1449,589,152,741,50,791
公投第８案,臺北市,信義區,三張里,744,1401,608,189,797,52,849
公投第８案,臺北市,信義區,三張里,745,1181,478,124,602,28,630
公投第８案,臺北市,信義區,三張里,746,1376,632,180,812,35,847
公投第８案,臺北市,信義區,三張里,747,1422,645,173,818,53,871
公投第８案,臺北市,信義區,三張里,748,1267,552,142,694,28,722
公投第８案,臺北市,信義區,三張里,749,1220,462,161,623,32,655
公投第８案,臺北市,信義區,三犁里,750,1562,592,178,770,31,801
公投第８案,臺北市,信義區,三犁里,751,1455,591,169,760,37,797
公投第８案,臺北市,信義區,三犁里,752,1605,652,175,827,52,879
公投第８案,臺北市,信義區,六合里,753,1626,787,173,960,29,989
公投第８案,臺北市,信義區,六合里,754,1561,647,202,849,84,933
公投第８案,臺北市,信義區,六合里,755,1547,537,172,709,34,743
公投第８案,臺北市,信義區,六合里,756,1336,566,164,730,30,760
公投第８案,臺北市,信義區,泰和里,757,1314,504,125,629,50,679
公投第８案,臺北市,信義區,泰和里,758,1297,511,141,652,49,701
公投第８案,臺北市,信義區,泰和里,759,1366,527,169,696,65,761
公投第８案,臺北市,信義區,泰和里,760,1472,576,203,779,62,841
公投第８案,臺北市,信義區,泰和里,761,1450,614,171,785,50,835
公投第８案,臺北市,信義區,景聯里,762,1328,529,186,715,57,772
公投第８案,臺北市,信義區,景聯里,763,1399,591,196,787,69,856
公投第８案,臺北市,信義區,景聯里,764,1373,573,190,763,76,839
公投第８案,臺北市,信義區,景勤里,765,1099,449,125,574,33,607
公投第８案,臺北市,信義區,景勤里,766,1226,488,167,655,52,707
公投第８案,臺北市,信義區,景勤里,767,1267,506,134,640,33,673
公投第８案,臺北市,信義區,雙和里,768,1531,643,200,843,74,917
公投第８案,臺北市,信義區,雙和里,769,1438,636,184,820,54,874
公投第８案,臺北市,信義區,雙和里,770,1657,667,191,858,31,889
公投第８案,臺北市,信義區,雙和里,771,1621,702,210,912,52,964
公投第８案,臺北市,信義區,嘉興里,772,1508,628,209,837,34,871
公投第８案,臺北市,信義區,嘉興里,773,1334,578,194,772,39,811
公投第８案,臺北市,信義區,黎順里,774,1246,412,131,543,51,594
公投第８案,臺北市,信義區,黎順里,775,1196,541,176,717,45,762
公投第８案,臺北市,信義區,黎順里,776,1220,524,159,683,32,715
公投第８案,臺北市,信義區,黎平里,777,1538,624,188,812,34,846
公投第８案,臺北市,信義區,黎平里,778,1565,687,182,869,74,943
公投第８案,臺北市,信義區,黎平里,779,1621,630,174,804,85,889
公投第８案,臺北市,信義區,黎平里,780,1486,597,171,768,69,837
公投第８案,臺北市,信義區,黎忠里,781,1507,596,172,768,36,804
公投第８案,臺北市,信義區,黎忠里,782,1516,650,177,827,72,899
公投第８案,臺北市,信義區,黎忠里,783,1287,561,171,732,72,804
公投第８案,臺北市,信義區,黎安里,784,1050,380,119,499,58,557
公投第８案,臺北市,信義區,黎安里,785,801,351,105,456,40,496
公投第８案,臺北市,中山區,正守里,786,1522,633,188,821,49,870
公投第８案,臺北市,中山區,正守里,787,1332,486,213,699,34,733
公投第８案,臺北市,中山區,正義里,788,1656,583,198,781,55,836
公投第８案,臺北市,中山區,正義里,789,1367,456,195,651,58,709
公投第８案,臺北市,中山區,正義里,790,1732,509,321,830,53,883
公投第８案,臺北市,中山區,正得里,791,1634,656,218,874,64,938
公投第８案,臺北市,中山區,正得里,792,1650,589,236,825,65,890
公投第８案,臺北市,中山區,民安里,793,1392,521,243,764,49,813
公投第８案,臺北市,中山區,民安里,794,1177,465,221,686,39,725
公投第８案,臺北市,中山區,民安里,795,1477,573,221,794,67,861
公投第８案,臺北市,中山區,康樂里,796,1063,375,146,521,60,581
公投第８案,臺北市,中山區,康樂里,797,1296,481,158,639,48,687
公投第８案,臺北市,中山區,中山里,798,1330,487,189,676,40,716
公投第８案,臺北市,中山區,中山里,799,1483,518,214,732,68,800
公投第８案,臺北市,中山區,中山里,800,1542,603,184,787,46,833
公投第８案,臺北市,中山區,中山里,801,1710,621,209,830,60,890
公投第８案,臺北市,中山區,聚盛里,802,1315,476,154,630,37,667
公投第８案,臺北市,中山區,聚盛里,803,1245,465,164,629,73,702
公投第８案,臺北市,中山區,聚盛里,804,1262,491,142,633,48,681
公投第８案,臺北市,中山區,集英里,805,1518,567,242,809,62,871
公投第８案,臺北市,中山區,集英里,806,1522,572,226,798,79,877
公投第８案,臺北市,中山區,集英里,807,1580,513,237,750,77,827
公投第８案,臺北市,中山區,集英里,808,1529,602,205,807,48,855
公投第８案,臺北市,中山區,聚葉里,809,1221,475,161,636,49,685
公投第８案,臺北市,中山區,聚葉里,810,1221,488,183,671,53,724
公投第８案,臺北市,中山區,聚葉里,811,1139,431,112,543,32,575
公投第８案,臺北市,中山區,恆安里,812,1407,494,218,712,85,797
公投第８案,臺北市,中山區,恆安里,813,1321,507,203,710,44,754
公投第８案,臺北市,中山區,恆安里,814,1578,576,164,740,48,788
公投第８案,臺北市,中山區,晴光里,815,1739,638,176,814,61,875
公投第８案,臺北市,中山區,晴光里,816,1637,589,220,809,49,858
公投第８案,臺北市,中山區,晴光里,817,1541,553,207,760,81,841
公投第８案,臺北市,中山區,圓山里,818,1210,488,174,662,57,719
公投第８案,臺北市,中山區,圓山里,819,1331,495,177,672,50,722
公投第８案,臺北市,中山區,圓山里,820,1224,421,153,574,70,644
公投第８案,臺北市,中山區,新庄里,821,1585,634,205,839,66,905
公投第８案,臺北市,中山區,新庄里,822,1523,615,239,854,93,947
公投第８案,臺北市,中山區,新庄里,823,1368,581,195,776,69,845
公投第８案,臺北市,中山區,劍潭里,824,1805,802,175,977,58,1035
公投第８案,臺北市,中山區,劍潭里,825,1404,656,116,772,56,828
公投第８案,臺北市,中山區,大直里,826,1708,716,297,1013,55,1068
公投第８案,臺北市,中山區,大直里,827,1451,635,208,843,69,912
公投第８案,臺北市,中山區,大直里,828,1684,712,231,943,88,1031
公投第８案,臺北市,中山區,大直里,829,1585,682,161,843,42,885
公投第８案,臺北市,中山區,大直里,830,1391,559,197,756,81,837
公投第８案,臺北市,中山區,成功里,831,1375,601,225,826,86,912
公投第８案,臺北市,中山區,成功里,832,1472,628,230,858,26,884
公投第８案,臺北市,中山區,成功里,833,1327,521,173,694,43,737
公投第８案,臺北市,中山區,成功里,834,1401,622,164,786,35,821
公投第８案,臺北市,中山區,永安里,835,1423,589,200,789,47,836
公投第８案,臺北市,中山區,永安里,836,1569,633,237,870,50,920
公投第８案,臺北市,中山區,永安里,837,1651,677,236,913,33,946
公投第８案,臺北市,中山區,永安里,838,1624,666,200,866,31,897
公投第８案,臺北市,中山區,永安里,839,1713,730,264,994,58,1052
公投第８案,臺北市,中山區,金泰里,840,1647,713,223,936,49,985
公投第８案,臺北市,中山區,金泰里,841,1762,664,236,900,54,954
公投第８案,臺北市,中山區,金泰里,842,1399,629,182,811,48,859
公投第８案,臺北市,中山區,金泰里,843,1489,663,214,877,46,923
公投第８案,臺北市,中山區,北安里,844,1269,582,157,739,39,778
公投第８案,臺北市,中山區,北安里,845,998,456,126,582,49,631
公投第８案,臺北市,中山區,新喜里,846,1472,471,186,657,68,725
公投第８案,臺北市,中山區,新喜里,847,1517,523,224,747,56,803
公投第８案,臺北市,中山區,新喜里,848,1704,722,225,947,80,1027
公投第８案,臺北市,中山區,新福里,849,1603,560,289,849,77,926
公投第８案,臺北市,中山區,新福里,850,1432,500,198,698,91,789
公投第８案,臺北市,中山區,新福里,851,1500,597,228,825,73,898
公投第８案,臺北市,中山區,松江里,852,1332,539,247,786,10,796
公投第８案,臺北市,中山區,松江里,853,1450,571,242,813,63,876
公投第８案,臺北市,中山區,松江里,854,1434,584,219,803,57,860
公投第８案,臺北市,中山區,松江里,855,1419,516,200,716,48,764
公投第８案,臺北市,中山區,新生里,856,1292,464,202,666,47,713
公投第８案,臺北市,中山區,新生里,857,1526,537,229,766,67,833
公投第８案,臺北市,中山區,新生里,858,1582,530,187,717,63,780
公投第８案,臺北市,中山區,中庄里,859,1588,533,217,750,73,823
公投第８案,臺北市,中山區,中庄里,860,1463,529,229,758,80,838
公投第８案,臺北市,中山區,中庄里,861,1533,514,213,727,61,788
公投第８案,臺北市,中山區,大佳里,862,944,332,153,485,61,546
公投第８案,臺北市,中山區,行政里,863,1745,704,305,1009,80,1089
公投第８案,臺北市,中山區,行政里,864,1679,579,205,784,57,841
公投第８案,臺北市,中山區,行政里,865,3419,558,196,754,60,814
公投第８案,臺北市,中山區,行仁里,866,1387,552,198,750,80,830
公投第８案,臺北市,中山區,行仁里,867,1672,660,235,895,84,979
公投第８案,臺北市,中山區,行仁里,868,1319,514,186,700,69,769
公投第８案,臺北市,中山區,行仁里,869,1364,497,207,704,66,770
公投第８案,臺北市,中山區,行仁里,870,1461,527,223,750,61,811
公投第８案,臺北市,中山區,行孝里,871,1173,446,191,637,56,693
公投第８案,臺北市,中山區,行孝里,872,1171,424,141,565,63,628
公投第８案,臺北市,中山區,行孝里,873,1310,502,189,691,51,742
公投第８案,臺北市,中山區,下埤里,874,1373,603,168,771,54,825
公投第８案,臺北市,中山區,下埤里,875,1290,537,190,727,40,767
公投第８案,臺北市,中山區,下埤里,876,1346,562,188,750,68,818
公投第８案,臺北市,中山區,下埤里,877,1468,590,229,819,70,889
公投第８案,臺北市,中山區,下埤里,878,1178,494,170,664,33,697
公投第８案,臺北市,中山區,江寧里,879,1654,683,241,924,55,979
公投第８案,臺北市,中山區,江寧里,880,1464,608,186,794,65,859
公投第８案,臺北市,中山區,江寧里,881,1450,534,220,754,40,794
公投第８案,臺北市,中山區,江寧里,882,1534,579,222,801,71,872
公投第８案,臺北市,中山區,江山里,883,1703,648,228,876,53,929
公投第８案,臺北市,中山區,江山里,884,1610,636,220,856,88,944
公投第８案,臺北市,中山區,江山里,885,1653,659,200,859,85,944
公投第８案,臺北市,中山區,江山里,886,1694,669,271,940,68,1008
公投第８案,臺北市,中山區,中吉里,887,1623,594,254,848,69,917
公投第８案,臺北市,中山區,中吉里,888,1618,607,273,880,65,945
公投第８案,臺北市,中山區,中吉里,889,1583,607,229,836,53,889
公投第８案,臺北市,中山區,中原里,890,1605,585,289,874,77,951
公投第８案,臺北市,中山區,中原里,891,1398,577,254,831,57,888
公投第８案,臺北市,中山區,中原里,892,1526,668,244,912,68,980
公投第８案,臺北市,中山區,興亞里,893,1555,586,257,843,65,908
公投第８案,臺北市,中山區,興亞里,894,1597,617,212,829,52,881
公投第８案,臺北市,中山區,興亞里,895,1587,598,237,835,95,930
公投第８案,臺北市,中山區,中央里,896,1587,693,188,881,76,957
公投第８案,臺北市,中山區,中央里,897,1546,621,239,860,83,943
公投第８案,臺北市,中山區,朱馥里,898,1322,520,167,687,64,751
公投第８案,臺北市,中山區,朱馥里,899,1267,512,175,687,52,739
公投第８案,臺北市,中山區,朱馥里,900,1210,520,143,663,20,683
公投第８案,臺北市,中山區,朱馥里,901,1295,525,160,685,63,748
公投第８案,臺北市,中山區,龍洲里,902,1467,672,209,881,65,946
公投第８案,臺北市,中山區,龍洲里,903,1491,686,148,834,48,882
公投第８案,臺北市,中山區,龍洲里,904,1516,778,149,927,62,989
公投第８案,臺北市,中山區,朱園里,905,1384,502,188,690,51,741
公投第８案,臺北市,中山區,朱園里,906,1138,513,165,678,47,725
公投第８案,臺北市,中山區,朱園里,907,1513,549,212,761,36,797
公投第８案,臺北市,中山區,埤頭里,908,1559,650,198,848,75,923
公投第８案,臺北市,中山區,埤頭里,909,1429,597,198,795,87,882
公投第８案,臺北市,中山區,朱崙里,910,1245,502,207,709,56,765
公投第８案,臺北市,中山區,朱崙里,911,1214,513,176,689,58,747
公投第８案,臺北市,中山區,力行里,912,1394,532,234,766,55,821
公投第８案,臺北市,中山區,力行里,913,1336,494,169,663,24,687
公投第８案,臺北市,中山區,力行里,914,1227,498,151,649,49,698
公投第８案,臺北市,中山區,力行里,915,1382,561,210,771,44,815
公投第８案,臺北市,中山區,復華里,916,1436,577,190,767,57,824
公投第８案,臺北市,中山區,復華里,917,1405,514,180,694,40,734
公投第８案,臺北市,中山區,復華里,918,1259,541,142,683,43,726
公投第８案,臺北市,大同區,玉泉里,919,1261,455,203,658,87,745
公投第８案,臺北市,大同區,玉泉里,920,1352,520,245,765,68,833
公投第８案,臺北市,大同區,建明里,921,1462,548,225,773,63,836
公投第８案,臺北市,大同區,建明里,922,1510,595,201,796,71,867
公投第８案,臺北市,大同區,建功里,923,1496,503,234,737,37,774
公投第８案,臺北市,大同區,建功里,924,1329,480,200,680,87,767
公投第８案,臺北市,大同區,建功里,925,1307,487,194,681,86,767
公投第８案,臺北市,大同區,建泰里,926,1065,410,155,565,63,628
公投第８案,臺北市,大同區,建泰里,927,1085,406,160,566,48,614
公投第８案,臺北市,大同區,建泰里,928,1047,401,189,590,66,656
公投第８案,臺北市,大同區,永樂里,929,1215,414,174,588,44,632
公投第８案,臺北市,大同區,永樂里,930,1117,427,219,646,40,686
公投第８案,臺北市,大同區,永樂里,931,1186,483,187,670,58,728
公投第８案,臺北市,大同區,永樂里,932,1185,447,212,659,64,723
公投第８案,臺北市,大同區,朝陽里,933,1359,517,195,712,48,760
公投第８案,臺北市,大同區,朝陽里,934,1273,510,173,683,34,717
公投第８案,臺北市,大同區,朝陽里,935,1291,521,202,723,56,779
公投第８案,臺北市,大同區,星明里,936,1288,485,168,653,51,704
公投第８案,臺北市,大同區,星明里,937,1245,505,210,715,55,770
公投第８案,臺北市,大同區,星明里,938,1261,531,195,726,65,791
公投第８案,臺北市,大同區,星明里,939,1348,503,197,700,35,735
公投第８案,臺北市,大同區,光能里,940,1676,623,255,878,102,980
公投第８案,臺北市,大同區,光能里,941,1311,542,194,736,67,803
公投第８案,臺北市,大同區,光能里,942,1316,498,210,708,87,795
公投第８案,臺北市,大同區,大有里,943,1409,520,222,742,74,816
公投第８案,臺北市,大同區,大有里,944,1436,565,229,794,70,864
公投第８案,臺北市,大同區,大有里,945,1408,531,238,769,64,833
公投第８案,臺北市,大同區,延平里,946,1276,479,207,686,46,732
公投第８案,臺北市,大同區,延平里,947,1110,460,146,606,18,624
公投第８案,臺北市,大同區,延平里,948,1324,526,197,723,35,758
公投第８案,臺北市,大同區,雙連里,949,1016,382,154,536,48,584
公投第８案,臺北市,大同區,雙連里,950,1028,430,160,590,47,637
公投第８案,臺北市,大同區,雙連里,951,1158,466,173,639,60,699
公投第８案,臺北市,大同區,雙連里,952,1138,470,164,634,57,691
公投第８案,臺北市,大同區,雙連里,953,1214,484,170,654,72,726
公投第８案,臺北市,大同區,雙連里,954,1090,418,167,585,26,611
公投第８案,臺北市,大同區,雙連里,955,1305,561,199,760,67,827
公投第８案,臺北市,大同區,南芳里,956,1167,428,156,584,34,618
公投第８案,臺北市,大同區,南芳里,957,1148,441,178,619,54,673
公投第８案,臺北市,大同區,南芳里,958,1203,504,180,684,53,737
公投第８案,臺北市,大同區,民權里,959,1441,512,222,734,54,788
公投第８案,臺北市,大同區,民權里,960,1315,525,228,753,68,821
公投第８案,臺北市,大同區,民權里,961,1393,521,189,710,82,792
公投第８案,臺北市,大同區,民權里,962,1278,505,199,704,62,766
公投第８案,臺北市,大同區,景星里,963,1246,431,177,608,56,664
公投第８案,臺北市,大同區,景星里,964,1142,411,173,584,75,659
公投第８案,臺北市,大同區,隆和里,965,1336,531,219,750,68,818
公投第８案,臺北市,大同區,隆和里,966,1363,549,220,769,65,834
公投第８案,臺北市,大同區,蓬萊里,967,1476,561,214,775,48,823
公投第８案,臺北市,大同區,蓬萊里,968,1418,525,245,770,66,836
公投第８案,臺北市,大同區,蓬萊里,969,1460,538,204,742,41,783
公投第８案,臺北市,大同區,國順里,970,1222,374,171,545,61,606
公投第８案,臺北市,大同區,國順里,971,1246,377,165,542,104,646
公投第８案,臺北市,大同區,國慶里,972,1256,482,218,700,80,780
公投第８案,臺北市,大同區,國慶里,973,1289,505,194,699,37,736
公投第８案,臺北市,大同區,國慶里,974,1340,479,200,679,24,703
公投第８案,臺北市,大同區,揚雅里,975,1555,544,226,770,67,837
公投第８案,臺北市,大同區,揚雅里,976,2459,550,184,734,85,819
公投第８案,臺北市,大同區,斯文里,977,1108,326,139,465,65,530
公投第８案,臺北市,大同區,斯文里,978,867,304,118,422,66,488
公投第８案,臺北市,大同區,斯文里,979,1329,546,217,763,57,820
公投第８案,臺北市,大同區,斯文里,980,1162,411,204,615,39,654
公投第８案,臺北市,大同區,鄰江里,981,1434,522,183,705,80,785
公投第８案,臺北市,大同區,鄰江里,982,1351,532,192,724,65,789
公投第８案,臺北市,大同區,鄰江里,983,1531,515,222,737,54,791
公投第８案,臺北市,大同區,鄰江里,984,1507,490,211,701,35,736
公投第８案,臺北市,大同區,至聖里,985,1488,530,231,761,69,830
公投第８案,臺北市,大同區,至聖里,986,1384,537,221,758,93,851
公投第８案,臺北市,大同區,至聖里,987,1460,575,194,769,78,847
公投第８案,臺北市,大同區,至聖里,988,1371,555,212,767,68,835
公投第８案,臺北市,大同區,至聖里,989,1439,540,208,748,34,782
公投第８案,臺北市,大同區,老師里,990,1376,524,226,750,82,832
公投第８案,臺北市,大同區,老師里,991,1366,490,194,684,93,777
公投第８案,臺北市,大同區,老師里,992,1218,510,215,725,62,787
公投第８案,臺北市,大同區,老師里,993,1235,512,154,666,62,728
公投第８案,臺北市,大同區,重慶里,994,1364,516,169,685,31,716
公投第８案,臺北市,大同區,重慶里,995,1408,569,332,901,93,994
公投第８案,臺北市,大同區,重慶里,996,1450,567,206,773,70,843
公投第８案,臺北市,大同區,重慶里,997,1429,597,216,813,76,889
公投第８案,臺北市,大同區,保安里,998,1170,450,188,638,78,716
公投第８案,臺北市,大同區,保安里,999,1245,441,214,655,77,732
公投第８案,臺北市,大同區,保安里,1000,1215,496,207,703,87,790
公投第８案,臺北市,中正區,水源里,1001,1308,541,197,738,44,782
公投第８案,臺北市,中正區,水源里,1002,1317,467,193,660,81,741
公投第８案,臺北市,中正區,富水里,1003,1069,510,116,626,35,661
公投第８案,臺北市,中正區,富水里,1004,1128,476,110,586,46,632
公投第８案,臺北市,中正區,文盛里,1005,1053,440,149,589,52,641
公投第８案,臺北市,中正區,文盛里,1006,1048,442,133,575,24,599
公投第８案,臺北市,中正區,林興里,1007,1297,547,128,675,59,734
公投第８案,臺北市,中正區,林興里,1008,1193,515,167,682,30,712
公投第８案,臺北市,中正區,林興里,1009,1500,692,225,917,53,970
公投第８案,臺北市,中正區,河堤里,1010,1346,530,176,706,40,746
公投第８案,臺北市,中正區,河堤里,1011,1283,538,174,712,24,736
公投第８案,臺北市,中正區,河堤里,1012,1450,582,184,766,57,823
公投第８案,臺北市,中正區,頂東里,1013,1433,604,192,796,58,854
公投第８案,臺北市,中正區,頂東里,1014,1309,580,225,805,56,861
公投第８案,臺北市,中正區,頂東里,1015,1386,580,198,778,27,805
公投第８案,臺北市,中正區,頂東里,1016,1201,519,163,682,47,729
公投第８案,臺北市,中正區,網溪里,1017,1336,582,184,766,61,827
公投第８案,臺北市,中正區,網溪里,1018,1358,577,197,774,52,826
公投第８案,臺北市,中正區,網溪里,1019,1177,503,156,659,55,714
公投第８案,臺北市,中正區,網溪里,1020,1236,578,171,749,38,787
公投第８案,臺北市,中正區,板溪里,1021,1478,598,205,803,54,857
公投第８案,臺北市,中正區,板溪里,1022,1474,637,193,830,28,858
公投第８案,臺北市,中正區,螢圃里,1023,1172,493,150,643,47,690
公投第８案,臺北市,中正區,螢圃里,1024,1310,526,198,724,49,773
公投第８案,臺北市,中正區,螢圃里,1025,1263,558,152,710,52,762
公投第８案,臺北市,中正區,螢圃里,1026,1169,480,176,656,45,701
公投第８案,臺北市,中正區,螢雪里,1027,1391,623,135,758,33,791
公投第８案,臺北市,中正區,螢雪里,1028,1201,480,167,647,39,686
公投第８案,臺北市,中正區,螢雪里,1029,1324,545,189,734,52,786
公投第８案,臺北市,中正區,永功里,1030,1216,473,143,616,65,681
公投第８案,臺北市,中正區,永功里,1031,1183,459,174,633,47,680
公投第８案,臺北市,中正區,永功里,1032,1469,585,226,811,76,887
公投第８案,臺北市,中正區,永功里,1033,1411,577,187,764,63,827
公投第８案,臺北市,中正區,永昌里,1034,1398,573,186,759,86,845
公投第８案,臺北市,中正區,永昌里,1035,1479,593,172,765,74,839
公投第８案,臺北市,中正區,永昌里,1036,1620,654,169,823,87,910
公投第８案,臺北市,中正區,龍興里,1037,1041,419,149,568,19,587
公投第８案,臺北市,中正區,龍興里,1038,1056,399,161,560,20,580
公投第８案,臺北市,中正區,龍興里,1039,1063,465,169,634,42,676
公投第８案,臺北市,中正區,忠勤里,1040,1591,501,173,674,69,743
公投第８案,臺北市,中正區,忠勤里,1041,1502,484,144,628,84,712
公投第８案,臺北市,中正區,忠勤里,1042,1331,502,140,642,69,711
公投第８案,臺北市,中正區,忠勤里,1043,1441,563,184,747,71,818
公投第８案,臺北市,中正區,廈安里,1044,1273,555,180,735,56,791
公投第８案,臺北市,中正區,廈安里,1045,1133,468,171,639,54,693
公投第８案,臺北市,中正區,廈安里,1046,1156,496,152,648,45,693
公投第８案,臺北市,中正區,愛國里,1047,1377,530,199,729,69,798
公投第８案,臺北市,中正區,愛國里,1048,1266,531,174,705,72,777
公投第８案,臺北市,中正區,南門里,1049,1111,519,142,661,48,709
公投第８案,臺北市,中正區,南門里,1050,1124,488,134,622,32,654
公投第８案,臺北市,中正區,龍光里,1051,1373,59,200,259,56,315
公投第８案,臺北市,中正區,龍光里,1052,1351,598,186,784,48,832
公投第８案,臺北市,中正區,南福里,1053,1495,620,214,834,38,872
公投第８案,臺北市,中正區,南福里,1054,1436,635,209,844,68,912
公投第８案,臺北市,中正區,南福里,1055,1516,637,193,830,33,863
公投第８案,臺北市,中正區,南福里,1056,1374,575,179,754,42,796
公投第８案,臺北市,中正區,南福里,1057,1522,594,192,786,48,834
公投第８案,臺北市,中正區,南福里,1058,1336,551,184,735,47,782
公投第８案,臺北市,中正區,龍福里,1059,1551,633,220,853,52,905
公投第８案,臺北市,中正區,龍福里,1060,1594,659,226,885,68,953
公投第８案,臺北市,中正區,龍福里,1061,1503,586,214,800,78,878
公投第８案,臺北市,中正區,新營里,1062,1455,633,184,817,42,859
公投第８案,臺北市,中正區,新營里,1063,1439,637,182,819,23,842
公投第８案,臺北市,中正區,新營里,1064,1469,612,200,812,51,863
公投第８案,臺北市,中正區,新營里,1065,1430,665,156,821,37,858
公投第８案,臺北市,中正區,新營里,1066,1444,641,190,831,60,891
公投第８案,臺北市,中正區,建國里,1067,1254,551,142,693,29,722
公投第８案,臺北市,中正區,光復里,1068,932,403,127,530,47,577
公投第８案,臺北市,中正區,光復里,1069,1055,420,172,592,51,643
公投第８案,臺北市,中正區,光復里,1070,1226,519,159,678,43,721
公投第８案,臺北市,中正區,黎明里,1071,1390,507,171,678,54,732
公投第８案,臺北市,中正區,黎明里,1072,1336,565,166,731,43,774
公投第８案,臺北市,中正區,梅花里,1073,1419,509,182,691,61,752
公投第８案,臺北市,中正區,梅花里,1074,1361,567,227,794,51,845
公投第８案,臺北市,中正區,幸福里,1075,2520,652,204,856,54,910
公投第８案,臺北市,中正區,幸福里,1076,1224,519,162,681,19,700
公投第８案,臺北市,中正區,幸福里,1077,1272,471,181,652,5,657
公投第８案,臺北市,中正區,幸市里,1078,1400,505,255,760,51,811
公投第８案,臺北市,中正區,幸市里,1079,1319,484,192,676,38,714
公投第８案,臺北市,中正區,幸市里,1080,1232,529,176,705,53,758
公投第８案,臺北市,中正區,東門里,1081,1265,571,181,752,46,798
公投第８案,臺北市,中正區,東門里,1082,1055,491,154,645,27,672
公投第８案,臺北市,中正區,東門里,1083,954,402,137,539,27,566
公投第８案,臺北市,中正區,文北里,1084,1018,432,141,573,37,610
公投第８案,臺北市,中正區,文北里,1085,1431,564,197,761,43,804
公投第８案,臺北市,中正區,文北里,1086,1271,463,159,622,46,668
公投第８案,臺北市,中正區,文北里,1087,983,386,181,567,47,614
公投第８案,臺北市,中正區,文祥里,1088,1594,613,240,853,48,901
公投第８案,臺北市,中正區,文祥里,1089,1565,704,193,897,58,955
公投第８案,臺北市,中正區,文祥里,1090,1650,666,231,897,47,944
公投第８案,臺北市,中正區,文祥里,1091,1600,597,232,829,45,874
公投第８案,臺北市,中正區,三愛里,1092,1391,542,209,751,23,774
公投第８案,臺北市,中正區,三愛里,1093,1769,700,249,949,53,1002
公投第８案,臺北市,中正區,三愛里,1094,1487,572,258,830,58,888
公投第８案,臺北市,中正區,三愛里,1095,1291,540,208,748,32,780
公投第８案,臺北市,中正區,三愛里,1096,1289,536,204,740,35,775
公投第８案,臺北市,萬華區,福星里,1097,1305,520,199,719,60,779
公投第８案,臺北市,萬華區,福星里,1098,1183,386,149,535,68,603
公投第８案,臺北市,萬華區,福星里,1099,1176,436,161,597,35,632
公投第８案,臺北市,萬華區,福星里,1100,1169,396,162,558,34,592
公投第８案,臺北市,萬華區,萬壽里,1101,1457,505,175,680,56,736
公投第８案,臺北市,萬華區,萬壽里,1102,1563,476,192,668,86,754
公投第８案,臺北市,萬華區,西門里,1103,1771,588,194,782,42,824
公投第８案,臺北市,萬華區,西門里,1104,1615,558,219,777,57,834
公投第８案,臺北市,萬華區,新起里,1105,1478,539,198,737,87,824
公投第８案,臺北市,萬華區,新起里,1106,1462,532,191,723,48,771
公投第８案,臺北市,萬華區,新起里,1107,1507,497,159,656,79,735
公投第８案,臺北市,萬華區,新起里,1108,1347,528,207,735,61,796
公投第８案,臺北市,萬華區,菜園里,1109,1367,489,186,675,55,730
公投第８案,臺北市,萬華區,菜園里,1110,1277,512,214,726,56,782
公投第８案,臺北市,萬華區,菜園里,1111,1395,492,254,746,56,802
公投第８案,臺北市,萬華區,菜園里,1112,1450,494,212,706,70,776
公投第８案,臺北市,萬華區,青山里,1113,1340,468,161,629,63,692
公投第８案,臺北市,萬華區,青山里,1114,1242,423,183,606,61,667
公投第８案,臺北市,萬華區,青山里,1115,1286,425,199,624,87,711
公投第８案,臺北市,萬華區,青山里,1116,1324,482,159,641,59,700
公投第８案,臺北市,萬華區,富民里,1117,1619,539,235,774,86,860
公投第８案,臺北市,萬華區,富民里,1118,1352,423,164,587,82,669
公投第８案,臺北市,萬華區,富民里,1119,1440,612,94,706,50,756
公投第８案,臺北市,萬華區,福音里,1120,1194,458,203,661,58,719
公投第８案,臺北市,萬華區,福音里,1121,1083,471,154,625,67,692
公投第８案,臺北市,萬華區,福音里,1122,1237,411,177,588,85,673
公投第８案,臺北市,萬華區,仁德里,1123,1625,531,232,763,79,842
公投第８案,臺北市,萬華區,仁德里,1124,1324,531,197,728,74,802
公投第８案,臺北市,萬華區,仁德里,1125,1352,537,179,716,77,793
公投第８案,臺北市,萬華區,富福里,1126,2630,464,209,673,66,739
公投第８案,臺北市,萬華區,富福里,1127,1504,576,261,837,71,908
公投第８案,臺北市,萬華區,富福里,1128,1425,513,197,710,64,774
公投第８案,臺北市,萬華區,柳鄉里,1129,1591,522,209,731,77,808
公投第８案,臺北市,萬華區,柳鄉里,1130,1474,552,164,716,87,803
公投第８案,臺北市,萬華區,柳鄉里,1131,1612,559,189,748,97,845
公投第８案,臺北市,萬華區,華江里,1132,1447,550,184,734,67,801
公投第８案,臺北市,萬華區,華江里,1133,1491,619,186,805,60,865
公投第８案,臺北市,萬華區,華江里,1134,1500,624,208,832,58,890
公投第８案,臺北市,萬華區,華江里,1135,1582,615,269,884,66,950
公投第８案,臺北市,萬華區,華江里,1136,1623,578,97,675,68,743
公投第８案,臺北市,萬華區,糖廍里,1137,1228,461,165,626,32,658
公投第８案,臺北市,萬華區,糖廍里,1138,1268,482,168,650,71,721
公投第８案,臺北市,萬華區,糖廍里,1139,1207,492,146,638,72,710
公投第８案,臺北市,萬華區,糖廍里,1140,1188,492,178,670,45,715
公投第８案,臺北市,萬華區,綠堤里,1141,1474,529,200,729,66,795
公投第８案,臺北市,萬華區,綠堤里,1142,1304,453,114,567,28,595
公投第８案,臺北市,萬華區,綠堤里,1143,1082,296,108,404,53,457
公投第８案,臺北市,萬華區,頂碩里,1144,1052,343,151,494,52,546
公投第８案,臺北市,萬華區,頂碩里,1145,1135,400,170,570,64,634
公投第８案,臺北市,萬華區,頂碩里,1146,1225,415,210,625,68,693
公投第８案,臺北市,萬華區,頂碩里,1147,1583,580,183,763,71,834
公投第８案,臺北市,萬華區,頂碩里,1148,1403,515,194,709,71,780
公投第８案,臺北市,萬華區,雙園里,1149,1406,533,195,728,77,805
公投第８案,臺北市,萬華區,雙園里,1150,1401,553,198,751,63,814
公投第８案,臺北市,萬華區,雙園里,1151,1188,475,168,643,67,710
公投第８案,臺北市,萬華區,和平里,1152,1597,553,204,757,87,844
公投第８案,臺北市,萬華區,和平里,1153,1290,516,194,710,83,793
公投第８案,臺北市,萬華區,和平里,1154,1746,557,235,792,38,830
公投第８案,臺北市,萬華區,和平里,1155,1595,505,199,704,52,756
公投第８案,臺北市,萬華區,和德里,1156,1701,579,233,812,119,931
公投第８案,臺北市,萬華區,和德里,1157,1339,404,173,577,88,665
公投第８案,臺北市,萬華區,和德里,1158,1484,475,161,636,98,734
公投第８案,臺北市,萬華區,和德里,1159,1604,612,210,822,91,913
公投第８案,臺北市,萬華區,全德里,1160,1197,466,174,640,50,690
公投第８案,臺北市,萬華區,全德里,1161,1347,478,171,649,84,733
公投第８案,臺北市,萬華區,全德里,1162,1223,537,188,725,54,779
公投第８案,臺北市,萬華區,日善里,1163,1036,426,133,559,42,601
公投第８案,臺北市,萬華區,日善里,1164,1035,412,183,595,68,663
公投第８案,臺北市,萬華區,日善里,1165,1141,510,187,697,10,707
公投第８案,臺北市,萬華區,忠德里,1166,1271,537,156,693,45,738
公投第８案,臺北市,萬華區,忠德里,1167,1328,508,200,708,98,806
公投第８案,臺北市,萬華區,忠德里,1168,1286,519,193,712,44,756
公投第８案,臺北市,萬華區,錦德里,1169,1679,664,228,892,96,988
公投第８案,臺北市,萬華區,錦德里,1170,1619,614,221,835,79,914
公投第８案,臺北市,萬華區,錦德里,1171,1625,542,196,738,74,812
公投第８案,臺北市,萬華區,孝德里,1172,1623,662,226,888,73,961
公投第８案,臺北市,萬華區,孝德里,1173,1280,480,155,635,82,717
公投第８案,臺北市,萬華區,壽德里,1174,1608,626,193,819,79,898
公投第８案,臺北市,萬華區,壽德里,1175,1453,560,220,780,68,848
公投第８案,臺北市,萬華區,壽德里,1176,1472,614,219,833,65,898
公投第８案,臺北市,萬華區,銘德里,1177,1373,522,224,746,45,791
公投第８案,臺北市,萬華區,銘德里,1178,1394,529,161,690,81,771
公投第８案,臺北市,萬華區,銘德里,1179,1427,503,179,682,46,728
公投第８案,臺北市,萬華區,保德里,1180,1342,531,226,757,67,824
公投第８案,臺北市,萬華區,保德里,1181,1569,650,202,852,82,934
公投第８案,臺北市,萬華區,榮德里,1182,1514,512,188,700,63,763
公投第８案,臺北市,萬華區,榮德里,1183,1720,580,190,770,41,811
公投第８案,臺北市,萬華區,華中里,1184,1461,620,200,820,79,899
公投第８案,臺北市,萬華區,華中里,1185,1264,466,169,635,43,678
公投第８案,臺北市,萬華區,華中里,1186,1334,574,201,775,66,841
公投第８案,臺北市,萬華區,華中里,1187,1446,563,207,770,50,820
公投第８案,臺北市,萬華區,興德里,1188,1307,476,152,628,53,681
公投第８案,臺北市,萬華區,興德里,1189,1420,560,175,735,94,829
公投第８案,臺北市,萬華區,興德里,1190,1427,491,198,689,41,730
公投第８案,臺北市,萬華區,日祥里,1191,956,373,122,495,48,543
公投第８案,臺北市,萬華區,日祥里,1192,1352,554,163,717,74,791
公投第８案,臺北市,萬華區,日祥里,1193,1370,588,130,718,54,772
公投第８案,臺北市,萬華區,日祥里,1194,1222,586,96,682,52,734
公投第８案,臺北市,萬華區,忠貞里,1195,1375,613,106,719,50,769
公投第８案,臺北市,萬華區,忠貞里,1196,1463,643,151,794,62,856
公投第８案,臺北市,萬華區,忠貞里,1197,1527,577,156,733,46,779
公投第８案,臺北市,萬華區,新忠里,1198,1485,600,147,747,57,804
公投第８案,臺北市,萬華區,新忠里,1199,1591,788,145,933,48,981
公投第８案,臺北市,萬華區,新和里,1200,1394,714,157,871,32,903
公投第８案,臺北市,萬華區,新和里,1201,1522,659,172,831,38,869
公投第８案,臺北市,萬華區,新和里,1202,1661,817,147,964,40,1004
公投第８案,臺北市,萬華區,新和里,1203,1561,723,180,903,33,936
公投第８案,臺北市,萬華區,新和里,1204,1406,660,183,843,53,896
公投第８案,臺北市,萬華區,新安里,1205,1498,473,171,644,49,693
公投第８案,臺北市,萬華區,新安里,1206,1478,461,160,621,78,699
公投第８案,臺北市,萬華區,新安里,1207,1170,429,188,617,69,686
公投第８案,臺北市,萬華區,新安里,1208,1376,634,126,760,57,817
公投第８案,臺北市,萬華區,凌霄里,1209,1093,468,121,589,25,614
公投第８案,臺北市,萬華區,凌霄里,1210,1084,490,127,617,64,681
公投第８案,臺北市,萬華區,凌霄里,1211,1119,489,136,625,51,676
公投第８案,臺北市,萬華區,騰雲里,1212,1381,630,179,809,47,856
公投第８案,臺北市,萬華區,騰雲里,1213,1396,589,176,765,53,818
公投第８案,臺北市,大安區,德安里,1214,1184,453,159,612,31,643
公投第８案,臺北市,大安區,德安里,1215,1197,465,144,609,44,653
公投第８案,臺北市,大安區,德安里,1216,1221,497,176,673,27,700
公投第８案,臺北市,大安區,德安里,1217,1246,580,139,719,23,742
公投第８案,臺北市,大安區,仁慈里,1218,1478,614,243,857,42,899
公投第８案,臺北市,大安區,仁慈里,1219,1314,493,193,686,65,751
公投第８案,臺北市,大安區,仁慈里,1220,1594,665,235,900,63,963
公投第８案,臺北市,大安區,和安里,1221,1429,598,225,823,30,853
公投第８案,臺北市,大安區,和安里,1222,1452,642,201,843,29,872
公投第８案,臺北市,大安區,和安里,1223,1551,603,247,850,36,886
公投第８案,臺北市,大安區,和安里,1224,1335,561,190,751,55,806
公投第８案,臺北市,大安區,民炤里,1225,1196,455,157,612,30,642
公投第８案,臺北市,大安區,民炤里,1226,1339,489,205,694,39,733
公投第８案,臺北市,大安區,民炤里,1227,1448,534,226,760,45,805
公投第８案,臺北市,大安區,民炤里,1228,1373,581,167,748,51,799
公投第８案,臺北市,大安區,民炤里,1229,1439,561,204,765,71,836
公投第８案,臺北市,大安區,仁愛里,1230,1174,450,156,606,17,623
公投第８案,臺北市,大安區,仁愛里,1231,1144,413,156,569,31,600
公投第８案,臺北市,大安區,仁愛里,1232,1119,442,124,566,34,600
公投第８案,臺北市,大安區,仁愛里,1233,1024,357,108,465,34,499
公投第８案,臺北市,大安區,義村里,1234,1032,488,112,600,27,627
公投第８案,臺北市,大安區,義村里,1235,1319,659,94,753,41,794
公投第８案,臺北市,大安區,義村里,1236,1369,615,180,795,47,842
公投第８案,臺北市,大安區,義村里,1237,1347,518,221,739,56,795
公投第８案,臺北市,大安區,民輝里,1238,1655,568,244,812,51,863
公投第８案,臺北市,大安區,民輝里,1239,1595,575,185,760,41,801
公投第８案,臺北市,大安區,民輝里,1240,1429,525,228,753,42,795
公投第８案,臺北市,大安區,民輝里,1241,1309,478,172,650,26,676
公投第８案,臺北市,大安區,昌隆里,1242,1508,554,209,763,47,810
公投第８案,臺北市,大安區,昌隆里,1243,1310,462,213,675,44,719
公投第８案,臺北市,大安區,誠安里,1244,1233,424,172,596,38,634
公投第８案,臺北市,大安區,誠安里,1245,1287,466,163,629,58,687
公投第８案,臺北市,大安區,誠安里,1246,1147,399,159,558,38,596
公投第８案,臺北市,大安區,光武里,1247,1260,465,177,642,33,675
公投第８案,臺北市,大安區,光武里,1248,1377,549,173,722,45,767
公投第８案,臺北市,大安區,光武里,1249,1284,488,158,646,68,714
公投第８案,臺北市,大安區,光武里,1250,1314,493,154,647,36,683
公投第８案,臺北市,大安區,光武里,1251,1273,456,189,645,32,677
公投第８案,臺北市,大安區,龍坡里,1252,1146,453,184,637,29,666
公投第８案,臺北市,大安區,龍坡里,1253,1285,517,204,721,30,751
公投第８案,臺北市,大安區,龍坡里,1254,1297,542,207,749,33,782
公投第８案,臺北市,大安區,龍坡里,1255,1101,486,153,639,34,673
公投第８案,臺北市,大安區,龍泉里,1256,1310,497,196,693,62,755
公投第８案,臺北市,大安區,龍泉里,1257,1365,540,226,766,65,831
公投第８案,臺北市,大安區,龍泉里,1258,1372,561,187,748,32,780
公投第８案,臺北市,大安區,古風里,1259,1189,501,194,695,34,729
公投第８案,臺北市,大安區,古風里,1260,1256,498,201,699,47,746
公投第８案,臺北市,大安區,古風里,1261,1151,487,166,653,37,690
公投第８案,臺北市,大安區,古莊里,1262,1501,481,196,677,45,722
公投第８案,臺北市,大安區,古莊里,1263,1520,657,203,860,40,900
公投第８案,臺北市,大安區,古莊里,1264,1529,645,252,897,52,949
公投第８案,臺北市,大安區,古莊里,1265,1579,671,233,904,54,958
公投第８案,臺北市,大安區,龍安里,1266,2619,470,159,629,48,677
公投第８案,臺北市,大安區,龍安里,1267,1290,555,153,708,28,736
公投第８案,臺北市,大安區,龍安里,1268,1307,541,227,768,39,807
公投第８案,臺北市,大安區,龍安里,1269,1489,631,191,822,36,858
公投第８案,臺北市,大安區,錦安里,1270,1097,496,149,645,40,685
公投第８案,臺北市,大安區,錦安里,1271,1328,542,182,724,48,772
公投第８案,臺北市,大安區,錦安里,1272,1189,469,181,650,26,676
公投第８案,臺北市,大安區,錦安里,1273,1270,508,202,710,26,736
公投第８案,臺北市,大安區,福住里,1274,1349,528,207,735,21,756
公投第８案,臺北市,大安區,福住里,1275,1292,515,170,685,35,720
公投第８案,臺北市,大安區,福住里,1276,1314,564,197,761,43,804
公投第８案,臺北市,大安區,福住里,1277,1200,483,195,678,52,730
公投第８案,臺北市,大安區,永康里,1278,1558,610,244,854,50,904
公投第８案,臺北市,大安區,永康里,1279,1561,617,228,845,47,892
公投第８案,臺北市,大安區,光明里,1280,1446,617,186,803,59,862
公投第８案,臺北市,大安區,光明里,1281,1499,635,203,838,43,881
公投第８案,臺北市,大安區,錦泰里,1282,1467,640,186,826,30,856
公投第８案,臺北市,大安區,錦泰里,1283,1511,568,120,688,52,740
公投第８案,臺北市,大安區,錦華里,1284,1600,674,223,897,61,958
公投第８案,臺北市,大安區,錦華里,1285,1573,619,258,877,53,930
公投第８案,臺北市,大安區,錦華里,1286,1467,636,208,844,51,895
公投第８案,臺北市,大安區,龍圖里,1287,1358,584,160,744,61,805
公投第８案,臺北市,大安區,龍圖里,1288,1568,620,209,829,71,900
公投第８案,臺北市,大安區,龍圖里,1289,1411,575,216,791,47,838
公投第８案,臺北市,大安區,龍圖里,1290,1554,666,198,864,30,894
公投第８案,臺北市,大安區,新龍里,1291,1345,604,175,779,43,822
公投第８案,臺北市,大安區,新龍里,1292,1435,652,149,801,27,828
公投第８案,臺北市,大安區,新龍里,1293,1481,708,185,893,30,923
公投第８案,臺北市,大安區,新龍里,1294,1451,734,157,891,40,931
公投第８案,臺北市,大安區,龍陣里,1295,1566,628,227,855,66,921
公投第８案,臺北市,大安區,龍陣里,1296,1525,624,226,850,39,889
公投第８案,臺北市,大安區,龍雲里,1297,1336,517,167,684,52,736
公投第８案,臺北市,大安區,龍雲里,1298,1483,606,222,828,65,893
公投第８案,臺北市,大安區,龍雲里,1299,1396,514,154,668,40,708
公投第８案,臺北市,大安區,龍生里,1300,1406,605,204,809,62,871
公投第８案,臺北市,大安區,龍生里,1301,1434,600,212,812,40,852
公投第８案,臺北市,大安區,龍生里,1302,1288,521,190,711,37,748
公投第８案,臺北市,大安區,龍生里,1303,1407,584,204,788,42,830
公投第８案,臺北市,大安區,住安里,1304,1514,563,203,766,43,809
公投第８案,臺北市,大安區,住安里,1305,1550,552,159,711,59,770
公投第８案,臺北市,大安區,住安里,1306,1490,624,192,816,54,870
公投第８案,臺北市,大安區,義安里,1307,1284,503,168,671,35,706
公投第８案,臺北市,大安區,義安里,1308,1129,503,134,637,39,676
公投第８案,臺北市,大安區,義安里,1309,1193,500,176,676,27,703
公投第８案,臺北市,大安區,義安里,1310,1057,413,151,564,36,600
公投第８案,臺北市,大安區,通化里,1311,1361,532,196,728,53,781
公投第８案,臺北市,大安區,通化里,1312,1412,557,169,726,68,794
公投第８案,臺北市,大安區,通化里,1313,1423,461,174,635,50,685
公投第８案,臺北市,大安區,通化里,1314,1257,475,176,651,85,736
公投第８案,臺北市,大安區,通安里,1315,1133,470,180,650,53,703
公投第８案,臺北市,大安區,通安里,1316,1077,405,158,563,38,601
公投第８案,臺北市,大安區,通安里,1317,1300,538,197,735,51,786
公投第８案,臺北市,大安區,通安里,1318,1319,600,151,751,70,821
公投第８案,臺北市,大安區,臨江里,1319,1265,535,146,681,75,756
公投第８案,臺北市,大安區,臨江里,1320,1265,486,158,644,39,683
公投第８案,臺北市,大安區,臨江里,1321,1103,480,138,618,35,653
公投第８案,臺北市,大安區,法治里,1322,1341,604,139,743,42,785
公投第８案,臺北市,大安區,法治里,1323,1357,618,155,773,50,823
公投第８案,臺北市,大安區,法治里,1324,1260,526,179,705,42,747
公投第８案,臺北市,大安區,全安里,1325,1295,556,170,726,40,766
公投第８案,臺北市,大安區,全安里,1326,1399,542,155,697,40,737
公投第８案,臺北市,大安區,全安里,1327,1150,461,163,624,37,661
公投第８案,臺北市,大安區,群賢里,1328,1351,532,145,677,36,713
公投第８案,臺北市,大安區,群賢里,1329,1341,552,196,748,49,797
公投第８案,臺北市,大安區,群賢里,1330,1129,466,141,607,23,630
公投第８案,臺北市,大安區,群賢里,1331,1328,584,144,728,25,753
公投第８案,臺北市,大安區,群英里,1332,1557,788,140,928,48,976
公投第８案,臺北市,大安區,群英里,1333,1461,687,188,875,50,925
公投第８案,臺北市,大安區,群英里,1334,1589,615,165,780,33,813
公投第８案,臺北市,大安區,群英里,1335,1473,640,149,789,40,829
公投第８案,臺北市,大安區,虎嘯里,1336,1479,499,299,798,39,837
公投第８案,臺北市,大安區,虎嘯里,1337,833,370,117,487,33,520
公投第８案,臺北市,大安區,虎嘯里,1338,999,412,123,535,30,565
公投第８案,臺北市,大安區,臥龍里,1339,1757,819,187,1006,44,1050
公投第８案,臺北市,大安區,龍淵里,1340,1573,679,197,876,40,916
公投第８案,臺北市,大安區,龍淵里,1341,1587,697,230,927,53,980
公投第８案,臺北市,大安區,龍淵里,1342,1496,597,255,852,62,914
公投第８案,臺北市,大安區,龍淵里,1343,1440,596,201,797,48,845
公投第８案,臺北市,大安區,龍淵里,1344,1578,655,240,895,56,951
公投第８案,臺北市,大安區,龍門里,1345,1223,486,193,679,32,711
公投第８案,臺北市,大安區,龍門里,1346,1119,445,169,614,21,635
公投第８案,臺北市,大安區,龍門里,1347,1252,554,169,723,25,748
公投第８案,臺北市,大安區,大學里,1348,1576,649,230,879,45,924
公投第８案,臺北市,大安區,大學里,1349,1425,568,187,755,47,802
公投第８案,臺北市,大安區,大學里,1350,1450,537,206,743,33,776
公投第８案,臺北市,大安區,大學里,1351,1444,558,207,765,42,807
公投第８案,臺北市,大安區,大學里,1352,1337,580,204,784,44,828
公投第８案,臺北市,大安區,芳和里,1353,1417,539,181,720,35,755
公投第８案,臺北市,大安區,芳和里,1354,1250,317,259,576,54,630
公投第８案,臺北市,大安區,芳和里,1355,1176,474,149,623,61,684
公投第８案,臺北市,大安區,芳和里,1356,1257,552,180,732,52,784
公投第８案,臺北市,大安區,黎元里,1357,1257,525,171,696,53,749
公投第８案,臺北市,大安區,黎元里,1358,1148,472,154,626,32,658
公投第８案,臺北市,大安區,黎元里,1359,1418,559,200,759,61,820
公投第８案,臺北市,大安區,黎元里,1360,1028,418,132,550,25,575
公投第８案,臺北市,大安區,黎孝里,1361,1445,506,210,716,54,770
公投第８案,臺北市,大安區,黎孝里,1362,1361,582,171,753,55,808
公投第８案,臺北市,大安區,黎孝里,1363,1343,573,194,767,53,820
公投第８案,臺北市,大安區,黎孝里,1364,1267,516,174,690,62,752
公投第８案,臺北市,大安區,黎孝里,1365,1380,547,170,717,35,752
公投第８案,臺北市,大安區,黎和里,1366,1524,607,183,790,61,851
公投第８案,臺北市,大安區,黎和里,1367,1470,633,183,816,42,858
公投第８案,臺北市,大安區,黎和里,1368,1318,507,124,631,61,692
公投第８案,臺北市,大安區,建安里,1369,1430,566,181,747,47,794
公投第８案,臺北市,大安區,建安里,1370,1386,561,180,741,56,797
公投第８案,臺北市,大安區,建安里,1371,1438,539,187,726,32,758
公投第８案,臺北市,大安區,建倫里,1372,1270,465,160,625,29,654
公投第８案,臺北市,大安區,建倫里,1373,1395,537,173,710,67,777
公投第８案,臺北市,大安區,建倫里,1374,1292,518,169,687,49,736
公投第８案,臺北市,大安區,建倫里,1375,1310,522,165,687,42,729
公投第８案,臺北市,大安區,敦安里,1376,1319,513,182,695,40,735
公投第８案,臺北市,大安區,敦安里,1377,1355,636,119,755,30,785
公投第８案,臺北市,大安區,敦安里,1378,1312,512,146,658,28,686
公投第８案,臺北市,大安區,敦安里,1379,1335,559,157,716,29,745
公投第８案,臺北市,大安區,正聲里,1380,1489,550,188,738,42,780
公投第８案,臺北市,大安區,正聲里,1381,1307,551,166,717,28,745
公投第８案,臺北市,大安區,正聲里,1382,1328,493,187,680,20,700
公投第８案,臺北市,大安區,敦煌里,1383,1277,484,166,650,10,660
公投第８案,臺北市,大安區,敦煌里,1384,1314,537,165,702,44,746
公投第８案,臺北市,大安區,敦煌里,1385,1270,516,195,711,55,766
公投第８案,臺北市,大安區,敦煌里,1386,1308,510,187,697,59,756
公投第８案,臺北市,大安區,華聲里,1387,1138,445,155,600,33,633
公投第８案,臺北市,大安區,華聲里,1388,1333,559,147,706,31,737
公投第８案,臺北市,大安區,華聲里,1389,1176,484,155,639,45,684
公投第８案,臺北市,大安區,車層里,1390,1311,514,189,703,53,756
公投第８案,臺北市,大安區,車層里,1391,1295,500,179,679,32,711
公投第８案,臺北市,大安區,車層里,1392,1421,587,178,765,59,824
公投第８案,臺北市,大安區,車層里,1393,1409,556,177,733,49,782
公投第８案,臺北市,大安區,光信里,1394,1434,607,201,808,39,847
公投第８案,臺北市,大安區,光信里,1395,1449,528,199,727,55,782
公投第８案,臺北市,大安區,光信里,1396,1284,520,183,703,55,758
公投第８案,臺北市,大安區,光信里,1397,1248,485,154,639,33,672
公投第８案,臺北市,大安區,光信里,1398,1119,505,180,685,33,718
公投第８案,臺北市,大安區,學府里,1399,883,388,108,496,36,532
公投第８案,臺北市,大安區,學府里,1400,630,244,75,319,40,359
公投第８案,臺北市,大安區,學府里,1401,814,3,123,126,33,159
公投第８案,臺北市,文山區,景行里,1402,1539,584,239,823,40,863
公投第８案,臺北市,文山區,景行里,1403,1548,604,171,775,40,815
公投第８案,臺北市,文山區,景行里,1404,1493,619,208,827,77,904
公投第８案,臺北市,文山區,景行里,1405,1648,702,224,926,66,992
公投第８案,臺北市,文山區,景東里,1406,1544,652,188,840,57,897
公投第８案,臺北市,文山區,景東里,1407,1557,663,178,841,68,909
公投第８案,臺北市,文山區,景東里,1408,1514,642,160,802,52,854
公投第８案,臺北市,文山區,景東里,1409,1540,730,192,922,64,986
公投第８案,臺北市,文山區,景美里,1410,1466,677,184,861,44,905
公投第８案,臺北市,文山區,景美里,1411,1444,656,196,852,46,898
公投第８案,臺北市,文山區,景美里,1412,1455,615,199,814,72,886
公投第８案,臺北市,文山區,景慶里,1413,1440,578,170,748,62,810
公投第８案,臺北市,文山區,景慶里,1414,1398,605,189,794,66,860
公投第８案,臺北市,文山區,景慶里,1415,1412,582,148,730,31,761
公投第８案,臺北市,文山區,景慶里,1416,1426,587,185,772,54,826
公投第８案,臺北市,文山區,景仁里,1417,1437,603,198,801,49,850
公投第８案,臺北市,文山區,景仁里,1418,1340,587,167,754,55,809
公投第８案,臺北市,文山區,景仁里,1419,1568,646,205,851,37,888
公投第８案,臺北市,文山區,景華里,1420,1372,597,153,750,32,782
公投第８案,臺北市,文山區,景華里,1421,1046,451,109,560,38,598
公投第８案,臺北市,文山區,景華里,1422,1274,547,168,715,48,763
公投第８案,臺北市,文山區,景華里,1423,1324,566,173,739,42,781
公投第８案,臺北市,文山區,萬有里,1424,1722,703,223,926,63,989
公投第８案,臺北市,文山區,萬有里,1425,1737,758,196,954,74,1028
公投第８案,臺北市,文山區,萬有里,1426,1370,657,166,823,28,851
公投第８案,臺北市,文山區,萬祥里,1427,1495,611,202,813,67,880
公投第８案,臺北市,文山區,萬祥里,1428,1328,581,167,748,54,802
公投第８案,臺北市,文山區,萬祥里,1429,1138,488,151,639,58,697
公投第８案,臺北市,文山區,萬隆里,1430,1471,664,169,833,41,874
公投第８案,臺北市,文山區,萬隆里,1431,1144,510,163,673,40,713
公投第８案,臺北市,文山區,萬隆里,1432,1176,530,170,700,60,760
公投第８案,臺北市,文山區,萬隆里,1433,1212,523,84,607,51,658
公投第８案,臺北市,文山區,萬隆里,1434,1214,539,166,705,44,749
公投第８案,臺北市,文山區,萬年里,1435,1170,463,163,626,47,673
公投第８案,臺北市,文山區,萬年里,1436,1308,532,210,742,55,797
公投第８案,臺北市,文山區,萬年里,1437,1190,507,160,667,58,725
公投第８案,臺北市,文山區,萬年里,1438,1110,491,122,613,49,662
公投第８案,臺北市,文山區,萬和里,1439,1512,655,173,828,59,887
公投第８案,臺北市,文山區,萬和里,1440,1387,672,123,795,65,860
公投第８案,臺北市,文山區,萬盛里,1441,1355,580,175,755,56,811
公投第８案,臺北市,文山區,萬盛里,1442,1370,542,209,751,73,824
公投第８案,臺北市,文山區,萬盛里,1443,1484,645,178,823,64,887
公投第８案,臺北市,文山區,興豐里,1444,1786,756,214,970,77,1047
公投第８案,臺北市,文山區,興豐里,1445,1260,567,139,706,60,766
公投第８案,臺北市,文山區,興豐里,1446,1194,577,171,748,28,776
公投第８案,臺北市,文山區,興邦里,1447,1444,617,203,820,53,873
公投第８案,臺北市,文山區,興邦里,1448,1495,681,152,833,63,896
公投第８案,臺北市,文山區,興邦里,1449,1446,666,159,825,63,888
公投第８案,臺北市,文山區,興光里,1450,1450,619,162,781,76,857
公投第８案,臺北市,文山區,興光里,1451,1486,658,179,837,54,891
公投第８案,臺北市,文山區,興家里,1452,1259,582,135,717,44,761
公投第８案,臺北市,文山區,興家里,1453,1317,613,159,772,26,798
公投第８案,臺北市,文山區,興家里,1454,1321,602,177,779,44,823
公投第８案,臺北市,文山區,興家里,1455,1475,632,178,810,52,862
公投第８案,臺北市,文山區,興家里,1456,1271,522,164,686,48,734
公投第８案,臺北市,文山區,興得里,1457,1609,694,226,920,48,968
公投第８案,臺北市,文山區,興得里,1458,1501,631,161,792,39,831
公投第８案,臺北市,文山區,興得里,1459,997,387,123,510,41,551
公投第８案,臺北市,文山區,興得里,1460,1052,500,137,637,44,681
公投第８案,臺北市,文山區,興業里,1461,1247,574,151,725,41,766
公投第８案,臺北市,文山區,興業里,1462,1167,478,187,665,53,718
公投第８案,臺北市,文山區,興業里,1463,1280,562,169,731,39,770
公投第８案,臺北市,文山區,興業里,1464,1153,538,132,670,37,707
公投第８案,臺北市,文山區,興安里,1465,1557,718,177,895,52,947
公投第８案,臺北市,文山區,興安里,1466,1444,631,161,792,64,856
公投第８案,臺北市,文山區,興安里,1467,1459,722,172,894,42,936
公投第８案,臺北市,文山區,興安里,1468,1357,632,175,807,50,857
公投第８案,臺北市,文山區,興福里,1469,1194,581,161,742,50,792
公投第８案,臺北市,文山區,興福里,1470,1184,541,159,700,61,761
公投第８案,臺北市,文山區,興福里,1471,1119,506,163,669,48,717
公投第８案,臺北市,文山區,興福里,1472,1350,634,163,797,60,857
公投第８案,臺北市,文山區,興旺里,1473,1502,623,164,787,58,845
公投第８案,臺北市,文山區,興旺里,1474,1511,669,100,769,240,1009
公投第８案,臺北市,文山區,興旺里,1475,1481,686,201,887,45,932
公投第８案,臺北市,文山區,興旺里,1476,1477,727,163,890,49,939
公投第８案,臺北市,文山區,興旺里,1477,1294,590,152,742,57,799
公投第８案,臺北市,文山區,興泰里,1478,1040,523,144,667,40,707
公投第８案,臺北市,文山區,興泰里,1479,1323,619,161,780,55,835
公投第８案,臺北市,文山區,興泰里,1480,1153,495,157,652,59,711
公投第８案,臺北市,文山區,興昌里,1481,1525,656,173,829,65,894
公投第８案,臺北市,文山區,興昌里,1482,1412,575,157,732,57,789
公投第８案,臺北市,文山區,興昌里,1483,1473,656,209,865,62,927
公投第８案,臺北市,文山區,興昌里,1484,1486,659,197,856,37,893
公投第８案,臺北市,文山區,試院里,1485,1616,785,169,954,59,1013
公投第８案,臺北市,文山區,試院里,1486,1489,685,193,878,66,944
公投第８案,臺北市,文山區,試院里,1487,1414,622,160,782,57,839
公投第８案,臺北市,文山區,試院里,1488,1494,703,206,909,52,961
公投第８案,臺北市,文山區,華興里,1489,1547,721,187,908,56,964
公投第８案,臺北市,文山區,華興里,1490,1587,671,230,901,66,967
公投第８案,臺北市,文山區,華興里,1491,1515,734,192,926,43,969
公投第８案,臺北市,文山區,華興里,1492,1573,716,206,922,63,985
公投第８案,臺北市,文山區,華興里,1493,1542,708,210,918,43,961
公投第８案,臺北市,文山區,明義里,1494,1465,567,157,724,81,805
公投第８案,臺北市,文山區,明義里,1495,699,216,88,304,40,344
公投第８案,臺北市,文山區,明義里,1496,1372,500,148,648,62,710
公投第８案,臺北市,文山區,明興里,1497,1448,535,153,688,57,745
公投第８案,臺北市,文山區,明興里,1498,1548,653,200,853,61,914
公投第８案,臺北市,文山區,明興里,1499,1501,649,191,840,48,888
公投第８案,臺北市,文山區,明興里,1500,1560,713,188,901,40,941
公投第８案,臺北市,文山區,木柵里,1501,1567,683,190,873,52,925
公投第８案,臺北市,文山區,木柵里,1502,1554,666,197,863,54,917
公投第８案,臺北市,文山區,木柵里,1503,1544,665,189,854,62,916
公投第８案,臺北市,文山區,木柵里,1504,1528,698,175,873,50,923
公投第８案,臺北市,文山區,木柵里,1505,1543,741,178,919,40,959
公投第８案,臺北市,文山區,木新里,1506,2754,670,230,900,60,960
公投第８案,臺北市,文山區,木新里,1507,1709,635,83,718,76,794
公投第８案,臺北市,文山區,木新里,1508,1515,577,212,789,80,869
公投第８案,臺北市,文山區,木新里,1509,1571,622,169,791,71,862
公投第８案,臺北市,文山區,木新里,1510,1578,651,177,828,74,902
公投第８案,臺北市,文山區,順興里,1511,1454,573,179,752,68,820
公投第８案,臺北市,文山區,順興里,1512,1436,614,169,783,67,850
公投第８案,臺北市,文山區,順興里,1513,1402,660,173,833,61,894
公投第８案,臺北市,文山區,順興里,1514,1117,515,146,661,41,702
公投第８案,臺北市,文山區,順興里,1515,1094,452,138,590,62,652
公投第８案,臺北市,文山區,忠順里,1516,1070,492,142,634,53,687
公投第８案,臺北市,文山區,忠順里,1517,1319,638,165,803,39,842
公投第８案,臺北市,文山區,忠順里,1518,1226,578,153,731,56,787
公投第８案,臺北市,文山區,樟林里,1519,1385,592,153,745,45,790
公投第８案,臺北市,文山區,樟林里,1520,1416,599,192,791,63,854
公投第８案,臺北市,文山區,樟林里,1521,1412,660,177,837,63,900
公投第８案,臺北市,文山區,樟林里,1522,1535,659,162,821,62,883
公投第８案,臺北市,文山區,樟林里,1523,1654,780,209,989,59,1048
公投第８案,臺北市,文山區,樟新里,1524,1156,543,148,691,40,731
公投第８案,臺北市,文山區,樟新里,1525,1231,577,149,726,48,774
公投第８案,臺北市,文山區,樟新里,1526,1218,519,141,660,47,707
公投第８案,臺北市,文山區,樟新里,1527,1176,555,157,712,44,756
公投第８案,臺北市,文山區,樟文里,1528,1392,599,213,812,49,861
公投第８案,臺北市,文山區,樟文里,1529,1323,514,175,689,95,784
公投第８案,臺北市,文山區,樟文里,1530,1297,532,167,699,46,745
公投第８案,臺北市,文山區,樟文里,1531,1296,582,159,741,74,815
公投第８案,臺北市,文山區,樟腳里,1532,1613,655,217,872,65,937
公投第８案,臺北市,文山區,樟腳里,1533,1697,731,237,968,60,1028
公投第８案,臺北市,文山區,樟腳里,1534,1579,665,187,852,72,924
公投第８案,臺北市,文山區,樟樹里,1535,1320,605,170,775,62,837
公投第８案,臺北市,文山區,樟樹里,1536,1438,617,166,783,38,821
公投第８案,臺北市,文山區,樟樹里,1537,1465,598,155,753,32,785
公投第８案,臺北市,文山區,萬芳里,1538,1646,667,237,904,85,989
公投第８案,臺北市,文山區,萬芳里,1539,1286,548,177,725,53,778
公投第８案,臺北市,文山區,萬芳里,1540,1219,542,168,710,39,749
公投第８案,臺北市,文山區,萬芳里,1541,1292,597,154,751,52,803
公投第８案,臺北市,文山區,萬芳里,1542,1489,610,172,782,66,848
公投第８案,臺北市,文山區,萬美里,1543,1611,699,211,910,69,979
公投第８案,臺北市,文山區,萬美里,1544,1549,573,180,753,54,807
公投第８案,臺北市,文山區,萬美里,1545,1678,677,194,871,69,940
公投第８案,臺北市,文山區,萬美里,1546,1660,660,220,880,63,943
公投第８案,臺北市,文山區,博嘉里,1547,1816,665,187,852,47,899
公投第８案,臺北市,文山區,博嘉里,1548,985,389,144,533,32,565
公投第８案,臺北市,文山區,博嘉里,1549,1314,637,131,768,37,805
公投第８案,臺北市,文山區,博嘉里,1550,1018,474,138,612,50,662
公投第８案,臺北市,文山區,萬興里,1551,1578,678,204,882,53,935
公投第８案,臺北市,文山區,萬興里,1552,1457,626,187,813,38,851
公投第８案,臺北市,文山區,萬興里,1553,1326,597,164,761,59,820
公投第８案,臺北市,文山區,萬興里,1554,1393,624,172,796,57,853
公投第８案,臺北市,文山區,萬興里,1555,1377,555,168,723,63,786
公投第８案,臺北市,文山區,政大里,1556,1448,625,200,825,45,870
公投第８案,臺北市,文山區,政大里,1557,1447,667,190,857,57,914
公投第８案,臺北市,文山區,政大里,1558,1739,809,252,1061,69,1130
公投第８案,臺北市,文山區,政大里,1559,1457,668,155,823,46,869
公投第８案,臺北市,文山區,指南里,1560,1288,585,167,752,46,798
公投第８案,臺北市,文山區,指南里,1561,1301,475,161,636,78,714
公投第８案,臺北市,文山區,指南里,1562,865,293,122,415,59,474
公投第８案,臺北市,文山區,老泉里,1563,789,294,109,403,40,443
公投第８案,高雄市,桃源區,梅山里,1,264,58,18,76,0,76
公投第８案,高雄市,桃源區,拉芙蘭里,2,233,119,35,154,17,171
公投第８案,高雄市,桃源區,復興里,3,279,140,26,166,8,174
公投第８案,高雄市,桃源區,勤和里,4,223,71,35,106,3,109
公投第８案,高雄市,桃源區,桃源里,5,783,233,63,296,16,312
公投第８案,高雄市,桃源區,高中里,6,632,187,42,229,9,238
公投第８案,高雄市,桃源區,建山里,7,612,302,78,380,35,415
公投第８案,高雄市,桃源區,寶山里,8,472,174,51,225,24,249
公投第８案,高雄市,那瑪夏區,達卡努瓦里,9,741,225,71,296,29,325
公投第８案,高雄市,那瑪夏區,達卡努瓦里,10,585,262,95,357,64,421
公投第８案,高雄市,那瑪夏區,瑪雅里,11,609,334,70,404,60,464
公投第８案,高雄市,那瑪夏區,南沙魯里,12,489,116,39,155,7,162
公投第８案,高雄市,甲仙區,東安里,13,472,120,30,150,11,161
公投第８案,高雄市,甲仙區,西安里,14,882,388,105,493,61,554
公投第８案,高雄市,甲仙區,和安里,15,668,246,67,313,41,354
公投第８案,高雄市,甲仙區,大田里,16,1581,503,167,670,124,794
公投第８案,高雄市,甲仙區,寶隆里,17,673,151,52,203,11,214
公投第８案,高雄市,甲仙區,關山里,18,607,194,47,241,37,278
公投第８案,高雄市,甲仙區,小林里,19,534,184,47,231,11,242
公投第８案,高雄市,六龜區,新威里,20,760,238,92,330,42,372
公投第８案,高雄市,六龜區,新興里,21,666,196,75,271,36,307
公投第８案,高雄市,六龜區,新寮里,22,704,275,72,347,52,399
公投第８案,高雄市,六龜區,新發里,23,1003,323,115,438,71,509
公投第８案,高雄市,六龜區,荖濃里,24,1382,422,117,539,114,653
公投第８案,高雄市,六龜區,六龜里,25,986,245,94,339,78,417
公投第８案,高雄市,六龜區,義寶里,26,1046,340,118,458,54,512
公投第８案,高雄市,六龜區,興龍里,27,812,217,100,317,65,382
公投第８案,高雄市,六龜區,中興里,28,1431,551,35,586,77,663
公投第８案,高雄市,六龜區,寶來里,29,912,318,85,403,74,477
公投第８案,高雄市,六龜區,文武里,30,1472,375,139,514,49,563
公投第８案,高雄市,六龜區,大津里,31,327,83,35,118,25,143
公投第８案,高雄市,杉林區,杉林里,32,640,193,70,263,52,315
公投第８案,高雄市,杉林區,木梓里,33,696,205,61,266,28,294
公投第８案,高雄市,杉林區,集來里,34,1284,282,119,401,47,448
公投第８案,高雄市,杉林區,新庄里,35,1027,284,105,389,48,437
公投第８案,高雄市,杉林區,新庄里,36,482,150,45,195,31,226
公投第８案,高雄市,杉林區,上平里,37,1627,581,193,774,127,901
公投第８案,高雄市,杉林區,月眉里,38,1630,543,133,676,35,711
公投第８案,高雄市,杉林區,大愛里,39,973,237,83,320,25,345
公投第８案,高雄市,杉林區,大愛里,40,987,275,84,359,26,385
公投第８案,高雄市,杉林區,月美里,41,1261,428,146,574,89,663
公投第８案,高雄市,內門區,溝坪里,42,969,296,79,375,61,436
公投第８案,高雄市,內門區,金竹里,43,652,175,54,229,12,241
公投第８案,高雄市,內門區,永富里,44,961,301,115,416,93,509
公投第８案,高雄市,內門區,永吉里,45,426,124,32,156,7,163
公投第８案,高雄市,內門區,永興里,46,398,128,36,164,16,180
公投第８案,高雄市,內門區,石坑里,47,508,159,48,207,12,219
公投第８案,高雄市,內門區,內門里,48,980,488,14,502,70,572
公投第８案,高雄市,內門區,內豊里,49,1225,356,128,484,49,533
公投第８案,高雄市,內門區,觀亭里,50,1722,583,221,804,142,946
公投第８案,高雄市,內門區,中埔里,51,560,174,72,246,29,275
公投第８案,高雄市,內門區,內東里,52,801,207,86,293,18,311
公投第８案,高雄市,內門區,內南里,53,423,147,50,197,18,215
公投第８案,高雄市,內門區,東埔里,54,497,141,59,200,36,236
公投第８案,高雄市,內門區,三平里,55,677,199,83,282,34,316
公投第８案,高雄市,內門區,木柵里,56,593,128,49,177,16,193
公投第８案,高雄市,內門區,內興里,57,597,130,61,191,56,247
公投第８案,高雄市,內門區,瑞山里,58,343,93,34,127,12,139
公投第８案,高雄市,內門區,光興里,59,670,216,86,302,51,353
公投第８案,高雄市,旗山區,太平里,60,1060,463,117,580,53,633
公投第８案,高雄市,旗山區,太平里,61,1125,411,128,539,52,591
公投第８案,高雄市,旗山區,大德里,62,1100,499,114,613,32,645
公投第８案,高雄市,旗山區,大德里,63,1238,513,165,678,32,710
公投第８案,高雄市,旗山區,湄洲里,64,933,390,105,495,26,521
公投第８案,高雄市,旗山區,湄洲里,65,727,233,86,319,23,342
公投第８案,高雄市,旗山區,圓富里,66,1071,409,127,536,59,595
公投第８案,高雄市,旗山區,圓富里,67,744,265,89,354,28,382
公投第８案,高雄市,旗山區,中正里,68,1100,362,120,482,31,513
公投第８案,高雄市,旗山區,中正里,69,369,143,33,176,17,193
公投第８案,高雄市,旗山區,大林里,70,888,254,99,353,20,373
公投第８案,高雄市,旗山區,大林里,71,510,140,50,190,12,202
公投第８案,高雄市,旗山區,上洲里,72,1042,401,160,561,87,648
公投第８案,高雄市,旗山區,新光里,73,791,281,98,379,54,433
公投第８案,高雄市,旗山區,南勝里,74,939,363,124,487,83,570
公投第８案,高雄市,旗山區,南勝里,75,1218,420,143,563,34,597
公投第８案,高雄市,旗山區,中寮里,76,178,53,19,72,23,95
公投第８案,高雄市,旗山區,東平里,77,946,408,120,528,58,586
公投第８案,高雄市,旗山區,東平里,78,1025,351,146,497,40,537
公投第８案,高雄市,旗山區,東昌里,79,1040,435,114,549,77,626
公投第８案,高雄市,旗山區,竹峰里,80,900,380,139,519,54,573
公投第８案,高雄市,旗山區,竹峰里,81,663,239,63,302,28,330
公投第８案,高雄市,旗山區,瑞吉里,82,954,374,93,467,63,530
公投第８案,高雄市,旗山區,瑞吉里,83,1060,374,126,500,37,537
公投第８案,高雄市,旗山區,永和里,84,1110,460,138,598,64,662
公投第８案,高雄市,旗山區,永和里,85,1062,419,153,572,57,629
公投第８案,高雄市,旗山區,永和里,86,1151,457,119,576,42,618
公投第８案,高雄市,旗山區,三協里,87,266,111,29,140,24,164
公投第８案,高雄市,旗山區,三協里,88,633,242,103,345,39,384
公投第８案,高雄市,旗山區,三協里,89,1307,425,161,586,38,624
公投第８案,高雄市,旗山區,鯤洲里,90,754,240,119,359,66,425
公投第８案,高雄市,旗山區,大山里,91,1296,458,168,626,111,737
公投第８案,高雄市,旗山區,中洲里,92,839,253,89,342,23,365
公投第８案,高雄市,旗山區,南洲里,93,1329,508,176,684,60,744
公投第８案,高雄市,旗山區,廣福里,94,628,259,78,337,33,370
公投第８案,高雄市,美濃區,福安里,95,1175,449,146,595,91,686
公投第８案,高雄市,美濃區,福安里,96,1438,483,163,646,37,683
公投第８案,高雄市,美濃區,合和里,97,989,355,101,456,50,506
公投第８案,高雄市,美濃區,合和里,98,1427,575,69,644,78,722
公投第８案,高雄市,美濃區,祿興里,99,1309,528,141,669,66,735
公投第８案,高雄市,美濃區,祿興里,100,1263,522,158,680,81,761
公投第８案,高雄市,美濃區,中壇里,101,997,431,101,532,67,599
公投第８案,高雄市,美濃區,中壇里,102,1064,429,129,558,56,614
公投第８案,高雄市,美濃區,德興里,103,1498,597,141,738,79,817
公投第８案,高雄市,美濃區,龍山里,104,1119,461,122,583,74,657
公投第８案,高雄市,美濃區,龍山里,105,1031,444,115,559,82,641
公投第８案,高雄市,美濃區,獅山里,106,1437,520,165,685,78,763
公投第８案,高雄市,美濃區,獅山里,107,1071,417,131,548,60,608
公投第８案,高雄市,美濃區,龍肚里,108,687,279,67,346,41,387
公投第８案,高雄市,美濃區,龍肚里,109,775,223,72,295,18,313
公投第８案,高雄市,美濃區,廣德里,110,1353,469,157,626,68,694
公投第８案,高雄市,美濃區,興隆里,111,1191,424,116,540,43,583
公投第８案,高雄市,美濃區,中圳里,112,906,306,91,397,30,427
公投第８案,高雄市,美濃區,中圳里,113,1178,520,118,638,52,690
公投第８案,高雄市,美濃區,東門里,114,1252,432,118,550,34,584
公投第８案,高雄市,美濃區,泰安里,115,1549,623,183,806,59,865
公投第８案,高雄市,美濃區,瀰濃里,116,1088,383,111,494,55,549
公投第８案,高雄市,美濃區,瀰濃里,117,1116,451,135,586,49,635
公投第８案,高雄市,美濃區,清水里,118,977,365,131,496,32,528
公投第８案,高雄市,美濃區,清水里,119,816,329,113,442,68,510
公投第８案,高雄市,美濃區,吉洋里,120,955,327,63,390,30,420
公投第８案,高雄市,美濃區,吉洋里,121,943,373,107,480,67,547
公投第８案,高雄市,美濃區,吉和里,122,1371,493,123,616,53,669
公投第８案,高雄市,美濃區,吉東里,123,919,314,118,432,74,506
公投第８案,高雄市,美濃區,吉東里,124,915,371,129,500,62,562
公投第８案,高雄市,美濃區,廣林里,125,828,278,110,388,67,455
公投第８案,高雄市,美濃區,廣林里,126,674,184,73,257,60,317
公投第８案,高雄市,茂林區,多納里,127,507,252,67,319,37,356
公投第８案,高雄市,茂林區,萬山里,128,382,193,45,238,23,261
公投第８案,高雄市,茂林區,茂林里,129,726,339,71,410,31,441
公投第８案,高雄市,茄萣區,福德里,130,976,285,119,404,22,426
公投第８案,高雄市,茄萣區,萬福里,131,887,275,140,415,69,484
公投第８案,高雄市,茄萣區,白雲里,132,1710,621,178,799,39,838
公投第８案,高雄市,茄萣區,嘉賜里,133,1280,379,142,521,39,560
公投第８案,高雄市,茄萣區,嘉賜里,134,1314,508,170,678,33,711
公投第８案,高雄市,茄萣區,嘉賜里,135,1157,482,163,645,29,674
公投第８案,高雄市,茄萣區,嘉安里,136,1785,631,232,863,121,984
公投第８案,高雄市,茄萣區,嘉樂里,137,838,266,120,386,100,486
公投第８案,高雄市,茄萣區,嘉樂里,138,1249,510,183,693,96,789
公投第８案,高雄市,茄萣區,嘉泰里,139,1116,371,139,510,101,611
公投第８案,高雄市,茄萣區,嘉福里,140,978,305,111,416,56,472
公投第８案,高雄市,茄萣區,和協里,141,1125,330,114,444,46,490
公投第８案,高雄市,茄萣區,嘉定里,142,1139,375,168,543,78,621
公投第８案,高雄市,茄萣區,保定里,143,1363,459,183,642,19,661
公投第８案,高雄市,茄萣區,保定里,144,1598,581,238,819,108,927
公投第８案,高雄市,茄萣區,大定里,145,1111,383,150,533,66,599
公投第８案,高雄市,茄萣區,光定里,146,925,266,100,366,48,414
公投第８案,高雄市,茄萣區,吉定里,147,1148,406,136,542,69,611
公投第８案,高雄市,茄萣區,崎漏里,148,1353,453,161,614,44,658
公投第８案,高雄市,茄萣區,崎漏里,149,1331,458,195,653,68,721
公投第８案,高雄市,茄萣區,崎漏里,150,1829,589,226,815,70,885
公投第８案,高雄市,湖內區,海山里,151,1112,380,132,512,35,547
公投第８案,高雄市,湖內區,劉家里,152,1017,351,135,486,92,578
公投第８案,高雄市,湖內區,太爺里,153,796,256,110,366,28,394
公投第８案,高雄市,湖內區,公舘里,154,1079,454,159,613,34,647
公投第８案,高雄市,湖內區,公舘里,155,1115,423,155,578,36,614
公投第８案,高雄市,湖內區,葉厝里,156,1311,482,156,638,40,678
公投第８案,高雄市,湖內區,葉厝里,157,1319,464,169,633,40,673
公投第８案,高雄市,湖內區,大湖里,158,1244,547,159,706,78,784
公投第８案,高雄市,湖內區,大湖里,159,1227,552,155,707,58,765
公投第８案,高雄市,湖內區,大湖里,160,1163,491,155,646,69,715
公投第８案,高雄市,湖內區,田尾里,161,981,399,151,550,39,589
公投第８案,高雄市,湖內區,湖內里,162,780,282,94,376,19,395
公投第８案,高雄市,湖內區,湖內里,163,832,304,113,417,57,474
公投第８案,高雄市,湖內區,湖內里,164,1017,451,147,598,38,636
公投第８案,高雄市,湖內區,湖內里,165,1051,423,137,560,31,591
公投第８案,高雄市,湖內區,海埔里,166,941,330,121,451,35,486
公投第８案,高雄市,湖內區,海埔里,167,863,314,109,423,54,477
公投第８案,高雄市,湖內區,文賢里,168,1160,411,157,568,62,630
公投第８案,高雄市,湖內區,中賢里,169,1090,312,114,426,25,451
公投第８案,高雄市,湖內區,中賢里,170,1122,411,174,585,57,642
公投第８案,高雄市,湖內區,逸賢里,171,1123,353,117,470,31,501
公投第８案,高雄市,湖內區,忠興里,172,684,225,102,327,32,359
公投第８案,高雄市,湖內區,湖東里,173,1249,440,137,577,27,604
公投第８案,高雄市,湖內區,湖東里,174,1453,508,153,661,57,718
公投第８案,高雄市,路竹區,竹滬里,175,1026,373,121,494,29,523
公投第８案,高雄市,路竹區,竹滬里,176,1069,397,155,552,74,626
公投第８案,高雄市,路竹區,竹滬里,177,1127,460,154,614,75,689
公投第８案,高雄市,路竹區,頂寮里,178,1179,440,146,586,78,664
公投第８案,高雄市,路竹區,新達里,179,1237,454,153,607,95,702
公投第８案,高雄市,路竹區,後鄉里,180,1096,535,56,591,65,656
公投第８案,高雄市,路竹區,北嶺里,181,1272,556,161,717,80,797
公投第８案,高雄市,路竹區,社西里,182,1182,470,159,629,64,693
公投第８案,高雄市,路竹區,社西里,183,1127,460,143,603,49,652
公投第８案,高雄市,路竹區,甲北里,184,956,386,127,513,58,571
公投第８案,高雄市,路竹區,甲北里,185,1132,431,172,603,59,662
公投第８案,高雄市,路竹區,甲南里,186,1025,424,140,564,91,655
公投第８案,高雄市,路竹區,甲南里,187,1007,369,123,492,32,524
公投第８案,高雄市,路竹區,甲南里,188,1301,469,156,625,71,696
公投第８案,高雄市,路竹區,下坑里,189,885,364,107,471,34,505
公投第８案,高雄市,路竹區,下坑里,190,837,258,111,369,22,391
公投第８案,高雄市,路竹區,下坑里,191,930,369,130,499,66,565
公投第８案,高雄市,路竹區,竹園里,192,781,246,107,353,49,402
公投第８案,高雄市,路竹區,竹園里,193,1023,380,161,541,66,607
公投第８案,高雄市,路竹區,竹東里,194,1763,745,204,949,84,1033
公投第８案,高雄市,路竹區,竹東里,195,1637,616,223,839,65,904
公投第８案,高雄市,路竹區,竹西里,196,1070,390,148,538,49,587
公投第８案,高雄市,路竹區,竹西里,197,1177,461,170,631,77,708
公投第８案,高雄市,路竹區,文北里,198,1007,402,141,543,49,592
公投第８案,高雄市,路竹區,文北里,199,1026,513,31,544,42,586
公投第８案,高雄市,路竹區,文北里,200,1017,410,130,540,60,600
公投第８案,高雄市,路竹區,文南里,201,1264,493,172,665,68,733
公投第８案,高雄市,路竹區,文南里,202,1089,464,143,607,52,659
公投第８案,高雄市,路竹區,三爺里,203,851,331,117,448,43,491
公投第８案,高雄市,路竹區,鴨寮里,204,1011,410,149,559,65,624
公投第８案,高雄市,路竹區,鴨寮里,205,937,421,146,567,36,603
公投第８案,高雄市,路竹區,社東里,206,820,254,110,364,14,378
公投第８案,高雄市,路竹區,社東里,207,910,405,142,547,32,579
公投第８案,高雄市,路竹區,社中里,208,867,330,115,445,48,493
公投第８案,高雄市,路竹區,竹南里,209,937,356,128,484,45,529
公投第８案,高雄市,路竹區,竹南里,210,900,370,115,485,26,511
公投第８案,高雄市,路竹區,竹南里,211,900,370,125,495,57,552
公投第８案,高雄市,路竹區,社南里,212,918,393,113,506,40,546
公投第８案,高雄市,路竹區,社南里,213,870,371,145,516,41,557
公投第８案,高雄市,路竹區,社南里,214,1150,494,176,670,51,721
公投第８案,高雄市,路竹區,社南里,215,1537,723,184,907,73,980
公投第８案,高雄市,阿蓮區,石安里,216,1299,375,175,550,45,595
公投第８案,高雄市,阿蓮區,中路里,217,1107,405,140,545,31,576
公投第８案,高雄市,阿蓮區,中路里,218,898,290,111,401,31,432
公投第８案,高雄市,阿蓮區,峯山里,219,1259,436,153,589,85,674
公投第８案,高雄市,阿蓮區,港後里,220,1579,573,184,757,50,807
公投第８案,高雄市,阿蓮區,港後里,221,564,230,76,306,9,315
公投第８案,高雄市,阿蓮區,崗山里,222,768,326,119,445,51,496
公投第８案,高雄市,阿蓮區,阿蓮里,223,1092,436,145,581,55,636
公投第８案,高雄市,阿蓮區,阿蓮里,224,1099,405,156,561,63,624
公投第８案,高雄市,阿蓮區,阿蓮里,225,1134,467,126,593,26,619
公投第８案,高雄市,阿蓮區,阿蓮里,226,1561,547,194,741,27,768
公投第８案,高雄市,阿蓮區,清蓮里,227,1533,583,223,806,92,898
公投第８案,高雄市,阿蓮區,清蓮里,228,1116,381,137,518,33,551
公投第８案,高雄市,阿蓮區,和蓮里,229,1054,367,139,506,43,549
公投第８案,高雄市,阿蓮區,和蓮里,230,1260,479,146,625,58,683
公投第８案,高雄市,阿蓮區,青旗里,231,1504,546,172,718,74,792
公投第８案,高雄市,阿蓮區,復安里,232,848,271,103,374,20,394
公投第８案,高雄市,阿蓮區,復安里,233,823,320,80,400,24,424
公投第８案,高雄市,阿蓮區,玉庫里,234,1021,412,118,530,25,555
公投第８案,高雄市,阿蓮區,南蓮里,235,1715,587,197,784,47,831
公投第８案,高雄市,阿蓮區,南蓮里,236,1300,460,167,627,55,682
公投第８案,高雄市,田寮區,鹿埔里,237,369,99,37,136,6,142
公投第８案,高雄市,田寮區,南安里,238,656,189,56,245,25,270
公投第８案,高雄市,田寮區,南安里,239,406,73,31,104,11,115
公投第８案,高雄市,田寮區,大同里,240,380,118,42,160,27,187
公投第８案,高雄市,田寮區,田寮里,241,379,129,48,177,15,192
公投第８案,高雄市,田寮區,七星里,242,625,208,85,293,58,351
公投第８案,高雄市,田寮區,崇德里,243,946,322,91,413,20,433
公投第８案,高雄市,田寮區,西德里,244,794,232,88,320,54,374
公投第８案,高雄市,田寮區,三和里,245,382,101,40,141,27,168
公投第８案,高雄市,田寮區,古亭里,246,513,99,58,157,42,199
公投第８案,高雄市,田寮區,新興里,247,601,183,84,267,23,290
公投第８案,高雄市,田寮區,新興里,248,620,216,85,301,58,359
公投第８案,高雄市,永安區,永安里,249,756,335,111,446,52,498
公投第８案,高雄市,永安區,永安里,250,818,308,124,432,80,512
公投第８案,高雄市,永安區,永華里,251,866,408,138,546,49,595
公投第８案,高雄市,永安區,永華里,252,951,377,164,541,71,612
公投第８案,高雄市,永安區,新港里,253,992,402,152,554,69,623
公投第８案,高雄市,永安區,新港里,254,682,201,83,284,23,307
公投第８案,高雄市,永安區,新港里,255,665,259,99,358,21,379
公投第８案,高雄市,永安區,鹽田里,256,371,132,59,191,13,204
公投第８案,高雄市,永安區,保寧里,257,1114,460,188,648,80,728
公投第８案,高雄市,永安區,保寧里,258,1418,617,211,828,46,874
公投第８案,高雄市,永安區,維新里,259,1477,637,227,864,88,952
公投第８案,高雄市,永安區,維新里,260,1891,818,270,1088,99,1187
公投第８案,高雄市,岡山區,岡山里,261,1345,632,190,822,53,875
公投第８案,高雄市,岡山區,岡山里,262,1045,312,128,440,24,464
公投第８案,高雄市,岡山區,岡山里,263,1051,461,127,588,50,638
公投第８案,高雄市,岡山區,岡山里,264,917,399,122,521,19,540
公投第８案,高雄市,岡山區,壽天里,265,934,426,137,563,39,602
公投第８案,高雄市,岡山區,壽天里,266,1097,483,150,633,55,688
公投第８案,高雄市,岡山區,壽天里,267,1208,584,175,759,43,802
公投第８案,高雄市,岡山區,平安里,268,1159,498,188,686,80,766
公投第８案,高雄市,岡山區,維仁里,269,1018,411,155,566,58,624
公投第８案,高雄市,岡山區,大遼里,270,1316,450,157,607,42,649
公投第８案,高雄市,岡山區,程香里,271,1345,551,72,623,36,659
公投第８案,高雄市,岡山區,程香里,272,1295,557,193,750,53,803
公投第８案,高雄市,岡山區,程香里,273,1425,599,179,778,63,841
公投第８案,高雄市,岡山區,後紅里,274,1328,530,139,669,37,706
公投第８案,高雄市,岡山區,後紅里,275,1382,602,171,773,24,797
公投第８案,高雄市,岡山區,後紅里,276,1381,656,152,808,22,830
公投第８案,高雄市,岡山區,碧紅里,277,1282,531,159,690,79,769
公投第８案,高雄市,岡山區,碧紅里,278,1240,507,163,670,18,688
公投第８案,高雄市,岡山區,碧紅里,279,1327,587,143,730,64,794
公投第８案,高雄市,岡山區,竹圍里,280,1736,708,192,900,66,966
公投第８案,高雄市,岡山區,竹圍里,281,1566,665,208,873,73,946
公投第８案,高雄市,岡山區,竹圍里,282,1779,545,167,712,46,758
公投第８案,高雄市,岡山區,竹圍里,283,1593,687,196,883,73,956
公投第８案,高雄市,岡山區,台上里,284,1480,645,202,847,70,917
公投第８案,高雄市,岡山區,台上里,285,1364,608,163,771,37,808
公投第８案,高雄市,岡山區,台上里,286,1410,617,189,806,56,862
公投第８案,高雄市,岡山區,台上里,287,1148,539,183,722,64,786
公投第８案,高雄市,岡山區,為隨里,288,625,251,101,352,52,404
公投第８案,高雄市,岡山區,灣裡里,289,969,444,112,556,41,597
公投第８案,高雄市,岡山區,灣裡里,290,861,388,117,505,22,527
公投第８案,高雄市,岡山區,本洲里,291,823,307,98,405,26,431
公投第８案,高雄市,岡山區,本洲里,292,889,391,135,526,67,593
公投第８案,高雄市,岡山區,前峰里,293,1283,550,167,717,53,770
公投第８案,高雄市,岡山區,前峰里,294,1512,600,174,774,48,822
公投第８案,高雄市,岡山區,壽峰里,295,983,437,177,614,58,672
公投第８案,高雄市,岡山區,壽峰里,296,1262,540,164,704,46,750
公投第８案,高雄市,岡山區,仁壽里,297,1096,450,163,613,65,678
公投第８案,高雄市,岡山區,仁壽里,298,1066,456,134,590,56,646
公投第８案,高雄市,岡山區,仁壽里,299,1188,496,126,622,40,662
公投第８案,高雄市,岡山區,後協里,300,1360,587,183,770,66,836
公投第８案,高雄市,岡山區,後協里,301,1363,596,186,782,44,826
公投第８案,高雄市,岡山區,後協里,302,1352,640,180,820,57,877
公投第８案,高雄市,岡山區,後協里,303,1460,628,171,799,70,869
公投第８案,高雄市,岡山區,協和里,304,1272,574,154,728,53,781
公投第８案,高雄市,岡山區,協和里,305,1080,510,136,646,51,697
公投第８案,高雄市,岡山區,協和里,306,1255,523,179,702,76,778
公投第８案,高雄市,岡山區,協榮里,307,938,434,143,577,52,629
公投第８案,高雄市,岡山區,協榮里,308,1237,563,170,733,56,789
公投第８案,高雄市,岡山區,劉厝里,309,1413,487,177,664,35,699
公投第８案,高雄市,岡山區,白米里,310,765,309,113,422,13,435
公投第８案,高雄市,岡山區,白米里,311,1043,483,153,636,41,677
公投第８案,高雄市,岡山區,石潭里,312,844,310,84,394,35,429
公投第８案,高雄市,岡山區,石潭里,313,993,514,172,686,42,728
公投第８案,高雄市,岡山區,福興里,314,1038,462,141,603,67,670
公投第８案,高雄市,岡山區,嘉興里,315,1070,402,171,573,78,651
公投第８案,高雄市,岡山區,嘉興里,316,1023,435,167,602,81,683
公投第８案,高雄市,岡山區,嘉興里,317,1349,527,202,729,34,763
公投第８案,高雄市,岡山區,嘉峰里,318,1452,545,160,705,49,754
公投第８案,高雄市,岡山區,嘉峰里,319,301,46,138,184,19,203
公投第８案,高雄市,岡山區,潭底里,320,756,311,115,426,85,511
公投第８案,高雄市,岡山區,華崗里,321,733,244,89,333,15,348
公投第８案,高雄市,岡山區,華崗里,322,854,380,134,514,78,592
公投第８案,高雄市,岡山區,三和里,323,866,271,78,349,22,371
公投第８案,高雄市,岡山區,大莊里,324,978,382,117,499,60,559
公投第８案,高雄市,岡山區,忠孝里,325,1336,716,103,819,0,819
公投第８案,高雄市,岡山區,忠孝里,326,1218,665,79,744,18,762
公投第８案,高雄市,岡山區,忠孝里,327,341,179,62,241,18,259
公投第８案,高雄市,岡山區,仁義里,328,955,623,61,684,30,714
公投第８案,高雄市,岡山區,仁義里,329,940,574,59,633,15,648
公投第８案,高雄市,岡山區,信義里,330,851,413,115,528,48,576
公投第８案,高雄市,岡山區,信義里,331,762,435,79,514,21,535
公投第８案,高雄市,岡山區,和平里,332,318,153,71,224,16,240
公投第８案,高雄市,燕巢區,尖山里,333,1152,431,132,563,93,656
公投第８案,高雄市,燕巢區,瓊林里,334,1120,460,146,606,27,633
公投第８案,高雄市,燕巢區,瓊林里,335,974,431,152,583,58,641
公投第８案,高雄市,燕巢區,安招里,336,1019,372,146,518,16,534
公投第８案,高雄市,燕巢區,安招里,337,1058,389,135,524,73,597
公投第８案,高雄市,燕巢區,安招里,338,1017,297,92,389,40,429
公投第８案,高雄市,燕巢區,安招里,339,259,33,4,37,4,41
公投第８案,高雄市,燕巢區,角宿里,340,926,426,127,553,64,617
公投第８案,高雄市,燕巢區,角宿里,341,624,213,76,289,18,307
公投第８案,高雄市,燕巢區,角宿里,342,1102,485,163,648,69,717
公投第８案,高雄市,燕巢區,鳳雄里,343,1072,391,130,521,56,577
公投第８案,高雄市,燕巢區,鳳雄里,344,1361,517,192,709,65,774
公投第８案,高雄市,燕巢區,金山里,345,472,203,49,252,35,287
公投第８案,高雄市,燕巢區,東燕里,346,1197,445,131,576,60,636
公投第８案,高雄市,燕巢區,東燕里,347,1134,496,151,647,91,738
公投第８案,高雄市,燕巢區,南燕里,348,1148,405,149,554,50,604
公投第８案,高雄市,燕巢區,南燕里,349,1207,456,121,577,75,652
公投第８案,高雄市,燕巢區,南燕里,350,1402,636,193,829,46,875
公投第８案,高雄市,燕巢區,西燕里,351,1000,381,153,534,73,607
公投第８案,高雄市,燕巢區,西燕里,352,1110,459,150,609,71,680
公投第８案,高雄市,燕巢區,西燕里,353,1291,507,160,667,76,743
公投第８案,高雄市,燕巢區,橫山里,354,797,284,124,408,78,486
公投第８案,高雄市,燕巢區,橫山里,355,1098,364,137,501,64,565
公投第８案,高雄市,燕巢區,深水里,356,1393,519,162,681,70,751
公投第８案,高雄市,燕巢區,深水里,357,1079,337,90,427,27,454
公投第８案,高雄市,彌陀區,光和里,358,1246,478,189,667,81,748
公投第８案,高雄市,彌陀區,彌靖里,359,885,358,135,493,55,548
公投第８案,高雄市,彌陀區,彌靖里,360,955,415,159,574,73,647
公投第８案,高雄市,彌陀區,彌仁里,361,534,189,78,267,48,315
公投第８案,高雄市,彌陀區,彌壽里,362,738,313,100,413,32,445
公投第８案,高雄市,彌陀區,彌陀里,363,855,420,105,525,50,575
公投第８案,高雄市,彌陀區,彌陀里,364,877,370,126,496,61,557
公投第８案,高雄市,彌陀區,舊港里,365,781,326,111,437,65,502
公投第８案,高雄市,彌陀區,舊港里,366,808,316,114,430,38,468
公投第８案,高雄市,彌陀區,文安里,367,904,301,111,412,42,454
公投第８案,高雄市,彌陀區,文安里,368,825,322,123,445,54,499
公投第８案,高雄市,彌陀區,過港里,369,941,320,115,435,81,516
公投第８案,高雄市,彌陀區,鹽埕里,370,1013,390,136,526,40,566
公投第８案,高雄市,彌陀區,鹽埕里,371,1024,419,154,573,69,642
公投第８案,高雄市,彌陀區,海尾里,372,861,320,93,413,22,435
公投第８案,高雄市,彌陀區,漯底里,373,1163,495,133,628,96,724
公投第８案,高雄市,彌陀區,南寮里,374,1216,530,160,690,99,789
公投第８案,高雄市,彌陀區,南寮里,375,861,390,138,528,94,622
公投第８案,高雄市,梓官區,梓信里,376,1061,455,164,619,77,696
公投第８案,高雄市,梓官區,梓信里,377,1063,413,140,553,82,635
公投第８案,高雄市,梓官區,梓義里,378,969,366,144,510,34,544
公投第８案,高雄市,梓官區,梓義里,379,1078,347,158,505,31,536
公投第８案,高雄市,梓官區,梓和里,380,838,321,132,453,67,520
公投第８案,高雄市,梓官區,梓和里,381,611,230,119,349,31,380
公投第８案,高雄市,梓官區,梓和里,382,782,305,102,407,31,438
公投第８案,高雄市,梓官區,梓平里,383,1451,644,203,847,95,942
公投第８案,高雄市,梓官區,中崙里,384,1144,418,161,579,26,605
公投第８案,高雄市,梓官區,同安里,385,975,331,123,454,17,471
公投第８案,高雄市,梓官區,大舍里,386,1317,512,166,678,57,735
公投第８案,高雄市,梓官區,大舍里,387,1218,496,174,670,83,753
公投第８案,高雄市,梓官區,大舍里,388,1073,433,141,574,43,617
公投第８案,高雄市,梓官區,赤崁里,389,1112,374,134,508,47,555
公投第８案,高雄市,梓官區,赤崁里,390,715,257,97,354,45,399
公投第８案,高雄市,梓官區,赤東里,391,1311,465,168,633,57,690
公投第８案,高雄市,梓官區,赤東里,392,939,340,128,468,40,508
公投第８案,高雄市,梓官區,赤西里,393,824,369,111,480,34,514
公投第８案,高雄市,梓官區,禮蚵里,394,1052,423,163,586,109,695
公投第８案,高雄市,梓官區,禮蚵里,395,1020,414,126,540,106,646
公投第８案,高雄市,梓官區,智蚵里,396,1260,444,159,603,42,645
公投第８案,高雄市,梓官區,智蚵里,397,1595,603,196,799,50,849
公投第８案,高雄市,梓官區,信蚵里,398,829,349,107,456,38,494
公投第８案,高雄市,梓官區,信蚵里,399,1532,577,176,753,35,788
公投第８案,高雄市,梓官區,茄苳里,400,1195,490,185,675,85,760
公投第８案,高雄市,梓官區,茄苳里,401,1143,467,152,619,86,705
公投第８案,高雄市,梓官區,典寶里,402,1186,498,168,666,69,735
公投第８案,高雄市,梓官區,典寶里,403,1732,614,138,752,47,799
公投第８案,高雄市,橋頭區,橋頭里,404,1005,443,144,587,80,667
公投第８案,高雄市,橋頭區,橋頭里,405,1073,447,177,624,54,678
公投第８案,高雄市,橋頭區,橋南里,406,1129,443,163,606,41,647
公投第８案,高雄市,橋頭區,仕隆里,407,1244,523,173,696,85,781
公投第８案,高雄市,橋頭區,仕隆里,408,1091,428,148,576,41,617
公投第８案,高雄市,橋頭區,仕豐里,409,1329,593,205,798,60,858
公投第８案,高雄市,橋頭區,仕豐里,410,1140,471,187,658,47,705
公投第８案,高雄市,橋頭區,芋寮里,411,1220,574,98,672,82,754
公投第８案,高雄市,橋頭區,東林里,412,1047,456,186,642,67,709
公投第８案,高雄市,橋頭區,東林里,413,1315,478,200,678,107,785
公投第８案,高雄市,橋頭區,西林里,414,691,247,100,347,38,385
公投第８案,高雄市,橋頭區,西林里,415,720,308,106,414,60,474
公投第８案,高雄市,橋頭區,白樹里,416,1192,487,179,666,80,746
公投第８案,高雄市,橋頭區,白樹里,417,1318,537,221,758,80,838
公投第８案,高雄市,橋頭區,白樹里,418,761,333,105,438,53,491
公投第８案,高雄市,橋頭區,筆秀里,419,973,392,131,523,28,551
公投第８案,高雄市,橋頭區,筆秀里,420,587,252,75,327,34,361
公投第８案,高雄市,橋頭區,新莊里,421,812,361,119,480,47,527
公投第８案,高雄市,橋頭區,新莊里,422,343,136,67,203,11,214
公投第８案,高雄市,橋頭區,新莊里,423,1266,618,156,774,37,811
公投第８案,高雄市,橋頭區,甲北里,424,1128,471,168,639,98,737
公投第８案,高雄市,橋頭區,甲北里,425,884,380,115,495,68,563
公投第８案,高雄市,橋頭區,甲南里,426,1187,480,127,607,83,690
公投第８案,高雄市,橋頭區,甲南里,427,1259,523,159,682,89,771
公投第８案,高雄市,橋頭區,頂鹽里,428,1361,495,176,671,80,751
公投第８案,高雄市,橋頭區,中崎里,429,671,232,84,316,37,353
公投第８案,高雄市,橋頭區,仕和里,430,1215,520,192,712,67,779
公投第８案,高雄市,橋頭區,仕和里,431,1255,466,207,673,108,781
公投第８案,高雄市,橋頭區,仕和里,432,1219,536,184,720,67,787
公投第８案,高雄市,橋頭區,德松里,433,1372,549,165,714,37,751
公投第８案,高雄市,橋頭區,三德里,434,758,208,80,288,11,299
公投第８案,高雄市,楠梓區,清豐里,435,1309,681,86,767,52,819
公投第８案,高雄市,楠梓區,清豐里,436,1408,598,194,792,29,821
公投第８案,高雄市,楠梓區,清豐里,437,1851,772,266,1038,58,1096
公投第８案,高雄市,楠梓區,清豐里,438,1578,655,248,903,75,978
公投第８案,高雄市,楠梓區,清豐里,439,1715,714,210,924,42,966
公投第８案,高雄市,楠梓區,清豐里,440,1611,651,206,857,30,887
公投第８案,高雄市,楠梓區,清豐里,441,2024,824,213,1037,72,1109
公投第８案,高雄市,楠梓區,清豐里,442,1890,749,214,963,39,1002
公投第８案,高雄市,楠梓區,清豐里,443,1762,658,193,851,25,876
公投第８案,高雄市,楠梓區,清豐里,444,1888,743,219,962,75,1037
公投第８案,高雄市,楠梓區,清豐里,445,1822,719,227,946,84,1030
公投第８案,高雄市,楠梓區,清豐里,446,1846,743,228,971,67,1038
公投第８案,高雄市,楠梓區,東寧里,447,1268,573,174,747,73,820
公投第８案,高雄市,楠梓區,東寧里,448,1240,580,169,749,56,805
公投第８案,高雄市,楠梓區,東寧里,449,1432,611,236,847,35,882
公投第８案,高雄市,楠梓區,五常里,450,1490,641,178,819,62,881
公投第８案,高雄市,楠梓區,五常里,451,1464,664,188,852,56,908
公投第８案,高雄市,楠梓區,五常里,452,1435,523,210,733,84,817
公投第８案,高雄市,楠梓區,五常里,453,1602,629,187,816,83,899
公投第８案,高雄市,楠梓區,享平里,454,1500,580,205,785,62,847
公投第８案,高雄市,楠梓區,享平里,455,1591,606,216,822,106,928
公投第８案,高雄市,楠梓區,惠楠里,456,1669,410,185,595,63,658
公投第８案,高雄市,楠梓區,惠楠里,457,1469,623,207,830,68,898
公投第８案,高雄市,楠梓區,中陽里,458,1559,593,196,789,97,886
公投第８案,高雄市,楠梓區,中陽里,459,1638,612,226,838,94,932
公投第８案,高雄市,楠梓區,惠民里,460,1960,802,270,1072,88,1160
公投第８案,高雄市,楠梓區,惠民里,461,1912,731,264,995,151,1146
公投第８案,高雄市,楠梓區,惠豐里,462,1559,649,182,831,65,896
公投第８案,高雄市,楠梓區,惠豐里,463,1423,595,154,749,53,802
公投第８案,高雄市,楠梓區,惠豐里,464,1696,742,202,944,46,990
公投第８案,高雄市,楠梓區,錦屏里,465,1493,504,215,719,156,875
公投第８案,高雄市,楠梓區,錦屏里,466,1527,577,249,826,107,933
公投第８案,高雄市,楠梓區,玉屏里,467,1020,395,180,575,79,654
公投第８案,高雄市,楠梓區,玉屏里,468,1197,435,190,625,86,711
公投第８案,高雄市,楠梓區,金田里,469,1528,494,246,740,99,839
公投第８案,高雄市,楠梓區,金田里,470,1918,608,263,871,118,989
公投第８案,高雄市,楠梓區,稔田里,471,1458,418,200,618,113,731
公投第８案,高雄市,楠梓區,瑞屏里,472,1790,742,269,1011,112,1123
公投第８案,高雄市,楠梓區,瑞屏里,473,1845,818,241,1059,87,1146
公投第８案,高雄市,楠梓區,翠屏里,474,2037,871,261,1132,85,1217
公投第８案,高雄市,楠梓區,翠屏里,475,1964,825,218,1043,65,1108
公投第８案,高雄市,楠梓區,翠屏里,476,2006,831,227,1058,50,1108
公投第８案,高雄市,楠梓區,翠屏里,477,1951,790,256,1046,63,1109
公投第８案,高雄市,楠梓區,翠屏里,478,1951,823,200,1023,68,1091
公投第８案,高雄市,楠梓區,翠屏里,479,2008,894,223,1117,86,1203
公投第８案,高雄市,楠梓區,翠屏里,480,1923,825,235,1060,102,1162
公投第８案,高雄市,楠梓區,翠屏里,481,1921,874,206,1080,66,1146
公投第８案,高雄市,楠梓區,宏南里,482,832,382,139,521,35,556
公投第８案,高雄市,楠梓區,宏毅里,483,1156,435,193,628,61,689
公投第８案,高雄市,楠梓區,宏毅里,484,1125,438,200,638,63,701
公投第８案,高雄市,楠梓區,宏榮里,485,1060,430,181,611,64,675
公投第８案,高雄市,楠梓區,宏榮里,486,1502,663,211,874,68,942
公投第８案,高雄市,楠梓區,廣昌里,487,1404,545,215,760,98,858
公投第８案,高雄市,楠梓區,廣昌里,488,1552,578,163,741,84,825
公投第８案,高雄市,楠梓區,久昌里,489,1460,576,187,763,79,842
公投第８案,高雄市,楠梓區,久昌里,490,1315,513,136,649,73,722
公投第８案,高雄市,楠梓區,大昌里,491,1062,450,145,595,74,669
公投第８案,高雄市,楠梓區,大昌里,492,1078,469,119,588,72,660
公投第８案,高雄市,楠梓區,福昌里,493,914,384,132,516,94,610
公投第８案,高雄市,楠梓區,福昌里,494,1064,458,146,604,104,708
公投第８案,高雄市,楠梓區,盛昌里,495,1705,709,234,943,96,1039
公投第８案,高雄市,楠梓區,盛昌里,496,1728,784,191,975,69,1044
公投第８案,高雄市,楠梓區,盛昌里,497,1917,869,203,1072,81,1153
公投第８案,高雄市,楠梓區,泰昌里,498,1439,536,171,707,108,815
公投第８案,高雄市,楠梓區,興昌里,499,1287,564,162,726,87,813
公投第８案,高雄市,楠梓區,興昌里,500,1504,675,195,870,88,958
公投第８案,高雄市,楠梓區,興昌里,501,1405,689,166,855,76,931
公投第８案,高雄市,楠梓區,建昌里,502,1287,509,188,697,88,785
公投第８案,高雄市,楠梓區,建昌里,503,1295,577,167,744,58,802
公投第８案,高雄市,楠梓區,宏昌里,504,1483,646,212,858,69,927
公投第８案,高雄市,楠梓區,宏昌里,505,1649,790,227,1017,74,1091
公投第８案,高雄市,楠梓區,和昌里,506,998,438,132,570,79,649
公投第８案,高雄市,楠梓區,和昌里,507,1025,459,140,599,71,670
公投第８案,高雄市,楠梓區,慶昌里,508,1671,778,231,1009,87,1096
公投第８案,高雄市,楠梓區,慶昌里,509,1453,625,229,854,102,956
公投第８案,高雄市,楠梓區,隆昌里,510,1673,656,228,884,101,985
公投第８案,高雄市,楠梓區,隆昌里,511,1653,716,168,884,63,947
公投第８案,高雄市,楠梓區,秀昌里,512,1034,448,133,581,60,641
公投第８案,高雄市,楠梓區,秀昌里,513,1127,544,165,709,68,777
公投第８案,高雄市,楠梓區,裕昌里,514,1575,625,190,815,99,914
公投第８案,高雄市,楠梓區,裕昌里,515,1559,665,210,875,74,949
公投第８案,高雄市,楠梓區,裕昌里,516,1378,558,171,729,62,791
公投第８案,高雄市,楠梓區,國昌里,517,1714,708,236,944,87,1031
公投第８案,高雄市,楠梓區,國昌里,518,1721,724,219,943,87,1030
公投第８案,高雄市,楠梓區,加昌里,519,1628,698,203,901,77,978
公投第８案,高雄市,楠梓區,加昌里,520,1590,765,212,977,90,1067
公投第８案,高雄市,楠梓區,加昌里,521,1628,722,196,918,77,995
公投第８案,高雄市,楠梓區,加昌里,522,1739,822,254,1076,50,1126
公投第８案,高雄市,楠梓區,加昌里,523,1642,794,195,989,75,1064
公投第８案,高雄市,楠梓區,仁昌里,524,1766,695,203,898,88,986
公投第８案,高雄市,楠梓區,仁昌里,525,1482,628,145,773,85,858
公投第８案,高雄市,楠梓區,仁昌里,526,1749,715,160,875,40,915
公投第８案,高雄市,楠梓區,藍田里,527,1591,690,217,907,57,964
公投第８案,高雄市,楠梓區,藍田里,528,1545,758,189,947,45,992
公投第８案,高雄市,楠梓區,藍田里,529,1651,803,222,1025,45,1070
公投第８案,高雄市,楠梓區,藍田里,530,1646,769,217,986,67,1053
公投第８案,高雄市,楠梓區,中興里,531,1496,637,124,761,97,858
公投第８案,高雄市,楠梓區,中和里,532,1403,517,181,698,103,801
公投第８案,高雄市,楠梓區,中和里,533,1624,668,208,876,66,942
公投第８案,高雄市,左營區,進學里,534,2604,509,289,798,75,873
公投第８案,高雄市,左營區,尾西里,535,1037,397,154,551,93,644
公投第８案,高雄市,左營區,頂北里,536,542,231,67,298,53,351
公投第８案,高雄市,左營區,中北里,537,635,224,102,326,59,385
公投第８案,高雄市,左營區,中南里,538,518,165,56,221,20,241
公投第８案,高雄市,左營區,廟東里,539,813,250,116,366,73,439
公投第８案,高雄市,左營區,廟北里,540,889,295,149,444,91,535
公投第８案,高雄市,左營區,尾南里,541,731,276,111,387,84,471
公投第８案,高雄市,左營區,尾北里,542,1592,539,201,740,57,797
公投第８案,高雄市,左營區,尾北里,543,1709,680,223,903,58,961
公投第８案,高雄市,左營區,屏山里,544,1588,700,156,856,67,923
公投第８案,高雄市,左營區,祥和里,545,358,166,19,185,10,195
公投第８案,高雄市,左營區,永清里,546,666,389,50,439,17,456
公投第８案,高雄市,左營區,莒光里,547,1748,727,182,909,74,983
公投第８案,高雄市,左營區,光輝里,548,1196,550,141,691,76,767
公投第８案,高雄市,左營區,光輝里,549,1240,547,165,712,70,782
公投第８案,高雄市,左營區,合群里,550,1402,720,103,823,48,871
公投第８案,高雄市,左營區,合群里,551,1173,635,79,714,33,747
公投第８案,高雄市,左營區,明建里,552,641,366,68,434,25,459
公投第８案,高雄市,左營區,頂西里,553,951,317,147,464,53,517
公投第８案,高雄市,左營區,聖后里,554,732,258,110,368,50,418
公投第８案,高雄市,左營區,聖西里,555,339,108,53,161,16,177
公投第８案,高雄市,左營區,聖南里,556,519,200,69,269,20,289
公投第８案,高雄市,左營區,城南里,557,514,187,93,280,62,342
公投第８案,高雄市,左營區,路東里,558,720,295,94,389,68,457
公投第８案,高雄市,左營區,廍北里,559,411,148,64,212,57,269
公投第８案,高雄市,左營區,廍南里,560,603,238,112,350,45,395
公投第８案,高雄市,左營區,埤西里,561,904,340,139,479,87,566
公投第８案,高雄市,左營區,埤北里,562,1318,478,120,598,56,654
公投第８案,高雄市,左營區,埤東里,563,966,338,116,454,34,488
公投第８案,高雄市,左營區,海勝里,564,1440,673,128,801,45,846
公投第８案,高雄市,左營區,海勝里,565,1990,901,158,1059,58,1117
公投第８案,高雄市,左營區,海勝里,566,1090,554,75,629,42,671
公投第８案,高雄市,左營區,海勝里,567,1272,625,100,725,68,793
公投第８案,高雄市,左營區,崇實里,568,1558,756,183,939,31,970
公投第８案,高雄市,左營區,崇實里,569,1501,718,205,923,40,963
公投第８案,高雄市,左營區,自助里,570,360,197,38,235,12,247
公投第８案,高雄市,左營區,果貿里,571,1335,672,80,752,36,788
公投第８案,高雄市,左營區,果貿里,572,1359,644,119,763,25,788
公投第８案,高雄市,左營區,果惠里,573,1487,712,151,863,64,927
公投第８案,高雄市,左營區,果峰里,574,1637,703,161,864,63,927
公投第８案,高雄市,左營區,新下里,575,1553,754,182,936,50,986
公投第８案,高雄市,左營區,新下里,576,1564,689,227,916,79,995
公投第８案,高雄市,左營區,新下里,577,1788,847,240,1087,72,1159
公投第８案,高雄市,左營區,新下里,578,2028,886,266,1152,89,1241
公投第８案,高雄市,左營區,新下里,579,2037,844,280,1124,101,1225
公投第８案,高雄市,左營區,新下里,580,2101,962,266,1228,64,1292
公投第８案,高雄市,左營區,新下里,581,2018,921,239,1160,68,1228
公投第８案,高雄市,左營區,新上里,582,1925,815,330,1145,93,1238
公投第８案,高雄市,左營區,新上里,583,1989,800,300,1100,42,1142
公投第８案,高雄市,左營區,新上里,584,1780,666,218,884,40,924
公投第８案,高雄市,左營區,新上里,585,1778,770,270,1040,40,1080
公投第８案,高雄市,左營區,新上里,586,1496,689,192,881,33,914
公投第８案,高雄市,左營區,新上里,587,1538,677,240,917,55,972
公投第８案,高雄市,左營區,新上里,588,2058,893,286,1179,73,1252
公投第８案,高雄市,左營區,新上里,589,1992,843,285,1128,40,1168
公投第８案,高雄市,左營區,新上里,590,2058,885,298,1183,81,1264
公投第８案,高雄市,左營區,新上里,591,2090,917,288,1205,60,1265
公投第８案,高雄市,左營區,新上里,592,2157,875,311,1186,81,1267
公投第８案,高雄市,左營區,新上里,593,2096,939,304,1243,58,1301
公投第８案,高雄市,左營區,新上里,594,2101,924,331,1255,83,1338
公投第８案,高雄市,左營區,新中里,595,1649,689,218,907,85,992
公投第８案,高雄市,左營區,新中里,596,1516,528,265,793,102,895
公投第８案,高雄市,左營區,新中里,597,1678,727,236,963,97,1060
公投第８案,高雄市,左營區,新光里,598,1898,793,287,1080,98,1178
公投第８案,高雄市,左營區,新光里,599,1837,747,239,986,61,1047
公投第８案,高雄市,左營區,新光里,600,1922,767,232,999,42,1041
公投第８案,高雄市,左營區,新光里,601,1785,801,241,1042,61,1103
公投第８案,高雄市,左營區,新光里,602,1886,817,207,1024,32,1056
公投第８案,高雄市,左營區,新光里,603,1895,870,238,1108,50,1158
公投第８案,高雄市,左營區,新光里,604,1831,849,222,1071,40,1111
公投第８案,高雄市,左營區,菜公里,605,2050,855,267,1122,47,1169
公投第８案,高雄市,左營區,菜公里,606,2251,1085,320,1405,64,1469
公投第８案,高雄市,左營區,菜公里,607,2126,983,291,1274,45,1319
公投第８案,高雄市,左營區,菜公里,608,1928,782,235,1017,32,1049
公投第８案,高雄市,左營區,菜公里,609,2166,872,297,1169,68,1237
公投第８案,高雄市,左營區,菜公里,610,2031,918,240,1158,63,1221
公投第８案,高雄市,左營區,菜公里,611,1987,910,255,1165,60,1225
公投第８案,高雄市,左營區,菜公里,612,2166,989,283,1272,42,1314
公投第８案,高雄市,左營區,菜公里,613,1856,804,256,1060,77,1137
公投第８案,高雄市,左營區,菜公里,614,2289,1011,325,1336,60,1396
公投第８案,高雄市,左營區,菜公里,615,1973,881,245,1126,49,1175
公投第８案,高雄市,左營區,菜公里,616,1818,802,232,1034,93,1127
公投第８案,高雄市,左營區,菜公里,617,1565,666,192,858,31,889
公投第８案,高雄市,左營區,菜公里,618,1608,811,192,1003,45,1048
公投第８案,高雄市,左營區,福山里,619,1812,864,240,1104,71,1175
公投第８案,高雄市,左營區,福山里,620,1821,768,195,963,25,988
公投第８案,高雄市,左營區,福山里,621,1907,840,268,1108,72,1180
公投第８案,高雄市,左營區,福山里,622,1812,829,167,996,53,1049
公投第８案,高雄市,左營區,福山里,623,1833,876,227,1103,50,1153
公投第８案,高雄市,左營區,福山里,624,1850,818,264,1082,72,1154
公投第８案,高雄市,左營區,福山里,625,1738,737,210,947,79,1026
公投第８案,高雄市,左營區,福山里,626,1864,888,247,1135,62,1197
公投第８案,高雄市,左營區,福山里,627,1887,873,254,1127,63,1190
公投第８案,高雄市,左營區,福山里,628,1870,810,203,1013,31,1044
公投第８案,高雄市,左營區,福山里,629,1866,849,201,1050,32,1082
公投第８案,高雄市,左營區,福山里,630,1862,798,238,1036,22,1058
公投第８案,高雄市,左營區,福山里,631,1816,834,222,1056,39,1095
公投第８案,高雄市,左營區,福山里,632,1833,791,224,1015,47,1062
公投第８案,高雄市,左營區,福山里,633,1676,742,240,982,72,1054
公投第８案,高雄市,左營區,福山里,634,1843,839,228,1067,66,1133
公投第８案,高雄市,左營區,福山里,635,1872,884,227,1111,43,1154
公投第８案,高雄市,左營區,福山里,636,2259,1013,266,1279,59,1338
公投第８案,高雄市,大社區,嘉誠里,637,950,336,130,466,76,542
公投第８案,高雄市,大社區,保社里,638,1306,456,162,618,45,663
公投第８案,高雄市,大社區,保社里,639,1856,620,161,781,40,821
公投第８案,高雄市,大社區,大社里,640,986,408,154,562,69,631
公投第８案,高雄市,大社區,大社里,641,1116,372,138,510,63,573
公投第８案,高雄市,大社區,大社里,642,1253,520,201,721,85,806
公投第８案,高雄市,大社區,大社里,643,1613,643,221,864,63,927
公投第８案,高雄市,大社區,保安里,644,1455,521,193,714,56,770
公投第８案,高雄市,大社區,保安里,645,1674,641,273,914,61,975
公投第８案,高雄市,大社區,三奶里,646,1004,420,120,540,67,607
公投第８案,高雄市,大社區,三奶里,647,879,329,132,461,40,501
公投第８案,高雄市,大社區,三奶里,648,778,261,124,385,22,407
公投第８案,高雄市,大社區,觀音里,649,1110,437,174,611,64,675
公投第８案,高雄市,大社區,觀音里,650,1432,535,209,744,64,808
公投第８案,高雄市,大社區,觀音里,651,1466,596,194,790,49,839
公投第８案,高雄市,大社區,觀音里,652,1383,572,243,815,95,910
公投第８案,高雄市,大社區,神農里,653,1645,681,217,898,87,985
公投第８案,高雄市,大社區,神農里,654,1555,530,195,725,58,783
公投第８案,高雄市,大社區,神農里,655,1750,660,266,926,88,1014
公投第８案,高雄市,大社區,中里里,656,1111,425,161,586,65,651
公投第８案,高雄市,大社區,中里里,657,1133,462,154,616,78,694
公投第８案,高雄市,大社區,中里里,658,912,374,116,490,46,536
公投第８案,高雄市,大社區,翠屏里,659,745,234,82,316,16,332
公投第８案,高雄市,大社區,翠屏里,660,934,374,130,504,35,539
公投第８案,高雄市,仁武區,大灣里,661,1777,803,247,1050,55,1105
公投第８案,高雄市,仁武區,大灣里,662,2273,993,320,1313,76,1389
公投第８案,高雄市,仁武區,灣內里,663,1384,622,208,830,81,911
公投第８案,高雄市,仁武區,灣內里,664,1170,467,157,624,64,688
公投第８案,高雄市,仁武區,灣內里,665,1216,540,203,743,73,816
公投第８案,高雄市,仁武區,灣內里,666,1598,662,203,865,22,887
公投第８案,高雄市,仁武區,灣內里,667,2143,1008,272,1280,47,1327
公投第８案,高雄市,仁武區,考潭里,668,1300,498,174,672,73,745
公投第８案,高雄市,仁武區,考潭里,669,1338,548,186,734,77,811
公投第８案,高雄市,仁武區,烏林里,670,1217,450,163,613,23,636
公投第８案,高雄市,仁武區,烏林里,671,1202,403,135,538,78,616
公投第８案,高雄市,仁武區,烏林里,672,1404,500,169,669,47,716
公投第８案,高雄市,仁武區,仁福里,673,830,314,109,423,57,480
公投第８案,高雄市,仁武區,仁武里,674,1802,556,172,728,42,770
公投第８案,高雄市,仁武區,仁武里,675,1877,703,203,906,82,988
公投第８案,高雄市,仁武區,仁武里,676,1738,581,196,777,48,825
公投第８案,高雄市,仁武區,文武里,677,1549,581,198,779,64,843
公投第８案,高雄市,仁武區,文武里,678,1579,637,251,888,59,947
公投第８案,高雄市,仁武區,文武里,679,1406,542,158,700,43,743
公投第８案,高雄市,仁武區,文武里,680,1461,653,137,790,32,822
公投第８案,高雄市,仁武區,文武里,681,1311,550,209,759,61,820
公投第８案,高雄市,仁武區,文武里,682,1373,531,168,699,37,736
公投第８案,高雄市,仁武區,竹後里,683,1035,312,152,464,21,485
公投第８案,高雄市,仁武區,竹後里,684,1181,405,185,590,40,630
公投第８案,高雄市,仁武區,八卦里,685,1670,643,200,843,51,894
公投第８案,高雄市,仁武區,八卦里,686,1576,599,227,826,26,852
公投第８案,高雄市,仁武區,八卦里,687,1576,709,198,907,69,976
公投第８案,高雄市,仁武區,八卦里,688,1915,859,259,1118,47,1165
公投第８案,高雄市,仁武區,八卦里,689,1758,720,191,911,32,943
公投第８案,高雄市,仁武區,八卦里,690,1892,888,233,1121,72,1193
公投第８案,高雄市,仁武區,八卦里,691,2025,871,267,1138,84,1222
公投第８案,高雄市,仁武區,八卦里,692,2014,927,237,1164,74,1238
公投第８案,高雄市,仁武區,八卦里,693,1473,685,232,917,58,975
公投第８案,高雄市,仁武區,高楠里,694,979,346,119,465,49,514
公投第８案,高雄市,仁武區,高楠里,695,944,384,115,499,28,527
公投第８案,高雄市,仁武區,後安里,696,1153,468,146,614,86,700
公投第８案,高雄市,仁武區,後安里,697,1328,510,148,658,43,701
公投第８案,高雄市,仁武區,中華里,698,1657,672,246,918,80,998
公投第８案,高雄市,仁武區,五和里,699,1545,636,107,743,74,817
公投第８案,高雄市,仁武區,五和里,700,1417,597,217,814,61,875
公投第８案,高雄市,仁武區,五和里,701,1602,752,217,969,55,1024
公投第８案,高雄市,仁武區,仁和里,702,1823,823,258,1081,87,1168
公投第８案,高雄市,仁武區,仁和里,703,1914,777,254,1031,38,1069
公投第８案,高雄市,仁武區,赤山里,704,1992,914,150,1064,57,1121
公投第８案,高雄市,仁武區,赤山里,705,2045,774,254,1028,45,1073
公投第８案,高雄市,仁武區,赤山里,706,1982,895,246,1141,63,1204
公投第８案,高雄市,仁武區,仁慈里,707,2167,828,272,1100,63,1163
公投第８案,高雄市,鳥松區,鳥松里,708,1678,666,252,918,64,982
公投第８案,高雄市,鳥松區,鳥松里,709,1682,638,201,839,75,914
公投第８案,高雄市,鳥松區,鳥松里,710,1225,510,181,691,53,744
公投第８案,高雄市,鳥松區,鳥松里,711,1322,503,162,665,68,733
公投第８案,高雄市,鳥松區,鳥松里,712,1215,509,170,679,56,735
公投第８案,高雄市,鳥松區,鳥松里,713,1779,665,242,907,51,958
公投第８案,高雄市,鳥松區,鳥松里,714,1129,486,215,701,28,729
公投第８案,高雄市,鳥松區,夢裡里,715,1374,590,197,787,68,855
公投第８案,高雄市,鳥松區,夢裡里,716,1089,399,190,589,35,624
公投第８案,高雄市,鳥松區,夢裡里,717,2219,940,348,1288,69,1357
公投第８案,高雄市,鳥松區,大華里,718,1634,652,240,892,32,924
公投第８案,高雄市,鳥松區,大華里,719,1553,702,216,918,68,986
公投第８案,高雄市,鳥松區,大華里,720,1572,692,246,938,55,993
公投第８案,高雄市,鳥松區,大華里,721,1688,723,292,1015,44,1059
公投第８案,高雄市,鳥松區,大華里,722,1626,678,283,961,39,1000
公投第８案,高雄市,鳥松區,大華里,723,1744,773,276,1049,70,1119
公投第８案,高雄市,鳥松區,坔埔里,724,1230,466,162,628,58,686
公投第８案,高雄市,鳥松區,坔埔里,725,1201,508,166,674,94,768
公投第８案,高雄市,鳥松區,坔埔里,726,1117,498,167,665,51,716
公投第８案,高雄市,鳥松區,仁美里,727,1255,479,164,643,71,714
公投第８案,高雄市,鳥松區,仁美里,728,1432,535,154,689,46,735
公投第８案,高雄市,鳥松區,仁美里,729,1370,500,166,666,37,703
公投第８案,高雄市,鳥松區,仁美里,730,1364,618,159,777,71,848
公投第８案,高雄市,鳥松區,仁美里,731,1041,418,168,586,65,651
公投第８案,高雄市,鳥松區,大竹里,732,702,361,107,468,40,508
公投第８案,高雄市,鳥松區,華美里,733,1212,470,189,659,69,728
公投第８案,高雄市,鳥松區,華美里,734,1289,548,145,693,64,757
公投第８案,高雄市,鳥松區,華美里,735,1449,658,222,880,47,927
公投第８案,高雄市,大樹區,竹寮里,736,1386,537,176,713,29,742
公投第８案,高雄市,大樹區,竹寮里,737,1315,605,194,799,36,835
公投第８案,高雄市,大樹區,九曲里,738,2461,946,288,1234,82,1316
公投第８案,高雄市,大樹區,九曲里,739,1274,487,143,630,37,667
公投第８案,高雄市,大樹區,九曲里,740,1265,502,140,642,71,713
公投第８案,高雄市,大樹區,久堂里,741,1504,577,168,745,78,823
公投第８案,高雄市,大樹區,久堂里,742,1049,357,128,485,29,514
公投第８案,高雄市,大樹區,久堂里,743,1573,596,192,788,54,842
公投第８案,高雄市,大樹區,水安里,744,1121,384,101,485,41,526
公投第８案,高雄市,大樹區,水安里,745,1207,490,153,643,58,701
公投第８案,高雄市,大樹區,水寮里,746,1134,417,145,562,28,590
公投第８案,高雄市,大樹區,水寮里,747,1124,430,183,613,40,653
公投第８案,高雄市,大樹區,檨腳里,748,1259,453,160,613,104,717
公投第８案,高雄市,大樹區,檨腳里,749,1105,479,145,624,67,691
公投第８案,高雄市,大樹區,檨腳里,750,1128,429,154,583,64,647
公投第８案,高雄市,大樹區,興山里,751,1079,367,137,504,89,593
公投第８案,高雄市,大樹區,和山里,752,1025,355,110,465,39,504
公投第８案,高雄市,大樹區,姑山里,753,950,347,120,467,61,528
公投第８案,高雄市,大樹區,大坑里,754,1433,484,220,704,107,811
公投第８案,高雄市,大樹區,井腳里,755,794,258,92,350,24,374
公投第８案,高雄市,大樹區,井腳里,756,781,201,72,273,17,290
公投第８案,高雄市,大樹區,小坪里,757,1318,419,162,581,30,611
公投第８案,高雄市,大樹區,龍目里,758,736,267,88,355,49,404
公投第８案,高雄市,大樹區,龍目里,759,1047,324,126,450,28,478
公投第８案,高雄市,大樹區,大樹里,760,1271,483,172,655,84,739
公投第８案,高雄市,大樹區,大樹里,761,1186,371,143,514,39,553
公投第８案,高雄市,大樹區,三和里,762,1007,391,132,523,53,576
公投第８案,高雄市,大樹區,溪埔里,763,859,348,108,456,57,513
公投第８案,高雄市,大樹區,溪埔里,764,735,253,58,311,22,333
公投第８案,高雄市,大樹區,興田里,765,1046,415,146,561,77,638
公投第８案,高雄市,大樹區,興田里,766,880,540,63,603,48,651
公投第８案,高雄市,大樹區,統嶺里,767,720,263,76,339,20,359
公投第８案,高雄市,鼓山區,鼓峰里,768,959,361,104,465,25,490
公投第８案,高雄市,鼓山區,鼓峰里,769,1000,472,130,602,54,656
公投第８案,高雄市,鼓山區,雄峰里,770,910,392,98,490,13,503
公投第８案,高雄市,鼓山區,雄峰里,771,1085,538,118,656,55,711
公投第８案,高雄市,鼓山區,前峰里,772,1484,490,163,653,51,704
公投第８案,高雄市,鼓山區,前峰里,773,1393,621,159,780,31,811
公投第８案,高雄市,鼓山區,前峰里,774,1270,610,169,779,71,850
公投第８案,高雄市,鼓山區,光榮里,775,1055,402,132,534,47,581
公投第８案,高雄市,鼓山區,光榮里,776,1172,450,165,615,35,650
公投第８案,高雄市,鼓山區,光榮里,777,1175,495,189,684,51,735
公投第８案,高雄市,鼓山區,民族里,778,1274,499,194,693,47,740
公投第８案,高雄市,鼓山區,內惟里,779,1085,381,123,504,52,556
公投第８案,高雄市,鼓山區,建國里,780,1470,579,179,758,69,827
公投第８案,高雄市,鼓山區,建國里,781,974,417,167,584,51,635
公投第８案,高雄市,鼓山區,忠正里,782,1275,523,185,708,87,795
公投第８案,高雄市,鼓山區,忠正里,783,1206,445,172,617,67,684
公投第８案,高雄市,鼓山區,忠正里,784,1238,508,167,675,31,706
公投第８案,高雄市,鼓山區,自強里,785,721,436,41,477,19,496
公投第８案,高雄市,鼓山區,龍井里,786,1220,460,148,608,35,643
公投第８案,高雄市,鼓山區,正德里,787,1966,645,220,865,46,911
公投第８案,高雄市,鼓山區,平和里,788,1722,580,245,825,78,903
公投第８案,高雄市,鼓山區,平和里,789,1720,633,204,837,29,866
公投第８案,高雄市,鼓山區,民強里,790,1287,518,174,692,109,801
公投第８案,高雄市,鼓山區,民強里,791,1369,434,152,586,44,630
公投第８案,高雄市,鼓山區,厚生里,792,1222,539,166,705,37,742
公投第８案,高雄市,鼓山區,厚生里,793,1770,692,185,877,58,935
公投第８案,高雄市,鼓山區,龍子里,794,1860,771,203,974,48,1022
公投第８案,高雄市,鼓山區,龍子里,795,1857,749,241,990,58,1048
公投第８案,高雄市,鼓山區,龍子里,796,1841,766,253,1019,54,1073
公投第８案,高雄市,鼓山區,龍子里,797,1830,799,250,1049,71,1120
公投第８案,高雄市,鼓山區,龍子里,798,1809,766,237,1003,69,1072
公投第８案,高雄市,鼓山區,龍子里,799,1894,854,231,1085,51,1136
公投第８案,高雄市,鼓山區,龍子里,800,1882,835,284,1119,25,1144
公投第８案,高雄市,鼓山區,龍子里,801,1894,824,319,1143,62,1205
公投第８案,高雄市,鼓山區,龍水里,802,1745,760,207,967,45,1012
公投第８案,高雄市,鼓山區,龍水里,803,1887,825,185,1010,26,1036
公投第８案,高雄市,鼓山區,龍水里,804,1891,867,294,1161,61,1222
公投第８案,高雄市,鼓山區,龍水里,805,1903,839,262,1101,60,1161
公投第８案,高雄市,鼓山區,龍水里,806,1998,833,330,1163,49,1212
公投第８案,高雄市,鼓山區,龍水里,807,1912,850,260,1110,67,1177
公投第８案,高雄市,鼓山區,龍水里,808,1923,864,260,1124,75,1199
公投第８案,高雄市,鼓山區,龍水里,809,1888,859,271,1130,38,1168
公投第８案,高雄市,鼓山區,龍水里,810,1873,873,255,1128,19,1147
公投第８案,高雄市,鼓山區,龍水里,811,1959,951,314,1265,48,1313
公投第８案,高雄市,鼓山區,龍水里,812,1897,917,260,1177,59,1236
公投第８案,高雄市,鼓山區,明誠里,813,2362,1076,300,1376,47,1423
公投第８案,高雄市,鼓山區,明誠里,814,1850,841,232,1073,77,1150
公投第８案,高雄市,鼓山區,明誠里,815,1928,1072,67,1139,35,1174
公投第８案,高雄市,鼓山區,明誠里,816,1937,842,213,1055,37,1092
公投第８案,高雄市,鼓山區,明誠里,817,2123,918,262,1180,75,1255
公投第８案,高雄市,鼓山區,明誠里,818,1861,785,274,1059,39,1098
公投第８案,高雄市,鼓山區,明誠里,819,1892,823,225,1048,38,1086
公投第８案,高雄市,鼓山區,明誠里,820,2147,931,315,1246,56,1302
公投第８案,高雄市,鼓山區,華豐里,821,1897,880,233,1113,46,1159
公投第８案,高雄市,鼓山區,華豐里,822,2041,833,295,1128,30,1158
公投第８案,高雄市,鼓山區,裕興里,823,1309,567,152,719,55,774
公投第８案,高雄市,鼓山區,裕興里,824,1867,796,278,1074,64,1138
公投第８案,高雄市,鼓山區,裕豐里,825,1152,580,156,736,45,781
公投第８案,高雄市,鼓山區,裕豐里,826,1404,657,185,842,59,901
公投第８案,高雄市,鼓山區,鼓岩里,827,1210,322,97,419,27,446
公投第８案,高雄市,鼓山區,樹德里,828,1135,399,178,577,51,628
公投第８案,高雄市,鼓山區,寶樹里,829,1831,430,148,578,84,662
公投第８案,高雄市,鼓山區,興宗里,830,1288,526,154,680,76,756
公投第８案,高雄市,鼓山區,光化里,831,1241,476,139,615,40,655
公投第８案,高雄市,鼓山區,山下里,832,1342,568,172,740,83,823
公投第８案,高雄市,鼓山區,河邊里,833,1422,555,208,763,105,868
公投第８案,高雄市,鼓山區,綠川里,834,1453,617,196,813,104,917
公投第８案,高雄市,鼓山區,登山里,835,616,246,103,349,49,398
公投第８案,高雄市,鼓山區,峰南里,836,834,292,128,420,81,501
公投第８案,高雄市,鼓山區,麗興里,837,969,349,144,493,60,553
公投第８案,高雄市,鼓山區,新民里,838,978,335,147,482,88,570
公投第８案,高雄市,鼓山區,延平里,839,760,282,130,412,74,486
公投第８案,高雄市,鼓山區,維生里,840,1248,491,177,668,71,739
公投第８案,高雄市,鼓山區,惠安里,841,1143,369,165,534,23,557
公投第８案,高雄市,鼓山區,壽山里,842,1358,439,153,592,80,672
公投第８案,高雄市,鼓山區,哨船頭里,843,1036,386,104,490,19,509
公投第８案,高雄市,鼓山區,桃源里,844,580,196,89,285,15,300
公投第８案,高雄市,鹽埕區,藍橋里,845,1304,530,212,742,62,804
公投第８案,高雄市,鹽埕區,慈愛里,846,357,141,51,192,25,217
公投第８案,高雄市,鹽埕區,博愛里,847,651,240,105,345,28,373
公投第８案,高雄市,鹽埕區,壽星里,848,1322,444,163,607,32,639
公投第８案,高雄市,鹽埕區,中山里,849,1056,422,141,563,27,590
公投第８案,高雄市,鹽埕區,教仁里,850,904,348,151,499,19,518
公投第８案,高雄市,鹽埕區,教仁里,851,1130,423,147,570,32,602
公投第８案,高雄市,鹽埕區,新樂里,852,840,370,102,472,23,495
公投第８案,高雄市,鹽埕區,中原里,853,616,277,125,402,33,435
公投第８案,高雄市,鹽埕區,光明里,854,1397,471,198,669,43,712
公投第８案,高雄市,鹽埕區,育仁里,855,766,283,126,409,18,427
公投第８案,高雄市,鹽埕區,河濱里,856,839,343,132,475,43,518
公投第８案,高雄市,鹽埕區,河濱里,857,805,337,126,463,18,481
公投第８案,高雄市,鹽埕區,沙地里,858,750,275,100,375,23,398
公投第８案,高雄市,鹽埕區,南端里,859,986,353,142,495,38,533
公投第８案,高雄市,鹽埕區,港都里,860,1068,361,120,481,13,494
公投第８案,高雄市,鹽埕區,江西里,861,1060,397,174,571,59,630
公投第８案,高雄市,鹽埕區,新豐里,862,805,289,113,402,38,440
公投第８案,高雄市,鹽埕區,府北里,863,1073,359,135,494,18,512
公投第８案,高雄市,鹽埕區,府北里,864,921,299,132,431,34,465
公投第８案,高雄市,鹽埕區,陸橋里,865,1171,436,163,599,23,622
公投第８案,高雄市,鹽埕區,瀨南里,866,594,205,111,316,22,338
公投第８案,高雄市,鹽埕區,新化里,867,592,241,85,326,19,345
公投第８案,高雄市,鹽埕區,江南里,868,610,187,107,294,15,309
公投第８案,高雄市,旗津區,旗下里,869,1177,508,101,609,123,732
公投第８案,高雄市,旗津區,永安里,870,1109,349,120,469,55,524
公投第８案,高雄市,旗津區,振興里,871,1642,486,191,677,26,703
公投第８案,高雄市,旗津區,慈愛里,872,1209,420,141,561,103,664
公投第８案,高雄市,旗津區,慈愛里,873,1112,345,115,460,62,522
公投第８案,高雄市,旗津區,復興里,874,1483,546,207,753,100,853
公投第８案,高雄市,旗津區,復興里,875,1460,468,107,575,37,612
公投第８案,高雄市,旗津區,中華里,876,1572,558,243,801,175,976
公投第８案,高雄市,旗津區,實踐里,877,1384,452,132,584,36,620
公投第８案,高雄市,旗津區,北汕里,878,1390,425,164,589,44,633
公投第８案,高雄市,旗津區,北汕里,879,1239,386,146,532,69,601
公投第８案,高雄市,旗津區,南汕里,880,2045,637,282,919,139,1058
公投第８案,高雄市,旗津區,上竹里,881,893,283,108,391,23,414
公投第８案,高雄市,旗津區,上竹里,882,1866,548,253,801,161,962
公投第８案,高雄市,旗津區,中洲里,883,1874,458,217,675,43,718
公投第８案,高雄市,旗津區,安順里,884,893,279,105,384,71,455
公投第８案,高雄市,旗津區,中興里,885,1215,399,179,578,48,626
公投第８案,高雄市,旗津區,中興里,886,1297,433,119,552,48,600
公投第８案,高雄市,三民區,鼎金里,887,1893,730,262,992,99,1091
公投第８案,高雄市,三民區,鼎金里,888,1982,721,231,952,109,1061
公投第８案,高雄市,三民區,鼎盛里,889,1661,673,208,881,89,970
公投第８案,高雄市,三民區,鼎盛里,890,1894,749,219,968,32,1000
公投第８案,高雄市,三民區,鼎盛里,891,1839,730,240,970,70,1040
公投第８案,高雄市,三民區,鼎盛里,892,2014,798,279,1077,78,1155
公投第８案,高雄市,三民區,鼎強里,893,1897,732,252,984,133,1117
公投第８案,高雄市,三民區,鼎強里,894,2016,691,279,970,63,1033
公投第８案,高雄市,三民區,鼎力里,895,1924,733,249,982,62,1044
公投第８案,高雄市,三民區,鼎力里,896,1749,707,240,947,84,1031
公投第８案,高雄市,三民區,鼎西里,897,1845,840,253,1093,77,1170
公投第８案,高雄市,三民區,鼎西里,898,1724,649,197,846,53,899
公投第８案,高雄市,三民區,鼎西里,899,1889,771,245,1016,55,1071
公投第８案,高雄市,三民區,鼎西里,900,1622,637,230,867,82,949
公投第８案,高雄市,三民區,鼎中里,901,1870,743,267,1010,46,1056
公投第８案,高雄市,三民區,鼎中里,902,1523,641,238,879,78,957
公投第８案,高雄市,三民區,鼎泰里,903,2006,703,246,949,70,1019
公投第８案,高雄市,三民區,鼎泰里,904,2076,936,282,1218,85,1303
公投第８案,高雄市,三民區,鼎泰里,905,2073,887,244,1131,38,1169
公投第８案,高雄市,三民區,鼎泰里,906,2045,881,238,1119,81,1200
公投第８案,高雄市,三民區,鼎泰里,907,2070,710,245,955,86,1041
公投第８案,高雄市,三民區,鼎泰里,908,2035,743,291,1034,80,1114
公投第８案,高雄市,三民區,鼎泰里,909,2075,920,298,1218,63,1281
公投第８案,高雄市,三民區,鼎泰里,910,2053,926,232,1158,24,1182
公投第８案,高雄市,三民區,鼎泰里,911,2063,946,272,1218,79,1297
公投第８案,高雄市,三民區,鼎泰里,912,2143,995,268,1263,75,1338
公投第８案,高雄市,三民區,本館里,913,1746,726,271,997,95,1092
公投第８案,高雄市,三民區,本館里,914,1735,617,218,835,31,866
公投第８案,高雄市,三民區,本館里,915,1655,624,214,838,79,917
公投第８案,高雄市,三民區,本館里,916,1583,661,214,875,70,945
公投第８案,高雄市,三民區,本館里,917,1800,740,218,958,55,1013
公投第８案,高雄市,三民區,本和里,918,1730,743,222,965,49,1014
公投第８案,高雄市,三民區,本和里,919,1715,681,230,911,41,952
公投第８案,高雄市,三民區,本和里,920,1691,662,277,939,66,1005
公投第８案,高雄市,三民區,本和里,921,1865,795,241,1036,66,1102
公投第８案,高雄市,三民區,本文里,922,1073,481,170,651,42,693
公投第８案,高雄市,三民區,本文里,923,917,408,159,567,65,632
公投第８案,高雄市,三民區,本武里,924,1647,623,281,904,73,977
公投第８案,高雄市,三民區,本元里,925,1654,682,231,913,90,1003
公投第８案,高雄市,三民區,本元里,926,1639,651,248,899,57,956
公投第８案,高雄市,三民區,本元里,927,1833,808,228,1036,69,1105
公投第８案,高雄市,三民區,本安里,928,1362,636,204,840,38,878
公投第８案,高雄市,三民區,本安里,929,1557,700,223,923,69,992
公投第８案,高雄市,三民區,本安里,930,1482,645,222,867,25,892
公投第８案,高雄市,三民區,本上里,931,1563,672,248,920,47,967
公投第８案,高雄市,三民區,本上里,932,1497,622,229,851,45,896
公投第８案,高雄市,三民區,本上里,933,1523,689,220,909,42,951
公投第８案,高雄市,三民區,本揚里,934,1293,581,218,799,63,862
公投第８案,高雄市,三民區,本揚里,935,1662,756,231,987,58,1045
公投第８案,高雄市,三民區,本揚里,936,1441,603,193,796,63,859
公投第８案,高雄市,三民區,本揚里,937,1326,618,216,834,58,892
公投第８案,高雄市,三民區,本揚里,938,1476,647,253,900,43,943
公投第８案,高雄市,三民區,寶獅里,939,1968,720,226,946,41,987
公投第８案,高雄市,三民區,寶獅里,940,1618,582,207,789,35,824
公投第８案,高雄市,三民區,寶德里,941,1873,771,237,1008,69,1077
公投第８案,高雄市,三民區,寶德里,942,1487,608,220,828,72,900
公投第８案,高雄市,三民區,寶德里,943,1640,603,241,844,34,878
公投第８案,高雄市,三民區,寶泰里,944,1889,740,215,955,40,995
公投第８案,高雄市,三民區,寶泰里,945,1969,777,218,995,45,1040
公投第８案,高雄市,三民區,寶興里,946,1466,571,201,772,103,875
公投第８案,高雄市,三民區,寶興里,947,1697,741,245,986,60,1046
公投第８案,高雄市,三民區,寶興里,948,1663,698,225,923,83,1006
公投第８案,高雄市,三民區,寶興里,949,1649,679,226,905,52,957
公投第８案,高雄市,三民區,寶中里,950,1486,574,200,774,49,823
公投第８案,高雄市,三民區,寶中里,951,1495,568,197,765,33,798
公投第８案,高雄市,三民區,寶華里,952,1548,748,224,972,26,998
公投第８案,高雄市,三民區,寶華里,953,1493,582,212,794,40,834
公投第８案,高雄市,三民區,寶國里,954,1445,647,198,845,40,885
公投第８案,高雄市,三民區,寶國里,955,1529,668,55,723,46,769
公投第８案,高雄市,三民區,寶國里,956,1506,616,180,796,37,833
公投第８案,高雄市,三民區,寶國里,957,1549,700,206,906,67,973
公投第８案,高雄市,三民區,寶國里,958,1620,715,237,952,78,1030
公投第８案,高雄市,三民區,寶民里,959,1550,676,239,915,64,979
公投第８案,高雄市,三民區,寶民里,960,1488,657,224,881,57,938
公投第８案,高雄市,三民區,寶慶里,961,1335,582,180,762,62,824
公投第８案,高雄市,三民區,寶慶里,962,1332,577,176,753,63,816
公投第８案,高雄市,三民區,寶業里,963,1764,702,269,971,106,1077
公投第８案,高雄市,三民區,寶業里,964,1811,742,247,989,49,1038
公投第８案,高雄市,三民區,寶業里,965,1693,733,250,983,88,1071
公投第８案,高雄市,三民區,寶盛里,966,1684,710,284,994,89,1083
公投第８案,高雄市,三民區,寶盛里,967,1464,599,176,775,65,840
公投第８案,高雄市,三民區,寶盛里,968,1719,780,284,1064,43,1107
公投第８案,高雄市,三民區,寶安里,969,1749,725,240,965,33,998
公投第８案,高雄市,三民區,寶安里,970,1908,766,219,985,48,1033
公投第８案,高雄市,三民區,寶安里,971,1573,700,202,902,62,964
公投第８案,高雄市,三民區,寶安里,972,1628,643,218,861,54,915
公投第８案,高雄市,三民區,寶龍里,973,1377,476,170,646,61,707
公投第８案,高雄市,三民區,寶龍里,974,1530,695,209,904,60,964
公投第８案,高雄市,三民區,寶龍里,975,1188,465,140,605,64,669
公投第８案,高雄市,三民區,寶珠里,976,2791,568,213,781,40,821
公投第８案,高雄市,三民區,寶珠里,977,1840,772,248,1020,75,1095
公投第８案,高雄市,三民區,寶珠里,978,1671,704,226,930,113,1043
公投第８案,高雄市,三民區,寶玉里,979,1624,674,232,906,74,980
公投第８案,高雄市,三民區,寶玉里,980,1555,747,243,990,68,1058
公投第８案,高雄市,三民區,寶玉里,981,1489,679,241,920,61,981
公投第８案,高雄市,三民區,寶玉里,982,1662,744,222,966,71,1037
公投第８案,高雄市,三民區,寶玉里,983,1639,675,202,877,32,909
公投第８案,高雄市,三民區,灣子里,984,1872,718,277,995,95,1090
公投第８案,高雄市,三民區,灣子里,985,1968,831,247,1078,74,1152
公投第８案,高雄市,三民區,灣愛里,986,1471,518,147,665,121,786
公投第８案,高雄市,三民區,灣愛里,987,1534,596,199,795,79,874
公投第８案,高雄市,三民區,灣中里,988,1659,623,177,800,105,905
公投第８案,高雄市,三民區,灣中里,989,1815,648,195,843,54,897
公投第８案,高雄市,三民區,灣中里,990,1808,676,216,892,62,954
公投第８案,高雄市,三民區,灣華里,991,1224,426,167,593,48,641
公投第８案,高雄市,三民區,灣華里,992,1406,548,187,735,37,772
公投第８案,高雄市,三民區,灣勝里,993,945,347,143,490,30,520
公投第８案,高雄市,三民區,灣勝里,994,944,393,151,544,49,593
公投第８案,高雄市,三民區,灣利里,995,1669,621,261,882,86,968
公投第８案,高雄市,三民區,灣利里,996,1473,552,254,806,107,913
公投第８案,高雄市,三民區,灣復里,997,1876,658,225,883,74,957
公投第８案,高雄市,三民區,灣復里,998,1682,430,158,588,67,655
公投第８案,高雄市,三民區,正興里,999,1791,652,263,915,49,964
公投第８案,高雄市,三民區,正興里,1000,1808,737,281,1018,73,1091
公投第８案,高雄市,三民區,正興里,1001,1798,684,229,913,74,987
公投第８案,高雄市,三民區,正興里,1002,2030,835,290,1125,72,1197
公投第８案,高雄市,三民區,正興里,1003,2034,860,256,1116,28,1144
公投第８案,高雄市,三民區,正興里,1004,1998,840,250,1090,47,1137
公投第８案,高雄市,三民區,正順里,1005,1914,731,211,942,39,981
公投第８案,高雄市,三民區,正順里,1006,1965,767,233,1000,58,1058
公投第８案,高雄市,三民區,灣興里,1007,1885,805,186,991,104,1095
公投第８案,高雄市,三民區,灣成里,1008,1220,516,177,693,22,715
公投第８案,高雄市,三民區,灣成里,1009,1057,382,163,545,86,631
公投第８案,高雄市,三民區,安康里,1010,1434,456,160,616,33,649
公投第８案,高雄市,三民區,安康里,1011,1350,453,131,584,54,638
公投第８案,高雄市,三民區,安寧里,1012,872,277,98,375,25,400
公投第８案,高雄市,三民區,安寧里,1013,954,347,123,470,25,495
公投第８案,高雄市,三民區,安吉里,1014,1689,567,308,875,32,907
公投第８案,高雄市,三民區,安吉里,1015,1390,524,213,737,28,765
公投第８案,高雄市,三民區,安吉里,1016,1336,512,231,743,62,805
公投第８案,高雄市,三民區,安發里,1017,1437,643,241,884,63,947
公投第８案,高雄市,三民區,安發里,1018,1452,584,210,794,43,837
公投第８案,高雄市,三民區,安發里,1019,1513,607,238,845,90,935
公投第８案,高雄市,三民區,安東里,1020,1467,608,247,855,107,962
公投第８案,高雄市,三民區,安東里,1021,1381,584,257,841,95,936
公投第８案,高雄市,三民區,安和里,1022,1117,457,141,598,58,656
公投第８案,高雄市,三民區,安和里,1023,1327,547,217,764,45,809
公投第８案,高雄市,三民區,達德里,1024,1304,521,208,729,48,777
公投第８案,高雄市,三民區,達明里,1025,1483,499,224,723,42,765
公投第８案,高雄市,三民區,達仁里,1026,1473,610,233,843,59,902
公投第８案,高雄市,三民區,達勇里,1027,980,396,149,545,41,586
公投第８案,高雄市,三民區,同德里,1028,1409,583,211,794,76,870
公投第８案,高雄市,三民區,同德里,1029,1230,477,215,692,58,750
公投第８案,高雄市,三民區,德智里,1030,1024,433,177,610,73,683
公投第８案,高雄市,三民區,德智里,1031,1130,456,189,645,67,712
公投第８案,高雄市,三民區,德仁里,1032,1889,658,256,914,45,959
公投第８案,高雄市,三民區,安生里,1033,1427,551,227,778,41,819
公投第８案,高雄市,三民區,德東里,1034,791,318,128,446,23,469
公投第８案,高雄市,三民區,德行里,1035,1079,474,185,659,95,754
公投第８案,高雄市,三民區,精華里,1036,1492,550,252,802,92,894
公投第８案,高雄市,三民區,民享里,1037,1020,421,168,589,66,655
公投第８案,高雄市,三民區,民享里,1038,1001,399,160,559,17,576
公投第８案,高雄市,三民區,安宜里,1039,1581,629,219,848,61,909
公投第８案,高雄市,三民區,安宜里,1040,1471,565,213,778,50,828
公投第８案,高雄市,三民區,安泰里,1041,1151,451,168,619,35,654
公投第８案,高雄市,三民區,安泰里,1042,1334,542,225,767,79,846
公投第８案,高雄市,三民區,安泰里,1043,1275,537,183,720,51,771
公投第８案,高雄市,三民區,安邦里,1044,1688,485,224,709,52,761
公投第８案,高雄市,三民區,安邦里,1045,1214,455,195,650,42,692
公投第８案,高雄市,三民區,安邦里,1046,1149,507,184,691,32,723
公投第８案,高雄市,三民區,十全里,1047,1667,636,260,896,110,1006
公投第８案,高雄市,三民區,十美里,1048,1786,620,247,867,42,909
公投第８案,高雄市,三民區,德北里,1049,896,363,144,507,30,537
公投第８案,高雄市,三民區,德北里,1050,925,391,125,516,63,579
公投第８案,高雄市,三民區,立誠里,1051,684,298,114,412,60,472
公投第８案,高雄市,三民區,立業里,1052,981,593,1,594,66,660
公投第８案,高雄市,三民區,港東里,1053,1383,472,189,661,96,757
公投第８案,高雄市,三民區,港新里,1054,1382,526,198,724,67,791
公投第８案,高雄市,三民區,港西里,1055,808,306,103,409,40,449
公投第８案,高雄市,三民區,博愛里,1056,1197,489,188,677,32,709
公投第８案,高雄市,三民區,博惠里,1057,1344,529,165,694,65,759
公投第８案,高雄市,三民區,博惠里,1058,1344,515,231,746,67,813
公投第８案,高雄市,三民區,博惠里,1059,1359,577,178,755,24,779
公投第８案,高雄市,三民區,長明里,1060,1073,448,172,620,62,682
公投第８案,高雄市,三民區,建東里,1061,1186,454,155,609,61,670
公投第８案,高雄市,三民區,興德里,1062,1749,692,246,938,93,1031
公投第８案,高雄市,三民區,鳳南里,1063,877,312,114,426,21,447
公投第８案,高雄市,三民區,鳳北里,1064,1402,563,233,796,114,910
公投第８案,高雄市,三民區,德西里,1065,769,331,127,458,28,486
公投第８案,高雄市,三民區,豐裕里,1066,1207,501,172,673,73,746
公投第８案,高雄市,三民區,豐裕里,1067,1270,449,157,606,51,657
公投第８案,高雄市,三民區,川東里,1068,1248,494,169,663,62,725
公投第８案,高雄市,三民區,裕民里,1069,1263,530,160,690,94,784
公投第８案,高雄市,三民區,力行里,1070,1101,434,166,600,43,643
公投第８案,高雄市,三民區,千歲里,1071,1116,475,145,620,30,650
公投第８案,高雄市,三民區,立德里,1072,1152,465,160,625,40,665
公投第８案,高雄市,三民區,千北里,1073,1057,429,147,576,86,662
公投第８案,高雄市,三民區,千秋里,1074,971,329,133,462,56,518
公投第８案,高雄市,三民區,千秋里,1075,1062,403,141,544,28,572
公投第８案,高雄市,前金區,三川里,1076,673,238,101,339,15,354
公投第８案,高雄市,前金區,草江里,1077,1022,472,123,595,27,622
公投第８案,高雄市,前金區,長城里,1078,1324,505,161,666,46,712
公投第８案,高雄市,前金區,北金里,1079,839,327,126,453,55,508
公投第８案,高雄市,前金區,東金里,1080,975,369,152,521,74,595
公投第８案,高雄市,前金區,新生里,1081,1806,772,213,985,75,1060
公投第８案,高雄市,前金區,新生里,1082,1781,738,242,980,43,1023
公投第８案,高雄市,前金區,後金里,1083,717,295,121,416,34,450
公投第８案,高雄市,前金區,長興里,1084,1097,430,158,588,24,612
公投第８案,高雄市,前金區,青山里,1085,1633,637,240,877,38,915
公投第８案,高雄市,前金區,民生里,1086,759,355,125,480,34,514
公投第８案,高雄市,前金區,復元里,1087,948,404,170,574,59,633
公投第８案,高雄市,前金區,林投里,1088,1009,340,140,480,81,561
公投第８案,高雄市,前金區,國民里,1089,945,388,133,521,46,567
公投第８案,高雄市,前金區,社東里,1090,772,334,112,446,21,467
公投第８案,高雄市,前金區,社東里,1091,757,321,136,457,32,489
公投第８案,高雄市,前金區,社西里,1092,1047,459,153,612,37,649
公投第８案,高雄市,前金區,博孝里,1093,985,415,158,573,52,625
公投第８案,高雄市,前金區,長生里,1094,1674,650,224,874,30,904
公投第８案,高雄市,前金區,榮復里,1095,1088,425,159,584,34,618
公投第８案,高雄市,前金區,文西里,1096,893,395,146,541,59,600
公投第８案,高雄市,前金區,文東里,1097,1184,445,171,616,37,653
公投第８案,高雄市,新興區,浩然里,1098,828,336,120,456,36,492
公投第８案,高雄市,新興區,浩然里,1099,963,414,152,566,68,634
公投第８案,高雄市,新興區,振成里,1100,1075,397,145,542,37,579
公投第８案,高雄市,新興區,德生里,1101,1488,621,208,829,32,861
公投第８案,高雄市,新興區,德生里,1102,1438,601,201,802,43,845
公投第８案,高雄市,新興區,振華里,1103,1049,446,164,610,31,641
公投第８案,高雄市,新興區,正氣里,1104,1378,556,264,820,93,913
公投第８案,高雄市,新興區,德政里,1105,666,300,96,396,40,436
公投第８案,高雄市,新興區,仁聲里,1106,981,368,204,572,32,604
公投第８案,高雄市,新興區,德望里,1107,933,404,166,570,39,609
公投第８案,高雄市,新興區,德望里,1108,987,410,124,534,29,563
公投第８案,高雄市,新興區,華聲里,1109,988,435,132,567,46,613
公投第８案,高雄市,新興區,蕉園里,1110,735,325,112,437,45,482
公投第８案,高雄市,新興區,永寧里,1111,1317,513,226,739,41,780
公投第８案,高雄市,新興區,玉衡里,1112,800,296,86,382,23,405
公投第８案,高雄市,新興區,順昌里,1113,968,389,165,554,43,597
公投第８案,高雄市,新興區,順昌里,1114,913,396,131,527,29,556
公投第８案,高雄市,新興區,文昌里,1115,1389,564,247,811,37,848
公投第８案,高雄市,新興區,文昌里,1116,1228,557,217,774,52,826
公投第８案,高雄市,新興區,光耀里,1117,1211,498,179,677,90,767
公投第８案,高雄市,新興區,光耀里,1118,1101,475,149,624,19,643
公投第８案,高雄市,新興區,興昌里,1119,752,338,112,450,22,472
公投第８案,高雄市,新興區,興昌里,1120,873,412,155,567,53,620
公投第８案,高雄市,新興區,開平里,1121,1609,647,279,926,45,971
公投第８案,高雄市,新興區,開平里,1122,1736,750,277,1027,61,1088
公投第８案,高雄市,新興區,成功里,1123,1258,512,160,672,27,699
公投第８案,高雄市,新興區,新江里,1124,1105,463,167,630,59,689
公投第８案,高雄市,新興區,黎明里,1125,851,303,139,442,63,505
公投第８案,高雄市,新興區,愛平里,1126,1011,411,173,584,50,634
公投第８案,高雄市,新興區,南港里,1127,888,376,160,536,81,617
公投第８案,高雄市,新興區,南港里,1128,1005,397,133,530,34,564
公投第８案,高雄市,新興區,中東里,1129,1375,420,156,576,21,597
公投第８案,高雄市,新興區,中東里,1130,1388,558,214,772,81,853
公投第８案,高雄市,新興區,明莊里,1131,719,269,102,371,57,428
公投第８案,高雄市,新興區,大明里,1132,1077,391,170,561,86,647
公投第８案,高雄市,新興區,秋山里,1133,875,295,113,408,18,426
公投第８案,高雄市,新興區,長驛里,1134,936,357,121,478,24,502
公投第８案,高雄市,新興區,建興里,1135,944,358,130,488,65,553
公投第８案,高雄市,新興區,建華里,1136,833,289,119,408,34,442
公投第８案,高雄市,新興區,漢民里,1137,708,284,108,392,16,408
公投第８案,高雄市,新興區,榮治里,1138,741,319,83,402,20,422
公投第８案,高雄市,新興區,東坡里,1139,1235,408,186,594,37,631
公投第８案,高雄市,苓雅區,博仁里,1140,718,301,119,420,27,447
公投第８案,高雄市,苓雅區,苓洲里,1141,1492,647,158,805,46,851
公投第８案,高雄市,苓雅區,苓昇里,1142,1210,514,165,679,50,729
公投第８案,高雄市,苓雅區,苓中里,1143,1617,568,190,758,38,796
公投第８案,高雄市,苓雅區,苓雅里,1144,1428,602,189,791,86,877
公投第８案,高雄市,苓雅區,苓東里,1145,1444,483,194,677,53,730
公投第８案,高雄市,苓雅區,城北里,1146,1452,585,201,786,75,861
公投第８案,高雄市,苓雅區,城西里,1147,554,232,81,313,42,355
公投第８案,高雄市,苓雅區,城東里,1148,950,355,147,502,20,522
公投第８案,高雄市,苓雅區,城東里,1149,978,336,155,491,23,514
公投第８案,高雄市,苓雅區,意誠里,1150,1673,609,191,800,41,841
公投第８案,高雄市,苓雅區,意誠里,1151,2045,725,270,995,74,1069
公投第８案,高雄市,苓雅區,鼓中里,1152,939,381,138,519,72,591
公投第８案,高雄市,苓雅區,田西里,1153,1284,487,165,652,42,694
公投第８案,高雄市,苓雅區,人和里,1154,908,388,123,511,31,542
公投第８案,高雄市,苓雅區,人和里,1155,838,333,106,439,18,457
公投第８案,高雄市,苓雅區,仁政里,1156,1267,519,191,710,39,749
公投第８案,高雄市,苓雅區,廣澤里,1157,994,420,168,588,58,646
公投第８案,高雄市,苓雅區,廣澤里,1158,774,245,139,384,23,407
公投第８案,高雄市,苓雅區,美田里,1159,1121,461,163,624,33,657
公投第８案,高雄市,苓雅區,華堂里,1160,1474,572,226,798,63,861
公投第８案,高雄市,苓雅區,華堂里,1161,1525,631,229,860,73,933
公投第８案,高雄市,苓雅區,日中里,1162,1147,460,154,614,36,650
公投第８案,高雄市,苓雅區,日中里,1163,1014,436,166,602,38,640
公投第８案,高雄市,苓雅區,普照里,1164,1496,584,260,844,62,906
公投第８案,高雄市,苓雅區,普照里,1165,1499,627,239,866,74,940
公投第８案,高雄市,苓雅區,和煦里,1166,1138,509,160,669,25,694
公投第８案,高雄市,苓雅區,和煦里,1167,839,396,145,541,37,578
公投第８案,高雄市,苓雅區,晴朗里,1168,2088,511,160,671,50,721
公投第８案,高雄市,苓雅區,普天里,1169,1648,694,259,953,11,964
公投第８案,高雄市,苓雅區,普天里,1170,1623,654,223,877,71,948
公投第８案,高雄市,苓雅區,林富里,1171,1932,898,286,1184,67,1251
公投第８案,高雄市,苓雅區,林圍里,1172,1127,552,181,733,26,759
公投第８案,高雄市,苓雅區,林圍里,1173,1156,565,178,743,25,768
公投第８案,高雄市,苓雅區,林安里,1174,1465,623,238,861,37,898
公投第８案,高雄市,苓雅區,光華里,1175,690,245,89,334,26,360
公投第８案,高雄市,苓雅區,林興里,1176,1283,456,176,632,103,735
公投第８案,高雄市,苓雅區,林華里,1177,1432,563,217,780,82,862
公投第８案,高雄市,苓雅區,林華里,1178,1313,543,194,737,48,785
公投第８案,高雄市,苓雅區,林西里,1179,1579,570,230,800,31,831
公投第８案,高雄市,苓雅區,林中里,1180,1385,533,228,761,73,834
公投第８案,高雄市,苓雅區,林中里,1181,1449,650,179,829,71,900
公投第８案,高雄市,苓雅區,林泉里,1182,1834,818,273,1091,52,1143
公投第８案,高雄市,苓雅區,林南里,1183,1436,602,284,886,11,897
公投第８案,高雄市,苓雅區,林南里,1184,1431,628,228,856,60,916
公投第８案,高雄市,苓雅區,中正里,1185,1248,567,200,767,24,791
公投第８案,高雄市,苓雅區,中正里,1186,1470,666,218,884,48,932
公投第８案,高雄市,苓雅區,尚義里,1187,1540,713,213,926,89,1015
公投第８案,高雄市,苓雅區,同慶里,1188,1374,613,208,821,35,856
公投第８案,高雄市,苓雅區,同慶里,1189,839,398,129,527,25,552
公投第８案,高雄市,苓雅區,凱旋里,1190,1022,485,162,647,42,689
公投第８案,高雄市,苓雅區,凱旋里,1191,1062,501,149,650,18,668
公投第８案,高雄市,苓雅區,安祥里,1192,1078,471,153,624,25,649
公投第８案,高雄市,苓雅區,安祥里,1193,1117,491,187,678,30,708
公投第８案,高雄市,苓雅區,奏捷里,1194,1516,634,242,876,60,936
公投第８案,高雄市,苓雅區,福壽里,1195,1440,460,314,774,114,888
公投第８案,高雄市,苓雅區,福南里,1196,839,340,130,470,42,512
公投第８案,高雄市,苓雅區,福南里,1197,888,354,110,464,25,489
公投第８案,高雄市,苓雅區,五權里,1198,1101,467,189,656,36,692
公投第８案,高雄市,苓雅區,五權里,1199,1004,466,180,646,66,712
公投第８案,高雄市,苓雅區,民主里,1200,1427,596,207,803,67,870
公投第８案,高雄市,苓雅區,民主里,1201,1168,482,163,645,41,686
公投第８案,高雄市,苓雅區,民主里,1202,1184,535,197,732,63,795
公投第８案,高雄市,苓雅區,林德里,1203,974,419,163,582,35,617
公投第８案,高雄市,苓雅區,林德里,1204,849,329,97,426,19,445
公投第８案,高雄市,苓雅區,林貴里,1205,1821,777,263,1040,59,1099
公投第８案,高雄市,苓雅區,林榮里,1206,1306,582,191,773,58,831
公投第８案,高雄市,苓雅區,林榮里,1207,1185,509,178,687,31,718
公投第８案,高雄市,苓雅區,林榮里,1208,1415,566,230,796,48,844
公投第８案,高雄市,苓雅區,英明里,1209,962,437,153,590,41,631
公投第８案,高雄市,苓雅區,英明里,1210,964,378,153,531,59,590
公投第８案,高雄市,苓雅區,林靖里,1211,1524,654,209,863,38,901
公投第８案,高雄市,苓雅區,朝陽里,1212,1455,615,216,831,40,871
公投第８案,高雄市,苓雅區,福隆里,1213,1272,450,175,625,45,670
公投第８案,高雄市,苓雅區,福隆里,1214,1256,467,169,636,34,670
公投第８案,高雄市,苓雅區,福祥里,1215,1203,470,158,628,37,665
公投第８案,高雄市,苓雅區,福海里,1216,1062,488,131,619,20,639
公投第８案,高雄市,苓雅區,福康里,1217,850,364,130,494,69,563
公投第８案,高雄市,苓雅區,福康里,1218,1010,408,178,586,95,681
公投第８案,高雄市,苓雅區,福人里,1219,1118,445,153,598,33,631
公投第８案,高雄市,苓雅區,福人里,1220,937,393,148,541,54,595
公投第８案,高雄市,苓雅區,福地里,1221,1493,547,155,702,33,735
公投第８案,高雄市,苓雅區,福地里,1222,1183,516,157,673,37,710
公投第８案,高雄市,苓雅區,福居里,1223,1318,465,161,626,34,660
公投第８案,高雄市,苓雅區,福居里,1224,1362,534,205,739,55,794
公投第８案,高雄市,苓雅區,福東里,1225,1102,397,184,581,84,665
公投第８案,高雄市,苓雅區,福東里,1226,1481,611,193,804,69,873
公投第８案,高雄市,苓雅區,福西里,1227,878,401,122,523,59,582
公投第８案,高雄市,苓雅區,福西里,1228,908,311,126,437,25,462
公投第８案,高雄市,苓雅區,永康里,1229,1056,500,138,638,51,689
公投第８案,高雄市,苓雅區,永康里,1230,1091,403,144,547,43,590
公投第８案,高雄市,苓雅區,正文里,1231,976,410,160,570,35,605
公投第８案,高雄市,苓雅區,正文里,1232,1063,482,180,662,45,707
公投第８案,高雄市,苓雅區,正言里,1233,1484,640,218,858,78,936
公投第８案,高雄市,苓雅區,正言里,1234,1290,484,255,739,40,779
公投第８案,高雄市,苓雅區,正大里,1235,1740,736,262,998,59,1057
公投第８案,高雄市,苓雅區,正大里,1236,1594,672,209,881,66,947
公投第８案,高雄市,苓雅區,正大里,1237,1648,702,197,899,23,922
公投第８案,高雄市,苓雅區,五福里,1238,1236,557,179,736,65,801
公投第８案,高雄市,苓雅區,五福里,1239,1211,492,196,688,55,743
公投第８案,高雄市,苓雅區,五福里,1240,1283,503,199,702,31,733
公投第８案,高雄市,苓雅區,正心里,1241,1804,774,277,1051,86,1137
公投第８案,高雄市,苓雅區,正心里,1242,1718,748,249,997,72,1069
公投第８案,高雄市,苓雅區,正道里,1243,1297,553,196,749,66,815
公投第８案,高雄市,苓雅區,正道里,1244,1449,594,206,800,91,891
公投第８案,高雄市,苓雅區,正道里,1245,1307,544,202,746,31,777
公投第８案,高雄市,苓雅區,正義里,1246,1184,528,162,690,61,751
公投第８案,高雄市,苓雅區,正義里,1247,1250,547,217,764,82,846
公投第８案,高雄市,苓雅區,正仁里,1248,1248,481,193,674,38,712
公投第８案,高雄市,苓雅區,正仁里,1249,1283,540,185,725,29,754
公投第８案,高雄市,苓雅區,文昌里,1250,1121,483,145,628,34,662
公投第８案,高雄市,苓雅區,文昌里,1251,1258,522,184,706,31,737
公投第８案,高雄市,苓雅區,文昌里,1252,1339,593,151,744,27,771
公投第８案,高雄市,苓雅區,建軍里,1253,1986,759,278,1037,71,1108
公投第８案,高雄市,苓雅區,衛武里,1254,1028,417,141,558,39,597
公投第８案,高雄市,苓雅區,衛武里,1255,948,417,134,551,17,568
公投第８案,高雄市,鳳山區,鳳崗里,1256,1080,491,156,647,59,706
公投第８案,高雄市,鳳山區,縣衙里,1257,819,365,112,477,37,514
公投第８案,高雄市,鳳山區,曹公里,1258,851,352,107,459,73,532
公投第８案,高雄市,鳳山區,曹公里,1259,1075,463,166,629,41,670
公投第８案,高雄市,鳳山區,鎮西里,1260,1223,556,166,722,35,757
公投第８案,高雄市,鳳山區,鎮西里,1261,1207,520,184,704,41,745
公投第８案,高雄市,鳳山區,鎮西里,1262,1339,495,198,693,41,734
公投第８案,高雄市,鳳山區,鎮西里,1263,1188,451,118,569,42,611
公投第８案,高雄市,鳳山區,北門里,1264,1055,457,126,583,58,641
公投第８案,高雄市,鳳山區,北門里,1265,1109,447,114,561,75,636
公投第８案,高雄市,鳳山區,北門里,1266,756,367,105,472,43,515
公投第８案,高雄市,鳳山區,北門里,1267,1182,476,132,608,38,646
公投第８案,高雄市,鳳山區,鎮北里,1268,1496,623,187,810,89,899
公投第８案,高雄市,鳳山區,鎮北里,1269,2094,767,210,977,66,1043
公投第８案,高雄市,鳳山區,鎮北里,1270,1672,676,208,884,30,914
公投第８案,高雄市,鳳山區,鎮北里,1271,1761,731,193,924,29,953
公投第８案,高雄市,鳳山區,鎮北里,1272,1450,596,192,788,72,860
公投第８案,高雄市,鳳山區,武松里,1273,1455,540,165,705,44,749
公投第８案,高雄市,鳳山區,武松里,1274,1234,523,140,663,69,732
公投第８案,高雄市,鳳山區,忠誠里,1275,1713,748,230,978,109,1087
公投第８案,高雄市,鳳山區,忠誠里,1276,1698,667,173,840,34,874
公投第８案,高雄市,鳳山區,文英里,1277,1247,513,185,698,74,772
公投第８案,高雄市,鳳山區,文英里,1278,1087,456,153,609,49,658
公投第８案,高雄市,鳳山區,文英里,1279,1199,533,146,679,28,707
公投第８案,高雄市,鳳山區,文華里,1280,1559,728,114,842,57,899
公投第８案,高雄市,鳳山區,文華里,1281,1233,544,142,686,43,729
公投第８案,高雄市,鳳山區,文華里,1282,1277,522,176,698,54,752
公投第８案,高雄市,鳳山區,文華里,1283,1481,655,138,793,18,811
公投第８案,高雄市,鳳山區,文華里,1284,1154,551,167,718,16,734
公投第８案,高雄市,鳳山區,文華里,1285,1475,535,231,766,26,792
公投第８案,高雄市,鳳山區,文山里,1286,1247,483,129,612,83,695
公投第８案,高雄市,鳳山區,文山里,1287,1538,576,186,762,83,845
公投第８案,高雄市,鳳山區,文山里,1288,1097,427,150,577,34,611
公投第８案,高雄市,鳳山區,文山里,1289,1221,433,161,594,28,622
公投第８案,高雄市,鳳山區,文山里,1290,1075,512,158,670,61,731
公投第８案,高雄市,鳳山區,文德里,1291,1751,782,227,1009,50,1059
公投第８案,高雄市,鳳山區,文德里,1292,1758,771,227,998,45,1043
公投第８案,高雄市,鳳山區,文德里,1293,1749,722,228,950,85,1035
公投第８案,高雄市,鳳山區,文德里,1294,1746,747,182,929,26,955
公投第８案,高雄市,鳳山區,文德里,1295,1712,716,190,906,54,960
公投第８案,高雄市,鳳山區,文衡里,1296,1247,536,174,710,32,742
公投第８案,高雄市,鳳山區,文衡里,1297,1409,695,101,796,57,853
公投第８案,高雄市,鳳山區,文衡里,1298,1347,574,183,757,61,818
公投第８案,高雄市,鳳山區,文福里,1299,1771,734,222,956,27,983
公投第８案,高雄市,鳳山區,文福里,1300,1537,645,202,847,20,867
公投第８案,高雄市,鳳山區,文福里,1301,1605,731,218,949,34,983
公投第８案,高雄市,鳳山區,文福里,1302,1375,605,171,776,51,827
公投第８案,高雄市,鳳山區,文福里,1303,1393,623,182,805,66,871
公投第８案,高雄市,鳳山區,文福里,1304,1584,645,185,830,24,854
公投第８案,高雄市,鳳山區,成功里,1305,618,208,122,330,24,354
公投第８案,高雄市,鳳山區,縣口里,1306,423,186,52,238,12,250
公投第８案,高雄市,鳳山區,光明里,1307,1312,516,176,692,69,761
公投第８案,高雄市,鳳山區,和德里,1308,769,317,106,423,36,459
公投第８案,高雄市,鳳山區,和德里,1309,1213,570,160,730,31,761
公投第８案,高雄市,鳳山區,和興里,1310,1107,529,149,678,39,717
公投第８案,高雄市,鳳山區,和興里,1311,1188,495,174,669,36,705
公投第８案,高雄市,鳳山區,和興里,1312,1183,516,171,687,44,731
公投第８案,高雄市,鳳山區,和興里,1313,1264,520,204,724,56,780
公投第８案,高雄市,鳳山區,南興里,1314,882,354,127,481,35,516
公投第８案,高雄市,鳳山區,三民里,1315,1007,476,170,646,57,703
公投第８案,高雄市,鳳山區,新興里,1316,853,344,106,450,85,535
公投第８案,高雄市,鳳山區,新興里,1317,1660,302,117,419,57,476
公投第８案,高雄市,鳳山區,興仁里,1318,1124,491,163,654,37,691
公投第８案,高雄市,鳳山區,興仁里,1319,1112,444,176,620,72,692
公投第８案,高雄市,鳳山區,興仁里,1320,1182,465,138,603,50,653
公投第８案,高雄市,鳳山區,興中里,1321,875,440,136,576,49,625
公投第８案,高雄市,鳳山區,協和里,1322,1040,407,180,587,50,637
公投第８案,高雄市,鳳山區,協和里,1323,1094,488,172,660,34,694
公投第８案,高雄市,鳳山區,協和里,1324,1217,501,194,695,66,761
公投第８案,高雄市,鳳山區,忠義里,1325,974,462,163,625,41,666
公投第８案,高雄市,鳳山區,忠義里,1326,987,443,115,558,44,602
公投第８案,高雄市,鳳山區,忠義里,1327,1210,588,163,751,24,775
公投第８案,高雄市,鳳山區,忠義里,1328,1391,574,188,762,64,826
公投第８案,高雄市,鳳山區,忠孝里,1329,1241,427,164,591,26,617
公投第８案,高雄市,鳳山區,忠孝里,1330,1000,477,119,596,49,645
公投第８案,高雄市,鳳山區,忠孝里,1331,1092,488,130,618,46,664
公投第８案,高雄市,鳳山區,忠孝里,1332,1308,576,174,750,54,804
公投第８案,高雄市,鳳山區,忠孝里,1333,1031,454,125,579,66,645
公投第８案,高雄市,鳳山區,中和里,1334,1159,497,169,666,74,740
公投第８案,高雄市,鳳山區,中和里,1335,1127,465,143,608,64,672
公投第８案,高雄市,鳳山區,中和里,1336,1109,537,205,742,52,794
公投第８案,高雄市,鳳山區,誠義里,1337,1879,851,263,1114,74,1188
公投第８案,高雄市,鳳山區,誠義里,1338,1803,890,251,1141,52,1193
公投第８案,高雄市,鳳山區,生明里,1339,2045,824,183,1007,98,1105
公投第８案,高雄市,鳳山區,鎮東里,1340,1432,608,167,775,43,818
公投第８案,高雄市,鳳山區,鎮東里,1341,1033,409,102,511,23,534
公投第８案,高雄市,鳳山區,瑞竹里,1342,1253,515,185,700,95,795
公投第８案,高雄市,鳳山區,瑞竹里,1343,1217,503,168,671,32,703
公投第８案,高雄市,鳳山區,瑞竹里,1344,1267,607,155,762,52,814
公投第８案,高雄市,鳳山區,瑞竹里,1345,1251,484,151,635,52,687
公投第８案,高雄市,鳳山區,瑞興里,1346,1563,667,193,860,87,947
公投第８案,高雄市,鳳山區,瑞興里,1347,1888,884,213,1097,68,1165
公投第８案,高雄市,鳳山區,瑞興里,1348,1368,588,188,776,60,836
公投第８案,高雄市,鳳山區,東門里,1349,1588,627,179,806,49,855
公投第８案,高雄市,鳳山區,東門里,1350,1255,644,104,748,54,802
公投第８案,高雄市,鳳山區,東門里,1351,1264,538,166,704,74,778
公投第８案,高雄市,鳳山區,東門里,1352,1291,637,66,703,86,789
公投第８案,高雄市,鳳山區,誠德里,1353,1224,528,118,646,48,694
公投第８案,高雄市,鳳山區,誠德里,1354,1296,579,188,767,37,804
公投第８案,高雄市,鳳山區,誠信里,1355,826,393,108,501,55,556
公投第８案,高雄市,鳳山區,誠信里,1356,1229,569,128,697,54,751
公投第８案,高雄市,鳳山區,誠智里,1357,1467,702,142,844,55,899
公投第８案,高雄市,鳳山區,誠智里,1358,1218,536,142,678,64,742
公投第８案,高雄市,鳳山區,鳳東里,1359,2173,878,256,1134,91,1225
公投第８案,高雄市,鳳山區,鳳東里,1360,2255,1069,164,1233,75,1308
公投第８案,高雄市,鳳山區,鳳東里,1361,1556,688,190,878,45,923
公投第８案,高雄市,鳳山區,埤頂里,1362,1521,600,190,790,69,859
公投第８案,高雄市,鳳山區,埤頂里,1363,1407,537,150,687,49,736
公投第８案,高雄市,鳳山區,埤頂里,1364,1542,687,181,868,68,936
公投第８案,高雄市,鳳山區,埤頂里,1365,1502,616,150,766,22,788
公投第８案,高雄市,鳳山區,中正里,1366,1320,616,142,758,68,826
公投第８案,高雄市,鳳山區,中正里,1367,1507,699,90,789,43,832
公投第８案,高雄市,鳳山區,中正里,1368,1284,676,107,783,36,819
公投第８案,高雄市,鳳山區,海光里,1369,1441,585,160,745,45,790
公投第８案,高雄市,鳳山區,海光里,1370,1485,671,155,826,88,914
公投第８案,高雄市,鳳山區,國泰里,1371,1205,449,176,625,73,698
公投第８案,高雄市,鳳山區,國泰里,1372,1284,503,164,667,28,695
公投第８案,高雄市,鳳山區,國泰里,1373,1326,543,205,748,68,816
公投第８案,高雄市,鳳山區,國光里,1374,1096,446,160,606,31,637
公投第８案,高雄市,鳳山區,國光里,1375,1182,487,186,673,83,756
公投第８案,高雄市,鳳山區,國光里,1376,1017,470,164,634,58,692
公投第８案,高雄市,鳳山區,國隆里,1377,1198,452,176,628,89,717
公投第８案,高雄市,鳳山區,國隆里,1378,1281,447,169,616,37,653
公投第８案,高雄市,鳳山區,國富里,1379,1358,600,209,809,45,854
公投第８案,高雄市,鳳山區,國富里,1380,1226,664,94,758,49,807
公投第８案,高雄市,鳳山區,武慶里,1381,1098,495,144,639,72,711
公投第８案,高雄市,鳳山區,武慶里,1382,1200,504,175,679,41,720
公投第８案,高雄市,鳳山區,武漢里,1383,942,384,120,504,45,549
公投第８案,高雄市,鳳山區,武漢里,1384,1206,491,138,629,27,656
公投第８案,高雄市,鳳山區,武漢里,1385,1159,529,175,704,41,745
公投第８案,高雄市,鳳山區,武漢里,1386,1401,618,192,810,68,878
公投第８案,高雄市,鳳山區,新甲里,1387,1525,606,174,780,31,811
公投第８案,高雄市,鳳山區,新甲里,1388,1345,528,196,724,41,765
公投第８案,高雄市,鳳山區,新武里,1389,1180,502,183,685,47,732
公投第８案,高雄市,鳳山區,新武里,1390,1106,399,149,548,32,580
公投第８案,高雄市,鳳山區,新泰里,1391,1442,632,210,842,73,915
公投第８案,高雄市,鳳山區,新泰里,1392,1376,608,187,795,59,854
公投第８案,高雄市,鳳山區,新泰里,1393,1243,535,159,694,30,724
公投第８案,高雄市,鳳山區,新樂里,1394,1361,596,150,746,22,768
公投第８案,高雄市,鳳山區,新樂里,1395,1416,593,221,814,67,881
公投第８案,高雄市,鳳山區,新樂里,1396,1536,706,235,941,77,1018
公投第８案,高雄市,鳳山區,新強里,1397,1388,527,172,699,30,729
公投第８案,高雄市,鳳山區,新強里,1398,1241,501,194,695,80,775
公投第８案,高雄市,鳳山區,新強里,1399,1394,601,216,817,58,875
公投第８案,高雄市,鳳山區,新強里,1400,1188,567,176,743,30,773
公投第８案,高雄市,鳳山區,海洋里,1401,1112,459,156,615,44,659
公投第８案,高雄市,鳳山區,海洋里,1402,1198,537,91,628,51,679
公投第８案,高雄市,鳳山區,海洋里,1403,1475,564,245,809,50,859
公投第８案,高雄市,鳳山區,新富里,1404,1216,449,147,596,41,637
公投第８案,高雄市,鳳山區,新富里,1405,1318,435,171,606,42,648
公投第８案,高雄市,鳳山區,新富里,1406,1465,590,196,786,82,868
公投第８案,高雄市,鳳山區,老爺里,1407,1314,468,167,635,41,676
公投第８案,高雄市,鳳山區,老爺里,1408,1649,598,185,783,27,810
公投第８案,高雄市,鳳山區,老爺里,1409,1601,602,180,782,98,880
公投第８案,高雄市,鳳山區,老爺里,1410,1155,452,153,605,26,631
公投第８案,高雄市,鳳山區,老爺里,1411,1050,423,150,573,66,639
公投第８案,高雄市,鳳山區,中民里,1412,1417,538,150,688,22,710
公投第８案,高雄市,鳳山區,中民里,1413,1525,616,200,816,66,882
公投第８案,高雄市,鳳山區,中民里,1414,1514,659,204,863,63,926
公投第８案,高雄市,鳳山區,中崙里,1415,1190,520,132,652,47,699
公投第８案,高雄市,鳳山區,中崙里,1416,1325,530,149,679,26,705
公投第８案,高雄市,鳳山區,中榮里,1417,1049,462,130,592,62,654
公投第８案,高雄市,鳳山區,中榮里,1418,1026,543,19,562,35,597
公投第８案,高雄市,鳳山區,中榮里,1419,1152,488,171,659,61,720
公投第８案,高雄市,鳳山區,中榮里,1420,1254,482,138,620,22,642
公投第８案,高雄市,鳳山區,過埤里,1421,1688,636,207,843,33,876
公投第８案,高雄市,鳳山區,過埤里,1422,1657,743,152,895,72,967
公投第８案,高雄市,鳳山區,過埤里,1423,1729,656,208,864,43,907
公投第８案,高雄市,鳳山區,過埤里,1424,1628,711,206,917,63,980
公投第８案,高雄市,鳳山區,過埤里,1425,1891,694,202,896,24,920
公投第８案,高雄市,鳳山區,過埤里,1426,1594,746,200,946,102,1048
公投第８案,高雄市,鳳山區,過埤里,1427,1342,645,169,814,22,836
公投第８案,高雄市,鳳山區,過埤里,1428,1448,689,213,902,45,947
公投第８案,高雄市,鳳山區,正義里,1429,1405,601,190,791,77,868
公投第８案,高雄市,鳳山區,正義里,1430,1097,456,171,627,86,713
公投第８案,高雄市,鳳山區,正義里,1431,1248,509,211,720,97,817
公投第８案,高雄市,鳳山區,正義里,1432,1225,481,199,680,81,761
公投第８案,高雄市,鳳山區,正義里,1433,1214,461,170,631,36,667
公投第８案,高雄市,鳳山區,保安里,1434,2032,890,275,1165,100,1265
公投第８案,高雄市,鳳山區,保安里,1435,1927,802,241,1043,85,1128
公投第８案,高雄市,鳳山區,保安里,1436,2097,946,272,1218,86,1304
公投第８案,高雄市,鳳山區,一甲里,1437,968,353,157,510,56,566
公投第８案,高雄市,鳳山區,一甲里,1438,1200,548,59,607,70,677
公投第８案,高雄市,鳳山區,一甲里,1439,1101,420,164,584,86,670
公投第８案,高雄市,鳳山區,二甲里,1440,1369,602,86,688,48,736
公投第８案,高雄市,鳳山區,二甲里,1441,1542,630,198,828,74,902
公投第８案,高雄市,鳳山區,二甲里,1442,1536,632,219,851,65,916
公投第８案,高雄市,鳳山區,龍成里,1443,1382,488,190,678,39,717
公投第８案,高雄市,鳳山區,龍成里,1444,1452,570,206,776,102,878
公投第８案,高雄市,鳳山區,鎮南里,1445,1058,437,133,570,64,634
公投第８案,高雄市,鳳山區,鎮南里,1446,976,434,145,579,58,637
公投第８案,高雄市,鳳山區,鎮南里,1447,1545,571,170,741,53,794
公投第８案,高雄市,鳳山區,鎮南里,1448,1143,444,173,617,56,673
公投第８案,高雄市,鳳山區,富甲里,1449,1301,246,75,321,18,339
公投第８案,高雄市,鳳山區,富甲里,1450,1250,409,137,546,38,584
公投第８案,高雄市,鳳山區,善美里,1451,1208,505,141,646,61,707
公投第８案,高雄市,鳳山區,善美里,1452,1202,491,150,641,98,739
公投第８案,高雄市,鳳山區,善美里,1453,1499,592,174,766,94,860
公投第８案,高雄市,鳳山區,善美里,1454,1522,600,197,797,55,852
公投第８案,高雄市,鳳山區,富榮里,1455,1125,489,162,651,67,718
公投第８案,高雄市,鳳山區,富榮里,1456,1307,552,173,725,37,762
公投第８案,高雄市,鳳山區,南和里,1457,1405,548,205,753,75,828
公投第８案,高雄市,鳳山區,南和里,1458,1252,506,177,683,75,758
公投第８案,高雄市,鳳山區,南成里,1459,1291,585,166,751,37,788
公投第８案,高雄市,鳳山區,南成里,1460,938,387,137,524,70,594
公投第８案,高雄市,鳳山區,南成里,1461,1783,732,252,984,52,1036
公投第８案,高雄市,鳳山區,南成里,1462,1105,484,141,625,42,667
公投第８案,高雄市,鳳山區,南成里,1463,1392,528,186,714,92,806
公投第８案,高雄市,鳳山區,南成里,1464,1244,570,202,772,57,829
公投第８案,高雄市,鳳山區,天興里,1465,1154,434,154,588,57,645
公投第８案,高雄市,鳳山區,天興里,1466,1153,470,167,637,58,695
公投第８案,高雄市,鳳山區,天興里,1467,1148,394,139,533,22,555
公投第８案,高雄市,鳳山區,大德里,1468,1432,528,177,705,121,826
公投第８案,高雄市,鳳山區,大德里,1469,1429,392,162,554,28,582
公投第８案,高雄市,鳳山區,大德里,1470,1479,590,188,778,29,807
公投第８案,高雄市,鳳山區,五福里,1471,1026,425,155,580,57,637
公投第８案,高雄市,鳳山區,五福里,1472,993,397,181,578,99,677
公投第８案,高雄市,鳳山區,五福里,1473,947,415,131,546,71,617
公投第８案,高雄市,鳳山區,福興里,1474,1042,411,124,535,65,600
公投第８案,高雄市,鳳山區,福興里,1475,1098,443,154,597,67,664
公投第８案,高雄市,鳳山區,福興里,1476,1284,464,160,624,26,650
公投第８案,高雄市,鳳山區,福興里,1477,1242,453,156,609,49,658
公投第８案,高雄市,鳳山區,福興里,1478,1093,456,147,603,89,692
公投第８案,高雄市,鳳山區,福祥里,1479,1353,497,204,701,50,751
公投第８案,高雄市,鳳山區,福祥里,1480,1353,509,159,668,28,696
公投第８案,高雄市,鳳山區,福誠里,1481,1309,552,172,724,76,800
公投第８案,高雄市,鳳山區,福誠里,1482,1627,658,216,874,66,940
公投第８案,高雄市,鳳山區,福誠里,1483,1372,556,178,734,100,834
公投第８案,高雄市,前鎮區,草衙里,1484,1809,626,232,858,143,1001
公投第８案,高雄市,前鎮區,草衙里,1485,1835,652,253,905,94,999
公投第８案,高雄市,前鎮區,草衙里,1486,1890,576,166,742,86,828
公投第８案,高雄市,前鎮區,草衙里,1487,2013,662,239,901,71,972
公投第８案,高雄市,前鎮區,草衙里,1488,1776,638,227,865,84,949
公投第８案,高雄市,前鎮區,明孝里,1489,1705,531,197,728,100,828
公投第８案,高雄市,前鎮區,明孝里,1490,672,249,92,341,81,422
公投第８案,高雄市,前鎮區,明正里,1491,1726,553,190,743,105,848
公投第８案,高雄市,前鎮區,明正里,1492,1597,607,224,831,48,879
公投第８案,高雄市,前鎮區,明正里,1493,1690,651,260,911,90,1001
公投第８案,高雄市,前鎮區,明義里,1494,1080,468,142,610,76,686
公投第８案,高雄市,前鎮區,明義里,1495,1159,498,183,681,84,765
公投第８案,高雄市,前鎮區,仁愛里,1496,1314,477,157,634,79,713
公投第８案,高雄市,前鎮區,德昌里,1497,896,387,103,490,68,558
公投第８案,高雄市,前鎮區,德昌里,1498,1002,392,151,543,50,593
公投第８案,高雄市,前鎮區,平等里,1499,2765,678,279,957,110,1067
公投第８案,高雄市,前鎮區,平昌里,1500,600,235,70,305,71,376
公投第８案,高雄市,前鎮區,明禮里,1501,1466,349,122,471,50,521
公投第８案,高雄市,前鎮區,信義里,1502,1449,527,176,703,57,760
公投第８案,高雄市,前鎮區,信德里,1503,991,362,121,483,62,545
公投第８案,高雄市,前鎮區,信德里,1504,1248,505,160,665,88,753
公投第８案,高雄市,前鎮區,明道里,1505,1066,432,140,572,108,680
公投第８案,高雄市,前鎮區,興化里,1506,706,253,42,295,37,332
公投第８案,高雄市,前鎮區,興仁里,1507,713,231,94,325,43,368
公投第８案,高雄市,前鎮區,前鎮里,1508,1344,436,192,628,51,679
公投第８案,高雄市,前鎮區,鎮東里,1509,856,343,115,458,59,517
公投第８案,高雄市,前鎮區,鎮東里,1510,873,269,128,397,45,442
公投第８案,高雄市,前鎮區,鎮榮里,1511,1114,379,135,514,53,567
公投第８案,高雄市,前鎮區,鎮榮里,1512,1112,355,130,485,19,504
公投第８案,高雄市,前鎮區,鎮昌里,1513,1044,390,132,522,63,585
公投第８案,高雄市,前鎮區,鎮昌里,1514,940,322,142,464,50,514
公投第８案,高雄市,前鎮區,鎮海里,1515,1342,482,137,619,83,702
公投第８案,高雄市,前鎮區,鎮海里,1516,1402,624,224,848,68,916
公投第８案,高雄市,前鎮區,鎮海里,1517,1320,578,185,763,34,797
公投第８案,高雄市,前鎮區,鎮陽里,1518,958,361,147,508,64,572
公投第８案,高雄市,前鎮區,興邦里,1519,1276,630,188,818,49,867
公投第８案,高雄市,前鎮區,興邦里,1520,1459,644,168,812,98,910
公投第８案,高雄市,前鎮區,鎮中里,1521,761,226,108,334,27,361
公投第８案,高雄市,前鎮區,鎮北里,1522,1093,380,152,532,29,561
公投第８案,高雄市,前鎮區,忠純里,1523,1521,776,134,910,51,961
公投第８案,高雄市,前鎮區,忠純里,1524,1557,761,155,916,43,959
公投第８案,高雄市,前鎮區,忠純里,1525,1821,736,176,912,36,948
公投第８案,高雄市,前鎮區,忠誠里,1526,1066,584,107,691,46,737
公投第８案,高雄市,前鎮區,忠誠里,1527,1046,565,99,664,17,681
公投第８案,高雄市,前鎮區,西山里,1528,1709,647,279,926,65,991
公投第８案,高雄市,前鎮區,西山里,1529,1723,733,243,976,90,1066
公投第８案,高雄市,前鎮區,民權里,1530,1202,531,202,733,54,787
公投第８案,高雄市,前鎮區,民權里,1531,1279,559,225,784,53,837
公投第８案,高雄市,前鎮區,民權里,1532,1513,730,193,923,59,982
公投第８案,高雄市,前鎮區,建隆里,1533,1260,538,146,684,25,709
公投第８案,高雄市,前鎮區,振興里,1534,1139,496,167,663,85,748
公投第８案,高雄市,前鎮區,振興里,1535,1140,528,178,706,54,760
公投第８案,高雄市,前鎮區,良和里,1536,1462,594,229,823,92,915
公投第８案,高雄市,前鎮區,良和里,1537,1359,603,196,799,44,843
公投第８案,高雄市,前鎮區,西甲里,1538,2037,662,292,954,100,1054
公投第８案,高雄市,前鎮區,盛興里,1539,1410,562,167,729,32,761
公投第８案,高雄市,前鎮區,盛興里,1540,1307,491,209,700,28,728
公投第８案,高雄市,前鎮區,盛豐里,1541,1512,556,230,786,96,882
公投第８案,高雄市,前鎮區,盛豐里,1542,1491,582,246,828,88,916
公投第８案,高雄市,前鎮區,興中里,1543,1621,643,211,854,96,950
公投第８案,高雄市,前鎮區,興中里,1544,1522,550,182,732,75,807
公投第８案,高雄市,前鎮區,興東里,1545,1593,631,244,875,72,947
公投第８案,高雄市,前鎮區,興東里,1546,1885,769,260,1029,97,1126
公投第８案,高雄市,前鎮區,興東里,1547,1870,787,278,1065,100,1165
公投第８案,高雄市,前鎮區,忠孝里,1548,1388,560,212,772,35,807
公投第８案,高雄市,前鎮區,忠孝里,1549,1348,566,165,731,80,811
公投第８案,高雄市,前鎮區,復國里,1550,1341,495,159,654,120,774
公投第８案,高雄市,前鎮區,復國里,1551,1364,594,219,813,46,859
公投第８案,高雄市,前鎮區,竹內里,1552,1367,548,200,748,81,829
公投第８案,高雄市,前鎮區,竹內里,1553,1326,485,207,692,88,780
公投第８案,高雄市,前鎮區,竹東里,1554,1059,422,120,542,49,591
公投第８案,高雄市,前鎮區,竹東里,1555,1119,497,142,639,25,664
公投第８案,高雄市,前鎮區,竹南里,1556,1565,561,220,781,39,820
公投第８案,高雄市,前鎮區,竹南里,1557,1549,600,234,834,71,905
公投第８案,高雄市,前鎮區,竹南里,1558,1691,816,224,1040,54,1094
公投第８案,高雄市,前鎮區,竹南里,1559,1837,884,174,1058,41,1099
公投第８案,高雄市,前鎮區,竹北里,1560,1092,484,157,641,29,670
公投第８案,高雄市,前鎮區,竹北里,1561,1126,485,157,642,64,706
公投第８案,高雄市,前鎮區,竹西里,1562,1215,450,172,622,84,706
公投第８案,高雄市,前鎮區,竹西里,1563,1443,599,213,812,41,853
公投第８案,高雄市,前鎮區,竹西里,1564,1448,690,231,921,38,959
公投第８案,高雄市,前鎮區,竹中里,1565,1648,700,208,908,92,1000
公投第８案,高雄市,前鎮區,竹中里,1566,1603,566,202,768,102,870
公投第８案,高雄市,前鎮區,瑞竹里,1567,1596,584,169,753,26,779
公投第８案,高雄市,前鎮區,瑞南里,1568,1450,527,133,660,48,708
公投第８案,高雄市,前鎮區,瑞南里,1569,1510,564,182,746,92,838
公投第８案,高雄市,前鎮區,瑞南里,1570,1647,687,243,930,104,1034
公投第８案,高雄市,前鎮區,瑞豐里,1571,1342,536,160,696,76,772
公投第８案,高雄市,前鎮區,瑞豐里,1572,1384,537,140,677,57,734
公投第８案,高雄市,前鎮區,瑞祥里,1573,1479,571,155,726,88,814
公投第８案,高雄市,前鎮區,瑞祥里,1574,1546,630,200,830,45,875
公投第８案,高雄市,前鎮區,瑞祥里,1575,1595,683,221,904,74,978
公投第８案,高雄市,前鎮區,瑞東里,1576,1201,513,158,671,74,745
公投第８案,高雄市,前鎮區,瑞東里,1577,1082,408,141,549,25,574
公投第８案,高雄市,前鎮區,瑞和里,1578,996,369,119,488,50,538
公投第８案,高雄市,前鎮區,瑞和里,1579,932,349,138,487,89,576
公投第８案,高雄市,前鎮區,瑞平里,1580,1146,450,189,639,57,696
公投第８案,高雄市,前鎮區,瑞平里,1581,1096,464,148,612,35,647
公投第８案,高雄市,前鎮區,瑞平里,1582,1332,628,165,793,20,813
公投第８案,高雄市,前鎮區,瑞隆里,1583,1175,469,159,628,42,670
公投第８案,高雄市,前鎮區,瑞隆里,1584,986,401,128,529,70,599
公投第８案,高雄市,前鎮區,瑞隆里,1585,1316,558,184,742,81,823
公投第８案,高雄市,前鎮區,瑞北里,1586,1559,546,188,734,78,812
公投第８案,高雄市,前鎮區,瑞北里,1587,1622,682,217,899,88,987
公投第８案,高雄市,前鎮區,瑞西里,1588,1310,497,176,673,40,713
公投第８案,高雄市,前鎮區,瑞西里,1589,1299,483,209,692,109,801
公投第８案,高雄市,前鎮區,瑞崗里,1590,1191,545,182,727,74,801
公投第８案,高雄市,前鎮區,瑞崗里,1591,1375,528,142,670,30,700
公投第８案,高雄市,前鎮區,瑞興里,1592,1338,540,190,730,29,759
公投第８案,高雄市,前鎮區,瑞興里,1593,1175,441,162,603,29,632
公投第８案,高雄市,前鎮區,瑞誠里,1594,1357,528,178,706,33,739
公投第８案,高雄市,前鎮區,瑞誠里,1595,1187,487,211,698,69,767
公投第８案,高雄市,前鎮區,瑞文里,1596,1164,438,171,609,49,658
公投第８案,高雄市,前鎮區,瑞文里,1597,1219,513,180,693,70,763
公投第８案,高雄市,前鎮區,瑞華里,1598,1428,512,206,718,30,748
公投第８案,高雄市,前鎮區,瑞華里,1599,1495,548,218,766,114,880
公投第８案,高雄市,前鎮區,瑞華里,1600,1531,706,161,867,36,903
公投第８案,高雄市,前鎮區,瑞昌里,1601,1509,516,276,792,105,897
公投第８案,高雄市,前鎮區,瑞昌里,1602,1591,610,210,820,78,898
公投第８案,高雄市,小港區,小港里,1603,1108,477,168,645,46,691
公投第８案,高雄市,小港區,小港里,1604,1171,498,165,663,70,733
公投第８案,高雄市,小港區,港口里,1605,1557,671,266,937,25,962
公投第８案,高雄市,小港區,港口里,1606,1668,651,182,833,26,859
公投第８案,高雄市,小港區,港正里,1607,1183,546,139,685,33,718
公投第８案,高雄市,小港區,港正里,1608,1372,560,172,732,31,763
公投第８案,高雄市,小港區,港墘里,1609,1737,713,270,983,64,1047
公投第８案,高雄市,小港區,港明里,1610,1586,601,248,849,104,953
公投第８案,高雄市,小港區,港明里,1611,1558,574,177,751,80,831
公投第８案,高雄市,小港區,港后里,1612,1284,583,216,799,78,877
公投第８案,高雄市,小港區,港后里,1613,1249,544,164,708,69,777
公投第８案,高雄市,小港區,港南里,1614,2400,732,272,1004,121,1125
公投第８案,高雄市,小港區,港興里,1615,1181,470,189,659,50,709
公投第８案,高雄市,小港區,港興里,1616,1079,424,147,571,35,606
公投第８案,高雄市,小港區,鳳宮里,1617,1335,547,195,742,44,786
公投第８案,高雄市,小港區,鳳宮里,1618,1241,548,152,700,66,766
公投第８案,高雄市,小港區,店鎮里,1619,1513,581,221,802,67,869
公投第８案,高雄市,小港區,店鎮里,1620,1349,590,171,761,70,831
公投第８案,高雄市,小港區,店鎮里,1621,1483,562,208,770,53,823
公投第８案,高雄市,小港區,店鎮里,1622,1451,614,189,803,31,834
公投第８案,高雄市,小港區,大苓里,1623,1241,479,150,629,27,656
公投第８案,高雄市,小港區,大苓里,1624,1262,544,217,761,81,842
公投第８案,高雄市,小港區,二苓里,1625,1813,752,245,997,104,1101
公投第８案,高雄市,小港區,二苓里,1626,1877,654,211,865,41,906
公投第８案,高雄市,小港區,三苓里,1627,1391,567,177,744,32,776
公投第８案,高雄市,小港區,三苓里,1628,1453,622,200,822,34,856
公投第８案,高雄市,小港區,正苓里,1629,1374,551,215,766,48,814
公投第８案,高雄市,小港區,正苓里,1630,1348,538,187,725,65,790
公投第８案,高雄市,小港區,正苓里,1631,1334,599,171,770,65,835
公投第８案,高雄市,小港區,順苓里,1632,1433,547,212,759,36,795
公投第８案,高雄市,小港區,順苓里,1633,1448,515,189,704,21,725
公投第８案,高雄市,小港區,順苓里,1634,1488,836,43,879,80,959
公投第８案,高雄市,小港區,六苓里,1635,1278,549,169,718,64,782
公投第８案,高雄市,小港區,六苓里,1636,1306,616,209,825,58,883
公投第８案,高雄市,小港區,宏亮里,1637,1625,672,211,883,92,975
公投第８案,高雄市,小港區,宏亮里,1638,1640,697,245,942,100,1042
公投第８案,高雄市,小港區,山東里,1639,1506,617,192,809,64,873
公投第８案,高雄市,小港區,山東里,1640,1438,555,173,728,66,794
公投第８案,高雄市,小港區,青島里,1641,1105,560,151,711,42,753
公投第８案,高雄市,小港區,青島里,1642,1167,490,135,625,20,645
公投第８案,高雄市,小港區,濟南里,1643,1420,640,173,813,34,847
公投第８案,高雄市,小港區,濟南里,1644,1380,639,197,836,65,901
公投第８案,高雄市,小港區,濟南里,1645,1239,550,120,670,33,703
公投第８案,高雄市,小港區,泰山里,1646,1563,713,188,901,59,960
公投第８案,高雄市,小港區,泰山里,1647,1644,689,202,891,85,976
公投第８案,高雄市,小港區,山明里,1648,1895,875,126,1001,83,1084
公投第８案,高雄市,小港區,山明里,1649,1748,674,218,892,99,991
公投第８案,高雄市,小港區,山明里,1650,1579,613,262,875,100,975
公投第８案,高雄市,小港區,山明里,1651,2135,801,264,1065,53,1118
公投第８案,高雄市,小港區,山明里,1652,1728,689,236,925,81,1006
公投第８案,高雄市,小港區,山明里,1653,2022,753,247,1000,54,1054
公投第８案,高雄市,小港區,高松里,1654,1329,464,131,595,22,617
公投第８案,高雄市,小港區,高松里,1655,1320,510,176,686,43,729
公投第８案,高雄市,小港區,高松里,1656,1267,497,190,687,88,775
公投第８案,高雄市,小港區,松金里,1657,1298,554,185,739,85,824
公投第８案,高雄市,小港區,松金里,1658,1289,566,179,745,36,781
公投第８案,高雄市,小港區,松山里,1659,1534,635,218,853,48,901
公投第８案,高雄市,小港區,松山里,1660,1494,622,209,831,48,879
公投第８案,高雄市,小港區,大坪里,1661,1377,556,184,740,82,822
公投第８案,高雄市,小港區,大坪里,1662,1344,622,158,780,80,860
公投第８案,高雄市,小港區,坪頂里,1663,1508,637,200,837,67,904
公投第８案,高雄市,小港區,坪頂里,1664,1400,403,313,716,35,751
公投第８案,高雄市,小港區,坪頂里,1665,1457,642,192,834,63,897
公投第８案,高雄市,小港區,坪頂里,1666,1392,560,178,738,36,774
公投第８案,高雄市,小港區,孔宅里,1667,1983,770,241,1011,74,1085
公投第８案,高雄市,小港區,孔宅里,1668,1204,503,117,620,33,653
公投第８案,高雄市,小港區,孔宅里,1669,1300,500,212,712,52,764
公投第８案,高雄市,小港區,廈莊里,1670,1857,762,300,1062,95,1157
公投第８案,高雄市,小港區,廈莊里,1671,1566,654,187,841,40,881
公投第８案,高雄市,小港區,合作里,1672,1343,601,193,794,84,878
公投第８案,高雄市,小港區,合作里,1673,1236,588,187,775,91,866
公投第８案,高雄市,小港區,桂林里,1674,1564,674,213,887,96,983
公投第８案,高雄市,小港區,桂林里,1675,1484,589,212,801,17,818
公投第８案,高雄市,小港區,桂林里,1676,1477,584,203,787,41,828
公投第８案,高雄市,小港區,桂林里,1677,1482,658,215,873,41,914
公投第８案,高雄市,小港區,桂林里,1678,1708,642,215,857,39,896
公投第８案,高雄市,小港區,中厝里,1679,1867,698,298,996,73,1069
公投第８案,高雄市,小港區,中厝里,1680,1709,615,191,806,24,830
公投第８案,高雄市,小港區,鳳鳴里,1681,1425,523,187,710,71,781
公投第８案,高雄市,小港區,鳳鳴里,1682,1696,568,176,744,57,801
公投第８案,高雄市,小港區,龍鳳里,1683,1522,603,67,670,48,718
公投第８案,高雄市,小港區,龍鳳里,1684,1531,615,192,807,97,904
公投第８案,高雄市,小港區,鳳森里,1685,2215,703,349,1052,147,1199
公投第８案,高雄市,小港區,鳳林里,1686,1515,558,196,754,38,792
公投第８案,高雄市,小港區,鳳林里,1687,1535,488,203,691,38,729
公投第８案,高雄市,小港區,鳳興里,1688,1276,479,177,656,35,691
公投第８案,高雄市,小港區,鳳興里,1689,1217,406,144,550,39,589
公投第８案,高雄市,小港區,鳳源里,1690,1707,562,193,755,88,843
公投第８案,高雄市,小港區,鳳源里,1691,1920,638,262,900,125,1025
公投第８案,高雄市,大寮區,拷潭里,1692,727,234,81,315,35,350
公投第８案,高雄市,大寮區,拷潭里,1693,718,230,86,316,17,333
公投第８案,高雄市,大寮區,內坑里,1694,1340,476,143,619,45,664
公投第８案,高雄市,大寮區,內坑里,1695,1575,415,275,690,49,739
公投第８案,高雄市,大寮區,內坑里,1696,444,172,58,230,32,262
公投第８案,高雄市,大寮區,內坑里,1697,2374,798,208,1006,50,1056
公投第８案,高雄市,大寮區,大寮里,1698,1291,500,141,641,82,723
公投第８案,高雄市,大寮區,大寮里,1699,1400,535,194,729,80,809
公投第８案,高雄市,大寮區,大寮里,1700,1390,534,168,702,34,736
公投第８案,高雄市,大寮區,大寮里,1701,1401,491,208,699,82,781
公投第８案,高雄市,大寮區,大寮里,1702,1199,436,144,580,31,611
公投第８案,高雄市,大寮區,上寮里,1703,1210,404,146,550,25,575
公投第８案,高雄市,大寮區,上寮里,1704,1195,458,156,614,51,665
公投第８案,高雄市,大寮區,三隆里,1705,1166,416,137,553,28,581
公投第８案,高雄市,大寮區,三隆里,1706,1353,530,168,698,42,740
公投第８案,高雄市,大寮區,三隆里,1707,1052,423,139,562,80,642
公投第８案,高雄市,大寮區,三隆里,1708,1024,308,116,424,31,455
公投第８案,高雄市,大寮區,琉球里,1709,1189,450,174,624,33,657
公投第８案,高雄市,大寮區,琉球里,1710,1512,629,198,827,92,919
公投第８案,高雄市,大寮區,琉球里,1711,1633,591,200,791,82,873
公投第８案,高雄市,大寮區,翁園里,1712,1214,495,166,661,55,716
公投第８案,高雄市,大寮區,翁園里,1713,1258,528,189,717,85,802
公投第８案,高雄市,大寮區,翁園里,1714,1323,495,221,716,32,748
公投第８案,高雄市,大寮區,前庄里,1715,1253,565,141,706,50,756
公投第８案,高雄市,大寮區,前庄里,1716,1035,461,122,583,71,654
公投第８案,高雄市,大寮區,中庄里,1717,1106,432,140,572,31,603
公投第８案,高雄市,大寮區,中庄里,1718,1195,481,158,639,45,684
公投第８案,高雄市,大寮區,中庄里,1719,1051,430,135,565,26,591
公投第８案,高雄市,大寮區,中庄里,1720,1425,584,180,764,87,851
公投第８案,高雄市,大寮區,中庄里,1721,1635,633,217,850,60,910
公投第８案,高雄市,大寮區,中庄里,1722,1359,552,185,737,68,805
公投第８案,高雄市,大寮區,中庄里,1723,1361,587,156,743,62,805
公投第８案,高雄市,大寮區,中庄里,1724,1629,674,197,871,43,914
公投第８案,高雄市,大寮區,後庄里,1725,1518,644,174,818,61,879
公投第８案,高雄市,大寮區,後庄里,1726,1620,624,193,817,73,890
公投第８案,高雄市,大寮區,後庄里,1727,1648,645,189,834,30,864
公投第８案,高雄市,大寮區,後庄里,1728,1385,567,155,722,50,772
公投第８案,高雄市,大寮區,後庄里,1729,1435,555,164,719,32,751
公投第８案,高雄市,大寮區,義仁里,1730,1046,412,121,533,29,562
公投第８案,高雄市,大寮區,義仁里,1731,789,263,117,380,37,417
公投第８案,高雄市,大寮區,新厝里,1732,909,341,117,458,35,493
公投第８案,高雄市,大寮區,新厝里,1733,733,270,117,387,46,433
公投第８案,高雄市,大寮區,過溪里,1734,1553,532,222,754,84,838
公投第８案,高雄市,大寮區,過溪里,1735,922,432,39,471,28,499
公投第８案,高雄市,大寮區,潮寮里,1736,1012,373,136,509,77,586
公投第８案,高雄市,大寮區,潮寮里,1737,968,333,128,461,71,532
公投第８案,高雄市,大寮區,潮寮里,1738,1021,376,122,498,44,542
公投第８案,高雄市,大寮區,會結里,1739,1554,509,154,663,85,748
公投第８案,高雄市,大寮區,會社里,1740,1120,452,166,618,68,686
公投第８案,高雄市,大寮區,會社里,1741,1225,561,146,707,60,767
公投第８案,高雄市,大寮區,會社里,1742,1320,383,103,486,25,511
公投第８案,高雄市,大寮區,會社里,1743,1317,528,163,691,51,742
公投第８案,高雄市,大寮區,會社里,1744,1119,441,131,572,25,597
公投第８案,高雄市,大寮區,山頂里,1745,1190,510,157,667,55,722
公投第８案,高雄市,大寮區,山頂里,1746,1229,534,164,698,57,755
公投第８案,高雄市,大寮區,山頂里,1747,1178,549,148,697,56,753
公投第８案,高雄市,大寮區,山頂里,1748,1272,575,183,758,35,793
公投第８案,高雄市,大寮區,山頂里,1749,1413,573,164,737,31,768
公投第８案,高雄市,大寮區,山頂里,1750,1185,527,153,680,59,739
公投第８案,高雄市,大寮區,忠義里,1751,553,242,53,295,6,301
公投第８案,高雄市,大寮區,永芳里,1752,1121,402,149,551,78,629
公投第８案,高雄市,大寮區,永芳里,1753,1227,481,174,655,29,684
公投第８案,高雄市,大寮區,永芳里,1754,1058,485,158,643,74,717
公投第８案,高雄市,大寮區,永芳里,1755,1209,492,167,659,36,695
公投第８案,高雄市,大寮區,永芳里,1756,1100,474,135,609,20,629
公投第８案,高雄市,大寮區,永芳里,1757,1122,430,129,559,30,589
公投第８案,高雄市,大寮區,義和里,1758,983,407,157,564,81,645
公投第８案,高雄市,大寮區,義和里,1759,1192,430,142,572,31,603
公投第８案,高雄市,大寮區,溪寮里,1760,719,258,97,355,32,387
公投第８案,高雄市,大寮區,溪寮里,1761,829,350,98,448,40,488
公投第８案,高雄市,大寮區,江山里,1762,771,339,115,454,79,533
公投第８案,高雄市,大寮區,江山里,1763,1075,406,183,589,90,679
公投第８案,高雄市,大寮區,昭明里,1764,1280,519,176,695,92,787
公投第８案,高雄市,大寮區,昭明里,1765,1179,445,157,602,89,691
公投第８案,高雄市,大寮區,昭明里,1766,1210,441,158,599,29,628
公投第８案,高雄市,大寮區,光武里,1767,189,94,15,109,7,116
公投第８案,高雄市,大寮區,中興里,1768,1228,525,155,680,71,751
公投第８案,高雄市,大寮區,中興里,1769,1170,511,119,630,42,672
公投第８案,高雄市,大寮區,中興里,1770,1416,663,153,816,57,873
公投第８案,高雄市,大寮區,中興里,1771,1482,690,173,863,2,865
公投第８案,高雄市,大寮區,中興里,1772,1478,612,140,752,67,819
公投第８案,高雄市,林園區,東林里,1773,1262,427,243,670,88,758
公投第８案,高雄市,林園區,東林里,1774,1562,549,192,741,79,820
公投第８案,高雄市,林園區,林園里,1775,1078,428,129,557,36,593
公投第８案,高雄市,林園區,林園里,1776,979,402,162,564,64,628
公投第８案,高雄市,林園區,林園里,1777,1195,463,145,608,65,673
公投第８案,高雄市,林園區,溪州里,1778,1380,508,175,683,70,753
公投第８案,高雄市,林園區,溪州里,1779,1280,482,158,640,84,724
公投第８案,高雄市,林園區,溪州里,1780,1269,454,156,610,29,639
公投第８案,高雄市,林園區,潭頭里,1781,1568,470,164,634,28,662
公投第８案,高雄市,林園區,潭頭里,1782,1226,505,158,663,62,725
公投第８案,高雄市,林園區,中厝里,1783,1480,583,159,742,64,806
公投第８案,高雄市,林園區,中厝里,1784,1459,614,178,792,63,855
公投第８案,高雄市,林園區,中門里,1785,1593,592,163,755,57,812
公投第８案,高雄市,林園區,中門里,1786,895,330,114,444,89,533
公投第８案,高雄市,林園區,頂厝里,1787,1110,394,149,543,40,583
公投第８案,高雄市,林園區,頂厝里,1788,1348,478,171,649,72,721
公投第８案,高雄市,林園區,頂厝里,1789,912,356,130,486,63,549
公投第８案,高雄市,林園區,頂厝里,1790,1085,467,160,627,74,701
公投第８案,高雄市,林園區,港埔里,1791,955,363,107,470,30,500
公投第８案,高雄市,林園區,港埔里,1792,879,373,118,491,53,544
公投第８案,高雄市,林園區,西溪里,1793,1103,437,129,566,73,639
公投第８案,高雄市,林園區,西溪里,1794,1054,459,140,599,84,683
公投第８案,高雄市,林園區,西溪里,1795,1292,417,149,566,24,590
公投第８案,高雄市,林園區,港嘴里,1796,1683,554,165,719,28,747
公投第８案,高雄市,林園區,北汕里,1797,607,246,61,307,38,345
公投第８案,高雄市,林園區,北汕里,1798,1012,391,124,515,77,592
公投第８案,高雄市,林園區,林內里,1799,1046,432,134,566,50,616
公投第８案,高雄市,林園區,林內里,1800,914,311,87,398,17,415
公投第８案,高雄市,林園區,王公里,1801,1405,567,189,756,78,834
公投第８案,高雄市,林園區,王公里,1802,1299,533,189,722,20,742
公投第８案,高雄市,林園區,王公里,1803,1170,39,184,223,39,262
公投第８案,高雄市,林園區,林家里,1804,1299,398,155,553,40,593
公投第８案,高雄市,林園區,龔厝里,1805,1031,403,144,547,39,586
公投第８案,高雄市,林園區,龔厝里,1806,849,153,108,261,24,285
公投第８案,高雄市,林園區,鳳芸里,1807,838,260,125,385,69,454
公投第８案,高雄市,林園區,鳳芸里,1808,938,381,110,491,30,521
公投第８案,高雄市,林園區,中芸里,1809,1051,411,94,505,41,546
公投第８案,高雄市,林園區,中芸里,1810,786,314,110,424,54,478
公投第８案,高雄市,林園區,東汕里,1811,894,367,110,477,79,556
公投第８案,高雄市,林園區,西汕里,1812,749,199,57,256,21,277
公投第８案,高雄市,林園區,仁愛里,1813,1485,630,195,825,40,865
公投第８案,高雄市,林園區,仁愛里,1814,1478,557,218,775,100,875
公投第８案,高雄市,林園區,文賢里,1815,1345,587,188,775,76,851
公投第８案,高雄市,林園區,文賢里,1816,1038,362,152,514,60,574
公投第８案,高雄市,林園區,廣應里,1817,1203,486,172,658,36,694
公投第８案,高雄市,林園區,廣應里,1818,1138,444,58,502,22,524
公投第８案,高雄市,林園區,廣應里,1819,1025,368,108,476,23,499
公投第８案,高雄市,林園區,五福里,1820,1341,545,158,703,85,788
公投第８案,高雄市,林園區,五福里,1821,1218,389,131,520,24,544
公投第８案,高雄市,林園區,中汕里,1822,1147,340,107,447,25,472
公投第８案,高雄市,林園區,中汕里,1823,1176,344,127,471,21,492
公投第８案,新北市,石門區,德茂里,1,1121,376,151,527,52,579
公投第８案,新北市,石門區,富基里,2,1389,440,152,592,78,670
公投第８案,新北市,石門區,老梅里,3,933,330,101,431,61,492
公投第８案,新北市,石門區,老梅里,4,1244,433,116,549,69,618
公投第８案,新北市,石門區,山溪里,5,883,324,90,414,71,485
公投第８案,新北市,石門區,石門里,6,1564,588,167,755,70,825
公投第８案,新北市,石門區,尖鹿里,7,1500,523,207,730,65,795
公投第８案,新北市,石門區,乾華里,8,328,110,28,138,13,151
公投第８案,新北市,石門區,茂林里,9,651,281,81,362,41,403
公投第８案,新北市,石門區,草里里,10,915,291,77,368,43,411
公投第８案,新北市,三芝區,八賢里,11,312,106,30,136,12,148
公投第８案,新北市,三芝區,埔頭里,12,1421,521,123,644,40,684
公投第８案,新北市,三芝區,埔頭里,13,1557,574,168,742,59,801
公投第８案,新北市,三芝區,埔頭里,14,1828,687,188,875,73,948
公投第８案,新北市,三芝區,古庄里,15,1060,370,120,490,50,540
公投第８案,新北市,三芝區,新庄里,16,819,232,90,322,34,356
公投第８案,新北市,三芝區,埔坪里,17,1701,519,156,675,42,717
公投第８案,新北市,三芝區,埔坪里,18,1740,580,179,759,78,837
公投第８案,新北市,三芝區,埔坪里,19,1451,451,160,611,52,663
公投第８案,新北市,三芝區,埔坪里,20,1248,391,125,516,59,575
公投第８案,新北市,三芝區,茂長里,21,629,231,70,301,20,321
公投第８案,新北市,三芝區,橫山里,22,504,165,50,215,18,233
公投第８案,新北市,三芝區,錫板里,23,698,218,73,291,15,306
公投第８案,新北市,三芝區,後厝里,24,2069,708,182,890,65,955
公投第８案,新北市,三芝區,福德里,25,784,287,89,376,38,414
公投第８案,新北市,三芝區,圓山里,26,522,160,74,234,29,263
公投第８案,新北市,三芝區,店子里,27,587,176,74,250,53,303
公投第８案,新北市,三芝區,興華里,28,1189,366,184,550,51,601
公投第８案,新北市,淡水區,中和里,29,544,169,80,249,39,288
公投第８案,新北市,淡水區,屯山里,30,1044,397,119,516,63,579
公投第８案,新北市,淡水區,賢孝里,31,1462,523,162,685,40,725
公投第８案,新北市,淡水區,興仁里,32,1525,539,192,731,64,795
公投第８案,新北市,淡水區,蕃薯里,33,986,334,96,430,46,476
公投第８案,新北市,淡水區,忠山里,34,806,310,98,408,37,445
公投第８案,新北市,淡水區,義山里,35,1173,426,143,569,88,657
公投第８案,新北市,淡水區,義山里,36,1343,448,125,573,51,624
公投第８案,新北市,淡水區,水源里,37,1153,339,114,453,33,486
公投第８案,新北市,淡水區,水源里,38,874,241,124,365,47,412
公投第８案,新北市,淡水區,忠寮里,39,1063,348,152,500,88,588
公投第８案,新北市,淡水區,樹興里,40,1309,439,138,577,41,618
公投第８案,新北市,淡水區,坪頂里,41,1290,475,162,637,55,692
公投第８案,新北市,淡水區,福德里,42,1675,712,185,897,39,936
公投第８案,新北市,淡水區,福德里,43,1589,642,175,817,57,874
公投第８案,新北市,淡水區,福德里,44,1624,680,190,870,53,923
公投第８案,新北市,淡水區,福德里,45,1241,465,142,607,48,655
公投第８案,新北市,淡水區,竹圍里,46,1317,480,163,643,64,707
公投第８案,新北市,淡水區,竹圍里,47,1225,496,154,650,38,688
公投第８案,新北市,淡水區,竹圍里,48,1426,593,157,750,40,790
公投第８案,新北市,淡水區,竹圍里,49,1610,675,207,882,54,936
公投第８案,新北市,淡水區,民權里,50,1982,780,235,1015,50,1065
公投第８案,新北市,淡水區,民權里,51,1924,627,210,837,58,895
公投第８案,新北市,淡水區,民生里,52,1822,658,204,862,59,921
公投第８案,新北市,淡水區,民生里,53,1232,493,164,657,78,735
公投第８案,新北市,淡水區,民生里,54,1588,646,190,836,69,905
公投第８案,新北市,淡水區,民生里,55,1784,692,150,842,54,896
公投第８案,新北市,淡水區,八勢里,56,1762,611,234,845,79,924
公投第８案,新北市,淡水區,八勢里,57,1546,595,171,766,51,817
公投第８案,新北市,淡水區,八勢里,58,1897,733,228,961,53,1014
公投第８案,新北市,淡水區,竿蓁里,59,1489,587,164,751,45,796
公投第８案,新北市,淡水區,竿蓁里,60,1679,610,195,805,55,860
公投第８案,新北市,淡水區,竿蓁里,61,1693,619,184,803,41,844
公投第８案,新北市,淡水區,竿蓁里,62,1674,585,178,763,25,788
公投第８案,新北市,淡水區,竿蓁里,63,1330,548,148,696,25,721
公投第８案,新北市,淡水區,竿蓁里,64,1467,596,141,737,27,764
公投第８案,新北市,淡水區,崁頂里,65,1837,747,176,923,52,975
公投第８案,新北市,淡水區,崁頂里,66,1924,508,125,633,18,651
公投第８案,新北市,淡水區,崁頂里,67,2340,901,243,1144,34,1178
公投第８案,新北市,淡水區,崁頂里,68,1704,571,159,730,53,783
公投第８案,新北市,淡水區,崁頂里,69,1363,530,141,671,47,718
公投第８案,新北市,淡水區,崁頂里,70,3068,1072,276,1348,51,1399
公投第８案,新北市,淡水區,埤島里,71,1528,565,139,704,41,745
公投第８案,新北市,淡水區,水碓里,72,1600,556,183,739,62,801
公投第８案,新北市,淡水區,水碓里,73,1874,750,221,971,74,1045
公投第８案,新北市,淡水區,水碓里,74,1567,587,166,753,80,833
公投第８案,新北市,淡水區,北新里,75,1245,490,170,660,38,698
公投第８案,新北市,淡水區,北新里,76,1211,441,159,600,32,632
公投第８案,新北市,淡水區,正德里,77,1992,814,233,1047,51,1098
公投第８案,新北市,淡水區,正德里,78,2028,801,215,1016,40,1056
公投第８案,新北市,淡水區,新興里,79,1373,528,171,699,81,780
公投第８案,新北市,淡水區,新興里,80,1732,701,174,875,41,916
公投第８案,新北市,淡水區,新興里,81,1519,533,178,711,52,763
公投第８案,新北市,淡水區,新興里,82,1727,621,167,788,28,816
公投第８案,新北市,淡水區,新義里,83,1297,401,268,669,38,707
公投第８案,新北市,淡水區,新義里,84,1066,397,120,517,52,569
公投第８案,新北市,淡水區,新義里,85,1387,550,159,709,57,766
公投第８案,新北市,淡水區,新春里,86,1909,723,250,973,62,1035
公投第８案,新北市,淡水區,新春里,87,1770,678,207,885,63,948
公投第８案,新北市,淡水區,新春里,88,2049,747,209,956,70,1026
公投第８案,新北市,淡水區,新春里,89,1680,669,202,871,37,908
公投第８案,新北市,淡水區,新民里,90,1433,571,204,775,69,844
公投第８案,新北市,淡水區,新民里,91,1365,518,158,676,42,718
公投第８案,新北市,淡水區,新民里,92,1452,570,176,746,65,811
公投第８案,新北市,淡水區,北投里,93,1804,737,162,899,63,962
公投第８案,新北市,淡水區,北投里,94,1322,497,152,649,47,696
公投第８案,新北市,淡水區,北投里,95,2019,784,207,991,37,1028
公投第８案,新北市,淡水區,北投里,96,1696,737,207,944,45,989
公投第８案,新北市,淡水區,北投里,97,1576,622,212,834,42,876
公投第８案,新北市,淡水區,鄧公里,98,1781,832,125,957,48,1005
公投第８案,新北市,淡水區,鄧公里,99,1665,688,222,910,61,971
公投第８案,新北市,淡水區,鄧公里,100,2013,762,242,1004,72,1076
公投第８案,新北市,淡水區,幸福里,101,1108,396,155,551,43,594
公投第８案,新北市,淡水區,幸福里,102,1305,504,149,653,68,721
公投第８案,新北市,淡水區,幸福里,103,1199,441,168,609,24,633
公投第８案,新北市,淡水區,學府里,104,2017,777,213,990,71,1061
公投第８案,新北市,淡水區,學府里,105,2125,704,246,950,79,1029
公投第８案,新北市,淡水區,中興里,106,1289,402,146,548,37,585
公投第８案,新北市,淡水區,中興里,107,1319,571,159,730,52,782
公投第８案,新北市,淡水區,中興里,108,1051,406,125,531,33,564
公投第８案,新北市,淡水區,長庚里,109,1348,524,147,671,42,713
公投第８案,新北市,淡水區,清文里,110,1106,400,115,515,47,562
公投第８案,新北市,淡水區,草東里,111,717,274,110,384,34,418
公投第８案,新北市,淡水區,協元里,112,1385,494,180,674,41,715
公投第８案,新北市,淡水區,永吉里,113,841,332,125,457,46,503
公投第８案,新北市,淡水區,民安里,114,665,263,81,344,34,378
公投第８案,新北市,淡水區,新生里,115,419,176,52,228,23,251
公投第８案,新北市,淡水區,文化里,116,1599,653,192,845,35,880
公投第８案,新北市,淡水區,油車里,117,1670,628,194,822,55,877
公投第８案,新北市,淡水區,油車里,118,1683,760,131,891,65,956
公投第８案,新北市,淡水區,油車里,119,1577,558,171,729,64,793
公投第８案,新北市,淡水區,沙崙里,120,1618,588,166,754,55,809
公投第８案,新北市,淡水區,沙崙里,121,2214,749,223,972,46,1018
公投第８案,新北市,淡水區,大庄里,122,1832,674,213,887,66,953
公投第８案,新北市,淡水區,大庄里,123,2123,807,228,1035,71,1106
公投第８案,新北市,淡水區,大庄里,124,2998,1050,199,1249,32,1281
公投第８案,新北市,八里區,龍源里,125,1498,511,161,672,70,742
公投第８案,新北市,八里區,龍源里,126,1939,651,188,839,47,886
公投第８案,新北市,八里區,龍源里,127,1516,551,175,726,80,806
公投第８案,新北市,八里區,龍源里,128,1642,640,218,858,71,929
公投第８案,新北市,八里區,米倉里,129,1927,630,202,832,106,938
公投第８案,新北市,八里區,米倉里,130,1276,497,136,633,57,690
公投第８案,新北市,八里區,大崁里,131,1349,552,178,730,55,785
公投第８案,新北市,八里區,大崁里,132,1403,535,176,711,74,785
公投第８案,新北市,八里區,埤頭里,133,1644,616,207,823,64,887
公投第８案,新北市,八里區,埤頭里,134,1853,715,200,915,66,981
公投第８案,新北市,八里區,頂罟里,135,1793,742,195,937,102,1039
公投第８案,新北市,八里區,舊城里,136,1644,598,222,820,63,883
公投第８案,新北市,八里區,舊城里,137,1846,682,206,888,76,964
公投第８案,新北市,八里區,舊城里,138,1346,484,165,649,70,719
公投第８案,新北市,八里區,舊城里,139,1621,603,199,802,69,871
公投第８案,新北市,八里區,訊塘里,140,2110,656,200,856,86,942
公投第８案,新北市,八里區,訊塘里,141,1967,674,234,908,92,1000
公投第８案,新北市,八里區,荖阡里,142,1626,626,204,830,64,894
公投第８案,新北市,八里區,長坑里,143,1514,554,201,755,77,832
公投第８案,新北市,八里區,下罟里,144,1456,464,274,738,96,834
公投第８案,新北市,林口區,東林里,145,1268,420,174,594,84,678
公投第８案,新北市,林口區,東林里,146,1171,391,163,554,53,607
公投第８案,新北市,林口區,東林里,147,1218,470,167,637,62,699
公投第８案,新北市,林口區,林口里,148,1788,671,191,862,56,918
公投第８案,新北市,林口區,林口里,149,1625,562,180,742,84,826
公投第８案,新北市,林口區,林口里,150,1448,516,165,681,72,753
公投第８案,新北市,林口區,西林里,151,1328,461,140,601,84,685
公投第８案,新北市,林口區,西林里,152,1523,496,137,633,73,706
公投第８案,新北市,林口區,西林里,153,1245,506,126,632,51,683
公投第８案,新北市,林口區,西林里,154,1329,636,143,779,47,826
公投第８案,新北市,林口區,西林里,155,1465,633,181,814,42,856
公投第８案,新北市,林口區,西林里,156,1369,583,188,771,34,805
公投第８案,新北市,林口區,菁湖里,157,1346,509,220,729,57,786
公投第８案,新北市,林口區,菁湖里,158,1181,404,174,578,71,649
公投第８案,新北市,林口區,菁湖里,159,1291,559,206,765,31,796
公投第８案,新北市,林口區,中湖里,160,1213,458,169,627,47,674
公投第８案,新北市,林口區,中湖里,161,1256,528,157,685,48,733
公投第８案,新北市,林口區,中湖里,162,1185,406,183,589,55,644
公投第８案,新北市,林口區,湖北里,163,1361,509,177,686,51,737
公投第８案,新北市,林口區,湖南里,164,1756,737,127,864,32,896
公投第８案,新北市,林口區,湖南里,165,1676,662,167,829,33,862
公投第８案,新北市,林口區,湖南里,166,1540,675,170,845,24,869
公投第８案,新北市,林口區,湖南里,167,1569,658,146,804,49,853
公投第８案,新北市,林口區,湖南里,168,1514,641,162,803,34,837
公投第８案,新北市,林口區,湖南里,169,1193,538,126,664,29,693
公投第８案,新北市,林口區,湖南里,170,1610,702,181,883,34,917
公投第８案,新北市,林口區,湖南里,171,1338,582,155,737,37,774
公投第８案,新北市,林口區,湖南里,172,1141,467,149,616,37,653
公投第８案,新北市,林口區,湖南里,173,1307,529,157,686,52,738
公投第８案,新北市,林口區,湖南里,174,1327,571,157,728,33,761
公投第８案,新北市,林口區,湖南里,175,1285,551,155,706,36,742
公投第８案,新北市,林口區,南勢里,176,1481,588,196,784,48,832
公投第８案,新北市,林口區,南勢里,177,1510,638,182,820,32,852
公投第８案,新北市,林口區,南勢里,178,1785,719,199,918,48,966
公投第８案,新北市,林口區,南勢里,179,1792,710,229,939,33,972
公投第８案,新北市,林口區,南勢里,180,1517,652,169,821,38,859
公投第８案,新北市,林口區,南勢里,181,1564,691,174,865,35,900
公投第８案,新北市,林口區,南勢里,182,1560,701,151,852,43,895
公投第８案,新北市,林口區,南勢里,183,1544,635,166,801,38,839
公投第８案,新北市,林口區,南勢里,184,1593,665,154,819,38,857
公投第８案,新北市,林口區,南勢里,185,1431,605,166,771,31,802
公投第８案,新北市,林口區,仁愛里,186,1571,607,189,796,48,844
公投第８案,新北市,林口區,仁愛里,187,1439,614,178,792,42,834
公投第８案,新北市,林口區,仁愛里,188,1451,608,186,794,48,842
公投第８案,新北市,林口區,仁愛里,189,1391,596,190,786,53,839
公投第８案,新北市,林口區,麗林里,190,1461,611,168,779,33,812
公投第８案,新北市,林口區,麗林里,191,1691,682,195,877,33,910
公投第８案,新北市,林口區,麗林里,192,1524,597,195,792,55,847
公投第８案,新北市,林口區,麗林里,193,1343,630,165,795,43,838
公投第８案,新北市,林口區,麗林里,194,1398,635,163,798,40,838
公投第８案,新北市,林口區,東勢里,195,1380,590,171,761,56,817
公投第８案,新北市,林口區,東勢里,196,1367,533,171,704,62,766
公投第８案,新北市,林口區,東勢里,197,1350,523,221,744,31,775
公投第８案,新北市,林口區,東勢里,198,1194,498,155,653,45,698
公投第８案,新北市,林口區,麗園里,199,1344,498,170,668,68,736
公投第８案,新北市,林口區,麗園里,200,1154,465,145,610,43,653
公投第８案,新北市,林口區,麗園里,201,1119,502,145,647,46,693
公投第８案,新北市,林口區,頂福里,202,1026,309,132,441,60,501
公投第８案,新北市,林口區,下福里,203,1210,420,195,615,58,673
公投第８案,新北市,林口區,嘉寶里,204,912,327,121,448,65,513
公投第８案,新北市,林口區,瑞平里,205,824,302,135,437,43,480
公投第８案,新北市,林口區,太平里,206,1411,543,194,737,95,832
公投第８案,新北市,五股區,興珍里,207,1456,479,205,684,109,793
公投第８案,新北市,五股區,興珍里,208,1482,515,182,697,87,784
公投第８案,新北市,五股區,興珍里,209,1287,460,197,657,65,722
公投第８案,新北市,五股區,更寮里,210,1106,320,193,513,39,552
公投第８案,新北市,五股區,觀音里,211,1283,421,162,583,93,676
公投第８案,新北市,五股區,集福里,212,1833,615,239,854,64,918
公投第８案,新北市,五股區,集福里,213,1141,463,132,595,60,655
公投第８案,新北市,五股區,集福里,214,463,177,69,246,37,283
公投第８案,新北市,五股區,集賢里,215,1786,677,201,878,68,946
公投第８案,新北市,五股區,集賢里,216,1660,556,246,802,43,845
公投第８案,新北市,五股區,成德里,217,1534,549,203,752,93,845
公投第８案,新北市,五股區,成德里,218,1285,471,153,624,101,725
公投第８案,新北市,五股區,成州里,219,1832,607,224,831,134,965
公投第８案,新北市,五股區,成州里,220,1542,562,188,750,45,795
公投第８案,新北市,五股區,成州里,221,1897,585,207,792,60,852
公投第８案,新北市,五股區,成功里,222,1964,618,215,833,124,957
公投第８案,新北市,五股區,成功里,223,1779,582,214,796,89,885
公投第８案,新北市,五股區,成功里,224,1735,597,199,796,98,894
公投第８案,新北市,五股區,成泰里,225,2299,822,243,1065,57,1122
公投第８案,新北市,五股區,成泰里,226,1755,581,195,776,68,844
公投第８案,新北市,五股區,成泰里,227,1674,645,203,848,78,926
公投第８案,新北市,五股區,成泰里,228,1661,596,226,822,94,916
公投第８案,新北市,五股區,五龍里,229,1281,385,166,551,47,598
公投第８案,新北市,五股區,五福里,230,1566,564,189,753,90,843
公投第８案,新北市,五股區,五福里,231,1560,497,158,655,40,695
公投第８案,新北市,五股區,六福里,232,1622,602,198,800,51,851
公投第８案,新北市,五股區,六福里,233,1779,700,198,898,50,948
公投第８案,新北市,五股區,民義里,234,1487,512,172,684,86,770
公投第８案,新北市,五股區,民義里,235,1567,620,182,802,56,858
公投第８案,新北市,五股區,五股里,236,1333,347,127,474,42,516
公投第８案,新北市,五股區,五股里,237,1263,501,200,701,66,767
公投第８案,新北市,五股區,五股里,238,1314,497,179,676,82,758
公投第８案,新北市,五股區,德音里,239,1513,544,165,709,41,750
公投第８案,新北市,五股區,德音里,240,1517,603,171,774,46,820
公投第８案,新北市,五股區,德音里,241,1613,570,221,791,80,871
公投第８案,新北市,五股區,水碓里,242,1616,605,182,787,82,869
公投第８案,新北市,五股區,水碓里,243,1616,579,205,784,81,865
公投第８案,新北市,五股區,水碓里,244,1689,625,212,837,79,916
公投第８案,新北市,五股區,水碓里,245,1894,709,198,907,38,945
公投第８案,新北市,五股區,福德里,246,1210,513,177,690,72,762
公投第８案,新北市,五股區,福德里,247,1643,586,190,776,70,846
公投第８案,新北市,五股區,德泰里,248,1441,549,153,702,33,735
公投第８案,新北市,五股區,德泰里,249,1305,548,143,691,61,752
公投第８案,新北市,五股區,德泰里,250,1170,492,166,658,62,720
公投第８案,新北市,五股區,貿商里,251,1397,646,144,790,61,851
公投第８案,新北市,五股區,貿商里,252,1312,595,115,710,70,780
公投第８案,新北市,五股區,陸一里,253,1127,460,81,541,32,573
公投第８案,新北市,五股區,陸一里,254,1154,487,70,557,44,601
公投第８案,新北市,泰山區,大科里,255,643,213,78,291,33,324
公投第８案,新北市,泰山區,大科里,256,186,89,19,108,6,114
公投第８案,新北市,泰山區,黎明里,257,1457,502,173,675,52,727
公投第８案,新北市,泰山區,黎明里,258,1594,626,189,815,73,888
公投第８案,新北市,泰山區,山腳里,259,1598,598,142,740,64,804
公投第８案,新北市,泰山區,山腳里,260,1503,550,150,700,47,747
公投第８案,新北市,泰山區,山腳里,261,1436,522,150,672,77,749
公投第８案,新北市,泰山區,山腳里,262,1384,518,185,703,59,762
公投第８案,新北市,泰山區,福泰里,263,1231,478,151,629,59,688
公投第８案,新北市,泰山區,福泰里,264,1295,456,162,618,36,654
公投第８案,新北市,泰山區,福興里,265,1563,643,181,824,73,897
公投第８案,新北市,泰山區,福興里,266,1610,679,178,857,68,925
公投第８案,新北市,泰山區,楓樹里,267,1253,478,156,634,40,674
公投第８案,新北市,泰山區,楓樹里,268,1294,464,148,612,52,664
公投第８案,新北市,泰山區,楓樹里,269,1354,545,196,741,47,788
公投第８案,新北市,泰山區,同榮里,270,1259,497,134,631,44,675
公投第８案,新北市,泰山區,同榮里,271,1252,504,159,663,32,695
公投第８案,新北市,泰山區,同榮里,272,1094,405,123,528,30,558
公投第８案,新北市,泰山區,同興里,273,1590,598,217,815,75,890
公投第８案,新北市,泰山區,同興里,274,1634,579,236,815,92,907
公投第８案,新北市,泰山區,全興里,275,1536,495,182,677,52,729
公投第８案,新北市,泰山區,全興里,276,1534,627,201,828,57,885
公投第８案,新北市,泰山區,全興里,277,1545,715,173,888,60,948
公投第８案,新北市,泰山區,全興里,278,1399,592,133,725,57,782
公投第８案,新北市,泰山區,全興里,279,1315,508,155,663,33,696
公投第８案,新北市,泰山區,義學里,280,1201,612,61,673,61,734
公投第８案,新北市,泰山區,義學里,281,1182,440,146,586,70,656
公投第８案,新北市,泰山區,義學里,282,1665,615,184,799,72,871
公投第８案,新北市,泰山區,義仁里,283,1855,698,227,925,84,1009
公投第８案,新北市,泰山區,義仁里,284,1866,701,219,920,107,1027
公投第８案,新北市,泰山區,義仁里,285,1935,768,200,968,62,1030
公投第８案,新北市,泰山區,義仁里,286,1589,589,174,763,53,816
公投第８案,新北市,泰山區,明志里,287,1152,437,116,553,43,596
公投第８案,新北市,泰山區,明志里,288,1114,417,152,569,58,627
公投第８案,新北市,泰山區,明志里,289,1040,461,129,590,57,647
公投第８案,新北市,泰山區,泰友里,290,1003,446,109,555,46,601
公投第８案,新北市,泰山區,泰友里,291,975,397,142,539,28,567
公投第８案,新北市,泰山區,新明里,292,1440,544,195,739,46,785
公投第８案,新北市,泰山區,新明里,293,1480,555,176,731,27,758
公投第８案,新北市,泰山區,貴子里,294,1211,473,154,627,44,671
公投第８案,新北市,泰山區,貴子里,295,1237,473,157,630,36,666
公投第８案,新北市,泰山區,貴子里,296,1069,414,111,525,51,576
公投第８案,新北市,泰山區,貴賢里,297,1680,718,203,921,75,996
公投第８案,新北市,泰山區,貴賢里,298,1651,642,213,855,52,907
公投第８案,新北市,泰山區,貴和里,299,1420,524,161,685,38,723
公投第８案,新北市,泰山區,貴和里,300,1337,541,169,710,45,755
公投第８案,新北市,泰山區,貴和里,301,1591,634,221,855,49,904
公投第８案,新北市,新莊區,海山里,302,1123,411,168,579,81,660
公投第８案,新北市,新莊區,海山里,303,1278,506,195,701,78,779
公投第８案,新北市,新莊區,海山里,304,1163,512,158,670,68,738
公投第８案,新北市,新莊區,海山里,305,1228,488,209,697,57,754
公投第８案,新北市,新莊區,全安里,306,1211,454,188,642,65,707
公投第８案,新北市,新莊區,全安里,307,1176,439,200,639,61,700
公投第８案,新北市,新莊區,全安里,308,1536,646,225,871,56,927
公投第８案,新北市,新莊區,全泰里,309,1486,812,85,897,73,970
公投第８案,新北市,新莊區,全泰里,310,1513,662,237,899,73,972
公投第８案,新北市,新莊區,全泰里,311,1395,568,233,801,88,889
公投第８案,新北市,新莊區,忠孝里,312,1353,512,167,679,89,768
公投第８案,新北市,新莊區,忠孝里,313,1409,588,209,797,76,873
公投第８案,新北市,新莊區,忠孝里,314,1478,601,161,762,35,797
公投第８案,新北市,新莊區,文衡里,315,921,366,147,513,62,575
公投第８案,新北市,新莊區,文衡里,316,971,399,163,562,48,610
公投第８案,新北市,新莊區,文聖里,317,1534,678,211,889,75,964
公投第８案,新北市,新莊區,文聖里,318,1516,586,191,777,55,832
公投第８案,新北市,新莊區,興漢里,319,697,271,94,365,45,410
公投第８案,新北市,新莊區,興漢里,320,1235,532,127,659,40,699
公投第８案,新北市,新莊區,興漢里,321,1138,438,157,595,51,646
公投第８案,新北市,新莊區,榮和里,322,1063,379,138,517,31,548
公投第８案,新北市,新莊區,榮和里,323,3399,556,218,774,67,841
公投第８案,新北市,新莊區,文德里,324,1575,643,213,856,78,934
公投第８案,新北市,新莊區,文明里,325,1615,690,244,934,82,1016
公投第８案,新北市,新莊區,化成里,326,1612,548,224,772,80,852
公投第８案,新北市,新莊區,化成里,327,1514,527,213,740,84,824
公投第８案,新北市,新莊區,頭前里,328,1382,474,169,643,36,679
公投第８案,新北市,新莊區,頭前里,329,1475,610,189,799,60,859
公投第８案,新北市,新莊區,頭前里,330,1462,609,182,791,31,822
公投第８案,新北市,新莊區,頭前里,331,1426,597,145,742,46,788
公投第８案,新北市,新莊區,頭前里,332,1421,521,201,722,68,790
公投第８案,新北市,新莊區,福基里,333,1536,609,184,793,63,856
公投第８案,新北市,新莊區,福基里,334,1587,671,189,860,60,920
公投第８案,新北市,新莊區,福基里,335,749,281,90,371,21,392
公投第８案,新北市,新莊區,福興里,336,1276,574,150,724,55,779
公投第８案,新北市,新莊區,福興里,337,1303,505,164,669,39,708
公投第８案,新北市,新莊區,福興里,338,1259,520,167,687,76,763
公投第８案,新北市,新莊區,福興里,339,1291,560,156,716,59,775
公投第８案,新北市,新莊區,昌平里,340,1493,637,175,812,36,848
公投第８案,新北市,新莊區,昌平里,341,1507,614,200,814,62,876
公投第８案,新北市,新莊區,昌平里,342,1456,592,163,755,24,779
公投第８案,新北市,新莊區,昌平里,343,1396,579,168,747,32,779
公投第８案,新北市,新莊區,和平里,344,1351,456,162,618,62,680
公投第８案,新北市,新莊區,和平里,345,1403,574,172,746,66,812
公投第８案,新北市,新莊區,和平里,346,1497,561,198,759,73,832
公投第８案,新北市,新莊區,幸福里,347,1272,507,174,681,91,772
公投第８案,新北市,新莊區,幸福里,348,1269,442,132,574,46,620
公投第８案,新北市,新莊區,幸福里,349,1335,519,191,710,78,788
公投第８案,新北市,新莊區,昌隆里,350,1300,569,176,745,49,794
公投第８案,新北市,新莊區,昌隆里,351,1286,575,153,728,51,779
公投第８案,新北市,新莊區,昌隆里,352,1255,586,180,766,59,825
公投第８案,新北市,新莊區,信義里,353,1558,635,205,840,99,939
公投第８案,新北市,新莊區,信義里,354,1567,503,171,674,84,758
公投第８案,新北市,新莊區,信義里,355,1603,625,228,853,85,938
公投第８案,新北市,新莊區,昌信里,356,1538,607,203,810,43,853
公投第８案,新北市,新莊區,昌信里,357,1671,626,228,854,57,911
公投第８案,新北市,新莊區,昌明里,358,1698,603,217,820,54,874
公投第８案,新北市,新莊區,昌明里,359,1545,672,207,879,58,937
公投第８案,新北市,新莊區,仁義里,360,1696,676,215,891,135,1026
公投第８案,新北市,新莊區,仁義里,361,1626,603,194,797,103,900
公投第８案,新北市,新莊區,仁愛里,362,1170,151,394,545,87,632
公投第８案,新北市,新莊區,仁愛里,363,1236,454,151,605,114,719
公投第８案,新北市,新莊區,自信里,364,1071,389,130,519,75,594
公投第８案,新北市,新莊區,自信里,365,1129,407,182,589,57,646
公投第８案,新北市,新莊區,自立里,366,1586,624,234,858,58,916
公投第８案,新北市,新莊區,自立里,367,1597,556,200,756,73,829
公投第８案,新北市,新莊區,自立里,368,1573,498,192,690,123,813
公投第８案,新北市,新莊區,自強里,369,1225,435,143,578,55,633
公投第８案,新北市,新莊區,自強里,370,1217,437,139,576,39,615
公投第８案,新北市,新莊區,思源里,371,1571,578,202,780,89,869
公投第８案,新北市,新莊區,思源里,372,1594,596,189,785,77,862
公投第８案,新北市,新莊區,思源里,373,1583,584,207,791,69,860
公投第８案,新北市,新莊區,思賢里,374,1245,532,155,687,65,752
公投第８案,新北市,新莊區,思賢里,375,1203,452,169,621,53,674
公投第８案,新北市,新莊區,思賢里,376,1265,559,169,728,66,794
公投第８案,新北市,新莊區,中華里,377,1255,510,165,675,75,750
公投第８案,新北市,新莊區,中華里,378,1287,519,180,699,52,751
公投第８案,新北市,新莊區,中美里,379,1167,444,204,648,82,730
公投第８案,新北市,新莊區,中美里,380,1299,476,164,640,79,719
公投第８案,新北市,新莊區,中美里,381,1207,486,153,639,59,698
公投第８案,新北市,新莊區,中美里,382,1415,583,179,762,64,826
公投第８案,新北市,新莊區,恆安里,383,1342,503,197,700,81,781
公投第８案,新北市,新莊區,恆安里,384,1341,500,186,686,94,780
公投第８案,新北市,新莊區,恆安里,385,1247,471,166,637,80,717
公投第８案,新北市,新莊區,立人里,386,984,512,92,604,34,638
公投第８案,新北市,新莊區,立人里,387,1043,452,134,586,55,641
公投第８案,新北市,新莊區,立德里,388,1135,526,186,712,47,759
公投第８案,新北市,新莊區,立德里,389,1185,476,152,628,57,685
公投第８案,新北市,新莊區,中和里,390,1346,549,170,719,55,774
公投第８案,新北市,新莊區,中和里,391,1372,524,210,734,84,818
公投第８案,新北市,新莊區,中和里,392,1350,565,178,743,83,826
公投第８案,新北市,新莊區,中泰里,393,1307,481,162,643,89,732
公投第８案,新北市,新莊區,中泰里,394,1353,498,176,674,101,775
公投第８案,新北市,新莊區,中泰里,395,1287,504,185,689,89,778
公投第８案,新北市,新莊區,中宏里,396,1567,508,149,657,36,693
公投第８案,新北市,新莊區,中宏里,397,1709,715,207,922,97,1019
公投第８案,新北市,新莊區,中全里,398,1616,585,158,743,44,787
公投第８案,新北市,新莊區,中全里,399,1628,547,184,731,80,811
公投第８案,新北市,新莊區,立志里,400,1148,459,164,623,80,703
公投第８案,新北市,新莊區,立志里,401,1201,458,172,630,10,640
公投第８案,新北市,新莊區,立志里,402,1135,484,179,663,63,726
公投第８案,新北市,新莊區,立廷里,403,1495,643,226,869,70,939
公投第８案,新北市,新莊區,立廷里,404,1486,582,210,792,81,873
公投第８案,新北市,新莊區,立廷里,405,1483,672,179,851,54,905
公投第８案,新北市,新莊區,立廷里,406,1553,634,160,794,57,851
公投第８案,新北市,新莊區,立廷里,407,1625,752,211,963,43,1006
公投第８案,新北市,新莊區,立廷里,408,1671,696,192,888,35,923
公投第８案,新北市,新莊區,立基里,409,1389,613,81,694,74,768
公投第８案,新北市,新莊區,立基里,410,1272,522,159,681,46,727
公投第８案,新北市,新莊區,立基里,411,1409,648,174,822,53,875
公投第８案,新北市,新莊區,立基里,412,1372,535,225,760,56,816
公投第８案,新北市,新莊區,中誠里,413,955,358,133,491,67,558
公投第８案,新北市,新莊區,中誠里,414,952,335,122,457,81,538
公投第８案,新北市,新莊區,中港里,415,1412,541,202,743,44,787
公投第８案,新北市,新莊區,中港里,416,1415,536,213,749,73,822
公投第８案,新北市,新莊區,中港里,417,1421,581,192,773,80,853
公投第８案,新北市,新莊區,中港里,418,1293,555,191,746,63,809
公投第８案,新北市,新莊區,中信里,419,1475,526,185,711,25,736
公投第８案,新北市,新莊區,中信里,420,1429,567,168,735,81,816
公投第８案,新北市,新莊區,中信里,421,1481,593,186,779,64,843
公投第８案,新北市,新莊區,中信里,422,1472,524,175,699,93,792
公投第８案,新北市,新莊區,中信里,423,1474,620,190,810,49,859
公投第８案,新北市,新莊區,中平里,424,1462,677,185,862,27,889
公投第８案,新北市,新莊區,中平里,425,1484,637,204,841,42,883
公投第８案,新北市,新莊區,中平里,426,1461,607,174,781,55,836
公投第８案,新北市,新莊區,中平里,427,1444,603,193,796,36,832
公投第８案,新北市,新莊區,中平里,428,1437,622,190,812,30,842
公投第８案,新北市,新莊區,中原里,429,1641,601,187,788,45,833
公投第８案,新北市,新莊區,中原里,430,1633,596,201,797,42,839
公投第８案,新北市,新莊區,中原里,431,1531,631,201,832,26,858
公投第８案,新北市,新莊區,中原里,432,1517,646,198,844,61,905
公投第８案,新北市,新莊區,中原里,433,1487,585,187,772,50,822
公投第８案,新北市,新莊區,中原里,434,1560,647,182,829,56,885
公投第８案,新北市,新莊區,中隆里,435,1584,591,218,809,80,889
公投第８案,新北市,新莊區,中隆里,436,1602,633,189,822,41,863
公投第８案,新北市,新莊區,中隆里,437,818,298,118,416,66,482
公投第８案,新北市,新莊區,立功里,438,1633,526,178,704,72,776
公投第８案,新北市,新莊區,立功里,439,1652,592,211,803,78,881
公投第８案,新北市,新莊區,立泰里,440,1498,178,571,749,79,828
公投第８案,新北市,新莊區,立泰里,441,1379,514,180,694,48,742
公投第８案,新北市,新莊區,立泰里,442,1381,572,171,743,58,801
公投第８案,新北市,新莊區,立言里,443,1535,623,190,813,84,897
公投第８案,新北市,新莊區,立言里,444,1492,662,212,874,71,945
公投第８案,新北市,新莊區,立言里,445,1450,639,179,818,93,911
公投第８案,新北市,新莊區,豐年里,446,1107,457,135,592,64,656
公投第８案,新北市,新莊區,豐年里,447,1063,464,152,616,64,680
公投第８案,新北市,新莊區,豐年里,448,1143,433,170,603,64,667
公投第８案,新北市,新莊區,國泰里,449,1341,492,157,649,120,769
公投第８案,新北市,新莊區,泰豐里,450,1063,442,138,580,46,626
公投第８案,新北市,新莊區,泰豐里,451,1096,430,166,596,60,656
公投第８案,新北市,新莊區,瓊林里,452,1309,526,170,696,52,748
公投第８案,新北市,新莊區,瓊林里,453,1216,475,191,666,59,725
公投第８案,新北市,新莊區,瓊林里,454,1278,468,157,625,61,686
公投第８案,新北市,新莊區,瓊林里,455,1352,492,205,697,78,775
公投第８案,新北市,新莊區,福營里,456,1298,445,171,616,61,677
公投第８案,新北市,新莊區,福營里,457,1042,402,152,554,55,609
公投第８案,新北市,新莊區,營盤里,458,881,330,109,439,27,466
公投第８案,新北市,新莊區,營盤里,459,1109,473,188,661,54,715
公投第８案,新北市,新莊區,丹鳳里,460,1291,492,166,658,58,716
公投第８案,新北市,新莊區,丹鳳里,461,1293,507,139,646,34,680
公投第８案,新北市,新莊區,丹鳳里,462,1336,519,197,716,71,787
公投第８案,新北市,新莊區,丹鳳里,463,1384,536,151,687,54,741
公投第８案,新北市,新莊區,丹鳳里,464,1231,476,109,585,24,609
公投第８案,新北市,新莊區,丹鳳里,465,940,385,111,496,35,531
公投第８案,新北市,新莊區,合鳳里,466,1369,486,177,663,102,765
公投第８案,新北市,新莊區,合鳳里,467,1384,506,188,694,77,771
公投第８案,新北市,新莊區,合鳳里,468,1272,491,164,655,83,738
公投第８案,新北市,新莊區,祥鳳里,469,1073,467,117,584,51,635
公投第８案,新北市,新莊區,祥鳳里,470,1058,424,136,560,38,598
公投第８案,新北市,新莊區,雙鳳里,471,1528,630,172,802,25,827
公投第８案,新北市,新莊區,雙鳳里,472,1244,504,118,622,57,679
公投第８案,新北市,新莊區,雙鳳里,473,1356,518,147,665,60,725
公投第８案,新北市,新莊區,雙鳳里,474,1164,470,105,575,36,611
公投第８案,新北市,新莊區,雙鳳里,475,1423,592,166,758,82,840
公投第８案,新北市,新莊區,雙鳳里,476,1250,553,178,731,43,774
公投第８案,新北市,新莊區,雙鳳里,477,1252,485,162,647,38,685
公投第８案,新北市,新莊區,龍福里,478,1022,396,122,518,34,552
公投第８案,新北市,新莊區,龍福里,479,959,375,145,520,44,564
公投第８案,新北市,新莊區,龍鳳里,480,1646,669,225,894,56,950
公投第８案,新北市,新莊區,龍鳳里,481,1551,580,192,772,74,846
公投第８案,新北市,新莊區,龍鳳里,482,1526,622,217,839,66,905
公投第８案,新北市,新莊區,龍鳳里,483,1518,616,186,802,50,852
公投第８案,新北市,新莊區,龍鳳里,484,1547,663,186,849,54,903
公投第８案,新北市,新莊區,裕民里,485,1505,540,191,731,94,825
公投第８案,新北市,新莊區,裕民里,486,1527,532,202,734,88,822
公投第８案,新北市,新莊區,裕民里,487,1482,530,186,716,64,780
公投第８案,新北市,新莊區,裕民里,488,1586,566,168,734,86,820
公投第８案,新北市,新莊區,龍安里,489,1065,392,138,530,91,621
公投第８案,新北市,新莊區,龍安里,490,1040,485,135,620,54,674
公投第８案,新北市,新莊區,富國里,491,1090,403,143,546,63,609
公投第８案,新北市,新莊區,富國里,492,1071,414,137,551,69,620
公投第８案,新北市,新莊區,富民里,493,1704,595,208,803,35,838
公投第８案,新北市,新莊區,富民里,494,1698,612,179,791,48,839
公投第８案,新北市,新莊區,後德里,495,1362,590,193,783,61,844
公投第８案,新北市,新莊區,後德里,496,1350,559,179,738,41,779
公投第８案,新北市,新莊區,萬安里,497,1689,658,218,876,85,961
公投第８案,新北市,新莊區,萬安里,498,1612,649,186,835,100,935
公投第８案,新北市,新莊區,建福里,499,1130,474,145,619,61,680
公投第８案,新北市,新莊區,建福里,500,1111,462,156,618,74,692
公投第８案,新北市,新莊區,後港里,501,1539,581,200,781,47,828
公投第８案,新北市,新莊區,後港里,502,1586,604,233,837,47,884
公投第８案,新北市,新莊區,後港里,503,1631,647,210,857,78,935
公投第８案,新北市,新莊區,後港里,504,1540,598,197,795,60,855
公投第８案,新北市,新莊區,四維里,505,1388,448,186,634,64,698
公投第８案,新北市,新莊區,四維里,506,1388,467,158,625,90,715
公投第８案,新北市,新莊區,四維里,507,1387,459,160,619,73,692
公投第８案,新北市,新莊區,南港里,508,1181,431,148,579,51,630
公投第８案,新北市,新莊區,南港里,509,1135,416,175,591,70,661
公投第８案,新北市,新莊區,南港里,510,1173,447,199,646,60,706
公投第８案,新北市,新莊區,南港里,511,1215,511,148,659,47,706
公投第８案,新北市,新莊區,建安里,512,1488,706,97,803,56,859
公投第８案,新北市,新莊區,建安里,513,1444,575,190,765,57,822
公投第８案,新北市,新莊區,建安里,514,1499,514,266,780,49,829
公投第８案,新北市,新莊區,建安里,515,1449,552,213,765,28,793
公投第８案,新北市,新莊區,民全里,516,1640,660,184,844,82,926
公投第８案,新北市,新莊區,民全里,517,1648,608,206,814,89,903
公投第８案,新北市,新莊區,八德里,518,1371,494,169,663,59,722
公投第８案,新北市,新莊區,八德里,519,1400,499,196,695,74,769
公投第８案,新北市,新莊區,成德里,520,1457,561,168,729,86,815
公投第８案,新北市,新莊區,成德里,521,1502,551,181,732,93,825
公投第８案,新北市,新莊區,成德里,522,1412,526,181,707,78,785
公投第８案,新北市,新莊區,民安里,523,1318,485,164,649,81,730
公投第８案,新北市,新莊區,民安里,524,1411,593,170,763,66,829
公投第８案,新北市,新莊區,民安里,525,1262,545,150,695,34,729
公投第８案,新北市,新莊區,民安里,526,1228,550,138,688,53,741
公投第８案,新北市,新莊區,民有里,527,1748,723,223,946,73,1019
公投第８案,新北市,新莊區,民有里,528,1761,728,212,940,82,1022
公投第８案,新北市,新莊區,民本里,529,1326,472,157,629,75,704
公投第８案,新北市,新莊區,民本里,530,1344,439,162,601,69,670
公投第８案,新北市,新莊區,光明里,531,1355,558,156,714,54,768
公投第８案,新北市,新莊區,光明里,532,1306,512,172,684,76,760
公投第８案,新北市,新莊區,光明里,533,1349,574,187,761,46,807
公投第８案,新北市,新莊區,光正里,534,1265,510,158,668,39,707
公投第８案,新北市,新莊區,光正里,535,1282,542,167,709,67,776
公投第８案,新北市,新莊區,光正里,536,1237,542,144,686,59,745
公投第８案,新北市,新莊區,光榮里,537,1301,539,134,673,31,704
公投第８案,新北市,新莊區,光榮里,538,1262,515,141,656,67,723
公投第８案,新北市,新莊區,光榮里,539,1270,504,168,672,52,724
公投第８案,新北市,新莊區,光和里,540,1245,476,187,663,70,733
公投第８案,新北市,新莊區,光和里,541,1220,436,173,609,78,687
公投第８案,新北市,新莊區,光華里,542,1245,480,142,622,36,658
公投第８案,新北市,新莊區,光華里,543,1212,442,146,588,53,641
公投第８案,新北市,新莊區,光華里,544,1253,451,147,598,85,683
公投第８案,新北市,新莊區,光華里,545,1272,461,148,609,66,675
公投第８案,新北市,新莊區,光華里,546,1227,545,140,685,37,722
公投第８案,新北市,新莊區,西盛里,547,1126,483,143,626,48,674
公投第８案,新北市,新莊區,西盛里,548,1240,506,173,679,41,720
公投第８案,新北市,新莊區,西盛里,549,1460,586,178,764,62,826
公投第８案,新北市,新莊區,西盛里,550,1072,403,152,555,44,599
公投第８案,新北市,新莊區,西盛里,551,1127,410,123,533,52,585
公投第８案,新北市,新莊區,西盛里,552,1332,573,159,732,41,773
公投第８案,新北市,新莊區,西盛里,553,1341,527,138,665,23,688
公投第８案,新北市,新莊區,西盛里,554,1140,347,119,466,26,492
公投第８案,新北市,蘆洲區,光華里,555,1600,572,229,801,110,911
公投第８案,新北市,蘆洲區,光華里,556,1549,561,217,778,79,857
公投第８案,新北市,蘆洲區,光華里,557,1516,587,201,788,101,889
公投第８案,新北市,蘆洲區,光明里,558,1404,524,155,679,95,774
公投第８案,新北市,蘆洲區,光明里,559,1381,473,179,652,99,751
公投第８案,新北市,蘆洲區,光明里,560,1485,627,159,786,52,838
公投第８案,新北市,蘆洲區,中路里,561,1779,489,154,643,50,693
公投第８案,新北市,蘆洲區,中路里,562,1797,652,239,891,68,959
公投第８案,新北市,蘆洲區,永安里,563,1364,526,183,709,79,788
公投第８案,新北市,蘆洲區,永安里,564,1635,642,194,836,79,915
公投第８案,新北市,蘆洲區,永安里,565,1567,498,178,676,56,732
公投第８案,新北市,蘆洲區,九芎里,566,1524,563,188,751,57,808
公投第８案,新北市,蘆洲區,九芎里,567,1612,551,195,746,81,827
公投第８案,新北市,蘆洲區,九芎里,568,1674,613,186,799,73,872
公投第８案,新北市,蘆洲區,延平里,569,1838,649,213,862,78,940
公投第８案,新北市,蘆洲區,延平里,570,1814,562,198,760,55,815
公投第８案,新北市,蘆洲區,中華里,571,1473,519,236,755,55,810
公投第８案,新北市,蘆洲區,中華里,572,1465,565,158,723,70,793
公投第８案,新北市,蘆洲區,中原里,573,1652,622,229,851,98,949
公投第８案,新北市,蘆洲區,中原里,574,1650,597,201,798,104,902
公投第８案,新北市,蘆洲區,中原里,575,1656,677,188,865,57,922
公投第８案,新北市,蘆洲區,長安里,576,1571,524,227,751,68,819
公投第８案,新北市,蘆洲區,長安里,577,1523,523,210,733,86,819
公投第８案,新北市,蘆洲區,長安里,578,1475,584,173,757,55,812
公投第８案,新北市,蘆洲區,忠義里,579,1367,497,147,644,79,723
公投第８案,新北市,蘆洲區,忠義里,580,1514,598,187,785,69,854
公投第８案,新北市,蘆洲區,正義里,581,1791,709,277,986,62,1048
公投第８案,新北市,蘆洲區,正義里,582,1714,775,194,969,68,1037
公投第８案,新北市,蘆洲區,正義里,583,1780,741,222,963,44,1007
公投第８案,新北市,蘆洲區,正義里,584,1713,713,204,917,55,972
公投第８案,新北市,蘆洲區,正義里,585,1720,719,217,936,53,989
公投第８案,新北市,蘆洲區,正義里,586,1766,714,202,916,56,972
公投第８案,新北市,蘆洲區,南港里,587,1623,627,177,804,79,883
公投第８案,新北市,蘆洲區,南港里,588,1740,670,221,891,58,949
公投第８案,新北市,蘆洲區,南港里,589,1759,717,221,938,77,1015
公投第８案,新北市,蘆洲區,永樂里,590,1775,686,253,939,85,1024
公投第８案,新北市,蘆洲區,永樂里,591,1909,750,260,1010,79,1089
公投第８案,新北市,蘆洲區,永樂里,592,1805,694,256,950,100,1050
公投第８案,新北市,蘆洲區,成功里,593,1642,596,212,808,59,867
公投第８案,新北市,蘆洲區,成功里,594,1713,633,212,845,64,909
公投第８案,新北市,蘆洲區,成功里,595,1746,592,224,816,79,895
公投第８案,新北市,蘆洲區,成功里,596,1596,596,210,806,70,876
公投第８案,新北市,蘆洲區,永康里,597,1434,521,170,691,64,755
公投第８案,新北市,蘆洲區,永康里,598,1450,519,200,719,75,794
公投第８案,新北市,蘆洲區,永康里,599,1543,529,196,725,30,755
公投第８案,新北市,蘆洲區,永康里,600,1525,593,169,762,57,819
公投第８案,新北市,蘆洲區,永德里,601,1419,491,164,655,78,733
公投第８案,新北市,蘆洲區,永德里,602,1298,509,173,682,58,740
公投第８案,新北市,蘆洲區,永德里,603,1304,466,165,631,76,707
公投第８案,新北市,蘆洲區,樓厝里,604,1806,646,235,881,80,961
公投第８案,新北市,蘆洲區,樓厝里,605,1910,672,241,913,81,994
公投第８案,新北市,蘆洲區,樓厝里,606,1873,597,184,781,80,861
公投第８案,新北市,蘆洲區,信義里,607,1785,586,198,784,58,842
公投第８案,新北市,蘆洲區,信義里,608,1760,570,224,794,73,867
公投第８案,新北市,蘆洲區,玉清里,609,1841,732,207,939,81,1020
公投第８案,新北市,蘆洲區,玉清里,610,1855,669,185,854,47,901
公投第８案,新北市,蘆洲區,玉清里,611,1450,480,165,645,85,730
公投第８案,新北市,蘆洲區,復興里,612,1585,554,188,742,83,825
公投第８案,新北市,蘆洲區,復興里,613,1541,492,180,672,110,782
公投第８案,新北市,蘆洲區,福安里,614,1626,578,206,784,82,866
公投第８案,新北市,蘆洲區,福安里,615,1241,474,167,641,73,714
公投第８案,新北市,蘆洲區,鷺江里,616,1634,590,217,807,76,883
公投第８案,新北市,蘆洲區,鷺江里,617,1573,607,179,786,81,867
公投第８案,新北市,蘆洲區,鷺江里,618,1619,609,237,846,64,910
公投第８案,新北市,蘆洲區,恆德里,619,1878,687,220,907,108,1015
公投第８案,新北市,蘆洲區,恆德里,620,1797,642,231,873,97,970
公投第８案,新北市,蘆洲區,恆德里,621,1816,715,250,965,46,1011
公投第８案,新北市,蘆洲區,溪墘里,622,1344,520,187,707,92,799
公投第８案,新北市,蘆洲區,溪墘里,623,1492,545,242,787,74,861
公投第８案,新北市,蘆洲區,仁復里,624,1959,674,240,914,135,1049
公投第８案,新北市,蘆洲區,仁德里,625,1611,558,215,773,110,883
公投第８案,新北市,蘆洲區,仁德里,626,1574,698,131,829,88,917
公投第８案,新北市,蘆洲區,仁德里,627,1653,627,205,832,85,917
公投第８案,新北市,蘆洲區,仁義里,628,3085,735,240,975,81,1056
公投第８案,新北市,蘆洲區,仁義里,629,1812,632,253,885,83,968
公投第８案,新北市,蘆洲區,得勝里,630,1332,478,183,661,70,731
公投第８案,新北市,蘆洲區,得勝里,631,1648,510,196,706,98,804
公投第８案,新北市,蘆洲區,得仁里,632,1355,486,165,651,37,688
公投第８案,新北市,蘆洲區,得仁里,633,1371,470,183,653,48,701
公投第８案,新北市,蘆洲區,保和里,634,1111,385,175,560,76,636
公投第８案,新北市,蘆洲區,保和里,635,1176,432,176,608,88,696
公投第８案,新北市,蘆洲區,樹德里,636,1602,592,218,810,73,883
公投第８案,新北市,蘆洲區,樹德里,637,1361,449,188,637,57,694
公投第８案,新北市,蘆洲區,民和里,638,1530,568,185,753,27,780
公投第８案,新北市,蘆洲區,民和里,639,925,331,113,444,83,527
公投第８案,新北市,蘆洲區,水湳里,640,1851,681,233,914,96,1010
公投第８案,新北市,蘆洲區,水湳里,641,1791,608,197,805,69,874
公投第８案,新北市,蘆洲區,水湳里,642,1853,616,219,835,83,918
公投第８案,新北市,蘆洲區,水湳里,643,1758,573,209,782,52,834
公投第８案,新北市,蘆洲區,水湳里,644,1798,659,219,878,90,968
公投第８案,新北市,蘆洲區,水河里,645,1645,637,196,833,60,893
公投第８案,新北市,蘆洲區,水河里,646,1612,539,178,717,73,790
公投第８案,新北市,蘆洲區,水河里,647,1784,582,177,759,95,854
公投第８案,新北市,蘆洲區,水河里,648,1701,526,187,713,75,788
公投第８案,新北市,蘆洲區,水河里,649,1581,580,184,764,46,810
公投第８案,新北市,蘆洲區,仁愛里,650,1534,565,217,782,58,840
公投第８案,新北市,蘆洲區,仁愛里,651,1620,605,233,838,88,926
公投第８案,新北市,蘆洲區,仁愛里,652,1494,601,198,799,87,886
公投第８案,新北市,蘆洲區,忠孝里,653,1183,463,141,604,53,657
公投第８案,新北市,蘆洲區,忠孝里,654,985,322,187,509,56,565
公投第８案,新北市,蘆洲區,保佑里,655,1673,562,212,774,92,866
公投第８案,新北市,蘆洲區,保佑里,656,1688,617,210,827,115,942
公投第８案,新北市,蘆洲區,保新里,657,1249,575,153,728,55,783
公投第８案,新北市,蘆洲區,保新里,658,1476,524,171,695,81,776
公投第８案,新北市,三重區,大有里,659,1509,568,159,727,80,807
公投第８案,新北市,三重區,大有里,660,1591,623,219,842,76,918
公投第８案,新北市,三重區,大有里,661,1653,619,244,863,86,949
公投第８案,新北市,三重區,博愛里,662,1392,533,212,745,84,829
公投第８案,新北市,三重區,博愛里,663,1451,598,177,775,103,878
公投第８案,新北市,三重區,博愛里,664,1329,473,188,661,103,764
公投第８案,新北市,三重區,二重里,665,1459,591,184,775,57,832
公投第８案,新北市,三重區,頂崁里,666,1024,396,154,550,68,618
公投第８案,新北市,三重區,頂崁里,667,1066,411,173,584,66,650
公投第８案,新北市,三重區,谷王里,668,856,377,124,501,64,565
公投第８案,新北市,三重區,五谷里,669,764,276,122,398,41,439
公投第８案,新北市,三重區,五谷里,670,821,314,132,446,60,506
公投第８案,新北市,三重區,中興里,671,1887,643,263,906,80,986
公投第８案,新北市,三重區,中興里,672,1646,569,235,804,69,873
公投第８案,新北市,三重區,德厚里,673,358,138,52,190,20,210
公投第８案,新北市,三重區,成功里,674,1039,415,143,558,66,624
公投第８案,新北市,三重區,成功里,675,1114,445,183,628,49,677
公投第８案,新北市,三重區,成功里,676,1588,846,28,874,54,928
公投第８案,新北市,三重區,成功里,677,1702,633,215,848,59,907
公投第８案,新北市,三重區,福祉里,678,1288,516,210,726,65,791
公投第８案,新北市,三重區,福祉里,679,1629,654,254,908,78,986
公投第８案,新北市,三重區,福祉里,680,1861,740,218,958,85,1043
公投第８案,新北市,三重區,福德里,681,1727,608,206,814,68,882
公投第８案,新北市,三重區,福德里,682,1813,703,242,945,59,1004
公投第８案,新北市,三重區,福民里,683,1595,626,196,822,81,903
公投第８案,新北市,三重區,福民里,684,1513,598,199,797,75,872
公投第８案,新北市,三重區,過田里,685,4433,512,237,749,72,821
公投第８案,新北市,三重區,過田里,686,1283,514,179,693,50,743
公投第８案,新北市,三重區,過田里,687,1430,612,193,805,67,872
公投第８案,新北市,三重區,過田里,688,1357,580,163,743,49,792
公投第８案,新北市,三重區,錦田里,689,963,381,142,523,45,568
公投第８案,新北市,三重區,錦田里,690,883,327,127,454,62,516
公投第８案,新北市,三重區,重明里,691,1494,551,189,740,106,846
公投第８案,新北市,三重區,重明里,692,1616,617,231,848,98,946
公投第８案,新北市,三重區,光田里,693,1329,510,161,671,88,759
公投第８案,新北市,三重區,光田里,694,1289,525,212,737,67,804
公投第８案,新北市,三重區,光田里,695,1380,511,192,703,99,802
公投第８案,新北市,三重區,光陽里,696,1668,671,205,876,64,940
公投第８案,新北市,三重區,光陽里,697,1226,504,184,688,88,776
公投第８案,新北市,三重區,光陽里,698,1421,558,204,762,70,832
公投第８案,新北市,三重區,光陽里,699,1364,542,189,731,69,800
公投第８案,新北市,三重區,田心里,700,1232,500,178,678,55,733
公投第８案,新北市,三重區,田心里,701,1248,524,186,710,68,778
公投第８案,新北市,三重區,田心里,702,1256,480,110,590,81,671
公投第８案,新北市,三重區,福田里,703,1506,613,241,854,78,932
公投第８案,新北市,三重區,福田里,704,1669,669,238,907,88,995
公投第８案,新北市,三重區,田中里,705,1308,500,161,661,105,766
公投第８案,新北市,三重區,田中里,706,1263,582,176,758,71,829
公投第８案,新北市,三重區,田中里,707,1471,550,194,744,97,841
公投第８案,新北市,三重區,田中里,708,1447,518,227,745,132,877
公投第８案,新北市,三重區,田安里,709,1693,550,203,753,79,832
公投第８案,新北市,三重區,田安里,710,2015,749,272,1021,59,1080
公投第８案,新北市,三重區,田安里,711,1812,635,208,843,103,946
公投第８案,新北市,三重區,三民里,712,1509,531,171,702,52,754
公投第８案,新北市,三重區,三民里,713,1439,590,185,775,61,836
公投第８案,新北市,三重區,光明里,714,1437,556,189,745,76,821
公投第８案,新北市,三重區,光明里,715,1697,616,234,850,71,921
公投第８案,新北市,三重區,光明里,716,1793,658,201,859,54,913
公投第８案,新北市,三重區,光明里,717,1603,666,226,892,66,958
公投第８案,新北市,三重區,光正里,718,1166,430,161,591,43,634
公投第８案,新北市,三重區,光正里,719,1126,467,152,619,45,664
公投第８案,新北市,三重區,同安里,720,1291,432,147,579,68,647
公投第８案,新北市,三重區,同慶里,721,1597,589,204,793,104,897
公投第８案,新北市,三重區,菜寮里,722,1081,435,147,582,81,663
公投第８案,新北市,三重區,菜寮里,723,911,374,139,513,73,586
公投第８案,新北市,三重區,永春里,724,1719,572,208,780,57,837
公投第８案,新北市,三重區,中正里,725,1289,475,163,638,86,724
公投第８案,新北市,三重區,吉利里,726,1318,511,187,698,107,805
公投第８案,新北市,三重區,大同里,727,1822,641,220,861,84,945
公投第８案,新北市,三重區,中民里,728,1185,432,154,586,106,692
公投第８案,新北市,三重區,平和里,729,1369,463,152,615,107,722
公投第８案,新北市,三重區,大安里,730,1507,569,210,779,82,861
公投第８案,新北市,三重區,仁德里,731,926,343,134,477,75,552
公投第８案,新北市,三重區,仁德里,732,950,319,113,432,28,460
公投第８案,新北市,三重區,忠孝里,733,1678,568,223,791,89,880
公投第８案,新北市,三重區,仁義里,734,1117,393,150,543,95,638
公投第８案,新北市,三重區,光榮里,735,1318,477,156,633,67,700
公投第８案,新北市,三重區,光輝里,736,1388,486,213,699,48,747
公投第８案,新北市,三重區,福星里,737,1026,382,131,513,85,598
公投第８案,新北市,三重區,福利里,738,1096,460,160,620,63,683
公投第８案,新北市,三重區,福利里,739,967,380,145,525,46,571
公投第８案,新北市,三重區,清和里,740,1871,629,269,898,80,978
公投第８案,新北市,三重區,清和里,741,1663,615,211,826,107,933
公投第８案,新北市,三重區,永興里,742,1208,458,136,594,33,627
公投第８案,新北市,三重區,中山里,743,1398,471,191,662,66,728
公投第８案,新北市,三重區,中山里,744,1078,394,139,533,37,570
公投第８案,新北市,三重區,大園里,745,1102,390,133,523,83,606
公投第８案,新北市,三重區,大園里,746,1393,484,186,670,97,767
公投第８案,新北市,三重區,國隆里,747,1251,506,153,659,80,739
公投第８案,新北市,三重區,國隆里,748,1234,523,183,706,79,785
公投第８案,新北市,三重區,重陽里,749,1661,619,247,866,93,959
公投第８案,新北市,三重區,重陽里,750,1590,622,190,812,95,907
公投第８案,新北市,三重區,民生里,751,1182,460,163,623,77,700
公投第８案,新北市,三重區,民生里,752,1369,500,239,739,79,818
公投第８案,新北市,三重區,民生里,753,1222,494,196,690,68,758
公投第８案,新北市,三重區,重新里,754,1304,447,184,631,113,744
公投第８案,新北市,三重區,正德里,755,1054,383,119,502,62,564
公投第８案,新北市,三重區,正義里,756,1635,582,223,805,107,912
公投第８案,新北市,三重區,正安里,757,1779,628,219,847,87,934
公投第８案,新北市,三重區,自強里,758,1633,610,217,827,107,934
公投第８案,新北市,三重區,文化里,759,1107,443,138,581,59,640
公投第８案,新北市,三重區,文化里,760,1021,421,159,580,52,632
公投第８案,新北市,三重區,中央里,761,1649,523,204,727,131,858
公投第８案,新北市,三重區,雙園里,762,874,321,133,454,44,498
公投第８案,新北市,三重區,錦通里,763,1402,525,189,714,110,824
公投第８案,新北市,三重區,錦安里,764,1713,545,209,754,109,863
公投第８案,新北市,三重區,長安里,765,973,313,108,421,69,490
公投第８案,新北市,三重區,長安里,766,1038,407,138,545,67,612
公投第８案,新北市,三重區,光華里,767,1833,596,210,806,134,940
公投第８案,新北市,三重區,長生里,768,817,295,125,420,41,461
公投第８案,新北市,三重區,開元里,769,1387,547,199,746,78,824
公投第８案,新北市,三重區,大德里,770,784,320,107,427,44,471
公投第８案,新北市,三重區,長元里,771,1096,357,150,507,36,543
公投第８案,新北市,三重區,長元里,772,1163,470,137,607,83,690
公投第８案,新北市,三重區,長江里,773,1868,710,198,908,71,979
公投第８案,新北市,三重區,長泰里,774,1117,371,151,522,93,615
公投第８案,新北市,三重區,長泰里,775,934,318,118,436,58,494
公投第８案,新北市,三重區,長福里,776,1412,471,190,661,80,741
公投第８案,新北市,三重區,介壽里,777,1062,473,150,623,58,681
公投第８案,新北市,三重區,萬壽里,778,891,338,89,427,86,513
公投第８案,新北市,三重區,萬壽里,779,936,426,127,553,91,644
公投第８案,新北市,三重區,錦江里,780,1085,381,136,517,81,598
公投第８案,新北市,三重區,錦江里,781,1065,331,153,484,24,508
公投第８案,新北市,三重區,龍濱里,782,1398,557,176,733,68,801
公投第８案,新北市,三重區,龍濱里,783,1550,616,203,819,63,882
公投第８案,新北市,三重區,龍門里,784,1674,601,205,806,102,908
公投第８案,新北市,三重區,秀江里,785,1215,469,151,620,86,706
公投第８案,新北市,三重區,奕壽里,786,1606,572,223,795,85,880
公投第８案,新北市,三重區,三安里,787,1182,480,122,602,60,662
公投第８案,新北市,三重區,三安里,788,1238,461,167,628,100,728
公投第８案,新北市,三重區,福安里,789,1342,538,184,722,74,796
公投第８案,新北市,三重區,福安里,790,1408,543,215,758,62,820
公投第８案,新北市,三重區,信安里,791,1770,665,195,860,120,980
公投第８案,新北市,三重區,安慶里,792,940,355,133,488,62,550
公投第８案,新北市,三重區,安慶里,793,975,344,135,479,29,508
公投第８案,新北市,三重區,幸福里,794,1507,548,184,732,66,798
公投第８案,新北市,三重區,幸福里,795,1419,513,208,721,92,813
公投第８案,新北市,三重區,幸福里,796,1257,497,149,646,67,713
公投第８案,新北市,三重區,六合里,797,1619,585,231,816,99,915
公投第８案,新北市,三重區,六合里,798,1745,652,209,861,95,956
公投第８案,新北市,三重區,六福里,799,1519,578,202,780,78,858
公投第８案,新北市,三重區,六福里,800,1682,604,204,808,81,889
公投第８案,新北市,三重區,六福里,801,1697,671,244,915,78,993
公投第８案,新北市,三重區,順德里,802,1073,371,116,487,86,573
公投第８案,新北市,三重區,順德里,803,924,325,122,447,62,509
公投第８案,新北市,三重區,承德里,804,1613,516,176,692,64,756
公投第８案,新北市,三重區,瑞德里,805,1034,380,108,488,62,550
公投第８案,新北市,三重區,瑞德里,806,1118,413,161,574,79,653
公投第８案,新北市,三重區,崇德里,807,1269,454,164,618,96,714
公投第８案,新北市,三重區,崇德里,808,990,343,138,481,69,550
公投第８案,新北市,三重區,崇德里,809,1336,494,167,661,96,757
公投第８案,新北市,三重區,厚德里,810,1601,650,198,848,78,926
公投第８案,新北市,三重區,厚德里,811,1581,575,245,820,102,922
公投第８案,新北市,三重區,維德里,812,1345,478,213,691,73,764
公投第８案,新北市,三重區,維德里,813,1226,494,192,686,66,752
公投第８案,新北市,三重區,尚德里,814,1650,590,169,759,107,866
公投第８案,新北市,三重區,尚德里,815,1140,437,143,580,76,656
公投第８案,新北市,三重區,培德里,816,1639,599,196,795,47,842
公投第８案,新北市,三重區,培德里,817,1699,647,217,864,85,949
公投第８案,新北市,三重區,立德里,818,1501,681,208,889,105,994
公投第８案,新北市,三重區,立德里,819,1538,586,207,793,75,868
公投第８案,新北市,三重區,永德里,820,1540,567,181,748,94,842
公投第８案,新北市,三重區,永德里,821,1276,488,158,646,71,717
公投第８案,新北市,三重區,永德里,822,1539,520,224,744,81,825
公投第８案,新北市,三重區,永煇里,823,1170,474,169,643,60,703
公投第８案,新北市,三重區,永煇里,824,1120,389,189,578,60,638
公投第８案,新北市,三重區,永發里,825,1789,662,242,904,105,1009
公投第８案,新北市,三重區,永發里,826,1520,522,198,720,90,810
公投第８案,新北市,三重區,永發里,827,1821,660,256,916,98,1014
公投第８案,新北市,三重區,永盛里,828,1407,528,172,700,92,792
公投第８案,新北市,三重區,永盛里,829,1491,563,198,761,74,835
公投第８案,新北市,三重區,永吉里,830,1381,545,196,741,78,819
公投第８案,新北市,三重區,永吉里,831,1222,427,185,612,94,706
公投第８案,新北市,三重區,永安里,832,1938,707,238,945,72,1017
公投第８案,新北市,三重區,永安里,833,1639,613,198,811,49,860
公投第８案,新北市,三重區,永豐里,834,1614,601,206,807,99,906
公投第８案,新北市,三重區,永豐里,835,1709,624,221,845,92,937
公投第８案,新北市,三重區,永豐里,836,1753,625,180,805,100,905
公投第８案,新北市,三重區,永福里,837,1398,506,231,737,81,818
公投第８案,新北市,三重區,永福里,838,1706,595,237,832,93,925
公投第８案,新北市,三重區,永福里,839,1614,620,228,848,76,924
公投第８案,新北市,三重區,永清里,840,1591,585,214,799,58,857
公投第８案,新北市,三重區,永清里,841,1627,613,192,805,60,865
公投第８案,新北市,三重區,永清里,842,1505,556,209,765,105,870
公投第８案,新北市,三重區,永順里,843,1331,544,147,691,64,755
公投第８案,新北市,三重區,永順里,844,1678,573,176,749,63,812
公投第８案,新北市,三重區,永順里,845,1498,564,216,780,65,845
公投第８案,新北市,三重區,溪美里,846,1800,689,277,966,88,1054
公投第８案,新北市,三重區,溪美里,847,1703,582,191,773,60,833
公投第８案,新北市,三重區,溪美里,848,1975,696,222,918,65,983
公投第８案,新北市,三重區,溪美里,849,1894,652,242,894,81,975
公投第８案,新北市,三重區,福隆里,850,1405,564,196,760,64,824
公投第８案,新北市,三重區,福隆里,851,1293,514,177,691,53,744
公投第８案,新北市,三重區,福隆里,852,1259,479,182,661,63,724
公投第８案,新北市,三重區,五常里,853,1144,450,166,616,92,708
公投第８案,新北市,三重區,五常里,854,1254,487,182,669,99,768
公投第８案,新北市,三重區,五常里,855,1313,508,169,677,76,753
公投第８案,新北市,三重區,五福里,856,1594,566,201,767,106,873
公投第８案,新北市,三重區,五福里,857,1775,675,215,890,86,976
公投第８案,新北市,三重區,仁忠里,858,1516,532,193,725,123,848
公投第８案,新北市,三重區,仁忠里,859,1315,519,197,716,104,820
公投第８案,新北市,三重區,慈福里,860,843,309,134,443,76,519
公投第８案,新北市,三重區,慈福里,861,1160,396,141,537,76,613
公投第８案,新北市,三重區,慈生里,862,1052,381,171,552,67,619
公投第８案,新北市,三重區,慈生里,863,1054,434,162,596,67,663
公投第８案,新北市,三重區,慈惠里,864,997,363,147,510,79,589
公投第８案,新北市,三重區,慈惠里,865,936,325,126,451,48,499
公投第８案,新北市,三重區,慈愛里,866,1658,592,207,799,107,906
公投第８案,新北市,三重區,慈愛里,867,1496,517,193,710,101,811
公投第８案,新北市,三重區,慈化里,868,1064,440,145,585,72,657
公投第８案,新北市,三重區,慈化里,869,1152,482,160,642,62,704
公投第８案,新北市,三重區,慈祐里,870,1532,550,175,725,57,782
公投第８案,新北市,三重區,慈祐里,871,1338,470,114,584,55,639
公投第８案,新北市,三重區,慈祐里,872,1303,486,187,673,61,734
公投第８案,新北市,三重區,富華里,873,1369,547,169,716,100,816
公投第８案,新北市,三重區,富華里,874,1491,576,158,734,104,838
公投第８案,新北市,三重區,富貴里,875,1821,604,220,824,124,948
公投第８案,新北市,三重區,富貴里,876,1906,657,214,871,83,954
公投第８案,新北市,三重區,富貴里,877,1842,702,261,963,76,1039
公投第８案,新北市,三重區,富福里,878,878,309,108,417,55,472
公投第８案,新北市,三重區,富福里,879,963,386,155,541,68,609
公投第８案,新北市,三重區,五華里,880,1381,456,161,617,33,650
公投第８案,新北市,三重區,五華里,881,1681,562,180,742,89,831
公投第８案,新北市,三重區,五華里,882,1548,544,199,743,50,793
公投第８案,新北市,三重區,碧華里,883,1542,614,195,809,85,894
公投第８案,新北市,三重區,碧華里,884,1557,581,190,771,82,853
公投第８案,新北市,三重區,碧華里,885,1661,655,184,839,59,898
公投第８案,新北市,三重區,碧華里,886,2024,801,220,1021,44,1065
公投第８案,新北市,三重區,福樂里,887,1588,512,194,706,87,793
公投第８案,新北市,三重區,福樂里,888,1706,588,223,811,127,938
公投第８案,新北市,三重區,仁華里,889,1341,519,197,716,67,783
公投第８案,新北市,三重區,仁華里,890,1025,351,132,483,49,532
公投第８案,新北市,三重區,仁華里,891,1339,514,163,677,84,761
公投第８案,新北市,三重區,五順里,892,1725,602,233,835,126,961
公投第８案,新北市,三重區,五順里,893,1826,698,213,911,85,996
公投第８案,新北市,板橋區,留侯里,894,1388,549,187,736,79,815
公投第８案,新北市,板橋區,流芳里,895,1294,514,196,710,49,759
公投第８案,新北市,板橋區,赤松里,896,667,272,96,368,28,396
公投第８案,新北市,板橋區,黃石里,897,898,319,105,424,50,474
公投第８案,新北市,板橋區,挹秀里,898,829,357,100,457,47,504
公投第８案,新北市,板橋區,挹秀里,899,739,334,91,425,41,466
公投第８案,新北市,板橋區,湳興里,900,1035,434,143,577,56,633
公投第８案,新北市,板橋區,湳興里,901,1713,544,178,722,39,761
公投第８案,新北市,板橋區,湳興里,902,658,228,82,310,16,326
公投第８案,新北市,板橋區,湳興里,903,1312,466,167,633,101,734
公投第８案,新北市,板橋區,新興里,904,1492,528,167,695,64,759
公投第８案,新北市,板橋區,新興里,905,1393,477,156,633,77,710
公投第８案,新北市,板橋區,社後里,906,4742,584,227,811,66,877
公投第８案,新北市,板橋區,社後里,907,1439,535,175,710,46,756
公投第８案,新北市,板橋區,社後里,908,1187,471,160,631,87,718
公投第８案,新北市,板橋區,社後里,909,1122,441,120,561,46,607
公投第８案,新北市,板橋區,香社里,910,1363,552,165,717,62,779
公投第８案,新北市,板橋區,香社里,911,1093,434,165,599,49,648
公投第８案,新北市,板橋區,香社里,912,1331,547,188,735,49,784
公投第８案,新北市,板橋區,香雅里,913,1026,429,147,576,65,641
公投第８案,新北市,板橋區,香雅里,914,1244,500,134,634,92,726
公投第８案,新北市,板橋區,中正里,915,1268,438,156,594,93,687
公投第８案,新北市,板橋區,中正里,916,1313,449,148,597,47,644
公投第８案,新北市,板橋區,中正里,917,1196,488,188,676,53,729
公投第８案,新北市,板橋區,自強里,918,1137,540,176,716,61,777
公投第８案,新北市,板橋區,自強里,919,1269,549,196,745,60,805
公投第８案,新北市,板橋區,自強里,920,1117,491,154,645,33,678
公投第８案,新北市,板橋區,自強里,921,1042,463,140,603,58,661
公投第８案,新北市,板橋區,自立里,922,1257,483,190,673,86,759
公投第８案,新北市,板橋區,自立里,923,1216,476,167,643,79,722
公投第８案,新北市,板橋區,光華里,924,1126,437,153,590,62,652
公投第８案,新北市,板橋區,光華里,925,1290,574,193,767,73,840
公投第８案,新北市,板橋區,光榮里,926,1215,449,134,583,14,597
公投第８案,新北市,板橋區,光榮里,927,1099,401,137,538,26,564
公投第８案,新北市,板橋區,國光里,928,1329,665,129,794,49,843
公投第８案,新北市,板橋區,國光里,929,996,481,85,566,40,606
公投第８案,新北市,板橋區,國光里,930,1047,454,119,573,46,619
公投第８案,新北市,板橋區,港尾里,931,1272,598,183,781,84,865
公投第８案,新北市,板橋區,港尾里,932,1252,556,144,700,64,764
公投第８案,新北市,板橋區,新生里,933,1238,479,179,658,73,731
公投第８案,新北市,板橋區,新生里,934,1389,583,210,793,85,878
公投第８案,新北市,板橋區,新生里,935,1194,491,190,681,71,752
公投第８案,新北市,板橋區,金華里,936,1093,402,112,514,68,582
公投第８案,新北市,板橋區,金華里,937,1148,427,143,570,87,657
公投第８案,新北市,板橋區,金華里,938,1268,496,153,649,57,706
公投第８案,新北市,板橋區,港德里,939,1230,467,180,647,71,718
公投第８案,新北市,板橋區,港德里,940,1012,389,134,523,53,576
公投第８案,新北市,板橋區,港德里,941,811,322,114,436,50,486
公投第８案,新北市,板橋區,港德里,942,1197,495,173,668,83,751
公投第８案,新北市,板橋區,民權里,943,1142,443,124,567,43,610
公投第８案,新北市,板橋區,民權里,944,1222,469,157,626,66,692
公投第８案,新北市,板橋區,民安里,945,796,352,96,448,53,501
公投第８案,新北市,板橋區,民安里,946,997,446,123,569,78,647
公投第８案,新北市,板橋區,建國里,947,1011,365,179,544,40,584
公投第８案,新北市,板橋區,建國里,948,1157,430,167,597,70,667
公投第８案,新北市,板橋區,建國里,949,1040,418,144,562,67,629
公投第８案,新北市,板橋區,漢生里,950,1173,522,142,664,47,711
公投第８案,新北市,板橋區,漢生里,951,1193,462,142,604,35,639
公投第８案,新北市,板橋區,漢生里,952,1255,524,158,682,45,727
公投第８案,新北市,板橋區,公舘里,953,1306,515,185,700,57,757
公投第８案,新北市,板橋區,公舘里,954,1050,418,136,554,24,578
公投第８案,新北市,板橋區,公舘里,955,942,368,137,505,37,542
公投第８案,新北市,板橋區,新民里,956,1133,488,159,647,65,712
公投第８案,新北市,板橋區,新民里,957,1251,505,165,670,56,726
公投第８案,新北市,板橋區,新民里,958,1293,522,177,699,45,744
公投第８案,新北市,板橋區,幸福里,959,1208,427,157,584,71,655
公投第８案,新北市,板橋區,幸福里,960,1223,465,150,615,75,690
公投第８案,新北市,板橋區,幸福里,961,1061,392,152,544,60,604
公投第８案,新北市,板橋區,文德里,962,1515,603,194,797,56,853
公投第８案,新北市,板橋區,文德里,963,1225,513,165,678,76,754
公投第８案,新北市,板橋區,忠誠里,964,1120,556,119,675,33,708
公投第８案,新北市,板橋區,忠誠里,965,1091,495,140,635,52,687
公投第８案,新北市,板橋區,忠誠里,966,1385,648,132,780,43,823
公投第８案,新北市,板橋區,陽明里,967,1283,499,189,688,79,767
公投第８案,新北市,板橋區,陽明里,968,1204,450,153,603,102,705
公投第８案,新北市,板橋區,百壽里,969,1191,548,146,694,61,755
公投第８案,新北市,板橋區,百壽里,970,1078,455,163,618,68,686
公投第８案,新北市,板橋區,介壽里,971,1351,506,204,710,86,796
公投第８案,新北市,板橋區,介壽里,972,1322,534,165,699,77,776
公投第８案,新北市,板橋區,新埔里,973,868,336,124,460,65,525
公投第８案,新北市,板橋區,新埔里,974,1029,416,191,607,80,687
公投第８案,新北市,板橋區,華江里,975,1602,679,216,895,50,945
公投第８案,新北市,板橋區,華江里,976,1362,538,204,742,73,815
公投第８案,新北市,板橋區,華江里,977,1698,641,214,855,106,961
公投第８案,新北市,板橋區,華江里,978,1495,637,163,800,48,848
公投第８案,新北市,板橋區,江翠里,979,1522,498,242,740,94,834
公投第８案,新北市,板橋區,江翠里,980,1279,527,154,681,73,754
公投第８案,新北市,板橋區,江翠里,981,1559,478,182,660,66,726
公投第８案,新北市,板橋區,純翠里,982,1537,539,173,712,114,826
公投第８案,新北市,板橋區,純翠里,983,1531,496,204,700,88,788
公投第８案,新北市,板橋區,純翠里,984,1720,645,219,864,36,900
公投第８案,新北市,板橋區,溪頭里,985,1165,424,128,552,47,599
公投第８案,新北市,板橋區,溪頭里,986,1857,760,238,998,63,1061
公投第８案,新北市,板橋區,溪頭里,987,1078,391,146,537,83,620
公投第８案,新北市,板橋區,溪頭里,988,1177,422,155,577,31,608
公投第８案,新北市,板橋區,聯翠里,989,1798,689,259,948,62,1010
公投第８案,新北市,板橋區,聯翠里,990,1455,580,186,766,119,885
公投第８案,新北市,板橋區,文化里,991,1245,482,197,679,83,762
公投第８案,新北市,板橋區,文化里,992,1704,578,249,827,105,932
公投第８案,新北市,板橋區,宏翠里,993,1600,682,196,878,39,917
公投第８案,新北市,板橋區,宏翠里,994,1409,487,179,666,43,709
公投第８案,新北市,板橋區,宏翠里,995,1286,492,173,665,71,736
公投第８案,新北市,板橋區,仁翠里,996,1359,381,159,540,129,669
公投第８案,新北市,板橋區,仁翠里,997,1188,402,167,569,61,630
公投第８案,新北市,板橋區,新翠里,998,1627,572,194,766,68,834
公投第８案,新北市,板橋區,新翠里,999,1633,539,170,709,40,749
公投第８案,新北市,板橋區,新翠里,1000,1814,744,251,995,91,1086
公投第８案,新北市,板橋區,新翠里,1001,1810,721,201,922,84,1006
公投第８案,新北市,板橋區,朝陽里,1002,1133,425,142,567,92,659
公投第８案,新北市,板橋區,朝陽里,1003,841,311,117,428,48,476
公投第８案,新北市,板橋區,朝陽里,1004,1050,455,128,583,70,653
公投第８案,新北市,板橋區,吉翠里,1005,1130,378,135,513,88,601
公投第８案,新北市,板橋區,吉翠里,1006,1056,413,164,577,81,658
公投第８案,新北市,板橋區,吉翠里,1007,1129,290,245,535,38,573
公投第８案,新北市,板橋區,德翠里,1008,1713,664,210,874,97,971
公投第８案,新北市,板橋區,德翠里,1009,1622,640,221,861,86,947
公投第８案,新北市,板橋區,德翠里,1010,1427,638,192,830,62,892
公投第８案,新北市,板橋區,德翠里,1011,1471,658,196,854,37,891
公投第８案,新北市,板橋區,新海里,1012,1076,385,148,533,24,557
公投第８案,新北市,板橋區,新海里,1013,979,337,106,443,12,455
公投第８案,新北市,板橋區,新海里,1014,1079,496,132,628,40,668
公投第８案,新北市,板橋區,滿翠里,1015,828,291,111,402,71,473
公投第８案,新北市,板橋區,滿翠里,1016,820,295,136,431,84,515
公投第８案,新北市,板橋區,滿翠里,1017,989,368,148,516,47,563
公投第８案,新北市,板橋區,明翠里,1018,1023,359,154,513,85,598
公投第８案,新北市,板橋區,明翠里,1019,1044,360,150,510,43,553
公投第８案,新北市,板橋區,明翠里,1020,968,368,135,503,68,571
公投第８案,新北市,板橋區,明翠里,1021,1222,488,166,654,38,692
公投第８案,新北市,板橋區,松翠里,1022,1385,521,173,694,54,748
公投第８案,新北市,板橋區,松翠里,1023,1585,570,209,779,84,863
公投第８案,新北市,板橋區,柏翠里,1024,1840,674,237,911,92,1003
公投第８案,新北市,板橋區,柏翠里,1025,1806,705,293,998,118,1116
公投第８案,新北市,板橋區,龍翠里,1026,1506,558,204,762,95,857
公投第８案,新北市,板橋區,龍翠里,1027,1476,526,202,728,98,826
公投第８案,新北市,板橋區,龍翠里,1028,1500,595,193,788,84,872
公投第８案,新北市,板橋區,松柏里,1029,1096,462,156,618,78,696
公投第８案,新北市,板橋區,松柏里,1030,963,367,152,519,84,603
公投第８案,新北市,板橋區,華翠里,1031,1601,592,186,778,61,839
公投第８案,新北市,板橋區,華翠里,1032,1507,641,204,845,86,931
公投第８案,新北市,板橋區,莒光里,1033,1315,504,215,719,95,814
公投第８案,新北市,板橋區,莒光里,1034,1178,419,174,593,43,636
公投第８案,新北市,板橋區,忠翠里,1035,1822,764,232,996,93,1089
公投第８案,新北市,板橋區,忠翠里,1036,1605,661,244,905,90,995
公投第８案,新北市,板橋區,忠翠里,1037,1549,658,214,872,25,897
公投第８案,新北市,板橋區,忠翠里,1038,1948,835,245,1080,64,1144
公投第８案,新北市,板橋區,忠翠里,1039,1935,744,242,986,39,1025
公投第８案,新北市,板橋區,嵐翠里,1040,1097,394,130,524,51,575
公投第８案,新北市,板橋區,嵐翠里,1041,1095,390,159,549,59,608
公投第８案,新北市,板橋區,文聖里,1042,1678,567,238,805,110,915
公投第８案,新北市,板橋區,文聖里,1043,1750,623,219,842,123,965
公投第８案,新北市,板橋區,文翠里,1044,1187,427,167,594,71,665
公投第８案,新北市,板橋區,文翠里,1045,1154,456,161,617,36,653
公投第８案,新北市,板橋區,文翠里,1046,1262,488,183,671,37,708
公投第８案,新北市,板橋區,青翠里,1047,1271,485,143,628,92,720
公投第８案,新北市,板橋區,青翠里,1048,1410,512,183,695,110,805
公投第８案,新北市,板橋區,懷翠里,1049,1745,615,181,796,110,906
公投第８案,新北市,板橋區,懷翠里,1050,1867,660,252,912,145,1057
公投第８案,新北市,板橋區,懷翠里,1051,1753,698,241,939,106,1045
公投第８案,新北市,板橋區,福翠里,1052,1204,483,166,649,17,666
公投第８案,新北市,板橋區,港嘴里,1053,1614,608,196,804,84,888
公投第８案,新北市,板橋區,港嘴里,1054,1237,501,178,679,59,738
公投第８案,新北市,板橋區,港嘴里,1055,1361,528,199,727,88,815
公投第８案,新北市,板橋區,港嘴里,1056,1243,459,173,632,49,681
公投第８案,新北市,板橋區,振興里,1057,1515,519,186,705,49,754
公投第８案,新北市,板橋區,振興里,1058,1515,600,213,813,95,908
公投第８案,新北市,板橋區,振興里,1059,949,375,124,499,80,579
公投第８案,新北市,板橋區,振義里,1060,1629,596,219,815,84,899
公投第８案,新北市,板橋區,振義里,1061,1238,480,173,653,60,713
公投第８案,新北市,板橋區,振義里,1062,901,272,74,346,35,381
公投第８案,新北市,板橋區,光復里,1063,1475,573,179,752,109,861
公投第８案,新北市,板橋區,光復里,1064,1481,522,205,727,98,825
公投第８案,新北市,板橋區,埔墘里,1065,1800,631,191,822,100,922
公投第８案,新北市,板橋區,埔墘里,1066,1630,604,213,817,81,898
公投第８案,新北市,板橋區,埔墘里,1067,1298,546,163,709,57,766
公投第８案,新北市,板橋區,埔墘里,1068,874,342,127,469,52,521
公投第８案,新北市,板橋區,富貴里,1069,992,362,130,492,25,517
公投第８案,新北市,板橋區,富貴里,1070,1034,459,154,613,20,633
公投第８案,新北市,板橋區,長壽里,1071,1451,528,227,755,95,850
公投第８案,新北市,板橋區,長壽里,1072,1130,471,154,625,54,679
公投第８案,新北市,板橋區,福壽里,1073,1440,603,183,786,63,849
公投第８案,新北市,板橋區,福壽里,1074,1531,578,225,803,105,908
公投第８案,新北市,板橋區,居仁里,1075,1349,580,198,778,85,863
公投第８案,新北市,板橋區,居仁里,1076,1593,519,187,706,54,760
公投第８案,新北市,板橋區,海山里,1077,1174,463,137,600,42,642
公投第８案,新北市,板橋區,海山里,1078,1228,472,163,635,61,696
公投第８案,新北市,板橋區,海山里,1079,1187,442,181,623,45,668
公投第８案,新北市,板橋區,海山里,1080,870,339,128,467,69,536
公投第８案,新北市,板橋區,海山里,1081,2033,905,241,1146,57,1203
公投第８案,新北市,板橋區,九如里,1082,1418,505,196,701,69,770
公投第８案,新北市,板橋區,九如里,1083,1075,397,161,558,63,621
公投第８案,新北市,板橋區,正泰里,1084,1515,557,169,726,49,775
公投第８案,新北市,板橋區,正泰里,1085,1182,501,184,685,51,736
公投第８案,新北市,板橋區,玉光里,1086,1893,687,251,938,108,1046
公投第８案,新北市,板橋區,玉光里,1087,1302,470,181,651,69,720
公投第８案,新北市,板橋區,玉光里,1088,1366,481,177,658,54,712
公投第８案,新北市,板橋區,光仁里,1089,1318,549,184,733,91,824
公投第８案,新北市,板橋區,光仁里,1090,1200,465,157,622,49,671
公投第８案,新北市,板橋區,埤墘里,1091,2028,788,279,1067,69,1136
公投第８案,新北市,板橋區,埤墘里,1092,1746,657,249,906,118,1024
公投第８案,新北市,板橋區,莊敬里,1093,1954,711,215,926,43,969
公投第８案,新北市,板橋區,莊敬里,1094,1474,562,186,748,75,823
公投第８案,新北市,板橋區,永安里,1095,1418,541,178,719,65,784
公投第８案,新北市,板橋區,永安里,1096,1563,627,242,869,92,961
公投第８案,新北市,板橋區,雙玉里,1097,1780,640,226,866,117,983
公投第８案,新北市,板橋區,雙玉里,1098,1707,649,220,869,58,927
公投第８案,新北市,板橋區,廣新里,1099,906,247,53,300,13,313
公投第８案,新北市,板橋區,廣新里,1100,1030,373,107,480,76,556
公投第８案,新北市,板橋區,廣新里,1101,1115,436,152,588,59,647
公投第８案,新北市,板橋區,深丘里,1102,1836,693,219,912,40,952
公投第８案,新北市,板橋區,深丘里,1103,1881,719,208,927,102,1029
公投第８案,新北市,板橋區,深丘里,1104,1688,663,210,873,43,916
公投第８案,新北市,板橋區,深丘里,1105,1760,758,229,987,49,1036
公投第８案,新北市,板橋區,香丘里,1106,1044,437,189,626,57,683
公投第８案,新北市,板橋區,香丘里,1107,1043,428,157,585,53,638
公投第８案,新北市,板橋區,香丘里,1108,1099,458,160,618,67,685
公投第８案,新北市,板橋區,西安里,1109,1260,438,237,675,56,731
公投第８案,新北市,板橋區,西安里,1110,1131,444,160,604,53,657
公投第８案,新北市,板橋區,東丘里,1111,1225,485,168,653,66,719
公投第８案,新北市,板橋區,東丘里,1112,1455,645,194,839,63,902
公投第８案,新北市,板橋區,東丘里,1113,1267,467,198,665,48,713
公投第８案,新北市,板橋區,民生里,1114,972,338,169,507,75,582
公投第８案,新北市,板橋區,民生里,1115,994,393,144,537,48,585
公投第８案,新北市,板橋區,長安里,1116,1111,445,151,596,32,628
公投第８案,新北市,板橋區,長安里,1117,1177,479,227,706,72,778
公投第８案,新北市,板橋區,長安里,1118,1544,608,170,778,83,861
公投第８案,新北市,板橋區,東安里,1119,1021,388,114,502,92,594
公投第８案,新北市,板橋區,東安里,1120,1040,387,129,516,74,590
公投第８案,新北市,板橋區,福丘里,1121,1504,577,201,778,38,816
公投第８案,新北市,板橋區,福丘里,1122,1373,537,156,693,50,743
公投第８案,新北市,板橋區,福丘里,1123,1210,495,171,666,30,696
公投第８案,新北市,板橋區,福祿里,1124,1809,679,195,874,86,960
公投第８案,新北市,板橋區,福祿里,1125,1551,631,181,812,98,910
公投第８案,新北市,板橋區,民族里,1126,1408,591,170,761,41,802
公投第８案,新北市,板橋區,民族里,1127,1285,546,150,696,42,738
公投第８案,新北市,板橋區,民族里,1128,1102,465,170,635,47,682
公投第８案,新北市,板橋區,國泰里,1129,1399,503,164,667,39,706
公投第８案,新北市,板橋區,國泰里,1130,1692,669,183,852,103,955
公投第８案,新北市,板橋區,後埔里,1131,1625,677,234,911,43,954
公投第８案,新北市,板橋區,後埔里,1132,1712,674,211,885,96,981
公投第８案,新北市,板橋區,福德里,1133,1246,478,172,650,47,697
公投第８案,新北市,板橋區,福德里,1134,1471,581,192,773,49,822
公投第８案,新北市,板橋區,福德里,1135,1761,711,196,907,85,992
公投第８案,新北市,板橋區,景星里,1136,1499,569,207,776,87,863
公投第８案,新北市,板橋區,景星里,1137,1528,529,195,724,75,799
公投第８案,新北市,板橋區,福星里,1138,1536,600,197,797,81,878
公投第８案,新北市,板橋區,福星里,1139,1550,623,202,825,65,890
公投第８案,新北市,板橋區,鄉雲里,1140,2050,838,286,1124,104,1228
公投第８案,新北市,板橋區,鄉雲里,1141,1300,544,159,703,68,771
公投第８案,新北市,板橋區,廣德里,1142,1537,636,185,821,63,884
公投第８案,新北市,板橋區,廣德里,1143,1341,480,146,626,29,655
公投第８案,新北市,板橋區,廣德里,1144,1606,664,198,862,38,900
公投第８案,新北市,板橋區,廣德里,1145,1433,525,149,674,53,727
公投第８案,新北市,板橋區,大豐里,1146,1685,591,185,776,55,831
公投第８案,新北市,板橋區,大豐里,1147,1248,499,189,688,77,765
公投第８案,新北市,板橋區,大豐里,1148,1172,485,112,597,58,655
公投第８案,新北市,板橋區,重慶里,1149,1640,535,172,707,29,736
公投第８案,新北市,板橋區,重慶里,1150,1428,557,160,717,41,758
公投第８案,新北市,板橋區,重慶里,1151,1527,589,203,792,85,877
公投第８案,新北市,板橋區,重慶里,1152,1350,572,175,747,43,790
公投第８案,新北市,板橋區,重慶里,1153,1582,651,168,819,78,897
公投第８案,新北市,板橋區,仁愛里,1154,919,420,115,535,58,593
公投第８案,新北市,板橋區,仁愛里,1155,930,375,102,477,34,511
公投第８案,新北市,板橋區,仁愛里,1156,974,442,123,565,30,595
公投第８案,新北市,板橋區,和平里,1157,1732,769,179,948,57,1005
公投第８案,新北市,板橋區,和平里,1158,1438,566,172,738,65,803
公投第８案,新北市,板橋區,廣福里,1159,1777,614,231,845,115,960
公投第８案,新北市,板橋區,廣福里,1160,1764,607,194,801,73,874
公投第８案,新北市,板橋區,五權里,1161,1289,515,155,670,21,691
公投第８案,新北市,板橋區,五權里,1162,1182,487,131,618,51,669
公投第８案,新北市,板橋區,五權里,1163,1174,461,172,633,71,704
公投第８案,新北市,板橋區,華興里,1164,1870,663,236,899,109,1008
公投第８案,新北市,板橋區,華興里,1165,1842,743,256,999,74,1073
公投第８案,新北市,板橋區,華貴里,1166,1094,450,118,568,66,634
公投第８案,新北市,板橋區,華貴里,1167,1228,445,156,601,73,674
公投第８案,新北市,板橋區,華福里,1168,998,428,163,591,58,649
公投第８案,新北市,板橋區,華福里,1169,862,375,143,518,48,566
公投第８案,新北市,板橋區,華德里,1170,1622,570,203,773,75,848
公投第８案,新北市,板橋區,華德里,1171,1205,492,168,660,75,735
公投第８案,新北市,板橋區,華德里,1172,1787,611,219,830,60,890
公投第８案,新北市,板橋區,華德里,1173,1610,688,184,872,48,920
公投第８案,新北市,板橋區,華東里,1174,2216,936,283,1219,62,1281
公投第８案,新北市,板橋區,華東里,1175,2294,919,284,1203,63,1266
公投第８案,新北市,板橋區,華東里,1176,2090,751,188,939,100,1039
公投第８案,新北市,板橋區,信義里,1177,1356,495,130,625,44,669
公投第８案,新北市,板橋區,信義里,1178,1067,443,139,582,45,627
公投第８案,新北市,板橋區,信義里,1179,1319,507,181,688,67,755
公投第８案,新北市,板橋區,浮洲里,1180,1316,443,163,606,65,671
公投第８案,新北市,板橋區,浮洲里,1181,1195,437,128,565,81,646
公投第８案,新北市,板橋區,浮洲里,1182,857,342,98,440,32,472
公投第８案,新北市,板橋區,華中里,1183,1417,487,185,672,97,769
公投第８案,新北市,板橋區,華中里,1184,1560,588,220,808,96,904
公投第８案,新北市,板橋區,華中里,1185,1747,672,214,886,103,989
公投第８案,新北市,板橋區,僑中里,1186,1176,513,186,699,65,764
公投第８案,新北市,板橋區,僑中里,1187,1101,461,146,607,35,642
公投第８案,新北市,板橋區,僑中里,1188,1458,590,204,794,34,828
公投第８案,新北市,板橋區,大觀里,1189,1630,565,177,742,56,798
公投第８案,新北市,板橋區,大觀里,1190,1611,548,216,764,113,877
公投第８案,新北市,板橋區,歡園里,1191,1139,411,133,544,43,587
公投第８案,新北市,板橋區,中山里,1192,1120,429,125,554,47,601
公投第８案,新北市,板橋區,中山里,1193,1022,400,155,555,98,653
公投第８案,新北市,板橋區,中山里,1194,1049,395,151,546,91,637
公投第８案,新北市,板橋區,中山里,1195,1007,429,124,553,33,586
公投第８案,新北市,板橋區,中山里,1196,1393,585,157,742,37,779
公投第８案,新北市,板橋區,復興里,1197,474,125,44,169,32,201
公投第８案,新北市,板橋區,復興里,1198,500,189,72,261,36,297
公投第８案,新北市,板橋區,大安里,1199,1177,443,148,591,51,642
公投第８案,新北市,板橋區,大安里,1200,1186,440,146,586,45,631
公投第８案,新北市,板橋區,大安里,1201,1139,460,163,623,77,700
公投第８案,新北市,板橋區,福安里,1202,1750,665,211,876,75,951
公投第８案,新北市,板橋區,福安里,1203,3451,873,246,1119,49,1168
公投第８案,新北市,板橋區,聚安里,1204,1620,565,193,758,97,855
公投第８案,新北市,板橋區,聚安里,1205,903,306,91,397,35,432
公投第８案,新北市,板橋區,聚安里,1206,1232,479,174,653,65,718
公投第８案,新北市,板橋區,聚安里,1207,975,337,105,442,26,468
公投第８案,新北市,板橋區,龍安里,1208,1224,447,155,602,43,645
公投第８案,新北市,板橋區,龍安里,1209,1291,515,149,664,43,707
公投第８案,新北市,板橋區,崑崙里,1210,1828,620,202,822,59,881
公投第８案,新北市,板橋區,崑崙里,1211,1725,608,188,796,59,855
公投第８案,新北市,板橋區,崑崙里,1212,1085,384,114,498,28,526
公投第８案,新北市,板橋區,崑崙里,1213,2357,837,284,1121,95,1216
公投第８案,新北市,板橋區,崑崙里,1214,1560,596,183,779,45,824
公投第８案,新北市,板橋區,成和里,1215,2201,717,189,906,40,946
公投第８案,新北市,板橋區,成和里,1216,1626,618,200,818,60,878
公投第８案,新北市,板橋區,成和里,1217,1786,593,173,766,59,825
公投第８案,新北市,板橋區,溪洲里,1218,1763,655,191,846,76,922
公投第８案,新北市,板橋區,溪洲里,1219,1744,608,189,797,38,835
公投第８案,新北市,板橋區,溪洲里,1220,1645,605,184,789,59,848
公投第８案,新北市,板橋區,溪福里,1221,1861,684,163,847,51,898
公投第８案,新北市,板橋區,溪福里,1222,1596,561,168,729,46,775
公投第８案,新北市,板橋區,溪福里,1223,1871,668,237,905,83,988
公投第８案,新北市,板橋區,溪福里,1224,1938,763,217,980,82,1062
公投第８案,新北市,板橋區,溪福里,1225,1827,737,222,959,53,1012
公投第８案,新北市,板橋區,溪福里,1226,1359,421,234,655,46,701
公投第８案,新北市,板橋區,溪福里,1227,1613,671,135,806,76,882
公投第８案,新北市,板橋區,溪北里,1228,1566,580,213,793,89,882
公投第８案,新北市,板橋區,溪北里,1229,1552,659,207,866,56,922
公投第８案,新北市,板橋區,堂春里,1230,1885,671,241,912,50,962
公投第８案,新北市,板橋區,堂春里,1231,1893,680,237,917,68,985
公投第８案,新北市,中和區,中原里,1232,1630,592,198,790,54,844
公投第８案,新北市,中和區,中原里,1233,1775,702,231,933,57,990
公投第８案,新北市,中和區,中原里,1234,1844,691,184,875,44,919
公投第８案,新北市,中和區,連和里,1235,1019,476,134,610,32,642
公投第８案,新北市,中和區,連和里,1236,1138,539,113,652,39,691
公投第８案,新北市,中和區,連城里,1237,1878,723,184,907,45,952
公投第８案,新北市,中和區,連城里,1238,1980,886,187,1073,54,1127
公投第８案,新北市,中和區,連城里,1239,1844,715,230,945,82,1027
公投第８案,新北市,中和區,力行里,1240,2085,858,222,1080,53,1133
公投第８案,新北市,中和區,力行里,1241,1498,599,170,769,64,833
公投第８案,新北市,中和區,力行里,1242,1761,687,219,906,42,948
公投第８案,新北市,中和區,正行里,1243,1254,474,155,629,37,666
公投第８案,新北市,中和區,正行里,1244,1343,596,141,737,46,783
公投第８案,新北市,中和區,德行里,1245,1789,738,196,934,35,969
公投第８案,新北市,中和區,德行里,1246,2000,831,213,1044,46,1090
公投第８案,新北市,中和區,德行里,1247,1953,674,228,902,51,953
公投第８案,新北市,中和區,枋寮里,1248,1712,645,225,870,73,943
公投第８案,新北市,中和區,枋寮里,1249,1582,684,158,842,57,899
公投第８案,新北市,中和區,漳和里,1250,1742,695,203,898,67,965
公投第８案,新北市,中和區,漳和里,1251,1493,664,192,856,60,916
公投第８案,新北市,中和區,廟美里,1252,1352,497,151,648,53,701
公投第８案,新北市,中和區,廟美里,1253,1244,565,124,689,44,733
公投第８案,新北市,中和區,廟美里,1254,1394,581,183,764,67,831
公投第８案,新北市,中和區,福真里,1255,1917,606,199,805,35,840
公投第８案,新北市,中和區,福真里,1256,1830,647,212,859,96,955
公投第８案,新北市,中和區,福善里,1257,1124,449,151,600,60,660
公投第８案,新北市,中和區,福善里,1258,1412,488,155,643,48,691
公投第８案,新北市,中和區,福善里,1259,1356,515,161,676,60,736
公投第８案,新北市,中和區,福美里,1260,1425,549,149,698,50,748
公投第８案,新北市,中和區,福美里,1261,1259,529,151,680,80,760
公投第８案,新北市,中和區,福美里,1262,1256,497,159,656,70,726
公投第８案,新北市,中和區,福祥里,1263,1423,578,162,740,54,794
公投第８案,新北市,中和區,福祥里,1264,1221,513,142,655,60,715
公投第８案,新北市,中和區,福祥里,1265,1858,642,216,858,77,935
公投第８案,新北市,中和區,瓦磘里,1266,1804,673,194,867,61,928
公投第８案,新北市,中和區,瓦磘里,1267,1669,650,231,881,47,928
公投第８案,新北市,中和區,瓦磘里,1268,1485,607,173,780,56,836
公投第８案,新北市,中和區,福和里,1269,1005,420,126,546,60,606
公投第８案,新北市,中和區,福和里,1270,1175,536,155,691,63,754
公投第８案,新北市,中和區,福和里,1271,1171,500,133,633,57,690
公投第８案,新北市,中和區,佳和里,1272,1746,646,178,824,32,856
公投第８案,新北市,中和區,佳和里,1273,1555,564,166,730,46,776
公投第８案,新北市,中和區,佳和里,1274,1112,451,123,574,56,630
公投第８案,新北市,中和區,新南里,1275,1780,781,212,993,56,1049
公投第８案,新北市,中和區,新南里,1276,1918,781,212,993,47,1040
公投第８案,新北市,中和區,新南里,1277,1689,575,151,726,42,768
公投第８案,新北市,中和區,新南里,1278,1781,769,189,958,39,997
公投第８案,新北市,中和區,南山里,1279,1419,555,180,735,56,791
公投第８案,新北市,中和區,南山里,1280,1344,515,165,680,42,722
公投第８案,新北市,中和區,南山里,1281,1804,826,242,1068,64,1132
公投第８案,新北市,中和區,平河里,1282,1788,639,237,876,81,957
公投第８案,新北市,中和區,平河里,1283,1793,700,207,907,73,980
公投第８案,新北市,中和區,平河里,1284,1352,560,151,711,71,782
公投第８案,新北市,中和區,平河里,1285,1813,795,168,963,62,1025
公投第８案,新北市,中和區,平河里,1286,1288,616,156,772,45,817
公投第８案,新北市,中和區,信和里,1287,1186,466,141,607,47,654
公投第８案,新北市,中和區,信和里,1288,1237,432,166,598,13,611
公投第８案,新北市,中和區,信和里,1289,1406,571,145,716,48,764
公投第８案,新北市,中和區,仁和里,1290,1442,573,159,732,69,801
公投第８案,新北市,中和區,仁和里,1291,1040,434,145,579,55,634
公投第８案,新北市,中和區,仁和里,1292,1292,544,181,725,60,785
公投第８案,新北市,中和區,中正里,1293,1811,706,205,911,70,981
公投第８案,新北市,中和區,中正里,1294,1789,685,214,899,118,1017
公投第８案,新北市,中和區,建和里,1295,859,400,77,477,43,520
公投第８案,新北市,中和區,建和里,1296,972,492,96,588,36,624
公投第８案,新北市,中和區,建和里,1297,1346,531,163,694,71,765
公投第８案,新北市,中和區,中山里,1298,1034,423,132,555,48,603
公投第８案,新北市,中和區,中山里,1299,1387,584,154,738,56,794
公投第８案,新北市,中和區,碧河里,1300,2067,836,231,1067,102,1169
公投第８案,新北市,中和區,碧河里,1301,1670,552,185,737,68,805
公投第８案,新北市,中和區,正南里,1302,1166,454,137,591,67,658
公投第８案,新北市,中和區,正南里,1303,963,406,124,530,45,575
公投第８案,新北市,中和區,正南里,1304,1070,417,103,520,47,567
公投第８案,新北市,中和區,頂南里,1305,1319,533,151,684,61,745
公投第８案,新北市,中和區,頂南里,1306,1438,646,100,746,158,904
公投第８案,新北市,中和區,華新里,1307,1808,715,164,879,34,913
公投第８案,新北市,中和區,華新里,1308,1191,482,99,581,24,605
公投第８案,新北市,中和區,華新里,1309,1632,652,188,840,70,910
公投第８案,新北市,中和區,華新里,1310,1765,696,164,860,48,908
公投第８案,新北市,中和區,東南里,1311,1168,560,96,656,44,700
公投第８案,新北市,中和區,東南里,1312,1176,504,103,607,30,637
公投第８案,新北市,中和區,東南里,1313,1565,776,145,921,61,982
公投第８案,新北市,中和區,華南里,1314,1578,609,152,761,48,809
公投第８案,新北市,中和區,華南里,1315,2029,848,188,1036,38,1074
公投第８案,新北市,中和區,華南里,1316,905,364,116,480,42,522
公投第８案,新北市,中和區,忠孝里,1317,839,313,83,396,46,442
公投第８案,新北市,中和區,忠孝里,1318,762,308,90,398,38,436
公投第８案,新北市,中和區,忠孝里,1319,1420,573,152,725,76,801
公投第８案,新北市,中和區,忠孝里,1320,1272,492,139,631,64,695
公投第８案,新北市,中和區,崇南里,1321,1976,776,190,966,70,1036
公投第８案,新北市,中和區,崇南里,1322,1779,741,165,906,54,960
公投第８案,新北市,中和區,興南里,1323,1454,521,130,651,64,715
公投第８案,新北市,中和區,興南里,1324,1374,532,135,667,34,701
公投第８案,新北市,中和區,景南里,1325,1369,544,98,642,53,695
公投第８案,新北市,中和區,景南里,1326,1501,592,153,745,69,814
公投第８案,新北市,中和區,景本里,1327,920,409,121,530,68,598
公投第８案,新北市,中和區,景本里,1328,1050,449,134,583,65,648
公投第８案,新北市,中和區,橫路里,1329,321,138,39,177,21,198
公投第８案,新北市,中和區,內南里,1330,1474,574,138,712,71,783
公投第８案,新北市,中和區,內南里,1331,1461,617,144,761,76,837
公投第８案,新北市,中和區,內南里,1332,1621,623,176,799,59,858
公投第８案,新北市,中和區,壽南里,1333,1327,547,204,751,68,819
公投第８案,新北市,中和區,壽南里,1334,775,296,104,400,46,446
公投第８案,新北市,中和區,福南里,1335,1916,705,210,915,48,963
公投第８案,新北市,中和區,福南里,1336,1901,719,186,905,83,988
公投第８案,新北市,中和區,外南里,1337,4411,542,169,711,39,750
公投第８案,新北市,中和區,外南里,1338,1212,495,144,639,25,664
公投第８案,新北市,中和區,外南里,1339,1126,467,140,607,44,651
公投第８案,新北市,中和區,中興里,1340,1507,591,151,742,33,775
公投第８案,新北市,中和區,中興里,1341,1519,645,150,795,24,819
公投第８案,新北市,中和區,中興里,1342,1467,617,184,801,45,846
公投第８案,新北市,中和區,中興里,1343,1453,632,166,798,84,882
公投第８案,新北市,中和區,吉興里,1344,1364,613,153,766,64,830
公投第８案,新北市,中和區,吉興里,1345,1302,560,112,672,57,729
公投第８案,新北市,中和區,復興里,1346,1627,562,131,693,50,743
公投第８案,新北市,中和區,復興里,1347,1503,332,177,509,45,554
公投第８案,新北市,中和區,復興里,1348,1392,531,149,680,34,714
公投第８案,新北市,中和區,和興里,1349,1067,472,120,592,42,634
公投第８案,新北市,中和區,和興里,1350,1623,622,184,806,55,861
公投第８案,新北市,中和區,和興里,1351,1208,530,140,670,37,707
公投第８案,新北市,中和區,景平里,1352,1991,645,184,829,55,884
公投第８案,新北市,中和區,景平里,1353,1932,700,141,841,59,900
公投第８案,新北市,中和區,景平里,1354,947,467,111,578,45,623
公投第８案,新北市,中和區,景新里,1355,1660,688,194,882,71,953
公投第８案,新北市,中和區,景新里,1356,1574,579,143,722,62,784
公投第８案,新北市,中和區,景福里,1357,2136,807,211,1018,73,1091
公投第８案,新北市,中和區,景福里,1358,1462,531,167,698,83,781
公投第８案,新北市,中和區,景福里,1359,1548,598,137,735,79,814
公投第８案,新北市,中和區,景安里,1360,692,352,83,435,22,457
公投第８案,新北市,中和區,景安里,1361,1221,583,119,702,63,765
公投第８案,新北市,中和區,景安里,1362,1331,543,183,726,64,790
公投第８案,新北市,中和區,景安里,1363,984,446,108,554,50,604
公投第８案,新北市,中和區,景文里,1364,1871,695,184,879,70,949
公投第８案,新北市,中和區,景文里,1365,1279,491,133,624,51,675
公投第８案,新北市,中和區,錦和里,1366,1629,666,211,877,53,930
公投第８案,新北市,中和區,錦和里,1367,1482,637,163,800,38,838
公投第８案,新北市,中和區,錦和里,1368,1715,733,199,932,66,998
公投第８案,新北市,中和區,錦昌里,1369,1952,812,209,1021,74,1095
公投第８案,新北市,中和區,灰磘里,1370,686,286,84,370,38,408
公投第８案,新北市,中和區,積穗里,1371,1577,521,191,712,36,748
公投第８案,新北市,中和區,積穗里,1372,1158,502,130,632,38,670
公投第８案,新北市,中和區,積穗里,1373,1195,572,142,714,20,734
公投第８案,新北市,中和區,積穗里,1374,1054,498,137,635,37,672
公投第８案,新北市,中和區,積穗里,1375,612,280,85,365,26,391
公投第８案,新北市,中和區,積穗里,1376,1668,717,179,896,40,936
公投第８案,新北市,中和區,民享里,1377,1071,458,152,610,75,685
公投第８案,新北市,中和區,民享里,1378,1169,538,194,732,65,797
公投第８案,新北市,中和區,員山里,1379,1370,535,160,695,45,740
公投第８案,新北市,中和區,員山里,1380,1574,668,186,854,92,946
公投第８案,新北市,中和區,員山里,1381,2614,900,218,1118,37,1155
公投第８案,新北市,中和區,嘉穗里,1382,1477,615,202,817,46,863
公投第８案,新北市,中和區,嘉穗里,1383,1041,395,143,538,73,611
公投第８案,新北市,中和區,文元里,1384,1538,683,144,827,62,889
公投第８案,新北市,中和區,文元里,1385,1599,574,204,778,60,838
公投第８案,新北市,中和區,文元里,1386,1586,671,211,882,86,968
公投第８案,新北市,中和區,嘉新里,1387,1726,698,255,953,96,1049
公投第８案,新北市,中和區,嘉新里,1388,1854,805,244,1049,86,1135
公投第８案,新北市,中和區,民安里,1389,1472,631,209,840,64,904
公投第８案,新北市,中和區,民安里,1390,1430,607,189,796,71,867
公投第８案,新北市,中和區,民安里,1391,1488,656,182,838,55,893
公投第８案,新北市,中和區,安穗里,1392,1251,482,151,633,42,675
公投第８案,新北市,中和區,安穗里,1393,1487,611,194,805,59,864
公投第８案,新北市,中和區,安穗里,1394,1328,476,166,642,100,742
公投第８案,新北市,中和區,瑞穗里,1395,1128,511,130,641,55,696
公投第８案,新北市,中和區,瑞穗里,1396,1008,491,128,619,40,659
公投第８案,新北市,中和區,明穗里,1397,1786,734,243,977,41,1018
公投第８案,新北市,中和區,明穗里,1398,2219,875,243,1118,71,1189
公投第８案,新北市,中和區,清穗里,1399,1322,466,165,631,44,675
公投第８案,新北市,中和區,清穗里,1400,1495,502,155,657,25,682
公投第８案,新北市,中和區,自強里,1401,1414,529,175,704,60,764
公投第８案,新北市,中和區,自強里,1402,1681,680,203,883,78,961
公投第８案,新北市,中和區,自強里,1403,1361,536,156,692,60,752
公投第８案,新北市,中和區,德穗里,1404,1442,586,156,742,58,800
公投第８案,新北市,中和區,德穗里,1405,1383,501,175,676,30,706
公投第８案,新北市,中和區,德穗里,1406,1264,553,136,689,39,728
公投第８案,新北市,中和區,民生里,1407,1810,707,242,949,118,1067
公投第８案,新北市,中和區,民生里,1408,1951,670,223,893,52,945
公投第８案,新北市,中和區,國光里,1409,1582,598,121,719,52,771
公投第８案,新北市,中和區,國光里,1410,1945,825,225,1050,102,1152
公投第８案,新北市,中和區,壽德里,1411,1390,605,134,739,59,798
公投第８案,新北市,中和區,壽德里,1412,1161,475,154,629,21,650
公投第８案,新北市,中和區,壽德里,1413,1399,674,91,765,36,801
公投第８案,新北市,中和區,明德里,1414,1070,399,146,545,33,578
公投第８案,新北市,中和區,明德里,1415,1169,460,130,590,29,619
公投第８案,新北市,中和區,明德里,1416,1214,567,129,696,69,765
公投第８案,新北市,中和區,錦中里,1417,1398,607,152,759,65,824
公投第８案,新北市,中和區,錦中里,1418,1049,439,126,565,38,603
公投第８案,新北市,中和區,錦中里,1419,1324,470,287,757,47,804
公投第８案,新北市,中和區,錦盛里,1420,1765,611,166,777,37,814
公投第８案,新北市,中和區,錦盛里,1421,1709,627,187,814,61,875
公投第８案,新北市,中和區,民有里,1422,1186,480,142,622,73,695
公投第８案,新北市,中和區,民有里,1423,1318,553,165,718,54,772
公投第８案,新北市,中和區,員富里,1424,1430,595,194,789,50,839
公投第８案,新北市,中和區,員富里,1425,1637,514,153,667,61,728
公投第８案,新北市,中和區,嘉慶里,1426,1283,487,170,657,61,718
公投第８案,新北市,中和區,嘉慶里,1427,1310,492,188,680,57,737
公投第８案,新北市,中和區,嘉慶里,1428,1301,556,155,711,58,769
公投第８案,新北市,中和區,冠穗里,1429,1681,672,221,893,71,964
公投第８案,新北市,中和區,冠穗里,1430,1384,556,172,728,48,776
公投第８案,新北市,中和區,國華里,1431,1187,469,152,621,65,686
公投第８案,新北市,中和區,國華里,1432,1779,589,182,771,8,779
公投第８案,新北市,中和區,宜安里,1433,1712,742,171,913,57,970
公投第８案,新北市,中和區,安樂里,1434,1462,570,178,748,44,792
公投第８案,新北市,中和區,安樂里,1435,1824,734,186,920,49,969
公投第８案,新北市,中和區,安和里,1436,1389,530,182,712,66,778
公投第８案,新北市,中和區,安和里,1437,1434,628,162,790,49,839
公投第８案,新北市,中和區,安順里,1438,1953,795,171,966,70,1036
公投第８案,新北市,中和區,安順里,1439,2002,779,248,1027,83,1110
公投第８案,新北市,中和區,安平里,1440,1858,764,152,916,44,960
公投第８案,新北市,中和區,安平里,1441,1801,737,173,910,38,948
公投第８案,新北市,中和區,安平里,1442,1691,722,178,900,73,973
公投第８案,新北市,中和區,中安里,1443,1363,597,154,751,52,803
公投第８案,新北市,中和區,中安里,1444,1220,579,131,710,39,749
公投第８案,新北市,中和區,中安里,1445,1365,649,153,802,35,837
公投第８案,新北市,中和區,泰安里,1446,1178,606,28,634,32,666
公投第８案,新北市,中和區,泰安里,1447,830,359,109,468,36,504
公投第８案,新北市,中和區,泰安里,1448,1197,454,133,587,56,643
公投第８案,新北市,中和區,秀山里,1449,1369,571,177,748,52,800
公投第８案,新北市,中和區,秀山里,1450,1336,574,167,741,52,793
公投第８案,新北市,中和區,秀山里,1451,1377,651,150,801,58,859
公投第８案,新北市,中和區,秀成里,1452,1499,634,184,818,63,881
公投第８案,新北市,中和區,秀成里,1453,1689,732,181,913,54,967
公投第８案,新北市,中和區,秀義里,1454,1323,561,170,731,61,792
公投第８案,新北市,中和區,秀義里,1455,1079,483,138,621,54,675
公投第８案,新北市,中和區,秀福里,1456,1545,634,203,837,68,905
公投第８案,新北市,中和區,秀福里,1457,1326,506,162,668,65,733
公投第８案,新北市,中和區,秀福里,1458,1443,580,156,736,41,777
公投第８案,新北市,中和區,秀景里,1459,1712,735,161,896,36,932
公投第８案,新北市,中和區,秀景里,1460,1916,785,192,977,66,1043
公投第８案,新北市,中和區,秀景里,1461,863,383,119,502,39,541
公投第８案,新北市,中和區,秀景里,1462,1203,582,144,726,11,737
公投第８案,新北市,中和區,秀明里,1463,1483,632,150,782,19,801
公投第８案,新北市,中和區,秀明里,1464,1575,663,140,803,36,839
公投第８案,新北市,中和區,秀明里,1465,1432,530,133,663,61,724
公投第８案,新北市,中和區,秀峰里,1466,1441,595,150,745,63,808
公投第８案,新北市,中和區,秀峰里,1467,1269,549,152,701,55,756
公投第８案,新北市,中和區,秀峰里,1468,1363,630,144,774,34,808
公投第８案,新北市,中和區,秀士里,1469,1089,496,89,585,38,623
公投第８案,新北市,中和區,秀士里,1470,1171,434,146,580,28,608
公投第８案,新北市,中和區,秀水里,1471,1150,489,108,597,46,643
公投第８案,新北市,中和區,秀水里,1472,1154,562,122,684,29,713
公投第８案,新北市,中和區,秀水里,1473,1067,506,114,620,41,661
公投第８案,新北市,中和區,秀仁里,1474,1526,617,163,780,44,824
公投第８案,新北市,中和區,秀仁里,1475,1447,629,159,788,54,842
公投第８案,新北市,永和區,光復里,1476,1554,632,203,835,83,918
公投第８案,新北市,永和區,網溪里,1477,1065,466,108,574,22,596
公投第８案,新北市,永和區,復興里,1478,854,395,99,494,50,544
公投第８案,新北市,永和區,復興里,1479,1253,547,148,695,66,761
公投第８案,新北市,永和區,竹林里,1480,1733,716,197,913,44,957
公投第８案,新北市,永和區,竹林里,1481,1581,646,188,834,59,893
公投第８案,新北市,永和區,桂林里,1482,1735,705,179,884,60,944
公投第８案,新北市,永和區,桂林里,1483,1563,663,141,804,28,832
公投第８案,新北市,永和區,上林里,1484,1650,708,209,917,62,979
公投第８案,新北市,永和區,上林里,1485,1454,655,123,778,47,825
公投第８案,新北市,永和區,福林里,1486,1568,582,172,754,62,816
公投第８案,新北市,永和區,福林里,1487,1444,556,158,714,53,767
公投第８案,新北市,永和區,勵行里,1488,1140,425,153,578,45,623
公投第８案,新北市,永和區,中興里,1489,1188,532,151,683,54,737
公投第８案,新北市,永和區,中興里,1490,1516,601,190,791,61,852
公投第８案,新北市,永和區,永興里,1491,1397,580,135,715,65,780
公投第８案,新北市,永和區,永興里,1492,1438,606,135,741,50,791
公投第８案,新北市,永和區,正興里,1493,1084,477,124,601,49,650
公投第８案,新北市,永和區,正興里,1494,941,397,116,513,31,544
公投第８案,新北市,永和區,豫溪里,1495,1598,676,141,817,49,866
公投第８案,新北市,永和區,豫溪里,1496,2842,591,194,785,38,823
公投第８案,新北市,永和區,光明里,1497,1261,551,180,731,57,788
公投第８案,新北市,永和區,光明里,1498,1449,677,194,871,55,926
公投第８案,新北市,永和區,福和里,1499,1511,657,183,840,50,890
公投第８案,新北市,永和區,福和里,1500,1470,682,168,850,64,914
公投第８案,新北市,永和區,福和里,1501,1580,701,177,878,43,921
公投第８案,新北市,永和區,得和里,1502,1438,679,169,848,59,907
公投第８案,新北市,永和區,得和里,1503,1305,628,143,771,36,807
公投第８案,新北市,永和區,得和里,1504,1046,492,117,609,27,636
公投第８案,新北市,永和區,永貞里,1505,1566,675,181,856,27,883
公投第８案,新北市,永和區,永貞里,1506,1468,611,203,814,43,857
公投第８案,新北市,永和區,永福里,1507,1305,623,182,805,48,853
公投第８案,新北市,永和區,永福里,1508,1181,521,143,664,41,705
公投第８案,新北市,永和區,河濱里,1509,1720,684,184,868,66,934
公投第８案,新北市,永和區,河濱里,1510,1103,483,166,649,34,683
公投第８案,新北市,永和區,秀和里,1511,1649,697,173,870,100,970
公投第８案,新北市,永和區,秀和里,1512,1206,527,178,705,41,746
公投第８案,新北市,永和區,秀和里,1513,1506,653,195,848,55,903
公投第８案,新北市,永和區,永元里,1514,1488,609,182,791,65,856
公投第８案,新北市,永和區,永元里,1515,1288,570,160,730,66,796
公投第８案,新北市,永和區,永元里,1516,1413,545,138,683,45,728
公投第８案,新北市,永和區,民權里,1517,1329,567,143,710,62,772
公投第８案,新北市,永和區,民權里,1518,1436,673,171,844,44,888
公投第８案,新北市,永和區,民權里,1519,1112,468,144,612,53,665
公投第８案,新北市,永和區,民族里,1520,1100,564,129,693,49,742
公投第８案,新北市,永和區,民族里,1521,1545,719,184,903,57,960
公投第８案,新北市,永和區,民族里,1522,1436,622,157,779,24,803
公投第８案,新北市,永和區,秀朗里,1523,1731,797,197,994,83,1077
公投第８案,新北市,永和區,秀朗里,1524,1762,774,234,1008,86,1094
公投第８案,新北市,永和區,秀成里,1525,1320,531,167,698,46,744
公投第８案,新北市,永和區,秀成里,1526,1297,453,147,600,18,618
公投第８案,新北市,永和區,秀林里,1527,1798,714,206,920,83,1003
公投第８案,新北市,永和區,秀林里,1528,1491,619,206,825,77,902
公投第８案,新北市,永和區,秀得里,1529,1223,561,115,676,24,700
公投第８案,新北市,永和區,秀得里,1530,1108,464,143,607,60,667
公投第８案,新北市,永和區,秀元里,1531,1408,606,185,791,69,860
公投第８案,新北市,永和區,秀元里,1532,1265,548,170,718,54,772
公投第８案,新北市,永和區,民生里,1533,1115,460,120,580,26,606
公投第８案,新北市,永和區,民生里,1534,1133,506,151,657,70,727
公投第８案,新北市,永和區,民生里,1535,1217,512,152,664,64,728
公投第８案,新北市,永和區,民本里,1536,1713,658,227,885,66,951
公投第８案,新北市,永和區,民本里,1537,1721,700,178,878,61,939
公投第８案,新北市,永和區,民富里,1538,1327,510,168,678,72,750
公投第８案,新北市,永和區,民富里,1539,1257,588,148,736,40,776
公投第８案,新北市,永和區,民樂里,1540,1348,650,144,794,57,851
公投第８案,新北市,永和區,民樂里,1541,1461,709,166,875,50,925
公投第８案,新北市,永和區,民樂里,1542,1368,597,149,746,68,814
公投第８案,新北市,永和區,民治里,1543,1234,513,130,643,73,716
公投第８案,新北市,永和區,民治里,1544,1303,559,140,699,63,762
公投第８案,新北市,永和區,智光里,1545,1516,645,145,790,26,816
公投第８案,新北市,永和區,智光里,1546,1422,622,168,790,77,867
公投第８案,新北市,永和區,潭安里,1547,991,454,128,582,34,616
公投第８案,新北市,永和區,潭安里,1548,1016,478,120,598,43,641
公投第８案,新北市,永和區,潭安里,1549,1146,498,134,632,60,692
公投第８案,新北市,永和區,潭安里,1550,1043,474,116,590,29,619
公投第８案,新北市,永和區,潭墘里,1551,1210,563,129,692,26,718
公投第８案,新北市,永和區,潭墘里,1552,1630,708,175,883,40,923
公投第８案,新北市,永和區,潭墘里,1553,1092,510,121,631,27,658
公投第８案,新北市,永和區,店街里,1554,1872,798,235,1033,57,1090
公投第８案,新北市,永和區,店街里,1555,1781,817,132,949,41,990
公投第８案,新北市,永和區,大新里,1556,1049,445,154,599,45,644
公投第８案,新北市,永和區,大新里,1557,1285,582,82,664,38,702
公投第８案,新北市,永和區,永安里,1558,1209,541,158,699,37,736
公投第８案,新北市,永和區,永安里,1559,1132,515,161,676,31,707
公投第８案,新北市,永和區,永安里,1560,1287,569,184,753,56,809
公投第８案,新北市,永和區,永樂里,1561,1068,469,144,613,58,671
公投第８案,新北市,永和區,永樂里,1562,1098,487,151,638,60,698
公投第８案,新北市,永和區,水源里,1563,1222,559,145,704,54,758
公投第８案,新北市,永和區,水源里,1564,1157,503,137,640,69,709
公投第８案,新北市,永和區,水源里,1565,1168,546,169,715,53,768
公投第８案,新北市,永和區,協和里,1566,1283,511,166,677,71,748
公投第８案,新北市,永和區,協和里,1567,1372,573,174,747,53,800
公投第８案,新北市,永和區,雙和里,1568,1876,851,171,1022,56,1078
公投第８案,新北市,永和區,雙和里,1569,1576,717,202,919,80,999
公投第８案,新北市,永和區,安和里,1570,1661,720,218,938,58,996
公投第８案,新北市,永和區,安和里,1571,1808,766,209,975,35,1010
公投第８案,新北市,永和區,前溪里,1572,1898,801,227,1028,51,1079
公投第８案,新北市,永和區,和平里,1573,1508,657,204,861,63,924
公投第８案,新北市,永和區,和平里,1574,1341,589,162,751,69,820
公投第８案,新北市,永和區,和平里,1575,1422,603,177,780,53,833
公投第８案,新北市,永和區,保平里,1576,1177,530,123,653,32,685
公投第８案,新北市,永和區,保平里,1577,1557,644,199,843,76,919
公投第８案,新北市,永和區,保平里,1578,1491,581,200,781,47,828
公投第８案,新北市,永和區,中溪里,1579,1586,651,193,844,56,900
公投第８案,新北市,永和區,中溪里,1580,1313,528,150,678,21,699
公投第８案,新北市,永和區,中溪里,1581,1636,660,195,855,78,933
公投第８案,新北市,永和區,保安里,1582,1598,652,198,850,66,916
公投第８案,新北市,永和區,保安里,1583,1609,723,192,915,57,972
公投第８案,新北市,永和區,保安里,1584,1375,609,195,804,47,851
公投第８案,新北市,永和區,保安里,1585,1648,783,189,972,65,1037
公投第８案,新北市,永和區,保順里,1586,1077,464,142,606,42,648
公投第８案,新北市,永和區,保順里,1587,1157,504,161,665,38,703
公投第８案,新北市,永和區,保順里,1588,1339,628,182,810,43,853
公投第８案,新北市,永和區,保順里,1589,1306,620,158,778,18,796
公投第８案,新北市,永和區,保順里,1590,1236,611,145,756,27,783
公投第８案,新北市,永和區,保順里,1591,1133,534,133,667,36,703
公投第８案,新北市,永和區,保順里,1592,1425,675,139,814,50,864
公投第８案,新北市,永和區,下溪里,1593,1938,794,228,1022,92,1114
公投第８案,新北市,永和區,下溪里,1594,1607,680,207,887,69,956
公投第８案,新北市,永和區,大同里,1595,853,391,94,485,40,525
公投第８案,新北市,永和區,新生里,1596,768,303,74,377,49,426
公投第８案,新北市,永和區,永成里,1597,893,302,69,371,29,400
公投第８案,新北市,永和區,忠義里,1598,743,327,72,399,37,436
公投第８案,新北市,永和區,仁愛里,1599,1155,466,146,612,50,662
公投第８案,新北市,永和區,仁愛里,1600,1263,585,143,728,51,779
公投第８案,新北市,永和區,文化里,1601,1189,566,124,690,38,728
公投第８案,新北市,永和區,文化里,1602,1346,539,151,690,44,734
公投第８案,新北市,永和區,信義里,1603,1368,564,157,721,52,773
公投第８案,新北市,永和區,信義里,1604,1043,453,136,589,27,616
公投第８案,新北市,永和區,後溪里,1605,1709,722,240,962,56,1018
公投第８案,新北市,永和區,上溪里,1606,879,367,91,458,21,479
公投第８案,新北市,永和區,上溪里,1607,904,371,128,499,43,542
公投第８案,新北市,永和區,頂溪里,1608,1221,558,154,712,58,770
公投第８案,新北市,永和區,頂溪里,1609,1018,437,140,577,56,633
公投第８案,新北市,永和區,河堤里,1610,1551,654,166,820,41,861
公投第８案,新北市,永和區,河堤里,1611,1428,628,174,802,59,861
公投第８案,新北市,永和區,新廍里,1612,1044,458,123,581,63,644
公投第８案,新北市,永和區,新廍里,1613,967,433,112,545,57,602
公投第８案,新北市,樹林區,三興里,1614,1408,494,167,661,80,741
公投第８案,新北市,樹林區,三興里,1615,1310,468,164,632,38,670
公投第８案,新北市,樹林區,三興里,1616,1534,507,173,680,75,755
公投第８案,新北市,樹林區,三福里,1617,1211,453,150,603,68,671
公投第８案,新北市,樹林區,三福里,1618,1125,435,160,595,57,652
公投第８案,新北市,樹林區,三福里,1619,1134,481,168,649,45,694
公投第８案,新北市,樹林區,三多里,1620,1897,589,200,789,100,889
公投第８案,新北市,樹林區,三多里,1621,1716,625,212,837,77,914
公投第８案,新北市,樹林區,三龍里,1622,736,285,114,399,58,457
公投第８案,新北市,樹林區,三龍里,1623,1137,484,170,654,35,689
公投第８案,新北市,樹林區,獇寮里,1624,1542,535,199,734,63,797
公投第８案,新北市,樹林區,獇寮里,1625,1470,598,192,790,69,859
公投第８案,新北市,樹林區,獇寮里,1626,1456,485,164,649,31,680
公投第８案,新北市,樹林區,光興里,1627,1124,437,146,583,30,613
公投第８案,新北市,樹林區,光興里,1628,1235,482,143,625,34,659
公投第８案,新北市,樹林區,光興里,1629,1212,458,175,633,37,670
公投第８案,新北市,樹林區,金寮里,1630,1223,430,133,563,35,598
公投第８案,新北市,樹林區,金寮里,1631,1335,479,155,634,83,717
公投第８案,新北市,樹林區,金寮里,1632,1206,459,155,614,48,662
公投第８案,新北市,樹林區,潭底里,1633,1927,462,161,623,92,715
公投第８案,新北市,樹林區,潭底里,1634,914,343,128,471,48,519
公投第８案,新北市,樹林區,潭底里,1635,1456,561,200,761,74,835
公投第８案,新北市,樹林區,文林里,1636,1409,525,158,683,53,736
公投第８案,新北市,樹林區,文林里,1637,1500,581,239,820,78,898
公投第８案,新北市,樹林區,文林里,1638,1545,621,171,792,72,864
公投第８案,新北市,樹林區,保安里,1639,1483,539,189,728,45,773
公投第８案,新北市,樹林區,保安里,1640,1524,570,184,754,40,794
公投第８案,新北市,樹林區,保安里,1641,1431,572,181,753,42,795
公投第８案,新北市,樹林區,保安里,1642,1181,437,149,586,70,656
公投第８案,新北市,樹林區,圳安里,1643,1116,415,160,575,77,652
公投第８案,新北市,樹林區,圳安里,1644,1077,364,156,520,45,565
公投第８案,新北市,樹林區,圳安里,1645,1103,386,123,509,22,531
公投第８案,新北市,樹林區,圳福里,1646,1385,520,177,697,70,767
公投第８案,新北市,樹林區,圳福里,1647,1266,459,151,610,54,664
公投第８案,新北市,樹林區,圳福里,1648,1195,436,157,593,57,650
公投第８案,新北市,樹林區,圳民里,1649,1254,463,157,620,56,676
公投第８案,新北市,樹林區,圳民里,1650,1263,502,171,673,51,724
公投第８案,新北市,樹林區,圳生里,1651,1473,570,236,806,88,894
公投第８案,新北市,樹林區,樹德里,1652,870,358,106,464,33,497
公投第８案,新北市,樹林區,樹德里,1653,1338,547,195,742,78,820
公投第８案,新北市,樹林區,樹德里,1654,1010,381,113,494,39,533
公投第８案,新北市,樹林區,樹福里,1655,1658,662,218,880,75,955
公投第８案,新北市,樹林區,樹福里,1656,1538,656,251,907,65,972
公投第８案,新北市,樹林區,樹西里,1657,1405,633,161,794,91,885
公投第８案,新北市,樹林區,樹西里,1658,1587,592,227,819,69,888
公投第８案,新北市,樹林區,樹西里,1659,1566,604,207,811,60,871
公投第８案,新北市,樹林區,樹興里,1660,997,364,114,478,27,505
公投第８案,新北市,樹林區,樹興里,1661,1187,439,173,612,61,673
公投第８案,新北市,樹林區,樹興里,1662,1061,388,129,517,62,579
公投第８案,新北市,樹林區,樹人里,1663,1701,706,185,891,61,952
公投第８案,新北市,樹林區,樹人里,1664,1278,524,138,662,61,723
公投第８案,新北市,樹林區,育英里,1665,1433,598,186,784,73,857
公投第８案,新北市,樹林區,育英里,1666,1306,558,163,721,77,798
公投第８案,新北市,樹林區,樹南里,1667,1268,518,183,701,72,773
公投第８案,新北市,樹林區,樹南里,1668,1281,501,192,693,43,736
公投第８案,新北市,樹林區,樹南里,1669,1200,379,283,662,54,716
公投第８案,新北市,樹林區,坡內里,1670,1491,543,191,734,37,771
公投第８案,新北市,樹林區,樹東里,1671,1066,410,112,522,28,550
公投第８案,新北市,樹林區,樹北里,1672,877,372,111,483,74,557
公投第８案,新北市,樹林區,彭福里,1673,1616,609,198,807,68,875
公投第８案,新北市,樹林區,彭福里,1674,1589,508,164,672,66,738
公投第８案,新北市,樹林區,彭福里,1675,1367,563,165,728,67,795
公投第８案,新北市,樹林區,和平里,1676,1144,471,163,634,47,681
公投第８案,新北市,樹林區,和平里,1677,1059,402,119,521,30,551
公投第８案,新北市,樹林區,和平里,1678,1224,445,172,617,60,677
公投第８案,新北市,樹林區,彭興里,1679,1141,388,133,521,51,572
公投第８案,新北市,樹林區,彭興里,1680,1396,460,99,559,32,591
公投第８案,新北市,樹林區,彭興里,1681,1157,421,168,589,45,634
公投第８案,新北市,樹林區,彭興里,1682,1498,492,192,684,89,773
公投第８案,新北市,樹林區,彭厝里,1683,1514,569,181,750,82,832
公投第８案,新北市,樹林區,彭厝里,1684,1546,556,168,724,57,781
公投第８案,新北市,樹林區,彭厝里,1685,1392,521,192,713,61,774
公投第８案,新北市,樹林區,大同里,1686,1566,660,155,815,61,876
公投第８案,新北市,樹林區,大同里,1687,1566,618,187,805,36,841
公投第８案,新北市,樹林區,中華里,1688,1517,584,175,759,66,825
公投第８案,新北市,樹林區,中華里,1689,1481,584,183,767,46,813
公投第８案,新北市,樹林區,太順里,1690,1261,446,141,587,47,634
公投第８案,新北市,樹林區,太順里,1691,1163,452,120,572,34,606
公投第８案,新北市,樹林區,東昇里,1692,1661,688,223,911,84,995
公投第８案,新北市,樹林區,東昇里,1693,1585,616,219,835,65,900
公投第８案,新北市,樹林區,東昇里,1694,1018,428,138,566,49,615
公投第８案,新北市,樹林區,東陽里,1695,1247,488,136,624,74,698
公投第８案,新北市,樹林區,東陽里,1696,1390,561,116,677,76,753
公投第８案,新北市,樹林區,東陽里,1697,1293,532,159,691,50,741
公投第８案,新北市,樹林區,東陽里,1698,1301,463,162,625,43,668
公投第８案,新北市,樹林區,東山里,1699,1606,551,222,773,73,846
公投第８案,新北市,樹林區,東山里,1700,1277,467,168,635,81,716
公投第８案,新北市,樹林區,山佳里,1701,1219,460,159,619,71,690
公投第８案,新北市,樹林區,山佳里,1702,1454,537,153,690,42,732
公投第８案,新北市,樹林區,山佳里,1703,1314,508,145,653,46,699
公投第８案,新北市,樹林區,山佳里,1704,1008,470,142,612,28,640
公投第８案,新北市,樹林區,中山里,1705,1574,591,169,760,87,847
公投第８案,新北市,樹林區,中山里,1706,1364,551,171,722,43,765
公投第８案,新北市,樹林區,中山里,1707,1677,560,210,770,80,850
公投第８案,新北市,樹林區,樂山里,1708,1683,519,160,679,42,721
公投第８案,新北市,樹林區,柑園里,1709,1452,593,184,777,59,836
公投第８案,新北市,樹林區,柑園里,1710,1592,711,175,886,38,924
公投第８案,新北市,樹林區,柑園里,1711,1619,707,179,886,45,931
公投第８案,新北市,樹林區,柑園里,1712,1642,774,188,962,42,1004
公投第８案,新北市,樹林區,柑園里,1713,1357,563,159,722,31,753
公投第８案,新北市,樹林區,西園里,1714,1638,595,250,845,87,932
公投第８案,新北市,樹林區,南園里,1715,1592,615,210,825,52,877
公投第８案,新北市,樹林區,南園里,1716,1521,658,172,830,56,886
公投第８案,新北市,樹林區,南園里,1717,1707,753,215,968,60,1028
公投第８案,新北市,樹林區,南園里,1718,1741,745,202,947,68,1015
公投第８案,新北市,樹林區,南園里,1719,1655,697,168,865,44,909
公投第８案,新北市,樹林區,南園里,1720,1775,638,200,838,79,917
公投第８案,新北市,樹林區,南園里,1721,1781,722,182,904,67,971
公投第８案,新北市,樹林區,東園里,1722,1565,496,169,665,47,712
公投第８案,新北市,樹林區,北園里,1723,936,326,131,457,45,502
公投第８案,新北市,樹林區,北園里,1724,1030,375,156,531,23,554
公投第８案,新北市,鶯歌區,建德里,1725,515,194,83,277,17,294
公投第８案,新北市,鶯歌區,東鶯里,1726,965,390,142,532,47,579
公投第８案,新北市,鶯歌區,北鶯里,1727,1931,746,220,966,94,1060
公投第８案,新北市,鶯歌區,北鶯里,1728,1797,628,197,825,60,885
公投第８案,新北市,鶯歌區,西鶯里,1729,1057,414,127,541,49,590
公投第８案,新北市,鶯歌區,西鶯里,1730,962,338,123,461,17,478
公投第８案,新北市,鶯歌區,中鶯里,1731,934,403,137,540,42,582
公投第８案,新北市,鶯歌區,南鶯里,1732,1742,712,262,974,81,1055
公投第８案,新北市,鶯歌區,南鶯里,1733,1634,587,207,794,66,860
公投第８案,新北市,鶯歌區,南鶯里,1734,1676,588,186,774,46,820
公投第８案,新北市,鶯歌區,建國里,1735,2052,745,276,1021,100,1121
公投第８案,新北市,鶯歌區,建國里,1736,1977,656,203,859,43,902
公投第８案,新北市,鶯歌區,建國里,1737,1957,750,246,996,25,1021
公投第８案,新北市,鶯歌區,二甲里,1738,850,260,92,352,27,379
公投第８案,新北市,鶯歌區,二橋里,1739,1782,655,206,861,56,917
公投第８案,新北市,鶯歌區,二橋里,1740,1496,582,153,735,56,791
公投第８案,新北市,鶯歌區,二橋里,1741,2071,682,251,933,53,986
公投第８案,新北市,鶯歌區,二橋里,1742,1753,530,224,754,58,812
公投第８案,新北市,鶯歌區,尖山里,1743,1737,646,172,818,51,869
公投第８案,新北市,鶯歌區,尖山里,1744,1669,618,151,769,67,836
公投第８案,新北市,鶯歌區,尖山里,1745,1842,581,193,774,48,822
公投第８案,新北市,鶯歌區,尖山里,1746,1454,495,185,680,54,734
公投第８案,新北市,鶯歌區,南靖里,1747,942,343,116,459,41,500
公投第８案,新北市,鶯歌區,南靖里,1748,1317,460,178,638,68,706
公投第８案,新北市,鶯歌區,南靖里,1749,949,307,93,400,21,421
公投第８案,新北市,鶯歌區,同慶里,1750,1440,589,196,785,58,843
公投第８案,新北市,鶯歌區,永昌里,1751,1809,610,308,918,74,992
公投第８案,新北市,鶯歌區,永昌里,1752,1758,703,215,918,69,987
公投第８案,新北市,鶯歌區,永昌里,1753,1589,607,194,801,61,862
公投第８案,新北市,鶯歌區,永昌里,1754,1067,438,157,595,37,632
公投第８案,新北市,鶯歌區,永昌里,1755,1092,444,155,599,43,642
公投第８案,新北市,鶯歌區,永吉里,1756,1730,676,215,891,57,948
公投第８案,新北市,鶯歌區,永吉里,1757,1281,515,137,652,61,713
公投第８案,新北市,鶯歌區,永吉里,1758,1238,540,160,700,54,754
公投第８案,新北市,鶯歌區,鳳祥里,1759,1568,611,182,793,76,869
公投第８案,新北市,鶯歌區,鳳祥里,1760,1271,482,146,628,56,684
公投第８案,新北市,鶯歌區,鳳祥里,1761,1183,355,109,464,27,491
公投第８案,新北市,鶯歌區,鳳鳴里,1762,1026,374,83,457,25,482
公投第８案,新北市,鶯歌區,鳳鳴里,1763,1721,612,182,794,43,837
公投第８案,新北市,鶯歌區,鳳鳴里,1764,1317,453,162,615,71,686
公投第８案,新北市,鶯歌區,鳳福里,1765,1046,399,165,564,62,626
公投第８案,新北市,鶯歌區,鳳福里,1766,1144,454,179,633,53,686
公投第８案,新北市,鶯歌區,鳳福里,1767,1336,438,166,604,69,673
公投第８案,新北市,鶯歌區,大湖里,1768,1479,478,151,629,44,673
公投第８案,新北市,鶯歌區,大湖里,1769,1736,624,211,835,55,890
公投第８案,新北市,鶯歌區,大湖里,1770,1389,586,179,765,68,833
公投第８案,新北市,鶯歌區,中湖里,1771,1956,717,22,739,86,825
公投第８案,新北市,鶯歌區,中湖里,1772,1371,464,220,684,53,737
公投第８案,新北市,鶯歌區,中湖里,1773,1810,533,154,687,43,730
公投第８案,新北市,鶯歌區,東湖里,1774,227,74,18,92,6,98
公投第８案,新北市,土城區,祖田里,1775,1505,542,189,731,72,803
公投第８案,新北市,土城區,頂新里,1776,1242,573,131,704,40,744
公投第８案,新北市,土城區,頂新里,1777,1206,523,155,678,35,713
公投第８案,新北市,土城區,頂福里,1778,1474,529,190,719,88,807
公投第８案,新北市,土城區,頂福里,1779,1489,509,183,692,61,753
公投第８案,新北市,土城區,頂福里,1780,1675,597,193,790,67,857
公投第８案,新北市,土城區,頂埔里,1781,1499,578,176,754,66,820
公投第８案,新北市,土城區,頂埔里,1782,1495,569,150,719,53,772
公投第８案,新北市,土城區,頂埔里,1783,1411,500,176,676,84,760
公投第８案,新北市,土城區,沛陂里,1784,1378,493,149,642,60,702
公投第８案,新北市,土城區,沛陂里,1785,1256,457,156,613,54,667
公投第８案,新北市,土城區,沛陂里,1786,1379,547,170,717,69,786
公投第８案,新北市,土城區,永寧里,1787,1424,494,176,670,67,737
公投第８案,新北市,土城區,永寧里,1788,1455,539,189,728,57,785
公投第８案,新北市,土城區,永寧里,1789,1419,495,194,689,47,736
公投第８案,新北市,土城區,永寧里,1790,1357,594,167,761,41,802
公投第８案,新北市,土城區,永寧里,1791,1501,581,168,749,50,799
公投第８案,新北市,土城區,大安里,1792,1206,452,159,611,82,693
公投第８案,新北市,土城區,大安里,1793,1255,498,181,679,50,729
公投第８案,新北市,土城區,大安里,1794,1869,677,209,886,83,969
公投第８案,新北市,土城區,員仁里,1795,1292,484,168,652,42,694
公投第８案,新北市,土城區,員仁里,1796,1324,521,140,661,33,694
公投第８案,新北市,土城區,員仁里,1797,1155,502,46,548,65,613
公投第８案,新北市,土城區,員仁里,1798,1183,443,145,588,63,651
公投第８案,新北市,土城區,埤塘里,1799,2518,361,124,485,52,537
公投第８案,新北市,土城區,埤塘里,1800,1218,467,146,613,48,661
公投第８案,新北市,土城區,埤塘里,1801,1133,468,112,580,69,649
公投第８案,新北市,土城區,土城里,1802,894,329,121,450,41,491
公投第８案,新北市,土城區,土城里,1803,931,363,127,490,57,547
公投第８案,新北市,土城區,長風里,1804,1820,915,163,1078,71,1149
公投第８案,新北市,土城區,員信里,1805,1320,505,148,653,34,687
公投第８案,新北市,土城區,員信里,1806,1241,454,150,604,47,651
公投第８案,新北市,土城區,員信里,1807,1414,541,171,712,60,772
公投第８案,新北市,土城區,員林里,1808,1378,566,165,731,52,783
公投第８案,新北市,土城區,員林里,1809,1421,584,182,766,60,826
公投第８案,新北市,土城區,員林里,1810,1340,534,143,677,43,720
公投第８案,新北市,土城區,員林里,1811,1144,477,147,624,54,678
公投第８案,新北市,土城區,員福里,1812,1268,496,164,660,63,723
公投第８案,新北市,土城區,員福里,1813,1196,458,146,604,83,687
公投第８案,新北市,土城區,員福里,1814,1308,551,173,724,54,778
公投第８案,新北市,土城區,員福里,1815,1175,490,140,630,41,671
公投第８案,新北市,土城區,日和里,1816,1230,475,169,644,60,704
公投第８案,新北市,土城區,日和里,1817,1342,502,179,681,87,768
公投第８案,新北市,土城區,日和里,1818,1268,510,181,691,53,744
公投第８案,新北市,土城區,日和里,1819,1227,522,177,699,75,774
公投第８案,新北市,土城區,日新里,1820,1356,501,187,688,91,779
公投第８案,新北市,土城區,日新里,1821,1496,587,175,762,71,833
公投第８案,新北市,土城區,日新里,1822,1309,500,163,663,82,745
公投第８案,新北市,土城區,裕生里,1823,1175,444,176,620,73,693
公投第８案,新北市,土城區,裕生里,1824,1237,458,156,614,78,692
公投第８案,新北市,土城區,裕生里,1825,1256,494,156,650,68,718
公投第８案,新北市,土城區,裕生里,1826,1228,494,134,628,37,665
公投第８案,新北市,土城區,貨饒里,1827,1182,439,146,585,80,665
公投第８案,新北市,土城區,貨饒里,1828,1558,600,177,777,57,834
公投第８案,新北市,土城區,貨饒里,1829,1160,458,141,599,63,662
公投第８案,新北市,土城區,瑞興里,1830,1357,501,188,689,72,761
公投第８案,新北市,土城區,瑞興里,1831,1464,490,183,673,116,789
公投第８案,新北市,土城區,復興里,1832,1335,464,157,621,73,694
公投第８案,新北市,土城區,復興里,1833,1346,487,167,654,89,743
公投第８案,新北市,土城區,復興里,1834,1435,591,217,808,57,865
公投第８案,新北市,土城區,廣福里,1835,1639,582,202,784,68,852
公投第８案,新北市,土城區,廣福里,1836,1728,683,222,905,74,979
公投第８案,新北市,土城區,廣福里,1837,1665,559,158,717,40,757
公投第８案,新北市,土城區,學成里,1838,1333,546,186,732,76,808
公投第８案,新北市,土城區,學成里,1839,1567,649,204,853,53,906
公投第８案,新北市,土城區,埤林里,1840,1576,590,192,782,84,866
公投第８案,新北市,土城區,埤林里,1841,1458,585,172,757,69,826
公投第８案,新北市,土城區,埤林里,1842,1517,594,196,790,80,870
公投第８案,新北市,土城區,埤林里,1843,1489,630,174,804,43,847
公投第８案,新北市,土城區,埤林里,1844,1463,611,183,794,45,839
公投第８案,新北市,土城區,廣興里,1845,1584,641,180,821,31,852
公投第８案,新北市,土城區,廣興里,1846,1464,580,164,744,53,797
公投第８案,新北市,土城區,樂利里,1847,1598,639,195,834,68,902
公投第８案,新北市,土城區,樂利里,1848,1500,545,166,711,88,799
公投第８案,新北市,土城區,樂利里,1849,1542,620,171,791,48,839
公投第８案,新北市,土城區,學府里,1850,1619,678,205,883,85,968
公投第８案,新北市,土城區,學府里,1851,1521,539,168,707,40,747
公投第８案,新北市,土城區,明德里,1852,1691,647,212,859,43,902
公投第８案,新北市,土城區,明德里,1853,1657,638,184,822,57,879
公投第８案,新北市,土城區,明德里,1854,1772,751,227,978,48,1026
公投第８案,新北市,土城區,學士里,1855,1423,583,175,758,20,778
公投第８案,新北市,土城區,學士里,1856,1321,575,200,775,52,827
公投第８案,新北市,土城區,學士里,1857,1429,591,215,806,59,865
公投第８案,新北市,土城區,柑林里,1858,1445,529,186,715,59,774
公投第８案,新北市,土城區,柑林里,1859,1520,638,184,822,58,880
公投第８案,新北市,土城區,中正里,1860,1484,518,125,643,29,672
公投第８案,新北市,土城區,中正里,1861,1362,519,166,685,40,725
公投第８案,新北市,土城區,青雲里,1862,1262,485,149,634,40,674
公投第８案,新北市,土城區,青雲里,1863,1343,547,175,722,47,769
公投第８案,新北市,土城區,清和里,1864,1337,394,209,603,52,655
公投第８案,新北市,土城區,清和里,1865,1325,397,139,536,56,592
公投第８案,新北市,土城區,清和里,1866,1390,485,170,655,52,707
公投第８案,新北市,土城區,清和里,1867,1534,587,164,751,79,830
公投第８案,新北市,土城區,清化里,1868,1484,535,167,702,86,788
公投第８案,新北市,土城區,清溪里,1869,1532,559,153,712,86,798
公投第８案,新北市,土城區,清溪里,1870,1507,605,156,761,83,844
公投第８案,新北市,土城區,清溪里,1871,1550,632,173,805,64,869
公投第８案,新北市,土城區,清溪里,1872,1567,632,173,805,53,858
公投第８案,新北市,土城區,青山里,1873,1367,569,159,728,51,779
公投第８案,新北市,土城區,青山里,1874,1293,498,135,633,62,695
公投第８案,新北市,土城區,清水里,1875,1402,530,185,715,73,788
公投第８案,新北市,土城區,清水里,1876,1379,531,161,692,62,754
公投第８案,新北市,土城區,清水里,1877,1471,550,156,706,49,755
公投第８案,新北市,土城區,清水里,1878,1410,549,149,698,49,747
公投第８案,新北市,土城區,清水里,1879,1542,575,197,772,64,836
公投第８案,新北市,土城區,永豐里,1880,1238,462,164,626,57,683
公投第８案,新北市,土城區,永豐里,1881,1301,492,129,621,55,676
公投第８案,新北市,土城區,永豐里,1882,1311,623,172,795,45,840
公投第８案,新北市,土城區,永富里,1883,1511,537,157,694,37,731
公投第８案,新北市,土城區,永富里,1884,1531,541,195,736,76,812
公投第８案,新北市,土城區,永富里,1885,1638,598,193,791,69,860
公投第８案,新北市,土城區,廷寮里,1886,1335,538,198,736,52,788
公投第８案,新北市,土城區,廷寮里,1887,1459,586,165,751,53,804
公投第８案,新北市,土城區,廷寮里,1888,1489,578,198,776,33,809
公投第８案,新北市,土城區,金城里,1889,1774,726,181,907,31,938
公投第８案,新北市,土城區,金城里,1890,1792,727,198,925,52,977
公投第８案,新北市,土城區,金城里,1891,1798,741,182,923,68,991
公投第８案,新北市,土城區,峯廷里,1892,1312,485,149,634,68,702
公投第８案,新北市,土城區,峯廷里,1893,1301,476,145,621,57,678
公投第８案,新北市,土城區,峯廷里,1894,1254,442,167,609,54,663
公投第８案,新北市,土城區,峯廷里,1895,1215,431,141,572,47,619
公投第８案,新北市,土城區,峯廷里,1896,1448,545,162,707,66,773
公投第８案,新北市,土城區,延吉里,1897,1321,474,166,640,69,709
公投第８案,新北市,土城區,延吉里,1898,1150,376,144,520,82,602
公投第８案,新北市,土城區,延吉里,1899,1425,452,187,639,59,698
公投第８案,新北市,土城區,延壽里,1900,1366,534,205,739,75,814
公投第８案,新北市,土城區,延壽里,1901,1292,520,155,675,55,730
公投第８案,新北市,土城區,延壽里,1902,1317,495,147,642,71,713
公投第８案,新北市,土城區,延祿里,1903,1324,543,154,697,60,757
公投第８案,新北市,土城區,延祿里,1904,1189,460,143,603,57,660
公投第８案,新北市,土城區,延祿里,1905,1223,467,162,629,79,708
公投第８案,新北市,土城區,平和里,1906,1550,594,177,771,57,828
公投第８案,新北市,土城區,平和里,1907,1606,636,189,825,85,910
公投第８案,新北市,土城區,平和里,1908,1509,587,190,777,52,829
公投第８案,新北市,土城區,平和里,1909,1529,579,176,755,69,824
公投第８案,新北市,土城區,安和里,1910,1458,506,167,673,93,766
公投第８案,新北市,土城區,安和里,1911,1468,548,197,745,86,831
公投第８案,新北市,土城區,安和里,1912,1495,555,193,748,53,801
公投第８案,新北市,土城區,延和里,1913,1303,487,182,669,71,740
公投第８案,新北市,土城區,延和里,1914,1365,517,188,705,61,766
公投第８案,新北市,土城區,延和里,1915,1476,563,166,729,91,820
公投第８案,新北市,土城區,延和里,1916,1519,646,127,773,39,812
公投第８案,新北市,三峽區,三峽里,1917,274,124,37,161,25,186
公投第８案,新北市,三峽區,秀川里,1918,583,211,69,280,42,322
公投第８案,新北市,三峽區,八張里,1919,1765,546,193,739,31,770
公投第８案,新北市,三峽區,八張里,1920,1714,613,230,843,61,904
公投第８案,新北市,三峽區,中埔里,1921,1355,514,128,642,33,675
公投第８案,新北市,三峽區,中埔里,1922,1329,554,147,701,44,745
公投第８案,新北市,三峽區,弘道里,1923,1059,367,126,493,58,551
公投第８案,新北市,三峽區,永舘里,1924,1364,534,187,721,60,781
公投第８案,新北市,三峽區,永舘里,1925,1098,433,156,589,57,646
公投第８案,新北市,三峽區,永舘里,1926,1296,496,152,648,62,710
公投第８案,新北市,三峽區,永舘里,1927,1240,421,178,599,65,664
公投第８案,新北市,三峽區,永舘里,1928,1531,581,177,758,50,808
公投第８案,新北市,三峽區,鳶山里,1929,1444,533,120,653,44,697
公投第８案,新北市,三峽區,鳶山里,1930,1347,477,177,654,80,734
公投第８案,新北市,三峽區,鳶山里,1931,1455,559,156,715,65,780
公投第８案,新北市,三峽區,鳶山里,1932,1556,505,162,667,41,708
公投第８案,新北市,三峽區,鳶山里,1933,1390,414,131,545,47,592
公投第８案,新北市,三峽區,鳶山里,1934,1532,592,173,765,55,820
公投第８案,新北市,三峽區,龍埔里,1935,1377,462,135,597,71,668
公投第８案,新北市,三峽區,龍埔里,1936,1731,652,184,836,57,893
公投第８案,新北市,三峽區,龍埔里,1937,1705,620,194,814,35,849
公投第８案,新北市,三峽區,龍埔里,1938,1590,670,169,839,35,874
公投第８案,新北市,三峽區,龍埔里,1939,1650,692,199,891,32,923
公投第８案,新北市,三峽區,龍恩里,1940,1441,580,170,750,36,786
公投第８案,新北市,三峽區,龍恩里,1941,1404,632,154,786,26,812
公投第８案,新北市,三峽區,龍恩里,1942,1295,597,139,736,33,769
公投第８案,新北市,三峽區,龍恩里,1943,1348,464,155,619,32,651
公投第８案,新北市,三峽區,龍學里,1944,1579,641,180,821,32,853
公投第８案,新北市,三峽區,龍學里,1945,1435,585,152,737,26,763
公投第８案,新北市,三峽區,龍學里,1946,1659,749,189,938,32,970
公投第８案,新北市,三峽區,龍學里,1947,1512,697,170,867,48,915
公投第８案,新北市,三峽區,龍學里,1948,1463,634,163,797,49,846
公投第８案,新北市,三峽區,龍學里,1949,1465,663,143,806,29,835
公投第８案,新北市,三峽區,龍學里,1950,1463,649,162,811,28,839
公投第８案,新北市,三峽區,龍學里,1951,1443,632,147,779,44,823
公投第８案,新北市,三峽區,礁溪里,1952,1634,591,171,762,60,822
公投第８案,新北市,三峽區,礁溪里,1953,1716,638,219,857,65,922
公投第８案,新北市,三峽區,礁溪里,1954,1675,614,188,802,69,871
公投第８案,新北市,三峽區,安溪里,1955,1649,506,161,667,55,722
公投第８案,新北市,三峽區,安溪里,1956,1489,528,178,706,80,786
公投第８案,新北市,三峽區,安溪里,1957,1771,624,180,804,57,861
公投第８案,新北市,三峽區,安溪里,1958,1726,693,173,866,70,936
公投第８案,新北市,三峽區,介壽里,1959,1363,483,166,649,77,726
公投第８案,新北市,三峽區,介壽里,1960,1624,639,160,799,40,839
公投第８案,新北市,三峽區,介壽里,1961,1352,523,180,703,56,759
公投第８案,新北市,三峽區,介壽里,1962,1608,433,147,580,28,608
公投第８案,新北市,三峽區,中正里,1963,1458,529,185,714,61,775
公投第８案,新北市,三峽區,中正里,1964,1641,557,172,729,50,779
公投第８案,新北市,三峽區,中正里,1965,1530,527,175,702,108,810
公投第８案,新北市,三峽區,大埔里,1966,1389,425,136,561,70,631
公投第８案,新北市,三峽區,大埔里,1967,1315,441,133,574,88,662
公投第８案,新北市,三峽區,大埔里,1968,934,422,97,519,50,569
公投第８案,新北市,三峽區,嘉添里,1969,1270,417,136,553,38,591
公投第８案,新北市,三峽區,嘉添里,1970,929,292,116,408,50,458
公投第８案,新北市,三峽區,添福里,1971,1035,363,122,485,17,502
公投第８案,新北市,三峽區,金圳里,1972,502,161,42,203,19,222
公投第８案,新北市,三峽區,五寮里,1973,836,272,76,348,59,407
公投第８案,新北市,三峽區,插角里,1974,669,195,73,268,59,327
公投第８案,新北市,三峽區,有木里,1975,733,271,87,358,72,430
公投第８案,新北市,三峽區,二鬮里,1976,1560,676,198,874,63,937
公投第８案,新北市,三峽區,二鬮里,1977,1638,620,173,793,50,843
公投第８案,新北市,三峽區,溪南里,1978,1394,458,144,602,56,658
公投第８案,新北市,三峽區,溪北里,1979,771,295,103,398,46,444
公投第８案,新北市,三峽區,溪北里,1980,1367,467,162,629,36,665
公投第８案,新北市,三峽區,溪東里,1981,1241,453,119,572,72,644
公投第８案,新北市,三峽區,溪東里,1982,1520,530,145,675,36,711
公投第８案,新北市,三峽區,成福里,1983,873,375,130,505,51,556
公投第８案,新北市,三峽區,竹崙里,1984,768,215,93,308,66,374
公投第８案,新北市,三峽區,竹崙里,1985,1097,351,124,475,33,508
公投第８案,新北市,三峽區,安坑里,1986,1322,359,132,491,76,567
公投第８案,新北市,新店區,新店里,1987,1603,637,175,812,61,873
公投第８案,新北市,新店區,張南里,1988,1921,802,222,1024,50,1074
公投第８案,新北市,新店區,國校里,1989,1082,418,137,555,24,579
公投第８案,新北市,新店區,國校里,1990,1235,501,162,663,51,714
公投第８案,新北市,新店區,文中里,1991,1568,714,158,872,38,910
公投第８案,新北市,新店區,廣明里,1992,771,304,111,415,39,454
公投第８案,新北市,新店區,文明里,1993,1256,487,163,650,44,694
公投第８案,新北市,新店區,文明里,1994,1008,436,112,548,53,601
公投第８案,新北市,新店區,中興里,1995,1515,697,133,830,50,880
公投第８案,新北市,新店區,中興里,1996,1637,772,186,958,56,1014
公投第８案,新北市,新店區,中興里,1997,1549,646,200,846,56,902
公投第８案,新北市,新店區,新生里,1998,2011,981,208,1189,62,1251
公投第８案,新北市,新店區,新生里,1999,1554,633,170,803,97,900
公投第８案,新北市,新店區,新生里,2000,1770,735,183,918,68,986
公投第８案,新北市,新店區,新德里,2001,1316,577,150,727,54,781
公投第８案,新北市,新店區,新德里,2002,1126,458,122,580,60,640
公投第８案,新北市,新店區,張北里,2003,1460,582,155,737,58,795
公投第８案,新北市,新店區,張北里,2004,1584,672,193,865,63,928
公投第８案,新北市,新店區,張北里,2005,1449,602,179,781,46,827
公投第８案,新北市,新店區,張北里,2006,1520,725,174,899,53,952
公投第８案,新北市,新店區,張北里,2007,1821,851,179,1030,41,1071
公投第８案,新北市,新店區,五峯里,2008,1956,800,249,1049,45,1094
公投第８案,新北市,新店區,五峯里,2009,1665,705,217,922,56,978
公投第８案,新北市,新店區,五峯里,2010,1588,742,169,911,53,964
公投第８案,新北市,新店區,五峯里,2011,1519,654,169,823,23,846
公投第８案,新北市,新店區,長春里,2012,1185,538,169,707,37,744
公投第８案,新北市,新店區,長春里,2013,1095,540,129,669,24,693
公投第８案,新北市,新店區,新安里,2014,1106,500,126,626,62,688
公投第８案,新北市,新店區,新安里,2015,2700,293,91,384,22,406
公投第８案,新北市,新店區,新安里,2016,995,444,116,560,27,587
公投第８案,新北市,新店區,新安里,2017,1168,498,128,626,45,671
公投第８案,新北市,新店區,忠誠里,2018,1123,575,122,697,62,759
公投第８案,新北市,新店區,忠誠里,2019,1085,515,141,656,46,702
公投第８案,新北市,新店區,中正里,2020,1412,656,166,822,58,880
公投第８案,新北市,新店區,中正里,2021,1659,720,177,897,61,958
公投第８案,新北市,新店區,中正里,2022,1198,608,112,720,51,771
公投第８案,新北市,新店區,中正里,2023,1376,564,145,709,35,744
公投第８案,新北市,新店區,中華里,2024,1300,549,122,671,39,710
公投第８案,新北市,新店區,中華里,2025,1238,536,141,677,49,726
公投第８案,新北市,新店區,中華里,2026,1388,659,134,793,31,824
公投第８案,新北市,新店區,仁愛里,2027,933,410,128,538,47,585
公投第８案,新北市,新店區,仁愛里,2028,908,434,109,543,38,581
公投第８案,新北市,新店區,建國里,2029,1582,669,181,850,61,911
公投第８案,新北市,新店區,建國里,2030,1247,590,137,727,49,776
公投第８案,新北市,新店區,百忍里,2031,971,436,101,537,66,603
公投第８案,新北市,新店區,百忍里,2032,1145,529,121,650,51,701
公投第８案,新北市,新店區,百忍里,2033,1392,640,141,781,55,836
公投第８案,新北市,新店區,百和里,2034,1452,689,171,860,57,917
公投第８案,新北市,新店區,百和里,2035,1440,607,174,781,53,834
公投第８案,新北市,新店區,福德里,2036,1786,729,201,930,88,1018
公投第８案,新北市,新店區,福德里,2037,1825,800,196,996,59,1055
公投第８案,新北市,新店區,百福里,2038,1477,687,164,851,33,884
公投第８案,新北市,新店區,百福里,2039,1750,869,102,971,59,1030
公投第８案,新北市,新店區,福民里,2040,1792,803,161,964,62,1026
公投第８案,新北市,新店區,福民里,2041,1979,883,164,1047,70,1117
公投第８案,新北市,新店區,中山里,2042,826,398,79,477,24,501
公投第８案,新北市,新店區,中山里,2043,1924,922,173,1095,46,1141
公投第８案,新北市,新店區,中山里,2044,1383,682,141,823,21,844
公投第８案,新北市,新店區,和平里,2045,830,307,79,386,39,425
公投第８案,新北市,新店區,中央里,2046,1759,841,179,1020,43,1063
公投第８案,新北市,新店區,中央里,2047,1957,941,184,1125,55,1180
公投第８案,新北市,新店區,中央里,2048,1481,704,157,861,37,898
公投第８案,新北市,新店區,國豐里,2049,1552,675,173,848,71,919
公投第８案,新北市,新店區,國豐里,2050,1467,614,152,766,76,842
公投第８案,新北市,新店區,明德里,2051,1371,601,146,747,50,797
公投第８案,新北市,新店區,明德里,2052,991,443,111,554,44,598
公投第８案,新北市,新店區,明德里,2053,1231,555,124,679,65,744
公投第８案,新北市,新店區,大豐里,2054,1701,733,199,932,64,996
公投第８案,新北市,新店區,大豐里,2055,1707,703,123,826,53,879
公投第８案,新北市,新店區,大同里,2056,1773,767,181,948,40,988
公投第８案,新北市,新店區,大同里,2057,1866,743,193,936,57,993
公投第８案,新北市,新店區,江陵里,2058,1735,768,211,979,51,1030
公投第８案,新北市,新店區,江陵里,2059,1632,763,215,978,57,1035
公投第８案,新北市,新店區,江陵里,2060,1591,731,157,888,60,948
公投第８案,新北市,新店區,復興里,2061,1495,585,159,744,72,816
公投第８案,新北市,新店區,復興里,2062,1511,597,125,722,28,750
公投第８案,新北市,新店區,寶興里,2063,1260,527,150,677,58,735
公投第８案,新北市,新店區,寶興里,2064,1948,922,201,1123,43,1166
公投第８案,新北市,新店區,寶興里,2065,1582,728,191,919,58,977
公投第８案,新北市,新店區,寶福里,2066,1315,545,172,717,49,766
公投第８案,新北市,新店區,寶福里,2067,1562,622,168,790,55,845
公投第８案,新北市,新店區,寶福里,2068,1982,953,174,1127,35,1162
公投第８案,新北市,新店區,寶福里,2069,1518,655,186,841,58,899
公投第８案,新北市,新店區,寶安里,2070,1735,763,171,934,33,967
公投第８案,新北市,新店區,寶安里,2071,1716,746,153,899,59,958
公投第８案,新北市,新店區,寶安里,2072,1580,685,178,863,61,924
公投第８案,新北市,新店區,信義里,2073,1358,623,170,793,50,843
公投第８案,新北市,新店區,信義里,2074,1610,696,216,912,90,1002
公投第８案,新北市,新店區,信義里,2075,1383,551,179,730,43,773
公投第８案,新北市,新店區,信義里,2076,1596,690,173,863,39,902
公投第８案,新北市,新店區,忠孝里,2077,1360,567,111,678,46,724
公投第８案,新北市,新店區,忠孝里,2078,1160,493,79,572,21,593
公投第８案,新北市,新店區,大鵬里,2079,1236,670,101,771,41,812
公投第８案,新北市,新店區,大鵬里,2080,1234,641,124,765,29,794
公投第８案,新北市,新店區,太平里,2081,1579,668,182,850,67,917
公投第８案,新北市,新店區,太平里,2082,1241,553,113,666,43,709
公投第８案,新北市,新店區,美城里,2083,1275,512,157,669,34,703
公投第８案,新北市,新店區,美城里,2084,1214,479,114,593,53,646
公投第８案,新北市,新店區,頂城里,2085,1578,545,171,716,72,788
公投第８案,新北市,新店區,下城里,2086,1442,582,165,747,48,795
公投第８案,新北市,新店區,下城里,2087,1475,540,169,709,80,789
公投第８案,新北市,新店區,柴埕里,2088,1580,689,183,872,54,926
公投第８案,新北市,新店區,柴埕里,2089,1585,621,170,791,44,835
公投第８案,新北市,新店區,柴埕里,2090,1586,621,191,812,76,888
公投第８案,新北市,新店區,柴埕里,2091,1931,797,202,999,74,1073
公投第８案,新北市,新店區,柴埕里,2092,1239,531,114,645,40,685
公投第８案,新北市,新店區,安和里,2093,1892,798,187,985,59,1044
公投第８案,新北市,新店區,安和里,2094,1529,567,165,732,60,792
公投第８案,新北市,新店區,安和里,2095,1358,620,109,729,59,788
公投第８案,新北市,新店區,安和里,2096,1905,710,214,924,46,970
公投第８案,新北市,新店區,永安里,2097,1885,766,164,930,59,989
公投第８案,新北市,新店區,永安里,2098,1345,522,142,664,69,733
公投第８案,新北市,新店區,永安里,2099,1387,565,165,730,64,794
公投第８案,新北市,新店區,新和里,2100,1960,800,202,1002,74,1076
公投第８案,新北市,新店區,新和里,2101,1837,758,191,949,78,1027
公投第８案,新北市,新店區,永平里,2102,1662,701,189,890,54,944
公投第８案,新北市,新店區,永平里,2103,1617,757,176,933,62,995
公投第８案,新北市,新店區,永平里,2104,1704,710,199,909,45,954
公投第８案,新北市,新店區,公崙里,2105,1835,703,207,910,77,987
公投第８案,新北市,新店區,公崙里,2106,2009,782,218,1000,84,1084
公投第８案,新北市,新店區,公崙里,2107,1450,578,173,751,61,812
公投第８案,新北市,新店區,公崙里,2108,1726,729,171,900,60,960
公投第８案,新北市,新店區,公崙里,2109,1797,724,179,903,69,972
公投第８案,新北市,新店區,公崙里,2110,1739,734,177,911,45,956
公投第８案,新北市,新店區,安昌里,2111,1523,657,155,812,34,846
公投第８案,新北市,新店區,安昌里,2112,1642,711,130,841,34,875
公投第８案,新北市,新店區,安昌里,2113,1644,723,158,881,25,906
公投第８案,新北市,新店區,德安里,2114,1662,609,176,785,44,829
公投第８案,新北市,新店區,德安里,2115,2067,875,242,1117,62,1179
公投第８案,新北市,新店區,德安里,2116,1870,606,182,788,48,836
公投第８案,新北市,新店區,達觀里,2117,1982,823,181,1004,64,1068
公投第８案,新北市,新店區,達觀里,2118,1546,679,141,820,38,858
公投第８案,新北市,新店區,明城里,2119,1712,799,194,993,41,1034
公投第８案,新北市,新店區,明城里,2120,1423,692,162,854,30,884
公投第８案,新北市,新店區,小城里,2121,1666,749,192,941,67,1008
公投第８案,新北市,新店區,小城里,2122,1769,843,176,1019,57,1076
公投第８案,新北市,新店區,雙城里,2123,1079,361,141,502,40,542
公投第８案,新北市,新店區,雙城里,2124,1140,428,134,562,26,588
公投第８案,新北市,新店區,雙城里,2125,1825,723,212,935,66,1001
公投第８案,新北市,新店區,雙城里,2126,1178,514,160,674,38,712
公投第８案,新北市,新店區,香坡里,2127,1463,591,155,746,48,794
公投第８案,新北市,新店區,香坡里,2128,1152,496,118,614,41,655
公投第８案,新北市,新店區,香坡里,2129,2008,734,161,895,41,936
公投第８案,新北市,新店區,香坡里,2130,2120,787,143,930,43,973
公投第８案,新北市,新店區,香坡里,2131,1153,553,106,659,16,675
公投第８案,新北市,新店區,香坡里,2132,1573,644,145,789,43,832
公投第８案,新北市,新店區,日興里,2133,1992,666,212,878,86,964
公投第８案,新北市,新店區,日興里,2134,1668,576,189,765,58,823
公投第８案,新北市,新店區,日興里,2135,1617,469,266,735,58,793
公投第８案,新北市,新店區,玫瑰里,2136,2013,786,196,982,97,1079
公投第８案,新北市,新店區,玫瑰里,2137,1791,785,184,969,59,1028
公投第８案,新北市,新店區,玫瑰里,2138,1624,694,174,868,50,918
公投第８案,新北市,新店區,吉祥里,2139,1178,568,117,685,28,713
公投第８案,新北市,新店區,吉祥里,2140,1277,596,118,714,33,747
公投第８案,新北市,新店區,吉祥里,2141,1879,819,177,996,67,1063
公投第８案,新北市,新店區,塗潭里,2142,939,291,117,408,27,435
公投第８案,新北市,新店區,華城里,2143,960,398,114,512,37,549
公投第８案,新北市,新店區,華城里,2144,1434,657,184,841,31,872
公投第８案,新北市,新店區,青潭里,2145,1838,773,112,885,66,951
公投第８案,新北市,新店區,青潭里,2146,1453,600,166,766,51,817
公投第８案,新北市,新店區,青潭里,2147,1549,602,164,766,63,829
公投第８案,新北市,新店區,美潭里,2148,1860,807,212,1019,53,1072
公投第８案,新北市,新店區,美潭里,2149,1743,658,158,816,44,860
公投第８案,新北市,新店區,美潭里,2150,1122,568,123,691,44,735
公投第８案,新北市,新店區,員潭里,2151,1468,628,143,771,40,811
公投第８案,新北市,新店區,員潭里,2152,1763,755,172,927,45,972
公投第８案,新北市,新店區,員潭里,2153,1344,507,159,666,49,715
公投第８案,新北市,新店區,雙坑里,2154,753,267,85,352,53,405
公投第８案,新北市,新店區,粗坑里,2155,602,206,84,290,10,300
公投第８案,新北市,新店區,粗坑里,2156,2237,817,274,1091,73,1164
公投第８案,新北市,新店區,屈尺里,2157,1096,416,136,552,34,586
公投第８案,新北市,新店區,屈尺里,2158,1143,363,116,479,58,537
公投第８案,新北市,新店區,龜山里,2159,1569,521,208,729,84,813
公投第８案,新北市,新店區,廣興里,2160,1284,465,161,626,70,696
公投第８案,新北市,新店區,直潭里,2161,439,84,37,121,15,136
公投第８案,新北市,新店區,直潭里,2162,750,271,121,392,42,434
公投第８案,新北市,深坑區,萬順里,2163,1142,418,134,552,37,589
公投第８案,新北市,深坑區,萬順里,2164,1139,456,159,615,53,668
公投第８案,新北市,深坑區,萬福里,2165,1065,366,145,511,60,571
公投第８案,新北市,深坑區,萬福里,2166,1400,511,148,659,57,716
公投第８案,新北市,深坑區,土庫里,2167,1330,482,135,617,57,674
公投第８案,新北市,深坑區,土庫里,2168,1380,490,149,639,46,685
公投第８案,新北市,深坑區,深坑里,2169,1496,497,137,634,28,662
公投第８案,新北市,深坑區,深坑里,2170,1508,618,173,791,71,862
公投第８案,新北市,深坑區,埔新里,2171,1624,647,208,855,69,924
公投第８案,新北市,深坑區,埔新里,2172,2165,853,245,1098,64,1162
公投第８案,新北市,深坑區,埔新里,2173,1790,743,235,978,73,1051
公投第８案,新北市,深坑區,昇高里,2174,782,274,84,358,21,379
公投第８案,新北市,深坑區,昇高里,2175,1164,508,131,639,30,669
公投第８案,新北市,深坑區,賴仲里,2176,1344,565,167,732,63,795
公投第８案,新北市,深坑區,賴仲里,2177,739,324,100,424,31,455
公投第８案,新北市,深坑區,阿柔里,2178,556,240,66,306,33,339
公投第８案,新北市,石碇區,石碇里,2179,391,160,58,218,22,240
公投第８案,新北市,石碇區,潭邊里,2180,789,276,75,351,47,398
公投第８案,新北市,石碇區,烏塗里,2181,662,187,63,250,26,276
公投第８案,新北市,石碇區,彭山里,2182,310,101,39,140,15,155
公投第８案,新北市,石碇區,豐田里,2183,280,101,34,135,13,148
公投第８案,新北市,石碇區,豐田里,2184,93,22,11,33,5,38
公投第８案,新北市,石碇區,隆盛里,2185,683,187,74,261,47,308
公投第８案,新北市,石碇區,豐林里,2186,323,152,41,193,9,202
公投第８案,新北市,石碇區,中民里,2187,726,177,69,246,9,255
公投第８案,新北市,石碇區,永定里,2188,591,193,88,281,34,315
公投第８案,新北市,石碇區,光明里,2189,282,114,51,165,24,189
公投第８案,新北市,石碇區,永安里,2190,788,232,65,297,16,313
公投第８案,新北市,石碇區,格頭里,2191,943,330,161,491,62,553
公投第８案,新北市,坪林區,坪林里,2192,1248,443,138,581,55,636
公投第８案,新北市,坪林區,水德里,2193,612,198,50,248,43,291
公投第８案,新北市,坪林區,大林里,2194,1141,412,134,546,104,650
公投第８案,新北市,坪林區,石𥕢里,2195,417,106,48,154,7,161
公投第８案,新北市,坪林區,粗窟里,2196,595,209,71,280,51,331
公投第８案,新北市,坪林區,粗窟里,2197,248,104,26,130,22,152
公投第８案,新北市,坪林區,上德里,2198,338,110,37,147,15,162
公投第８案,新北市,坪林區,上德里,2199,478,149,37,186,21,207
公投第８案,新北市,坪林區,漁光里,2200,390,102,34,136,11,147
公投第８案,新北市,坪林區,漁光里,2201,424,124,43,167,27,194
公投第８案,新北市,烏來區,忠治里,2202,1568,676,191,867,66,933
公投第８案,新北市,烏來區,烏來里,2203,1198,434,125,559,21,580
公投第８案,新北市,烏來區,烏來里,2204,1169,411,105,516,30,546
公投第８案,新北市,烏來區,孝義里,2205,228,87,22,109,4,113
公投第８案,新北市,烏來區,信賢里,2206,486,174,51,225,38,263
公投第８案,新北市,烏來區,福山里,2207,615,200,48,248,24,272
公投第８案,新北市,平溪區,薯榔里,2208,384,121,44,165,22,187
公投第８案,新北市,平溪區,菁桐里,2209,232,74,20,94,1,95
公投第８案,新北市,平溪區,白石里,2210,249,84,38,122,18,140
公投第８案,新北市,平溪區,石底里,2211,458,159,57,216,37,253
公投第８案,新北市,平溪區,平溪里,2212,232,78,32,110,19,129
公投第８案,新北市,平溪區,嶺腳里,2213,635,182,59,241,16,257
公投第８案,新北市,平溪區,東勢里,2214,427,148,46,194,42,236
公投第８案,新北市,平溪區,十分里,2215,862,233,67,300,43,343
公投第８案,新北市,平溪區,望古里,2216,147,52,17,69,4,73
公投第８案,新北市,平溪區,南山里,2217,365,96,24,120,15,135
公投第８案,新北市,平溪區,新寮里,2218,153,41,19,60,8,68
公投第８案,新北市,平溪區,平湖里,2219,177,65,24,89,20,109
公投第８案,新北市,瑞芳區,龍潭里,2220,725,302,82,384,35,419
公投第８案,新北市,瑞芳區,龍興里,2221,1074,431,120,551,53,604
公投第８案,新北市,瑞芳區,龍興里,2222,825,322,79,401,20,421
公投第８案,新北市,瑞芳區,龍鎮里,2223,1242,479,139,618,38,656
公投第８案,新北市,瑞芳區,龍安里,2224,598,241,56,297,31,328
公投第８案,新北市,瑞芳區,龍川里,2225,872,337,89,426,42,468
公投第８案,新北市,瑞芳區,龍川里,2226,760,254,73,327,39,366
公投第８案,新北市,瑞芳區,龍山里,2227,1330,463,119,582,37,619
公投第８案,新北市,瑞芳區,爪峯里,2228,1683,535,176,711,73,784
公投第８案,新北市,瑞芳區,爪峯里,2229,980,368,107,475,45,520
公投第８案,新北市,瑞芳區,爪峯里,2230,946,344,110,454,47,501
公投第８案,新北市,瑞芳區,新峰里,2231,1375,465,105,570,28,598
公投第８案,新北市,瑞芳區,新峰里,2232,1671,623,158,781,40,821
公投第８案,新北市,瑞芳區,東和里,2233,978,307,84,391,28,419
公投第８案,新北市,瑞芳區,東和里,2234,645,205,81,286,29,315
公投第８案,新北市,瑞芳區,柑坪里,2235,1089,372,131,503,59,562
公投第８案,新北市,瑞芳區,弓橋里,2236,286,84,22,106,15,121
公投第８案,新北市,瑞芳區,猴硐里,2237,461,147,52,199,31,230
公投第８案,新北市,瑞芳區,光復里,2238,274,91,24,115,22,137
公投第８案,新北市,瑞芳區,碩仁里,2239,155,60,22,82,11,93
公投第８案,新北市,瑞芳區,吉慶里,2240,817,316,94,410,40,450
公投第８案,新北市,瑞芳區,吉慶里,2241,884,326,89,415,55,470
公投第８案,新北市,瑞芳區,吉安里,2242,1333,442,142,584,49,633
公投第８案,新北市,瑞芳區,吉安里,2243,607,189,35,224,7,231
公投第８案,新北市,瑞芳區,吉安里,2244,1045,395,109,504,36,540
公投第８案,新北市,瑞芳區,上天里,2245,673,265,54,319,45,364
公投第８案,新北市,瑞芳區,上天里,2246,618,173,49,222,12,234
公投第８案,新北市,瑞芳區,傑魚里,2247,1063,379,92,471,25,496
公投第８案,新北市,瑞芳區,傑魚里,2248,860,321,97,418,47,465
公投第８案,新北市,瑞芳區,基山里,2249,432,102,23,125,6,131
公投第８案,新北市,瑞芳區,永慶里,2250,445,130,32,162,8,170
公投第８案,新北市,瑞芳區,崇文里,2251,318,106,19,125,9,134
公投第８案,新北市,瑞芳區,福住里,2252,159,53,14,67,10,77
公投第８案,新北市,瑞芳區,頌德里,2253,337,101,27,128,17,145
公投第８案,新北市,瑞芳區,瓜山里,2254,180,67,20,87,11,98
公投第８案,新北市,瑞芳區,銅山里,2255,187,56,10,66,15,81
公投第８案,新北市,瑞芳區,新山里,2256,369,128,39,167,24,191
公投第８案,新北市,瑞芳區,石山里,2257,335,115,47,162,24,186
公投第８案,新北市,瑞芳區,濓洞里,2258,470,131,51,182,18,200
公投第８案,新北市,瑞芳區,濓新里,2259,297,80,29,109,7,116
公投第８案,新北市,瑞芳區,南雅里,2260,267,133,28,161,3,164
公投第８案,新北市,瑞芳區,鼻頭里,2261,876,161,49,210,11,221
公投第８案,新北市,瑞芳區,海濱里,2262,1241,299,132,431,31,462
公投第８案,新北市,瑞芳區,瑞濱里,2263,998,310,158,468,62,530
公投第８案,新北市,瑞芳區,瑞濱里,2264,948,295,155,450,50,500
公投第８案,新北市,瑞芳區,深澳里,2265,1308,335,162,497,24,521
公投第８案,新北市,雙溪區,雙溪里,2266,455,158,36,194,21,215
公投第８案,新北市,雙溪區,新基里,2267,286,99,35,134,14,148
公投第８案,新北市,雙溪區,新基里,2268,496,191,57,248,27,275
公投第８案,新北市,雙溪區,三港里,2269,383,116,31,147,13,160
公投第８案,新北市,雙溪區,牡丹里,2270,887,254,78,332,45,377
公投第８案,新北市,雙溪區,牡丹里,2271,652,189,53,242,34,276
公投第８案,新北市,雙溪區,三貂里,2272,333,119,31,150,17,167
公投第８案,新北市,雙溪區,平林里,2273,642,216,75,291,29,320
公投第８案,新北市,雙溪區,平林里,2274,282,83,37,120,14,134
公投第８案,新北市,雙溪區,上林里,2275,621,176,61,237,32,269
公投第８案,新北市,雙溪區,外柑里,2276,422,119,36,155,11,166
公投第８案,新北市,雙溪區,長源里,2277,369,70,35,105,29,134
公投第８案,新北市,雙溪區,共和里,2278,120,48,7,55,10,65
公投第８案,新北市,雙溪區,共和里,2279,271,92,24,116,18,134
公投第８案,新北市,雙溪區,魚行里,2280,362,142,43,185,27,212
公投第８案,新北市,雙溪區,魚行里,2281,371,118,41,159,34,193
公投第８案,新北市,雙溪區,泰平里,2282,1047,409,134,543,65,608
公投第８案,新北市,貢寮區,貢寮里,2283,876,307,84,391,44,435
公投第８案,新北市,貢寮區,龍崗里,2284,433,142,49,191,27,218
公投第８案,新北市,貢寮區,吉林里,2285,516,142,38,180,16,196
公投第８案,新北市,貢寮區,雙玉里,2286,373,91,34,125,26,151
公投第８案,新北市,貢寮區,雙玉里,2287,313,89,32,121,28,149
公投第８案,新北市,貢寮區,福連里,2288,485,173,48,221,14,235
公投第８案,新北市,貢寮區,福連里,2289,415,122,54,176,34,210
公投第８案,新北市,貢寮區,福隆里,2290,812,224,83,307,17,324
公投第８案,新北市,貢寮區,福隆里,2291,861,259,106,365,47,412
公投第８案,新北市,貢寮區,龍門里,2292,676,151,79,230,31,261
公投第８案,新北市,貢寮區,真理里,2293,1091,254,108,362,25,387
公投第８案,新北市,貢寮區,真理里,2294,955,239,95,334,52,386
公投第８案,新北市,貢寮區,仁里里,2295,769,206,64,270,10,280
公投第８案,新北市,貢寮區,仁里里,2296,962,294,132,426,38,464
公投第８案,新北市,貢寮區,美豐里,2297,390,133,47,180,11,191
公投第８案,新北市,貢寮區,美豐里,2298,349,110,36,146,1,147
公投第８案,新北市,貢寮區,和美里,2299,508,124,42,166,31,197
公投第８案,新北市,貢寮區,和美里,2300,495,111,36,147,14,161
公投第８案,新北市,金山區,和平里,2301,481,184,43,227,35,262
公投第８案,新北市,金山區,大同里,2302,715,245,99,344,35,379
公投第８案,新北市,金山區,豐漁里,2303,481,137,47,184,30,214
公投第８案,新北市,金山區,磺港里,2304,1792,581,167,748,78,826
公投第８案,新北市,金山區,美田里,2305,1781,621,203,824,85,909
公投第８案,新北市,金山區,美田里,2306,2010,753,236,989,81,1070
公投第８案,新北市,金山區,金美里,2307,1572,522,183,705,60,765
公投第８案,新北市,金山區,金美里,2308,1777,634,188,822,85,907
公投第８案,新北市,金山區,金美里,2309,1631,551,154,705,69,774
公投第８案,新北市,金山區,五湖里,2310,828,313,83,396,36,432
公投第８案,新北市,金山區,五湖里,2311,888,303,118,421,29,450
公投第８案,新北市,金山區,重和里,2312,1211,397,125,522,85,607
公投第８案,新北市,金山區,兩湖里,2313,416,170,51,221,18,239
公投第８案,新北市,金山區,六股里,2314,682,260,91,351,47,398
公投第８案,新北市,金山區,三界里,2315,644,227,64,291,57,348
公投第８案,新北市,金山區,清泉里,2316,830,281,90,371,38,409
公投第８案,新北市,金山區,西湖里,2317,188,59,28,87,12,99
公投第８案,新北市,金山區,萬壽里,2318,469,163,67,230,29,259
公投第８案,新北市,金山區,永興里,2319,582,134,45,179,34,213
公投第８案,新北市,萬里區,萬里里,2320,1286,504,147,651,43,694
公投第８案,新北市,萬里區,萬里里,2321,1576,601,194,795,65,860
公投第８案,新北市,萬里區,萬里里,2322,1447,496,141,637,52,689
公投第８案,新北市,萬里區,北基里,2323,1466,465,129,594,75,669
公投第８案,新北市,萬里區,北基里,2324,1369,400,128,528,58,586
公投第８案,新北市,萬里區,龜吼里,2325,1215,315,101,416,59,475
公投第８案,新北市,萬里區,龜吼里,2326,1317,484,143,627,59,686
公投第８案,新北市,萬里區,野柳里,2327,1676,510,134,644,73,717
公投第８案,新北市,萬里區,野柳里,2328,1550,515,143,658,81,739
公投第８案,新北市,萬里區,大鵬里,2329,945,391,134,525,55,580
公投第８案,新北市,萬里區,大鵬里,2330,1760,659,214,873,82,955
公投第８案,新北市,萬里區,磺潭里,2331,570,204,58,262,24,286
公投第８案,新北市,萬里區,雙興里,2332,952,275,127,402,41,443
公投第８案,新北市,萬里區,溪底里,2333,674,247,85,332,63,395
公投第８案,新北市,萬里區,崁脚里,2334,405,144,45,189,19,208
公投第８案,新北市,萬里區,中幅里,2335,1089,369,116,485,65,550
公投第８案,新北市,汐止區,仁德里,2336,1595,598,170,768,87,855
公投第８案,新北市,汐止區,義民里,2337,1262,515,138,653,53,706
公投第８案,新北市,汐止區,禮門里,2338,917,352,119,471,70,541
公投第８案,新北市,汐止區,智慧里,2339,1929,774,226,1000,66,1066
公投第８案,新北市,汐止區,智慧里,2340,2227,844,257,1101,77,1178
公投第８案,新北市,汐止區,大同里,2341,1143,409,174,583,62,645
公投第８案,新北市,汐止區,大同里,2342,1367,554,155,709,43,752
公投第８案,新北市,汐止區,信望里,2343,322,110,42,152,21,173
公投第８案,新北市,汐止區,新昌里,2344,1460,576,200,776,4,780
公投第８案,新北市,汐止區,新昌里,2345,1719,593,211,804,71,875
公投第８案,新北市,汐止區,新昌里,2346,1661,589,173,762,65,827
公投第８案,新北市,汐止區,福安里,2347,1590,644,183,827,73,900
公投第８案,新北市,汐止區,福安里,2348,1599,645,171,816,55,871
公投第８案,新北市,汐止區,福安里,2349,1749,718,185,903,66,969
公投第８案,新北市,汐止區,秀峰里,2350,1809,225,101,326,30,356
公投第８案,新北市,汐止區,秀峰里,2351,1601,524,172,696,34,730
公投第８案,新北市,汐止區,秀峰里,2352,1387,527,140,667,71,738
公投第８案,新北市,汐止區,秀山里,2353,1779,679,321,1000,94,1094
公投第８案,新北市,汐止區,秀山里,2354,2074,851,228,1079,77,1156
公投第８案,新北市,汐止區,復興里,2355,2072,824,232,1056,54,1110
公投第８案,新北市,汐止區,復興里,2356,2120,884,280,1164,65,1229
公投第８案,新北市,汐止區,復興里,2357,1952,674,231,905,45,950
公投第８案,新北市,汐止區,自強里,2358,1654,610,190,800,78,878
公投第８案,新北市,汐止區,自強里,2359,1444,527,162,689,68,757
公投第８案,新北市,汐止區,自強里,2360,1627,700,210,910,51,961
公投第８案,新北市,汐止區,文化里,2361,1751,639,206,845,64,909
公投第８案,新北市,汐止區,文化里,2362,2066,824,210,1034,49,1083
公投第８案,新北市,汐止區,白雲里,2363,1941,651,160,811,58,869
公投第８案,新北市,汐止區,白雲里,2364,1906,666,194,860,51,911
公投第８案,新北市,汐止區,茄苳里,2365,1363,468,179,647,71,718
公投第８案,新北市,汐止區,茄苳里,2366,1368,459,176,635,58,693
公投第８案,新北市,汐止區,茄苳里,2367,1233,407,153,560,51,611
公投第８案,新北市,汐止區,崇德里,2368,1554,579,152,731,32,763
公投第８案,新北市,汐止區,崇德里,2369,1700,616,187,803,40,843
公投第８案,新北市,汐止區,崇德里,2370,1124,475,123,598,30,628
公投第８案,新北市,汐止區,城中里,2371,1900,773,225,998,85,1083
公投第８案,新北市,汐止區,城中里,2372,2050,826,201,1027,65,1092
公投第８案,新北市,汐止區,橋東里,2373,1244,459,145,604,59,663
公投第８案,新北市,汐止區,橋東里,2374,1320,471,147,618,43,661
公投第８案,新北市,汐止區,建成里,2375,1473,594,179,773,52,825
公投第８案,新北市,汐止區,建成里,2376,1802,730,192,922,70,992
公投第８案,新北市,汐止區,建成里,2377,1266,580,114,694,44,738
公投第８案,新北市,汐止區,長安里,2378,1481,505,169,674,65,739
公投第８案,新北市,汐止區,保安里,2379,1497,533,169,702,70,772
公投第８案,新北市,汐止區,東山里,2380,556,224,60,284,19,303
公投第８案,新北市,汐止區,保長里,2381,1913,698,195,893,63,956
公投第８案,新北市,汐止區,保長里,2382,2027,769,189,958,55,1013
公投第８案,新北市,汐止區,保新里,2383,1927,718,188,906,38,944
公投第８案,新北市,汐止區,保新里,2384,696,245,98,343,46,389
公投第８案,新北市,汐止區,鄉長里,2385,2127,764,213,977,73,1050
公投第８案,新北市,汐止區,江北里,2386,1642,548,161,709,56,765
公投第８案,新北市,汐止區,江北里,2387,1912,671,234,905,91,996
公投第８案,新北市,汐止區,江北里,2388,1893,634,191,825,51,876
公投第８案,新北市,汐止區,拱北里,2389,1466,481,154,635,76,711
公投第８案,新北市,汐止區,拱北里,2390,1538,552,155,707,83,790
公投第８案,新北市,汐止區,拱北里,2391,1550,568,162,730,52,782
公投第８案,新北市,汐止區,烘內里,2392,1456,509,151,660,72,732
公投第８案,新北市,汐止區,八連里,2393,947,403,111,514,58,572
公投第８案,新北市,汐止區,長青里,2394,923,360,123,483,27,510
公投第８案,新北市,汐止區,北峰里,2395,2043,673,225,898,128,1026
公投第８案,新北市,汐止區,北峰里,2396,2012,630,247,877,81,958
公投第８案,新北市,汐止區,金龍里,2397,1471,500,125,625,40,665
公投第８案,新北市,汐止區,金龍里,2398,1603,582,169,751,63,814
公投第８案,新北市,汐止區,金龍里,2399,1530,586,179,765,59,824
公投第８案,新北市,汐止區,樟樹里,2400,1988,604,206,810,43,853
公投第８案,新北市,汐止區,忠孝里,2401,2198,802,232,1034,55,1089
公投第８案,新北市,汐止區,忠孝里,2402,1712,628,177,805,61,866
公投第８案,新北市,汐止區,忠孝里,2403,1806,730,201,931,74,1005
公投第８案,新北市,汐止區,忠孝里,2404,1576,597,171,768,77,845
公投第８案,新北市,汐止區,厚德里,2405,1511,581,161,742,34,776
公投第８案,新北市,汐止區,厚德里,2406,1691,591,171,762,38,800
公投第８案,新北市,汐止區,厚德里,2407,1636,641,174,815,51,866
公投第８案,新北市,汐止區,厚德里,2408,1676,626,172,798,63,861
公投第８案,新北市,汐止區,山光里,2409,1264,479,125,604,50,654
公投第８案,新北市,汐止區,山光里,2410,1165,435,125,560,39,599
公投第８案,新北市,汐止區,中興里,2411,1765,631,198,829,59,888
公投第８案,新北市,汐止區,中興里,2412,1815,571,175,746,43,789
公投第８案,新北市,汐止區,中興里,2413,1778,603,205,808,71,879
公投第８案,新北市,汐止區,中興里,2414,1580,619,171,790,82,872
公投第８案,新北市,汐止區,福德里,2415,1516,569,183,752,54,806
公投第８案,新北市,汐止區,福德里,2416,1425,496,154,650,60,710
公投第８案,新北市,汐止區,興福里,2417,1388,557,157,714,44,758
公投第８案,新北市,汐止區,興福里,2418,1436,530,182,712,64,776
公投第８案,新北市,汐止區,康福里,2419,1591,611,184,795,44,839
公投第８案,新北市,汐止區,康福里,2420,1639,607,163,770,41,811
公投第８案,新北市,汐止區,康福里,2421,1394,516,142,658,26,684
公投第８案,新北市,汐止區,湖光里,2422,2035,701,227,928,58,986
公投第８案,新北市,汐止區,湖光里,2423,1895,688,198,886,69,955
公投第８案,新北市,汐止區,湖光里,2424,1374,622,130,752,22,774
公投第８案,新北市,汐止區,湖蓮里,2425,1061,484,116,600,26,626
公投第８案,新北市,汐止區,湖蓮里,2426,1312,651,147,798,30,828
公投第８案,新北市,汐止區,湖興里,2427,1548,635,173,808,45,853
公投第８案,新北市,汐止區,湖興里,2428,1350,587,153,740,33,773
公投第８案,新北市,汐止區,湖興里,2429,1499,599,176,775,39,814
公投第８案,新北市,汐止區,湖興里,2430,1366,556,158,714,72,786
公投第８案,新北市,汐止區,北山里,2431,1335,542,153,695,70,765
公投第８案,新北市,汐止區,北山里,2432,1324,597,149,746,61,807
公投第８案,新北市,汐止區,北山里,2433,1286,534,161,695,86,781
公投第８案,新北市,汐止區,北山里,2434,1155,439,147,586,50,636
公投第８案,新北市,汐止區,忠山里,2435,1682,767,219,986,49,1035
公投第８案,新北市,汐止區,忠山里,2436,1494,693,174,867,64,931
公投第８案,新北市,汐止區,環河里,2437,1166,443,186,629,68,697
公投第８案,新北市,汐止區,橫科里,2438,2184,816,263,1079,124,1203
公投第８案,新北市,汐止區,橫科里,2439,2031,780,229,1009,95,1104
公投第８案,新北市,汐止區,福山里,2440,1759,688,203,891,81,972
公投第８案,新北市,汐止區,福山里,2441,1577,637,194,831,61,892
公投第８案,新北市,汐止區,宜興里,2442,1364,534,159,693,18,711
公投第８案,新北市,汐止區,宜興里,2443,1401,582,161,743,42,785
公投第８案,新北市,汐止區,東勢里,2444,1173,482,159,641,52,693
公投第８案,新北市,汐止區,東勢里,2445,993,456,98,554,26,580
公投第８案,新北市,汐止區,東勢里,2446,1587,634,162,796,36,832
公投第８案,臺中市,大甲區,朝陽里,1,1356,541,177,718,88,806
公投第８案,臺中市,大甲區,大甲里,2,1059,479,124,603,58,661
公投第８案,臺中市,大甲區,順天里,3,694,302,99,401,37,438
公投第８案,臺中市,大甲區,順天里,4,874,346,141,487,31,518
公投第８案,臺中市,大甲區,孔門里,5,763,297,98,395,34,429
公投第８案,臺中市,大甲區,平安里,6,856,379,121,500,47,547
公投第８案,臺中市,大甲區,平安里,7,1249,555,130,685,58,743
公投第８案,臺中市,大甲區,庄美里,8,922,346,115,461,35,496
公投第８案,臺中市,大甲區,庄美里,9,1189,488,154,642,47,689
公投第８案,臺中市,大甲區,新美里,10,1065,501,115,616,67,683
公投第８案,臺中市,大甲區,新美里,11,1252,550,155,705,99,804
公投第８案,臺中市,大甲區,新美里,12,1057,419,126,545,58,603
公投第８案,臺中市,大甲區,岷山里,13,1031,413,144,557,35,592
公投第８案,臺中市,大甲區,岷山里,14,1060,453,150,603,66,669
公投第８案,臺中市,大甲區,中山里,15,1311,533,165,698,67,765
公投第８案,臺中市,大甲區,中山里,16,1424,627,138,765,55,820
公投第８案,臺中市,大甲區,中山里,17,1670,691,209,900,82,982
公投第８案,臺中市,大甲區,南陽里,18,812,340,86,426,48,474
公投第８案,臺中市,大甲區,薰風里,19,863,369,106,475,31,506
公投第８案,臺中市,大甲區,義和里,20,1598,680,204,884,64,948
公投第８案,臺中市,大甲區,義和里,21,1588,672,179,851,55,906
公投第８案,臺中市,大甲區,武陵里,22,1197,462,164,626,69,695
公投第８案,臺中市,大甲區,文曲里,23,1106,388,128,516,101,617
公投第８案,臺中市,大甲區,武曲里,24,903,385,118,503,70,573
公投第８案,臺中市,大甲區,武曲里,25,869,370,124,494,47,541
公投第８案,臺中市,大甲區,文武里,26,1350,553,184,737,44,781
公投第８案,臺中市,大甲區,文武里,27,1144,428,149,577,102,679
公投第８案,臺中市,大甲區,文武里,28,1208,533,149,682,59,741
公投第８案,臺中市,大甲區,文武里,29,1567,646,215,861,46,907
公投第８案,臺中市,大甲區,奉化里,30,1246,574,172,746,45,791
公投第８案,臺中市,大甲區,奉化里,31,767,314,106,420,47,467
公投第８案,臺中市,大甲區,德化里,32,790,329,104,433,47,480
公投第８案,臺中市,大甲區,德化里,33,972,446,91,537,42,579
公投第８案,臺中市,大甲區,江南里,34,1388,551,148,699,64,763
公投第８案,臺中市,大甲區,頂店里,35,1331,508,166,674,37,711
公投第８案,臺中市,大甲區,頂店里,36,1167,512,160,672,53,725
公投第８案,臺中市,大甲區,頂店里,37,1934,843,201,1044,62,1106
公投第８案,臺中市,大甲區,太白里,38,1263,470,132,602,58,660
公投第８案,臺中市,大甲區,孟春里,39,1390,656,74,730,61,791
公投第８案,臺中市,大甲區,孟春里,40,1186,396,121,517,40,557
公投第８案,臺中市,大甲區,孟春里,41,1397,565,167,732,39,771
公投第８案,臺中市,大甲區,幸福里,42,1173,360,112,472,24,496
公投第８案,臺中市,大甲區,幸福里,43,1398,531,156,687,82,769
公投第８案,臺中市,大甲區,日南里,44,1228,431,147,578,61,639
公投第８案,臺中市,大甲區,日南里,45,1258,484,138,622,58,680
公投第８案,臺中市,大甲區,日南里,46,1435,469,271,740,51,791
公投第８案,臺中市,大甲區,日南里,47,1532,579,203,782,61,843
公投第８案,臺中市,大甲區,龍泉里,48,652,258,75,333,43,376
公投第８案,臺中市,大甲區,龍泉里,49,870,283,96,379,43,422
公投第８案,臺中市,大甲區,西岐里,50,891,329,100,429,31,460
公投第８案,臺中市,大甲區,西岐里,51,784,326,92,418,33,451
公投第８案,臺中市,大甲區,銅安里,52,1368,488,166,654,95,749
公投第８案,臺中市,大甲區,福德里,53,1126,426,117,543,58,601
公投第８案,臺中市,大甲區,建興里,54,1486,510,138,648,83,731
公投第８案,臺中市,大安區,南埔里,55,1068,399,101,500,70,570
公投第８案,臺中市,大安區,南庄里,56,1050,428,110,538,75,613
公投第８案,臺中市,大安區,中庄里,57,1246,502,170,672,80,752
公投第８案,臺中市,大安區,中庄里,58,1397,539,173,712,66,778
公投第８案,臺中市,大安區,東安里,59,1227,511,177,688,71,759
公投第８案,臺中市,大安區,福興里,60,1170,481,130,611,77,688
公投第８案,臺中市,大安區,龜壳里,61,914,428,108,536,59,595
公投第８案,臺中市,大安區,龜壳里,62,667,241,57,298,47,345
公投第８案,臺中市,大安區,頂安里,63,890,347,79,426,60,486
公投第８案,臺中市,大安區,永安里,64,1289,502,145,647,83,730
公投第８案,臺中市,大安區,永安里,65,455,155,51,206,35,241
公投第８案,臺中市,大安區,福住里,66,1028,425,120,545,42,587
公投第８案,臺中市,大安區,海墘里,67,1446,603,167,770,90,860
公投第８案,臺中市,大安區,西安里,68,688,340,69,409,37,446
公投第８案,臺中市,大安區,西安里,69,1062,456,124,580,70,650
公投第８案,臺中市,大安區,松雅里,70,923,406,140,546,48,594
公投第８案,臺中市,外埔區,永豐里,71,1059,416,118,534,66,600
公投第８案,臺中市,外埔區,六分里,72,1013,440,120,560,28,588
公投第８案,臺中市,外埔區,六分里,73,1150,528,116,644,68,712
公投第８案,臺中市,外埔區,大同里,74,1855,904,202,1106,72,1178
公投第８案,臺中市,外埔區,大同里,75,1327,587,166,753,41,794
公投第８案,臺中市,外埔區,大同里,76,1453,652,170,822,54,876
公投第８案,臺中市,外埔區,大東里,77,1653,686,155,841,85,926
公投第８案,臺中市,外埔區,大東里,78,1615,637,180,817,56,873
公投第８案,臺中市,外埔區,大東里,79,1470,555,171,726,47,773
公投第８案,臺中市,外埔區,大東里,80,1559,633,203,836,78,914
公投第８案,臺中市,外埔區,三崁里,81,1902,739,222,961,109,1070
公投第８案,臺中市,外埔區,水美里,82,1138,515,154,669,62,731
公投第８案,臺中市,外埔區,水美里,83,1065,465,132,597,82,679
公投第８案,臺中市,外埔區,水美里,84,1243,567,158,725,52,777
公投第８案,臺中市,外埔區,鐵山里,85,962,375,105,480,49,529
公投第８案,臺中市,外埔區,鐵山里,86,1169,472,120,592,61,653
公投第８案,臺中市,外埔區,中山里,87,1216,558,157,715,65,780
公投第８案,臺中市,外埔區,馬鳴里,88,1391,562,141,703,68,771
公投第８案,臺中市,外埔區,土城里,89,1616,602,205,807,99,906
公投第８案,臺中市,外埔區,廍子里,90,1203,397,104,501,52,553
公投第８案,臺中市,清水區,鰲峰里,91,1076,422,131,553,26,579
公投第８案,臺中市,清水區,靈泉里,92,953,433,137,570,56,626
公投第８案,臺中市,清水區,清水里,93,914,373,138,511,56,567
公投第８案,臺中市,清水區,清水里,94,1143,523,154,677,54,731
公投第８案,臺中市,清水區,文昌里,95,680,295,96,391,34,425
公投第８案,臺中市,清水區,南寧里,96,904,394,117,511,53,564
公投第８案,臺中市,清水區,南寧里,97,893,391,128,519,54,573
公投第８案,臺中市,清水區,西寧里,98,1577,621,232,853,63,916
公投第８案,臺中市,清水區,北寧里,99,690,280,87,367,36,403
公投第８案,臺中市,清水區,中興里,100,403,161,63,224,22,246
公投第８案,臺中市,清水區,西社里,101,1413,603,174,777,66,843
公投第８案,臺中市,清水區,西社里,102,777,308,94,402,56,458
公投第８案,臺中市,清水區,南社里,103,1313,571,177,748,45,793
公投第８案,臺中市,清水區,南社里,104,1439,629,197,826,64,890
公投第８案,臺中市,清水區,南社里,105,1265,490,162,652,29,681
公投第８案,臺中市,清水區,南社里,106,1277,599,164,763,32,795
公投第８案,臺中市,清水區,南社里,107,1276,572,143,715,53,768
公投第８案,臺中市,清水區,南社里,108,1376,642,184,826,39,865
公投第８案,臺中市,清水區,南社里,109,1291,601,161,762,38,800
公投第８案,臺中市,清水區,裕嘉里,110,1510,651,192,843,75,918
公投第８案,臺中市,清水區,臨江里,111,1524,649,177,826,80,906
公投第８案,臺中市,清水區,秀水里,112,1474,574,160,734,49,783
公投第８案,臺中市,清水區,秀水里,113,1507,615,188,803,55,858
公投第８案,臺中市,清水區,秀水里,114,1321,590,182,772,89,861
公投第８案,臺中市,清水區,武鹿里,115,1157,424,144,568,35,603
公投第８案,臺中市,清水區,武鹿里,116,1255,563,150,713,43,756
公投第８案,臺中市,清水區,武鹿里,117,881,354,105,459,39,498
公投第８案,臺中市,清水區,海濱里,118,1083,493,115,608,61,669
公投第８案,臺中市,清水區,海濱里,119,951,437,112,549,29,578
公投第８案,臺中市,清水區,槺榔里,120,1424,571,140,711,71,782
公投第８案,臺中市,清水區,槺榔里,121,1233,443,170,613,62,675
公投第８案,臺中市,清水區,槺榔里,122,1288,423,184,607,22,629
公投第８案,臺中市,清水區,槺榔里,123,1200,517,144,661,62,723
公投第８案,臺中市,清水區,中社里,124,1609,782,132,914,45,959
公投第８案,臺中市,清水區,中社里,125,1136,510,162,672,37,709
公投第８案,臺中市,清水區,高西里,126,1302,531,116,647,78,725
公投第８案,臺中市,清水區,高南里,127,1373,553,135,688,88,776
公投第８案,臺中市,清水區,高東里,128,1257,443,137,580,76,656
公投第８案,臺中市,清水區,高北里,129,1184,423,126,549,62,611
公投第８案,臺中市,清水區,高美里,130,1322,534,135,669,73,742
公投第８案,臺中市,清水區,國姓里,131,1193,435,151,586,45,631
公投第８案,臺中市,清水區,國姓里,132,927,353,125,478,74,552
公投第８案,臺中市,清水區,菁埔里,133,1073,464,141,605,64,669
公投第８案,臺中市,清水區,菁埔里,134,1163,476,156,632,87,719
公投第８案,臺中市,清水區,頂湳里,135,855,323,92,415,62,477
公投第８案,臺中市,清水區,頂湳里,136,902,307,118,425,75,500
公投第８案,臺中市,清水區,田寮里,137,1415,579,167,746,70,816
公投第８案,臺中市,清水區,田寮里,138,1066,402,138,540,38,578
公投第８案,臺中市,清水區,橋頭里,139,1391,535,176,711,68,779
公投第８案,臺中市,清水區,橋頭里,140,1449,547,181,728,37,765
公投第８案,臺中市,清水區,橋頭里,141,1377,571,189,760,67,827
公投第８案,臺中市,清水區,橋頭里,142,1423,593,180,773,65,838
公投第８案,臺中市,清水區,橋頭里,143,1624,663,218,881,56,937
公投第８案,臺中市,清水區,下湳里,144,1358,515,158,673,81,754
公投第８案,臺中市,清水區,下湳里,145,1464,600,149,749,99,848
公投第８案,臺中市,清水區,東山里,146,1211,515,157,672,72,744
公投第８案,臺中市,清水區,吳厝里,147,1456,584,145,729,36,765
公投第８案,臺中市,清水區,楊厝里,148,1162,514,130,644,81,725
公投第８案,臺中市,清水區,海風里,149,1368,640,144,784,89,873
公投第８案,臺中市,梧棲區,頂寮里,150,1541,600,201,801,67,868
公投第８案,臺中市,梧棲區,頂寮里,151,1581,617,197,814,65,879
公投第８案,臺中市,梧棲區,下寮里,152,1083,423,156,579,57,636
公投第８案,臺中市,梧棲區,下寮里,153,876,383,112,495,33,528
公投第８案,臺中市,梧棲區,中正里,154,1043,406,148,554,63,617
公投第８案,臺中市,梧棲區,中正里,155,1502,563,177,740,45,785
公投第８案,臺中市,梧棲區,中正里,156,1384,595,158,753,43,796
公投第８案,臺中市,梧棲區,中和里,157,517,221,96,317,38,355
公投第８案,臺中市,梧棲區,文化里,158,1169,537,143,680,65,745
公投第８案,臺中市,梧棲區,安仁里,159,863,343,144,487,37,524
公投第８案,臺中市,梧棲區,草湳里,160,1277,468,125,593,48,641
公投第８案,臺中市,梧棲區,草湳里,161,1742,632,245,877,61,938
公投第８案,臺中市,梧棲區,草湳里,162,1342,499,225,724,63,787
公投第８案,臺中市,梧棲區,草湳里,163,1767,687,244,931,90,1021
公投第８案,臺中市,梧棲區,南簡里,164,1542,540,182,722,70,792
公投第８案,臺中市,梧棲區,南簡里,165,1636,616,217,833,64,897
公投第８案,臺中市,梧棲區,南簡里,166,1796,643,213,856,82,938
公投第８案,臺中市,梧棲區,福德里,167,1450,573,156,729,68,797
公投第８案,臺中市,梧棲區,福德里,168,1548,555,170,725,124,849
公投第８案,臺中市,梧棲區,福德里,169,1366,567,184,751,51,802
公投第８案,臺中市,梧棲區,大庄里,170,955,467,110,577,32,609
公投第８案,臺中市,梧棲區,大庄里,171,1305,502,154,656,60,716
公投第８案,臺中市,梧棲區,大庄里,172,1239,515,169,684,45,729
公投第８案,臺中市,梧棲區,大庄里,173,1079,483,112,595,72,667
公投第８案,臺中市,梧棲區,大庄里,174,1220,539,91,630,49,679
公投第８案,臺中市,梧棲區,大庄里,175,1544,656,195,851,77,928
公投第８案,臺中市,梧棲區,大村里,176,1460,613,204,817,61,878
公投第８案,臺中市,梧棲區,大村里,177,1292,566,157,723,61,784
公投第８案,臺中市,梧棲區,大村里,178,1300,529,148,677,62,739
公投第８案,臺中市,梧棲區,大村里,179,1555,558,205,763,72,835
公投第８案,臺中市,梧棲區,興農里,180,1031,414,112,526,47,573
公投第８案,臺中市,梧棲區,興農里,181,1277,548,148,696,70,766
公投第８案,臺中市,梧棲區,永寧里,182,1037,387,137,524,49,573
公投第８案,臺中市,梧棲區,永寧里,183,1187,479,157,636,70,706
公投第８案,臺中市,梧棲區,永安里,184,1399,541,155,696,55,751
公投第８案,臺中市,梧棲區,永安里,185,1135,461,132,593,47,640
公投第８案,臺中市,沙鹿區,居仁里,186,1380,544,132,676,60,736
公投第８案,臺中市,沙鹿區,洛泉里,187,852,358,115,473,47,520
公投第８案,臺中市,沙鹿區,洛泉里,188,1176,525,164,689,38,727
公投第８案,臺中市,沙鹿區,沙鹿里,189,958,406,158,564,81,645
公投第８案,臺中市,沙鹿區,美仁里,190,488,236,71,307,30,337
公投第８案,臺中市,沙鹿區,興仁里,191,1177,467,177,644,44,688
公投第８案,臺中市,沙鹿區,興仁里,192,1285,492,174,666,68,734
公投第８案,臺中市,沙鹿區,興安里,193,1736,607,235,842,99,941
公投第８案,臺中市,沙鹿區,興安里,194,1628,687,224,911,84,995
公投第８案,臺中市,沙鹿區,斗抵里,195,1469,574,176,750,37,787
公投第８案,臺中市,沙鹿區,斗抵里,196,1423,633,197,830,42,872
公投第８案,臺中市,沙鹿區,斗抵里,197,1444,588,189,777,85,862
公投第８案,臺中市,沙鹿區,鹿峰里,198,1469,586,186,772,89,861
公投第８案,臺中市,沙鹿區,鹿峰里,199,1902,748,252,1000,97,1097
公投第８案,臺中市,沙鹿區,鹿峰里,200,1675,707,216,923,64,987
公投第８案,臺中市,沙鹿區,鹿寮里,201,1098,431,143,574,61,635
公投第８案,臺中市,沙鹿區,鹿寮里,202,1539,628,229,857,75,932
公投第８案,臺中市,沙鹿區,鹿寮里,203,1329,569,178,747,40,787
公投第８案,臺中市,沙鹿區,鹿寮里,204,1255,458,177,635,54,689
公投第８案,臺中市,沙鹿區,鹿寮里,205,1507,622,205,827,60,887
公投第８案,臺中市,沙鹿區,竹林里,206,1463,598,173,771,95,866
公投第８案,臺中市,沙鹿區,竹林里,207,1279,476,151,627,80,707
公投第８案,臺中市,沙鹿區,竹林里,208,1024,399,91,490,43,533
公投第８案,臺中市,沙鹿區,竹林里,209,1388,528,142,670,82,752
公投第８案,臺中市,沙鹿區,竹林里,210,1074,452,146,598,50,648
公投第８案,臺中市,沙鹿區,竹林里,211,1072,468,142,610,42,652
公投第８案,臺中市,沙鹿區,犁分里,212,1107,493,130,623,68,691
公投第８案,臺中市,沙鹿區,福興里,213,1947,715,209,924,64,988
公投第８案,臺中市,沙鹿區,福興里,214,1682,650,179,829,71,900
公投第８案,臺中市,沙鹿區,北勢里,215,1633,792,154,946,3,949
公投第８案,臺中市,沙鹿區,北勢里,216,1533,569,169,738,58,796
公投第８案,臺中市,沙鹿區,北勢里,217,1605,546,158,704,50,754
公投第８案,臺中市,沙鹿區,晉江里,218,1694,671,164,835,40,875
公投第８案,臺中市,沙鹿區,六路里,219,1628,623,193,816,57,873
公投第８案,臺中市,沙鹿區,六路里,220,1665,725,209,934,30,964
公投第８案,臺中市,沙鹿區,六路里,221,1651,659,190,849,58,907
公投第８案,臺中市,沙鹿區,南勢里,222,1108,500,155,655,37,692
公投第８案,臺中市,沙鹿區,南勢里,223,1142,498,150,648,52,700
公投第８案,臺中市,沙鹿區,南勢里,224,1039,450,115,565,33,598
公投第８案,臺中市,沙鹿區,埔子里,225,1840,715,229,944,69,1013
公投第８案,臺中市,沙鹿區,埔子里,226,1872,763,221,984,52,1036
公投第８案,臺中市,沙鹿區,埔子里,227,1558,603,166,769,71,840
公投第８案,臺中市,沙鹿區,三鹿里,228,1739,665,177,842,56,898
公投第８案,臺中市,沙鹿區,三鹿里,229,1672,599,190,789,44,833
公投第８案,臺中市,沙鹿區,三鹿里,230,1634,676,190,866,43,909
公投第８案,臺中市,沙鹿區,三鹿里,231,1616,611,162,773,52,825
公投第８案,臺中市,沙鹿區,公明里,232,1593,647,199,846,57,903
公投第８案,臺中市,沙鹿區,公明里,233,981,412,88,500,27,527
公投第８案,臺中市,沙鹿區,公明里,234,1740,749,215,964,62,1026
公投第８案,臺中市,沙鹿區,清泉里,235,1247,531,167,698,65,763
公投第８案,臺中市,沙鹿區,清泉里,236,1047,481,98,579,17,596
公投第８案,臺中市,沙鹿區,西勢里,237,1119,458,131,589,74,663
公投第８案,臺中市,沙鹿區,西勢里,238,1025,390,134,524,25,549
公投第８案,臺中市,龍井區,竹坑里,239,1758,735,228,963,83,1046
公投第８案,臺中市,龍井區,竹坑里,240,1275,525,154,679,49,728
公投第８案,臺中市,龍井區,龍東里,241,1379,590,49,639,29,668
公投第８案,臺中市,龍井區,龍東里,242,1403,517,160,677,65,742
公投第８案,臺中市,龍井區,龍西里,243,974,380,135,515,47,562
公投第８案,臺中市,龍井區,龍西里,244,901,374,107,481,53,534
公投第８案,臺中市,龍井區,田中里,245,1779,595,219,814,80,894
公投第８案,臺中市,龍井區,田中里,246,1609,682,203,885,71,956
公投第８案,臺中市,龍井區,福田里,247,1038,373,130,503,29,532
公投第８案,臺中市,龍井區,麗水里,248,1328,589,151,740,66,806
公投第８案,臺中市,龍井區,麗水里,249,921,387,141,528,34,562
公投第８案,臺中市,龍井區,龍津里,250,1609,593,184,777,67,844
公投第８案,臺中市,龍井區,龍津里,251,1227,402,151,553,24,577
公投第８案,臺中市,龍井區,龍津里,252,1278,487,165,652,71,723
公投第８案,臺中市,龍井區,龍津里,253,914,265,116,381,24,405
公投第８案,臺中市,龍井區,三德里,254,1678,587,158,745,48,793
公投第８案,臺中市,龍井區,三德里,255,1233,414,161,575,40,615
公投第８案,臺中市,龍井區,忠和里,256,1520,580,191,771,84,855
公投第８案,臺中市,龍井區,忠和里,257,1905,697,227,924,44,968
公投第８案,臺中市,龍井區,忠和里,258,1520,585,247,832,65,897
公投第８案,臺中市,龍井區,山腳里,259,1385,512,151,663,85,748
公投第８案,臺中市,龍井區,山腳里,260,1212,470,154,624,54,678
公投第８案,臺中市,龍井區,山腳里,261,1432,593,179,772,37,809
公投第８案,臺中市,龍井區,山腳里,262,1663,623,204,827,49,876
公投第８案,臺中市,龍井區,龍泉里,263,1422,535,169,704,44,748
公投第８案,臺中市,龍井區,龍泉里,264,1616,530,211,741,72,813
公投第８案,臺中市,龍井區,龍泉里,265,1422,595,163,758,67,825
公投第８案,臺中市,龍井區,龍泉里,266,1165,519,137,656,32,688
公投第８案,臺中市,龍井區,龍泉里,267,1624,664,211,875,32,907
公投第８案,臺中市,龍井區,龍崗里,268,1613,665,186,851,54,905
公投第８案,臺中市,龍井區,龍崗里,269,943,400,137,537,49,586
公投第８案,臺中市,龍井區,新庄里,270,1595,578,174,752,99,851
公投第８案,臺中市,龍井區,新庄里,271,1508,656,161,817,71,888
公投第８案,臺中市,龍井區,新庄里,272,1479,540,190,730,51,781
公投第８案,臺中市,龍井區,新庄里,273,1509,612,198,810,61,871
公投第８案,臺中市,龍井區,南寮里,274,1582,681,189,870,78,948
公投第８案,臺中市,龍井區,東海里,275,1725,727,188,915,48,963
公投第８案,臺中市,龍井區,東海里,276,1616,717,145,862,47,909
公投第８案,臺中市,龍井區,東海里,277,1657,706,216,922,49,971
公投第８案,臺中市,龍井區,東海里,278,1774,760,210,970,61,1031
公投第８案,臺中市,龍井區,東海里,279,1701,737,221,958,73,1031
公投第８案,臺中市,龍井區,新東里,280,1121,490,124,614,48,662
公投第８案,臺中市,龍井區,新東里,281,987,429,144,573,46,619
公投第８案,臺中市,龍井區,新東里,282,1206,463,186,649,60,709
公投第８案,臺中市,龍井區,新東里,283,1378,611,199,810,36,846
公投第８案,臺中市,大肚區,王田里,284,1415,583,164,747,41,788
公投第８案,臺中市,大肚區,王田里,285,1392,530,153,683,63,746
公投第８案,臺中市,大肚區,王田里,286,1520,670,185,855,66,921
公投第８案,臺中市,大肚區,中和里,287,862,403,124,527,56,583
公投第８案,臺中市,大肚區,福山里,288,1256,555,165,720,57,777
公投第８案,臺中市,大肚區,福山里,289,1292,537,141,678,69,747
公投第８案,臺中市,大肚區,福山里,290,1010,441,129,570,45,615
公投第８案,臺中市,大肚區,營埔里,291,1485,635,187,822,96,918
公投第８案,臺中市,大肚區,社腳里,292,1190,552,132,684,71,755
公投第８案,臺中市,大肚區,社腳里,293,1250,535,143,678,65,743
公投第８案,臺中市,大肚區,新興里,294,1310,569,153,722,55,777
公投第８案,臺中市,大肚區,新興里,295,1294,531,149,680,56,736
公投第８案,臺中市,大肚區,大東里,296,1734,757,251,1008,65,1073
公投第８案,臺中市,大肚區,大東里,297,1316,512,153,665,81,746
公投第８案,臺中市,大肚區,大肚里,298,854,353,112,465,44,509
公投第８案,臺中市,大肚區,大肚里,299,1273,679,64,743,50,793
公投第８案,臺中市,大肚區,永和里,300,851,396,113,509,25,534
公投第８案,臺中市,大肚區,磺溪里,301,1629,693,162,855,48,903
公投第８案,臺中市,大肚區,永順里,302,1709,674,179,853,109,962
公投第８案,臺中市,大肚區,成功里,303,953,362,94,456,53,509
公投第８案,臺中市,大肚區,山陽里,304,1336,574,177,751,62,813
公投第８案,臺中市,大肚區,頂街里,305,2113,781,270,1051,91,1142
公投第８案,臺中市,大肚區,頂街里,306,1730,708,199,907,110,1017
公投第８案,臺中市,大肚區,頂街里,307,1692,710,199,909,34,943
公投第８案,臺中市,大肚區,頂街里,308,1747,742,189,931,53,984
公投第８案,臺中市,大肚區,瑞井里,309,1672,721,164,885,73,958
公投第８案,臺中市,大肚區,瑞井里,310,1675,627,199,826,57,883
公投第８案,臺中市,大肚區,瑞井里,311,1673,673,192,865,72,937
公投第８案,臺中市,大肚區,蔗廍里,312,1636,683,224,907,56,963
公投第８案,臺中市,大肚區,蔗廍里,313,1753,620,221,841,103,944
公投第８案,臺中市,大肚區,蔗廍里,314,1343,485,152,637,41,678
公投第８案,臺中市,大肚區,自強里,315,1822,739,188,927,65,992
公投第８案,臺中市,大肚區,自強里,316,1670,747,175,922,107,1029
公投第８案,臺中市,烏日區,烏日里,317,1480,637,229,866,65,931
公投第８案,臺中市,烏日區,烏日里,318,1841,772,224,996,93,1089
公投第８案,臺中市,烏日區,烏日里,319,1751,681,227,908,81,989
公投第８案,臺中市,烏日區,烏日里,320,1547,672,201,873,94,967
公投第８案,臺中市,烏日區,烏日里,321,1836,793,205,998,50,1048
公投第８案,臺中市,烏日區,湖日里,322,1239,539,194,733,85,818
公投第８案,臺中市,烏日區,湖日里,323,1295,520,148,668,73,741
公投第８案,臺中市,烏日區,三和里,324,1263,507,155,662,52,714
公投第８案,臺中市,烏日區,三和里,325,1622,678,187,865,40,905
公投第８案,臺中市,烏日區,三和里,326,1822,742,191,933,99,1032
公投第８案,臺中市,烏日區,榮泉里,327,1966,819,207,1026,69,1095
公投第８案,臺中市,烏日區,榮泉里,328,1615,706,179,885,62,947
公投第８案,臺中市,烏日區,榮泉里,329,1232,556,147,703,42,745
公投第８案,臺中市,烏日區,學田里,330,1347,557,120,677,37,714
公投第８案,臺中市,烏日區,學田里,331,1165,477,100,577,40,617
公投第８案,臺中市,烏日區,九德里,332,1664,742,196,938,44,982
公投第８案,臺中市,烏日區,九德里,333,1230,560,159,719,62,781
公投第８案,臺中市,烏日區,九德里,334,1574,680,223,903,94,997
公投第８案,臺中市,烏日區,九德里,335,1452,655,208,863,54,917
公投第８案,臺中市,烏日區,九德里,336,1879,729,174,903,71,974
公投第８案,臺中市,烏日區,九德里,337,1601,639,205,844,48,892
公投第８案,臺中市,烏日區,九德里,338,1546,654,231,885,68,953
公投第８案,臺中市,烏日區,九德里,339,1866,565,309,874,40,914
公投第８案,臺中市,烏日區,仁德里,340,1938,793,288,1081,86,1167
公投第８案,臺中市,烏日區,仁德里,341,1759,738,219,957,75,1032
公投第８案,臺中市,烏日區,仁德里,342,2061,843,240,1083,78,1161
公投第８案,臺中市,烏日區,仁德里,343,1691,749,192,941,59,1000
公投第８案,臺中市,烏日區,前竹里,344,1039,460,181,641,43,684
公投第８案,臺中市,烏日區,前竹里,345,1221,506,178,684,39,723
公投第８案,臺中市,烏日區,五光里,346,1650,657,219,876,101,977
公投第８案,臺中市,烏日區,光明里,347,937,511,29,540,42,582
公投第８案,臺中市,烏日區,光明里,348,1220,546,136,682,51,733
公投第８案,臺中市,烏日區,東園里,349,2139,763,53,816,132,948
公投第８案,臺中市,烏日區,溪埧里,350,1371,620,174,794,87,881
公投第８案,臺中市,烏日區,溪埧里,351,1277,535,153,688,61,749
公投第８案,臺中市,烏日區,溪埧里,352,1708,647,221,868,75,943
公投第８案,臺中市,烏日區,螺潭里,353,2048,841,216,1057,89,1146
公投第８案,臺中市,烏日區,北里里,354,1632,617,201,818,88,906
公投第８案,臺中市,烏日區,南里里,355,1327,535,192,727,78,805
公投第８案,臺中市,烏日區,溪尾里,356,854,318,106,424,71,495
公投第８案,臺中市,后里區,廣福里,357,852,402,93,495,48,543
公投第８案,臺中市,后里區,廣福里,358,1135,449,128,577,71,648
公投第８案,臺中市,后里區,仁里里,359,1079,396,125,521,52,573
公投第８案,臺中市,后里區,義里里,360,1539,683,153,836,77,913
公投第８案,臺中市,后里區,義里里,361,1591,687,157,844,81,925
公投第８案,臺中市,后里區,義德里,362,1376,509,148,657,44,701
公投第８案,臺中市,后里區,義德里,363,1298,522,165,687,24,711
公投第８案,臺中市,后里區,后里里,364,1428,587,172,759,91,850
公投第８案,臺中市,后里區,后里里,365,1178,557,162,719,63,782
公投第８案,臺中市,后里區,后里里,366,1095,480,124,604,53,657
公投第８案,臺中市,后里區,厚里里,367,963,393,111,504,25,529
公投第８案,臺中市,后里區,厚里里,368,1163,466,139,605,53,658
公投第８案,臺中市,后里區,墩東里,369,1018,463,115,578,37,615
公投第８案,臺中市,后里區,墩東里,370,854,407,97,504,59,563
公投第８案,臺中市,后里區,墩東里,371,1485,590,153,743,70,813
公投第８案,臺中市,后里區,墩東里,372,1355,668,139,807,48,855
公投第８案,臺中市,后里區,墩西里,373,840,313,92,405,62,467
公投第８案,臺中市,后里區,墩西里,374,1146,473,152,625,60,685
公投第８案,臺中市,后里區,墩南里,375,1669,747,188,935,87,1022
公投第８案,臺中市,后里區,墩南里,376,1673,742,188,930,110,1040
公投第８案,臺中市,后里區,墩北里,377,1493,653,168,821,50,871
公投第８案,臺中市,后里區,墩北里,378,1052,451,134,585,67,652
公投第８案,臺中市,后里區,墩北里,379,909,341,109,450,28,478
公投第８案,臺中市,后里區,中和里,380,1091,452,139,591,83,674
公投第８案,臺中市,后里區,中和里,381,1342,589,156,745,82,827
公投第８案,臺中市,后里區,舊社里,382,1138,413,159,572,65,637
公投第８案,臺中市,后里區,舊社里,383,977,431,105,536,52,588
公投第８案,臺中市,后里區,聯合里,384,1584,549,151,700,46,746
公投第８案,臺中市,后里區,太平里,385,915,370,111,481,39,520
公投第８案,臺中市,后里區,太平里,386,1225,516,143,659,77,736
公投第８案,臺中市,后里區,眉山里,387,1552,654,149,803,47,850
公投第８案,臺中市,后里區,眉山里,388,1600,657,182,839,29,868
公投第８案,臺中市,后里區,月眉里,389,942,396,100,496,40,536
公投第８案,臺中市,后里區,月眉里,390,943,358,140,498,26,524
公投第８案,臺中市,后里區,公館里,391,1055,403,107,510,51,561
公投第８案,臺中市,后里區,公館里,392,1067,432,137,569,61,630
公投第８案,臺中市,后里區,泰安里,393,1340,480,166,646,66,712
公投第８案,臺中市,豐原區,豐原里,394,983,372,130,502,56,558
公投第８案,臺中市,豐原區,豐原里,395,1309,538,186,724,56,780
公投第８案,臺中市,豐原區,豐榮里,396,1116,460,174,634,57,691
公投第８案,臺中市,豐原區,頂街里,397,945,433,124,557,52,609
公投第８案,臺中市,豐原區,中山里,398,850,339,145,484,73,557
公投第８案,臺中市,豐原區,下街里,399,760,341,99,440,45,485
公投第８案,臺中市,豐原區,中陽里,400,1617,663,218,881,10,891
公投第８案,臺中市,豐原區,中陽里,401,1677,678,140,818,70,888
公投第８案,臺中市,豐原區,中陽里,402,1771,834,233,1067,50,1117
公投第８案,臺中市,豐原區,大湳里,403,1145,436,177,613,60,673
公投第８案,臺中市,豐原區,大湳里,404,1362,662,48,710,59,769
公投第８案,臺中市,豐原區,北湳里,405,1389,625,160,785,51,836
公投第８案,臺中市,豐原區,北湳里,406,1530,663,211,874,65,939
公投第８案,臺中市,豐原區,東湳里,407,1471,581,198,779,104,883
公投第８案,臺中市,豐原區,東湳里,408,1410,573,197,770,90,860
公投第８案,臺中市,豐原區,東湳里,409,1162,463,152,615,57,672
公投第８案,臺中市,豐原區,西湳里,410,1656,671,222,893,47,940
公投第８案,臺中市,豐原區,西湳里,411,1838,762,226,988,56,1044
公投第８案,臺中市,豐原區,西湳里,412,1666,651,208,859,81,940
公投第８案,臺中市,豐原區,西湳里,413,1821,766,238,1004,96,1100
公投第８案,臺中市,豐原區,西湳里,414,1821,888,244,1132,80,1212
公投第８案,臺中市,豐原區,豐西里,415,1647,646,209,855,48,903
公投第８案,臺中市,豐原區,圳寮里,416,1256,569,181,750,88,838
公投第８案,臺中市,豐原區,豐圳里,417,1552,722,208,930,66,996
公投第８案,臺中市,豐原區,豐圳里,418,1793,758,225,983,57,1040
公投第８案,臺中市,豐原區,富春里,419,759,354,118,472,55,527
公投第８案,臺中市,豐原區,葫蘆里,420,642,262,112,374,46,420
公投第８案,臺中市,豐原區,西安里,421,1528,640,217,857,39,896
公投第８案,臺中市,豐原區,西安里,422,1788,815,228,1043,90,1133
公投第８案,臺中市,豐原區,西安里,423,1663,783,215,998,87,1085
公投第８案,臺中市,豐原區,西勢里,424,1260,608,187,795,75,870
公投第８案,臺中市,豐原區,西勢里,425,902,391,95,486,37,523
公投第８案,臺中市,豐原區,中興里,426,1357,541,130,671,38,709
公投第８案,臺中市,豐原區,中興里,427,1592,708,198,906,60,966
公投第８案,臺中市,豐原區,社皮里,428,1873,815,189,1004,95,1099
公投第８案,臺中市,豐原區,社皮里,429,1867,785,206,991,67,1058
公投第８案,臺中市,豐原區,社皮里,430,1823,749,216,965,95,1060
公投第８案,臺中市,豐原區,社皮里,431,1962,759,204,963,78,1041
公投第８案,臺中市,豐原區,社皮里,432,2313,996,331,1327,89,1416
公投第８案,臺中市,豐原區,三村里,433,1510,675,181,856,79,935
公投第８案,臺中市,豐原區,三村里,434,1824,746,283,1029,69,1098
公投第８案,臺中市,豐原區,三村里,435,1363,576,174,750,59,809
公投第８案,臺中市,豐原區,三村里,436,1535,695,206,901,69,970
公投第８案,臺中市,豐原區,東勢里,437,1457,605,243,848,60,908
公投第８案,臺中市,豐原區,民生里,438,1184,518,161,679,49,728
公投第８案,臺中市,豐原區,田心里,439,2299,790,223,1013,96,1109
公投第８案,臺中市,豐原區,田心里,440,1940,833,220,1053,100,1153
公投第８案,臺中市,豐原區,田心里,441,2067,813,265,1078,68,1146
公投第８案,臺中市,豐原區,豐田里,442,2038,851,215,1066,89,1155
公投第８案,臺中市,豐原區,豐田里,443,1835,738,541,1279,66,1345
公投第８案,臺中市,豐原區,豐田里,444,1979,776,269,1045,95,1140
公投第８案,臺中市,豐原區,豐田里,445,2014,818,205,1023,118,1141
公投第８案,臺中市,豐原區,豐田里,446,2257,910,284,1194,121,1315
公投第８案,臺中市,豐原區,鎌村里,447,1406,614,192,806,78,884
公投第８案,臺中市,豐原區,鎌村里,448,1418,619,170,789,62,851
公投第８案,臺中市,豐原區,鎌村里,449,1772,871,192,1063,61,1124
公投第８案,臺中市,豐原區,陽明里,450,1202,541,167,708,53,761
公投第８案,臺中市,豐原區,陽明里,451,1447,653,199,852,36,888
公投第８案,臺中市,豐原區,南陽里,452,1758,732,239,971,106,1077
公投第８案,臺中市,豐原區,南陽里,453,1546,705,211,916,72,988
公投第８案,臺中市,豐原區,南陽里,454,1815,871,182,1053,69,1122
公投第８案,臺中市,豐原區,南陽里,455,1932,840,265,1105,60,1165
公投第８案,臺中市,豐原區,南陽里,456,1770,832,235,1067,64,1131
公投第８案,臺中市,豐原區,南陽里,457,1560,654,167,821,53,874
公投第８案,臺中市,豐原區,北陽里,458,1810,765,220,985,63,1048
公投第８案,臺中市,豐原區,北陽里,459,1653,735,226,961,65,1026
公投第８案,臺中市,豐原區,北陽里,460,1444,620,173,793,66,859
公投第８案,臺中市,豐原區,北陽里,461,1318,605,174,779,59,838
公投第８案,臺中市,豐原區,北陽里,462,1566,647,218,865,95,960
公投第８案,臺中市,豐原區,北陽里,463,1748,736,207,943,71,1014
公投第８案,臺中市,豐原區,北陽里,464,1772,675,191,866,96,962
公投第８案,臺中市,豐原區,北陽里,465,1721,690,219,909,95,1004
公投第８案,臺中市,豐原區,東陽里,466,1578,688,198,886,65,951
公投第８案,臺中市,豐原區,南村里,467,1859,710,272,982,103,1085
公投第８案,臺中市,豐原區,南村里,468,1479,601,207,808,65,873
公投第８案,臺中市,豐原區,南村里,469,1889,817,216,1033,64,1097
公投第８案,臺中市,豐原區,南田里,470,1803,788,196,984,48,1032
公投第８案,臺中市,豐原區,南田里,471,1421,533,197,730,82,812
公投第８案,臺中市,豐原區,南嵩里,472,1585,676,238,914,87,1001
公投第８案,臺中市,豐原區,南嵩里,473,1774,920,122,1042,77,1119
公投第８案,臺中市,豐原區,翁明里,474,2132,920,254,1174,84,1258
公投第８案,臺中市,豐原區,翁子里,475,1515,616,198,814,87,901
公投第８案,臺中市,豐原區,翁子里,476,1359,528,150,678,32,710
公投第８案,臺中市,豐原區,翁社里,477,948,409,139,548,49,597
公投第８案,臺中市,豐原區,翁社里,478,1134,462,187,649,62,711
公投第８案,臺中市,豐原區,朴子里,479,1114,521,165,686,62,748
公投第８案,臺中市,豐原區,朴子里,480,1050,412,171,583,54,637
公投第８案,臺中市,豐原區,朴子里,481,1182,545,159,704,70,774
公投第８案,臺中市,神岡區,神岡里,482,1684,762,176,938,62,1000
公投第８案,臺中市,神岡區,神岡里,483,1559,673,180,853,69,922
公投第８案,臺中市,神岡區,庄前里,484,1095,444,132,576,42,618
公投第８案,臺中市,神岡區,庄前里,485,1044,487,164,651,57,708
公投第８案,臺中市,神岡區,北庄里,486,1310,584,187,771,82,853
公投第８案,臺中市,神岡區,北庄里,487,1294,539,180,719,109,828
公投第８案,臺中市,神岡區,庄後里,488,1143,491,142,633,53,686
公投第８案,臺中市,神岡區,庄後里,489,1022,446,130,576,58,634
公投第８案,臺中市,神岡區,圳前里,490,1269,490,148,638,54,692
公投第８案,臺中市,神岡區,圳前里,491,1085,391,86,477,32,509
公投第８案,臺中市,神岡區,圳堵里,492,942,377,152,529,66,595
公投第８案,臺中市,神岡區,圳堵里,493,1154,453,141,594,41,635
公投第８案,臺中市,神岡區,新庄里,494,1390,548,168,716,54,770
公投第８案,臺中市,神岡區,新庄里,495,1372,578,200,778,90,868
公投第８案,臺中市,神岡區,新庄里,496,1328,482,153,635,42,677
公投第８案,臺中市,神岡區,山皮里,497,1038,399,134,533,31,564
公投第８案,臺中市,神岡區,社口里,498,1452,614,157,771,51,822
公投第８案,臺中市,神岡區,社口里,499,1551,703,184,887,67,954
公投第８案,臺中市,神岡區,社口里,500,1567,624,158,782,79,861
公投第８案,臺中市,神岡區,社口里,501,1449,616,179,795,46,841
公投第８案,臺中市,神岡區,社口里,502,1246,469,147,616,26,642
公投第８案,臺中市,神岡區,社南里,503,1431,616,178,794,60,854
公投第８案,臺中市,神岡區,社南里,504,1163,501,153,654,81,735
公投第８案,臺中市,神岡區,社南里,505,1402,634,206,840,61,901
公投第８案,臺中市,神岡區,社南里,506,1271,543,155,698,52,750
公投第８案,臺中市,神岡區,三角里,507,1198,510,160,670,56,726
公投第８案,臺中市,神岡區,三角里,508,1312,564,160,724,77,801
公投第８案,臺中市,神岡區,大社里,509,1590,638,186,824,77,901
公投第８案,臺中市,神岡區,大社里,510,1324,510,163,673,48,721
公投第８案,臺中市,神岡區,大社里,511,1415,535,170,705,51,756
公投第８案,臺中市,神岡區,岸裡里,512,1483,674,208,882,58,940
公投第８案,臺中市,神岡區,岸裡里,513,1402,505,174,679,48,727
公投第８案,臺中市,神岡區,豐洲里,514,1275,524,139,663,48,711
公投第８案,臺中市,神岡區,豐洲里,515,1288,464,170,634,73,707
公投第８案,臺中市,神岡區,豐洲里,516,1080,420,132,552,64,616
公投第８案,臺中市,神岡區,豐洲里,517,1344,511,175,686,31,717
公投第８案,臺中市,神岡區,豐洲里,518,1061,458,141,599,67,666
公投第８案,臺中市,神岡區,豐洲里,519,1176,533,157,690,51,741
公投第８案,臺中市,神岡區,神洲里,520,1244,529,177,706,71,777
公投第８案,臺中市,神岡區,神洲里,521,1318,605,180,785,65,850
公投第８案,臺中市,神岡區,溪洲里,522,1471,578,168,746,53,799
公投第８案,臺中市,神岡區,溪洲里,523,1323,585,204,789,87,876
公投第８案,臺中市,大雅區,上雅里,524,2027,864,224,1088,74,1162
公投第８案,臺中市,大雅區,上雅里,525,1967,733,207,940,40,980
公投第８案,臺中市,大雅區,上雅里,526,1912,781,184,965,57,1022
公投第８案,臺中市,大雅區,大雅里,527,1537,695,192,887,51,938
公投第８案,臺中市,大雅區,大雅里,528,1439,612,202,814,60,874
公投第８案,臺中市,大雅區,大雅里,529,1402,591,195,786,51,837
公投第８案,臺中市,大雅區,文雅里,530,2013,840,236,1076,46,1122
公投第８案,臺中市,大雅區,文雅里,531,1917,796,255,1051,80,1131
公投第８案,臺中市,大雅區,文雅里,532,2011,789,249,1038,49,1087
公投第８案,臺中市,大雅區,三和里,533,1887,809,212,1021,57,1078
公投第８案,臺中市,大雅區,三和里,534,1480,646,204,850,58,908
公投第８案,臺中市,大雅區,三和里,535,1816,751,211,962,68,1030
公投第８案,臺中市,大雅區,二和里,536,1898,697,198,895,85,980
公投第８案,臺中市,大雅區,二和里,537,2008,860,215,1075,75,1150
公投第８案,臺中市,大雅區,二和里,538,1976,1060,15,1075,69,1144
公投第８案,臺中市,大雅區,四德里,539,1673,725,200,925,51,976
公投第８案,臺中市,大雅區,四德里,540,1409,634,194,828,41,869
公投第８案,臺中市,大雅區,四德里,541,1382,583,184,767,38,805
公投第８案,臺中市,大雅區,西寶里,542,1635,674,175,849,81,930
公投第８案,臺中市,大雅區,西寶里,543,1565,666,201,867,55,922
公投第８案,臺中市,大雅區,西寶里,544,1528,599,179,778,60,838
公投第８案,臺中市,大雅區,上楓里,545,1963,774,202,976,52,1028
公投第８案,臺中市,大雅區,上楓里,546,2073,780,222,1002,58,1060
公投第８案,臺中市,大雅區,上楓里,547,1984,805,233,1038,63,1101
公投第８案,臺中市,大雅區,大楓里,548,1688,679,194,873,73,946
公投第８案,臺中市,大雅區,大楓里,549,1387,603,169,772,50,822
公投第８案,臺中市,大雅區,大楓里,550,1701,733,205,938,94,1032
公投第８案,臺中市,大雅區,雅楓里,551,1721,699,204,903,72,975
公投第８案,臺中市,大雅區,雅楓里,552,1879,654,149,803,55,858
公投第８案,臺中市,大雅區,員林里,553,1568,699,225,924,62,986
公投第８案,臺中市,大雅區,員林里,554,1761,685,256,941,69,1010
公投第８案,臺中市,大雅區,員林里,555,1752,755,224,979,91,1070
公投第８案,臺中市,大雅區,員林里,556,1264,571,148,719,36,755
公投第８案,臺中市,大雅區,員林里,557,1302,603,150,753,59,812
公投第８案,臺中市,大雅區,員林里,558,1449,610,162,772,61,833
公投第８案,臺中市,大雅區,六寶里,559,1621,702,199,901,95,996
公投第８案,臺中市,大雅區,六寶里,560,1647,661,163,824,101,925
公投第８案,臺中市,大雅區,六寶里,561,1441,582,157,739,42,781
公投第８案,臺中市,大雅區,六寶里,562,1460,612,140,752,37,789
公投第８案,臺中市,大雅區,秀山里,563,1832,799,245,1044,82,1126
公投第８案,臺中市,大雅區,秀山里,564,1371,621,176,797,73,870
公投第８案,臺中市,大雅區,橫山里,565,1418,512,161,673,9,682
公投第８案,臺中市,大雅區,橫山里,566,1473,637,181,818,47,865
公投第８案,臺中市,大雅區,橫山里,567,1335,538,182,720,72,792
公投第８案,臺中市,大雅區,忠義里,568,1733,762,157,919,71,990
公投第８案,臺中市,大雅區,忠義里,569,1884,696,145,841,120,961
公投第８案,臺中市,潭子區,潭秀里,570,1306,561,164,725,58,783
公投第８案,臺中市,潭子區,潭北里,571,1128,464,166,630,57,687
公投第８案,臺中市,潭子區,潭北里,572,1159,517,166,683,62,745
公投第８案,臺中市,潭子區,潭陽里,573,1630,728,190,918,82,1000
公投第８案,臺中市,潭子區,潭陽里,574,1532,666,172,838,40,878
公投第８案,臺中市,潭子區,潭陽里,575,1677,639,184,823,43,866
公投第８案,臺中市,潭子區,潭陽里,576,1744,660,190,850,70,920
公投第８案,臺中市,潭子區,潭陽里,577,1795,739,237,976,57,1033
公投第８案,臺中市,潭子區,潭陽里,578,1171,494,134,628,45,673
公投第８案,臺中市,潭子區,潭陽里,579,1427,621,154,775,41,816
公投第８案,臺中市,潭子區,福仁里,580,1709,693,208,901,64,965
公投第８案,臺中市,潭子區,福仁里,581,1723,751,186,937,42,979
公投第８案,臺中市,潭子區,福仁里,582,1782,734,194,928,56,984
公投第８案,臺中市,潭子區,福仁里,583,1407,575,150,725,42,767
公投第８案,臺中市,潭子區,福仁里,584,1771,767,190,957,42,999
公投第８案,臺中市,潭子區,福仁里,585,1795,784,207,991,93,1084
公投第８案,臺中市,潭子區,頭家里,586,1612,758,192,950,61,1011
公投第８案,臺中市,潭子區,頭家里,587,1894,783,201,984,50,1034
公投第８案,臺中市,潭子區,頭家里,588,1689,688,203,891,59,950
公投第８案,臺中市,潭子區,頭家東里,589,1525,593,158,751,53,804
公投第８案,臺中市,潭子區,頭家東里,590,1622,653,200,853,54,907
公投第８案,臺中市,潭子區,頭家東里,591,1200,495,146,641,78,719
公投第８案,臺中市,潭子區,家興里,592,1355,552,142,694,25,719
公投第８案,臺中市,潭子區,家興里,593,1777,724,199,923,38,961
公投第８案,臺中市,潭子區,家興里,594,1923,836,205,1041,33,1074
公投第８案,臺中市,潭子區,家興里,595,1674,671,172,843,78,921
公投第８案,臺中市,潭子區,家福里,596,1451,675,178,853,60,913
公投第８案,臺中市,潭子區,家福里,597,1486,628,201,829,73,902
公投第８案,臺中市,潭子區,家福里,598,1511,655,192,847,70,917
公投第８案,臺中市,潭子區,甘蔗里,599,1666,749,184,933,60,993
公投第８案,臺中市,潭子區,甘蔗里,600,1750,720,186,906,76,982
公投第８案,臺中市,潭子區,甘蔗里,601,1437,609,146,755,55,810
公投第８案,臺中市,潭子區,甘蔗里,602,1735,729,198,927,49,976
公投第８案,臺中市,潭子區,甘蔗里,603,1612,635,211,846,66,912
公投第８案,臺中市,潭子區,甘蔗里,604,1143,531,146,677,28,705
公投第８案,臺中市,潭子區,東寶里,605,2096,853,210,1063,60,1123
公投第８案,臺中市,潭子區,東寶里,606,1549,653,215,868,67,935
公投第８案,臺中市,潭子區,東寶里,607,1573,650,205,855,35,890
公投第８案,臺中市,潭子區,東寶里,608,1585,635,154,789,48,837
公投第８案,臺中市,潭子區,東寶里,609,1572,658,166,824,55,879
公投第８案,臺中市,潭子區,東寶里,610,1738,779,197,976,53,1029
公投第８案,臺中市,潭子區,東寶里,611,1883,747,220,967,83,1050
公投第８案,臺中市,潭子區,大富里,612,1401,582,174,756,43,799
公投第８案,臺中市,潭子區,大富里,613,1352,579,192,771,61,832
公投第８案,臺中市,潭子區,大豐里,614,2085,913,217,1130,98,1228
公投第８案,臺中市,潭子區,大豐里,615,2047,895,245,1140,101,1241
公投第８案,臺中市,潭子區,大豐里,616,1673,629,213,842,37,879
公投第８案,臺中市,潭子區,栗林里,617,1874,773,236,1009,107,1116
公投第８案,臺中市,潭子區,栗林里,618,1051,418,155,573,57,630
公投第８案,臺中市,潭子區,栗林里,619,1674,634,201,835,52,887
公投第８案,臺中市,潭子區,嘉仁里,620,1831,761,232,993,84,1077
公投第８案,臺中市,潭子區,嘉仁里,621,2003,762,233,995,86,1081
公投第８案,臺中市,潭子區,新田里,622,1535,605,175,780,51,831
公投第８案,臺中市,潭子區,聚興里,623,2286,836,212,1048,118,1166
公投第８案,臺中市,潭子區,聚興里,624,1861,719,203,922,75,997
公投第８案,臺中市,西屯區,西安里,625,1638,725,224,949,68,1017
公投第８案,臺中市,西屯區,西安里,626,1335,512,170,682,48,730
公投第８案,臺中市,西屯區,西安里,627,1776,787,202,989,50,1039
公投第８案,臺中市,西屯區,至善里,628,1351,568,166,734,35,769
公投第８案,臺中市,西屯區,至善里,629,1338,572,183,755,59,814
公投第８案,臺中市,西屯區,至善里,630,1582,687,190,877,45,922
公投第８案,臺中市,西屯區,西平里,631,1710,686,168,854,41,895
公投第８案,臺中市,西屯區,西平里,632,1595,590,193,783,63,846
公投第８案,臺中市,西屯區,西平里,633,1585,727,151,878,61,939
公投第８案,臺中市,西屯區,西墩里,634,1749,657,241,898,68,966
公投第８案,臺中市,西屯區,西墩里,635,1877,821,200,1021,63,1084
公投第８案,臺中市,西屯區,西墩里,636,1697,661,220,881,44,925
公投第８案,臺中市,西屯區,潮洋里,637,1480,659,192,851,52,903
公投第８案,臺中市,西屯區,潮洋里,638,1483,685,224,909,60,969
公投第８案,臺中市,西屯區,潮洋里,639,2484,638,202,840,54,894
公投第８案,臺中市,西屯區,龍潭里,640,781,357,117,474,47,521
公投第８案,臺中市,西屯區,惠來里,641,1477,645,180,825,66,891
公投第８案,臺中市,西屯區,惠來里,642,1784,759,199,958,37,995
公投第８案,臺中市,西屯區,惠來里,643,1686,768,172,940,29,969
公投第８案,臺中市,西屯區,惠來里,644,1692,720,202,922,44,966
公投第８案,臺中市,西屯區,惠來里,645,1659,723,138,861,32,893
公投第８案,臺中市,西屯區,惠來里,646,1648,721,175,896,78,974
公投第８案,臺中市,西屯區,惠來里,647,1536,695,204,899,40,939
公投第８案,臺中市,西屯區,惠來里,648,1666,727,211,938,61,999
公投第８案,臺中市,西屯區,上石里,649,1428,631,160,791,56,847
公投第８案,臺中市,西屯區,上石里,650,1810,749,183,932,59,991
公投第８案,臺中市,西屯區,上石里,651,1574,683,175,858,35,893
公投第８案,臺中市,西屯區,上安里,652,1650,713,186,899,30,929
公投第８案,臺中市,西屯區,上安里,653,1681,681,213,894,78,972
公投第８案,臺中市,西屯區,上安里,654,1656,656,204,860,65,925
公投第８案,臺中市,西屯區,上德里,655,1243,565,123,688,72,760
公投第８案,臺中市,西屯區,上德里,656,1471,669,192,861,71,932
公投第８案,臺中市,西屯區,上德里,657,1431,695,157,852,41,893
公投第８案,臺中市,西屯區,逢甲里,658,1714,719,208,927,50,977
公投第８案,臺中市,西屯區,逢甲里,659,1424,629,158,787,56,843
公投第８案,臺中市,西屯區,逢甲里,660,1176,513,139,652,45,697
公投第８案,臺中市,西屯區,逢福里,661,1456,640,175,815,67,882
公投第８案,臺中市,西屯區,逢福里,662,1451,699,157,856,51,907
公投第８案,臺中市,西屯區,逢福里,663,1063,537,115,652,40,692
公投第８案,臺中市,西屯區,逢福里,664,1357,595,172,767,57,824
公投第８案,臺中市,西屯區,鵬程里,665,1355,679,106,785,54,839
公投第８案,臺中市,西屯區,鵬程里,666,1384,708,120,828,27,855
公投第８案,臺中市,西屯區,何厝里,667,1613,706,196,902,62,964
公投第８案,臺中市,西屯區,何厝里,668,1562,637,200,837,65,902
公投第８案,臺中市,西屯區,何明里,669,1219,543,177,720,71,791
公投第８案,臺中市,西屯區,何明里,670,1235,494,178,672,44,716
公投第８案,臺中市,西屯區,何明里,671,1131,468,158,626,53,679
公投第８案,臺中市,西屯區,何南里,672,1494,683,186,869,56,925
公投第８案,臺中市,西屯區,何南里,673,1325,579,162,741,20,761
公投第８案,臺中市,西屯區,何南里,674,1386,596,197,793,37,830
公投第８案,臺中市,西屯區,何成里,675,1816,766,230,996,75,1071
公投第８案,臺中市,西屯區,何成里,676,1734,699,181,880,49,929
公投第８案,臺中市,西屯區,何成里,677,1777,782,216,998,71,1069
公投第８案,臺中市,西屯區,何成里,678,1818,724,188,912,75,987
公投第８案,臺中市,西屯區,何安里,679,1699,691,194,885,80,965
公投第８案,臺中市,西屯區,何安里,680,1715,646,188,834,48,882
公投第８案,臺中市,西屯區,何安里,681,1654,658,176,834,53,887
公投第８案,臺中市,西屯區,何仁里,682,1636,675,185,860,25,885
公投第８案,臺中市,西屯區,何仁里,683,1298,515,164,679,33,712
公投第８案,臺中市,西屯區,何仁里,684,1391,587,199,786,49,835
公投第８案,臺中市,西屯區,何仁里,685,1853,796,229,1025,67,1092
公投第８案,臺中市,西屯區,何德里,686,1820,747,194,941,64,1005
公投第８案,臺中市,西屯區,何德里,687,1809,748,234,982,59,1041
公投第８案,臺中市,西屯區,何福里,688,1352,617,164,781,64,845
公投第８案,臺中市,西屯區,何福里,689,1521,662,188,850,32,882
公投第８案,臺中市,西屯區,何福里,690,1486,643,204,847,56,903
公投第８案,臺中市,西屯區,何源里,691,1674,694,233,927,56,983
公投第８案,臺中市,西屯區,何源里,692,1610,712,226,938,69,1007
公投第８案,臺中市,西屯區,何源里,693,1695,745,195,940,44,984
公投第８案,臺中市,西屯區,何源里,694,1684,698,187,885,59,944
公投第８案,臺中市,西屯區,大河里,695,1221,511,193,704,30,734
公投第８案,臺中市,西屯區,大河里,696,1252,600,198,798,62,860
公投第８案,臺中市,西屯區,大河里,697,1301,565,183,748,63,811
公投第８案,臺中市,西屯區,大石里,698,1049,532,87,619,41,660
公投第８案,臺中市,西屯區,大石里,699,1113,547,74,621,54,675
公投第８案,臺中市,西屯區,大福里,700,1557,663,140,803,56,859
公投第８案,臺中市,西屯區,大福里,701,1640,645,203,848,55,903
公投第８案,臺中市,西屯區,大鵬里,702,1402,655,199,854,81,935
公投第８案,臺中市,西屯區,大鵬里,703,1717,669,163,832,78,910
公投第８案,臺中市,西屯區,大鵬里,704,1688,687,193,880,75,955
公投第８案,臺中市,西屯區,港尾里,705,1168,472,154,626,95,721
公投第８案,臺中市,西屯區,港尾里,706,1729,697,192,889,52,941
公投第８案,臺中市,西屯區,港尾里,707,2007,809,197,1006,58,1064
公投第８案,臺中市,西屯區,廣福里,708,1296,549,147,696,99,795
公投第８案,臺中市,西屯區,廣福里,709,1068,400,100,500,30,530
公投第８案,臺中市,西屯區,林厝里,710,1707,655,151,806,103,909
公投第８案,臺中市,西屯區,林厝里,711,1636,729,182,911,57,968
公投第８案,臺中市,西屯區,永安里,712,1761,620,73,693,48,741
公投第８案,臺中市,西屯區,永安里,713,1314,558,158,716,49,765
公投第８案,臺中市,西屯區,永安里,714,1233,577,168,745,42,787
公投第８案,臺中市,西屯區,永安里,715,1549,625,166,791,52,843
公投第８案,臺中市,西屯區,永安里,716,1639,674,163,837,35,872
公投第８案,臺中市,西屯區,永安里,717,1486,599,154,753,60,813
公投第８案,臺中市,西屯區,永安里,718,1806,736,213,949,31,980
公投第８案,臺中市,西屯區,永安里,719,1451,604,156,760,29,789
公投第８案,臺中市,西屯區,福安里,720,1302,615,120,735,35,770
公投第８案,臺中市,西屯區,福安里,721,1353,599,192,791,52,843
公投第８案,臺中市,西屯區,福雅里,722,2162,976,251,1227,73,1300
公投第８案,臺中市,西屯區,福雅里,723,1520,622,188,810,58,868
公投第８案,臺中市,西屯區,福雅里,724,1935,825,187,1012,35,1047
公投第８案,臺中市,西屯區,福林里,725,1847,760,226,986,61,1047
公投第８案,臺中市,西屯區,福林里,726,1738,766,202,968,39,1007
公投第８案,臺中市,西屯區,福林里,727,1640,757,199,956,49,1005
公投第８案,臺中市,西屯區,福林里,728,1908,805,248,1053,43,1096
公投第８案,臺中市,西屯區,福瑞里,729,1402,625,152,777,41,818
公投第８案,臺中市,西屯區,福瑞里,730,1515,601,165,766,38,804
公投第８案,臺中市,西屯區,福聯里,731,1541,534,146,680,42,722
公投第８案,臺中市,西屯區,福聯里,732,1502,622,166,788,44,832
公投第８案,臺中市,西屯區,福和里,733,1526,624,226,850,58,908
公投第８案,臺中市,西屯區,福和里,734,1425,601,193,794,70,864
公投第８案,臺中市,西屯區,福和里,735,1334,586,198,784,82,866
公投第８案,臺中市,西屯區,福中里,736,1649,745,207,952,40,992
公投第８案,臺中市,西屯區,福中里,737,1566,634,187,821,31,852
公投第８案,臺中市,西屯區,福恩里,738,1629,753,188,941,50,991
公投第８案,臺中市,西屯區,福恩里,739,1628,691,230,921,42,963
公投第８案,臺中市,西屯區,福恩里,740,1442,689,163,852,37,889
公投第８案,臺中市,西屯區,協和里,741,1206,470,142,612,57,669
公投第８案,臺中市,西屯區,協和里,742,1086,461,172,633,50,683
公投第８案,臺中市,西屯區,協和里,743,1088,496,150,646,39,685
公投第８案,臺中市,西屯區,協和里,744,1140,489,156,645,35,680
公投第８案,臺中市,南屯區,南屯里,745,1321,547,185,732,75,807
公投第８案,臺中市,南屯區,南屯里,746,1346,553,216,769,66,835
公投第８案,臺中市,南屯區,南屯里,747,1428,590,193,783,72,855
公投第８案,臺中市,南屯區,南屯里,748,1442,625,163,788,40,828
公投第８案,臺中市,南屯區,南屯里,749,1408,700,175,875,32,907
公投第８案,臺中市,南屯區,南屯里,750,1404,682,148,830,29,859
公投第８案,臺中市,南屯區,豐樂里,751,1354,631,170,801,61,862
公投第８案,臺中市,南屯區,豐樂里,752,1332,581,181,762,72,834
公投第８案,臺中市,南屯區,豐樂里,753,1463,674,201,875,49,924
公投第８案,臺中市,南屯區,豐樂里,754,1413,695,82,777,65,842
公投第８案,臺中市,南屯區,豐樂里,755,1218,549,180,729,40,769
公投第８案,臺中市,南屯區,豐樂里,756,1308,558,161,719,36,755
公投第８案,臺中市,南屯區,豐樂里,757,1527,697,215,912,50,962
公投第８案,臺中市,南屯區,豐樂里,758,1294,588,176,764,42,806
公投第８案,臺中市,南屯區,楓樹里,759,1516,593,168,761,54,815
公投第８案,臺中市,南屯區,楓樹里,760,1529,650,188,838,98,936
公投第８案,臺中市,南屯區,楓樹里,761,1397,611,183,794,64,858
公投第８案,臺中市,南屯區,楓樹里,762,1406,581,160,741,47,788
公投第８案,臺中市,南屯區,中和里,763,1497,596,166,762,54,816
公投第８案,臺中市,南屯區,中和里,764,1424,572,164,736,81,817
公投第８案,臺中市,南屯區,中和里,765,1488,505,173,678,47,725
公投第８案,臺中市,南屯區,鎮平里,766,608,275,86,361,47,408
公投第８案,臺中市,南屯區,鎮平里,767,813,330,127,457,71,528
公投第８案,臺中市,南屯區,春社里,768,1190,507,155,662,69,731
公投第８案,臺中市,南屯區,春社里,769,1174,494,128,622,43,665
公投第８案,臺中市,南屯區,春社里,770,1224,536,152,688,24,712
公投第８案,臺中市,南屯區,春社里,771,1466,528,129,657,45,702
公投第８案,臺中市,南屯區,春社里,772,1333,440,105,545,29,574
公投第８案,臺中市,南屯區,春安里,773,814,352,100,452,67,519
公投第８案,臺中市,南屯區,文山里,774,1436,544,178,722,62,784
公投第８案,臺中市,南屯區,文山里,775,1515,649,190,839,61,900
公投第８案,臺中市,南屯區,文山里,776,1545,600,143,743,52,795
公投第８案,臺中市,南屯區,文山里,777,1383,603,158,761,53,814
公投第８案,臺中市,南屯區,文山里,778,1433,643,166,809,38,847
公投第８案,臺中市,南屯區,文山里,779,1134,436,141,577,48,625
公投第８案,臺中市,南屯區,文山里,780,1216,593,122,715,47,762
公投第８案,臺中市,南屯區,寶山里,781,1271,495,158,653,82,735
公投第８案,臺中市,南屯區,寶山里,782,1203,486,141,627,38,665
公投第８案,臺中市,南屯區,寶山里,783,1268,543,161,704,38,742
公投第８案,臺中市,南屯區,寶山里,784,1390,577,192,769,62,831
公投第８案,臺中市,南屯區,新生里,785,1397,587,173,760,50,810
公投第８案,臺中市,南屯區,永定里,786,1607,633,214,847,79,926
公投第８案,臺中市,南屯區,永定里,787,1582,702,194,896,49,945
公投第８案,臺中市,南屯區,永定里,788,1611,720,191,911,55,966
公投第８案,臺中市,南屯區,三厝里,789,1322,588,201,789,52,841
公投第８案,臺中市,南屯區,三厝里,790,1321,622,177,799,54,853
公投第８案,臺中市,南屯區,三厝里,791,1360,612,148,760,51,811
公投第８案,臺中市,南屯區,三厝里,792,1361,630,160,790,24,814
公投第８案,臺中市,南屯區,三厝里,793,1257,566,184,750,36,786
公投第８案,臺中市,南屯區,三義里,794,1207,606,145,751,31,782
公投第８案,臺中市,南屯區,三義里,795,1282,623,159,782,32,814
公投第８案,臺中市,南屯區,三義里,796,1248,611,169,780,38,818
公投第８案,臺中市,南屯區,三義里,797,1304,623,182,805,47,852
公投第８案,臺中市,南屯區,三義里,798,1214,552,147,699,44,743
公投第８案,臺中市,南屯區,三和里,799,1102,505,140,645,56,701
公投第８案,臺中市,南屯區,三和里,800,1630,816,189,1005,48,1053
公投第８案,臺中市,南屯區,三和里,801,1333,641,150,791,41,832
公投第８案,臺中市,南屯區,三和里,802,1292,608,163,771,43,814
公投第８案,臺中市,南屯區,三和里,803,1272,589,156,745,43,788
公投第８案,臺中市,南屯區,三和里,804,1345,627,136,763,46,809
公投第８案,臺中市,南屯區,黎明里,805,981,500,142,642,46,688
公投第８案,臺中市,南屯區,黎明里,806,1097,506,136,642,59,701
公投第８案,臺中市,南屯區,黎明里,807,991,480,124,604,42,646
公投第８案,臺中市,南屯區,黎明里,808,1170,538,142,680,30,710
公投第８案,臺中市,南屯區,溝墘里,809,1171,552,147,699,48,747
公投第８案,臺中市,南屯區,溝墘里,810,1349,557,179,736,74,810
公投第８案,臺中市,南屯區,溝墘里,811,1368,644,191,835,39,874
公投第８案,臺中市,南屯區,溝墘里,812,1263,606,162,768,48,816
公投第８案,臺中市,南屯區,大業里,813,1547,699,219,918,44,962
公投第８案,臺中市,南屯區,大業里,814,1649,716,211,927,63,990
公投第８案,臺中市,南屯區,大業里,815,1629,660,200,860,52,912
公投第８案,臺中市,南屯區,大業里,816,1580,606,195,801,59,860
公投第８案,臺中市,南屯區,惠中里,817,1444,709,196,905,41,946
公投第８案,臺中市,南屯區,惠中里,818,1413,644,146,790,27,817
公投第８案,臺中市,南屯區,惠中里,819,1377,613,148,761,45,806
公投第８案,臺中市,南屯區,惠中里,820,1527,654,225,879,54,933
公投第８案,臺中市,南屯區,惠中里,821,1335,606,180,786,47,833
公投第８案,臺中市,南屯區,田心里,822,1544,776,215,991,46,1037
公投第８案,臺中市,南屯區,田心里,823,1482,687,226,913,55,968
公投第８案,臺中市,南屯區,田心里,824,1488,532,217,749,78,827
公投第８案,臺中市,南屯區,田心里,825,1538,597,167,764,46,810
公投第８案,臺中市,南屯區,向心里,826,1674,761,210,971,86,1057
公投第８案,臺中市,南屯區,向心里,827,1996,609,197,806,58,864
公投第８案,臺中市,南屯區,向心里,828,1514,683,172,855,67,922
公投第８案,臺中市,南屯區,文心里,829,1217,576,142,718,65,783
公投第８案,臺中市,南屯區,文心里,830,1347,569,172,741,61,802
公投第８案,臺中市,南屯區,文心里,831,1109,489,137,626,46,672
公投第８案,臺中市,南屯區,同心里,832,1546,675,172,847,50,897
公投第８案,臺中市,南屯區,同心里,833,1408,657,194,851,54,905
公投第８案,臺中市,南屯區,同心里,834,1057,424,138,562,20,582
公投第８案,臺中市,南屯區,同心里,835,1133,473,158,631,62,693
公投第８案,臺中市,南屯區,大同里,836,1278,565,160,725,33,758
公投第８案,臺中市,南屯區,大同里,837,1144,543,157,700,54,754
公投第８案,臺中市,南屯區,大同里,838,1140,495,159,654,42,696
公投第８案,臺中市,南屯區,大同里,839,1171,531,164,695,44,739
公投第８案,臺中市,南屯區,大興里,840,1303,600,179,779,58,837
公投第８案,臺中市,南屯區,大興里,841,1402,570,154,724,53,777
公投第８案,臺中市,南屯區,大興里,842,1571,676,182,858,55,913
公投第８案,臺中市,南屯區,大誠里,843,1139,515,166,681,51,732
公投第８案,臺中市,南屯區,大誠里,844,1216,562,162,724,56,780
公投第８案,臺中市,南屯區,大誠里,845,1162,549,139,688,50,738
公投第８案,臺中市,北屯區,北屯里,846,1670,830,147,977,64,1041
公投第８案,臺中市,北屯區,北屯里,847,1706,674,189,863,65,928
公投第８案,臺中市,北屯區,北京里,848,1507,621,154,775,87,862
公投第８案,臺中市,北屯區,北京里,849,1652,722,199,921,61,982
公投第８案,臺中市,北屯區,北興里,850,1107,442,129,571,19,590
公投第８案,臺中市,北屯區,北興里,851,2151,844,228,1072,84,1156
公投第８案,臺中市,北屯區,三光里,852,1612,705,219,924,29,953
公投第８案,臺中市,北屯區,三光里,853,1743,727,200,927,52,979
公投第８案,臺中市,北屯區,三光里,854,2099,810,228,1038,54,1092
公投第８案,臺中市,北屯區,三光里,855,1595,673,186,859,37,896
公投第８案,臺中市,北屯區,三和里,856,1923,746,194,940,71,1011
公投第８案,臺中市,北屯區,三和里,857,1641,658,175,833,67,900
公投第８案,臺中市,北屯區,三和里,858,1157,557,138,695,35,730
公投第８案,臺中市,北屯區,三和里,859,1041,503,117,620,44,664
公投第８案,臺中市,北屯區,東光里,860,1563,690,103,793,52,845
公投第８案,臺中市,北屯區,東光里,861,1559,602,172,774,66,840
公投第８案,臺中市,北屯區,東光里,862,1411,552,118,670,25,695
公投第８案,臺中市,北屯區,水景里,863,1761,782,206,988,43,1031
公投第８案,臺中市,北屯區,水景里,864,1361,628,170,798,57,855
公投第８案,臺中市,北屯區,水景里,865,1852,757,216,973,76,1049
公投第８案,臺中市,北屯區,水景里,866,1928,831,224,1055,53,1108
公投第８案,臺中市,北屯區,水景里,867,1492,725,186,911,41,952
公投第８案,臺中市,北屯區,水景里,868,1998,823,210,1033,65,1098
公投第８案,臺中市,北屯區,水景里,869,1272,600,180,780,45,825
公投第８案,臺中市,北屯區,水景里,870,1317,575,162,737,39,776
公投第８案,臺中市,北屯區,軍功里,871,1327,476,164,640,100,740
公投第８案,臺中市,北屯區,軍功里,872,1280,491,150,641,32,673
公投第８案,臺中市,北屯區,軍功里,873,1865,746,165,911,64,975
公投第８案,臺中市,北屯區,軍功里,874,1230,564,159,723,64,787
公投第８案,臺中市,北屯區,軍功里,875,1356,524,147,671,56,727
公投第８案,臺中市,北屯區,軍功里,876,1732,747,180,927,61,988
公投第８案,臺中市,北屯區,軍功里,877,1586,717,168,885,48,933
公投第８案,臺中市,北屯區,軍功里,878,1441,613,158,771,46,817
公投第８案,臺中市,北屯區,和平里,879,2045,802,231,1033,78,1111
公投第８案,臺中市,北屯區,和平里,880,1914,612,313,925,78,1003
公投第８案,臺中市,北屯區,和平里,881,1918,834,198,1032,57,1089
公投第８案,臺中市,北屯區,和平里,882,2079,868,179,1047,37,1084
公投第８案,臺中市,北屯區,和平里,883,2040,859,232,1091,67,1158
公投第８案,臺中市,北屯區,廍子里,884,2027,683,276,959,50,1009
公投第８案,臺中市,北屯區,廍子里,885,1402,580,153,733,56,789
公投第８案,臺中市,北屯區,廍子里,886,1826,801,197,998,64,1062
公投第８案,臺中市,北屯區,廍子里,887,2162,857,186,1043,37,1080
公投第８案,臺中市,北屯區,廍子里,888,2332,872,211,1083,32,1115
公投第８案,臺中市,北屯區,民政里,889,985,421,107,528,52,580
公投第８案,臺中市,北屯區,東山里,890,2037,707,246,953,42,995
公投第８案,臺中市,北屯區,大坑里,891,1032,454,134,588,46,634
公投第８案,臺中市,北屯區,大坑里,892,1062,476,110,586,35,621
公投第８案,臺中市,北屯區,民德里,893,909,380,92,472,54,526
公投第８案,臺中市,北屯區,舊社里,894,1445,643,171,814,60,874
公投第８案,臺中市,北屯區,舊社里,895,1842,716,210,926,42,968
公投第８案,臺中市,北屯區,舊社里,896,1187,532,144,676,39,715
公投第８案,臺中市,北屯區,舊社里,897,1456,639,156,795,44,839
公投第８案,臺中市,北屯區,松茂里,898,1866,775,212,987,73,1060
公投第８案,臺中市,北屯區,松茂里,899,1667,683,170,853,52,905
公投第８案,臺中市,北屯區,松茂里,900,1683,751,178,929,30,959
公投第８案,臺中市,北屯區,松強里,901,1642,658,215,873,42,915
公投第８案,臺中市,北屯區,松強里,902,1475,651,165,816,25,841
公投第８案,臺中市,北屯區,松強里,903,1644,702,148,850,29,879
公投第８案,臺中市,北屯區,松強里,904,1603,755,158,913,34,947
公投第８案,臺中市,北屯區,松勇里,905,1949,857,229,1086,68,1154
公投第８案,臺中市,北屯區,松勇里,906,1790,850,210,1060,54,1114
公投第８案,臺中市,北屯區,松勇里,907,1440,621,175,796,49,845
公投第８案,臺中市,北屯區,松安里,908,1601,686,224,910,60,970
公投第８案,臺中市,北屯區,松安里,909,1527,592,205,797,58,855
公投第８案,臺中市,北屯區,松安里,910,1675,654,174,828,60,888
公投第８案,臺中市,北屯區,松和里,911,1579,492,149,641,41,682
公投第８案,臺中市,北屯區,松和里,912,1524,620,166,786,95,881
公投第８案,臺中市,北屯區,松和里,913,1677,675,174,849,67,916
公投第８案,臺中市,北屯區,松和里,914,1599,650,185,835,68,903
公投第８案,臺中市,北屯區,松竹里,915,1458,631,181,812,73,885
公投第８案,臺中市,北屯區,松竹里,916,1571,781,173,954,69,1023
公投第８案,臺中市,北屯區,松竹里,917,1579,656,209,865,71,936
公投第８案,臺中市,北屯區,松竹里,918,1849,779,242,1021,66,1087
公投第８案,臺中市,北屯區,松竹里,919,1682,736,185,921,44,965
公投第８案,臺中市,北屯區,平興里,920,1760,740,177,917,46,963
公投第８案,臺中市,北屯區,平興里,921,1699,735,185,920,71,991
公投第８案,臺中市,北屯區,平興里,922,1626,748,195,943,61,1004
公投第８案,臺中市,北屯區,平興里,923,1491,647,223,870,15,885
公投第８案,臺中市,北屯區,平田里,924,1640,650,205,855,34,889
公投第８案,臺中市,北屯區,平田里,925,2052,813,232,1045,69,1114
公投第８案,臺中市,北屯區,平田里,926,1875,798,214,1012,58,1070
公投第８案,臺中市,北屯區,平昌里,927,1559,669,161,830,29,859
公投第８案,臺中市,北屯區,平昌里,928,1480,631,176,807,75,882
公投第８案,臺中市,北屯區,平昌里,929,1397,585,176,761,72,833
公投第８案,臺中市,北屯區,平安里,930,1889,830,210,1040,57,1097
公投第８案,臺中市,北屯區,平安里,931,1728,697,199,896,100,996
公投第８案,臺中市,北屯區,平安里,932,1592,629,185,814,74,888
公投第８案,臺中市,北屯區,平順里,933,1656,646,189,835,80,915
公投第８案,臺中市,北屯區,平順里,934,1524,589,165,754,74,828
公投第８案,臺中市,北屯區,平心里,935,1502,638,197,835,47,882
公投第８案,臺中市,北屯區,平心里,936,1772,757,188,945,42,987
公投第８案,臺中市,北屯區,平心里,937,1461,675,152,827,52,879
公投第８案,臺中市,北屯區,平福里,938,1769,689,168,857,32,889
公投第８案,臺中市,北屯區,平福里,939,1894,791,260,1051,78,1129
公投第８案,臺中市,北屯區,平德里,940,2033,774,224,998,67,1065
公投第８案,臺中市,北屯區,平德里,941,1947,799,210,1009,58,1067
公投第８案,臺中市,北屯區,平德里,942,2188,879,311,1190,68,1258
公投第８案,臺中市,北屯區,平和里,943,1661,731,203,934,64,998
公投第８案,臺中市,北屯區,平和里,944,1667,729,199,928,44,972
公投第８案,臺中市,北屯區,平和里,945,1728,704,194,898,58,956
公投第８案,臺中市,北屯區,平陽里,946,1688,683,187,870,44,914
公投第８案,臺中市,北屯區,平陽里,947,1475,644,169,813,30,843
公投第８案,臺中市,北屯區,平陽里,948,1681,755,220,975,44,1019
公投第８案,臺中市,北屯區,仁和里,949,2078,892,261,1153,62,1215
公投第８案,臺中市,北屯區,仁和里,950,2059,869,229,1098,63,1161
公投第８案,臺中市,北屯區,仁和里,951,1792,771,222,993,47,1040
公投第８案,臺中市,北屯區,仁和里,952,2974,788,221,1009,39,1048
公投第８案,臺中市,北屯區,仁愛里,953,1072,432,143,575,55,630
公投第８案,臺中市,北屯區,仁美里,954,2099,1076,234,1310,64,1374
公投第８案,臺中市,北屯區,仁美里,955,1823,835,283,1118,50,1168
公投第８案,臺中市,北屯區,仁美里,956,2022,907,252,1159,75,1234
公投第８案,臺中市,北屯區,仁美里,957,1992,850,219,1069,43,1112
公投第８案,臺中市,北屯區,四民里,958,1585,712,193,905,56,961
公投第８案,臺中市,北屯區,同榮里,959,1565,701,198,899,60,959
公投第８案,臺中市,北屯區,同榮里,960,1780,648,190,838,57,895
公投第８案,臺中市,北屯區,同榮里,961,1874,885,211,1096,58,1154
公投第８案,臺中市,北屯區,后庄里,962,1755,839,163,1002,46,1048
公投第８案,臺中市,北屯區,后庄里,963,1497,747,209,956,46,1002
公投第８案,臺中市,北屯區,后庄里,964,1567,755,181,936,57,993
公投第８案,臺中市,北屯區,后庄里,965,1624,701,154,855,54,909
公投第８案,臺中市,北屯區,后庄里,966,1614,739,185,924,62,986
公投第８案,臺中市,北屯區,后庄里,967,1595,707,165,872,38,910
公投第８案,臺中市,北屯區,新平里,968,1782,706,167,873,77,950
公投第８案,臺中市,北屯區,新平里,969,1357,517,139,656,35,691
公投第８案,臺中市,北屯區,新平里,970,1071,445,110,555,67,622
公投第８案,臺中市,北屯區,陳平里,971,1372,554,145,699,62,761
公投第８案,臺中市,北屯區,陳平里,972,1415,635,150,785,61,846
公投第８案,臺中市,北屯區,陳平里,973,1789,812,219,1031,74,1105
公投第８案,臺中市,北屯區,忠平里,974,1907,896,224,1120,77,1197
公投第８案,臺中市,北屯區,忠平里,975,2008,895,221,1116,71,1187
公投第８案,臺中市,北屯區,大德里,976,1541,651,169,820,57,877
公投第８案,臺中市,北屯區,大德里,977,1669,734,204,938,59,997
公投第８案,臺中市,北屯區,大德里,978,1685,734,184,918,31,949
公投第８案,臺中市,北屯區,水湳里,979,1785,736,215,951,82,1033
公投第８案,臺中市,北屯區,水湳里,980,1596,725,187,912,67,979
公投第８案,臺中市,北屯區,水湳里,981,1731,759,226,985,63,1048
公投第８案,臺中市,北屯區,水湳里,982,1496,592,182,774,75,849
公投第８案,臺中市,北區,中正里,983,1437,537,176,713,43,756
公投第８案,臺中市,北區,六合里,984,1708,507,317,824,85,909
公投第８案,臺中市,北區,光大里,985,1051,399,103,502,39,541
公投第８案,臺中市,北區,光大里,986,996,407,132,539,35,574
公投第８案,臺中市,北區,文莊里,987,1504,707,127,834,30,864
公投第８案,臺中市,北區,文莊里,988,975,405,143,548,59,607
公投第８案,臺中市,北區,文莊里,989,886,381,100,481,41,522
公投第８案,臺中市,北區,大湖里,990,1276,381,138,519,50,569
公投第８案,臺中市,北區,大湖里,991,938,339,105,444,39,483
公投第８案,臺中市,北區,五常里,992,1404,520,163,683,87,770
公投第８案,臺中市,北區,錦平里,993,996,409,125,534,20,554
公投第８案,臺中市,北區,錦平里,994,869,318,121,439,54,493
公投第８案,臺中市,北區,新北里,995,704,330,81,411,20,431
公投第８案,臺中市,北區,新北里,996,979,380,106,486,35,521
公投第８案,臺中市,北區,新興里,997,773,319,65,384,19,403
公投第８案,臺中市,北區,新興里,998,759,336,79,415,37,452
公投第８案,臺中市,北區,樂英里,999,1438,700,113,813,50,863
公投第８案,臺中市,北區,樂英里,1000,1212,505,95,600,21,621
公投第８案,臺中市,北區,錦村里,1001,1731,707,226,933,40,973
公投第８案,臺中市,北區,錦村里,1002,1445,655,189,844,40,884
公投第８案,臺中市,北區,建成里,1003,1855,743,223,966,56,1022
公投第８案,臺中市,北區,建成里,1004,1728,653,149,802,69,871
公投第８案,臺中市,北區,建成里,1005,1878,721,188,909,62,971
公投第８案,臺中市,北區,建德里,1006,1793,653,194,847,84,931
公投第８案,臺中市,北區,建德里,1007,1555,650,167,817,82,899
公投第８案,臺中市,北區,錦洲里,1008,1761,648,164,812,44,856
公投第８案,臺中市,北區,錦洲里,1009,1579,665,154,819,41,860
公投第８案,臺中市,北區,錦祥里,1010,2192,849,221,1070,96,1166
公投第８案,臺中市,北區,錦祥里,1011,1560,684,187,871,58,929
公投第８案,臺中市,北區,金華里,1012,1476,623,166,789,62,851
公投第８案,臺中市,北區,金華里,1013,1006,470,120,590,28,618
公投第８案,臺中市,北區,金龍里,1014,1403,590,170,760,50,810
公投第８案,臺中市,北區,金龍里,1015,1446,585,158,743,32,775
公投第８案,臺中市,北區,金龍里,1016,1460,582,178,760,57,817
公投第８案,臺中市,北區,邱厝里,1017,1233,526,138,664,25,689
公投第８案,臺中市,北區,邱厝里,1018,1027,487,144,631,37,668
公投第８案,臺中市,北區,建興里,1019,1207,511,159,670,21,691
公投第８案,臺中市,北區,建興里,1020,1167,514,150,664,47,711
公投第８案,臺中市,北區,建興里,1021,1150,465,147,612,29,641
公投第８案,臺中市,北區,建興里,1022,1061,419,158,577,49,626
公投第８案,臺中市,北區,建興里,1023,1005,416,127,543,46,589
公投第８案,臺中市,北區,頂厝里,1024,1250,515,153,668,28,696
公投第８案,臺中市,北區,頂厝里,1025,1448,614,167,781,73,854
公投第８案,臺中市,北區,頂厝里,1026,1379,605,159,764,64,828
公投第８案,臺中市,北區,崇德里,1027,1652,687,202,889,68,957
公投第８案,臺中市,北區,崇德里,1028,1867,746,223,969,45,1014
公投第８案,臺中市,北區,賴厝里,1029,2078,407,109,516,27,543
公投第８案,臺中市,北區,賴厝里,1030,1562,695,190,885,58,943
公投第８案,臺中市,北區,賴厝里,1031,1430,613,154,767,37,804
公投第８案,臺中市,北區,賴福里,1032,2018,830,270,1100,54,1154
公投第８案,臺中市,北區,賴福里,1033,1710,645,165,810,43,853
公投第８案,臺中市,北區,賴興里,1034,1432,596,155,751,38,789
公投第８案,臺中市,北區,賴興里,1035,1157,507,147,654,37,691
公投第８案,臺中市,北區,賴興里,1036,1188,518,130,648,35,683
公投第８案,臺中市,北區,賴旺里,1037,1419,595,157,752,52,804
公投第８案,臺中市,北區,賴旺里,1038,1653,673,175,848,23,871
公投第８案,臺中市,北區,賴旺里,1039,1233,518,161,679,53,732
公投第８案,臺中市,北區,賴明里,1040,1243,514,163,677,34,711
公投第８案,臺中市,北區,賴明里,1041,1219,499,108,607,25,632
公投第８案,臺中市,北區,賴明里,1042,1272,504,184,688,65,753
公投第８案,臺中市,北區,梅川里,1043,1285,553,162,715,27,742
公投第８案,臺中市,北區,梅川里,1044,1780,746,239,985,43,1028
公投第８案,臺中市,北區,賴村里,1045,1461,559,152,711,31,742
公投第８案,臺中市,北區,賴村里,1046,1310,568,170,738,41,779
公投第８案,臺中市,北區,賴村里,1047,1669,666,182,848,41,889
公投第８案,臺中市,北區,育德里,1048,1932,860,206,1066,52,1118
公投第８案,臺中市,北區,育德里,1049,1682,679,206,885,41,926
公投第８案,臺中市,北區,淡溝里,1050,1891,713,239,952,36,988
公投第８案,臺中市,北區,淡溝里,1051,1882,740,236,976,84,1060
公投第８案,臺中市,北區,淡溝里,1052,1159,485,135,620,31,651
公投第８案,臺中市,北區,健行里,1053,1553,639,175,814,49,863
公投第８案,臺中市,北區,健行里,1054,1607,617,199,816,63,879
公投第８案,臺中市,北區,健行里,1055,1773,687,232,919,68,987
公投第８案,臺中市,北區,健行里,1056,1524,594,213,807,73,880
公投第８案,臺中市,北區,明德里,1057,1613,708,227,935,68,1003
公投第８案,臺中市,北區,明德里,1058,1877,831,210,1041,54,1095
公投第８案,臺中市,北區,明德里,1059,1792,716,239,955,64,1019
公投第８案,臺中市,北區,明新里,1060,1392,592,173,765,58,823
公投第８案,臺中市,北區,明新里,1061,1297,517,162,679,43,722
公投第８案,臺中市,北區,長青里,1062,1556,657,228,885,49,934
公投第８案,臺中市,北區,長青里,1063,1497,587,200,787,39,826
公投第８案,臺中市,北區,長青里,1064,1550,635,74,709,48,757
公投第８案,臺中市,北區,長青里,1065,1434,672,175,847,42,889
公投第８案,臺中市,北區,立人里,1066,1793,752,208,960,68,1028
公投第８案,臺中市,北區,立人里,1067,1866,775,222,997,47,1044
公投第８案,臺中市,北區,中達里,1068,1346,547,175,722,76,798
公投第８案,臺中市,北區,中達里,1069,1267,526,142,668,65,733
公投第８案,臺中市,中區,綠川里,1070,1652,669,250,919,93,1012
公投第８案,臺中市,中區,繼光里,1071,1531,569,227,796,56,852
公投第８案,臺中市,中區,公園里,1072,1431,537,201,738,54,792
公投第８案,臺中市,中區,光復里,1073,1060,429,126,555,59,614
公投第８案,臺中市,中區,光復里,1074,982,389,101,490,55,545
公投第８案,臺中市,中區,大墩里,1075,1191,455,166,621,65,686
公投第８案,臺中市,中區,大墩里,1076,855,336,121,457,38,495
公投第８案,臺中市,中區,柳川里,1077,1135,380,105,485,47,532
公投第８案,臺中市,中區,柳川里,1078,705,304,73,377,23,400
公投第８案,臺中市,中區,大誠里,1079,1009,429,139,568,35,603
公投第８案,臺中市,中區,大誠里,1080,1304,465,164,629,89,718
公投第８案,臺中市,中區,中華里,1081,1841,742,96,838,42,880
公投第８案,臺中市,西區,三民里,1082,1400,387,83,470,41,511
公投第８案,臺中市,西區,三民里,1083,861,393,132,525,19,544
公投第８案,臺中市,西區,利民里,1084,1416,623,173,796,43,839
公投第８案,臺中市,西區,民生里,1085,1020,432,159,591,46,637
公投第８案,臺中市,西區,民生里,1086,778,368,115,483,30,513
公投第８案,臺中市,西區,廣民里,1087,1465,596,163,759,41,800
公投第８案,臺中市,西區,平和里,1088,1017,427,135,562,25,587
公投第８案,臺中市,西區,平和里,1089,868,388,113,501,37,538
公投第８案,臺中市,西區,東昇里,1090,1251,567,87,654,50,704
公投第８案,臺中市,西區,東昇里,1091,1044,468,163,631,53,684
公投第８案,臺中市,西區,公民里,1092,1487,611,197,808,40,848
公投第８案,臺中市,西區,公民里,1093,1573,635,200,835,71,906
公投第８案,臺中市,西區,公民里,1094,1731,748,227,975,77,1052
公投第８案,臺中市,西區,藍興里,1095,1209,512,174,686,35,721
公投第８案,臺中市,西區,藍興里,1096,1564,655,183,838,50,888
公投第８案,臺中市,西區,藍興里,1097,1175,530,153,683,45,728
公投第８案,臺中市,西區,公舘里,1098,1505,604,201,805,33,838
公投第８案,臺中市,西區,公舘里,1099,1418,604,195,799,49,848
公投第８案,臺中市,西區,公舘里,1100,1497,507,148,655,17,672
公投第８案,臺中市,西區,公舘里,1101,1260,485,216,701,55,756
公投第８案,臺中市,西區,安龍里,1102,1399,589,192,781,67,848
公投第８案,臺中市,西區,安龍里,1103,1447,593,182,775,52,827
公投第８案,臺中市,西區,吉龍里,1104,1683,700,215,915,67,982
公投第８案,臺中市,西區,吉龍里,1105,1585,697,193,890,63,953
公投第８案,臺中市,西區,吉龍里,1106,1557,695,188,883,48,931
公投第８案,臺中市,西區,吉龍里,1107,1663,663,172,835,69,904
公投第８案,臺中市,西區,土庫里,1108,1921,776,277,1053,67,1120
公投第８案,臺中市,西區,土庫里,1109,1952,712,247,959,57,1016
公投第８案,臺中市,西區,土庫里,1110,1708,663,228,891,54,945
公投第８案,臺中市,西區,大忠里,1111,1131,532,150,682,32,714
公投第８案,臺中市,西區,大忠里,1112,1916,787,193,980,65,1045
公投第８案,臺中市,西區,大忠里,1113,1275,561,183,744,28,772
公投第８案,臺中市,西區,民龍里,1114,1822,704,182,886,76,962
公投第８案,臺中市,西區,民龍里,1115,1374,585,178,763,45,808
公投第８案,臺中市,西區,和龍里,1116,1129,439,140,579,76,655
公投第８案,臺中市,西區,和龍里,1117,1201,432,190,622,42,664
公投第８案,臺中市,西區,後龍里,1118,1639,653,198,851,72,923
公投第８案,臺中市,西區,後龍里,1119,1863,749,257,1006,83,1089
公投第８案,臺中市,西區,双龍里,1120,1287,601,157,758,62,820
公投第８案,臺中市,西區,双龍里,1121,1504,651,210,861,53,914
公投第８案,臺中市,西區,昇平里,1122,1308,522,181,703,58,761
公投第８案,臺中市,西區,昇平里,1123,1433,602,171,773,68,841
公投第８案,臺中市,西區,昇平里,1124,1450,585,193,778,37,815
公投第８案,臺中市,西區,昇平里,1125,1465,685,193,878,50,928
公投第８案,臺中市,西區,中興里,1126,1818,669,256,925,74,999
公投第８案,臺中市,西區,中興里,1127,1782,694,280,974,63,1037
公投第８案,臺中市,西區,公益里,1128,1428,578,221,799,55,854
公投第８案,臺中市,西區,公益里,1129,1366,514,158,672,52,724
公投第８案,臺中市,西區,公德里,1130,1498,611,180,791,58,849
公投第８案,臺中市,西區,公德里,1131,1350,593,160,753,56,809
公投第８案,臺中市,西區,公德里,1132,1339,600,170,770,35,805
公投第８案,臺中市,西區,公正里,1133,1613,716,197,913,50,963
公投第８案,臺中市,西區,公正里,1134,1454,605,180,785,62,847
公投第８案,臺中市,西區,公正里,1135,1597,660,240,900,53,953
公投第８案,臺中市,西區,公正里,1136,1411,667,174,841,52,893
公投第８案,臺中市,西區,公平里,1137,1493,623,190,813,73,886
公投第８案,臺中市,西區,公平里,1138,1600,716,202,918,59,977
公投第８案,臺中市,西區,公平里,1139,1710,682,220,902,64,966
公投第８案,臺中市,西區,忠明里,1140,1139,491,145,636,41,677
公投第８案,臺中市,西區,忠明里,1141,1105,482,136,618,56,674
公投第８案,臺中市,西區,忠明里,1142,1498,616,192,808,57,865
公投第８案,臺中市,西區,忠明里,1143,1921,678,226,904,40,944
公投第８案,臺中市,西區,忠誠里,1144,1340,523,186,709,68,777
公投第８案,臺中市,西區,忠誠里,1145,1536,669,222,891,43,934
公投第８案,臺中市,西區,忠誠里,1146,1361,519,198,717,81,798
公投第８案,臺中市,西區,忠誠里,1147,1430,677,171,848,41,889
公投第８案,臺中市,東區,新庄里,1148,1138,291,108,399,31,430
公投第８案,臺中市,東區,新庄里,1149,984,412,117,529,29,558
公投第８案,臺中市,東區,新庄里,1150,877,362,115,477,43,520
公投第８案,臺中市,東區,振興里,1151,1070,464,165,629,55,684
公投第８案,臺中市,東區,振興里,1152,1106,443,170,613,66,679
公投第８案,臺中市,東區,振興里,1153,953,390,116,506,71,577
公投第８案,臺中市,東區,東橋里,1154,1195,507,155,662,29,691
公投第８案,臺中市,東區,東橋里,1155,1251,515,145,660,44,704
公投第８案,臺中市,東區,東橋里,1156,1190,414,193,607,59,666
公投第８案,臺中市,東區,東興里,1157,1394,577,160,737,49,786
公投第８案,臺中市,東區,東興里,1158,1443,582,231,813,61,874
公投第８案,臺中市,東區,泉源里,1159,762,290,111,401,35,436
公投第８案,臺中市,東區,泉源里,1160,1140,504,168,672,51,723
公投第８案,臺中市,東區,干城里,1161,1211,475,194,669,77,746
公投第８案,臺中市,東區,干城里,1162,755,364,88,452,28,480
公投第８案,臺中市,東區,旱溪里,1163,1491,570,189,759,79,838
公投第８案,臺中市,東區,旱溪里,1164,1000,365,132,497,33,530
公投第８案,臺中市,東區,樂成里,1165,1114,438,174,612,64,676
公投第８案,臺中市,東區,樂成里,1166,1101,437,135,572,48,620
公投第８案,臺中市,東區,東門里,1167,1169,486,185,671,82,753
公投第８案,臺中市,東區,東門里,1168,1283,542,178,720,82,802
公投第８案,臺中市,東區,東門里,1169,1168,517,173,690,45,735
公投第８案,臺中市,東區,東門里,1170,1386,524,184,708,40,748
公投第８案,臺中市,東區,東門里,1171,1557,643,210,853,64,917
公投第８案,臺中市,東區,十甲里,1172,1380,534,204,738,77,815
公投第８案,臺中市,東區,十甲里,1173,1674,658,241,899,65,964
公投第８案,臺中市,東區,十甲里,1174,1604,716,226,942,53,995
公投第８案,臺中市,東區,東英里,1175,1815,792,238,1030,60,1090
公投第８案,臺中市,東區,東英里,1176,1700,670,202,872,65,937
公投第８案,臺中市,東區,東英里,1177,1592,652,202,854,53,907
公投第８案,臺中市,東區,東英里,1178,1850,708,200,908,10,918
公投第８案,臺中市,東區,東南里,1179,1252,580,130,710,40,750
公投第８案,臺中市,東區,東南里,1180,1250,557,184,741,48,789
公投第８案,臺中市,東區,東南里,1181,1241,551,153,704,55,759
公投第８案,臺中市,東區,東勢里,1182,1318,494,158,652,55,707
公投第８案,臺中市,東區,東勢里,1183,1288,516,152,668,65,733
公投第８案,臺中市,東區,合作里,1184,1442,635,169,804,88,892
公投第８案,臺中市,東區,合作里,1185,1202,508,143,651,63,714
公投第８案,臺中市,東區,合作里,1186,1452,669,128,797,60,857
公投第８案,臺中市,東區,富仁里,1187,1480,608,176,784,44,828
公投第８案,臺中市,東區,富仁里,1188,1736,800,132,932,51,983
公投第８案,臺中市,東區,富仁里,1189,867,331,112,443,52,495
公投第８案,臺中市,東區,富台里,1190,1693,674,142,816,65,881
公投第８案,臺中市,東區,東信里,1191,1538,669,188,857,78,935
公投第８案,臺中市,東區,東信里,1192,1593,624,266,890,110,1000
公投第８案,臺中市,東區,東信里,1193,1481,604,170,774,36,810
公投第８案,臺中市,東區,東信里,1194,1414,634,171,805,50,855
公投第８案,臺中市,東區,東信里,1195,1297,497,166,663,44,707
公投第８案,臺中市,東區,東信里,1196,1394,545,207,752,80,832
公投第８案,臺中市,南區,長春里,1197,937,386,142,528,44,572
公投第８案,臺中市,南區,長春里,1198,1001,449,151,600,56,656
公投第８案,臺中市,南區,長榮里,1199,1249,570,186,756,66,822
公投第８案,臺中市,南區,長榮里,1200,1202,562,201,763,55,818
公投第８案,臺中市,南區,城隍里,1201,1130,467,162,629,85,714
公投第８案,臺中市,南區,城隍里,1202,1239,538,172,710,73,783
公投第８案,臺中市,南區,城隍里,1203,1238,491,167,658,69,727
公投第８案,臺中市,南區,國光里,1204,1272,516,204,720,67,787
公投第８案,臺中市,南區,國光里,1205,1273,519,185,704,61,765
公投第８案,臺中市,南區,國光里,1206,1317,521,202,723,82,805
公投第８案,臺中市,南區,南門里,1207,1160,575,166,741,47,788
公投第８案,臺中市,南區,南門里,1208,1205,539,177,716,70,786
公投第８案,臺中市,南區,南門里,1209,1111,475,159,634,50,684
公投第８案,臺中市,南區,德義里,1210,1407,659,199,858,65,923
公投第８案,臺中市,南區,德義里,1211,1419,617,181,798,55,853
公投第８案,臺中市,南區,積善里,1212,1157,503,162,665,71,736
公投第８案,臺中市,南區,積善里,1213,1415,576,177,753,45,798
公投第８案,臺中市,南區,江川里,1214,1289,578,192,770,77,847
公投第８案,臺中市,南區,江川里,1215,1454,612,191,803,67,870
公投第８案,臺中市,南區,新榮里,1216,1491,641,152,793,69,862
公投第８案,臺中市,南區,新榮里,1217,1394,627,160,787,38,825
公投第８案,臺中市,南區,新榮里,1218,1430,603,200,803,51,854
公投第８案,臺中市,南區,福興里,1219,1342,564,180,744,93,837
公投第８案,臺中市,南區,福興里,1220,1304,587,192,779,103,882
公投第８案,臺中市,南區,福興里,1221,1190,548,152,700,45,745
公投第８案,臺中市,南區,福平里,1222,1273,568,114,682,71,753
公投第８案,臺中市,南區,福平里,1223,1387,650,177,827,77,904
公投第８案,臺中市,南區,福平里,1224,1356,562,193,755,59,814
公投第８案,臺中市,南區,福平里,1225,1304,579,167,746,69,815
公投第８案,臺中市,南區,福順里,1226,1256,579,178,757,29,786
公投第８案,臺中市,南區,福順里,1227,1364,629,201,830,38,868
公投第８案,臺中市,南區,福順里,1228,1361,558,206,764,82,846
公投第８案,臺中市,南區,福順里,1229,1407,652,178,830,39,869
公投第８案,臺中市,南區,和平里,1230,1308,549,187,736,63,799
公投第８案,臺中市,南區,和平里,1231,1250,545,142,687,47,734
公投第８案,臺中市,南區,和平里,1232,1284,518,175,693,47,740
公投第８案,臺中市,南區,平和里,1233,1175,509,171,680,74,754
公投第８案,臺中市,南區,平和里,1234,1158,523,194,717,52,769
公投第８案,臺中市,南區,平和里,1235,1168,502,162,664,53,717
公投第８案,臺中市,南區,南和里,1236,1626,767,210,977,58,1035
公投第８案,臺中市,南區,南和里,1237,2115,619,212,831,46,877
公投第８案,臺中市,南區,南和里,1238,1805,769,177,946,53,999
公投第８案,臺中市,南區,南和里,1239,1695,709,183,892,53,945
公投第８案,臺中市,南區,永興里,1240,1643,765,219,984,58,1042
公投第８案,臺中市,南區,永興里,1241,1423,622,212,834,47,881
公投第８案,臺中市,南區,永興里,1242,1542,681,188,869,44,913
公投第８案,臺中市,南區,永興里,1243,1533,800,78,878,39,917
公投第８案,臺中市,南區,永興里,1244,1531,708,203,911,78,989
公投第８案,臺中市,南區,永和里,1245,1392,536,171,707,37,744
公投第８案,臺中市,南區,永和里,1246,1592,671,182,853,50,903
公投第８案,臺中市,南區,永和里,1247,1431,647,190,837,56,893
公投第８案,臺中市,南區,樹義里,1248,1799,703,216,919,59,978
公投第８案,臺中市,南區,樹義里,1249,1708,821,202,1023,62,1085
公投第８案,臺中市,南區,樹義里,1250,1700,708,207,915,65,980
公投第８案,臺中市,南區,樹義里,1251,1751,822,201,1023,52,1075
公投第８案,臺中市,南區,樹義里,1252,2109,927,255,1182,69,1251
公投第８案,臺中市,南區,樹義里,1253,1697,715,224,939,63,1002
公投第８案,臺中市,南區,工學里,1254,1456,635,172,807,57,864
公投第８案,臺中市,南區,工學里,1255,1726,831,257,1088,58,1146
公投第８案,臺中市,南區,工學里,1256,1723,779,219,998,84,1082
公投第８案,臺中市,南區,工學里,1257,1569,702,203,905,66,971
公投第８案,臺中市,南區,樹德里,1258,1274,576,165,741,46,787
公投第８案,臺中市,南區,樹德里,1259,1390,675,196,871,48,919
公投第８案,臺中市,南區,樹德里,1260,1295,560,214,774,45,819
公投第８案,臺中市,南區,樹德里,1261,1312,582,155,737,68,805
公投第８案,臺中市,南區,樹德里,1262,1417,692,164,856,45,901
公投第８案,臺中市,南區,樹德里,1263,1230,646,161,807,46,853
公投第８案,臺中市,南區,西川里,1264,1308,557,166,723,58,781
公投第８案,臺中市,南區,西川里,1265,1467,595,199,794,81,875
公投第８案,臺中市,南區,西川里,1266,1399,638,147,785,72,857
公投第８案,臺中市,南區,崇倫里,1267,1207,503,161,664,68,732
公投第８案,臺中市,南區,崇倫里,1268,1317,571,150,721,52,773
公投第８案,臺中市,南區,崇倫里,1269,1563,652,216,868,47,915
公投第８案,臺中市,南區,崇倫里,1270,1221,600,140,740,32,772
公投第８案,臺中市,太平區,太平里,1271,1821,678,217,895,99,994
公投第８案,臺中市,太平區,太平里,1272,1680,598,188,786,52,838
公投第８案,臺中市,太平區,太平里,1273,1947,784,235,1019,111,1130
公投第８案,臺中市,太平區,長億里,1274,1910,764,264,1028,120,1148
公投第８案,臺中市,太平區,長億里,1275,1894,704,244,948,61,1009
公投第８案,臺中市,太平區,長億里,1276,1953,777,227,1004,73,1077
公投第８案,臺中市,太平區,永成里,1277,1846,769,208,977,83,1060
公投第８案,臺中市,太平區,永成里,1278,1493,648,181,829,48,877
公投第８案,臺中市,太平區,永成里,1279,1605,649,184,833,65,898
公投第８案,臺中市,太平區,永成里,1280,1619,718,189,907,46,953
公投第８案,臺中市,太平區,中平里,1281,2011,746,252,998,90,1088
公投第８案,臺中市,太平區,中平里,1282,2056,793,218,1011,40,1051
公投第８案,臺中市,太平區,中政里,1283,1876,740,208,948,84,1032
公投第８案,臺中市,太平區,中政里,1284,1815,703,198,901,85,986
公投第８案,臺中市,太平區,平安里,1285,1281,486,162,648,59,707
公投第８案,臺中市,太平區,平安里,1286,1004,449,158,607,51,658
公投第８案,臺中市,太平區,中興里,1287,1886,771,266,1037,86,1123
公投第８案,臺中市,太平區,中興里,1288,1431,571,198,769,91,860
公投第８案,臺中市,太平區,永平里,1289,1930,748,222,970,80,1050
公投第８案,臺中市,太平區,永平里,1290,2164,790,228,1018,104,1122
公投第８案,臺中市,太平區,東平里,1291,2048,803,208,1011,96,1107
公投第８案,臺中市,太平區,東平里,1292,2035,808,215,1023,71,1094
公投第８案,臺中市,太平區,成功里,1293,1685,628,194,822,110,932
公投第８案,臺中市,太平區,成功里,1294,2185,757,237,994,88,1082
公投第８案,臺中市,太平區,東和里,1295,1176,458,127,585,31,616
公投第８案,臺中市,太平區,東和里,1296,1597,607,188,795,55,850
公投第８案,臺中市,太平區,建國里,1297,1378,521,190,711,77,788
公投第８案,臺中市,太平區,建國里,1298,1546,575,186,761,76,837
公投第８案,臺中市,太平區,建興里,1299,1890,665,201,866,95,961
公投第８案,臺中市,太平區,建興里,1300,1053,426,105,531,64,595
公投第８案,臺中市,太平區,坪林里,1301,1582,702,159,861,88,949
公投第８案,臺中市,太平區,坪林里,1302,1699,734,190,924,72,996
公投第８案,臺中市,太平區,大興里,1303,1493,569,157,726,79,805
公投第８案,臺中市,太平區,大興里,1304,1063,393,136,529,48,577
公投第８案,臺中市,太平區,勤益里,1305,1117,500,126,626,55,681
公投第８案,臺中市,太平區,勤益里,1306,1084,487,105,592,56,648
公投第８案,臺中市,太平區,光華里,1307,1776,657,184,841,53,894
公投第８案,臺中市,太平區,光華里,1308,1729,694,185,879,5,884
公投第８案,臺中市,太平區,光華里,1309,1658,594,149,743,62,805
公投第８案,臺中市,太平區,光明里,1310,2010,825,165,990,75,1065
公投第８案,臺中市,太平區,光明里,1311,1752,709,156,865,65,930
公投第８案,臺中市,太平區,中山里,1312,1654,737,181,918,77,995
公投第８案,臺中市,太平區,中山里,1313,1951,591,131,722,45,767
公投第８案,臺中市,太平區,豐年里,1314,2170,960,281,1241,101,1342
公投第８案,臺中市,太平區,豐年里,1315,2231,976,275,1251,67,1318
公投第８案,臺中市,太平區,宜欣里,1316,1623,695,170,865,48,913
公投第８案,臺中市,太平區,宜欣里,1317,1548,541,162,703,60,763
公投第８案,臺中市,太平區,宜欣里,1318,1442,539,168,707,84,791
公投第８案,臺中市,太平區,宜欣里,1319,1501,512,170,682,39,721
公投第８案,臺中市,太平區,宜佳里,1320,2025,733,195,928,40,968
公投第８案,臺中市,太平區,宜佳里,1321,1885,729,207,936,71,1007
公投第８案,臺中市,太平區,宜佳里,1322,2155,743,225,968,84,1052
公投第８案,臺中市,太平區,宜昌里,1323,1775,604,205,809,62,871
公投第８案,臺中市,太平區,宜昌里,1324,2021,657,170,827,94,921
公投第８案,臺中市,太平區,新坪里,1325,2075,900,230,1130,85,1215
公投第８案,臺中市,太平區,新坪里,1326,1723,628,201,829,68,897
公投第８案,臺中市,太平區,新坪里,1327,2049,855,210,1065,79,1144
公投第８案,臺中市,太平區,新坪里,1328,1415,600,145,745,35,780
公投第８案,臺中市,太平區,新吉里,1329,1778,739,190,929,57,986
公投第８案,臺中市,太平區,新吉里,1330,1706,642,195,837,62,899
公投第８案,臺中市,太平區,新吉里,1331,2090,844,214,1058,65,1123
公投第８案,臺中市,太平區,新城里,1332,2093,792,185,977,71,1048
公投第８案,臺中市,太平區,新城里,1333,1688,596,146,742,49,791
公投第８案,臺中市,太平區,新城里,1334,1488,586,113,699,51,750
公投第８案,臺中市,太平區,新光里,1335,1667,685,240,925,71,996
公投第８案,臺中市,太平區,新光里,1336,1793,718,209,927,92,1019
公投第８案,臺中市,太平區,新光里,1337,1903,838,186,1024,46,1070
公投第８案,臺中市,太平區,新光里,1338,1834,737,210,947,76,1023
公投第８案,臺中市,太平區,新興里,1339,1526,618,139,757,51,808
公投第８案,臺中市,太平區,新興里,1340,1483,708,170,878,38,916
公投第８案,臺中市,太平區,新興里,1341,1694,736,177,913,41,954
公投第８案,臺中市,太平區,新高里,1342,1952,723,197,920,50,970
公投第８案,臺中市,太平區,新高里,1343,1995,809,209,1018,54,1072
公投第８案,臺中市,太平區,新高里,1344,1311,576,145,721,38,759
公投第８案,臺中市,太平區,新高里,1345,1537,776,182,958,58,1016
公投第８案,臺中市,太平區,新福里,1346,1974,721,195,916,62,978
公投第８案,臺中市,太平區,新福里,1347,1828,768,201,969,53,1022
公投第８案,臺中市,太平區,新福里,1348,2191,807,210,1017,50,1067
公投第８案,臺中市,太平區,頭汴里,1349,1825,666,200,866,107,973
公投第８案,臺中市,太平區,聖和里,1350,1559,562,160,722,15,737
公投第８案,臺中市,太平區,東汴里,1351,1225,464,144,608,79,687
公投第８案,臺中市,太平區,興隆里,1352,1678,670,191,861,71,932
公投第８案,臺中市,太平區,興隆里,1353,1501,524,175,699,101,800
公投第８案,臺中市,太平區,福隆里,1354,1450,623,220,843,78,921
公投第８案,臺中市,太平區,福隆里,1355,2126,796,207,1003,82,1085
公投第８案,臺中市,太平區,黃竹里,1356,699,300,95,395,55,450
公投第８案,臺中市,太平區,光隆里,1357,1428,458,161,619,41,660
公投第８案,臺中市,太平區,光隆里,1358,1666,664,195,859,98,957
公投第８案,臺中市,太平區,永隆里,1359,1241,524,125,649,41,690
公投第８案,臺中市,太平區,永隆里,1360,1266,549,146,695,66,761
公投第８案,臺中市,太平區,德隆里,1361,1166,483,138,621,50,671
公投第８案,臺中市,太平區,德隆里,1362,1790,635,208,843,86,929
公投第８案,臺中市,太平區,德隆里,1363,1754,595,151,746,65,811
公投第８案,臺中市,大里區,東湖里,1364,1614,626,174,800,52,852
公投第８案,臺中市,大里區,東湖里,1365,1599,596,163,759,39,798
公投第８案,臺中市,大里區,東湖里,1366,1715,625,194,819,53,872
公投第８案,臺中市,大里區,東湖里,1367,1264,534,140,674,32,706
公投第８案,臺中市,大里區,東湖里,1368,1416,555,141,696,44,740
公投第８案,臺中市,大里區,東湖里,1369,1188,483,124,607,40,647
公投第８案,臺中市,大里區,東湖里,1370,1359,491,163,654,66,720
公投第８案,臺中市,大里區,西湖里,1371,1457,597,181,778,62,840
公投第８案,臺中市,大里區,西湖里,1372,1403,593,171,764,64,828
公投第８案,臺中市,大里區,大里里,1373,1697,660,196,856,62,918
公投第８案,臺中市,大里區,大里里,1374,1811,746,239,985,99,1084
公投第８案,臺中市,大里區,新里里,1375,1830,705,208,913,68,981
公投第８案,臺中市,大里區,新里里,1376,2228,670,200,870,98,968
公投第８案,臺中市,大里區,新里里,1377,1997,836,219,1055,94,1149
公投第８案,臺中市,大里區,新里里,1378,2033,986,246,1232,60,1292
公投第８案,臺中市,大里區,新里里,1379,1835,728,267,995,53,1048
公投第８案,臺中市,大里區,國光里,1380,1268,531,149,680,37,717
公投第８案,臺中市,大里區,國光里,1381,1645,704,190,894,62,956
公投第８案,臺中市,大里區,國光里,1382,1561,692,173,865,48,913
公投第８案,臺中市,大里區,國光里,1383,1301,637,168,805,38,843
公投第８案,臺中市,大里區,樹王里,1384,1621,633,172,805,73,878
公投第８案,臺中市,大里區,樹王里,1385,1797,653,234,887,83,970
公投第８案,臺中市,大里區,祥興里,1386,1230,488,125,613,28,641
公投第８案,臺中市,大里區,祥興里,1387,1488,586,157,743,61,804
公投第８案,臺中市,大里區,祥興里,1388,1459,531,181,712,82,794
公投第８案,臺中市,大里區,祥興里,1389,1647,668,193,861,73,934
公投第８案,臺中市,大里區,祥興里,1390,1100,443,157,600,70,670
公投第８案,臺中市,大里區,內新里,1391,1410,575,172,747,58,805
公投第８案,臺中市,大里區,內新里,1392,1807,676,203,879,78,957
公投第８案,臺中市,大里區,內新里,1393,1331,523,184,707,54,761
公投第８案,臺中市,大里區,內新里,1394,1801,713,199,912,57,969
公投第８案,臺中市,大里區,內新里,1395,1909,736,183,919,46,965
公投第８案,臺中市,大里區,中新里,1396,1699,598,173,771,89,860
公投第８案,臺中市,大里區,中新里,1397,1627,697,190,887,58,945
公投第８案,臺中市,大里區,中新里,1398,1912,780,186,966,70,1036
公投第８案,臺中市,大里區,東昇里,1399,1753,677,182,859,78,937
公投第８案,臺中市,大里區,東昇里,1400,1602,649,168,817,58,875
公投第８案,臺中市,大里區,大元里,1401,1144,460,130,590,68,658
公投第８案,臺中市,大里區,大元里,1402,1655,648,240,888,76,964
公投第８案,臺中市,大里區,大元里,1403,1438,578,183,761,45,806
公投第８案,臺中市,大里區,夏田里,1404,1000,410,125,535,58,593
公投第８案,臺中市,大里區,仁化里,1405,1711,705,174,879,80,959
公投第８案,臺中市,大里區,仁化里,1406,1698,694,154,848,12,860
公投第８案,臺中市,大里區,仁化里,1407,1914,712,262,974,94,1068
公投第８案,臺中市,大里區,仁化里,1408,1465,615,182,797,31,828
公投第８案,臺中市,大里區,仁化里,1409,1581,638,185,823,85,908
公投第８案,臺中市,大里區,仁德里,1410,1509,632,183,815,79,894
公投第８案,臺中市,大里區,仁德里,1411,1570,631,149,780,36,816
公投第８案,臺中市,大里區,仁德里,1412,1425,579,192,771,50,821
公投第８案,臺中市,大里區,仁德里,1413,1384,553,192,745,76,821
公投第８案,臺中市,大里區,健民里,1414,1204,382,150,532,48,580
公投第８案,臺中市,大里區,健民里,1415,1761,624,180,804,39,843
公投第８案,臺中市,大里區,健民里,1416,1473,525,139,664,37,701
公投第８案,臺中市,大里區,塗城里,1417,1675,704,186,890,62,952
公投第８案,臺中市,大里區,塗城里,1418,1755,758,160,918,70,988
公投第８案,臺中市,大里區,塗城里,1419,1593,632,210,842,95,937
公投第８案,臺中市,大里區,塗城里,1420,1799,724,201,925,75,1000
公投第８案,臺中市,大里區,塗城里,1421,1606,647,183,830,86,916
公投第８案,臺中市,大里區,東興里,1422,1875,705,222,927,46,973
公投第８案,臺中市,大里區,東興里,1423,1670,674,214,888,66,954
公投第８案,臺中市,大里區,東興里,1424,1898,717,226,943,64,1007
公投第８案,臺中市,大里區,東興里,1425,1679,651,173,824,42,866
公投第８案,臺中市,大里區,大明里,1426,1373,522,157,679,71,750
公投第８案,臺中市,大里區,大明里,1427,1299,533,146,679,72,751
公投第８案,臺中市,大里區,大明里,1428,1430,595,158,753,54,807
公投第８案,臺中市,大里區,永隆里,1429,1805,845,243,1088,50,1138
公投第８案,臺中市,大里區,永隆里,1430,1806,881,244,1125,31,1156
公投第８案,臺中市,大里區,永隆里,1431,1826,911,227,1138,56,1194
公投第８案,臺中市,大里區,永隆里,1432,1805,912,219,1131,45,1176
公投第８案,臺中市,大里區,永隆里,1433,1907,878,207,1085,64,1149
公投第８案,臺中市,大里區,日新里,1434,1103,541,141,682,57,739
公投第８案,臺中市,大里區,日新里,1435,1419,590,138,728,68,796
公投第８案,臺中市,大里區,日新里,1436,1434,552,163,715,77,792
公投第８案,臺中市,大里區,西榮里,1437,1875,644,185,829,51,880
公投第８案,臺中市,大里區,西榮里,1438,1862,713,240,953,54,1007
公投第８案,臺中市,大里區,西榮里,1439,1850,750,186,936,42,978
公投第８案,臺中市,大里區,長榮里,1440,1622,650,206,856,77,933
公投第８案,臺中市,大里區,長榮里,1441,1638,736,205,941,71,1012
公投第８案,臺中市,大里區,長榮里,1442,1633,688,243,931,89,1020
公投第８案,臺中市,大里區,長榮里,1443,1662,688,205,893,42,935
公投第８案,臺中市,大里區,長榮里,1444,1917,892,198,1090,45,1135
公投第８案,臺中市,大里區,金城里,1445,1701,611,200,811,85,896
公投第８案,臺中市,大里區,金城里,1446,1549,604,152,756,76,832
公投第８案,臺中市,大里區,金城里,1447,1567,666,197,863,76,939
公投第８案,臺中市,大里區,金城里,1448,1614,673,170,843,81,924
公投第８案,臺中市,大里區,金城里,1449,1811,719,216,935,101,1036
公投第８案,臺中市,大里區,金城里,1450,1336,160,535,695,53,748
公投第８案,臺中市,大里區,立仁里,1451,1759,678,196,874,61,935
公投第８案,臺中市,大里區,立仁里,1452,1783,647,202,849,90,939
公投第８案,臺中市,大里區,立仁里,1453,1736,601,198,799,84,883
公投第８案,臺中市,大里區,立德里,1454,1874,780,204,984,66,1050
公投第８案,臺中市,大里區,立德里,1455,1889,775,221,996,71,1067
公投第８案,臺中市,大里區,立德里,1456,1947,744,227,971,65,1036
公投第８案,臺中市,大里區,立德里,1457,1938,847,217,1064,65,1129
公投第８案,臺中市,大里區,新仁里,1458,1836,741,218,959,82,1041
公投第８案,臺中市,大里區,新仁里,1459,1913,758,202,960,87,1047
公投第８案,臺中市,大里區,新仁里,1460,1913,723,203,926,95,1021
公投第８案,臺中市,大里區,新仁里,1461,1937,761,176,937,64,1001
公投第８案,臺中市,大里區,瑞城里,1462,1508,606,167,773,43,816
公投第８案,臺中市,大里區,瑞城里,1463,1340,582,162,744,33,777
公投第８案,臺中市,大里區,瑞城里,1464,1656,711,187,898,72,970
公投第８案,臺中市,大里區,瑞城里,1465,1290,521,153,674,45,719
公投第８案,臺中市,大里區,瑞城里,1466,1655,691,183,874,45,919
公投第８案,臺中市,大里區,瑞城里,1467,1260,439,141,580,28,608
公投第８案,臺中市,大里區,瑞城里,1468,1247,543,154,697,44,741
公投第８案,臺中市,大里區,瑞城里,1469,1548,594,195,789,76,865
公投第８案,臺中市,霧峰區,桐林里,1470,1205,541,150,691,50,741
公投第８案,臺中市,霧峰區,吉峰里,1471,1620,651,209,860,63,923
公投第８案,臺中市,霧峰區,吉峰里,1472,1559,691,191,882,71,953
公投第８案,臺中市,霧峰區,吉峰里,1473,1660,686,192,878,73,951
公投第８案,臺中市,霧峰區,吉峰里,1474,1602,716,189,905,69,974
公投第８案,臺中市,霧峰區,吉峰里,1475,1325,527,145,672,54,726
公投第８案,臺中市,霧峰區,吉峰里,1476,1515,654,161,815,60,875
公投第８案,臺中市,霧峰區,甲寅里,1477,1561,596,202,798,82,880
公投第８案,臺中市,霧峰區,甲寅里,1478,1691,633,212,845,64,909
公投第８案,臺中市,霧峰區,甲寅里,1479,1486,606,184,790,69,859
公投第８案,臺中市,霧峰區,本鄉里,1480,975,385,157,542,70,612
公投第８案,臺中市,霧峰區,本鄉里,1481,1358,632,139,771,61,832
公投第８案,臺中市,霧峰區,中正里,1482,1141,559,146,705,54,759
公投第８案,臺中市,霧峰區,中正里,1483,855,374,114,488,90,578
公投第８案,臺中市,霧峰區,錦榮里,1484,1202,508,129,637,82,719
公投第８案,臺中市,霧峰區,萊園里,1485,1078,427,121,548,54,602
公投第８案,臺中市,霧峰區,本堂里,1486,1456,613,192,805,89,894
公投第８案,臺中市,霧峰區,本堂里,1487,1573,700,183,883,66,949
公投第８案,臺中市,霧峰區,本堂里,1488,1591,707,163,870,68,938
公投第８案,臺中市,霧峰區,本堂里,1489,1214,567,142,709,70,779
公投第８案,臺中市,霧峰區,北柳里,1490,1267,507,150,657,66,723
公投第８案,臺中市,霧峰區,北柳里,1491,1277,563,110,673,86,759
公投第８案,臺中市,霧峰區,北柳里,1492,1366,546,172,718,60,778
公投第８案,臺中市,霧峰區,南柳里,1493,994,466,153,619,69,688
公投第８案,臺中市,霧峰區,南柳里,1494,863,381,118,499,46,545
公投第８案,臺中市,霧峰區,四德里,1495,1274,518,155,673,57,730
公投第８案,臺中市,霧峰區,四德里,1496,1162,452,152,604,76,680
公投第８案,臺中市,霧峰區,五福里,1497,1252,538,148,686,89,775
公投第８案,臺中市,霧峰區,五福里,1498,1322,522,188,710,80,790
公投第８案,臺中市,霧峰區,丁台里,1499,1116,477,157,634,72,706
公投第８案,臺中市,霧峰區,丁台里,1500,1156,473,180,653,81,734
公投第８案,臺中市,霧峰區,北勢里,1501,1147,542,120,662,60,722
公投第８案,臺中市,霧峰區,北勢里,1502,928,458,110,568,60,628
公投第８案,臺中市,霧峰區,南勢里,1503,1296,513,162,675,54,729
公投第８案,臺中市,霧峰區,萬豐里,1504,1314,558,75,633,85,718
公投第８案,臺中市,霧峰區,萬豐里,1505,1328,562,165,727,81,808
公投第８案,臺中市,霧峰區,舊正里,1506,989,379,131,510,72,582
公投第８案,臺中市,霧峰區,舊正里,1507,1088,480,120,600,83,683
公投第８案,臺中市,霧峰區,坑口里,1508,1363,634,140,774,82,856
公投第８案,臺中市,霧峰區,坑口里,1509,1573,682,200,882,82,964
公投第８案,臺中市,霧峰區,峰谷里,1510,1117,440,128,568,80,648
公投第８案,臺中市,霧峰區,六股里,1511,1342,592,182,774,86,860
公投第８案,臺中市,霧峰區,六股里,1512,1024,446,135,581,101,682
公投第８案,臺中市,東勢區,慶福里,1513,1299,503,147,650,67,717
公投第８案,臺中市,東勢區,慶東里,1514,1007,373,126,499,57,556
公投第８案,臺中市,東勢區,慶東里,1515,859,322,87,409,71,480
公投第８案,臺中市,東勢區,上城里,1516,991,419,140,559,87,646
公投第８案,臺中市,東勢區,下城里,1517,863,286,100,386,38,424
公投第８案,臺中市,東勢區,詒福里,1518,1628,614,188,802,125,927
公投第８案,臺中市,東勢區,新盛里,1519,1335,472,151,623,74,697
公投第８案,臺中市,東勢區,新盛里,1520,1092,499,145,644,54,698
公投第８案,臺中市,東勢區,新盛里,1521,1050,456,151,607,62,669
公投第８案,臺中市,東勢區,新盛里,1522,1431,613,141,754,66,820
公投第８案,臺中市,東勢區,福隆里,1523,1372,600,161,761,64,825
公投第８案,臺中市,東勢區,福隆里,1524,1412,626,158,784,49,833
公投第８案,臺中市,東勢區,福隆里,1525,878,359,93,452,64,516
公投第８案,臺中市,東勢區,隆興里,1526,1475,528,160,688,80,768
公投第８案,臺中市,東勢區,中嵙里,1527,872,354,80,434,31,465
公投第８案,臺中市,東勢區,中嵙里,1528,1006,381,119,500,66,566
公投第８案,臺中市,東勢區,泰昌里,1529,1222,493,152,645,31,676
公投第８案,臺中市,東勢區,泰昌里,1530,1228,569,162,731,74,805
公投第８案,臺中市,東勢區,泰昌里,1531,1036,363,117,480,32,512
公投第８案,臺中市,東勢區,上新里,1532,977,434,112,546,46,592
公投第８案,臺中市,東勢區,廣興里,1533,1395,581,127,708,37,745
公投第８案,臺中市,東勢區,延平里,1534,1169,504,145,649,90,739
公投第８案,臺中市,東勢區,延平里,1535,1027,445,130,575,67,642
公投第８案,臺中市,東勢區,南平里,1536,984,426,108,534,46,580
公投第８案,臺中市,東勢區,南平里,1537,866,417,101,518,44,562
公投第８案,臺中市,東勢區,東安里,1538,1031,437,114,551,87,638
公投第８案,臺中市,東勢區,中寧里,1539,865,422,85,507,68,575
公投第８案,臺中市,東勢區,北興里,1540,1357,638,150,788,74,862
公投第８案,臺中市,東勢區,粵寧里,1541,736,337,77,414,35,449
公投第８案,臺中市,東勢區,粵寧里,1542,1314,552,155,707,62,769
公投第８案,臺中市,東勢區,下新里,1543,1677,601,198,799,108,907
公投第８案,臺中市,東勢區,東新里,1544,950,408,124,532,35,567
公投第８案,臺中市,東勢區,東新里,1545,1007,458,114,572,53,625
公投第８案,臺中市,東勢區,興隆里,1546,1214,384,172,556,64,620
公投第８案,臺中市,東勢區,茂興里,1547,907,370,100,470,50,520
公投第８案,臺中市,東勢區,茂興里,1548,902,352,99,451,48,499
公投第８案,臺中市,東勢區,泰興里,1549,720,235,65,300,19,319
公投第８案,臺中市,東勢區,埤頭里,1550,666,214,78,292,13,305
公投第８案,臺中市,東勢區,明正里,1551,1361,516,146,662,78,740
公投第８案,臺中市,石岡區,石岡里,1552,1244,521,151,672,54,726
公投第８案,臺中市,石岡區,萬安里,1553,1539,612,185,797,67,864
公投第８案,臺中市,石岡區,九房里,1554,1202,485,163,648,62,710
公投第８案,臺中市,石岡區,金星里,1555,1272,478,141,619,78,697
公投第８案,臺中市,石岡區,龍興里,1556,652,274,70,344,47,391
公投第８案,臺中市,石岡區,萬興里,1557,1457,668,193,861,98,959
公投第８案,臺中市,石岡區,梅子里,1558,1836,721,218,939,97,1036
公投第８案,臺中市,石岡區,土牛里,1559,1001,425,99,524,55,579
公投第８案,臺中市,石岡區,德興里,1560,1448,627,187,814,70,884
公投第８案,臺中市,石岡區,和盛里,1561,1229,548,148,696,67,763
公投第８案,臺中市,新社區,新社里,1562,1011,390,126,516,34,550
公投第８案,臺中市,新社區,新社里,1563,1195,483,153,636,43,679
公投第８案,臺中市,新社區,新社里,1564,1053,460,122,582,45,627
公投第８案,臺中市,新社區,復盛里,1565,961,289,79,368,28,396
公投第８案,臺中市,新社區,復盛里,1566,919,348,101,449,22,471
公投第８案,臺中市,新社區,中正里,1567,1367,602,159,761,72,833
公投第８案,臺中市,新社區,月湖里,1568,1010,352,118,470,38,508
公投第８案,臺中市,新社區,崑山里,1569,1169,385,103,488,71,559
公投第８案,臺中市,新社區,大南里,1570,989,377,118,495,69,564
公投第８案,臺中市,新社區,大南里,1571,894,344,88,432,31,463
公投第８案,臺中市,新社區,永源里,1572,1033,392,96,488,22,510
公投第８案,臺中市,新社區,永源里,1573,1058,322,75,397,37,434
公投第８案,臺中市,新社區,永源里,1574,845,273,89,362,26,388
公投第８案,臺中市,新社區,中興里,1575,576,276,73,349,34,383
公投第８案,臺中市,新社區,協成里,1576,1229,429,120,549,74,623
公投第８案,臺中市,新社區,協成里,1577,890,281,82,363,38,401
公投第８案,臺中市,新社區,協成里,1578,781,277,74,351,41,392
公投第８案,臺中市,新社區,東興里,1579,1244,491,114,605,74,679
公投第８案,臺中市,新社區,慶西里,1580,213,52,11,63,15,78
公投第８案,臺中市,新社區,慶西里,1581,676,212,56,268,41,309
公投第８案,臺中市,新社區,中和里,1582,585,200,44,244,35,279
公投第８案,臺中市,新社區,福興里,1583,938,390,85,475,51,526
公投第８案,臺中市,新社區,福興里,1584,224,80,15,95,15,110
公投第８案,臺中市,和平區,南勢里,1585,956,435,137,572,39,611
公投第８案,臺中市,和平區,南勢里,1586,963,443,125,568,56,624
公投第８案,臺中市,和平區,天輪里,1587,456,181,53,234,23,257
公投第８案,臺中市,和平區,博愛里,1588,1011,471,104,575,63,638
公投第８案,臺中市,和平區,博愛里,1589,636,283,64,347,26,373
公投第８案,臺中市,和平區,自由里,1590,270,97,21,118,9,127
公投第８案,臺中市,和平區,自由里,1591,460,282,36,318,39,357
公投第８案,臺中市,和平區,自由里,1592,321,181,42,223,19,242
公投第８案,臺中市,和平區,達觀里,1593,783,367,98,465,30,495
公投第８案,臺中市,和平區,達觀里,1594,336,150,33,183,17,200
公投第８案,臺中市,和平區,中坑里,1595,451,238,56,294,14,308
公投第８案,臺中市,和平區,梨山里,1596,366,140,31,171,16,187
公投第８案,臺中市,和平區,梨山里,1597,771,265,55,320,13,333
公投第８案,臺中市,和平區,梨山里,1598,574,228,55,283,35,318
公投第８案,臺中市,和平區,梨山里,1599,274,117,33,150,19,169
公投第８案,臺中市,和平區,平等里,1600,157,63,10,73,12,85
公投第８案,臺中市,和平區,平等里,1601,713,267,54,321,20,341
公投第８案,臺南市,後壁區,後壁里,1,743,256,98,354,72,426
公投第８案,臺南市,後壁區,後壁里,2,898,303,89,392,30,422
公投第８案,臺南市,後壁區,侯伯里,3,786,218,85,303,60,363
公投第８案,臺南市,後壁區,侯伯里,4,534,147,67,214,58,272
公投第８案,臺南市,後壁區,嘉苳里,5,1034,329,122,451,78,529
公投第８案,臺南市,後壁區,嘉苳里,6,232,49,34,83,23,106
公投第８案,臺南市,後壁區,土溝里,7,479,135,53,188,45,233
公投第８案,臺南市,後壁區,土溝里,8,837,251,83,334,33,367
公投第８案,臺南市,後壁區,上茄苳里,9,1085,266,105,371,39,410
公投第８案,臺南市,後壁區,上茄苳里,10,1157,276,81,357,26,383
公投第８案,臺南市,後壁區,菁豐里,11,755,244,74,318,66,384
公投第８案,臺南市,後壁區,菁豐里,12,458,161,49,210,36,246
公投第８案,臺南市,後壁區,菁寮里,13,371,111,31,142,30,172
公投第８案,臺南市,後壁區,菁寮里,14,676,187,78,265,59,324
公投第８案,臺南市,後壁區,菁寮里,15,428,129,29,158,32,190
公投第８案,臺南市,後壁區,新嘉里,16,547,133,49,182,12,194
公投第８案,臺南市,後壁區,新嘉里,17,455,112,59,171,60,231
公投第８案,臺南市,後壁區,長短樹里,18,984,237,85,322,78,400
公投第８案,臺南市,後壁區,長短樹里,19,483,131,46,177,33,210
公投第８案,臺南市,後壁區,長短樹里,20,536,152,38,190,33,223
公投第８案,臺南市,後壁區,竹新里,21,958,219,68,287,15,302
公投第８案,臺南市,後壁區,竹新里,22,441,167,50,217,36,253
公投第８案,臺南市,後壁區,新東里,23,677,210,72,282,75,357
公投第８案,臺南市,後壁區,新東里,24,996,332,98,430,88,518
公投第８案,臺南市,後壁區,頂安里,25,1255,357,133,490,31,521
公投第８案,臺南市,後壁區,長安里,26,678,208,60,268,16,284
公投第８案,臺南市,後壁區,長安里,27,553,142,46,188,8,196
公投第８案,臺南市,後壁區,福安里,28,616,141,46,187,18,205
公投第８案,臺南市,後壁區,福安里,29,1189,358,127,485,41,526
公投第８案,臺南市,白河區,白河里,30,1176,386,152,538,85,623
公投第８案,臺南市,白河區,白河里,31,546,186,61,247,19,266
公投第８案,臺南市,白河區,永安里,32,859,304,114,418,42,460
公投第８案,臺南市,白河區,永安里,33,946,347,120,467,39,506
公投第８案,臺南市,白河區,永安里,34,1116,358,140,498,43,541
公投第８案,臺南市,白河區,外角里,35,1397,346,118,464,33,497
公投第８案,臺南市,白河區,庄內里,36,756,190,68,258,20,278
公投第８案,臺南市,白河區,庄內里,37,871,291,79,370,51,421
公投第８案,臺南市,白河區,秀祐里,38,897,298,101,399,40,439
公投第８案,臺南市,白河區,河東里,39,784,158,59,217,41,258
公投第８案,臺南市,白河區,河東里,40,572,146,62,208,23,231
公投第８案,臺南市,白河區,虎山里,41,457,97,29,126,8,134
公投第８案,臺南市,白河區,大林里,42,600,129,46,175,21,196
公投第８案,臺南市,白河區,崁頭里,43,375,74,23,97,9,106
公投第８案,臺南市,白河區,六溪里,44,508,84,28,112,10,122
公投第８案,臺南市,白河區,關嶺里,45,631,122,44,166,11,177
公投第８案,臺南市,白河區,關嶺里,46,391,73,22,95,14,109
公投第８案,臺南市,白河區,仙草里,47,799,155,63,218,21,239
公投第８案,臺南市,白河區,仙草里,48,506,103,26,129,24,153
公投第８案,臺南市,白河區,詔豐里,49,832,217,84,301,26,327
公投第８案,臺南市,白河區,詔豐里,50,1179,343,137,480,39,519
公投第８案,臺南市,白河區,大竹里,51,744,154,61,215,17,232
公投第８案,臺南市,白河區,大竹里,52,699,170,58,228,22,250
公投第８案,臺南市,白河區,廣蓮里,53,633,137,61,198,12,210
公投第８案,臺南市,白河區,廣蓮里,54,859,268,119,387,71,458
公投第８案,臺南市,白河區,竹門里,55,884,241,78,319,60,379
公投第８案,臺南市,白河區,崎內里,56,740,104,45,149,10,159
公投第８案,臺南市,白河區,昇安里,57,1334,377,111,488,57,545
公投第８案,臺南市,白河區,汴頭里,58,723,206,79,285,67,352
公投第８案,臺南市,白河區,內角里,59,682,210,91,301,72,373
公投第８案,臺南市,白河區,馬稠後里,60,855,282,110,392,46,438
公投第８案,臺南市,白河區,馬稠後里,61,543,129,54,183,28,211
公投第８案,臺南市,東山區,東山里,62,1401,403,141,544,70,614
公投第８案,臺南市,東山區,東中里,63,1185,325,92,417,43,460
公投第８案,臺南市,東山區,東中里,64,1303,328,128,456,69,525
公投第８案,臺南市,東山區,東正里,65,732,194,59,253,40,293
公投第８案,臺南市,東山區,東正里,66,721,167,61,228,43,271
公投第８案,臺南市,東山區,大客里,67,1104,233,107,340,54,394
公投第８案,臺南市,東山區,三榮里,68,943,254,66,320,43,363
公投第８案,臺南市,東山區,科里里,69,653,108,23,131,3,134
公投第８案,臺南市,東山區,科里里,70,596,155,53,208,82,290
公投第８案,臺南市,東山區,東河里,71,878,229,96,325,66,391
公投第８案,臺南市,東山區,聖賢里,72,771,171,86,257,62,319
公投第８案,臺南市,東山區,聖賢里,73,483,133,47,180,29,209
公投第８案,臺南市,東山區,聖賢里,74,640,204,63,267,52,319
公投第８案,臺南市,東山區,南溪里,75,425,63,29,92,3,95
公投第８案,臺南市,東山區,水雲里,76,394,93,31,124,20,144
公投第８案,臺南市,東山區,林安里,77,373,115,36,151,34,185
公投第８案,臺南市,東山區,東原里,78,1257,262,79,341,47,388
公投第８案,臺南市,東山區,東原里,79,887,134,53,187,7,194
公投第８案,臺南市,東山區,嶺南里,80,658,115,30,145,14,159
公投第８案,臺南市,東山區,南勢里,81,1101,198,74,272,34,306
公投第８案,臺南市,東山區,青山里,82,1057,169,70,239,18,257
公投第８案,臺南市,東山區,高原里,83,639,193,55,248,54,302
公投第８案,臺南市,東山區,高原里,84,270,66,34,100,17,117
公投第８案,臺南市,鹽水區,水秀里,85,1037,360,124,484,66,550
公投第８案,臺南市,鹽水區,水秀里,86,480,171,64,235,22,257
公投第８案,臺南市,鹽水區,津城里,87,636,249,92,341,36,377
公投第８案,臺南市,鹽水區,津城里,88,321,100,36,136,12,148
公投第８案,臺南市,鹽水區,津城里,89,497,193,65,258,36,294
公投第８案,臺南市,鹽水區,月港里,90,759,311,85,396,19,415
公投第８案,臺南市,鹽水區,月港里,91,341,119,25,144,18,162
公投第８案,臺南市,鹽水區,月港里,92,507,179,68,247,23,270
公投第８案,臺南市,鹽水區,橋南里,93,863,233,95,328,27,355
公投第８案,臺南市,鹽水區,橋南里,94,1373,449,136,585,26,611
公投第８案,臺南市,鹽水區,橋南里,95,1507,524,150,674,75,749
公投第８案,臺南市,鹽水區,岸內里,96,1374,472,181,653,72,725
公投第８案,臺南市,鹽水區,岸內里,97,1244,378,127,505,58,563
公投第８案,臺南市,鹽水區,岸內里,98,1022,341,135,476,59,535
公投第８案,臺南市,鹽水區,汫水里,99,921,190,81,271,49,320
公投第８案,臺南市,鹽水區,義中里,100,847,275,133,408,49,457
公投第８案,臺南市,鹽水區,義中里,101,736,153,56,209,6,215
公投第８案,臺南市,鹽水區,三明里,102,761,222,96,318,16,334
公投第８案,臺南市,鹽水區,三明里,103,285,93,33,126,11,137
公投第８案,臺南市,鹽水區,三明里,104,493,124,63,187,39,226
公投第８案,臺南市,鹽水區,文昌里,105,621,144,54,198,23,221
公投第８案,臺南市,鹽水區,文昌里,106,392,84,26,110,14,124
公投第８案,臺南市,鹽水區,歡雅里,107,925,276,95,371,34,405
公投第８案,臺南市,鹽水區,歡雅里,108,728,201,73,274,35,309
公投第８案,臺南市,鹽水區,三和里,109,214,43,17,60,20,80
公投第８案,臺南市,鹽水區,三和里,110,387,128,33,161,13,174
公投第８案,臺南市,鹽水區,三和里,111,301,90,40,130,19,149
公投第８案,臺南市,鹽水區,竹林里,112,755,176,74,250,35,285
公投第８案,臺南市,鹽水區,竹林里,113,365,82,42,124,20,144
公投第８案,臺南市,鹽水區,坔頭港里,114,935,257,96,353,36,389
公投第８案,臺南市,鹽水區,坔頭港里,115,494,126,54,180,33,213
公投第８案,臺南市,新營區,忠政里,116,1693,556,156,712,76,788
公投第８案,臺南市,新營區,忠政里,117,1561,628,166,794,74,868
公投第８案,臺南市,新營區,忠政里,118,1487,552,189,741,61,802
公投第８案,臺南市,新營區,民權里,119,1232,438,144,582,31,613
公投第８案,臺南市,新營區,民權里,120,1067,379,124,503,28,531
公投第８案,臺南市,新營區,三仙里,121,1419,416,164,580,40,620
公投第８案,臺南市,新營區,三仙里,122,1466,577,155,732,29,761
公投第８案,臺南市,新營區,永平里,123,932,369,138,507,58,565
公投第８案,臺南市,新營區,永平里,124,1099,337,115,452,28,480
公投第８案,臺南市,新營區,永平里,125,757,246,72,318,28,346
公投第８案,臺南市,新營區,大宏里,126,888,346,109,455,44,499
公投第８案,臺南市,新營區,大宏里,127,1115,373,149,522,20,542
公投第８案,臺南市,新營區,大宏里,128,937,312,91,403,22,425
公投第８案,臺南市,新營區,王公里,129,1387,471,171,642,35,677
公投第８案,臺南市,新營區,王公里,130,1526,550,145,695,56,751
公投第８案,臺南市,新營區,王公里,131,1301,518,161,679,43,722
公投第８案,臺南市,新營區,新東里,132,1538,655,157,812,54,866
公投第８案,臺南市,新營區,新東里,133,1584,623,178,801,48,849
公投第８案,臺南市,新營區,新東里,134,1583,693,162,855,41,896
公投第８案,臺南市,新營區,新東里,135,1530,602,181,783,42,825
公投第８案,臺南市,新營區,中營里,136,1193,460,170,630,49,679
公投第８案,臺南市,新營區,土庫里,137,1439,389,104,493,16,509
公投第８案,臺南市,新營區,興業里,138,1438,585,165,750,53,803
公投第８案,臺南市,新營區,興業里,139,359,126,58,184,25,209
公投第８案,臺南市,新營區,南興里,140,1233,330,126,456,33,489
公投第８案,臺南市,新營區,南興里,141,1227,374,91,465,25,490
公投第８案,臺南市,新營區,民生里,142,1320,422,110,532,31,563
公投第８案,臺南市,新營區,民生里,143,1930,555,175,730,30,760
公投第８案,臺南市,新營區,新北里,144,1501,569,163,732,55,787
公投第８案,臺南市,新營區,新北里,145,1475,546,122,668,46,714
公投第８案,臺南市,新營區,新北里,146,1753,664,205,869,60,929
公投第８案,臺南市,新營區,新南里,147,1748,613,182,795,48,843
公投第８案,臺南市,新營區,新南里,148,1741,643,179,822,55,877
公投第８案,臺南市,新營區,新南里,149,1433,488,155,643,27,670
公投第８案,臺南市,新營區,民榮里,150,1595,567,192,759,68,827
公投第８案,臺南市,新營區,民榮里,151,959,298,78,376,21,397
公投第８案,臺南市,新營區,民榮里,152,1865,620,189,809,76,885
公投第８案,臺南市,新營區,埤寮里,153,1678,521,168,689,88,777
公投第８案,臺南市,新營區,護鎮里,154,1373,421,136,557,56,613
公投第８案,臺南市,新營區,太南里,155,1431,328,154,482,31,513
公投第８案,臺南市,新營區,太南里,156,291,63,26,89,4,93
公投第８案,臺南市,新營區,太北里,157,1749,568,224,792,48,840
公投第８案,臺南市,新營區,南紙里,158,1862,595,177,772,49,821
公投第８案,臺南市,新營區,南紙里,159,1821,700,193,893,85,978
公投第８案,臺南市,新營區,嘉芳里,160,1845,589,193,782,62,844
公投第８案,臺南市,新營區,姑爺里,161,542,128,48,176,12,188
公投第８案,臺南市,新營區,姑爺里,162,402,91,38,129,5,134
公投第８案,臺南市,新營區,五興里,163,703,240,93,333,77,410
公投第８案,臺南市,新營區,五興里,164,941,264,110,374,43,417
公投第８案,臺南市,柳營區,士林里,165,1166,373,124,497,64,561
公投第８案,臺南市,柳營區,士林里,166,625,214,98,312,18,330
公投第８案,臺南市,柳營區,光福里,167,738,217,59,276,30,306
公投第８案,臺南市,柳營區,光福里,168,834,317,95,412,19,431
公投第８案,臺南市,柳營區,中埕里,169,1104,324,129,453,42,495
公投第８案,臺南市,柳營區,東昇里,170,1015,301,95,396,20,416
公投第８案,臺南市,柳營區,東昇里,171,1720,615,182,797,137,934
公投第８案,臺南市,柳營區,八翁里,172,1391,425,151,576,79,655
公投第８案,臺南市,柳營區,人和里,173,425,133,35,168,10,178
公投第８案,臺南市,柳營區,人和里,174,318,76,24,100,24,124
公投第８案,臺南市,柳營區,太康里,175,753,247,85,332,42,374
公投第８案,臺南市,柳營區,太康里,176,730,237,63,300,44,344
公投第８案,臺南市,柳營區,重溪里,177,725,234,73,307,41,348
公投第８案,臺南市,柳營區,重溪里,178,787,283,104,387,37,424
公投第８案,臺南市,柳營區,重溪里,179,297,96,39,135,34,169
公投第８案,臺南市,柳營區,篤農里,180,673,247,76,323,45,368
公投第８案,臺南市,柳營區,篤農里,181,640,226,70,296,63,359
公投第８案,臺南市,柳營區,大農里,182,660,187,64,251,29,280
公投第８案,臺南市,柳營區,神農里,183,1212,362,106,468,42,510
公投第８案,臺南市,柳營區,神農里,184,202,65,20,85,5,90
公投第８案,臺南市,柳營區,果毅里,185,1049,333,86,419,85,504
公投第８案,臺南市,柳營區,果毅里,186,158,51,17,68,3,71
公投第８案,臺南市,柳營區,旭山里,187,921,288,101,389,75,464
公投第８案,臺南市,柳營區,旭山里,188,504,151,35,186,21,207
公投第８案,臺南市,柳營區,旭山里,189,157,46,13,59,6,65
公投第８案,臺南市,北門區,永隆里,190,484,131,54,185,12,197
公投第８案,臺南市,北門區,永隆里,191,401,120,25,145,18,163
公投第８案,臺南市,北門區,北門里,192,456,118,27,145,7,152
公投第８案,臺南市,北門區,北門里,193,382,141,37,178,21,199
公投第８案,臺南市,北門區,玉港里,194,356,102,42,144,32,176
公投第８案,臺南市,北門區,玉港里,195,389,91,39,130,6,136
公投第８案,臺南市,北門區,保吉里,196,742,217,59,276,11,287
公投第８案,臺南市,北門區,保吉里,197,599,166,46,212,16,228
公投第８案,臺南市,北門區,蚵寮里,198,594,159,58,217,26,243
公投第８案,臺南市,北門區,蚵寮里,199,572,161,53,214,30,244
公投第８案,臺南市,北門區,蚵寮里,200,318,62,21,83,9,92
公投第８案,臺南市,北門區,雙春里,201,473,109,49,158,16,174
公投第８案,臺南市,北門區,錦湖里,202,954,200,63,263,15,278
公投第８案,臺南市,北門區,慈安里,203,737,277,70,347,40,387
公投第８案,臺南市,北門區,三光里,204,679,154,48,202,14,216
公投第８案,臺南市,北門區,三光里,205,521,113,47,160,37,197
公投第８案,臺南市,北門區,文山里,206,632,144,45,189,18,207
公投第８案,臺南市,北門區,文山里,207,636,148,46,194,15,209
公投第８案,臺南市,學甲區,秀昌里,208,862,282,137,419,61,480
公投第８案,臺南市,學甲區,秀昌里,209,611,220,99,319,12,331
公投第８案,臺南市,學甲區,秀昌里,210,936,321,121,442,30,472
公投第８案,臺南市,學甲區,明宜里,211,1066,311,149,460,40,500
公投第８案,臺南市,學甲區,明宜里,212,869,318,127,445,33,478
公投第８案,臺南市,學甲區,慈福里,213,635,224,63,287,37,324
公投第８案,臺南市,學甲區,慈福里,214,822,273,70,343,23,366
公投第８案,臺南市,學甲區,慈福里,215,443,125,41,166,19,185
公投第８案,臺南市,學甲區,仁得里,216,1370,498,149,647,37,684
公投第８案,臺南市,學甲區,仁得里,217,1117,414,128,542,60,602
公投第８案,臺南市,學甲區,仁得里,218,1365,444,148,592,86,678
公投第８案,臺南市,學甲區,新達里,219,1489,472,159,631,80,711
公投第８案,臺南市,學甲區,新達里,220,627,145,64,209,43,252
公投第８案,臺南市,學甲區,新榮里,221,1052,345,135,480,23,503
公投第８案,臺南市,學甲區,新榮里,222,1183,398,117,515,29,544
公投第８案,臺南市,學甲區,大灣里,223,979,274,81,355,36,391
公投第８案,臺南市,學甲區,豐和里,224,1241,339,145,484,69,553
公投第８案,臺南市,學甲區,中洲里,225,843,225,62,287,28,315
公投第８案,臺南市,學甲區,中洲里,226,580,176,60,236,43,279
公投第８案,臺南市,學甲區,光華里,227,832,199,67,266,24,290
公投第８案,臺南市,學甲區,光華里,228,406,84,50,134,10,144
公投第８案,臺南市,學甲區,宅港里,229,818,286,105,391,33,424
公投第８案,臺南市,學甲區,平和里,230,1052,261,98,359,19,378
公投第８案,臺南市,學甲區,三慶里,231,578,145,66,211,16,227
公投第８案,臺南市,學甲區,三慶里,232,430,103,43,146,21,167
公投第８案,臺南市,學甲區,三慶里,233,361,125,24,149,14,163
公投第８案,臺南市,將軍區,長榮里,234,1110,413,143,556,68,624
公投第８案,臺南市,將軍區,西甲里,235,1418,469,121,590,27,617
公投第８案,臺南市,將軍區,西甲里,236,969,287,103,390,31,421
公投第８案,臺南市,將軍區,忠嘉里,237,519,192,61,253,46,299
公投第８案,臺南市,將軍區,忠嘉里,238,1106,354,101,455,23,478
公投第８案,臺南市,將軍區,忠嘉里,239,542,159,68,227,40,267
公投第８案,臺南市,將軍區,忠嘉里,240,315,75,28,103,13,116
公投第８案,臺南市,將軍區,苓仔寮里,241,584,158,45,203,31,234
公投第８案,臺南市,將軍區,苓仔寮里,242,398,127,37,164,8,172
公投第８案,臺南市,將軍區,苓仔寮里,243,608,153,51,204,17,221
公投第８案,臺南市,將軍區,苓仔寮里,244,442,143,50,193,22,215
公投第８案,臺南市,將軍區,巷埔里,245,650,146,56,202,13,215
公投第８案,臺南市,將軍區,巷埔里,246,573,129,35,164,18,182
公投第８案,臺南市,將軍區,將軍里,247,617,148,46,194,10,204
公投第８案,臺南市,將軍區,將軍里,248,573,188,49,237,32,269
公投第８案,臺南市,將軍區,將軍里,249,434,129,52,181,31,212
公投第８案,臺南市,將軍區,玉山里,250,849,205,82,287,15,302
公投第８案,臺南市,將軍區,廣山里,251,645,166,54,220,33,253
公投第８案,臺南市,將軍區,長沙里,252,690,158,55,213,30,243
公投第８案,臺南市,將軍區,長沙里,253,663,129,43,172,10,182
公投第８案,臺南市,將軍區,平沙里,254,1175,262,103,365,32,397
公投第８案,臺南市,將軍區,鯤鯓里,255,837,184,58,242,31,273
公投第８案,臺南市,將軍區,鯤鯓里,256,1061,311,106,417,138,555
公投第８案,臺南市,將軍區,鯤溟里,257,976,211,66,277,24,301
公投第８案,臺南市,七股區,後港里,258,534,153,54,207,16,223
公投第８案,臺南市,七股區,後港里,259,508,171,61,232,20,252
公投第８案,臺南市,七股區,大潭里,260,665,150,40,190,10,200
公投第８案,臺南市,七股區,篤加里,261,834,245,58,303,30,333
公投第８案,臺南市,七股區,頂山里,262,810,202,75,277,16,293
公投第８案,臺南市,七股區,西寮里,263,480,98,38,136,14,150
公投第８案,臺南市,七股區,塩埕里,264,445,110,34,144,9,153
公投第８案,臺南市,七股區,中寮里,265,680,117,45,162,16,178
公投第８案,臺南市,七股區,龍山里,266,838,169,65,234,11,245
公投第８案,臺南市,七股區,龍山里,267,780,168,54,222,25,247
公投第８案,臺南市,七股區,溪南里,268,350,118,45,163,19,182
公投第８案,臺南市,七股區,七股里,269,907,325,114,439,98,537
公投第８案,臺南市,七股區,玉成里,270,780,226,63,289,22,311
公投第８案,臺南市,七股區,大埕里,271,1658,493,135,628,43,671
公投第８案,臺南市,七股區,大埕里,272,913,267,75,342,35,377
公投第８案,臺南市,七股區,樹林里,273,1202,390,129,519,70,589
公投第８案,臺南市,七股區,樹林里,274,696,185,40,225,12,237
公投第８案,臺南市,七股區,竹橋里,275,647,190,73,263,39,302
公投第８案,臺南市,七股區,竹橋里,276,622,242,76,318,67,385
公投第８案,臺南市,七股區,義合里,277,1175,437,128,565,100,665
公投第８案,臺南市,七股區,義合里,278,698,198,76,274,25,299
公投第８案,臺南市,七股區,永吉里,279,983,315,114,429,81,510
公投第８案,臺南市,七股區,三股里,280,1366,322,123,445,36,481
公投第８案,臺南市,七股區,十份里,281,1379,384,132,516,85,601
公投第８案,臺南市,佳里區,東寧里,282,1391,500,194,694,76,770
公投第８案,臺南市,佳里區,東寧里,283,829,331,111,442,37,479
公投第８案,臺南市,佳里區,忠仁里,284,1401,417,156,573,33,606
公投第８案,臺南市,佳里區,忠仁里,285,1452,448,124,572,24,596
公投第８案,臺南市,佳里區,鎮山里,286,1382,496,164,660,71,731
公投第８案,臺南市,佳里區,鎮山里,287,1463,521,164,685,80,765
公投第８案,臺南市,佳里區,鎮山里,288,1280,429,139,568,39,607
公投第８案,臺南市,佳里區,鎮山里,289,1486,542,174,716,86,802
公投第８案,臺南市,佳里區,安西里,290,1378,525,160,685,69,754
公投第８案,臺南市,佳里區,安西里,291,1505,544,185,729,69,798
公投第８案,臺南市,佳里區,安西里,292,1860,676,195,871,96,967
公投第８案,臺南市,佳里區,安西里,293,1134,417,126,543,90,633
公投第８案,臺南市,佳里區,文新里,294,1426,532,159,691,60,751
公投第８案,臺南市,佳里區,文新里,295,1779,679,179,858,71,929
公投第８案,臺南市,佳里區,文新里,296,1906,779,203,982,63,1045
公投第８案,臺南市,佳里區,建南里,297,1425,480,165,645,60,705
公投第８案,臺南市,佳里區,建南里,298,1255,446,152,598,55,653
公投第８案,臺南市,佳里區,建南里,299,1524,502,161,663,83,746
公投第８案,臺南市,佳里區,南勢里,300,1631,595,169,764,49,813
公投第８案,臺南市,佳里區,南勢里,301,1546,603,209,812,49,861
公投第８案,臺南市,佳里區,南勢里,302,1187,493,160,653,47,700
公投第８案,臺南市,佳里區,六安里,303,1381,495,163,658,48,706
公投第８案,臺南市,佳里區,六安里,304,1364,497,132,629,22,651
公投第８案,臺南市,佳里區,六安里,305,1314,491,149,640,36,676
公投第８案,臺南市,佳里區,佳化里,306,1164,421,145,566,69,635
公投第８案,臺南市,佳里區,佳化里,307,961,336,116,452,60,512
公投第８案,臺南市,佳里區,佳興里,308,1218,394,135,529,56,585
公投第８案,臺南市,佳里區,佳興里,309,919,320,118,438,28,466
公投第８案,臺南市,佳里區,營溪里,310,689,246,74,320,29,349
公投第８案,臺南市,佳里區,營溪里,311,383,104,50,154,13,167
公投第８案,臺南市,佳里區,海澄里,312,1507,511,143,654,64,718
公投第８案,臺南市,佳里區,海澄里,313,702,220,73,293,51,344
公投第８案,臺南市,佳里區,下營里,314,907,331,103,434,49,483
公投第８案,臺南市,佳里區,下營里,315,937,356,138,494,58,552
公投第８案,臺南市,佳里區,塭內里,316,1030,325,122,447,96,543
公投第８案,臺南市,佳里區,塭內里,317,981,326,124,450,53,503
公投第８案,臺南市,佳里區,塭內里,318,787,246,79,325,25,350
公投第８案,臺南市,佳里區,民安里,319,1513,519,156,675,84,759
公投第８案,臺南市,佳里區,子龍里,320,714,196,69,265,22,287
公投第８案,臺南市,佳里區,子龍里,321,745,224,92,316,50,366
公投第８案,臺南市,佳里區,子龍里,322,951,285,103,388,29,417
公投第８案,臺南市,西港區,西港里,323,933,331,97,428,13,441
公投第８案,臺南市,西港區,西港里,324,901,301,133,434,23,457
公投第８案,臺南市,西港區,西港里,325,1314,415,138,553,31,584
公投第８案,臺南市,西港區,慶安里,326,1349,465,149,614,78,692
公投第８案,臺南市,西港區,慶安里,327,1014,360,142,502,56,558
公投第８案,臺南市,西港區,慶安里,328,1900,494,178,672,29,701
公投第８案,臺南市,西港區,南海里,329,1663,499,159,658,61,719
公投第８案,臺南市,西港區,南海里,330,738,199,81,280,13,293
公投第８案,臺南市,西港區,港東里,331,1211,452,130,582,64,646
公投第８案,臺南市,西港區,港東里,332,382,112,40,152,27,179
公投第８案,臺南市,西港區,檨林里,333,786,227,81,308,15,323
公投第８案,臺南市,西港區,檨林里,334,838,267,80,347,14,361
公投第８案,臺南市,西港區,後營里,335,1449,378,140,518,47,565
公投第８案,臺南市,西港區,營西里,336,1479,388,131,519,32,551
公投第８案,臺南市,西港區,金砂里,337,763,263,80,343,76,419
公投第８案,臺南市,西港區,劉厝里,338,1297,380,113,493,27,520
公投第８案,臺南市,西港區,竹林里,339,1393,517,43,560,38,598
公投第８案,臺南市,西港區,永樂里,340,958,235,97,332,19,351
公投第８案,臺南市,西港區,永樂里,341,391,142,37,179,21,200
公投第８案,臺南市,西港區,新復里,342,805,291,73,364,55,419
公投第８案,臺南市,下營區,下營里,343,1558,415,145,560,55,615
公投第８案,臺南市,下營區,仁里里,344,1112,283,103,386,33,419
公投第８案,臺南市,下營區,仁里里,345,893,277,79,356,66,422
公投第８案,臺南市,下營區,宅內里,346,1623,417,154,571,64,635
公投第８案,臺南市,下營區,後街里,347,1568,504,154,658,103,761
公投第８案,臺南市,下營區,新興里,348,985,332,112,444,60,504
公投第８案,臺南市,下營區,新興里,349,953,294,79,373,21,394
公投第８案,臺南市,下營區,營前里,350,1031,328,100,428,30,458
公投第８案,臺南市,下營區,營前里,351,1077,390,129,519,77,596
公投第８案,臺南市,下營區,大吉里,352,703,166,70,236,44,280
公投第８案,臺南市,下營區,大吉里,353,854,238,78,316,23,339
公投第８案,臺南市,下營區,茅營里,354,1164,375,121,496,59,555
公投第８案,臺南市,下營區,茅營里,355,1091,309,109,418,35,453
公投第８案,臺南市,下營區,開化里,356,959,328,98,426,63,489
公投第８案,臺南市,下營區,開化里,357,935,300,92,392,35,427
公投第８案,臺南市,下營區,西連里,358,893,295,101,396,51,447
公投第８案,臺南市,下營區,賀建里,359,1293,441,138,579,93,672
公投第８案,臺南市,下營區,紅甲里,360,1185,376,139,515,110,625
公投第８案,臺南市,下營區,紅甲里,361,1070,256,81,337,22,359
公投第８案,臺南市,六甲區,六甲里,362,819,292,109,401,62,463
公投第８案,臺南市,六甲區,六甲里,363,645,213,83,296,19,315
公投第８案,臺南市,六甲區,六甲里,364,1444,429,159,588,53,641
公投第８案,臺南市,六甲區,甲東里,365,1554,413,164,577,53,630
公投第８案,臺南市,六甲區,甲東里,366,1171,329,102,431,46,477
公投第８案,臺南市,六甲區,甲南里,367,1351,402,166,568,77,645
公投第８案,臺南市,六甲區,七甲里,368,1010,277,107,384,81,465
公投第８案,臺南市,六甲區,七甲里,369,919,265,104,369,63,432
公投第８案,臺南市,六甲區,二甲里,370,1369,426,147,573,77,650
公投第８案,臺南市,六甲區,二甲里,371,976,333,90,423,77,500
公投第８案,臺南市,六甲區,二甲里,372,1015,346,140,486,59,545
公投第８案,臺南市,六甲區,水林里,373,1176,344,127,471,40,511
公投第８案,臺南市,六甲區,水林里,374,939,296,126,422,58,480
公投第８案,臺南市,六甲區,中社里,375,712,221,92,313,56,369
公投第８案,臺南市,六甲區,中社里,376,881,302,103,405,52,457
公投第８案,臺南市,六甲區,龜港里,377,1184,452,166,618,68,686
公投第８案,臺南市,六甲區,菁埔里,378,599,229,97,326,36,362
公投第８案,臺南市,六甲區,王爺里,379,759,155,52,207,9,216
公投第８案,臺南市,六甲區,大丘里,380,621,137,75,212,32,244
公投第８案,臺南市,麻豆區,新興里,381,1205,389,153,542,53,595
公投第８案,臺南市,麻豆區,新興里,382,660,225,103,328,39,367
公投第８案,臺南市,麻豆區,巷口里,383,523,169,87,256,15,271
公投第８案,臺南市,麻豆區,巷口里,384,1597,615,112,727,46,773
公投第８案,臺南市,麻豆區,東角里,385,1262,473,169,642,59,701
公投第８案,臺南市,麻豆區,東角里,386,1325,511,183,694,46,740
公投第８案,臺南市,麻豆區,晋江里,387,1384,458,163,621,32,653
公投第８案,臺南市,麻豆區,晋江里,388,1121,377,155,532,23,555
公投第８案,臺南市,麻豆區,中興里,389,1021,304,137,441,25,466
公投第８案,臺南市,麻豆區,中興里,390,954,308,117,425,37,462
公投第８案,臺南市,麻豆區,興農里,391,1513,419,178,597,29,626
公投第８案,臺南市,麻豆區,油車里,392,1726,495,183,678,56,734
公投第８案,臺南市,麻豆區,油車里,393,1804,625,194,819,74,893
公投第８案,臺南市,麻豆區,北勢里,394,1106,319,138,457,38,495
公投第８案,臺南市,麻豆區,大埕里,395,1503,501,185,686,41,727
公投第８案,臺南市,麻豆區,大埕里,396,1302,452,151,603,57,660
公投第８案,臺南市,麻豆區,清水里,397,645,209,72,281,18,299
公投第８案,臺南市,麻豆區,清水里,398,777,293,110,403,34,437
公投第８案,臺南市,麻豆區,南勢里,399,1612,488,182,670,45,715
公投第８案,臺南市,麻豆區,南勢里,400,718,197,83,280,17,297
公投第８案,臺南市,麻豆區,寮廍里,401,1656,456,168,624,28,652
公投第８案,臺南市,麻豆區,埤頭里,402,1355,416,159,575,82,657
公投第８案,臺南市,麻豆區,埤頭里,403,977,255,76,331,32,363
公投第８案,臺南市,麻豆區,海埔里,404,1012,292,114,406,29,435
公投第８案,臺南市,麻豆區,海埔里,405,626,220,76,296,28,324
公投第８案,臺南市,麻豆區,海埔里,406,467,94,32,126,5,131
公投第８案,臺南市,麻豆區,港尾里,407,1260,374,138,512,29,541
公投第８案,臺南市,麻豆區,麻口里,408,1111,367,142,509,46,555
公投第８案,臺南市,麻豆區,安業里,409,550,194,59,253,31,284
公投第８案,臺南市,麻豆區,安業里,410,798,242,109,351,52,403
公投第８案,臺南市,麻豆區,謝厝寮里,411,852,316,110,426,81,507
公投第８案,臺南市,麻豆區,謝厝寮里,412,830,223,75,298,13,311
公投第８案,臺南市,麻豆區,安正里,413,941,262,97,359,15,374
公投第８案,臺南市,麻豆區,井東里,414,1158,383,134,517,43,560
公投第８案,臺南市,麻豆區,井東里,415,612,180,69,249,11,260
公投第８案,臺南市,官田區,官田里,416,1104,347,102,449,17,466
公投第８案,臺南市,官田區,官田里,417,965,287,131,418,56,474
公投第８案,臺南市,官田區,二鎮里,418,1402,477,150,627,49,676
公投第８案,臺南市,官田區,二鎮里,419,1653,546,241,787,117,904
公投第８案,臺南市,官田區,烏山頭里,420,966,258,114,372,64,436
公投第８案,臺南市,官田區,烏山頭里,421,284,72,36,108,14,122
公投第８案,臺南市,官田區,大崎里,422,402,79,23,102,7,109
公投第８案,臺南市,官田區,隆田里,423,982,313,133,446,18,464
公投第８案,臺南市,官田區,隆田里,424,975,264,97,361,43,404
公投第８案,臺南市,官田區,隆本里,425,802,245,106,351,46,397
公投第８案,臺南市,官田區,隆本里,426,1118,405,129,534,60,594
公投第８案,臺南市,官田區,隆本里,427,1455,472,175,647,39,686
公投第８案,臺南市,官田區,南廍里,428,1208,400,149,549,38,587
公投第８案,臺南市,官田區,東西庄里,429,1293,366,144,510,66,576
公投第８案,臺南市,官田區,東西庄里,430,607,151,56,207,26,233
公投第８案,臺南市,官田區,渡拔里,431,501,148,55,203,36,239
公投第８案,臺南市,官田區,渡拔里,432,728,237,97,334,61,395
公投第８案,臺南市,官田區,渡拔里,433,842,235,121,356,20,376
公投第８案,臺南市,官田區,渡拔里,434,515,160,71,231,44,275
公投第８案,臺南市,官田區,社子里,435,873,227,77,304,22,326
公投第８案,臺南市,大內區,石湖里,436,759,188,79,267,55,322
公投第８案,臺南市,大內區,石湖里,437,262,59,22,81,3,84
公投第８案,臺南市,大內區,石林里,438,646,148,41,189,18,207
公投第８案,臺南市,大內區,石城里,439,1473,393,113,506,76,582
公投第８案,臺南市,大內區,內江里,440,915,331,84,415,76,491
公投第８案,臺南市,大內區,大內里,441,779,275,101,376,52,428
公投第８案,臺南市,大內區,內郭里,442,637,238,86,324,64,388
公投第８案,臺南市,大內區,頭社里,443,993,279,94,373,40,413
公投第８案,臺南市,大內區,環湖里,444,766,283,88,371,38,409
公投第８案,臺南市,大內區,二溪里,445,841,284,77,361,48,409
公投第８案,臺南市,大內區,曲溪里,446,583,186,50,236,47,283
公投第８案,臺南市,楠西區,楠西里,447,978,308,103,411,65,476
公投第８案,臺南市,楠西區,楠西里,448,870,320,109,429,44,473
公投第８案,臺南市,楠西區,灣丘里,449,1160,244,79,323,15,338
公投第８案,臺南市,楠西區,密枝里,450,699,187,63,250,32,282
公投第８案,臺南市,楠西區,照興里,451,990,251,63,314,20,334
公投第８案,臺南市,楠西區,鹿田里,452,928,282,72,354,39,393
公投第８案,臺南市,楠西區,龜丹里,453,660,223,41,264,48,312
公投第８案,臺南市,楠西區,東勢里,454,1187,377,115,492,82,574
公投第８案,臺南市,楠西區,東勢里,455,1056,342,100,442,35,477
公投第８案,臺南市,南化區,南化里,456,690,238,80,318,49,367
公投第８案,臺南市,南化區,南化里,457,695,240,84,324,57,381
公投第８案,臺南市,南化區,小崙里,458,806,236,83,319,37,356
公投第８案,臺南市,南化區,東和里,459,654,177,48,225,44,269
公投第８案,臺南市,南化區,西埔里,460,783,187,56,243,39,282
公投第８案,臺南市,南化區,中坑里,461,425,132,51,183,22,205
公投第８案,臺南市,南化區,北平里,462,559,185,53,238,36,274
公投第８案,臺南市,南化區,北寮里,463,1189,330,106,436,31,467
公投第８案,臺南市,南化區,玉山里,464,1044,371,118,489,34,523
公投第８案,臺南市,南化區,關山里,465,941,356,104,460,28,488
公投第８案,臺南市,玉井區,玉井里,466,1242,432,116,548,27,575
公投第８案,臺南市,玉井區,玉田里,467,1141,434,100,534,54,588
公投第８案,臺南市,玉井區,玉田里,468,698,212,80,292,30,322
公投第８案,臺南市,玉井區,玉田里,469,849,280,97,377,27,404
公投第８案,臺南市,玉井區,玉田里,470,949,361,92,453,54,507
公投第８案,臺南市,玉井區,中正里,471,618,214,61,275,26,301
公投第８案,臺南市,玉井區,中正里,472,594,168,50,218,11,229
公投第８案,臺南市,玉井區,竹圍里,473,927,282,76,358,16,374
公投第８案,臺南市,玉井區,竹圍里,474,512,167,55,222,49,271
公投第８案,臺南市,玉井區,沙田里,475,509,161,52,213,29,242
公投第８案,臺南市,玉井區,三埔里,476,496,172,58,230,30,260
公投第８案,臺南市,玉井區,三和里,477,759,222,81,303,15,318
公投第８案,臺南市,玉井區,望明里,478,669,176,50,226,12,238
公投第８案,臺南市,玉井區,望明里,479,787,239,71,310,71,381
公投第８案,臺南市,玉井區,層林里,480,620,166,71,237,45,282
公投第８案,臺南市,玉井區,豐里里,481,987,355,94,449,53,502
公投第８案,臺南市,左鎮區,光和里,482,392,119,38,157,32,189
公投第８案,臺南市,左鎮區,榮和里,483,644,226,54,280,55,335
公投第８案,臺南市,左鎮區,左鎮里,484,468,131,36,167,16,183
公投第８案,臺南市,左鎮區,中正里,485,753,187,81,268,44,312
公投第８案,臺南市,左鎮區,睦光里,486,345,97,33,130,27,157
公投第８案,臺南市,左鎮區,內庄里,487,393,114,32,146,18,164
公投第８案,臺南市,左鎮區,岡林里,488,420,118,40,158,17,175
公投第８案,臺南市,左鎮區,草山里,489,313,74,27,101,13,114
公投第８案,臺南市,左鎮區,二寮里,490,186,43,18,61,3,64
公投第８案,臺南市,左鎮區,澄山里,491,504,110,53,163,55,218
公投第８案,臺南市,善化區,東關里,492,1132,332,127,459,33,492
公投第８案,臺南市,善化區,坐駕里,493,1845,617,209,826,75,901
公投第８案,臺南市,善化區,坐駕里,494,2090,697,243,940,108,1048
公投第８案,臺南市,善化區,光文里,495,1582,607,173,780,91,871
公投第８案,臺南市,善化區,光文里,496,1901,693,262,955,88,1043
公投第８案,臺南市,善化區,光文里,497,1818,633,246,879,63,942
公投第８案,臺南市,善化區,文昌里,498,1639,588,191,779,79,858
公投第８案,臺南市,善化區,文昌里,499,1061,403,150,553,41,594
公投第８案,臺南市,善化區,南關里,500,1786,652,219,871,110,981
公投第８案,臺南市,善化區,頂街里,501,1147,409,130,539,40,579
公投第８案,臺南市,善化區,文正里,502,1581,503,205,708,80,788
公投第８案,臺南市,善化區,胡家里,503,1240,364,174,538,115,653
公投第８案,臺南市,善化區,胡厝里,504,1743,453,148,601,35,636
公投第８案,臺南市,善化區,什乃里,505,1246,446,183,629,66,695
公投第８案,臺南市,善化區,溪美里,506,961,298,131,429,29,458
公投第８案,臺南市,善化區,溪美里,507,938,300,107,407,15,422
公投第８案,臺南市,善化區,六分里,508,722,242,93,335,18,353
公投第８案,臺南市,善化區,六德里,509,1062,320,105,425,24,449
公投第８案,臺南市,善化區,田寮里,510,1715,596,175,771,95,866
公投第８案,臺南市,善化區,昌隆里,511,1120,368,114,482,54,536
公投第８案,臺南市,善化區,昌隆里,512,865,254,120,374,55,429
公投第８案,臺南市,善化區,牛庄里,513,1574,525,214,739,77,816
公投第８案,臺南市,善化區,嘉北里,514,1535,446,182,628,63,691
公投第８案,臺南市,善化區,嘉南里,515,1106,353,154,507,71,578
公投第８案,臺南市,善化區,小新里,516,1402,432,163,595,53,648
公投第８案,臺南市,善化區,小新里,517,1458,554,221,775,93,868
公投第８案,臺南市,善化區,小新里,518,1380,428,155,583,52,635
公投第８案,臺南市,善化區,蓮潭里,519,1232,468,157,625,17,642
公投第８案,臺南市,善化區,蓮潭里,520,1069,410,150,560,14,574
公投第８案,臺南市,安定區,蘇林里,521,1251,486,187,673,94,767
公投第８案,臺南市,安定區,蘇林里,522,899,322,105,427,44,471
公投第８案,臺南市,安定區,蘇厝里,523,1106,383,132,515,87,602
公投第８案,臺南市,安定區,蘇厝里,524,948,340,125,465,60,525
公投第８案,臺南市,安定區,安定里,525,1442,462,166,628,38,666
公投第８案,臺南市,安定區,安加里,526,1385,417,172,589,53,642
公投第８案,臺南市,安定區,安加里,527,801,311,93,404,54,458
公投第８案,臺南市,安定區,港尾里,528,736,210,85,295,38,333
公投第８案,臺南市,安定區,港尾里,529,781,275,87,362,39,401
公投第８案,臺南市,安定區,中榮里,530,795,281,111,392,22,414
公投第８案,臺南市,安定區,中榮里,531,862,340,106,446,58,504
公投第８案,臺南市,安定區,港口里,532,1487,495,162,657,38,695
公投第８案,臺南市,安定區,港口里,533,1385,484,152,636,36,672
公投第８案,臺南市,安定區,港南里,534,1518,443,189,632,40,672
公投第８案,臺南市,安定區,港南里,535,1094,441,134,575,61,636
公投第８案,臺南市,安定區,嘉同里,536,1590,554,215,769,116,885
公投第８案,臺南市,安定區,嘉同里,537,754,272,105,377,41,418
公投第８案,臺南市,安定區,中沙里,538,716,258,90,348,52,400
公投第８案,臺南市,安定區,新吉里,539,1492,548,195,743,66,809
公投第８案,臺南市,安定區,新吉里,540,943,329,126,455,57,512
公投第８案,臺南市,安定區,海寮里,541,1157,412,132,544,32,576
公投第８案,臺南市,安定區,海寮里,542,1384,466,168,634,133,767
公投第８案,臺南市,安定區,文科里,543,967,330,125,455,65,520
公投第８案,臺南市,安定區,文科里,544,611,223,65,288,35,323
公投第８案,臺南市,新市區,新市里,545,960,308,106,414,36,450
公投第８案,臺南市,新市區,新市里,546,1118,434,163,597,53,650
公投第８案,臺南市,新市區,新市里,547,850,283,99,382,32,414
公投第８案,臺南市,新市區,新和里,548,1241,463,126,589,72,661
公投第８案,臺南市,新市區,新和里,549,1297,482,171,653,47,700
公投第８案,臺南市,新市區,新和里,550,962,395,95,490,50,540
公投第８案,臺南市,新市區,新和里,551,1237,463,172,635,62,697
公投第８案,臺南市,新市區,新和里,552,1326,470,189,659,52,711
公投第８案,臺南市,新市區,社內里,553,1211,472,155,627,68,695
公投第８案,臺南市,新市區,社內里,554,1305,430,178,608,47,655
公投第８案,臺南市,新市區,大洲里,555,688,237,74,311,65,376
公投第８案,臺南市,新市區,豐華里,556,911,328,146,474,38,512
公投第８案,臺南市,新市區,三舍里,557,1525,474,190,664,53,717
公投第８案,臺南市,新市區,大營里,558,1091,321,89,410,5,415
公投第８案,臺南市,新市區,大營里,559,1122,406,126,532,31,563
公投第８案,臺南市,新市區,大營里,560,1049,340,126,466,34,500
公投第８案,臺南市,新市區,大社里,561,1564,451,174,625,25,650
公投第８案,臺南市,新市區,大社里,562,1515,563,183,746,62,808
公投第８案,臺南市,新市區,大社里,563,1378,453,180,633,34,667
公投第８案,臺南市,新市區,潭頂里,564,827,326,128,454,60,514
公投第８案,臺南市,新市區,潭頂里,565,960,390,127,517,92,609
公投第８案,臺南市,新市區,港墘里,566,951,325,106,431,68,499
公投第８案,臺南市,新市區,港墘里,567,1264,442,177,619,77,696
公投第８案,臺南市,新市區,港墘里,568,1173,416,140,556,38,594
公投第８案,臺南市,新市區,永就里,569,684,243,114,357,26,383
公投第８案,臺南市,新市區,永就里,570,1055,421,148,569,78,647
公投第８案,臺南市,新市區,永就里,571,1122,457,175,632,52,684
公投第８案,臺南市,山上區,明和里,572,855,210,78,288,70,358
公投第８案,臺南市,山上區,明和里,573,836,201,68,269,47,316
公投第８案,臺南市,山上區,南洲里,574,753,235,84,319,46,365
公投第８案,臺南市,山上區,南洲里,575,788,246,84,330,41,371
公投第８案,臺南市,山上區,山上里,576,984,335,109,444,45,489
公投第８案,臺南市,山上區,新莊里,577,972,268,102,370,12,382
公投第８案,臺南市,山上區,玉峯里,578,553,122,31,153,6,159
公投第８案,臺南市,山上區,平陽里,579,378,102,32,134,7,141
公投第８案,臺南市,山上區,豐德里,580,392,105,47,152,28,180
公投第８案,臺南市,新化區,武安里,581,746,327,76,403,49,452
公投第８案,臺南市,新化區,武安里,582,1102,438,50,488,161,649
公投第８案,臺南市,新化區,武安里,583,370,148,44,192,22,214
公投第８案,臺南市,新化區,武安里,584,947,366,124,490,77,567
公投第８案,臺南市,新化區,東榮里,585,1154,414,129,543,66,609
公投第８案,臺南市,新化區,東榮里,586,1082,401,132,533,74,607
公投第８案,臺南市,新化區,東榮里,587,1075,425,118,543,68,611
公投第８案,臺南市,新化區,東榮里,588,640,233,76,309,28,337
公投第８案,臺南市,新化區,護國里,589,410,129,48,177,23,200
公投第８案,臺南市,新化區,護國里,590,533,188,52,240,30,270
公投第８案,臺南市,新化區,護國里,591,836,288,112,400,29,429
公投第８案,臺南市,新化區,護國里,592,978,290,95,385,33,418
公投第８案,臺南市,新化區,太平里,593,1348,473,185,658,53,711
公投第８案,臺南市,新化區,太平里,594,1015,363,117,480,53,533
公投第８案,臺南市,新化區,太平里,595,1228,405,116,521,34,555
公投第８案,臺南市,新化區,太平里,596,789,290,109,399,52,451
公投第８案,臺南市,新化區,協興里,597,1022,333,139,472,30,502
公投第８案,臺南市,新化區,協興里,598,1021,340,115,455,23,478
公投第８案,臺南市,新化區,協興里,599,1229,480,159,639,67,706
公投第８案,臺南市,新化區,唪口里,600,1153,412,133,545,29,574
公投第８案,臺南市,新化區,唪口里,601,1012,271,101,372,28,400
公投第８案,臺南市,新化區,北勢里,602,1458,538,175,713,80,793
公投第８案,臺南市,新化區,豐榮里,603,1645,623,211,834,73,907
公投第８案,臺南市,新化區,豐榮里,604,1016,383,138,521,63,584
公投第８案,臺南市,新化區,豐榮里,605,559,191,62,253,13,266
公投第８案,臺南市,新化區,全興里,606,1222,488,151,639,37,676
公投第８案,臺南市,新化區,全興里,607,1562,635,214,849,66,915
公投第８案,臺南市,新化區,崙頂里,608,994,296,114,410,38,448
公投第８案,臺南市,新化區,崙頂里,609,1013,364,106,470,99,569
公投第８案,臺南市,新化區,知義里,610,1197,432,157,589,82,671
公投第８案,臺南市,新化區,知義里,611,1021,323,126,449,58,507
公投第８案,臺南市,新化區,山脚里,612,1428,431,135,566,80,646
公投第８案,臺南市,新化區,大坑里,613,456,131,51,182,33,215
公投第８案,臺南市,新化區,𦰡拔里,614,1037,389,129,518,58,576
公投第８案,臺南市,新化區,𦰡拔里,615,1097,397,123,520,92,612
公投第８案,臺南市,新化區,羊林里,616,902,320,119,439,58,497
公投第８案,臺南市,新化區,礁坑里,617,999,303,108,411,99,510
公投第８案,臺南市,安南區,東和里,618,2549,950,295,1245,55,1300
公投第８案,臺南市,安南區,󻕯南里,619,2321,763,284,1047,90,1137
公投第８案,臺南市,安南區,󻕯南里,620,2156,835,268,1103,85,1188
公投第８案,臺南市,安南區,州南里,621,1662,634,227,861,108,969
公投第８案,臺南市,安南區,州南里,622,1512,576,179,755,119,874
公投第８案,臺南市,安南區,州南里,623,1625,543,184,727,94,821
公投第８案,臺南市,安南區,安順里,624,2143,644,239,883,62,945
公投第８案,臺南市,安南區,安順里,625,2457,955,266,1221,105,1326
公投第８案,臺南市,安南區,州北里,626,2148,771,294,1065,132,1197
公投第８案,臺南市,安南區,州北里,627,2364,833,290,1123,103,1226
公投第８案,臺南市,安南區,新順里,628,1868,604,206,810,51,861
公投第８案,臺南市,安南區,新順里,629,1797,714,254,968,88,1056
公投第８案,臺南市,安南區,新順里,630,2268,856,270,1126,82,1208
公投第８案,臺南市,安南區,頂安里,631,2291,683,234,917,89,1006
公投第８案,臺南市,安南區,頂安里,632,2255,781,270,1051,94,1145
公投第８案,臺南市,安南區,安慶里,633,1940,614,224,838,95,933
公投第８案,臺南市,安南區,安慶里,634,2013,746,248,994,44,1038
公投第８案,臺南市,安南區,安慶里,635,2024,718,215,933,104,1037
公投第８案,臺南市,安南區,溪北里,636,1613,634,237,871,107,978
公投第８案,臺南市,安南區,溪北里,637,1178,408,132,540,50,590
公投第８案,臺南市,安南區,安和里,638,2143,740,272,1012,102,1114
公投第８案,臺南市,安南區,安西里,639,1721,594,261,855,109,964
公投第８案,臺南市,安南區,安西里,640,1773,680,247,927,79,1006
公投第８案,臺南市,安南區,溪頂里,641,1428,515,179,694,33,727
公投第８案,臺南市,安南區,溪頂里,642,1626,593,219,812,80,892
公投第８案,臺南市,安南區,溪頂里,643,1358,469,190,659,74,733
公投第８案,臺南市,安南區,安東里,644,1447,604,178,782,59,841
公投第８案,臺南市,安南區,安東里,645,1358,497,172,669,102,771
公投第８案,臺南市,安南區,鳳凰里,646,2116,678,252,930,71,1001
公投第８案,臺南市,安南區,鳳凰里,647,2321,749,260,1009,55,1064
公投第８案,臺南市,安南區,梅花里,648,2117,725,221,946,62,1008
公投第８案,臺南市,安南區,梅花里,649,1927,614,249,863,88,951
公投第８案,臺南市,安南區,理想里,650,2242,699,288,987,158,1145
公投第８案,臺南市,安南區,理想里,651,2334,770,271,1041,52,1093
公投第８案,臺南市,安南區,大安里,652,1822,673,233,906,84,990
公投第８案,臺南市,安南區,大安里,653,1813,630,249,879,124,1003
公投第８案,臺南市,安南區,原佃里,654,2188,781,249,1030,136,1166
公投第８案,臺南市,安南區,長安里,655,2399,801,267,1068,100,1168
公投第８案,臺南市,安南區,長安里,656,2247,693,248,941,88,1029
公投第８案,臺南市,安南區,公親里,657,1165,466,169,635,85,720
公投第８案,臺南市,安南區,布袋里,658,1539,519,173,692,72,764
公投第８案,臺南市,安南區,總頭里,659,1835,254,628,882,142,1024
公投第８案,臺南市,安南區,南興里,660,1797,594,261,855,113,968
公投第８案,臺南市,安南區,學東里,661,2223,711,242,953,117,1070
公投第８案,臺南市,安南區,公󻕯里,662,977,390,154,544,76,620
公投第８案,臺南市,安南區,佃東里,663,1642,517,188,705,46,751
公投第８案,臺南市,安南區,佃東里,664,1697,639,209,848,89,937
公投第８案,臺南市,安南區,佃西里,665,1966,644,188,832,74,906
公投第８案,臺南市,安南區,淵西里,666,1319,442,176,618,79,697
公投第８案,臺南市,安南區,淵西里,667,1909,609,230,839,91,930
公投第８案,臺南市,安南區,海西里,668,1763,634,226,860,82,942
公投第８案,臺南市,安南區,海西里,669,965,351,103,454,61,515
公投第８案,臺南市,安南區,海東里,670,1547,441,160,601,94,695
公投第８案,臺南市,安南區,海東里,671,1784,578,227,805,93,898
公投第８案,臺南市,安南區,海東里,672,2145,719,227,946,76,1022
公投第８案,臺南市,安南區,溪心里,673,2443,922,282,1204,92,1296
公投第８案,臺南市,安南區,溪心里,674,2565,771,285,1056,65,1121
公投第８案,臺南市,安南區,溪心里,675,2480,853,326,1179,106,1285
公投第８案,臺南市,安南區,淵東里,676,2349,692,239,931,121,1052
公投第８案,臺南市,安南區,淵東里,677,2168,761,285,1046,105,1151
公投第８案,臺南市,安南區,淵中里,678,1630,599,177,776,49,825
公投第８案,臺南市,安南區,淵中里,679,1675,486,178,664,60,724
公投第８案,臺南市,安南區,溪墘里,680,1627,660,222,882,127,1009
公投第８案,臺南市,安南區,溪墘里,681,1493,511,196,707,75,782
公投第８案,臺南市,安南區,海佃里,682,1397,495,197,692,92,784
公投第８案,臺南市,安南區,海佃里,683,1416,396,271,667,87,754
公投第８案,臺南市,安南區,海佃里,684,1460,523,190,713,32,745
公投第８案,臺南市,安南區,國安里,685,2222,713,188,901,58,959
公投第８案,臺南市,安南區,溪東里,686,2070,729,245,974,122,1096
公投第８案,臺南市,安南區,溪東里,687,1739,643,217,860,86,946
公投第８案,臺南市,安南區,安富里,688,1830,606,207,813,118,931
公投第８案,臺南市,安南區,安富里,689,1803,728,236,964,90,1054
公投第８案,臺南市,安南區,安富里,690,1800,684,249,933,80,1013
公投第８案,臺南市,安南區,幸福里,691,1815,541,220,761,89,850
公投第８案,臺南市,安南區,幸福里,692,1846,582,217,799,56,855
公投第８案,臺南市,安南區,海南里,693,905,340,148,488,64,552
公投第８案,臺南市,安南區,海南里,694,1073,419,152,571,92,663
公投第８案,臺南市,安南區,城東里,695,1579,638,181,819,86,905
公投第８案,臺南市,安南區,城南里,696,1876,613,226,839,127,966
公投第８案,臺南市,安南區,城南里,697,1194,390,146,536,62,598
公投第８案,臺南市,安南區,青草里,698,1475,384,124,508,35,543
公投第８案,臺南市,安南區,城西里,699,1380,468,145,613,29,642
公投第８案,臺南市,安南區,城北里,700,1462,434,169,603,34,637
公投第８案,臺南市,安南區,城中里,701,1044,397,127,524,71,595
公投第８案,臺南市,安南區,砂崙里,702,603,237,100,337,58,395
公投第８案,臺南市,安南區,砂崙里,703,690,265,101,366,32,398
公投第８案,臺南市,安南區,顯宮里,704,1447,469,182,651,65,716
公投第８案,臺南市,安南區,鹿耳里,705,910,426,124,550,47,597
公投第８案,臺南市,安南區,四草里,706,1850,589,191,780,102,882
公投第８案,臺南市,安南區,塩田里,707,1501,625,175,800,72,872
公投第８案,臺南市,永康區,五王里,708,1398,504,186,690,72,762
公投第８案,臺南市,永康區,五王里,709,1478,420,157,577,48,625
公投第８案,臺南市,永康區,五王里,710,1442,512,153,665,48,713
公投第８案,臺南市,永康區,五王里,711,1353,474,144,618,48,666
公投第８案,臺南市,永康區,三合里,712,1160,390,139,529,32,561
公投第８案,臺南市,永康區,三合里,713,1122,438,118,556,39,595
公投第８案,臺南市,永康區,三合里,714,1165,394,144,538,21,559
公投第８案,臺南市,永康區,六合里,715,1317,456,150,606,49,655
公投第８案,臺南市,永康區,六合里,716,1376,509,138,647,58,705
公投第８案,臺南市,永康區,六合里,717,1361,517,167,684,43,727
公投第８案,臺南市,永康區,六合里,718,1374,547,199,746,48,794
公投第８案,臺南市,永康區,網寮里,719,1709,527,232,759,71,830
公投第８案,臺南市,永康區,網寮里,720,1717,582,184,766,71,837
公投第８案,臺南市,永康區,網寮里,721,1759,563,221,784,54,838
公投第８案,臺南市,永康區,網寮里,722,1636,609,187,796,61,857
公投第８案,臺南市,永康區,二王里,723,1442,533,152,685,78,763
公投第８案,臺南市,永康區,二王里,724,1545,567,162,729,50,779
公投第８案,臺南市,永康區,二王里,725,1565,589,147,736,51,787
公投第８案,臺南市,永康區,二王里,726,1684,570,195,765,47,812
公投第８案,臺南市,永康區,二王里,727,1548,510,167,677,28,705
公投第８案,臺南市,永康區,永康里,728,1389,525,188,713,38,751
公投第８案,臺南市,永康區,永康里,729,1369,508,143,651,66,717
公投第８案,臺南市,永康區,永康里,730,1415,512,157,669,96,765
公投第８案,臺南市,永康區,永康里,731,1386,435,131,566,21,587
公投第８案,臺南市,永康區,永康里,732,1747,295,84,379,9,388
公投第８案,臺南市,永康區,永康里,733,1485,521,164,685,73,758
公投第８案,臺南市,永康區,埔園里,734,1747,602,189,791,95,886
公投第８案,臺南市,永康區,埔園里,735,1744,512,189,701,44,745
公投第８案,臺南市,永康區,埔園里,736,1797,582,181,763,60,823
公投第８案,臺南市,永康區,埔園里,737,1800,685,206,891,74,965
公投第８案,臺南市,永康區,龍埔里,738,1720,609,167,776,30,806
公投第８案,臺南市,永康區,龍埔里,739,1708,645,213,858,51,909
公投第８案,臺南市,永康區,正強里,740,1519,594,164,758,48,806
公投第８案,臺南市,永康區,正強里,741,1497,547,189,736,103,839
公投第８案,臺南市,永康區,正強里,742,1509,534,149,683,36,719
公投第８案,臺南市,永康區,正強里,743,1542,623,192,815,90,905
公投第８案,臺南市,永康區,正強里,744,1536,625,182,807,31,838
公投第８案,臺南市,永康區,大橋里,745,1531,555,205,760,63,823
公投第８案,臺南市,永康區,大橋里,746,1327,509,187,696,62,758
公投第８案,臺南市,永康區,大橋里,747,1456,540,175,715,23,738
公投第８案,臺南市,永康區,大橋里,748,1396,532,190,722,52,774
公投第８案,臺南市,永康區,東橋里,749,1636,551,223,774,66,840
公投第８案,臺南市,永康區,東橋里,750,1592,577,217,794,56,850
公投第８案,臺南市,永康區,東橋里,751,2017,703,221,924,33,957
公投第８案,臺南市,永康區,東橋里,752,672,249,82,331,21,352
公投第８案,臺南市,永康區,西橋里,753,1611,535,178,713,32,745
公投第８案,臺南市,永康區,西橋里,754,1502,568,173,741,54,795
公投第８案,臺南市,永康區,安康里,755,1660,527,164,691,35,726
公投第８案,臺南市,永康區,安康里,756,1561,484,158,642,38,680
公投第８案,臺南市,永康區,安康里,757,1590,497,202,699,37,736
公投第８案,臺南市,永康區,蔦松里,758,924,333,109,442,17,459
公投第８案,臺南市,永康區,蔦松里,759,938,391,115,506,26,532
公投第８案,臺南市,永康區,三民里,760,957,395,98,493,45,538
公投第８案,臺南市,永康區,三民里,761,496,166,68,234,42,276
公投第８案,臺南市,永康區,塩行里,762,1717,611,217,828,76,904
公投第８案,臺南市,永康區,塩行里,763,1615,518,180,698,44,742
公投第８案,臺南市,永康區,塩行里,764,1554,494,187,681,31,712
公投第８案,臺南市,永康區,塩興里,765,1196,386,135,521,35,556
公投第８案,臺南市,永康區,塩興里,766,1274,461,154,615,43,658
公投第８案,臺南市,永康區,塩興里,767,1215,467,146,613,41,654
公投第８案,臺南市,永康區,塩洲里,768,1457,518,179,697,29,726
公投第８案,臺南市,永康區,塩洲里,769,1451,545,171,716,22,738
公投第８案,臺南市,永康區,塩洲里,770,1423,453,181,634,49,683
公投第８案,臺南市,永康區,塩洲里,771,1394,517,186,703,40,743
公投第８案,臺南市,永康區,甲頂里,772,890,350,111,461,54,515
公投第８案,臺南市,永康區,甲頂里,773,1018,392,155,547,64,611
公投第８案,臺南市,永康區,甲頂里,774,368,144,44,188,26,214
公投第８案,臺南市,永康區,尚頂里,775,1208,458,199,657,56,713
公投第８案,臺南市,永康區,尚頂里,776,1187,357,162,519,37,556
公投第８案,臺南市,永康區,尚頂里,777,1381,479,184,663,36,699
公投第８案,臺南市,永康區,龍潭里,778,1405,497,154,651,79,730
公投第８案,臺南市,永康區,龍潭里,779,1445,467,175,642,80,722
公投第８案,臺南市,永康區,龍潭里,780,1687,599,183,782,67,849
公投第８案,臺南市,永康區,龍潭里,781,1535,472,166,638,41,679
公投第８案,臺南市,永康區,永明里,782,1542,612,163,775,60,835
公投第８案,臺南市,永康區,永明里,783,1618,597,168,765,40,805
公投第８案,臺南市,永康區,永明里,784,1338,550,155,705,36,741
公投第８案,臺南市,永康區,王行里,785,1285,475,182,657,79,736
公投第８案,臺南市,永康區,王行里,786,1240,437,144,581,32,613
公投第８案,臺南市,永康區,烏竹里,787,1343,433,172,605,64,669
公投第８案,臺南市,永康區,烏竹里,788,1327,526,180,706,55,761
公投第８案,臺南市,永康區,西勢里,789,1565,563,189,752,60,812
公投第８案,臺南市,永康區,西勢里,790,1476,611,110,721,100,821
公投第８案,臺南市,永康區,西勢里,791,1476,529,175,704,49,753
公投第８案,臺南市,永康區,西勢里,792,1463,570,201,771,60,831
公投第８案,臺南市,永康區,新樹里,793,983,357,129,486,89,575
公投第８案,臺南市,永康區,新樹里,794,1116,422,154,576,71,647
公投第８案,臺南市,永康區,大灣里,795,1117,369,133,502,85,587
公投第８案,臺南市,永康區,大灣里,796,1069,325,139,464,36,500
公投第８案,臺南市,永康區,大灣里,797,1180,510,144,654,43,697
公投第８案,臺南市,永康區,東灣里,798,1176,418,131,549,95,644
公投第８案,臺南市,永康區,東灣里,799,1158,383,170,553,55,608
公投第８案,臺南市,永康區,東灣里,800,1208,444,170,614,93,707
公投第８案,臺南市,永康區,西灣里,801,1501,515,197,712,89,801
公投第８案,臺南市,永康區,西灣里,802,1298,490,168,658,38,696
公投第８案,臺南市,永康區,西灣里,803,1542,593,137,730,33,763
公投第８案,臺南市,永康區,西灣里,804,1537,611,178,789,68,857
公投第８案,臺南市,永康區,西灣里,805,1359,557,182,739,79,818
公投第８案,臺南市,永康區,南灣里,806,1139,343,128,471,46,517
公投第８案,臺南市,永康區,南灣里,807,1158,378,142,520,53,573
公投第８案,臺南市,永康區,南灣里,808,1538,479,211,690,86,776
公投第８案,臺南市,永康區,崑山里,809,1166,401,119,520,22,542
公投第８案,臺南市,永康區,崑山里,810,1228,434,112,546,24,570
公投第８案,臺南市,永康區,崑山里,811,1200,340,281,621,67,688
公投第８案,臺南市,永康區,崑山里,812,1131,411,176,587,46,633
公投第８案,臺南市,永康區,崑山里,813,1147,402,142,544,34,578
公投第８案,臺南市,永康區,北灣里,814,1442,502,163,665,62,727
公投第８案,臺南市,永康區,北灣里,815,1325,460,135,595,35,630
公投第８案,臺南市,永康區,北灣里,816,1260,404,114,518,46,564
公投第８案,臺南市,永康區,北興里,817,1631,549,189,738,61,799
公投第８案,臺南市,永康區,北興里,818,1549,551,164,715,53,768
公投第８案,臺南市,永康區,北興里,819,1666,568,189,757,46,803
公投第８案,臺南市,永康區,復興里,820,1012,359,88,447,49,496
公投第８案,臺南市,永康區,復興里,821,976,316,82,398,24,422
公投第８案,臺南市,永康區,光復里,822,531,206,53,259,24,283
公投第８案,臺南市,永康區,建國里,823,859,343,79,422,51,473
公投第８案,臺南市,永康區,建國里,824,937,330,91,421,40,461
公投第８案,臺南市,永康區,復國里,825,1307,497,144,641,55,696
公投第８案,臺南市,永康區,復國里,826,1482,514,123,637,35,672
公投第８案,臺南市,永康區,復國里,827,1341,437,139,576,42,618
公投第８案,臺南市,永康區,復國里,828,1376,505,138,643,52,695
公投第８案,臺南市,永康區,復國里,829,1390,464,170,634,57,691
公投第８案,臺南市,永康區,復國里,830,1534,557,226,783,47,830
公投第８案,臺南市,永康區,復華里,831,1460,582,173,755,47,802
公投第８案,臺南市,永康區,復華里,832,1383,497,153,650,30,680
公投第８案,臺南市,永康區,復華里,833,1299,465,149,614,44,658
公投第８案,臺南市,永康區,復華里,834,1264,495,163,658,37,695
公投第８案,臺南市,永康區,復華里,835,1355,557,158,715,49,764
公投第８案,臺南市,永康區,復華里,836,1414,502,135,637,34,671
公投第８案,臺南市,永康區,復華里,837,1109,456,140,596,30,626
公投第８案,臺南市,永康區,神洲里,838,1151,427,110,537,51,588
公投第８案,臺南市,永康區,成功里,839,1026,597,9,606,54,660
公投第８案,臺南市,永康區,成功里,840,1071,346,124,470,30,500
公投第８案,臺南市,永康區,中華里,841,1387,588,198,786,78,864
公投第８案,臺南市,永康區,中華里,842,1377,548,205,753,50,803
公投第８案,臺南市,永康區,中興里,843,1687,607,214,821,74,895
公投第８案,臺南市,永康區,中興里,844,1700,593,202,795,48,843
公投第８案,臺南市,永康區,勝利里,845,1444,558,197,755,47,802
公投第８案,臺南市,永康區,勝利里,846,1485,554,154,708,50,758
公投第８案,臺南市,永康區,勝利里,847,1717,571,184,755,47,802
公投第８案,臺南市,永康區,勝利里,848,1701,560,174,734,60,794
公投第８案,臺南市,永康區,勝利里,849,1382,481,147,628,40,668
公投第８案,臺南市,北區,開元里,850,1793,622,196,818,91,909
公投第８案,臺南市,北區,開元里,851,1708,531,188,719,61,780
公投第８案,臺南市,北區,元寶里,852,997,369,116,485,25,510
公投第８案,臺南市,北區,元寶里,853,1452,447,161,608,42,650
公投第８案,臺南市,北區,元寶里,854,1351,461,175,636,25,661
公投第８案,臺南市,北區,合興里,855,1323,551,204,755,69,824
公投第８案,臺南市,北區,合興里,856,1073,396,151,547,35,582
公投第８案,臺南市,北區,合興里,857,1138,428,150,578,36,614
公投第８案,臺南市,北區,力行里,858,1189,421,145,566,48,614
公投第８案,臺南市,北區,力行里,859,1262,524,169,693,48,741
公投第８案,臺南市,北區,重興里,860,1017,433,131,564,31,595
公投第８案,臺南市,北區,重興里,861,847,306,95,401,28,429
公投第８案,臺南市,北區,東興里,862,1076,455,118,573,50,623
公投第８案,臺南市,北區,東興里,863,954,370,160,530,37,567
公投第８案,臺南市,北區,長勝里,864,1300,476,133,609,76,685
公投第８案,臺南市,北區,長勝里,865,1390,535,134,669,58,727
公投第８案,臺南市,北區,長勝里,866,1318,524,164,688,52,740
公投第８案,臺南市,北區,振興里,867,974,357,118,475,19,494
公投第８案,臺南市,北區,振興里,868,990,361,126,487,27,514
公投第８案,臺南市,北區,仁愛里,869,1016,395,175,570,29,599
公投第８案,臺南市,北區,仁愛里,870,1053,369,167,536,51,587
公投第８案,臺南市,北區,中樓里,871,1466,456,200,656,94,750
公投第８案,臺南市,北區,永祥里,872,1535,560,202,762,83,845
公投第８案,臺南市,北區,永祥里,873,1544,508,208,716,82,798
公投第８案,臺南市,北區,北門里,874,1760,698,205,903,72,975
公投第８案,臺南市,北區,北門里,875,1372,402,171,573,48,621
公投第８案,臺南市,北區,北門里,876,1002,406,129,535,51,586
公投第８案,臺南市,北區,北門里,877,1171,458,168,626,52,678
公投第８案,臺南市,北區,大光里,878,1285,474,106,580,30,610
公投第８案,臺南市,北區,大光里,879,1036,394,100,494,45,539
公投第８案,臺南市,北區,大光里,880,1392,546,150,696,50,746
公投第８案,臺南市,北區,大光里,881,1147,420,155,575,59,634
公投第８案,臺南市,北區,大興里,882,1526,451,156,607,52,659
公投第８案,臺南市,北區,大興里,883,1559,534,196,730,46,776
公投第８案,臺南市,北區,公園里,884,892,296,137,433,78,511
公投第８案,臺南市,北區,公園里,885,937,319,115,434,44,478
公投第８案,臺南市,北區,北華里,886,1449,507,208,715,112,827
公投第８案,臺南市,北區,北華里,887,1160,394,142,536,34,570
公投第８案,臺南市,北區,北華里,888,1567,368,143,511,81,592
公投第８案,臺南市,北區,長興里,889,1346,430,207,637,70,707
公投第８案,臺南市,北區,長興里,890,1451,488,154,642,18,660
公投第８案,臺南市,北區,小北里,891,1522,497,186,683,49,732
公投第８案,臺南市,北區,小北里,892,1278,437,158,595,39,634
公投第８案,臺南市,北區,小北里,893,1164,279,146,425,72,497
公投第８案,臺南市,北區,正覺里,894,1091,341,136,477,25,502
公投第８案,臺南市,北區,正覺里,895,993,325,128,453,35,488
公投第８案,臺南市,北區,正覺里,896,1119,327,114,441,42,483
公投第８案,臺南市,北區,成功里,897,1685,597,239,836,86,922
公投第８案,臺南市,北區,成功里,898,1368,491,187,678,24,702
公投第８案,臺南市,北區,成功里,899,1389,496,180,676,66,742
公投第８案,臺南市,北區,華德里,900,1469,579,198,777,31,808
公投第８案,臺南市,北區,華德里,901,1655,666,205,871,77,948
公投第８案,臺南市,北區,福德里,902,1261,500,172,672,39,711
公投第８案,臺南市,北區,福德里,903,1490,542,166,708,32,740
公投第８案,臺南市,北區,福德里,904,1436,640,180,820,6,826
公投第８案,臺南市,北區,成德里,905,1340,525,177,702,84,786
公投第８案,臺南市,北區,成德里,906,1464,551,199,750,42,792
公投第８案,臺南市,北區,成德里,907,1513,613,216,829,29,858
公投第８案,臺南市,北區,和順里,908,1709,665,226,891,35,926
公投第８案,臺南市,北區,和順里,909,1517,638,220,858,50,908
公投第８案,臺南市,北區,和順里,910,1598,575,224,799,28,827
公投第８案,臺南市,北區,立人里,911,1399,493,184,677,59,736
公投第８案,臺南市,北區,立人里,912,1214,412,160,572,60,632
公投第８案,臺南市,北區,雙安里,913,1064,417,148,565,31,596
公投第８案,臺南市,北區,雙安里,914,1148,459,182,641,59,700
公投第８案,臺南市,北區,文成里,915,1391,505,196,701,50,751
公投第８案,臺南市,北區,文成里,916,1584,622,188,810,56,866
公投第８案,臺南市,北區,元美里,917,1595,642,200,842,47,889
公投第８案,臺南市,北區,元美里,918,1397,513,173,686,42,728
公投第８案,臺南市,北區,文元里,919,1662,600,219,819,65,884
公投第８案,臺南市,北區,文元里,920,1634,566,203,769,35,804
公投第８案,臺南市,北區,大和里,921,1793,677,235,912,102,1014
公投第８案,臺南市,北區,大和里,922,1872,572,274,846,53,899
公投第８案,臺南市,北區,大港里,923,1874,634,254,888,119,1007
公投第８案,臺南市,北區,大港里,924,1760,625,204,829,73,902
公投第８案,臺南市,北區,大港里,925,1753,624,194,818,71,889
公投第８案,臺南市,北區,大豐里,926,1502,452,146,598,35,633
公投第８案,臺南市,北區,大豐里,927,1470,535,188,723,57,780
公投第８案,臺南市,北區,大豐里,928,1319,418,189,607,97,704
公投第８案,臺南市,北區,賢北里,929,1876,715,243,958,74,1032
公投第８案,臺南市,北區,賢北里,930,1720,597,234,831,48,879
公投第８案,臺南市,中西區,赤嵌里,931,1332,464,205,669,65,734
公投第８案,臺南市,中西區,赤嵌里,932,1246,438,190,628,84,712
公投第８案,臺南市,中西區,赤嵌里,933,1276,408,181,589,78,667
公投第８案,臺南市,中西區,郡王里,934,1583,593,225,818,64,882
公投第８案,臺南市,中西區,郡王里,935,1464,559,215,774,59,833
公投第８案,臺南市,中西區,法華里,936,1234,402,198,600,28,628
公投第８案,臺南市,中西區,法華里,937,1368,507,221,728,55,783
公投第８案,臺南市,中西區,開山里,938,1322,400,154,554,42,596
公投第８案,臺南市,中西區,開山里,939,1216,385,183,568,72,640
公投第８案,臺南市,中西區,永華里,940,1289,412,196,608,48,656
公投第８案,臺南市,中西區,永華里,941,1237,447,185,632,59,691
公投第８案,臺南市,中西區,藥王里,942,1189,342,168,510,39,549
公投第８案,臺南市,中西區,藥王里,943,1201,422,179,601,72,673
公投第８案,臺南市,中西區,藥王里,944,1065,428,145,573,63,636
公投第８案,臺南市,中西區,光賢里,945,1055,404,136,540,57,597
公投第８案,臺南市,中西區,光賢里,946,1170,476,191,667,45,712
公投第８案,臺南市,中西區,光賢里,947,1280,528,173,701,58,759
公投第８案,臺南市,中西區,大涼里,948,1223,448,194,642,46,688
公投第８案,臺南市,中西區,大涼里,949,1292,493,181,674,75,749
公投第８案,臺南市,中西區,西湖里,950,993,399,150,549,22,571
公投第８案,臺南市,中西區,西湖里,951,1541,554,208,762,63,825
公投第８案,臺南市,中西區,西湖里,952,1652,663,238,901,85,986
公投第８案,臺南市,中西區,西湖里,953,1212,480,170,650,37,687
公投第８案,臺南市,中西區,西賢里,954,1621,603,235,838,83,921
公投第８案,臺南市,中西區,西賢里,955,1660,594,258,852,57,909
公投第８案,臺南市,中西區,西賢里,956,1595,563,225,788,75,863
公投第８案,臺南市,中西區,城隍里,957,1436,488,205,693,69,762
公投第８案,臺南市,中西區,城隍里,958,1265,461,191,652,71,723
公投第８案,臺南市,中西區,城隍里,959,856,339,132,471,54,525
公投第８案,臺南市,中西區,南美里,960,1168,382,176,558,56,614
公投第８案,臺南市,中西區,南美里,961,1134,435,168,603,55,658
公投第８案,臺南市,中西區,南美里,962,995,402,156,558,65,623
公投第８案,臺南市,中西區,南門里,963,1313,584,166,750,55,805
公投第８案,臺南市,中西區,南門里,964,1265,494,198,692,56,748
公投第８案,臺南市,中西區,小西門里,965,1215,422,173,595,56,651
公投第８案,臺南市,中西區,小西門里,966,1248,466,152,618,65,683
公投第８案,臺南市,中西區,小西門里,967,687,211,120,331,46,377
公投第８案,臺南市,中西區,五條港里,968,1139,387,157,544,90,634
公投第８案,臺南市,中西區,五條港里,969,971,387,124,511,55,566
公投第８案,臺南市,中西區,兌悅里,970,1254,344,135,479,64,543
公投第８案,臺南市,中西區,兌悅里,971,979,340,138,478,52,530
公投第８案,臺南市,中西區,兌悅里,972,1745,596,217,813,73,886
公投第８案,臺南市,中西區,淺草里,973,1074,365,171,536,43,579
公投第８案,臺南市,中西區,淺草里,974,1436,460,200,660,48,708
公投第８案,臺南市,中西區,府前里,975,865,288,143,431,58,489
公投第８案,臺南市,中西區,府前里,976,1164,413,164,577,58,635
公投第８案,臺南市,中西區,南廠里,977,1285,386,172,558,39,597
公投第８案,臺南市,中西區,南廠里,978,1078,376,159,535,56,591
公投第８案,臺南市,中西區,南廠里,979,1704,470,188,658,63,721
公投第８案,臺南市,中西區,西和里,980,1296,471,196,667,87,754
公投第８案,臺南市,中西區,西和里,981,1128,429,140,569,51,620
公投第８案,臺南市,中西區,西和里,982,1245,447,187,634,42,676
公投第８案,臺南市,安平區,文平里,983,1753,638,238,876,89,965
公投第８案,臺南市,安平區,文平里,984,1859,680,204,884,63,947
公投第８案,臺南市,安平區,文平里,985,1382,475,181,656,53,709
公投第８案,臺南市,安平區,建平里,986,2547,861,310,1171,89,1260
公投第８案,臺南市,安平區,建平里,987,2407,880,313,1193,59,1252
公投第８案,臺南市,安平區,怡平里,988,2070,644,221,865,59,924
公投第８案,臺南市,安平區,怡平里,989,2132,744,275,1019,41,1060
公投第８案,臺南市,安平區,華平里,990,1450,553,182,735,23,758
公投第８案,臺南市,安平區,華平里,991,1605,554,185,739,29,768
公投第８案,臺南市,安平區,華平里,992,1755,620,243,863,75,938
公投第８案,臺南市,安平區,平通里,993,1728,557,202,759,54,813
公投第８案,臺南市,安平區,平通里,994,1754,496,190,686,33,719
公投第８案,臺南市,安平區,平通里,995,1686,619,192,811,61,872
公投第８案,臺南市,安平區,平通里,996,1843,705,231,936,55,991
公投第８案,臺南市,安平區,億載里,997,1565,612,202,814,51,865
公投第８案,臺南市,安平區,億載里,998,1288,484,152,636,37,673
公投第８案,臺南市,安平區,育平里,999,1653,541,205,746,23,769
公投第８案,臺南市,安平區,育平里,1000,1697,602,166,768,32,800
公投第８案,臺南市,安平區,育平里,1001,2154,745,206,951,56,1007
公投第８案,臺南市,安平區,育平里,1002,2107,739,231,970,52,1022
公投第８案,臺南市,安平區,國平里,1003,1675,644,200,844,77,921
公投第８案,臺南市,安平區,國平里,1004,1979,674,267,941,69,1010
公投第８案,臺南市,安平區,國平里,1005,1602,549,206,755,36,791
公投第８案,臺南市,安平區,國平里,1006,1586,571,179,750,53,803
公投第８案,臺南市,安平區,漁光里,1007,438,132,35,167,12,179
公投第８案,臺南市,安平區,平安里,1008,1780,575,230,805,93,898
公投第８案,臺南市,安平區,平安里,1009,1623,494,218,712,45,757
公投第８案,臺南市,安平區,天妃里,1010,2157,703,248,951,108,1059
公投第８案,臺南市,安平區,天妃里,1011,1286,390,157,547,56,603
公投第８案,臺南市,安平區,王城里,1012,1492,478,212,690,92,782
公投第８案,臺南市,安平區,王城里,1013,1325,388,133,521,44,565
公投第８案,臺南市,安平區,金城里,1014,2001,714,189,903,84,987
公投第８案,臺南市,南區,大恩里,1015,1221,451,172,623,48,671
公投第８案,臺南市,南區,大恩里,1016,2171,688,217,905,99,1004
公投第８案,臺南市,南區,大林里,1017,1150,478,141,619,45,664
公投第８案,臺南市,南區,大林里,1018,1122,448,127,575,35,610
公投第８案,臺南市,南區,大忠里,1019,1444,467,167,634,53,687
公投第８案,臺南市,南區,大忠里,1020,1765,586,205,791,68,859
公投第８案,臺南市,南區,大忠里,1021,1298,482,188,670,65,735
公投第８案,臺南市,南區,新生里,1022,1458,609,144,753,44,797
公投第８案,臺南市,南區,新生里,1023,1940,732,146,878,41,919
公投第８案,臺南市,南區,竹溪里,1024,1637,577,205,782,80,862
公投第８案,臺南市,南區,明德里,1025,871,286,96,382,11,393
公投第８案,臺南市,南區,大成里,1026,589,226,86,312,22,334
公投第８案,臺南市,南區,大成里,1027,801,343,134,477,46,523
公投第８案,臺南市,南區,田寮里,1028,990,384,120,504,64,568
公投第８案,臺南市,南區,田寮里,1029,1222,513,172,685,51,736
公投第８案,臺南市,南區,田寮里,1030,997,357,153,510,89,599
公投第８案,臺南市,南區,新興里,1031,1204,374,174,548,39,587
公投第８案,臺南市,南區,新興里,1032,1570,470,188,658,43,701
公投第８案,臺南市,南區,再興里,1033,1222,421,180,601,68,669
公投第８案,臺南市,南區,再興里,1034,1076,344,115,459,33,492
公投第８案,臺南市,南區,廣州里,1035,1127,337,188,525,36,561
公投第８案,臺南市,南區,廣州里,1036,1135,399,149,548,71,619
公投第８案,臺南市,南區,新昌里,1037,1263,436,157,593,76,669
公投第８案,臺南市,南區,新昌里,1038,1014,340,109,449,39,488
公投第８案,臺南市,南區,文華里,1039,1491,542,209,751,81,832
公投第８案,臺南市,南區,文華里,1040,1815,640,214,854,56,910
公投第８案,臺南市,南區,文南里,1041,1398,473,170,643,28,671
公投第８案,臺南市,南區,文南里,1042,2107,611,224,835,57,892
公投第８案,臺南市,南區,文南里,1043,1587,635,227,862,71,933
公投第８案,臺南市,南區,金華里,1044,1626,525,254,779,90,869
公投第８案,臺南市,南區,金華里,1045,1761,542,226,768,45,813
公投第８案,臺南市,南區,金華里,1046,1630,546,225,771,95,866
公投第８案,臺南市,南區,國宅里,1047,1542,552,205,757,71,828
公投第８案,臺南市,南區,國宅里,1048,1464,483,181,664,106,770
公投第８案,臺南市,南區,鹽埕里,1049,1727,545,242,787,118,905
公投第８案,臺南市,南區,鹽埕里,1050,1085,403,173,576,68,644
公投第８案,臺南市,南區,鹽埕里,1051,939,315,114,429,22,451
公投第８案,臺南市,南區,光明里,1052,1419,425,156,581,92,673
公投第８案,臺南市,南區,光明里,1053,1333,451,144,595,71,666
公投第８案,臺南市,南區,光明里,1054,1465,482,178,660,66,726
公投第８案,臺南市,南區,明亮里,1055,1099,382,131,513,35,548
公投第８案,臺南市,南區,明亮里,1056,1133,392,113,505,32,537
公投第８案,臺南市,南區,明亮里,1057,1375,419,178,597,112,709
公投第８案,臺南市,南區,府南里,1058,1781,518,204,722,49,771
公投第８案,臺南市,南區,府南里,1059,1542,603,199,802,71,873
公投第８案,臺南市,南區,府南里,1060,1486,483,180,663,46,709
公投第８案,臺南市,南區,明興里,1061,1640,573,225,798,108,906
公投第８案,臺南市,南區,明興里,1062,1701,493,212,705,60,765
公投第８案,臺南市,南區,郡南里,1063,1541,466,167,633,112,745
公投第８案,臺南市,南區,郡南里,1064,2027,687,206,893,127,1020
公投第８案,臺南市,南區,建南里,1065,1774,675,249,924,108,1032
公投第８案,臺南市,南區,建南里,1066,1613,517,230,747,83,830
公投第８案,臺南市,南區,建南里,1067,1707,550,215,765,31,796
公投第８案,臺南市,南區,南都里,1068,1657,346,157,503,29,532
公投第８案,臺南市,南區,南都里,1069,1077,377,142,519,56,575
公投第８案,臺南市,南區,南華里,1070,1185,451,127,578,47,625
公投第８案,臺南市,南區,南華里,1071,1249,425,172,597,59,656
公投第８案,臺南市,南區,開南里,1072,1985,605,189,794,43,837
公投第８案,臺南市,南區,開南里,1073,2017,560,252,812,93,905
公投第８案,臺南市,南區,開南里,1074,1717,525,217,742,98,840
公投第８案,臺南市,南區,彰南里,1075,929,344,111,455,51,506
公投第８案,臺南市,南區,彰南里,1076,695,249,109,358,36,394
公投第８案,臺南市,南區,鯤鯓里,1077,997,300,90,390,33,423
公投第８案,臺南市,南區,鯤鯓里,1078,784,251,56,307,23,330
公投第８案,臺南市,南區,喜北里,1079,1119,428,139,567,80,647
公投第８案,臺南市,南區,喜北里,1080,1054,264,123,387,37,424
公投第８案,臺南市,南區,喜南里,1081,1245,372,154,526,113,639
公投第８案,臺南市,南區,喜東里,1082,2064,597,229,826,92,918
公投第８案,臺南市,南區,省躬里,1083,2056,546,189,735,33,768
公投第８案,臺南市,南區,省躬里,1084,1373,389,145,534,37,571
公投第８案,臺南市,南區,永寧里,1085,1002,249,122,371,37,408
公投第８案,臺南市,南區,永寧里,1086,760,247,124,371,68,439
公投第８案,臺南市,南區,松安里,1087,1031,335,141,476,84,560
公投第８案,臺南市,南區,松安里,1088,744,253,91,344,64,408
公投第８案,臺南市,南區,佛壇里,1089,1186,414,140,554,86,640
公投第８案,臺南市,南區,佛壇里,1090,1358,456,194,650,91,741
公投第８案,臺南市,南區,同安里,1091,897,240,107,347,43,390
公投第８案,臺南市,南區,同安里,1092,1265,435,149,584,74,658
公投第８案,臺南市,南區,興農里,1093,1093,294,135,429,53,482
公投第８案,臺南市,南區,興農里,1094,1016,386,110,496,37,533
公投第８案,臺南市,東區,崇信里,1095,2681,715,257,972,70,1042
公投第８案,臺南市,東區,崇信里,1096,1811,604,249,853,37,890
公投第８案,臺南市,東區,崇學里,1097,1491,606,231,837,94,931
公投第８案,臺南市,東區,崇學里,1098,1378,519,182,701,53,754
公投第８案,臺南市,東區,崇德里,1099,1552,594,104,698,73,771
公投第８案,臺南市,東區,崇德里,1100,1326,509,216,725,32,757
公投第８案,臺南市,東區,崇德里,1101,1594,602,223,825,76,901
公投第８案,臺南市,東區,崇善里,1102,1639,628,249,877,62,939
公投第８案,臺南市,東區,崇善里,1103,1724,627,232,859,65,924
公投第８案,臺南市,東區,崇善里,1104,1629,602,222,824,83,907
公投第８案,臺南市,東區,崇成里,1105,1399,542,162,704,45,749
公投第８案,臺南市,東區,崇成里,1106,1534,602,171,773,43,816
公投第８案,臺南市,東區,崇文里,1107,1656,633,227,860,73,933
公投第８案,臺南市,東區,崇文里,1108,1322,507,149,656,72,728
公投第８案,臺南市,東區,崇文里,1109,1620,633,199,832,42,874
公投第８案,臺南市,東區,崇文里,1110,1331,597,165,762,45,807
公投第８案,臺南市,東區,東智里,1111,1039,386,137,523,61,584
公投第８案,臺南市,東區,東智里,1112,1257,409,137,546,44,590
公投第８案,臺南市,東區,大智里,1113,2067,696,219,915,131,1046
公投第８案,臺南市,東區,大智里,1114,2153,875,201,1076,45,1121
公投第８案,臺南市,東區,大智里,1115,2363,888,271,1159,64,1223
公投第８案,臺南市,東區,德高里,1116,1427,547,175,722,59,781
公投第８案,臺南市,東區,德高里,1117,1555,590,208,798,50,848
公投第８案,臺南市,東區,仁和里,1118,2115,680,194,874,76,950
公投第８案,臺南市,東區,仁和里,1119,2340,818,256,1074,90,1164
公投第８案,臺南市,東區,和平里,1120,2474,912,320,1232,83,1315
公投第８案,臺南市,東區,和平里,1121,2391,878,275,1153,83,1236
公投第８案,臺南市,東區,虎尾里,1122,1673,622,248,870,60,930
公投第８案,臺南市,東區,虎尾里,1123,1594,560,215,775,45,820
公投第８案,臺南市,東區,虎尾里,1124,1607,656,190,846,72,918
公投第８案,臺南市,東區,裕聖里,1125,2087,884,259,1143,48,1191
公投第８案,臺南市,東區,裕聖里,1126,2369,968,328,1296,50,1346
公投第８案,臺南市,東區,復興里,1127,1696,574,210,784,120,904
公投第８案,臺南市,東區,復興里,1128,1612,559,234,793,50,843
公投第８案,臺南市,東區,自強里,1129,1708,594,215,809,71,880
公投第８案,臺南市,東區,自強里,1130,1560,593,200,793,59,852
公投第８案,臺南市,東區,自強里,1131,1854,675,239,914,69,983
公投第８案,臺南市,東區,東聖里,1132,2278,727,304,1031,49,1080
公投第８案,臺南市,東區,關聖里,1133,2093,737,253,990,59,1049
公投第８案,臺南市,東區,關聖里,1134,2242,914,294,1208,67,1275
公投第８案,臺南市,東區,南聖里,1135,1152,467,156,623,56,679
公投第８案,臺南市,東區,南聖里,1136,1318,601,173,774,22,796
公投第８案,臺南市,東區,文聖里,1137,2200,842,284,1126,57,1183
公投第８案,臺南市,東區,文聖里,1138,1960,820,269,1089,51,1140
公投第８案,臺南市,東區,後甲里,1139,1489,529,201,730,49,779
公投第８案,臺南市,東區,後甲里,1140,1443,503,211,714,81,795
公投第８案,臺南市,東區,東光里,1141,1498,609,241,850,56,906
公投第８案,臺南市,東區,東光里,1142,1622,615,234,849,26,875
公投第８案,臺南市,東區,東光里,1143,1738,678,225,903,57,960
公投第８案,臺南市,東區,東明里,1144,1501,520,201,721,71,792
公投第８案,臺南市,東區,東明里,1145,1482,536,221,757,68,825
公投第８案,臺南市,東區,莊敬里,1146,1829,612,226,838,47,885
公投第８案,臺南市,東區,莊敬里,1147,1764,645,246,891,70,961
公投第８案,臺南市,東區,小東里,1148,1427,603,174,777,44,821
公投第８案,臺南市,東區,小東里,1149,1427,504,191,695,77,772
公投第８案,臺南市,東區,小東里,1150,1388,565,159,724,57,781
公投第８案,臺南市,東區,大學里,1151,1131,437,205,642,40,682
公投第８案,臺南市,東區,成大里,1152,1000,354,120,474,60,534
公投第８案,臺南市,東區,成大里,1153,996,383,117,500,53,553
公投第８案,臺南市,東區,東門里,1154,935,319,123,442,56,498
公投第８案,臺南市,東區,東門里,1155,947,307,155,462,83,545
公投第８案,臺南市,東區,圍下里,1156,1090,394,166,560,19,579
公投第８案,臺南市,東區,圍下里,1157,896,297,125,422,55,477
公投第８案,臺南市,東區,中西里,1158,1589,562,224,786,32,818
公投第８案,臺南市,東區,中西里,1159,1497,583,196,779,61,840
公投第８案,臺南市,東區,東安里,1160,1386,463,198,661,60,721
公投第８案,臺南市,東區,新東里,1161,1101,393,161,554,21,575
公投第８案,臺南市,東區,新東里,1162,1332,488,217,705,64,769
公投第８案,臺南市,東區,崇誨里,1163,1185,463,143,606,61,667
公投第８案,臺南市,東區,崇誨里,1164,1262,526,147,673,60,733
公投第８案,臺南市,東區,衛國里,1165,1517,517,187,704,53,757
公投第８案,臺南市,東區,裕農里,1166,1287,459,162,621,88,709
公投第８案,臺南市,東區,裕農里,1167,1657,626,222,848,67,915
公投第８案,臺南市,東區,富強里,1168,2238,811,283,1094,118,1212
公投第８案,臺南市,東區,富強里,1169,2246,787,302,1089,56,1145
公投第８案,臺南市,東區,富裕里,1170,2191,786,266,1052,68,1120
公投第８案,臺南市,東區,忠孝里,1171,2063,746,257,1003,72,1075
公投第８案,臺南市,東區,忠孝里,1172,2177,866,298,1164,87,1251
公投第８案,臺南市,東區,崇明里,1173,1863,757,216,973,104,1077
公投第８案,臺南市,東區,崇明里,1174,2185,880,250,1130,58,1188
公投第８案,臺南市,東區,大福里,1175,1721,563,192,755,57,812
公投第８案,臺南市,東區,大德里,1176,1556,547,201,748,113,861
公投第８案,臺南市,東區,路東里,1177,1602,665,198,863,57,920
公投第８案,臺南市,東區,大同里,1178,1523,543,165,708,87,795
公投第８案,臺南市,東區,大同里,1179,1382,432,188,620,65,685
公投第８案,臺南市,東區,泉南里,1180,1486,527,211,738,47,785
公投第８案,臺南市,東區,泉南里,1181,1560,536,248,784,85,869
公投第８案,臺南市,東區,泉南里,1182,1684,531,228,759,81,840
公投第８案,臺南市,東區,龍山里,1183,1653,605,251,856,53,909
公投第８案,臺南市,東區,龍山里,1184,1554,565,239,804,31,835
公投第８案,臺南市,東區,龍山里,1185,1408,549,199,748,36,784
公投第８案,臺南市,東區,德光里,1186,2084,812,313,1125,58,1183
公投第８案,臺南市,東區,德光里,1187,1896,709,235,944,85,1029
公投第８案,臺南市,仁德區,太子里,1188,1318,464,166,630,89,719
公投第８案,臺南市,仁德區,太子里,1189,1406,534,153,687,82,769
公投第８案,臺南市,仁德區,太子里,1190,1465,495,165,660,104,764
公投第８案,臺南市,仁德區,太子里,1191,1192,455,179,634,82,716
公投第８案,臺南市,仁德區,土庫里,1192,1429,561,188,749,73,822
公投第８案,臺南市,仁德區,土庫里,1193,1320,420,165,585,138,723
公投第８案,臺南市,仁德區,一甲里,1194,1373,564,147,711,112,823
公投第８案,臺南市,仁德區,一甲里,1195,1330,505,177,682,76,758
公投第８案,臺南市,仁德區,仁德里,1196,1687,677,203,880,36,916
公投第８案,臺南市,仁德區,仁德里,1197,1491,500,186,686,68,754
公投第８案,臺南市,仁德區,仁德里,1198,1151,364,129,493,45,538
公投第８案,臺南市,仁德區,仁德里,1199,1407,556,125,681,34,715
公投第８案,臺南市,仁德區,仁德里,1200,1465,594,166,760,66,826
公投第８案,臺南市,仁德區,仁義里,1201,1335,507,184,691,57,748
公投第８案,臺南市,仁德區,仁義里,1202,1490,535,177,712,69,781
公投第８案,臺南市,仁德區,仁義里,1203,1453,583,202,785,67,852
公投第８案,臺南市,仁德區,仁義里,1204,990,329,122,451,31,482
公投第８案,臺南市,仁德區,仁義里,1205,1573,598,210,808,75,883
公投第８案,臺南市,仁德區,仁義里,1206,1031,371,123,494,70,564
公投第８案,臺南市,仁德區,仁義里,1207,1194,407,172,579,40,619
公投第８案,臺南市,仁德區,新田里,1208,1268,455,137,592,57,649
公投第８案,臺南市,仁德區,新田里,1209,929,311,150,461,47,508
公投第８案,臺南市,仁德區,新田里,1210,1145,379,106,485,23,508
公投第８案,臺南市,仁德區,後壁里,1211,1413,463,173,636,69,705
公投第８案,臺南市,仁德區,後壁里,1212,1465,491,184,675,109,784
公投第８案,臺南市,仁德區,後壁里,1213,1390,538,197,735,60,795
公投第８案,臺南市,仁德區,後壁里,1214,1396,492,190,682,79,761
公投第８案,臺南市,仁德區,後壁里,1215,1906,687,237,924,68,992
公投第８案,臺南市,仁德區,後壁里,1216,1546,555,172,727,45,772
公投第８案,臺南市,仁德區,上崙里,1217,1546,462,165,627,41,668
公投第８案,臺南市,仁德區,上崙里,1218,1399,530,149,679,62,741
公投第８案,臺南市,仁德區,上崙里,1219,1748,617,190,807,114,921
公投第８案,臺南市,仁德區,上崙里,1220,1140,458,138,596,44,640
公投第８案,臺南市,仁德區,文賢里,1221,1277,431,136,567,31,598
公投第８案,臺南市,仁德區,文賢里,1222,1019,446,138,584,57,641
公投第８案,臺南市,仁德區,保安里,1223,1414,450,151,601,49,650
公投第８案,臺南市,仁德區,保安里,1224,1349,425,142,567,36,603
公投第８案,臺南市,仁德區,成功里,1225,1471,494,167,661,41,702
公投第８案,臺南市,仁德區,成功里,1226,1324,476,142,618,28,646
公投第８案,臺南市,仁德區,成功里,1227,1310,470,104,574,54,628
公投第８案,臺南市,仁德區,成功里,1228,554,207,76,283,28,311
公投第８案,臺南市,仁德區,仁和里,1229,1395,590,105,695,53,748
公投第８案,臺南市,仁德區,仁愛里,1230,1264,486,107,593,22,615
公投第８案,臺南市,仁德區,二行里,1231,1180,391,122,513,101,614
公投第８案,臺南市,仁德區,二行里,1232,928,270,92,362,44,406
公投第８案,臺南市,仁德區,大甲里,1233,965,286,100,386,31,417
公投第８案,臺南市,仁德區,大甲里,1234,1119,352,114,466,35,501
公投第８案,臺南市,仁德區,中洲里,1235,1206,430,128,558,88,646
公投第８案,臺南市,仁德區,中洲里,1236,1466,424,154,578,63,641
公投第８案,臺南市,歸仁區,南保里,1237,1560,539,176,715,79,794
公投第８案,臺南市,歸仁區,南保里,1238,1383,537,222,759,75,834
公投第８案,臺南市,歸仁區,南保里,1239,1491,528,191,719,48,767
公投第８案,臺南市,歸仁區,南保里,1240,1482,458,187,645,78,723
公投第８案,臺南市,歸仁區,南興里,1241,1330,472,166,638,36,674
公投第８案,臺南市,歸仁區,南興里,1242,1399,538,192,730,52,782
公投第８案,臺南市,歸仁區,南興里,1243,1416,479,163,642,33,675
公投第８案,臺南市,歸仁區,六甲里,1244,1336,368,147,515,44,559
公投第８案,臺南市,歸仁區,六甲里,1245,1183,371,135,506,79,585
公投第８案,臺南市,歸仁區,六甲里,1246,1237,395,137,532,28,560
公投第８案,臺南市,歸仁區,歸南里,1247,1133,414,146,560,74,634
公投第８案,臺南市,歸仁區,歸南里,1248,1149,393,132,525,45,570
公投第８案,臺南市,歸仁區,後市里,1249,1105,397,151,548,8,556
公投第８案,臺南市,歸仁區,後市里,1250,1099,388,150,538,62,600
公投第８案,臺南市,歸仁區,後市里,1251,1082,403,151,554,75,629
公投第８案,臺南市,歸仁區,文化里,1252,1519,550,184,734,54,788
公投第８案,臺南市,歸仁區,文化里,1253,1467,565,194,759,78,837
公投第８案,臺南市,歸仁區,辜厝里,1254,1090,372,148,520,50,570
公投第８案,臺南市,歸仁區,辜厝里,1255,1131,393,115,508,39,547
公投第８案,臺南市,歸仁區,辜厝里,1256,1080,370,103,473,36,509
公投第８案,臺南市,歸仁區,新厝里,1257,1121,355,106,461,26,487
公投第８案,臺南市,歸仁區,新厝里,1258,1336,461,165,626,94,720
公投第８案,臺南市,歸仁區,許厝里,1259,1128,385,156,541,73,614
公投第８案,臺南市,歸仁區,許厝里,1260,1055,361,135,496,31,527
公投第８案,臺南市,歸仁區,許厝里,1261,1102,407,131,538,39,577
公投第８案,臺南市,歸仁區,看西里,1262,1068,405,125,530,49,579
公投第８案,臺南市,歸仁區,看西里,1263,1033,367,151,518,74,592
公投第８案,臺南市,歸仁區,看東里,1264,1772,490,145,635,34,669
公投第８案,臺南市,歸仁區,崙頂里,1265,1399,498,188,686,77,763
公投第８案,臺南市,歸仁區,崙頂里,1266,1544,551,183,734,31,765
公投第８案,臺南市,歸仁區,沙崙里,1267,684,185,92,277,11,288
公投第８案,臺南市,歸仁區,大潭里,1268,839,313,129,442,45,487
公投第８案,臺南市,歸仁區,大潭里,1269,1014,373,144,517,66,583
公投第８案,臺南市,歸仁區,武東里,1270,1906,487,167,654,38,692
公投第８案,臺南市,歸仁區,歸仁里,1271,1245,467,164,631,79,710
公投第８案,臺南市,歸仁區,歸仁里,1272,1048,377,137,514,42,556
公投第８案,臺南市,歸仁區,八甲里,1273,1175,402,135,537,27,564
公投第８案,臺南市,歸仁區,八甲里,1274,1411,441,156,597,39,636
公投第８案,臺南市,歸仁區,七甲里,1275,1514,600,196,796,56,852
公投第８案,臺南市,歸仁區,七甲里,1276,1678,625,201,826,75,901
公投第８案,臺南市,歸仁區,媽廟里,1277,949,364,106,470,37,507
公投第８案,臺南市,歸仁區,媽廟里,1278,1009,376,149,525,69,594
公投第８案,臺南市,歸仁區,西埔里,1279,984,407,163,570,4,574
公投第８案,臺南市,歸仁區,西埔里,1280,756,292,105,397,47,444
公投第８案,臺南市,歸仁區,大廟里,1281,1478,603,198,801,71,872
公投第８案,臺南市,歸仁區,大廟里,1282,1467,597,196,793,81,874
公投第８案,臺南市,關廟區,關廟里,1283,982,319,131,450,34,484
公投第８案,臺南市,關廟區,關廟里,1284,1156,452,157,609,53,662
公投第８案,臺南市,關廟區,山西里,1285,1006,316,112,428,34,462
公投第８案,臺南市,關廟區,山西里,1286,1043,382,182,564,66,630
公投第８案,臺南市,關廟區,香洋里,1287,1012,362,127,489,92,581
公投第８案,臺南市,關廟區,香洋里,1288,1013,303,106,409,25,434
公投第８案,臺南市,關廟區,香洋里,1289,1294,459,141,600,42,642
公投第８案,臺南市,關廟區,北勢里,1290,1264,421,151,572,43,615
公投第８案,臺南市,關廟區,北勢里,1291,1166,387,160,547,44,591
公投第８案,臺南市,關廟區,新埔里,1292,1018,347,113,460,1,461
公投第８案,臺南市,關廟區,新光里,1293,733,219,76,295,46,341
公投第８案,臺南市,關廟區,五甲里,1294,1093,426,142,568,37,605
公投第８案,臺南市,關廟區,五甲里,1295,1081,436,99,535,31,566
公投第８案,臺南市,關廟區,五甲里,1296,978,381,139,520,49,569
公投第８案,臺南市,關廟區,東勢里,1297,1116,342,128,470,30,500
公投第８案,臺南市,關廟區,東勢里,1298,972,347,113,460,58,518
公投第８案,臺南市,關廟區,東勢里,1299,1045,351,153,504,97,601
公投第８案,臺南市,關廟區,松腳里,1300,872,319,106,425,33,458
公投第８案,臺南市,關廟區,松腳里,1301,1007,381,137,518,50,568
公投第８案,臺南市,關廟區,花園里,1302,763,271,123,394,61,455
公投第８案,臺南市,關廟區,花園里,1303,630,222,72,294,40,334
公投第８案,臺南市,關廟區,花園里,1304,959,346,142,488,63,551
公投第８案,臺南市,關廟區,花園里,1305,1123,405,116,521,37,558
公投第８案,臺南市,關廟區,深坑里,1306,804,283,106,389,67,456
公投第８案,臺南市,關廟區,深坑里,1307,720,237,83,320,17,337
公投第８案,臺南市,關廟區,布袋里,1308,843,267,62,329,20,349
公投第８案,臺南市,關廟區,布袋里,1309,358,113,42,155,12,167
公投第８案,臺南市,關廟區,南雄里,1310,797,276,87,363,62,425
公投第８案,臺南市,關廟區,南雄里,1311,709,215,67,282,14,296
公投第８案,臺南市,關廟區,埤頭里,1312,904,290,91,381,22,403
公投第８案,臺南市,關廟區,埤頭里,1313,963,326,108,434,29,463
公投第８案,臺南市,關廟區,下湖里,1314,489,169,65,234,6,240
公投第８案,臺南市,龍崎區,崎頂里,1315,1047,336,124,460,71,531
公投第８案,臺南市,龍崎區,土崎里,1316,630,184,61,245,26,271
公投第８案,臺南市,龍崎區,中坑里,1317,141,37,9,46,3,49
公投第８案,臺南市,龍崎區,楠坑里,1318,367,111,47,158,16,174
公投第８案,臺南市,龍崎區,牛埔里,1319,337,119,29,148,12,160
公投第８案,臺南市,龍崎區,大坪里,1320,318,88,30,118,7,125
公投第８案,臺南市,龍崎區,龍船里,1321,427,155,30,185,28,213
公投第８案,臺南市,龍崎區,石𥕢里,1322,446,107,47,154,21,175
公投第８案,桃園市,桃園區,大林里,1,1593,563,180,743,61,804
公投第８案,桃園市,桃園區,大林里,2,1934,599,197,796,40,836
公投第８案,桃園市,桃園區,大林里,3,1661,644,191,835,73,908
公投第８案,桃園市,桃園區,大林里,4,1448,504,121,625,33,658
公投第８案,桃園市,桃園區,大樹里,5,1974,678,211,889,53,942
公投第８案,桃園市,桃園區,大樹里,6,1882,582,194,776,86,862
公投第８案,桃園市,桃園區,大豐里,7,1800,605,211,816,61,877
公投第８案,桃園市,桃園區,大豐里,8,1598,630,184,814,58,872
公投第８案,桃園市,桃園區,大豐里,9,1626,497,181,678,92,770
公投第８案,桃園市,桃園區,建國里,10,1590,540,169,709,54,763
公投第８案,桃園市,桃園區,建國里,11,1637,552,210,762,69,831
公投第８案,桃園市,桃園區,建國里,12,1943,636,235,871,72,943
公投第８案,桃園市,桃園區,雲林里,13,1482,547,183,730,43,773
公投第８案,桃園市,桃園區,雲林里,14,1423,552,168,720,55,775
公投第８案,桃園市,桃園區,雲林里,15,1509,580,177,757,53,810
公投第８案,桃園市,桃園區,雲林里,16,1567,640,161,801,49,850
公投第８案,桃園市,桃園區,福安里,17,1305,512,147,659,51,710
公投第８案,桃園市,桃園區,福安里,18,1416,496,137,633,48,681
公投第８案,桃園市,桃園區,福安里,19,1439,570,201,771,38,809
公投第８案,桃園市,桃園區,福林里,20,1399,508,212,720,63,783
公投第８案,桃園市,桃園區,福林里,21,1540,610,191,801,58,859
公投第８案,桃園市,桃園區,福林里,22,1638,593,160,753,48,801
公投第８案,桃園市,桃園區,福林里,23,1228,485,131,616,46,662
公投第８案,桃園市,桃園區,豐林里,24,1649,576,178,754,75,829
公投第８案,桃園市,桃園區,豐林里,25,1601,606,174,780,52,832
公投第８案,桃園市,桃園區,豐林里,26,1477,500,151,651,87,738
公投第８案,桃園市,桃園區,豐林里,27,1503,578,165,743,37,780
公投第８案,桃園市,桃園區,中和里,28,1375,516,190,706,82,788
公投第８案,桃園市,桃園區,中興里,29,1743,644,238,882,55,937
公投第８案,桃園市,桃園區,中興里,30,1862,628,207,835,74,909
公投第８案,桃園市,桃園區,中興里,31,1728,625,215,840,64,904
公投第８案,桃園市,桃園區,文化里,32,690,251,93,344,17,361
公投第８案,桃園市,桃園區,文昌里,33,852,343,132,475,41,516
公投第８案,桃園市,桃園區,文明里,34,1353,524,192,716,68,784
公投第８案,桃園市,桃園區,北門里,35,1698,494,100,594,37,631
公投第８案,桃園市,桃園區,民生里,36,1452,489,188,677,66,743
公投第８案,桃園市,桃園區,永興里,37,1681,586,218,804,69,873
公投第８案,桃園市,桃園區,光興里,38,1669,564,215,779,75,854
公投第８案,桃園市,桃園區,光興里,39,1530,574,208,782,58,840
公投第８案,桃園市,桃園區,光興里,40,1582,587,205,792,62,854
公投第８案,桃園市,桃園區,西門里,41,1587,539,181,720,44,764
公投第８案,桃園市,桃園區,西湖里,42,1451,540,187,727,71,798
公投第８案,桃園市,桃園區,武陵里,43,1582,486,185,671,48,719
公投第８案,桃園市,桃園區,長美里,44,1028,371,161,532,45,577
公投第８案,桃園市,桃園區,南門里,45,1934,691,194,885,79,964
公投第８案,桃園市,桃園區,南門里,46,1016,388,109,497,56,553
公投第８案,桃園市,桃園區,南門里,47,1079,396,150,546,32,578
公投第８案,桃園市,桃園區,南門里,48,1837,630,215,845,42,887
公投第８案,桃園市,桃園區,南華里,49,1390,488,196,684,68,752
公投第８案,桃園市,桃園區,中山里,50,1489,596,154,750,41,791
公投第８案,桃園市,桃園區,中山里,51,1821,720,246,966,35,1001
公投第８案,桃園市,桃園區,中山里,52,1563,532,172,704,24,728
公投第８案,桃園市,桃園區,中山里,53,1697,662,210,872,38,910
公投第８案,桃園市,桃園區,中平里,54,1740,705,181,886,52,938
公投第８案,桃園市,桃園區,中平里,55,1626,621,172,793,55,848
公投第８案,桃園市,桃園區,中平里,56,1239,521,135,656,19,675
公投第８案,桃園市,桃園區,中正里,57,1766,766,178,944,50,994
公投第８案,桃園市,桃園區,中正里,58,1555,561,209,770,62,832
公投第８案,桃園市,桃園區,中正里,59,1831,696,209,905,53,958
公投第８案,桃園市,桃園區,中成里,60,1115,480,138,618,47,665
公投第８案,桃園市,桃園區,中成里,61,1562,568,234,802,57,859
公投第８案,桃園市,桃園區,中成里,62,1744,663,194,857,38,895
公投第８案,桃園市,桃園區,中信里,63,1838,614,201,815,43,858
公投第８案,桃園市,桃園區,中信里,64,1889,705,232,937,87,1024
公投第８案,桃園市,桃園區,中信里,65,1985,681,194,875,62,937
公投第８案,桃園市,桃園區,中原里,66,1524,646,179,825,49,874
公投第８案,桃園市,桃園區,中原里,67,1425,655,170,825,51,876
公投第８案,桃園市,桃園區,中原里,68,1606,682,184,866,50,916
公投第８案,桃園市,桃園區,中泰里,69,2056,891,209,1100,33,1133
公投第８案,桃園市,桃園區,中泰里,70,2010,851,210,1061,47,1108
公投第８案,桃園市,桃園區,中聖里,71,2245,827,217,1044,61,1105
公投第８案,桃園市,桃園區,中聖里,72,1590,612,184,796,38,834
公投第８案,桃園市,桃園區,中聖里,73,1536,693,192,885,30,915
公投第８案,桃園市,桃園區,中路里,74,1949,644,234,878,63,941
公投第８案,桃園市,桃園區,中路里,75,1965,718,199,917,58,975
公投第８案,桃園市,桃園區,中德里,76,2414,814,198,1012,69,1081
公投第８案,桃園市,桃園區,中德里,77,1942,704,226,930,63,993
公投第８案,桃園市,桃園區,中德里,78,2156,806,231,1037,66,1103
公投第８案,桃園市,桃園區,文中里,79,1404,512,211,723,65,788
公投第８案,桃園市,桃園區,文中里,80,1194,520,150,670,29,699
公投第８案,桃園市,桃園區,玉山里,81,1449,537,208,745,82,827
公投第８案,桃園市,桃園區,玉山里,82,1803,595,195,790,80,870
公投第８案,桃園市,桃園區,玉山里,83,1692,614,218,832,66,898
公投第８案,桃園市,桃園區,泰山里,84,1913,702,230,932,57,989
公投第８案,桃園市,桃園區,泰山里,85,1815,664,222,886,66,952
公投第８案,桃園市,桃園區,龍山里,86,1173,396,143,539,48,587
公投第８案,桃園市,桃園區,龍山里,87,1162,434,95,529,25,554
公投第８案,桃園市,桃園區,龍山里,88,1194,373,112,485,68,553
公投第８案,桃園市,桃園區,龍安里,89,1695,624,214,838,63,901
公投第８案,桃園市,桃園區,龍安里,90,1797,640,206,846,58,904
公投第８案,桃園市,桃園區,龍安里,91,1592,622,160,782,34,816
公投第８案,桃園市,桃園區,龍岡里,92,1780,660,162,822,77,899
公投第８案,桃園市,桃園區,龍岡里,93,1904,651,173,824,42,866
公投第８案,桃園市,桃園區,龍岡里,94,2021,763,186,949,29,978
公投第８案,桃園市,桃園區,龍祥里,95,1545,586,158,744,49,793
公投第８案,桃園市,桃園區,龍祥里,96,1617,597,150,747,34,781
公投第８案,桃園市,桃園區,龍祥里,97,1683,647,162,809,41,850
公投第８案,桃園市,桃園區,龍壽里,98,1834,725,200,925,73,998
公投第８案,桃園市,桃園區,龍壽里,99,2055,694,204,898,58,956
公投第８案,桃園市,桃園區,龍壽里,100,1828,677,164,841,29,870
公投第８案,桃園市,桃園區,龍鳳里,101,1873,680,192,872,45,917
公投第８案,桃園市,桃園區,龍鳳里,102,3687,574,146,720,40,760
公投第８案,桃園市,桃園區,龍鳳里,103,1850,686,209,895,40,935
公投第８案,桃園市,桃園區,龍鳳里,104,1827,692,167,859,50,909
公投第８案,桃園市,桃園區,中埔里,105,1149,497,149,646,44,690
公投第８案,桃園市,桃園區,中埔里,106,1061,425,148,573,41,614
公投第８案,桃園市,桃園區,中寧里,107,1831,614,190,804,43,847
公投第８案,桃園市,桃園區,中寧里,108,2168,746,95,841,70,911
公投第８案,桃園市,桃園區,中寧里,109,1874,683,199,882,32,914
公投第８案,桃園市,桃園區,北埔里,110,1524,510,161,671,28,699
公投第８案,桃園市,桃園區,北埔里,111,1528,590,178,768,40,808
公投第８案,桃園市,桃園區,北埔里,112,1489,588,176,764,44,808
公投第８案,桃園市,桃園區,永安里,113,1308,450,157,607,73,680
公投第８案,桃園市,桃園區,永安里,114,1583,559,188,747,58,805
公投第８案,桃園市,桃園區,永安里,115,1618,583,232,815,67,882
公投第８案,桃園市,桃園區,同安里,116,2127,745,238,983,80,1063
公投第８案,桃園市,桃園區,同安里,117,2033,724,205,929,27,956
公投第８案,桃園市,桃園區,同安里,118,2098,788,215,1003,49,1052
公投第８案,桃園市,桃園區,同安里,119,2126,813,244,1057,87,1144
公投第８案,桃園市,桃園區,同德里,120,1917,814,86,900,50,950
公投第８案,桃園市,桃園區,同德里,121,1997,728,193,921,55,976
公投第８案,桃園市,桃園區,同德里,122,1929,765,192,957,53,1010
公投第８案,桃園市,桃園區,自強里,123,1691,619,195,814,43,857
公投第８案,桃園市,桃園區,自強里,124,1900,720,195,915,43,958
公投第８案,桃園市,桃園區,自強里,125,1761,662,196,858,76,934
公投第８案,桃園市,桃園區,自強里,126,1922,684,212,896,43,939
公投第８案,桃園市,桃園區,西埔里,127,1995,715,184,899,58,957
公投第８案,桃園市,桃園區,西埔里,128,1063,399,128,527,48,575
公投第８案,桃園市,桃園區,明德里,129,1412,541,129,670,63,733
公投第８案,桃園市,桃園區,明德里,130,1746,703,198,901,29,930
公投第８案,桃園市,桃園區,東埔里,131,1689,566,185,751,60,811
公投第８案,桃園市,桃園區,東埔里,132,1542,457,160,617,42,659
公投第８案,桃園市,桃園區,東埔里,133,1437,511,164,675,46,721
公投第８案,桃園市,桃園區,長安里,134,1679,578,192,770,52,822
公投第８案,桃園市,桃園區,長安里,135,1886,614,189,803,70,873
公投第８案,桃園市,桃園區,長德里,136,1657,634,188,822,67,889
公投第８案,桃園市,桃園區,長德里,137,1349,513,162,675,47,722
公投第８案,桃園市,桃園區,長德里,138,1805,696,199,895,44,939
公投第８案,桃園市,桃園區,信光里,139,1846,648,211,859,67,926
公投第８案,桃園市,桃園區,信光里,140,1644,552,170,722,50,772
公投第８案,桃園市,桃園區,信光里,141,1674,562,175,737,63,800
公投第８案,桃園市,桃園區,信光里,142,1737,631,204,835,49,884
公投第８案,桃園市,桃園區,南埔里,143,1566,571,200,771,59,830
公投第８案,桃園市,桃園區,南埔里,144,1517,608,161,769,40,809
公投第８案,桃園市,桃園區,南埔里,145,1619,534,169,703,37,740
公投第８案,桃園市,桃園區,莊敬里,146,1774,653,199,852,52,904
公投第８案,桃園市,桃園區,莊敬里,147,1666,663,163,826,37,863
公投第８案,桃園市,桃園區,莊敬里,148,1528,588,179,767,26,793
公投第８案,桃園市,桃園區,莊敬里,149,1709,590,218,808,58,866
公投第８案,桃園市,桃園區,莊敬里,150,1719,558,267,825,33,858
公投第８案,桃園市,桃園區,慈文里,151,1569,508,162,670,53,723
公投第８案,桃園市,桃園區,慈文里,152,1505,542,156,698,45,743
公投第８案,桃園市,桃園區,慈文里,153,1496,523,174,697,58,755
公投第８案,桃園市,桃園區,慈文里,154,1505,593,155,748,54,802
公投第８案,桃園市,桃園區,新埔里,155,1807,680,180,860,49,909
公投第８案,桃園市,桃園區,新埔里,156,1857,714,193,907,41,948
公投第８案,桃園市,桃園區,新埔里,157,1589,628,195,823,70,893
公投第８案,桃園市,桃園區,新埔里,158,2088,753,243,996,45,1041
公投第８案,桃園市,桃園區,新埔里,159,1893,708,195,903,44,947
公投第８案,桃園市,桃園區,瑞慶里,160,1303,423,128,551,40,591
公投第８案,桃園市,桃園區,瑞慶里,161,1416,536,173,709,46,755
公投第８案,桃園市,桃園區,瑞慶里,162,1351,481,139,620,41,661
公投第８案,桃園市,桃園區,瑞慶里,163,1659,589,172,761,43,804
公投第８案,桃園市,桃園區,寶安里,164,2103,773,188,961,55,1016
公投第８案,桃園市,桃園區,寶安里,165,1943,763,153,916,43,959
公投第８案,桃園市,桃園區,寶安里,166,1927,701,210,911,64,975
公投第８案,桃園市,桃園區,寶安里,167,1929,633,172,805,54,859
公投第８案,桃園市,桃園區,寶慶里,168,2204,944,241,1185,50,1235
公投第８案,桃園市,桃園區,寶慶里,169,2033,651,236,887,43,930
公投第８案,桃園市,桃園區,寶慶里,170,1656,662,157,819,23,842
公投第８案,桃園市,桃園區,三元里,171,1712,588,198,786,58,844
公投第８案,桃園市,桃園區,三元里,172,1738,627,190,817,56,873
公投第８案,桃園市,桃園區,三民里,173,1432,667,161,828,29,857
公投第８案,桃園市,桃園區,三民里,174,1421,612,153,765,50,815
公投第８案,桃園市,桃園區,三民里,175,1344,504,161,665,27,692
公投第８案,桃園市,桃園區,大有里,176,1942,663,194,857,44,901
公投第８案,桃園市,桃園區,大有里,177,2001,738,202,940,61,1001
公投第８案,桃園市,桃園區,大有里,178,1941,668,164,832,33,865
公投第８案,桃園市,桃園區,大業里,179,1702,636,207,843,47,890
公投第８案,桃園市,桃園區,大業里,180,1589,596,180,776,45,821
公投第８案,桃園市,桃園區,大業里,181,1544,592,153,745,37,782
公投第８案,桃園市,桃園區,大興里,182,1860,557,173,730,46,776
公投第８案,桃園市,桃園區,大興里,183,1726,623,176,799,68,867
公投第８案,桃園市,桃園區,大興里,184,1798,606,214,820,47,867
公投第８案,桃園市,桃園區,成功里,185,1925,689,234,923,34,957
公投第８案,桃園市,桃園區,成功里,186,1945,653,247,900,47,947
公投第８案,桃園市,桃園區,汴洲里,187,1764,463,302,765,59,824
公投第８案,桃園市,桃園區,汴洲里,188,1899,750,205,955,78,1033
公投第８案,桃園市,桃園區,汴洲里,189,1415,540,155,695,20,715
公投第８案,桃園市,桃園區,忠義里,190,1790,635,172,807,44,851
公投第８案,桃園市,桃園區,忠義里,191,1693,578,184,762,34,796
公投第８案,桃園市,桃園區,東山里,192,1916,639,121,760,54,814
公投第８案,桃園市,桃園區,東門里,193,1434,473,154,627,33,660
公投第８案,桃園市,桃園區,東門里,194,1494,586,197,783,47,830
公投第８案,桃園市,桃園區,青溪里,195,1311,475,173,648,70,718
公投第８案,桃園市,桃園區,青溪里,196,1476,519,194,713,52,765
公投第８案,桃園市,桃園區,青溪里,197,1484,562,209,771,55,826
公投第８案,桃園市,桃園區,春日里,198,1514,543,175,718,50,768
公投第８案,桃園市,桃園區,春日里,199,1446,534,151,685,70,755
公投第８案,桃園市,桃園區,春日里,200,1573,533,175,708,23,731
公投第８案,桃園市,桃園區,春日里,201,1564,523,152,675,47,722
公投第８案,桃園市,桃園區,朝陽里,202,1015,391,130,521,50,571
公投第８案,桃園市,桃園區,朝陽里,203,955,320,121,441,36,477
公投第８案,桃園市,桃園區,會稽里,204,1796,670,172,842,51,893
公投第８案,桃園市,桃園區,會稽里,205,1878,700,177,877,29,906
公投第８案,桃園市,桃園區,會稽里,206,1729,613,194,807,38,845
公投第８案,桃園市,桃園區,會稽里,207,1843,625,160,785,29,814
公投第８案,桃園市,桃園區,會稽里,208,1817,600,142,742,38,780
公投第８案,桃園市,桃園區,萬壽里,209,979,371,140,511,42,553
公投第８案,桃園市,桃園區,福元里,210,1363,536,174,710,40,750
公投第８案,桃園市,桃園區,福元里,211,1546,588,157,745,21,766
公投第８案,桃園市,桃園區,福元里,212,1308,487,137,624,33,657
公投第８案,桃園市,桃園區,寶山里,213,2164,770,237,1007,62,1069
公投第８案,桃園市,桃園區,寶山里,214,2020,684,230,914,59,973
公投第８案,桃園市,桃園區,寶山里,215,1924,646,157,803,50,853
公投第８案,桃園市,桃園區,寶山里,216,2088,688,161,849,52,901
公投第８案,桃園市,龜山區,精忠里,217,874,398,56,454,25,479
公投第８案,桃園市,龜山區,精忠里,218,2014,821,177,998,83,1081
公投第８案,桃園市,龜山區,精忠里,219,2145,760,235,995,38,1033
公投第８案,桃園市,龜山區,陸光里,220,1744,771,109,880,65,945
公投第８案,桃園市,龜山區,陸光里,221,1885,795,158,953,63,1016
公投第８案,桃園市,龜山區,中興里,222,1546,355,340,695,59,754
公投第８案,桃園市,龜山區,中興里,223,1684,577,190,767,72,839
公投第８案,桃園市,龜山區,中興里,224,1477,448,169,617,39,656
公投第８案,桃園市,龜山區,新興里,225,1528,660,139,799,55,854
公投第８案,桃園市,龜山區,新興里,226,1428,207,68,275,16,291
公投第８案,桃園市,龜山區,新路里,227,1525,570,196,766,66,832
公投第８案,桃園市,龜山區,新路里,228,1041,412,135,547,60,607
公投第８案,桃園市,龜山區,新路里,229,1404,473,176,649,34,683
公投第８案,桃園市,龜山區,新路里,230,1478,554,189,743,69,812
公投第８案,桃園市,龜山區,龜山里,231,2178,794,250,1044,65,1109
公投第８案,桃園市,龜山區,龜山里,232,1672,595,215,810,87,897
公投第８案,桃園市,龜山區,龜山里,233,1376,487,141,628,44,672
公投第８案,桃園市,龜山區,龜山里,234,1480,499,192,691,57,748
公投第８案,桃園市,龜山區,大同里,235,1258,482,153,635,49,684
公投第８案,桃園市,龜山區,大同里,236,1464,559,161,720,32,752
公投第８案,桃園市,龜山區,大同里,237,1844,638,193,831,102,933
公投第８案,桃園市,龜山區,大同里,238,1169,443,134,577,27,604
公投第８案,桃園市,龜山區,山頂里,239,1921,536,166,702,32,734
公投第８案,桃園市,龜山區,山頂里,240,1694,576,183,759,32,791
公投第８案,桃園市,龜山區,山頂里,241,1771,703,212,915,66,981
公投第８案,桃園市,龜山區,山德里,242,1665,551,170,721,65,786
公投第８案,桃園市,龜山區,山德里,243,1439,466,179,645,75,720
公投第８案,桃園市,龜山區,山德里,244,1728,534,180,714,70,784
公投第８案,桃園市,龜山區,山福里,245,1788,668,184,852,55,907
公投第８案,桃園市,龜山區,山福里,246,1465,486,152,638,60,698
公投第８案,桃園市,龜山區,幸福里,247,1659,493,148,641,46,687
公投第８案,桃園市,龜山區,幸福里,248,1693,539,147,686,39,725
公投第８案,桃園市,龜山區,幸福里,249,1818,501,147,648,20,668
公投第８案,桃園市,龜山區,龍壽里,250,1752,568,234,802,79,881
公投第８案,桃園市,龜山區,龍華里,251,1818,605,240,845,43,888
公投第８案,桃園市,龜山區,龍華里,252,1499,555,175,730,26,756
公投第８案,桃園市,龜山區,迴龍里,253,1916,664,220,884,61,945
公投第８案,桃園市,龜山區,迴龍里,254,1804,619,214,833,57,890
公投第８案,桃園市,龜山區,迴龍里,255,2127,699,243,942,46,988
公投第８案,桃園市,龜山區,嶺頂里,256,1005,326,145,471,64,535
公投第８案,桃園市,龜山區,嶺頂里,257,1449,575,148,723,36,759
公投第８案,桃園市,龜山區,嶺頂里,258,1498,484,173,657,62,719
公投第８案,桃園市,龜山區,新嶺里,259,2149,669,225,894,63,957
公投第８案,桃園市,龜山區,新嶺里,260,1771,485,128,613,42,655
公投第８案,桃園市,龜山區,兔坑里,261,841,294,103,397,32,429
公投第８案,桃園市,龜山區,兔坑里,262,2284,723,257,980,66,1046
公投第８案,桃園市,龜山區,兔坑里,263,1228,412,166,578,72,650
公投第８案,桃園市,龜山區,福源里,264,1979,638,187,825,52,877
公投第８案,桃園市,龜山區,舊路里,265,1378,457,129,586,38,624
公投第８案,桃園市,龜山區,舊路里,266,1061,361,129,490,42,532
公投第８案,桃園市,龜山區,大坑里,267,1917,651,192,843,56,899
公投第８案,桃園市,龜山區,楓福里,268,1540,687,170,857,46,903
公投第８案,桃園市,龜山區,楓福里,269,1433,589,151,740,34,774
公投第８案,桃園市,龜山區,楓樹里,270,1455,505,177,682,39,721
公投第８案,桃園市,龜山區,楓樹里,271,2280,867,278,1145,70,1215
公投第８案,桃園市,龜山區,樂善里,272,1668,594,199,793,48,841
公投第８案,桃園市,龜山區,樂善里,273,1885,624,221,845,47,892
公投第８案,桃園市,龜山區,長庚里,274,1849,628,239,867,37,904
公投第８案,桃園市,龜山區,長庚里,275,1704,643,264,907,35,942
公投第８案,桃園市,龜山區,公西里,276,1156,416,152,568,47,615
公投第８案,桃園市,龜山區,大崗里,277,2114,635,181,816,69,885
公投第８案,桃園市,龜山區,大崗里,278,1943,592,193,785,35,820
公投第８案,桃園市,龜山區,大湖里,279,1800,597,198,795,39,834
公投第８案,桃園市,龜山區,大湖里,280,2020,673,241,914,57,971
公投第８案,桃園市,龜山區,大湖里,281,1319,554,135,689,43,732
公投第８案,桃園市,龜山區,大華里,282,2229,852,267,1119,48,1167
公投第８案,桃園市,龜山區,大華里,283,1992,702,238,940,26,966
公投第８案,桃園市,龜山區,大華里,284,2237,749,236,985,71,1056
公投第８案,桃園市,龜山區,大華里,285,2133,775,209,984,44,1028
公投第８案,桃園市,龜山區,文化里,286,2187,788,256,1044,62,1106
公投第８案,桃園市,龜山區,文化里,287,1959,689,208,897,59,956
公投第８案,桃園市,龜山區,文化里,288,1910,597,228,825,41,866
公投第８案,桃園市,龜山區,南上里,289,1840,626,252,878,100,978
公投第８案,桃園市,龜山區,南美里,290,2266,815,257,1072,55,1127
公投第８案,桃園市,龜山區,文青里,291,2387,826,203,1029,31,1060
公投第８案,桃園市,龜山區,文青里,292,1692,570,177,747,35,782
公投第８案,桃園市,龜山區,文青里,293,904,334,104,438,21,459
公投第８案,桃園市,龜山區,文青里,294,1469,600,156,756,26,782
公投第８案,桃園市,八德區,興仁里,295,1761,583,164,747,89,836
公投第８案,桃園市,八德區,興仁里,296,1804,520,173,693,24,717
公投第８案,桃園市,八德區,興仁里,297,1813,364,120,484,37,521
公投第８案,桃園市,八德區,興仁里,298,1784,614,153,767,42,809
公投第８案,桃園市,八德區,福興里,299,2257,718,166,884,59,943
公投第８案,桃園市,八德區,福興里,300,1857,549,163,712,34,746
公投第８案,桃園市,八德區,福興里,301,2261,742,205,947,53,1000
公投第８案,桃園市,八德區,福興里,302,1903,716,183,899,76,975
公投第８案,桃園市,八德區,瑞豐里,303,1955,721,190,911,71,982
公投第８案,桃園市,八德區,瑞豐里,304,1665,534,157,691,14,705
公投第８案,桃園市,八德區,瑞興里,305,1431,538,171,709,72,781
公投第８案,桃園市,八德區,瑞興里,306,1263,490,152,642,41,683
公投第８案,桃園市,八德區,瑞泰里,307,1583,614,190,804,80,884
公投第８案,桃園市,八德區,瑞泰里,308,1246,490,147,637,47,684
公投第８案,桃園市,八德區,瑞泰里,309,1356,532,152,684,40,724
公投第８案,桃園市,八德區,瑞發里,310,1630,639,172,811,83,894
公投第８案,桃園市,八德區,瑞發里,311,1586,556,141,697,38,735
公投第８案,桃園市,八德區,瑞德里,312,1649,599,191,790,75,865
公投第８案,桃園市,八德區,瑞德里,313,1910,612,181,793,99,892
公投第８案,桃園市,八德區,瑞祥里,314,1612,624,183,807,85,892
公投第８案,桃園市,八德區,瑞祥里,315,1640,671,137,808,48,856
公投第８案,桃園市,八德區,廣德里,316,1303,445,165,610,54,664
公投第８案,桃園市,八德區,廣德里,317,1413,600,149,749,53,802
公投第８案,桃園市,八德區,廣興里,318,1711,583,219,802,63,865
公投第８案,桃園市,八德區,廣興里,319,1562,608,148,756,82,838
公投第８案,桃園市,八德區,廣隆里,320,1735,657,166,823,59,882
公投第８案,桃園市,八德區,廣隆里,321,1658,631,172,803,41,844
公投第８案,桃園市,八德區,廣隆里,322,1022,423,138,561,49,610
公投第８案,桃園市,八德區,竹園里,323,1673,545,172,717,55,772
公投第８案,桃園市,八德區,竹園里,324,1741,623,167,790,41,831
公投第８案,桃園市,八德區,霄裡里,325,2110,774,213,987,80,1067
公投第８案,桃園市,八德區,龍友里,326,1145,486,91,577,30,607
公投第８案,桃園市,八德區,龍友里,327,1010,463,86,549,38,587
公投第８案,桃園市,八德區,茄明里,328,1848,587,178,765,26,791
公投第８案,桃園市,八德區,茄明里,329,1334,516,154,670,50,720
公投第８案,桃園市,八德區,茄明里,330,1349,426,119,545,34,579
公投第８案,桃園市,八德區,茄苳里,331,1341,552,162,714,46,760
公投第８案,桃園市,八德區,茄苳里,332,1178,476,141,617,61,678
公投第８案,桃園市,八德區,永豐里,333,1374,529,162,691,46,737
公投第８案,桃園市,八德區,永豐里,334,1462,468,192,660,76,736
公投第８案,桃園市,八德區,高明里,335,1943,598,177,775,65,840
公投第８案,桃園市,八德區,高明里,336,1928,493,275,768,94,862
公投第８案,桃園市,八德區,高城里,337,1403,447,150,597,37,634
公投第８案,桃園市,八德區,高城里,338,1672,544,185,729,70,799
公投第８案,桃園市,八德區,白鷺里,339,1947,630,210,840,44,884
公投第８案,桃園市,八德區,白鷺里,340,1200,460,153,613,47,660
公投第８案,桃園市,八德區,大湳里,341,1895,603,205,808,85,893
公投第８案,桃園市,八德區,大湳里,342,1988,651,197,848,67,915
公投第８案,桃園市,八德區,大發里,343,2006,729,231,960,83,1043
公投第８案,桃園市,八德區,大仁里,344,2061,667,222,889,13,902
公投第８案,桃園市,八德區,大仁里,345,2108,647,245,892,74,966
公投第８案,桃園市,八德區,大明里,346,1862,728,101,829,60,889
公投第８案,桃園市,八德區,大明里,347,1681,620,174,794,29,823
公投第８案,桃園市,八德區,大安里,348,1317,486,160,646,65,711
公投第８案,桃園市,八德區,大安里,349,2093,842,243,1085,77,1162
公投第８案,桃園市,八德區,大竹里,350,1499,570,209,779,70,849
公投第８案,桃園市,八德區,大興里,351,1782,643,196,839,65,904
公投第８案,桃園市,八德區,大興里,352,1763,697,168,865,34,899
公投第８案,桃園市,八德區,大愛里,353,1226,456,152,608,59,667
公投第８案,桃園市,八德區,大愛里,354,1311,527,153,680,40,720
公投第８案,桃園市,八德區,大華里,355,1170,477,141,618,46,664
公投第８案,桃園市,八德區,大華里,356,1313,545,127,672,39,711
公投第８案,桃園市,八德區,大順里,357,1186,492,122,614,32,646
公投第８案,桃園市,八德區,大順里,358,1481,512,159,671,50,721
公投第８案,桃園市,八德區,大和里,359,1998,749,207,956,69,1025
公投第８案,桃園市,八德區,大和里,360,916,368,110,478,31,509
公投第８案,桃園市,八德區,大和里,361,1943,706,168,874,54,928
公投第８案,桃園市,八德區,大和里,362,2076,785,160,945,44,989
公投第８案,桃園市,八德區,大昌里,363,1363,502,155,657,69,726
公投第８案,桃園市,八德區,大昌里,364,1491,535,186,721,60,781
公投第８案,桃園市,八德區,大信里,365,1474,507,172,679,75,754
公投第８案,桃園市,八德區,大信里,366,718,131,22,153,22,175
公投第８案,桃園市,八德區,大信里,367,1386,506,168,674,56,730
公投第８案,桃園市,八德區,陸光里,368,1487,557,142,699,72,771
公投第８案,桃園市,八德區,陸光里,369,1552,623,109,732,80,812
公投第８案,桃園市,八德區,陸光里,370,1255,471,88,559,55,614
公投第８案,桃園市,八德區,大同里,371,1505,618,150,768,70,838
公投第８案,桃園市,八德區,大慶里,372,1436,464,163,627,74,701
公投第８案,桃園市,八德區,大成里,373,1618,579,223,802,74,876
公投第８案,桃園市,八德區,大成里,374,1685,616,166,782,66,848
公投第８案,桃園市,八德區,大義里,375,1835,641,143,784,63,847
公投第８案,桃園市,八德區,大義里,376,1881,692,180,872,76,948
公投第８案,桃園市,八德區,大忠里,377,1766,607,174,781,54,835
公投第８案,桃園市,八德區,大智里,378,1817,655,172,827,93,920
公投第８案,桃園市,八德區,大智里,379,2198,885,189,1074,45,1119
公投第８案,桃園市,八德區,大宏里,380,1732,651,182,833,69,902
公投第８案,桃園市,八德區,大宏里,381,2089,821,213,1034,36,1070
公投第８案,桃園市,八德區,大正里,382,1257,488,151,639,35,674
公投第８案,桃園市,八德區,大正里,383,1267,441,146,587,69,656
公投第８案,桃園市,八德區,大正里,384,1427,613,127,740,23,763
公投第８案,桃園市,八德區,大福里,385,1685,709,204,913,59,972
公投第８案,桃園市,八德區,大福里,386,1748,684,204,888,56,944
公投第８案,桃園市,八德區,大福里,387,1650,870,189,1059,66,1125
公投第８案,桃園市,八德區,大強里,388,1478,558,190,748,53,801
公投第８案,桃園市,八德區,大強里,389,1607,624,167,791,68,859
公投第８案,桃園市,八德區,大勇里,390,1841,727,209,936,82,1018
公投第８案,桃園市,八德區,大勇里,391,2082,753,218,971,79,1050
公投第８案,桃園市,八德區,大榮里,392,1959,646,188,834,64,898
公投第８案,桃園市,八德區,大千里,393,2209,823,247,1070,60,1130
公投第８案,桃園市,八德區,大漢里,394,1864,759,158,917,56,973
公投第８案,桃園市,八德區,大漢里,395,2000,687,215,902,67,969
公投第８案,桃園市,蘆竹區,新興里,396,1358,428,184,612,89,701
公投第８案,桃園市,蘆竹區,新興里,397,1538,465,205,670,100,770
公投第８案,桃園市,蘆竹區,中福里,398,2118,617,205,822,73,895
公投第８案,桃園市,蘆竹區,中福里,399,1673,639,209,848,77,925
公投第８案,桃園市,蘆竹區,上興里,400,1500,569,183,752,30,782
公投第８案,桃園市,蘆竹區,上興里,401,1699,645,199,844,61,905
公投第８案,桃園市,蘆竹區,中興里,402,2250,828,242,1070,72,1142
公投第８案,桃園市,蘆竹區,中興里,403,2354,778,228,1006,29,1035
公投第８案,桃園市,蘆竹區,新莊里,404,1446,478,140,618,28,646
公投第８案,桃園市,蘆竹區,新莊里,405,1623,515,164,679,72,751
公投第８案,桃園市,蘆竹區,新莊里,406,1747,615,161,776,40,816
公投第８案,桃園市,蘆竹區,上竹里,407,1988,683,261,944,77,1021
公投第８案,桃園市,蘆竹區,上竹里,408,1437,525,173,698,56,754
公投第８案,桃園市,蘆竹區,宏竹里,409,1532,596,188,784,72,856
公投第８案,桃園市,蘆竹區,宏竹里,410,1447,522,128,650,40,690
公投第８案,桃園市,蘆竹區,大竹里,411,2189,757,266,1023,66,1089
公投第８案,桃園市,蘆竹區,大竹里,412,2498,851,237,1088,76,1164
公投第８案,桃園市,蘆竹區,富竹里,413,1322,454,199,653,35,688
公投第８案,桃園市,蘆竹區,蘆竹里,414,1991,551,200,751,91,842
公投第８案,桃園市,蘆竹區,蘆竹里,415,2097,657,237,894,84,978
公投第８案,桃園市,蘆竹區,南興里,416,1558,619,179,798,45,843
公投第８案,桃園市,蘆竹區,南興里,417,1891,735,202,937,53,990
公投第８案,桃園市,蘆竹區,南興里,418,1590,564,156,720,52,772
公投第８案,桃園市,蘆竹區,福昌里,419,2404,762,250,1012,59,1071
公投第８案,桃園市,蘆竹區,福昌里,420,2522,936,263,1199,51,1250
公投第８案,桃園市,蘆竹區,福興里,421,1633,623,186,809,32,841
公投第８案,桃園市,蘆竹區,福興里,422,1715,632,188,820,58,878
公投第８案,桃園市,蘆竹區,正興里,423,2215,697,244,941,36,977
公投第８案,桃園市,蘆竹區,正興里,424,2029,708,216,924,51,975
公投第８案,桃園市,蘆竹區,順興里,425,1731,612,175,787,46,833
公投第８案,桃園市,蘆竹區,順興里,426,1820,708,174,882,44,926
公投第８案,桃園市,蘆竹區,蘆興里,427,1633,634,177,811,64,875
公投第８案,桃園市,蘆竹區,南榮里,428,1668,498,178,676,33,709
公投第８案,桃園市,蘆竹區,南榮里,429,1493,599,172,771,40,811
公投第８案,桃園市,蘆竹區,南崁里,430,1864,650,233,883,79,962
公投第８案,桃園市,蘆竹區,南崁里,431,1703,576,173,749,33,782
公投第８案,桃園市,蘆竹區,錦興里,432,1893,656,210,866,43,909
公投第８案,桃園市,蘆竹區,錦興里,433,1922,730,252,982,76,1058
公投第８案,桃園市,蘆竹區,興榮里,434,1393,535,169,704,33,737
公投第８案,桃園市,蘆竹區,興榮里,435,1338,511,170,681,53,734
公投第８案,桃園市,蘆竹區,錦中里,436,1688,620,194,814,43,857
公投第８案,桃園市,蘆竹區,錦中里,437,1462,486,195,681,71,752
公投第８案,桃園市,蘆竹區,長興里,438,1232,423,159,582,30,612
公投第８案,桃園市,蘆竹區,長興里,439,1356,481,129,610,36,646
公投第８案,桃園市,蘆竹區,五福里,440,1181,517,133,650,62,712
公投第８案,桃園市,蘆竹區,五福里,441,1199,458,121,579,28,607
公投第８案,桃園市,蘆竹區,中山里,442,1710,685,172,857,52,909
公投第８案,桃園市,蘆竹區,中山里,443,1423,508,158,666,38,704
公投第８案,桃園市,蘆竹區,福祿里,444,1522,582,182,764,49,813
公投第８案,桃園市,蘆竹區,福祿里,445,1639,644,182,826,44,870
公投第８案,桃園市,蘆竹區,羊稠里,446,2055,746,220,966,53,1019
公投第８案,桃園市,蘆竹區,羊稠里,447,2178,810,233,1043,43,1086
公投第８案,桃園市,蘆竹區,吉祥里,448,1709,680,195,875,37,912
公投第８案,桃園市,蘆竹區,長壽里,449,1667,674,185,859,55,914
公投第８案,桃園市,蘆竹區,長壽里,450,1745,708,175,883,47,930
公投第８案,桃園市,蘆竹區,長壽里,451,1967,788,240,1028,55,1083
公投第８案,桃園市,蘆竹區,吉祥里,452,1802,740,206,946,39,985
公投第８案,桃園市,蘆竹區,營盤里,453,2727,992,265,1257,54,1311
公投第８案,桃園市,蘆竹區,營盤里,454,1868,633,188,821,40,861
公投第８案,桃園市,蘆竹區,營福里,455,1537,562,171,733,45,778
公投第８案,桃園市,蘆竹區,營福里,456,1616,591,198,789,53,842
公投第８案,桃園市,蘆竹區,瓦窯里,457,1483,591,197,788,66,854
公投第８案,桃園市,蘆竹區,瓦窯里,458,1689,621,171,792,50,842
公投第８案,桃園市,蘆竹區,內厝里,459,1318,385,124,509,56,565
公投第８案,桃園市,蘆竹區,內厝里,460,1203,582,75,657,102,759
公投第８案,桃園市,蘆竹區,山鼻里,461,1771,574,200,774,29,803
公投第８案,桃園市,蘆竹區,山腳里,462,1832,518,243,761,101,862
公投第８案,桃園市,蘆竹區,山腳里,463,1763,566,215,781,108,889
公投第８案,桃園市,蘆竹區,外社里,464,1497,381,192,573,23,596
公投第８案,桃園市,蘆竹區,坑子里,465,1671,610,242,852,133,985
公投第８案,桃園市,蘆竹區,坑口里,466,929,321,134,455,78,533
公投第８案,桃園市,蘆竹區,坑口里,467,1559,511,238,749,122,871
公投第８案,桃園市,蘆竹區,海湖里,468,1497,552,153,705,34,739
公投第８案,桃園市,蘆竹區,海湖里,469,1441,608,219,827,85,912
公投第８案,桃園市,蘆竹區,濱海里,470,1465,499,176,675,62,737
公投第８案,桃園市,蘆竹區,濱海里,471,1029,345,146,491,42,533
公投第８案,桃園市,大園區,大園里,472,1538,487,167,654,50,704
公投第８案,桃園市,大園區,大園里,473,1616,444,151,595,36,631
公投第８案,桃園市,大園區,大園里,474,1437,556,196,752,60,812
公投第８案,桃園市,大園區,大園里,475,1554,597,190,787,50,837
公投第８案,桃園市,大園區,田心里,476,1237,436,157,593,47,640
公投第８案,桃園市,大園區,田心里,477,1347,478,148,626,67,693
公投第８案,桃園市,大園區,田心里,478,1261,434,146,580,31,611
公投第８案,桃園市,大園區,田心里,479,1256,444,135,579,57,636
公投第８案,桃園市,大園區,田心里,480,1370,449,127,576,38,614
公投第８案,桃園市,大園區,溪海里,481,1610,517,179,696,51,747
公投第８案,桃園市,大園區,溪海里,482,1419,469,180,649,61,710
公投第８案,桃園市,大園區,溪海里,483,1588,456,136,592,27,619
公投第８案,桃園市,大園區,和平里,484,1612,572,185,757,49,806
公投第８案,桃園市,大園區,橫峰里,485,1440,501,161,662,48,710
公投第８案,桃園市,大園區,橫峰里,486,1326,440,163,603,43,646
公投第８案,桃園市,大園區,橫峰里,487,1455,579,171,750,66,816
公投第８案,桃園市,大園區,橫峰里,488,1562,574,191,765,70,835
公投第８案,桃園市,大園區,橫峰里,489,1284,523,154,677,36,713
公投第８案,桃園市,大園區,橫峰里,490,1454,514,144,658,29,687
公投第８案,桃園市,大園區,橫峰里,491,1490,561,162,723,36,759
公投第８案,桃園市,大園區,五權里,492,1617,483,183,666,43,709
公投第８案,桃園市,大園區,五權里,493,1594,519,208,727,95,822
公投第８案,桃園市,大園區,五權里,494,1650,582,183,765,68,833
公投第８案,桃園市,大園區,埔心里,495,1467,478,201,679,26,705
公投第８案,桃園市,大園區,埔心里,496,1494,527,166,693,43,736
公投第８案,桃園市,大園區,埔心里,497,1538,544,161,705,66,771
公投第８案,桃園市,大園區,埔心里,498,1397,486,153,639,30,669
公投第８案,桃園市,大園區,大海里,499,1637,556,173,729,27,756
公投第８案,桃園市,大園區,三石里,500,1452,493,146,639,60,699
公投第８案,桃園市,大園區,三石里,501,1414,578,154,732,61,793
公投第８案,桃園市,大園區,菓林里,502,1670,571,190,761,44,805
公投第８案,桃園市,大園區,菓林里,503,1701,599,155,754,62,816
公投第８案,桃園市,大園區,菓林里,504,1813,520,168,688,41,729
公投第８案,桃園市,大園區,菓林里,505,1687,531,177,708,56,764
公投第８案,桃園市,大園區,竹圍里,506,1650,608,191,799,18,817
公投第８案,桃園市,大園區,竹圍里,507,1556,631,192,823,54,877
公投第８案,桃園市,大園區,海口里,508,1844,597,181,778,40,818
公投第８案,桃園市,大園區,沙崙里,509,1336,461,125,586,67,653
公投第８案,桃園市,大園區,沙崙里,510,1414,510,208,718,68,786
公投第８案,桃園市,大園區,後厝里,511,1238,509,167,676,57,733
公投第８案,桃園市,大園區,後厝里,512,1227,511,170,681,57,738
公投第８案,桃園市,大園區,圳頭里,513,1199,406,148,554,27,581
公投第８案,桃園市,大園區,圳頭里,514,1349,424,141,565,32,597
公投第８案,桃園市,大園區,內海里,515,1120,375,137,512,39,551
公投第８案,桃園市,大園區,內海里,516,1080,396,112,508,36,544
公投第８案,桃園市,大園區,北港里,517,1341,459,145,604,54,658
公投第８案,桃園市,大園區,北港里,518,1345,501,176,677,39,716
公投第８案,桃園市,大園區,南港里,519,1565,496,147,643,57,700
公投第８案,桃園市,大園區,南港里,520,1519,468,157,625,31,656
公投第８案,桃園市,大園區,南港里,521,2130,718,198,916,71,987
公投第８案,桃園市,大溪區,興和里,522,1477,535,218,753,74,827
公投第８案,桃園市,大溪區,福仁里,523,1006,359,139,498,45,543
公投第８案,桃園市,大溪區,田心里,524,1553,538,183,721,92,813
公投第８案,桃園市,大溪區,田心里,525,1597,570,210,780,84,864
公投第８案,桃園市,大溪區,田心里,526,1358,502,150,652,70,722
公投第８案,桃園市,大溪區,一心里,527,1585,519,181,700,50,750
公投第８案,桃園市,大溪區,一心里,528,1612,588,192,780,55,835
公投第８案,桃園市,大溪區,一心里,529,1555,520,143,663,40,703
公投第８案,桃園市,大溪區,一德里,530,1282,529,183,712,60,772
公投第８案,桃園市,大溪區,一德里,531,1392,522,137,659,71,730
公投第８案,桃園市,大溪區,一德里,532,1422,481,178,659,58,717
公投第８案,桃園市,大溪區,一德里,533,1448,537,174,711,77,788
公投第８案,桃園市,大溪區,月眉里,534,1269,508,197,705,70,775
公投第８案,桃園市,大溪區,永福里,535,977,345,164,509,82,591
公投第８案,桃園市,大溪區,康安里,536,1359,512,192,704,48,752
公投第８案,桃園市,大溪區,義和里,537,1135,425,182,607,75,682
公投第８案,桃園市,大溪區,義和里,538,660,211,102,313,39,352
公投第８案,桃園市,大溪區,美華里,539,1056,354,128,482,39,521
公投第８案,桃園市,大溪區,美華里,540,1263,458,133,591,60,651
公投第８案,桃園市,大溪區,美華里,541,717,246,97,343,53,396
公投第８案,桃園市,大溪區,福安里,542,1299,363,145,508,21,529
公投第８案,桃園市,大溪區,福安里,543,976,365,113,478,60,538
公投第８案,桃園市,大溪區,復興里,544,938,345,102,447,59,506
公投第８案,桃園市,大溪區,新峰里,545,832,289,82,371,34,405
公投第８案,桃園市,大溪區,中新里,546,866,285,77,362,24,386
公投第８案,桃園市,大溪區,中新里,547,694,202,95,297,34,331
公投第８案,桃園市,大溪區,瑞興里,548,1410,420,191,611,48,659
公投第８案,桃園市,大溪區,瑞興里,549,1303,445,132,577,68,645
公投第８案,桃園市,大溪區,仁善里,550,1125,421,122,543,46,589
公投第８案,桃園市,大溪區,仁善里,551,1170,461,132,593,43,636
公投第８案,桃園市,大溪區,仁善里,552,1308,530,173,703,59,762
公投第８案,桃園市,大溪區,仁美里,553,1094,393,154,547,67,614
公投第８案,桃園市,大溪區,仁美里,554,2153,844,230,1074,71,1145
公投第８案,桃園市,大溪區,僑愛里,555,1173,551,77,628,49,677
公投第８案,桃園市,大溪區,僑愛里,556,1369,534,137,671,29,700
公投第８案,桃園市,大溪區,仁義里,557,1446,558,118,676,67,743
公投第８案,桃園市,大溪區,仁義里,558,1406,477,86,563,61,624
公投第８案,桃園市,大溪區,仁和里,559,1592,672,148,820,38,858
公投第８案,桃園市,大溪區,仁和里,560,1497,574,196,770,83,853
公投第８案,桃園市,大溪區,仁和里,561,1559,587,212,799,82,881
公投第８案,桃園市,大溪區,仁愛里,562,1684,614,179,793,30,823
公投第８案,桃園市,大溪區,仁愛里,563,1959,915,97,1012,62,1074
公投第８案,桃園市,大溪區,仁愛里,564,1369,544,160,704,70,774
公投第８案,桃園市,大溪區,仁武里,565,1431,555,170,725,70,795
公投第８案,桃園市,大溪區,仁武里,566,1657,470,139,609,32,641
公投第８案,桃園市,大溪區,仁文里,567,1387,413,147,560,33,593
公投第８案,桃園市,大溪區,仁文里,568,1085,429,95,524,44,568
公投第８案,桃園市,大溪區,仁文里,569,1403,577,164,741,54,795
公投第８案,桃園市,大溪區,南興里,570,1511,526,165,691,93,784
公投第８案,桃園市,大溪區,南興里,571,1719,513,193,706,91,797
公投第８案,桃園市,大溪區,南興里,572,1717,508,187,695,101,796
公投第８案,桃園市,大溪區,光明里,573,1207,435,139,574,74,648
公投第８案,桃園市,大溪區,光明里,574,1188,489,97,586,86,672
公投第８案,桃園市,大溪區,員林里,575,1514,497,168,665,35,700
公投第８案,桃園市,大溪區,三元里,576,1529,633,150,783,72,855
公投第８案,桃園市,大溪區,三元里,577,1260,557,133,690,51,741
公投第８案,桃園市,大溪區,瑞源里,578,831,340,108,448,22,470
公投第８案,桃園市,大溪區,瑞源里,579,1407,554,168,722,64,786
公投第８案,桃園市,大溪區,瑞源里,580,1494,494,151,645,75,720
公投第８案,桃園市,復興區,三民里,581,1991,752,233,985,106,1091
公投第８案,桃園市,復興區,澤仁里,582,1392,553,146,699,84,783
公投第８案,桃園市,復興區,霞雲里,583,564,221,56,277,16,293
公投第８案,桃園市,復興區,義盛里,584,716,255,63,318,23,341
公投第８案,桃園市,復興區,羅浮里,585,1016,445,119,564,62,626
公投第８案,桃園市,復興區,長興里,586,669,191,55,246,17,263
公投第８案,桃園市,復興區,奎輝里,587,760,264,63,327,25,352
公投第８案,桃園市,復興區,高義里,588,751,269,70,339,18,357
公投第８案,桃園市,復興區,三光里,589,683,179,43,222,10,232
公投第８案,桃園市,復興區,華陵里,590,1224,431,120,551,41,592
公投第８案,桃園市,中壢區,後寮里,591,1401,568,118,686,54,740
公投第８案,桃園市,中壢區,後寮里,592,1798,651,193,844,55,899
公投第８案,桃園市,中壢區,後寮里,593,1642,560,157,717,55,772
公投第８案,桃園市,中壢區,明德里,594,1670,645,189,834,53,887
公投第８案,桃園市,中壢區,明德里,595,1456,598,171,769,22,791
公投第８案,桃園市,中壢區,明德里,596,1531,698,164,862,45,907
公投第８案,桃園市,中壢區,至善里,597,1623,682,200,882,50,932
公投第８案,桃園市,中壢區,至善里,598,1953,690,149,839,48,887
公投第８案,桃園市,中壢區,龍慈里,599,1155,486,142,628,29,657
公投第８案,桃園市,中壢區,龍慈里,600,1800,637,156,793,49,842
公投第８案,桃園市,中壢區,龍慈里,601,1757,676,138,814,37,851
公投第８案,桃園市,中壢區,龍興里,602,1281,573,128,701,51,752
公投第８案,桃園市,中壢區,龍興里,603,1462,634,159,793,33,826
公投第８案,桃園市,中壢區,龍興里,604,1560,569,149,718,56,774
公投第８案,桃園市,中壢區,龍德里,605,1602,711,172,883,42,925
公投第８案,桃園市,中壢區,龍德里,606,1006,493,120,613,32,645
公投第８案,桃園市,中壢區,龍德里,607,1474,723,157,880,34,914
公投第８案,桃園市,中壢區,龍岡里,608,1627,640,154,794,89,883
公投第８案,桃園市,中壢區,龍岡里,609,1519,632,178,810,49,859
公投第８案,桃園市,中壢區,龍岡里,610,1526,602,162,764,79,843
公投第８案,桃園市,中壢區,龍東里,611,1618,660,138,798,75,873
公投第８案,桃園市,中壢區,龍東里,612,1554,684,148,832,71,903
公投第８案,桃園市,中壢區,龍東里,613,1706,714,127,841,77,918
公投第８案,桃園市,中壢區,龍昌里,614,1818,828,168,996,47,1043
公投第８案,桃園市,中壢區,龍昌里,615,1991,758,165,923,50,973
公投第８案,桃園市,中壢區,龍昌里,616,1609,661,140,801,27,828
公投第８案,桃園市,中壢區,龍平里,617,1329,522,86,608,23,631
公投第８案,桃園市,中壢區,龍平里,618,1587,573,131,704,84,788
公投第８案,桃園市,中壢區,仁美里,619,1955,771,164,935,39,974
公投第８案,桃園市,中壢區,仁美里,620,1711,621,218,839,46,885
公投第８案,桃園市,中壢區,仁美里,621,1712,658,159,817,56,873
公投第８案,桃園市,中壢區,仁福里,622,1448,626,151,777,54,831
公投第８案,桃園市,中壢區,仁福里,623,1605,607,164,771,51,822
公投第８案,桃園市,中壢區,仁福里,624,1633,587,145,732,17,749
公投第８案,桃園市,中壢區,華愛里,625,1795,775,185,960,57,1017
公投第８案,桃園市,中壢區,華愛里,626,1689,711,170,881,33,914
公投第８案,桃園市,中壢區,普仁里,627,1201,486,140,626,44,670
公投第８案,桃園市,中壢區,普仁里,628,1353,526,149,675,35,710
公投第８案,桃園市,中壢區,普仁里,629,1587,617,144,761,33,794
公投第８案,桃園市,中壢區,普忠里,630,1883,757,103,860,53,913
公投第８案,桃園市,中壢區,普忠里,631,1448,547,167,714,32,746
公投第８案,桃園市,中壢區,普強里,632,1810,740,176,916,33,949
公投第８案,桃園市,中壢區,普強里,633,1916,721,178,899,81,980
公投第８案,桃園市,中壢區,普慶里,634,1177,519,128,647,24,671
公投第８案,桃園市,中壢區,普慶里,635,1410,595,187,782,50,832
公投第８案,桃園市,中壢區,信義里,636,1368,498,145,643,16,659
公投第８案,桃園市,中壢區,信義里,637,1424,606,186,792,56,848
公投第８案,桃園市,中壢區,信義里,638,1573,640,199,839,38,877
公投第８案,桃園市,中壢區,正義里,639,1152,472,146,618,24,642
公投第８案,桃園市,中壢區,正義里,640,1178,466,143,609,24,633
公投第８案,桃園市,中壢區,正義里,641,1966,755,223,978,75,1053
公投第８案,桃園市,中壢區,普義里,642,3474,525,148,673,33,706
公投第８案,桃園市,中壢區,普義里,643,2099,841,213,1054,63,1117
公投第８案,桃園市,中壢區,德義里,644,1178,484,125,609,41,650
公投第８案,桃園市,中壢區,德義里,645,1397,620,175,795,61,856
公投第８案,桃園市,中壢區,仁義里,646,1669,670,199,869,50,919
公投第８案,桃園市,中壢區,仁義里,647,2087,757,186,943,61,1004
公投第８案,桃園市,中壢區,忠義里,648,1900,827,87,914,56,970
公投第８案,桃園市,中壢區,忠義里,649,1640,523,153,676,31,707
公投第８案,桃園市,中壢區,龍安里,650,994,479,89,568,27,595
公投第８案,桃園市,中壢區,龍安里,651,1131,560,114,674,55,729
公投第８案,桃園市,中壢區,仁愛里,652,1625,721,183,904,50,954
公投第８案,桃園市,中壢區,仁愛里,653,1384,618,193,811,46,857
公投第８案,桃園市,中壢區,仁德里,654,1588,616,179,795,48,843
公投第８案,桃園市,中壢區,仁德里,655,1445,618,130,748,37,785
公投第８案,桃園市,中壢區,仁和里,656,1743,614,142,756,58,814
公投第８案,桃園市,中壢區,仁和里,657,1812,678,138,816,44,860
公投第８案,桃園市,中壢區,仁祥里,658,1546,580,146,726,63,789
公投第８案,桃園市,中壢區,仁祥里,659,1290,511,128,639,48,687
公投第８案,桃園市,中壢區,華勛里,660,2145,775,173,948,94,1042
公投第８案,桃園市,中壢區,華勛里,661,1451,519,145,664,50,714
公投第８案,桃園市,中壢區,中堅里,662,1489,609,131,740,37,777
公投第８案,桃園市,中壢區,中堅里,663,827,352,79,431,26,457
公投第８案,桃園市,中壢區,中堅里,664,1442,592,112,704,36,740
公投第８案,桃園市,中壢區,興仁里,665,1842,668,178,846,22,868
公投第８案,桃園市,中壢區,興仁里,666,1520,559,120,679,26,705
公投第８案,桃園市,中壢區,中正里,667,1764,625,151,776,45,821
公投第８案,桃園市,中壢區,中正里,668,1488,659,137,796,28,824
公投第８案,桃園市,中壢區,中正里,669,1593,625,168,793,53,846
公投第８案,桃園市,中壢區,中山里,670,1505,604,158,762,41,803
公投第８案,桃園市,中壢區,中山里,671,1661,625,179,804,37,841
公投第８案,桃園市,中壢區,中山里,672,1492,530,252,782,34,816
公投第８案,桃園市,中壢區,篤行里,673,1249,441,146,587,30,617
公投第８案,桃園市,中壢區,篤行里,674,1257,541,126,667,31,698
公投第８案,桃園市,中壢區,自強里,675,1659,628,157,785,78,863
公投第８案,桃園市,中壢區,自強里,676,1815,783,177,960,50,1010
公投第８案,桃園市,中壢區,中興里,677,1702,653,155,808,49,857
公投第８案,桃園市,中壢區,中興里,678,1541,620,162,782,21,803
公投第８案,桃園市,中壢區,自立里,679,1659,550,236,786,40,826
公投第８案,桃園市,中壢區,自立里,680,1874,731,130,861,118,979
公投第８案,桃園市,中壢區,自立里,681,1603,636,117,753,50,803
公投第８案,桃園市,中壢區,自信里,682,1735,660,172,832,49,881
公投第８案,桃園市,中壢區,自信里,683,1815,717,170,887,22,909
公投第８案,桃園市,中壢區,自信里,684,1873,821,174,995,37,1032
公投第８案,桃園市,中壢區,莊敬里,685,1739,774,138,912,56,968
公投第８案,桃園市,中壢區,莊敬里,686,1709,658,140,798,41,839
公投第８案,桃園市,中壢區,自治里,687,1655,678,192,870,43,913
公投第８案,桃園市,中壢區,自治里,688,1664,713,120,833,44,877
公投第８案,桃園市,中壢區,內壢里,689,1087,395,102,497,17,514
公投第８案,桃園市,中壢區,內壢里,690,1065,416,121,537,61,598
公投第８案,桃園市,中壢區,成功里,691,1844,705,209,914,78,992
公投第８案,桃園市,中壢區,成功里,692,1220,426,102,528,48,576
公投第８案,桃園市,中壢區,成功里,693,1219,471,143,614,39,653
公投第８案,桃園市,中壢區,福德里,694,1260,471,172,643,51,694
公投第８案,桃園市,中壢區,福德里,695,1594,663,187,850,77,927
公投第８案,桃園市,中壢區,中原里,696,1733,649,209,858,76,934
公投第８案,桃園市,中壢區,中原里,697,1979,806,175,981,58,1039
公投第８案,桃園市,中壢區,忠孝里,698,1621,628,180,808,29,837
公投第８案,桃園市,中壢區,忠孝里,699,1391,557,175,732,43,775
公投第８案,桃園市,中壢區,忠孝里,700,1531,648,155,803,36,839
公投第８案,桃園市,中壢區,復興里,701,1943,702,176,878,48,926
公投第８案,桃園市,中壢區,復興里,702,1363,548,134,682,32,714
公投第８案,桃園市,中壢區,復興里,703,2172,744,181,925,61,986
公投第８案,桃園市,中壢區,復興里,704,1798,698,132,830,49,879
公投第８案,桃園市,中壢區,復興里,705,1671,643,153,796,28,824
公投第８案,桃園市,中壢區,復華里,706,1969,749,183,932,43,975
公投第８案,桃園市,中壢區,復華里,707,1563,751,170,921,61,982
公投第８案,桃園市,中壢區,復華里,708,1762,742,182,924,49,973
公投第８案,桃園市,中壢區,文化里,709,1923,632,130,762,50,812
公投第８案,桃園市,中壢區,文化里,710,1572,654,173,827,67,894
公投第８案,桃園市,中壢區,文化里,711,1850,776,192,968,46,1014
公投第８案,桃園市,中壢區,文化里,712,1583,605,151,756,61,817
公投第８案,桃園市,中壢區,文化里,713,1735,627,197,824,60,884
公投第８案,桃園市,中壢區,和平里,714,1292,481,160,641,30,671
公投第８案,桃園市,中壢區,和平里,715,1265,516,117,633,26,659
公投第８案,桃園市,中壢區,內定里,716,1798,670,206,876,43,919
公投第８案,桃園市,中壢區,內定里,717,1822,769,209,978,62,1040
公投第８案,桃園市,中壢區,內定里,718,1613,646,178,824,26,850
公投第８案,桃園市,中壢區,內定里,719,1405,553,165,718,40,758
公投第８案,桃園市,中壢區,石頭里,720,1730,665,229,894,80,974
公投第８案,桃園市,中壢區,中央里,721,1384,640,172,812,38,850
公投第８案,桃園市,中壢區,中央里,722,1122,475,132,607,20,627
公投第８案,桃園市,中壢區,中央里,723,992,418,188,606,0,606
公投第８案,桃園市,中壢區,新興里,724,1820,654,218,872,49,921
公投第８案,桃園市,中壢區,新興里,725,1847,689,193,882,58,940
公投第８案,桃園市,中壢區,林森里,726,1302,572,141,713,53,766
公投第８案,桃園市,中壢區,林森里,727,1203,490,150,640,45,685
公投第８案,桃園市,中壢區,林森里,728,1226,570,161,731,50,781
公投第８案,桃園市,中壢區,振興里,729,1234,521,141,662,46,708
公投第８案,桃園市,中壢區,振興里,730,2023,747,159,906,50,956
公投第８案,桃園市,中壢區,振興里,731,1555,564,149,713,20,733
公投第８案,桃園市,中壢區,東興里,732,1951,693,211,904,69,973
公投第８案,桃園市,中壢區,東興里,733,1383,569,144,713,55,768
公投第８案,桃園市,中壢區,健行里,734,1164,513,142,655,49,704
公投第８案,桃園市,中壢區,健行里,735,1482,630,142,772,36,808
公投第８案,桃園市,中壢區,健行里,736,1770,686,210,896,49,945
公投第８案,桃園市,中壢區,水尾里,737,1703,703,214,917,73,990
公投第８案,桃園市,中壢區,水尾里,738,1841,725,182,907,63,970
公投第８案,桃園市,中壢區,金華里,739,1941,808,197,1005,45,1050
公投第８案,桃園市,中壢區,金華里,740,2029,847,212,1059,57,1116
公投第８案,桃園市,中壢區,忠福里,741,1636,685,173,858,39,897
公投第８案,桃園市,中壢區,忠福里,742,1528,672,166,838,32,870
公投第８案,桃園市,中壢區,忠福里,743,2289,759,240,999,91,1090
公投第８案,桃園市,中壢區,忠福里,744,2020,695,235,930,59,989
公投第８案,桃園市,中壢區,幸福里,745,2027,788,206,994,59,1053
公投第８案,桃園市,中壢區,幸福里,746,1883,638,158,796,35,831
公投第８案,桃園市,中壢區,幸福里,747,2080,807,166,973,52,1025
公投第８案,桃園市,中壢區,永福里,748,646,234,75,309,20,329
公投第８案,桃園市,中壢區,永福里,749,1780,1014,32,1046,67,1113
公投第８案,桃園市,中壢區,永福里,750,1372,601,150,751,25,776
公投第８案,桃園市,中壢區,永福里,751,1668,676,228,904,49,953
公投第８案,桃園市,中壢區,青埔里,752,1987,763,186,949,43,992
公投第８案,桃園市,中壢區,青埔里,753,1520,587,191,778,30,808
公投第８案,桃園市,中壢區,新街里,754,852,313,111,424,41,465
公投第８案,桃園市,中壢區,新街里,755,1209,494,123,617,45,662
公投第８案,桃園市,中壢區,興南里,756,1481,532,176,708,85,793
公投第８案,桃園市,中壢區,興南里,757,1564,582,134,716,22,738
公投第８案,桃園市,中壢區,興國里,758,1957,760,234,994,65,1059
公投第８案,桃園市,中壢區,興平里,759,1223,498,177,675,64,739
公投第８案,桃園市,中壢區,興平里,760,1182,468,146,614,54,668
公投第８案,桃園市,中壢區,興和里,761,1066,418,166,584,45,629
公投第８案,桃園市,中壢區,興和里,762,1701,698,202,900,62,962
公投第８案,桃園市,中壢區,永興里,763,943,355,97,452,45,497
公投第８案,桃園市,中壢區,中壢里,764,731,313,101,414,28,442
公投第８案,桃園市,中壢區,中榮里,765,851,329,112,441,47,488
公投第８案,桃園市,中壢區,中建里,766,1011,377,137,514,39,553
公投第８案,桃園市,中壢區,舊明里,767,1532,584,193,777,51,828
公投第８案,桃園市,中壢區,新明里,768,1028,404,114,518,42,560
公投第８案,桃園市,中壢區,新明里,769,1157,451,151,602,47,649
公投第８案,桃園市,中壢區,新明里,770,1591,591,206,797,54,851
公投第８案,桃園市,中壢區,光明里,771,2156,747,210,957,65,1022
公投第８案,桃園市,中壢區,光明里,772,1479,487,158,645,33,678
公投第８案,桃園市,中壢區,光明里,773,1780,705,181,886,40,926
公投第８案,桃園市,中壢區,永光里,774,1651,637,186,823,67,890
公投第８案,桃園市,中壢區,永光里,775,1870,828,136,964,42,1006
公投第８案,桃園市,中壢區,永光里,776,1913,669,174,843,26,869
公投第８案,桃園市,中壢區,三民里,777,1609,541,150,691,36,727
公投第８案,桃園市,中壢區,三民里,778,1539,550,178,728,32,760
公投第８案,桃園市,中壢區,五權里,779,1426,540,171,711,42,753
公投第８案,桃園市,中壢區,五權里,780,1618,540,193,733,37,770
公投第８案,桃園市,中壢區,五權里,781,1441,553,178,731,51,782
公投第８案,桃園市,中壢區,五權里,782,1528,625,176,801,42,843
公投第８案,桃園市,中壢區,五福里,783,1683,622,194,816,65,881
公投第８案,桃園市,中壢區,五福里,784,1945,750,230,980,94,1074
公投第８案,桃園市,中壢區,芝芭里,785,1534,545,194,739,68,807
公投第８案,桃園市,中壢區,芝芭里,786,1810,534,288,822,86,908
公投第８案,桃園市,中壢區,洽溪里,787,1097,362,136,498,64,562
公投第８案,桃園市,中壢區,洽溪里,788,1917,690,204,894,36,930
公投第８案,桃園市,中壢區,洽溪里,789,1858,673,222,895,57,952
公投第８案,桃園市,中壢區,內厝里,790,1576,624,177,801,40,841
公投第８案,桃園市,中壢區,內厝里,791,1478,687,97,784,40,824
公投第８案,桃園市,中壢區,內厝里,792,1589,599,203,802,38,840
公投第８案,桃園市,中壢區,月眉里,793,2037,754,256,1010,102,1112
公投第８案,桃園市,中壢區,月眉里,794,1158,483,157,640,52,692
公投第８案,桃園市,中壢區,月眉里,795,1967,728,259,987,78,1065
公投第８案,桃園市,中壢區,山東里,796,1830,656,202,858,77,935
公投第８案,桃園市,中壢區,山東里,797,1856,605,235,840,62,902
公投第８案,桃園市,中壢區,過嶺里,798,2068,710,230,940,80,1020
公投第８案,桃園市,中壢區,過嶺里,799,2152,637,209,846,47,893
公投第８案,桃園市,中壢區,過嶺里,800,2158,694,223,917,59,976
公投第８案,桃園市,平鎮區,平鎮里,801,1487,505,165,670,57,727
公投第８案,桃園市,平鎮區,平鎮里,802,1453,555,142,697,57,754
公投第８案,桃園市,平鎮區,平鎮里,803,1491,580,179,759,50,809
公投第８案,桃園市,平鎮區,鎮興里,804,1346,478,165,643,57,700
公投第８案,桃園市,平鎮區,鎮興里,805,1660,594,174,768,47,815
公投第８案,桃園市,平鎮區,南勢里,806,1921,679,164,843,47,890
公投第８案,桃園市,平鎮區,南勢里,807,1974,823,188,1011,59,1070
公投第８案,桃園市,平鎮區,南勢里,808,1867,709,184,893,42,935
公投第８案,桃園市,平鎮區,金星里,809,1786,704,173,877,46,923
公投第８案,桃園市,平鎮區,金星里,810,1634,522,131,653,34,687
公投第８案,桃園市,平鎮區,金星里,811,1080,449,111,560,24,584
公投第８案,桃園市,平鎮區,金星里,812,1514,600,164,764,28,792
公投第８案,桃園市,平鎮區,平安里,813,1918,665,151,816,69,885
公投第８案,桃園市,平鎮區,平安里,814,1182,425,155,580,73,653
公投第８案,桃園市,平鎮區,平安里,815,1667,592,169,761,43,804
公投第８案,桃園市,平鎮區,平南里,816,1640,559,157,716,41,757
公投第８案,桃園市,平鎮區,平南里,817,1603,623,160,783,31,814
公投第８案,桃園市,平鎮區,平南里,818,1556,669,163,832,16,848
公投第８案,桃園市,平鎮區,平南里,819,1697,628,159,787,42,829
公投第８案,桃園市,平鎮區,山峰里,820,1130,411,95,506,19,525
公投第８案,桃園市,平鎮區,山峰里,821,1196,462,119,581,44,625
公投第８案,桃園市,平鎮區,福林里,822,1685,667,164,831,38,869
公投第８案,桃園市,平鎮區,福林里,823,1532,611,195,806,58,864
公投第８案,桃園市,平鎮區,湧光里,824,1564,607,160,767,34,801
公投第８案,桃園市,平鎮區,湧光里,825,1824,602,127,729,30,759
公投第８案,桃園市,平鎮區,湧光里,826,1912,693,179,872,32,904
公投第８案,桃園市,平鎮區,莊敬里,827,1048,403,112,515,46,561
公投第８案,桃園市,平鎮區,莊敬里,828,1259,524,126,650,58,708
公投第８案,桃園市,平鎮區,莊敬里,829,1061,337,182,519,22,541
公投第８案,桃園市,平鎮區,莊敬里,830,1072,484,119,603,31,634
公投第８案,桃園市,平鎮區,湧豐里,831,1788,644,191,835,62,897
公投第８案,桃園市,平鎮區,湧安里,832,1510,629,127,756,35,791
公投第８案,桃園市,平鎮區,湧安里,833,1403,542,143,685,53,738
公投第８案,桃園市,平鎮區,湧安里,834,1407,544,154,698,69,767
公投第８案,桃園市,平鎮區,宋屋里,835,1901,719,237,956,60,1016
公投第８案,桃園市,平鎮區,宋屋里,836,1994,702,182,884,32,916
公投第８案,桃園市,平鎮區,平興里,837,1730,663,177,840,56,896
公投第８案,桃園市,平鎮區,平興里,838,1905,764,189,953,51,1004
公投第８案,桃園市,平鎮區,平興里,839,1723,712,186,898,37,935
公投第８案,桃園市,平鎮區,廣興里,840,1307,514,140,654,56,710
公投第８案,桃園市,平鎮區,廣興里,841,1337,530,158,688,46,734
公投第８案,桃園市,平鎮區,廣興里,842,980,460,129,589,46,635
公投第８案,桃園市,平鎮區,廣興里,843,1818,645,228,873,57,930
公投第８案,桃園市,平鎮區,廣達里,844,1463,571,182,753,50,803
公投第８案,桃園市,平鎮區,廣達里,845,1213,507,162,669,32,701
公投第８案,桃園市,平鎮區,廣達里,846,1085,437,135,572,43,615
公投第８案,桃園市,平鎮區,廣仁里,847,1458,536,148,684,33,717
公投第８案,桃園市,平鎮區,廣仁里,848,1408,550,165,715,56,771
公投第８案,桃園市,平鎮區,廣仁里,849,1396,492,169,661,57,718
公投第８案,桃園市,平鎮區,復旦里,850,1044,482,155,637,33,670
公投第８案,桃園市,平鎮區,復旦里,851,1124,483,115,598,14,612
公投第８案,桃園市,平鎮區,復旦里,852,1517,653,107,760,28,788
公投第８案,桃園市,平鎮區,復旦里,853,1571,626,156,782,29,811
公投第８案,桃園市,平鎮區,復興里,854,1752,744,188,932,36,968
公投第８案,桃園市,平鎮區,復興里,855,1434,634,189,823,31,854
公投第８案,桃園市,平鎮區,復興里,856,1710,731,201,932,48,980
公投第８案,桃園市,平鎮區,義民里,857,1555,644,177,821,43,864
公投第８案,桃園市,平鎮區,義民里,858,2051,906,19,925,35,960
公投第８案,桃園市,平鎮區,義民里,859,1477,566,185,751,37,788
公投第８案,桃園市,平鎮區,義興里,860,1501,583,168,751,28,779
公投第８案,桃園市,平鎮區,義興里,861,1405,556,154,710,65,775
公投第８案,桃園市,平鎮區,義興里,862,1656,620,205,825,58,883
公投第８案,桃園市,平鎮區,義興里,863,1921,672,181,853,38,891
公投第８案,桃園市,平鎮區,雙連里,864,1717,641,141,782,31,813
公投第８案,桃園市,平鎮區,雙連里,865,1319,503,163,666,45,711
公投第８案,桃園市,平鎮區,雙連里,866,1745,614,233,847,62,909
公投第８案,桃園市,平鎮區,高雙里,867,1721,668,194,862,78,940
公投第８案,桃園市,平鎮區,高雙里,868,1206,494,124,618,38,656
公投第８案,桃園市,平鎮區,高雙里,869,1202,585,148,733,44,777
公投第８案,桃園市,平鎮區,北勢里,870,1208,527,128,655,50,705
公投第８案,桃園市,平鎮區,北勢里,871,1267,537,160,697,49,746
公投第８案,桃園市,平鎮區,北華里,872,1094,473,107,580,27,607
公投第８案,桃園市,平鎮區,北華里,873,1394,580,176,756,62,818
公投第８案,桃園市,平鎮區,北華里,874,1215,563,135,698,14,712
公投第８案,桃園市,平鎮區,新勢里,875,1010,528,6,534,47,581
公投第８案,桃園市,平鎮區,新勢里,876,1261,508,159,667,30,697
公投第８案,桃園市,平鎮區,新勢里,877,1314,581,152,733,28,761
公投第８案,桃園市,平鎮區,北安里,878,722,294,89,383,38,421
公投第８案,桃園市,平鎮區,北安里,879,839,281,131,412,35,447
公投第８案,桃園市,平鎮區,新榮里,880,1399,536,172,708,36,744
公投第８案,桃園市,平鎮區,新榮里,881,1968,713,217,930,57,987
公投第８案,桃園市,平鎮區,新榮里,882,1672,651,201,852,41,893
公投第８案,桃園市,平鎮區,新富里,883,2213,494,124,618,34,652
公投第８案,桃園市,平鎮區,新富里,884,949,433,118,551,33,584
公投第８案,桃園市,平鎮區,新富里,885,1621,713,194,907,54,961
公投第８案,桃園市,平鎮區,新富里,886,1643,629,168,797,41,838
公投第８案,桃園市,平鎮區,新英里,887,1844,773,188,961,48,1009
公投第８案,桃園市,平鎮區,新英里,888,1752,715,188,903,48,951
公投第８案,桃園市,平鎮區,新貴里,889,1577,547,170,717,64,781
公投第８案,桃園市,平鎮區,新貴里,890,1517,640,171,811,35,846
公投第８案,桃園市,平鎮區,北興里,891,1039,430,145,575,32,607
公投第８案,桃園市,平鎮區,北興里,892,1318,566,159,725,51,776
公投第８案,桃園市,平鎮區,北興里,893,1636,656,157,813,47,860
公投第８案,桃園市,平鎮區,金陵里,894,1316,574,101,675,95,770
公投第８案,桃園市,平鎮區,金陵里,895,1474,616,168,784,29,813
公投第８案,桃園市,平鎮區,北貴里,896,1480,513,130,643,61,704
公投第８案,桃園市,平鎮區,北貴里,897,1330,555,125,680,27,707
公投第８案,桃園市,平鎮區,北貴里,898,1228,510,139,649,31,680
公投第８案,桃園市,平鎮區,北富里,899,1377,575,177,752,47,799
公投第８案,桃園市,平鎮區,北富里,900,1198,555,137,692,30,722
公投第８案,桃園市,平鎮區,北富里,901,1231,537,171,708,37,745
公投第８案,桃園市,平鎮區,建安里,902,1243,490,161,651,62,713
公投第８案,桃園市,平鎮區,建安里,903,1590,646,146,792,47,839
公投第８案,桃園市,平鎮區,建安里,904,1366,530,148,678,54,732
公投第８案,桃園市,平鎮區,華安里,905,1332,545,123,668,49,717
公投第８案,桃園市,平鎮區,華安里,906,1201,440,104,544,25,569
公投第８案,桃園市,平鎮區,華安里,907,1668,567,163,730,46,776
公投第８案,桃園市,平鎮區,東安里,908,1351,512,126,638,67,705
公投第８案,桃園市,平鎮區,東安里,909,1460,512,114,626,34,660
公投第８案,桃園市,平鎮區,新安里,910,1841,700,180,880,42,922
公投第８案,桃園市,平鎮區,新安里,911,1475,557,104,661,21,682
公投第８案,桃園市,平鎮區,新安里,912,1011,415,112,527,32,559
公投第８案,桃園市,平鎮區,東勢里,913,1052,364,110,474,33,507
公投第８案,桃園市,平鎮區,東勢里,914,1154,511,141,652,55,707
公投第８案,桃園市,平鎮區,東勢里,915,1645,607,155,762,35,797
公投第８案,桃園市,平鎮區,東勢里,916,1539,538,148,686,61,747
公投第８案,桃園市,平鎮區,龍恩里,917,1385,536,128,664,83,747
公投第８案,桃園市,平鎮區,龍恩里,918,1395,567,134,701,38,739
公投第８案,桃園市,平鎮區,東社里,919,1711,666,144,810,40,850
公投第８案,桃園市,平鎮區,東社里,920,1631,639,139,778,55,833
公投第８案,桃園市,平鎮區,忠貞里,921,1110,483,100,583,21,604
公投第８案,桃園市,平鎮區,貿易里,922,1931,832,163,995,52,1047
公投第８案,桃園市,平鎮區,龍興里,923,1127,459,114,573,44,617
公投第８案,桃園市,平鎮區,龍興里,924,1414,581,117,698,71,769
公投第８案,桃園市,平鎮區,中正里,925,1609,678,119,797,43,840
公投第８案,桃園市,楊梅區,仁美里,926,1269,506,145,651,56,707
公投第８案,桃園市,楊梅區,仁美里,927,1246,577,137,714,55,769
公投第８案,桃園市,楊梅區,仁美里,928,1408,637,145,782,40,822
公投第８案,桃園市,楊梅區,埔心里,929,1434,570,161,731,62,793
公投第８案,桃園市,楊梅區,光華里,930,1515,594,108,702,62,764
公投第８案,桃園市,楊梅區,光華里,931,1657,585,157,742,55,797
公投第８案,桃園市,楊梅區,金龍里,932,1137,505,115,620,33,653
公投第８案,桃園市,楊梅區,四維里,933,2211,871,189,1060,38,1098
公投第８案,桃園市,楊梅區,四維里,934,2008,752,206,958,32,990
公投第８案,桃園市,楊梅區,永平里,935,1911,762,206,968,33,1001
公投第８案,桃園市,楊梅區,瑞塘里,936,1449,570,178,748,64,812
公投第８案,桃園市,楊梅區,瑞塘里,937,1877,628,170,798,68,866
公投第８案,桃園市,楊梅區,瑞塘里,938,1988,688,205,893,61,954
公投第８案,桃園市,楊梅區,瑞坪里,939,1931,752,197,949,35,984
公投第８案,桃園市,楊梅區,瑞坪里,940,1938,746,161,907,47,954
公投第８案,桃園市,楊梅區,瑞坪里,941,1677,728,128,856,30,886
公投第８案,桃園市,楊梅區,梅溪里,942,1848,686,203,889,32,921
公投第８案,桃園市,楊梅區,梅溪里,943,1882,716,194,910,36,946
公投第８案,桃園市,楊梅區,瑞溪里,944,1541,472,110,582,18,600
公投第８案,桃園市,楊梅區,瑞溪里,945,1938,714,173,887,51,938
公投第８案,桃園市,楊梅區,金溪里,946,1562,525,142,667,20,687
公投第８案,桃園市,楊梅區,金溪里,947,2125,778,331,1109,67,1176
公投第８案,桃園市,楊梅區,三民里,948,1516,653,184,837,48,885
公投第８案,桃園市,楊梅區,三民里,949,1807,677,174,851,38,889
公投第８案,桃園市,楊梅區,楊明里,950,2101,728,214,942,49,991
公投第８案,桃園市,楊梅區,楊明里,951,2054,802,211,1013,64,1077
公投第８案,桃園市,楊梅區,楊明里,952,2226,816,172,988,36,1024
公投第８案,桃園市,楊梅區,裕成里,953,1405,573,152,725,23,748
公投第８案,桃園市,楊梅區,裕成里,954,1843,640,186,826,41,867
公投第８案,桃園市,楊梅區,裕新里,955,2324,794,204,998,62,1060
公投第８案,桃園市,楊梅區,大同里,956,1713,673,170,843,33,876
公投第８案,桃園市,楊梅區,大同里,957,1587,712,163,875,61,936
公投第８案,桃園市,楊梅區,中山里,958,1416,610,169,779,0,779
公投第８案,桃園市,楊梅區,中山里,959,1591,681,157,838,33,871
公投第８案,桃園市,楊梅區,楊梅里,960,1943,798,182,980,57,1037
公投第８案,桃園市,楊梅區,楊梅里,961,1762,682,280,962,43,1005
公投第８案,桃園市,楊梅區,楊江里,962,1083,443,91,534,38,572
公投第８案,桃園市,楊梅區,梅新里,963,2027,788,199,987,61,1048
公投第８案,桃園市,楊梅區,紅梅里,964,1274,524,140,664,64,728
公投第８案,桃園市,楊梅區,紅梅里,965,1359,592,136,728,53,781
公投第８案,桃園市,楊梅區,永寧里,966,2444,634,176,810,54,864
公投第８案,桃園市,楊梅區,永寧里,967,2298,754,187,941,40,981
公投第８案,桃園市,楊梅區,永寧里,968,2222,831,208,1039,48,1087
公投第８案,桃園市,楊梅區,大平里,969,1610,602,175,777,71,848
公投第８案,桃園市,楊梅區,大平里,970,1627,606,169,775,91,866
公投第８案,桃園市,楊梅區,秀才里,971,1589,647,157,804,57,861
公投第８案,桃園市,楊梅區,秀才里,972,1758,663,194,857,76,933
公投第８案,桃園市,楊梅區,東流里,973,1776,522,184,706,65,771
公投第８案,桃園市,楊梅區,東流里,974,1000,353,93,446,25,471
公投第８案,桃園市,楊梅區,豐野里,975,2290,787,175,962,81,1043
公投第８案,桃園市,楊梅區,豐野里,976,1551,570,186,756,61,817
公投第８案,桃園市,楊梅區,富岡里,977,1861,671,171,842,75,917
公投第８案,桃園市,楊梅區,富豐里,978,1141,370,116,486,52,538
公投第８案,桃園市,楊梅區,富豐里,979,1785,640,163,803,53,856
公投第８案,桃園市,楊梅區,員本里,980,1498,569,160,729,70,799
公投第８案,桃園市,楊梅區,員本里,981,1187,422,149,571,51,622
公投第８案,桃園市,楊梅區,三湖里,982,1270,505,144,649,60,709
公投第８案,桃園市,楊梅區,三湖里,983,1424,545,143,688,47,735
公投第８案,桃園市,楊梅區,頭湖里,984,1273,604,48,652,20,672
公投第８案,桃園市,楊梅區,頭湖里,985,1534,484,167,651,38,689
公投第８案,桃園市,楊梅區,上湖里,986,1783,552,182,734,80,814
公投第８案,桃園市,楊梅區,上湖里,987,1709,638,146,784,25,809
公投第８案,桃園市,楊梅區,上湖里,988,1920,659,162,821,63,884
公投第８案,桃園市,楊梅區,上田里,989,1194,465,127,592,33,625
公投第８案,桃園市,楊梅區,上田里,990,1408,554,170,724,19,743
公投第８案,桃園市,楊梅區,高山里,991,1737,595,144,739,37,776
公投第８案,桃園市,楊梅區,高山里,992,1920,747,160,907,31,938
公投第８案,桃園市,楊梅區,高上里,993,1234,479,145,624,34,658
公投第８案,桃園市,楊梅區,高上里,994,1491,590,172,762,67,829
公投第８案,桃園市,楊梅區,青山里,995,2020,697,195,892,49,941
公投第８案,桃園市,楊梅區,青山里,996,1863,642,159,801,34,835
公投第８案,桃園市,楊梅區,高榮里,997,1692,644,183,827,63,890
公投第８案,桃園市,楊梅區,高榮里,998,1686,691,144,835,35,870
公投第８案,桃園市,楊梅區,雙榮里,999,1626,637,184,821,73,894
公投第８案,桃園市,楊梅區,雙榮里,1000,1557,658,158,816,22,838
公投第８案,桃園市,楊梅區,新榮里,1001,1603,678,192,870,64,934
公投第８案,桃園市,楊梅區,新榮里,1002,1889,648,190,838,87,925
公投第８案,桃園市,楊梅區,水美里,1003,1448,620,140,760,30,790
公投第８案,桃園市,楊梅區,水美里,1004,1351,554,162,716,55,771
公投第８案,桃園市,楊梅區,水美里,1005,1313,571,132,703,60,763
公投第８案,桃園市,楊梅區,瑞原里,1006,1689,629,200,829,45,874
公投第８案,桃園市,楊梅區,瑞原里,1007,2063,710,195,905,33,938
公投第８案,桃園市,龍潭區,黃唐里,1008,1482,568,139,707,28,735
公投第８案,桃園市,龍潭區,黃唐里,1009,1528,565,155,720,51,771
公投第８案,桃園市,龍潭區,黃唐里,1010,1503,578,147,725,48,773
公投第８案,桃園市,龍潭區,永興里,1011,1568,570,170,740,54,794
公投第８案,桃園市,龍潭區,永興里,1012,1216,449,113,562,67,629
公投第８案,桃園市,龍潭區,中山里,1013,2088,670,197,867,82,949
公投第８案,桃園市,龍潭區,中山里,1014,1987,828,205,1033,79,1112
公投第８案,桃園市,龍潭區,中山里,1015,1586,702,161,863,50,913
公投第８案,桃園市,龍潭區,烏樹林里,1016,1221,407,165,572,46,618
公投第８案,桃園市,龍潭區,烏樹林里,1017,1134,449,136,585,54,639
公投第８案,桃園市,龍潭區,烏林里,1018,2081,716,203,919,62,981
公投第８案,桃園市,龍潭區,烏林里,1019,1925,547,283,830,43,873
公投第８案,桃園市,龍潭區,百年里,1020,2095,928,154,1082,37,1119
公投第８案,桃園市,龍潭區,百年里,1021,2040,951,150,1101,59,1160
公投第８案,桃園市,龍潭區,凌雲里,1022,1790,630,192,822,59,881
公投第８案,桃園市,龍潭區,凌雲里,1023,1872,697,225,922,96,1018
公投第８案,桃園市,龍潭區,龍祥里,1024,1726,692,206,898,77,975
公投第８案,桃園市,龍潭區,龍祥里,1025,1792,709,205,914,60,974
公投第８案,桃園市,龍潭區,八德里,1026,1398,548,145,693,38,731
公投第８案,桃園市,龍潭區,八德里,1027,1345,489,129,618,44,662
公投第８案,桃園市,龍潭區,八德里,1028,1409,585,134,719,51,770
公投第８案,桃園市,龍潭區,聖德里,1029,1362,470,136,606,28,634
公投第８案,桃園市,龍潭區,聖德里,1030,1650,668,213,881,55,936
公投第８案,桃園市,龍潭區,上林里,1031,1597,623,165,788,44,832
公投第８案,桃園市,龍潭區,上林里,1032,1410,546,154,700,36,736
公投第８案,桃園市,龍潭區,上林里,1033,1275,511,145,656,54,710
公投第８案,桃園市,龍潭區,龍潭里,1034,1909,771,250,1021,66,1087
公投第８案,桃園市,龍潭區,龍星里,1035,2024,851,205,1056,33,1089
公投第８案,桃園市,龍潭區,龍星里,1036,2002,812,205,1017,59,1076
公投第８案,桃園市,龍潭區,中正里,1037,1786,751,205,956,52,1008
公投第８案,桃園市,龍潭區,中正里,1038,1756,707,143,850,44,894
公投第８案,桃園市,龍潭區,中正里,1039,1830,781,181,962,37,999
公投第８案,桃園市,龍潭區,上華里,1040,1697,791,173,964,32,996
公投第８案,桃園市,龍潭區,上華里,1041,1519,659,127,786,38,824
公投第８案,桃園市,龍潭區,九龍里,1042,1805,674,163,837,50,887
公投第８案,桃園市,龍潭區,九龍里,1043,1792,633,137,770,42,812
公投第８案,桃園市,龍潭區,武漢里,1044,1500,657,153,810,65,875
公投第８案,桃園市,龍潭區,祥和里,1045,1427,522,138,660,31,691
公投第８案,桃園市,龍潭區,東興里,1046,1444,480,130,610,45,655
公投第８案,桃園市,龍潭區,東興里,1047,1321,505,121,626,45,671
公投第８案,桃園市,龍潭區,東興里,1048,1215,542,148,690,40,730
公投第８案,桃園市,龍潭區,中興里,1049,1297,491,139,630,64,694
公投第８案,桃園市,龍潭區,中興里,1050,1407,545,122,667,17,684
公投第８案,桃園市,龍潭區,中興里,1051,1564,563,160,723,49,772
公投第８案,桃園市,龍潭區,北興里,1052,1317,498,145,643,58,701
公投第８案,桃園市,龍潭區,北興里,1053,1023,383,78,461,47,508
公投第８案,桃園市,龍潭區,佳安里,1054,1721,670,188,858,62,920
公投第８案,桃園市,龍潭區,佳安里,1055,1764,754,152,906,69,975
公投第８案,桃園市,龍潭區,三坑里,1056,1499,467,264,731,71,802
公投第８案,桃園市,龍潭區,大平里,1057,2151,766,180,946,52,998
公投第８案,桃園市,龍潭區,三林里,1058,1524,691,124,815,31,846
公投第８案,桃園市,龍潭區,三林里,1059,1456,679,154,833,29,862
公投第８案,桃園市,龍潭區,建林里,1060,1847,905,156,1061,48,1109
公投第８案,桃園市,龍潭區,建林里,1061,1899,923,173,1096,32,1128
公投第８案,桃園市,龍潭區,富林里,1062,1725,730,161,891,38,929
公投第８案,桃園市,龍潭區,富林里,1063,1665,786,169,955,56,1011
公投第８案,桃園市,龍潭區,高平里,1064,1649,625,146,771,42,813
公投第８案,桃園市,龍潭區,高平里,1065,1539,556,138,694,44,738
公投第８案,桃園市,龍潭區,高原里,1066,1541,551,176,727,60,787
公投第８案,桃園市,龍潭區,高原里,1067,1375,545,150,695,55,750
公投第８案,桃園市,龍潭區,高原里,1068,1453,587,163,750,33,783
公投第８案,桃園市,龍潭區,三和里,1069,1074,443,125,568,49,617
公投第８案,桃園市,龍潭區,三和里,1070,1299,607,131,738,16,754
公投第８案,桃園市,龍潭區,三水里,1071,678,188,99,287,30,317
公投第８案,桃園市,新屋區,新屋里,1072,1306,581,146,727,29,756
公投第８案,桃園市,新屋區,新屋里,1073,1556,606,211,817,46,863
公投第８案,桃園市,新屋區,新生里,1074,1849,811,230,1041,76,1117
公投第８案,桃園市,新屋區,新生里,1075,2096,862,279,1141,74,1215
公投第８案,桃園市,新屋區,後湖里,1076,1517,545,199,744,52,796
公投第８案,桃園市,新屋區,清華里,1077,2095,881,247,1128,72,1200
公投第８案,桃園市,新屋區,清華里,1078,1856,622,188,810,48,858
公投第８案,桃園市,新屋區,石磊里,1079,1986,782,242,1024,71,1095
公投第８案,桃園市,新屋區,東明里,1080,1425,475,157,632,52,684
公投第８案,桃園市,新屋區,社子里,1081,1385,487,149,636,37,673
公投第８案,桃園市,新屋區,埔頂里,1082,1271,537,193,730,51,781
公投第８案,桃園市,新屋區,埔頂里,1083,1271,486,158,644,37,681
公投第８案,桃園市,新屋區,九斗里,1084,1234,467,182,649,54,703
公投第８案,桃園市,新屋區,九斗里,1085,1085,406,144,550,55,605
公投第８案,桃園市,新屋區,頭洲里,1086,1992,812,224,1036,42,1078
公投第８案,桃園市,新屋區,頭洲里,1087,2032,836,276,1112,80,1192
公投第８案,桃園市,新屋區,大坡里,1088,1291,482,153,635,70,705
公投第８案,桃園市,新屋區,望間里,1089,1401,487,153,640,43,683
公投第８案,桃園市,新屋區,後庄里,1090,1106,446,148,594,53,647
公投第８案,桃園市,新屋區,蚵間里,1091,908,323,114,437,18,455
公投第８案,桃園市,新屋區,深圳里,1092,663,267,102,369,39,408
公投第８案,桃園市,新屋區,槺榔里,1093,1088,393,130,523,54,577
公投第８案,桃園市,新屋區,笨港里,1094,1050,460,155,615,54,669
公投第８案,桃園市,新屋區,永安里,1095,896,373,102,475,30,505
公投第８案,桃園市,新屋區,永安里,1096,1369,578,150,728,90,818
公投第８案,桃園市,新屋區,永興里,1097,995,311,134,445,38,483
公投第８案,桃園市,新屋區,下埔里,1098,741,292,85,377,25,402
公投第８案,桃園市,新屋區,石牌里,1099,943,368,149,517,65,582
公投第８案,桃園市,新屋區,下田里,1100,1714,584,195,779,99,878
公投第８案,桃園市,新屋區,赤欄里,1101,1340,535,147,682,19,701
公投第８案,桃園市,觀音區,觀音里,1102,1371,452,129,581,38,619
公投第８案,桃園市,觀音區,觀音里,1103,1362,406,117,523,33,556
公投第８案,桃園市,觀音區,白玉里,1104,997,334,128,462,74,536
公投第８案,桃園市,觀音區,廣興里,1105,1407,484,121,605,34,639
公投第８案,桃園市,觀音區,大潭里,1106,1692,637,194,831,38,869
公投第８案,桃園市,觀音區,保生里,1107,1279,484,133,617,25,642
公投第８案,桃園市,觀音區,保生里,1108,791,303,86,389,19,408
公投第８案,桃園市,觀音區,武威里,1109,892,352,110,462,41,503
公投第８案,桃園市,觀音區,三和里,1110,886,398,109,507,25,532
公投第８案,桃園市,觀音區,新興里,1111,712,273,82,355,40,395
公投第８案,桃園市,觀音區,坑尾里,1112,1609,507,196,703,110,813
公投第８案,桃園市,觀音區,金湖里,1113,1274,489,159,648,57,705
公投第８案,桃園市,觀音區,金湖里,1114,1351,431,121,552,25,577
公投第８案,桃園市,觀音區,藍埔里,1115,1262,522,151,673,55,728
公投第８案,桃園市,觀音區,藍埔里,1116,1242,474,160,634,76,710
公投第８案,桃園市,觀音區,大同里,1117,1461,525,170,695,71,766
公投第８案,桃園市,觀音區,大同里,1118,1613,583,179,762,54,816
公投第８案,桃園市,觀音區,大堀里,1119,1479,550,185,735,59,794
公投第８案,桃園市,觀音區,崙坪里,1120,1552,494,189,683,55,738
公投第８案,桃園市,觀音區,崙坪里,1121,1517,494,221,715,34,749
公投第８案,桃園市,觀音區,崙坪里,1122,1691,561,204,765,71,836
公投第８案,桃園市,觀音區,富源里,1123,1157,471,137,608,23,631
公投第８案,桃園市,觀音區,富源里,1124,1455,516,169,685,55,740
公投第８案,桃園市,觀音區,富源里,1125,1150,460,113,573,36,609
公投第８案,桃園市,觀音區,上大里,1126,1112,444,143,587,39,626
公投第８案,桃園市,觀音區,上大里,1127,1251,560,25,585,21,606
公投第８案,桃園市,觀音區,新坡里,1128,1446,541,145,686,97,783
公投第８案,桃園市,觀音區,新坡里,1129,1493,502,187,689,96,785
公投第８案,桃園市,觀音區,廣福里,1130,1339,487,151,638,64,702
公投第８案,桃園市,觀音區,廣福里,1131,1137,481,139,620,35,655
公投第８案,桃園市,觀音區,塔腳里,1132,1043,372,104,476,48,524
公投第８案,桃園市,觀音區,保障里,1133,993,312,105,417,42,459
公投第８案,桃園市,觀音區,保障里,1134,975,311,142,453,28,481
公投第８案,桃園市,觀音區,草漯里,1135,2029,624,195,819,43,862
公投第８案,桃園市,觀音區,草新里,1136,1765,678,221,899,41,940
公投第８案,桃園市,觀音區,草新里,1137,1809,668,197,865,51,916
公投第８案,桃園市,觀音區,草新里,1138,1869,650,203,853,42,895
公投第８案,桃園市,觀音區,樹林里,1139,1870,595,153,748,61,809
公投第８案,桃園市,觀音區,樹林里,1140,1932,480,159,639,46,685
公投第８案,桃園市,觀音區,富林里,1141,899,261,87,348,14,362
公投第８案,桃園市,觀音區,富林里,1142,985,311,79,390,19,409
