公投案編號,縣市,行政區,村里,投開票所,投票權人數,同意票數,不同意票數,有效票數,無效票數,投票人數
公投第７案,連江縣,,,,11205,4843,655,5498,235,5733
公投第７案,金門縣,,,,122695,35436,6045,41481,2336,43817
公投第７案,宜蘭縣,,,,386089,153113,42257,195370,16537,211907
公投第７案,新竹縣,,,,445051,191602,45444,237046,12685,249731
公投第７案,苗栗縣,,,,461580,198009,47324,245333,15647,260980
公投第７案,彰化縣,,,,1066994,452334,111030,563364,45223,608587
公投第７案,南投縣,,,,427089,187162,41641,228803,15881,244684
公投第７案,雲林縣,,,,584480,213508,57394,270902,26295,297197
公投第７案,嘉義縣,,,,442775,155084,42921,198005,21707,219712
公投第７案,屏東縣,,,,711720,259443,70573,330016,33128,363144
公投第７案,臺東縣,,,,185996,67881,17418,85299,8509,93808
公投第７案,花蓮縣,,,,278059,108373,25734,134107,10391,144498
公投第７案,澎湖縣,,,,90405,29508,7117,36625,3289,39914
公投第７案,基隆市,,,,320030,121863,31714,153577,9450,163027
公投第７案,新竹市,,,,351775,147391,39438,186829,9769,196598
公投第７案,嘉義市,,,,221553,86276,24205,110481,7639,118120
公投第７案,臺北市,,,,2228430,924026,277072,1201098,77356,1278454
公投第７案,高雄市,,,,2353342,990802,272337,1263139,92579,1355718
公投第７案,新北市,,,,3375513,1346167,373414,1719581,127273,1846854
公投第７案,臺中市,,,,2295642,1013174,234816,1247990,71112,1319102
公投第７案,臺南市,,,,1594821,572230,167275,739505,59206,798711
公投第７案,桃園市,,,,1801823,697528,173333,870861,48893,919754
公投第７案,連江縣,東引鄉,,,1138,512,52,564,15,579
公投第７案,連江縣,南竿鄉,,,6461,2773,367,3140,133,3273
公投第７案,連江縣,北竿鄉,,,2125,914,141,1055,47,1102
公投第７案,連江縣,莒光鄉,,,1481,644,95,739,40,779
公投第７案,金門縣,金湖鎮,,,25915,7615,1324,8939,545,9484
公投第７案,金門縣,烈嶼鄉,,,11676,3546,506,4052,212,4264
公投第７案,金門縣,烏坵鄉,,,567,138,16,154,11,165
公投第７案,金門縣,金沙鎮,,,18560,5261,868,6129,431,6560
公投第７案,金門縣,金寧鄉,,,28162,8151,1507,9658,503,10161
公投第７案,金門縣,金城鎮,,,37815,10725,1824,12549,634,13183
公投第７案,宜蘭縣,壯圍鄉,,,21447,8549,2410,10959,1263,12222
公投第７案,宜蘭縣,大同鄉,,,4935,1644,443,2087,240,2327
公投第７案,宜蘭縣,冬山鄉,,,45405,17752,4886,22638,1528,24166
公投第７案,宜蘭縣,三星鄉,,,19051,6988,2021,9009,924,9933
公投第７案,宜蘭縣,五結鄉,,,34892,13493,3720,17213,1321,18534
公投第７案,宜蘭縣,員山鄉,,,28131,10584,2958,13542,1477,15019
公投第７案,宜蘭縣,蘇澳鎮,,,34512,13719,3778,17497,1713,19210
公投第７案,宜蘭縣,羅東鎮,,,57686,24091,6724,30815,2259,33074
公投第７案,宜蘭縣,頭城鎮,,,25135,9800,2648,12448,1309,13757
公投第７案,宜蘭縣,南澳鄉,,,4644,2007,429,2436,203,2639
公投第７案,宜蘭縣,礁溪鄉,,,31084,11862,3428,15290,1265,16555
公投第７案,宜蘭縣,宜蘭市,,,79167,32624,8812,41436,3035,44471
公投第７案,新竹縣,五峰鄉,,,3997,1242,331,1573,75,1648
公投第７案,新竹縣,芎林鄉,,,17293,7631,1895,9526,592,10118
公投第７案,新竹縣,北埔鄉,,,8180,3535,782,4317,227,4544
公投第７案,新竹縣,新豐鄉,,,45790,19499,4612,24111,1385,25496
公投第７案,新竹縣,尖石鄉,,,7364,2358,565,2923,210,3133
公投第７案,新竹縣,寶山鄉,,,12973,5773,1417,7190,398,7588
公投第７案,新竹縣,關西鎮,,,24712,10714,2451,13165,803,13968
公投第７案,新竹縣,竹東鎮,,,78794,32641,7500,40141,2098,42239
公投第７案,新竹縣,新埔鎮,,,28894,12327,2899,15226,971,16197
公投第７案,新竹縣,橫山鄉,,,11346,5073,1166,6239,430,6669
公投第７案,新竹縣,湖口鄉,,,63511,27505,6227,33732,1748,35480
公投第７案,新竹縣,峨眉鄉,,,5068,2238,570,2808,242,3050
公投第７案,新竹縣,竹北市,,,137129,61066,15029,76095,3506,79601
公投第７案,苗栗縣,竹南鎮,,,68528,29221,6996,36217,2120,38337
公投第７案,苗栗縣,大湖鄉,,,12653,5128,1137,6265,458,6723
公投第７案,苗栗縣,公館鄉,,,28318,12634,3027,15661,1054,16715
公投第７案,苗栗縣,泰安鄉,,,5180,2518,616,3134,240,3374
公投第７案,苗栗縣,頭屋鄉,,,9390,4766,1012,5778,308,6086
公投第７案,苗栗縣,西湖鄉,,,6382,2724,617,3341,184,3525
公投第７案,苗栗縣,銅鑼鄉,,,15424,6726,1472,8198,444,8642
公投第７案,苗栗縣,三義鄉,,,13889,6388,1334,7722,413,8135
公投第７案,苗栗縣,獅潭鄉,,,3968,1552,324,1876,143,2019
公投第７案,苗栗縣,三灣鄉,,,5852,2464,651,3115,260,3375
公投第７案,苗栗縣,南庄鄉,,,8784,3104,893,3997,311,4308
公投第７案,苗栗縣,苗栗市,,,74249,33815,7069,40884,1931,42815
公投第７案,苗栗縣,造橋鄉,,,11027,4744,1156,5900,515,6415
公投第７案,苗栗縣,頭份市,,,83617,36143,8496,44639,2330,46969
公投第７案,苗栗縣,苑裡鎮,,,38890,15998,4451,20449,1621,22070
公投第７案,苗栗縣,卓蘭鎮,,,14772,6482,1521,8003,538,8541
公投第７案,苗栗縣,通霄鎮,,,29709,11314,3282,14596,1351,15947
公投第７案,苗栗縣,後龍鎮,,,30948,12288,3270,15558,1426,16984
公投第７案,彰化縣,秀水鄉,,,32394,14290,3569,17859,1289,19148
公投第７案,彰化縣,溪湖鎮,,,45147,19566,4696,24262,1832,26094
公投第７案,彰化縣,線西鄉,,,14065,6361,1367,7728,637,8365
公投第７案,彰化縣,福興鄉,,,39745,15627,3996,19623,1927,21550
公投第７案,彰化縣,和美鎮,,,75286,32445,7579,40024,2554,42578
公投第７案,彰化縣,員林市,,,102028,43129,10985,54114,3431,57545
公投第７案,彰化縣,鹿港鎮,,,70505,30219,7228,37447,3228,40675
公投第７案,彰化縣,北斗鎮,,,27593,11915,2859,14774,1294,16068
公投第７案,彰化縣,彰化市,,,190995,85910,21752,107662,7322,114984
公投第７案,彰化縣,田尾鄉,,,23179,10126,2487,12613,1014,13627
公投第７案,彰化縣,田中鎮,,,35391,14996,3604,18600,1687,20287
公投第７案,彰化縣,社頭鄉,,,36306,15452,3889,19341,1416,20757
公投第７案,彰化縣,埤頭鄉,,,25677,9819,2728,12547,1343,13890
公投第７案,彰化縣,大城鄉,,,14713,4053,953,5006,598,5604
公投第７案,彰化縣,芳苑鄉,,,29291,10149,2400,12549,1685,14234
公投第７案,彰化縣,溪州鄉,,,25405,9269,2429,11698,1177,12875
公投第７案,彰化縣,竹塘鄉,,,12821,4837,1264,6101,710,6811
公投第７案,彰化縣,芬園鄉,,,20408,8346,1976,10322,960,11282
公投第７案,彰化縣,埔鹽鄉,,,28026,12676,2865,15541,1323,16864
公投第７案,彰化縣,永靖鄉,,,31239,13632,3376,17008,1436,18444
公投第７案,彰化縣,埔心鄉,,,29642,13153,3544,16697,1503,18200
公投第７案,彰化縣,大村鄉,,,31492,13893,3300,17193,1265,18458
公投第７案,彰化縣,二水鄉,,,13339,5683,1607,7290,694,7984
公投第７案,彰化縣,伸港鄉,,,30407,13300,2650,15950,1254,17204
公投第７案,彰化縣,二林鎮,,,42976,16535,3868,20403,1952,22355
公投第７案,彰化縣,花壇鄉,,,38924,16953,4059,21012,1692,22704
公投第７案,南投縣,名間鄉,,,33408,14946,3387,18333,1622,19955
公投第７案,南投縣,中寮鄉,,,13181,5701,1272,6973,633,7606
公投第７案,南投縣,水里鄉,,,15458,6511,1422,7933,589,8522
公投第７案,南投縣,國姓鄉,,,16597,7165,1490,8655,629,9284
公投第７案,南投縣,仁愛鄉,,,12589,5087,1090,6177,467,6644
公投第７案,南投縣,信義鄉,,,13299,5246,1259,6505,961,7466
公投第７案,南投縣,竹山鎮,,,47034,18659,5202,23861,1821,25682
公投第７案,南投縣,魚池鄉,,,13958,5746,1277,7023,536,7559
公投第７案,南投縣,草屯鎮,,,82922,37026,8133,45159,2518,47677
公投第７案,南投縣,集集鎮,,,9611,4068,1045,5113,418,5531
公投第７案,南投縣,鹿谷鄉,,,15941,6543,1383,7926,587,8513
公投第７案,南投縣,埔里鎮,,,68763,30711,6093,36804,2423,39227
公投第７案,南投縣,南投市,,,84328,39753,8588,48341,2677,51018
公投第７案,雲林縣,水林鄉,,,22508,6599,1794,8393,1086,9479
公投第７案,雲林縣,大埤鄉,,,16509,5988,1651,7639,738,8377
公投第７案,雲林縣,斗六市,,,89761,38874,9361,48235,2719,50954
公投第７案,雲林縣,虎尾鎮,,,58167,22521,5890,28411,2061,30472
公投第７案,雲林縣,斗南鎮,,,38138,15804,4072,19876,1529,21405
公投第７案,雲林縣,林內鄉,,,15551,6202,1601,7803,942,8745
公投第７案,雲林縣,二崙鄉,,,23367,7403,2281,9684,1247,10931
公投第７案,雲林縣,古坑鄉,,,27477,10321,2757,13078,1145,14223
公投第７案,雲林縣,莿桐鄉,,,24570,9304,2727,12031,1428,13459
公投第７案,雲林縣,北港鎮,,,33958,12837,3548,16385,1884,18269
公投第７案,雲林縣,土庫鎮,,,24412,8902,2454,11356,1302,12658
公投第７案,雲林縣,口湖鄉,,,24193,7648,2080,9728,1405,11133
公投第７案,雲林縣,元長鄉,,,22830,6583,1928,8511,1043,9554
公投第７案,雲林縣,麥寮鄉,,,37119,12437,3759,16196,1781,17977
公投第７案,雲林縣,四湖鄉,,,20983,5552,1552,7104,889,7993
公投第７案,雲林縣,褒忠鄉,,,11381,4069,1127,5196,511,5707
公投第７案,雲林縣,臺西鄉,,,21125,6679,1728,8407,1093,9500
公投第７案,雲林縣,崙背鄉,,,21050,6925,2106,9031,970,10001
公投第７案,雲林縣,東勢鄉,,,13239,4542,1181,5723,742,6465
公投第７案,雲林縣,西螺鎮,,,38142,14318,3797,18115,1780,19895
公投第７案,嘉義縣,朴子市,,,35191,12753,3455,16208,1714,17922
公投第７案,嘉義縣,東石鄉,,,21915,5735,1576,7311,1164,8475
公投第７案,嘉義縣,大林鎮,,,26922,9837,2605,12442,1126,13568
公投第７案,嘉義縣,太保市,,,31568,11773,3217,14990,1411,16401
公投第７案,嘉義縣,竹崎鄉,,,31228,11147,3039,14186,1393,15579
公投第７案,嘉義縣,水上鄉,,,43857,16150,4702,20852,2000,22852
公投第７案,嘉義縣,民雄鄉,,,61209,22895,6700,29595,2904,32499
公投第７案,嘉義縣,六腳鄉,,,20821,5958,1540,7498,959,8457
公投第７案,嘉義縣,溪口鄉,,,13105,4446,1304,5750,716,6466
公投第７案,嘉義縣,番路鄉,,,10156,4089,968,5057,508,5565
公投第７案,嘉義縣,鹿草鄉,,,13937,4397,1220,5617,904,6521
公投第７案,嘉義縣,新港鄉,,,27342,9871,2914,12785,1636,14421
公投第７案,嘉義縣,梅山鄉,,,17083,6588,1785,8373,882,9255
公投第７案,嘉義縣,大埔鄉,,,3999,1555,392,1947,167,2114
公投第７案,嘉義縣,中埔鄉,,,39139,12785,3594,16379,1538,17917
公投第７案,嘉義縣,阿里山鄉,,,4691,1295,297,1592,447,2039
公投第７案,嘉義縣,義竹鄉,,,16647,5818,1526,7344,901,8245
公投第７案,嘉義縣,布袋鎮,,,23965,7992,2087,10079,1337,11416
公投第７案,屏東縣,屏東市,,,170148,66120,17114,83234,5603,88837
公投第７案,屏東縣,新園鄉,,,30706,10874,3150,14024,1928,15952
公投第７案,屏東縣,來義鄉,,,6257,2655,554,3209,362,3571
公投第７案,屏東縣,瑪家鄉,,,5663,2394,657,3051,223,3274
公投第７案,屏東縣,潮州鎮,,,46444,17240,4550,21790,1878,23668
公投第７案,屏東縣,恆春鎮,,,25661,8909,2055,10964,842,11806
公投第７案,屏東縣,麟洛鄉,,,9970,4077,1077,5154,408,5562
公投第７案,屏東縣,里港鄉,,,22128,8226,2453,10679,1363,12042
公投第７案,屏東縣,九如鄉,,,19132,7108,1976,9084,1227,10311
公投第７案,屏東縣,長治鄉,,,26256,9969,2844,12813,1489,14302
公投第７案,屏東縣,東港鎮,,,39495,14549,3955,18504,2301,20805
公投第７案,屏東縣,萬丹鄉,,,43478,15892,4655,20547,2197,22744
公投第７案,屏東縣,內埔鄉,,,47558,15808,4258,20066,1854,21920
公投第７案,屏東縣,萬巒鄉,,,17945,6002,1899,7901,986,8887
公投第７案,屏東縣,高樹鄉,,,21697,6898,2226,9124,1225,10349
公投第７案,屏東縣,竹田鄉,,,15353,6113,1793,7906,867,8773
公投第７案,屏東縣,枋寮鄉,,,21394,7667,2168,9835,1370,11205
公投第７案,屏東縣,新埤鄉,,,9033,3096,909,4005,465,4470
公投第７案,屏東縣,鹽埔鄉,,,22402,8036,2168,10204,1173,11377
公投第７案,屏東縣,南州鄉,,,9479,3479,966,4445,493,4938
公投第７案,屏東縣,車城鄉,,,7595,2167,580,2747,279,3026
公投第７案,屏東縣,林邊鄉,,,15691,5897,1721,7618,991,8609
公投第７案,屏東縣,佳冬鄉,,,17063,5700,1644,7344,1050,8394
公投第７案,屏東縣,琉球鄉,,,10706,3306,726,4032,551,4583
公投第７案,屏東縣,崁頂鄉,,,12270,4496,1231,5727,563,6290
公投第７案,屏東縣,三地門鄉,,,6373,2295,606,2901,279,3180
公投第７案,屏東縣,滿州鄉,,,7206,2211,556,2767,240,3007
公投第７案,屏東縣,春日鄉,,,3923,767,215,982,56,1038
公投第７案,屏東縣,枋山鄉,,,4856,1689,484,2173,236,2409
公投第７案,屏東縣,霧臺鄉,,,2950,1151,301,1452,109,1561
公投第７案,屏東縣,泰武鄉,,,4344,1895,515,2410,287,2697
公投第７案,屏東縣,牡丹鄉,,,4314,1348,280,1628,104,1732
公投第７案,屏東縣,獅子鄉,,,4230,1409,287,1696,129,1825
公投第７案,臺東縣,綠島鄉,,,3579,1183,276,1459,90,1549
公投第７案,臺東縣,蘭嶼鄉,,,4181,1020,384,1404,113,1517
公投第７案,臺東縣,長濱鄉,,,6484,1686,496,2182,409,2591
公投第７案,臺東縣,達仁鄉,,,3137,1240,337,1577,188,1765
公投第７案,臺東縣,臺東市,,,87803,35634,8420,44054,3184,47238
公投第７案,臺東縣,鹿野鄉,,,6936,2114,674,2788,299,3087
公投第７案,臺東縣,卑南鄉,,,14976,5493,1478,6971,819,7790
公投第７案,臺東縣,海端鄉,,,3278,1151,383,1534,197,1731
公投第７案,臺東縣,太麻里鄉,,,9666,3129,898,4027,521,4548
公投第７案,臺東縣,池上鄉,,,7162,2353,585,2938,311,3249
公投第７案,臺東縣,大武鄉,,,5266,1658,485,2143,528,2671
公投第７案,臺東縣,東河鄉,,,7635,2149,636,2785,421,3206
公投第７案,臺東縣,延平鄉,,,2930,1008,311,1319,190,1509
公投第７案,臺東縣,關山鎮,,,7509,2816,631,3447,232,3679
公投第７案,臺東縣,成功鎮,,,12426,4157,1106,5263,802,6065
公投第７案,臺東縣,金峰鄉,,,3028,1090,318,1408,205,1613
公投第７案,花蓮縣,光復鄉,,,11417,4079,1077,5156,659,5815
公投第７案,花蓮縣,新城鄉,,,17029,6963,1575,8538,621,9159
公投第７案,花蓮縣,豐濱鄉,,,4395,1236,386,1622,276,1898
公投第７案,花蓮縣,鳳林鎮,,,9676,3909,897,4806,493,5299
公投第７案,花蓮縣,花蓮市,,,84807,35174,7825,42999,2424,45423
公投第７案,花蓮縣,富里鄉,,,9065,2909,736,3645,470,4115
公投第７案,花蓮縣,卓溪鄉,,,4947,1889,515,2404,276,2680
公投第７案,花蓮縣,秀林鄉,,,12562,4415,1109,5524,477,6001
公投第７案,花蓮縣,萬榮鄉,,,5269,1872,625,2497,331,2828
公投第７案,花蓮縣,吉安鄉,,,72116,29187,6603,35790,2064,37854
公投第７案,花蓮縣,玉里鎮,,,20650,6862,1752,8614,1061,9675
公投第７案,花蓮縣,瑞穗鄉,,,10279,3616,910,4526,493,5019
公投第７案,花蓮縣,壽豐鄉,,,15847,6262,1724,7986,746,8732
公投第７案,澎湖縣,馬公市,,,53655,19408,4608,24016,1799,25815
公投第７案,澎湖縣,湖西鄉,,,12741,3956,930,4886,459,5345
公投第７案,澎湖縣,望安鄉,,,4628,1256,302,1558,196,1754
公投第７案,澎湖縣,七美鄉,,,3374,712,180,892,102,994
公投第７案,澎湖縣,西嶼鄉,,,7382,1641,409,2050,367,2417
公投第７案,澎湖縣,白沙鄉,,,8625,2535,688,3223,366,3589
公投第７案,基隆市,安樂區,,,70396,27453,6944,34397,1844,36241
公投第７案,基隆市,七堵區,,,46256,17808,4870,22678,1506,24184
公投第７案,基隆市,中正區,,,45545,15640,4183,19823,1380,21203
公投第７案,基隆市,仁愛區,,,36738,14062,3933,17995,1508,19503
公投第７案,基隆市,中山區,,,41856,15400,4324,19724,1228,20952
公投第７案,基隆市,暖暖區,,,33225,13090,3210,16300,842,17142
公投第７案,基隆市,信義區,,,46014,18410,4250,22660,1142,23802
公投第７案,新竹市,東區,,,163757,69070,19030,88100,4123,92223
公投第７案,新竹市,香山區,,,64896,27405,6894,34299,1973,36272
公投第７案,新竹市,北區,,,123122,50916,13514,64430,3673,68103
公投第７案,嘉義市,西區,,,120906,47018,13046,60064,4301,64365
公投第７案,嘉義市,東區,,,100647,39258,11159,50417,3338,53755
公投第７案,臺北市,南港區,,,101907,43217,12009,55226,3158,58384
公投第７案,臺北市,北投區,,,213250,85525,25619,111144,7721,118865
公投第７案,臺北市,士林區,,,241854,96156,31493,127649,9864,137513
公投第７案,臺北市,中山區,,,195148,78649,25050,103699,7022,110721
公投第７案,臺北市,內湖區,,,236824,101149,28663,129812,7239,137051
公投第７案,臺北市,大同區,,,107557,42497,14769,57266,4486,61752
公投第７案,臺北市,中正區,,,128292,54089,16359,70448,4232,74680
公投第７案,臺北市,文山區,,,227211,101174,26288,127462,7798,135260
公投第７案,臺北市,信義區,,,190444,80160,23245,103405,6057,109462
公投第７案,臺北市,松山區,,,169278,72344,21698,94042,5769,99811
公投第７案,臺北市,大安區,,,252645,104681,32294,136975,7388,144363
公投第７案,臺北市,萬華區,,,164020,64385,19585,83970,6622,90592
公投第７案,高雄市,旗山區,,,31996,12737,3373,16110,1400,17510
公投第７案,高雄市,永安區,,,12001,5315,1565,6880,606,7486
公投第７案,高雄市,梓官區,,,31025,12760,3460,16220,1448,17668
公投第７案,高雄市,彌陀區,,,16487,7027,1965,8992,1060,10052
公投第７案,高雄市,阿蓮區,,,24534,9426,2614,12040,871,12911
公投第７案,高雄市,湖內區,,,25729,10110,2791,12901,967,13868
公投第７案,高雄市,那瑪夏區,,,2424,979,254,1233,144,1377
公投第７案,高雄市,路竹區,,,43850,18361,5165,23526,1997,25523
公投第７案,高雄市,大社區,,,30046,11644,3867,15511,1271,16782
公投第７案,高雄市,鳥松區,,,39191,16980,4996,21976,1467,23443
公投第７案,高雄市,橋頭區,,,32565,14112,4123,18235,1669,19904
公投第７案,高雄市,岡山區,,,81244,37008,9109,46117,3112,49229
公投第７案,高雄市,仁武區,,,73611,31665,8127,39792,2375,42167
公投第７案,高雄市,田寮區,,,6671,2119,621,2740,340,3080
公投第７案,高雄市,前金區,,,23928,10022,3181,13203,900,14103
公投第７案,高雄市,旗津區,,,24860,8332,2706,11038,1261,12299
公投第７案,高雄市,大樹區,,,36772,14634,3834,18468,1480,19948
公投第７案,高雄市,苓雅區,,,146786,62964,18917,81881,5252,87133
公投第７案,高雄市,小港區,,,132733,55974,15327,71301,4956,76257
公投第７案,高雄市,鳳山區,,,300510,130829,33944,164773,11240,176013
公投第７案,高雄市,新興區,,,44355,18956,5836,24792,1698,26490
公投第７案,高雄市,左營區,,,161367,73230,18003,91233,5165,96398
公投第７案,高雄市,三民區,,,289519,121925,35486,157411,10419,167830
公投第７案,高雄市,鼓山區,,,114979,49511,13531,63042,3914,66956
公投第７案,高雄市,楠梓區,,,153132,66374,17502,83876,7019,90895
公投第７案,高雄市,大寮區,,,97309,40259,10438,50697,3833,54530
公投第７案,高雄市,林園區,,,59129,23394,6249,29643,2480,32123
公投第７案,高雄市,前鎮區,,,161797,66683,18986,85669,7156,92825
公投第７案,高雄市,鹽埕區,,,21617,8437,2797,11234,652,11886
公投第７案,高雄市,燕巢區,,,26012,10583,2759,13342,1259,14601
公投第７案,高雄市,六龜區,,,11501,3692,1075,4767,621,5388
公投第７案,高雄市,杉林區,,,10607,3301,981,4282,451,4733
公投第７案,高雄市,內門區,,,13002,4181,1233,5414,697,6111
公投第７案,高雄市,美濃區,,,35311,13876,3588,17464,1617,19081
公投第７案,高雄市,甲仙區,,,5417,1893,444,2337,260,2597
公投第７案,高雄市,桃源區,,,3498,1339,305,1644,99,1743
公投第７案,高雄市,茂林區,,,1615,809,166,975,79,1054
公投第７案,高雄市,茄萣區,,,26212,9361,3019,12380,1344,13724
公投第７案,新北市,新店區,,,264053,113797,26226,140023,8228,148251
公投第７案,新北市,新莊區,,,344981,140045,41204,181249,13774,195023
公投第７案,新北市,深坑區,,,20624,8193,2201,10394,716,11110
公投第７案,新北市,瑞芳區,,,35036,12211,3277,15488,1236,16724
公投第７案,新北市,坪林區,,,5891,2075,535,2610,311,2921
公投第７案,新北市,汐止區,,,173831,67547,18065,85612,5665,91277
公投第７案,新北市,石碇區,,,6861,2358,719,3077,309,3386
公投第７案,新北市,土城區,,,200783,78924,22140,101064,7807,108871
公投第７案,新北市,淡水區,,,147272,56960,15439,72399,4367,76766
公投第７案,新北市,鶯歌區,,,71645,27167,7924,35091,2344,37435
公投第７案,新北市,三峽區,,,94291,35739,10099,45838,3190,49028
公投第７案,新北市,蘆洲區,,,167457,62988,19193,82181,6888,89069
公投第７案,新北市,泰山區,,,64252,26020,6947,32967,2173,35140
公投第７案,新北市,樹林區,,,152102,60667,17206,77873,5482,83355
公投第７案,新北市,五股區,,,72443,27379,7871,35250,2856,38106
公投第７案,新北市,三重區,,,329846,128111,39417,167528,16104,183632
公投第７案,新北市,永和區,,,187798,83228,20414,103642,6419,110061
公投第７案,新北市,雙溪區,,,7999,2739,737,3476,373,3849
公投第７案,新北市,三芝區,,,20119,6999,1927,8926,704,9630
公投第７案,新北市,石門區,,,10528,3899,1018,4917,509,5426
公投第７案,新北市,中和區,,,355978,146208,37338,183546,12119,195665
公投第７案,新北市,林口區,,,86203,36042,9434,45476,2656,48132
公投第７案,新北市,烏來區,,,5264,2072,470,2542,161,2703
公投第７案,新北市,貢寮區,,,11279,3309,1075,4384,423,4807
公投第７案,新北市,金山區,,,18978,6853,1860,8713,843,9556
公投第７案,新北市,萬里區,,,19297,6883,1811,8694,854,9548
公投第７案,新北市,平溪區,,,4321,1428,412,1840,190,2030
公投第７案,新北市,板橋區,,,463411,183642,54962,238604,19309,257913
公投第７案,新北市,八里區,,,32970,12684,3493,16177,1263,17440
公投第７案,臺中市,西屯區,,,183814,82825,18412,101237,4948,106185
公投第７案,臺中市,中區,,,14696,6132,1541,7673,468,8141
公投第７案,臺中市,東區,,,64291,28395,6994,35389,2147,37536
公投第７案,臺中市,西區,,,95040,41855,10696,52551,2576,55127
公投第７案,臺中市,豐原區,,,136658,61483,15505,76988,4660,81648
公投第７案,臺中市,清水區,,,71528,32206,7100,39306,2489,41795
公投第７案,臺中市,新社區,,,20860,8246,1889,10135,651,10786
公投第７案,臺中市,東勢區,,,43181,18958,4311,23269,1783,25052
公投第７案,臺中市,南區,,,103643,48518,11525,60043,3309,63352
公投第７案,臺中市,北區,,,124621,53751,12471,66222,3239,69461
公投第７案,臺中市,北屯區,,,227720,100833,22423,123256,6126,129382
公投第７案,臺中市,南屯區,,,135448,63052,14504,77556,3946,81502
公投第７案,臺中市,梧棲區,,,47040,20303,4831,25134,1659,26793
公投第７案,臺中市,神岡區,,,54565,24223,5774,29997,1950,31947
公投第７案,臺中市,沙鹿區,,,74207,32234,7425,39659,2329,41988
公投第７案,臺中市,大甲區,,,63069,27122,6558,33680,2271,35951
公投第７案,臺中市,后里區,,,44962,20022,4396,24418,1587,26005
公投第７案,臺中市,潭子區,,,89487,39569,8853,48422,2553,50975
公投第７案,臺中市,大安區,,,16520,7288,1691,8979,734,9713
公投第７案,臺中市,大雅區,,,77189,33608,7469,41077,2236,43313
公投第７案,臺中市,外埔區,,,27059,12116,2667,14783,912,15695
公投第７案,臺中市,龍井區,,,63584,26747,6871,33618,1884,35502
公投第７案,臺中市,大肚區,,,47457,21090,4776,25866,1563,27429
公投第７案,臺中市,石岡區,,,12880,5735,1379,7114,477,7591
公投第７案,臺中市,烏日區,,,61705,27379,6443,33822,2087,35909
公投第７案,臺中市,太平區,,,157926,66181,14725,80906,4802,85708
公投第７案,臺中市,和平區,,,9498,4505,864,5369,309,5678
公投第７案,臺中市,大里區,,,171769,73521,16988,90509,5141,95650
公投第７案,臺中市,霧峰區,,,55225,25277,5735,31012,2276,33288
公投第７案,臺南市,東區,,,153359,59256,18165,77421,5127,82548
公投第７案,臺南市,仁德區,,,64632,24241,6852,31093,2493,33586
公投第７案,臺南市,歸仁區,,,57387,21131,6313,27444,2191,29635
公投第７案,臺南市,關廟區,,,29913,11016,3138,14154,1190,15344
公投第７案,臺南市,南區,,,108650,37899,11973,49872,4423,54295
公投第７案,臺南市,永康區,,,195001,73031,20165,93196,6228,99424
公投第７案,臺南市,南化區,,,7786,2581,694,3275,343,3618
公投第７案,臺南市,山上區,,,6511,1960,542,2502,264,2766
公投第７案,臺南市,楠西區,,,8528,2647,696,3343,312,3655
公投第７案,臺南市,玉井區,,,12357,4278,1046,5324,470,5794
公投第７案,臺南市,善化區,,,39950,14134,4332,18466,1553,20019
公投第７案,臺南市,安定區,,,26104,9675,2801,12476,1199,13675
公投第７案,臺南市,新市區,,,30386,11296,3511,14807,1203,16010
公投第７案,臺南市,將軍區,,,17754,5144,1406,6550,631,7181
公投第７案,臺南市,北門區,,,9925,2791,714,3505,286,3791
公投第７案,臺南市,新化區,,,37296,13968,3880,17848,1819,19667
公投第７案,臺南市,佳里區,,,50407,19007,4960,23967,1833,25800
公投第７案,臺南市,西港區,,,21564,7029,1898,8927,665,9592
公投第７案,臺南市,七股區,,,19950,6088,1601,7689,715,8404
公投第７案,臺南市,大內區,,,8654,2868,708,3576,450,4026
公投第７案,臺南市,下營區,,,20947,6734,1827,8561,882,9443
公投第７案,臺南市,東山區,,,18471,4639,1339,5978,743,6721
公投第７案,臺南市,六甲區,,,19144,6274,1934,8208,904,9112
公投第７案,臺南市,官田區,,,18675,6127,1935,8062,681,8743
公投第７案,臺南市,後壁區,,,20841,6384,1789,8173,1083,9256
公投第７案,臺南市,鹽水區,,,22121,7197,2115,9312,884,10196
公投第７案,臺南市,白河區,,,24894,7115,2194,9309,945,10254
公投第７案,臺南市,麻豆區,,,37963,12768,3962,16730,1110,17840
公投第７案,臺南市,學甲區,,,22567,7444,2145,9589,862,10451
公投第７案,臺南市,安南區,,,159654,58644,17005,75649,6515,82164
公投第７案,臺南市,左鎮區,,,4418,1315,348,1663,246,1909
公投第７案,臺南市,新營區,,,64949,23334,6243,29577,1931,31508
公投第７案,臺南市,柳營區,,,18804,6416,1700,8116,880,8996
公投第７案,臺南市,安平區,,,55379,19987,5922,25909,1649,27558
公投第７案,臺南市,北區,,,110906,41806,12882,54688,3681,58369
公投第７案,臺南市,中西區,,,65261,24805,8210,33015,2651,35666
公投第７案,臺南市,龍崎區,,,3713,1201,330,1531,164,1695
公投第７案,桃園市,大園區,,,73900,26894,7155,34049,2005,36054
公投第７案,桃園市,楊梅區,,,137917,54109,12102,66211,3373,69584
公投第７案,桃園市,大溪區,,,78285,30058,7843,37901,2974,40875
公投第７案,桃園市,蘆竹區,,,129252,48141,12964,61105,3805,64910
公投第７案,桃園市,新屋區,,,41461,17090,4471,21561,1267,22828
公投第７案,桃園市,八德區,,,165065,62058,15724,77782,4842,82624
公投第７案,桃園市,桃園區,,,359790,135663,36174,171837,9359,181196
公投第７案,桃園市,中壢區,,,334402,134509,31525,166034,8758,174792
公投第７案,桃園市,龜山區,,,131702,47936,12769,60705,3366,64071
公投第７案,桃園市,觀音區,,,55149,20514,5326,25840,1616,27456
公投第７案,桃園市,復興區,,,9766,3740,843,4583,355,4938
公投第７案,桃園市,龍潭區,,,101574,42077,9102,51179,2699,53878
公投第７案,桃園市,平鎮區,,,183560,74739,17335,92074,4474,96548
公投第７案,連江縣,南竿鄉,介壽村,1,1967,859,115,974,39,1013
公投第７案,連江縣,南竿鄉,福沃村、復興村,2,1837,723,105,828,50,878
公投第７案,連江縣,南竿鄉,清水村、珠螺村,3,1114,491,77,568,20,588
公投第７案,連江縣,南竿鄉,馬祖村、津沙村、四維村、仁愛村,4,1543,700,70,770,24,794
公投第７案,連江縣,北竿鄉,后沃村、橋仔村、塘岐村,5,1515,664,113,777,37,814
公投第７案,連江縣,北竿鄉,坂里村、白沙村、芹壁村,6,610,250,28,278,10,288
公投第７案,連江縣,莒光鄉,田沃村、西坵村、青帆村,7,698,279,38,317,18,335
公投第７案,連江縣,莒光鄉,大坪村、福正村,8,783,365,57,422,22,444
公投第７案,連江縣,東引鄉,樂華村、中柳村,9,1138,512,52,564,15,579
公投第７案,金門縣,金城鎮,東門里,1,1396,406,69,475,17,492
公投第７案,金門縣,金城鎮,東門里,2,1831,552,105,657,34,691
公投第７案,金門縣,金城鎮,東門里,3,1750,507,96,603,39,642
公投第７案,金門縣,金城鎮,南門里,4,1889,581,99,680,37,717
公投第７案,金門縣,金城鎮,南門里,5,1675,423,84,507,29,536
公投第７案,金門縣,金城鎮,南門里,6,1901,638,107,745,35,780
公投第７案,金門縣,金城鎮,西門里,7,1610,409,99,508,48,556
公投第７案,金門縣,金城鎮,西門里,8,1687,487,89,576,26,602
公投第７案,金門縣,金城鎮,西門里,9,1594,481,79,560,20,580
公投第７案,金門縣,金城鎮,西門里,10,1726,520,65,585,13,598
公投第７案,金門縣,金城鎮,西門里,11,1733,530,78,608,21,629
公投第７案,金門縣,金城鎮,西門里,12,1532,504,90,594,28,622
公投第７案,金門縣,金城鎮,北門里,13,2079,569,102,671,46,717
公投第７案,金門縣,金城鎮,北門里,14,2033,541,75,616,34,650
公投第７案,金門縣,金城鎮,賢庵里,15,2517,731,105,836,46,882
公投第７案,金門縣,金城鎮,賢庵里,16,2083,594,100,694,32,726
公投第７案,金門縣,金城鎮,金水里,17,2140,598,106,704,31,735
公投第７案,金門縣,金城鎮,古城里,18,2435,583,94,677,31,708
公投第７案,金門縣,金城鎮,古城里,19,1353,253,60,313,32,345
公投第７案,金門縣,金城鎮,珠沙里,20,1574,422,57,479,18,497
公投第７案,金門縣,金城鎮,珠沙里,21,1277,396,65,461,17,478
公投第７案,金門縣,金寧鄉,古寧村,22,1735,417,78,495,46,541
公投第７案,金門縣,金寧鄉,古寧村,23,1537,374,81,455,29,484
公投第７案,金門縣,金寧鄉,安美村,24,1766,454,98,552,39,591
公投第７案,金門縣,金寧鄉,安美村,25,1015,311,56,367,8,375
公投第７案,金門縣,金寧鄉,安美村,26,1726,486,80,566,48,614
公投第７案,金門縣,金寧鄉,湖埔村,27,1691,417,82,499,34,533
公投第７案,金門縣,金寧鄉,湖埔村,28,2044,637,191,828,37,865
公投第７案,金門縣,金寧鄉,湖埔村,29,1848,653,77,730,34,764
公投第７案,金門縣,金寧鄉,湖埔村,30,1735,527,77,604,0,604
公投第７案,金門縣,金寧鄉,榜林村,31,1795,510,86,596,31,627
公投第７案,金門縣,金寧鄉,榜林村,32,1834,467,73,540,42,582
公投第７案,金門縣,金寧鄉,榜林村,33,1528,419,67,486,24,510
公投第７案,金門縣,金寧鄉,盤山村,34,1473,483,62,545,23,568
公投第７案,金門縣,金寧鄉,盤山村,35,1679,490,72,562,38,600
公投第７案,金門縣,金寧鄉,盤山村,36,1921,707,196,903,28,931
公投第７案,金門縣,金寧鄉,盤山村,37,1298,389,62,451,16,467
公投第７案,金門縣,金寧鄉,后盤村,38,1537,410,69,479,26,505
公投第７案,金門縣,烈嶼鄉,林湖村,39,1647,630,62,692,30,722
公投第７案,金門縣,烈嶼鄉,林湖村,40,1733,511,72,583,34,617
公投第７案,金門縣,烈嶼鄉,黃埔村,41,1635,500,71,571,33,604
公投第７案,金門縣,烈嶼鄉,西口村,42,1296,355,61,416,24,440
公投第７案,金門縣,烈嶼鄉,西口村,43,1099,284,49,333,22,355
公投第７案,金門縣,烈嶼鄉,上林村,44,1425,409,65,474,22,496
公投第７案,金門縣,烈嶼鄉,上岐村,45,1412,425,73,498,27,525
公投第７案,金門縣,烈嶼鄉,上岐村,46,1429,432,53,485,20,505
公投第７案,金門縣,烏坵鄉,大坵村,47,275,68,7,75,3,78
公投第７案,金門縣,烏坵鄉,小坵村,48,292,70,9,79,8,87
公投第７案,金門縣,金湖鎮,新市里,49,1348,415,92,507,33,540
公投第７案,金門縣,金湖鎮,新市里,50,1386,364,69,433,53,486
公投第７案,金門縣,金湖鎮,新市里,51,1403,497,70,567,37,604
公投第７案,金門縣,金湖鎮,山外里,52,1771,553,92,645,28,673
公投第７案,金門縣,金湖鎮,山外里,53,1493,418,101,519,39,558
公投第７案,金門縣,金湖鎮,溪湖里,54,1510,444,57,501,34,535
公投第７案,金門縣,金湖鎮,蓮庵里,55,1607,509,65,574,38,612
公投第７案,金門縣,金湖鎮,料羅里,56,2006,540,85,625,45,670
公投第７案,金門縣,金湖鎮,新湖里,57,1780,516,102,618,23,641
公投第７案,金門縣,金湖鎮,新湖里,58,1739,533,81,614,21,635
公投第７案,金門縣,金湖鎮,新湖里,59,1384,386,67,453,25,478
公投第７案,金門縣,金湖鎮,新湖里,60,1400,428,71,499,29,528
公投第７案,金門縣,金湖鎮,新湖里,61,1325,468,95,563,22,585
公投第７案,金門縣,金湖鎮,正義里,62,1236,327,56,383,29,412
公投第７案,金門縣,金湖鎮,正義里,63,1382,366,71,437,35,472
公投第７案,金門縣,金湖鎮,瓊林里,64,1631,459,81,540,20,560
公投第７案,金門縣,金湖鎮,瓊林里,65,1514,392,69,461,34,495
公投第７案,金門縣,金沙鎮,汶沙里,66,1909,491,109,600,54,654
公投第７案,金門縣,金沙鎮,汶沙里,67,1524,511,75,586,39,625
公投第７案,金門縣,金沙鎮,汶沙里,68,1673,432,69,501,43,544
公投第７案,金門縣,金沙鎮,何斗里,69,2003,532,80,612,48,660
公投第７案,金門縣,金沙鎮,浦山里,70,1212,399,69,468,25,493
公投第７案,金門縣,金沙鎮,浦山里,71,1126,312,67,379,31,410
公投第７案,金門縣,金沙鎮,西園里,72,1540,391,61,452,27,479
公投第７案,金門縣,金沙鎮,官嶼里,73,1216,283,54,337,39,376
公投第７案,金門縣,金沙鎮,官嶼里,74,950,205,38,243,15,258
公投第７案,金門縣,金沙鎮,三山里,75,1895,595,72,667,34,701
公投第７案,金門縣,金沙鎮,大洋里,76,1135,360,76,436,27,463
公投第７案,金門縣,金沙鎮,光前里,77,1252,349,55,404,31,435
公投第７案,金門縣,金沙鎮,光前里,78,1125,401,43,444,18,462
公投第７案,宜蘭縣,宜蘭市,民族里,1,982,389,105,494,22,516
公投第７案,宜蘭縣,宜蘭市,民族里,2,1270,511,131,642,56,698
公投第７案,宜蘭縣,宜蘭市,建軍里,3,849,347,94,441,20,461
公投第７案,宜蘭縣,宜蘭市,建軍里,4,756,321,94,415,25,440
公投第７案,宜蘭縣,宜蘭市,泰山里,5,1107,414,89,503,48,551
公投第７案,宜蘭縣,宜蘭市,泰山里,6,893,359,90,449,46,495
公投第７案,宜蘭縣,宜蘭市,負郭里,7,912,376,99,475,32,507
公投第７案,宜蘭縣,宜蘭市,負郭里,8,1335,549,144,693,58,751
公投第７案,宜蘭縣,宜蘭市,負郭里,9,686,250,84,334,31,365
公投第７案,宜蘭縣,宜蘭市,思源里,10,1366,626,159,785,35,820
公投第７案,宜蘭縣,宜蘭市,思源里,11,1363,596,154,750,28,778
公投第７案,宜蘭縣,宜蘭市,思源里,12,1540,672,160,832,51,883
公投第７案,宜蘭縣,宜蘭市,七結里,13,1341,568,140,708,19,727
公投第７案,宜蘭縣,宜蘭市,七結里,14,1209,493,132,625,58,683
公投第７案,宜蘭縣,宜蘭市,文化里,15,900,353,101,454,53,507
公投第７案,宜蘭縣,宜蘭市,文化里,16,980,375,101,476,38,514
公投第７案,宜蘭縣,宜蘭市,文化里,17,1165,478,137,615,26,641
公投第７案,宜蘭縣,宜蘭市,復興里,18,904,402,77,479,23,502
公投第７案,宜蘭縣,宜蘭市,復興里,19,813,349,86,435,22,457
公投第７案,宜蘭縣,宜蘭市,復興里,20,978,395,102,497,42,539
公投第７案,宜蘭縣,宜蘭市,民權里,21,1282,439,114,553,25,578
公投第７案,宜蘭縣,宜蘭市,民權里,22,465,188,72,260,11,271
公投第７案,宜蘭縣,宜蘭市,神農里,23,669,277,80,357,34,391
公投第７案,宜蘭縣,宜蘭市,神農里,24,923,407,89,496,31,527
公投第７案,宜蘭縣,宜蘭市,神農里,25,1006,404,87,491,41,532
公投第７案,宜蘭縣,宜蘭市,大新里,26,762,343,115,458,41,499
公投第７案,宜蘭縣,宜蘭市,新民里,27,727,314,95,409,38,447
公投第７案,宜蘭縣,宜蘭市,新民里,28,833,393,97,490,57,547
公投第７案,宜蘭縣,宜蘭市,進士里,29,1143,498,107,605,35,640
公投第７案,宜蘭縣,宜蘭市,進士里,30,979,409,99,508,24,532
公投第７案,宜蘭縣,宜蘭市,南橋里,31,1214,480,128,608,52,660
公投第７案,宜蘭縣,宜蘭市,凱旋里,32,1283,508,158,666,67,733
公投第７案,宜蘭縣,宜蘭市,南津里,33,946,407,105,512,35,547
公投第７案,宜蘭縣,宜蘭市,南津里,34,1090,456,96,552,33,585
公投第７案,宜蘭縣,宜蘭市,建業里,35,943,406,103,509,19,528
公投第７案,宜蘭縣,宜蘭市,建業里,36,774,341,114,455,36,491
公投第７案,宜蘭縣,宜蘭市,擺厘里,37,968,443,111,554,36,590
公投第７案,宜蘭縣,宜蘭市,擺厘里,38,926,425,118,543,28,571
公投第７案,宜蘭縣,宜蘭市,擺厘里,39,1019,438,125,563,49,612
公投第７案,宜蘭縣,宜蘭市,延平里,40,1084,452,110,562,49,611
公投第７案,宜蘭縣,宜蘭市,延平里,41,1095,443,123,566,27,593
公投第７案,宜蘭縣,宜蘭市,延平里,42,1083,471,123,594,28,622
公投第７案,宜蘭縣,宜蘭市,成功里,43,1108,433,123,556,35,591
公投第７案,宜蘭縣,宜蘭市,成功里,44,848,367,107,474,20,494
公投第７案,宜蘭縣,宜蘭市,成功里,45,1095,453,118,571,33,604
公投第７案,宜蘭縣,宜蘭市,東村里,46,1110,480,121,601,25,626
公投第７案,宜蘭縣,宜蘭市,東村里,47,1104,478,123,601,41,642
公投第７案,宜蘭縣,宜蘭市,新東里,48,1134,486,110,596,44,640
公投第７案,宜蘭縣,宜蘭市,新東里,49,1146,498,118,616,43,659
公投第７案,宜蘭縣,宜蘭市,新東里,50,876,391,88,479,49,528
公投第７案,宜蘭縣,宜蘭市,黎明里,51,905,376,81,457,49,506
公投第７案,宜蘭縣,宜蘭市,黎明里,52,910,381,115,496,38,534
公投第７案,宜蘭縣,宜蘭市,七張里,53,1434,506,128,634,34,668
公投第７案,宜蘭縣,宜蘭市,孝廉里,54,1152,454,122,576,61,637
公投第７案,宜蘭縣,宜蘭市,東門里,55,966,400,138,538,36,574
公投第７案,宜蘭縣,宜蘭市,小東里,56,711,287,91,378,35,413
公投第７案,宜蘭縣,宜蘭市,小東里,57,884,387,108,495,37,532
公投第７案,宜蘭縣,宜蘭市,菜園里,58,1326,528,184,712,52,764
公投第７案,宜蘭縣,宜蘭市,慈安里,59,909,338,100,438,27,465
公投第７案,宜蘭縣,宜蘭市,慈安里,60,894,364,91,455,35,490
公投第７案,宜蘭縣,宜蘭市,中興里,61,1259,486,118,604,31,635
公投第７案,宜蘭縣,宜蘭市,中興里,62,789,316,79,395,24,419
公投第７案,宜蘭縣,宜蘭市,中興里,63,867,351,91,442,34,476
公投第７案,宜蘭縣,宜蘭市,新生里,64,1454,550,170,720,86,806
公投第７案,宜蘭縣,宜蘭市,新生里,65,1130,530,123,653,38,691
公投第７案,宜蘭縣,宜蘭市,茭白里,66,1087,409,77,486,22,508
公投第７案,宜蘭縣,宜蘭市,茭白里,67,938,409,113,522,58,580
公投第７案,宜蘭縣,宜蘭市,北津里,68,1285,509,149,658,61,719
公投第７案,宜蘭縣,宜蘭市,北津里,69,952,353,107,460,22,482
公投第７案,宜蘭縣,宜蘭市,梅洲里,70,948,380,130,510,61,571
公投第７案,宜蘭縣,宜蘭市,梅洲里,71,1160,420,142,562,42,604
公投第７案,宜蘭縣,宜蘭市,梅洲里,72,1015,438,111,549,65,614
公投第７案,宜蘭縣,宜蘭市,南門里,73,424,189,58,247,13,260
公投第７案,宜蘭縣,宜蘭市,南門里,74,964,410,104,514,48,562
公投第７案,宜蘭縣,宜蘭市,中山里,75,959,353,110,463,53,516
公投第７案,宜蘭縣,宜蘭市,西門里,76,814,364,110,474,40,514
公投第７案,宜蘭縣,宜蘭市,西門里,77,885,350,127,477,49,526
公投第７案,宜蘭縣,宜蘭市,北門里,78,1162,435,179,614,65,679
公投第７案,宜蘭縣,羅東鎮,開明里,79,689,295,82,377,30,407
公投第７案,宜蘭縣,羅東鎮,開明里,80,718,292,78,370,29,399
公投第７案,宜蘭縣,羅東鎮,大新里,81,1475,570,188,758,62,820
公投第７案,宜蘭縣,羅東鎮,東安里,82,1466,571,157,728,69,797
公投第７案,宜蘭縣,羅東鎮,東安里,83,1075,448,117,565,37,602
公投第７案,宜蘭縣,羅東鎮,東安里,84,963,399,100,499,38,537
公投第７案,宜蘭縣,羅東鎮,新群里,85,1511,568,157,725,86,811
公投第７案,宜蘭縣,羅東鎮,新群里,86,1166,471,126,597,29,626
公投第７案,宜蘭縣,羅東鎮,羅莊里,87,1273,516,155,671,63,734
公投第７案,宜蘭縣,羅東鎮,羅莊里,88,1735,692,178,870,44,914
公投第７案,宜蘭縣,羅東鎮,南昌里,89,1487,629,167,796,45,841
公投第７案,宜蘭縣,羅東鎮,南昌里,90,837,367,102,469,33,502
公投第７案,宜蘭縣,羅東鎮,南豪里,91,1312,551,172,723,62,785
公投第７案,宜蘭縣,羅東鎮,成功里,92,1502,597,154,751,51,802
公投第７案,宜蘭縣,羅東鎮,仁德里,93,1138,449,113,562,21,583
公投第７案,宜蘭縣,羅東鎮,仁和里,94,1010,397,118,515,46,561
公投第７案,宜蘭縣,羅東鎮,中山里,95,1373,553,145,698,91,789
公投第７案,宜蘭縣,羅東鎮,漢民里,96,1089,470,103,573,37,610
公投第７案,宜蘭縣,羅東鎮,漢民里,97,1304,551,117,668,39,707
公投第７案,宜蘭縣,羅東鎮,漢民里,98,1288,485,141,626,63,689
公投第７案,宜蘭縣,羅東鎮,維揚里,99,1036,451,133,584,58,642
公投第７案,宜蘭縣,羅東鎮,維揚里,100,969,452,122,574,40,614
公投第７案,宜蘭縣,羅東鎮,維揚里,101,985,423,126,549,42,591
公投第７案,宜蘭縣,羅東鎮,西安里,102,1420,565,195,760,75,835
公投第７案,宜蘭縣,羅東鎮,西安里,103,1430,629,138,767,53,820
公投第７案,宜蘭縣,羅東鎮,北成里,104,1075,437,139,576,52,628
公投第７案,宜蘭縣,羅東鎮,北成里,105,879,376,107,483,38,521
公投第７案,宜蘭縣,羅東鎮,北成里,106,850,356,91,447,22,469
公投第７案,宜蘭縣,羅東鎮,國華里,107,1111,493,135,628,33,661
公投第７案,宜蘭縣,羅東鎮,國華里,108,1139,515,157,672,37,709
公投第７案,宜蘭縣,羅東鎮,國華里,109,1130,504,154,658,35,693
公投第７案,宜蘭縣,羅東鎮,國華里,110,980,411,123,534,45,579
公投第７案,宜蘭縣,羅東鎮,賢文里,111,1431,606,151,757,47,804
公投第７案,宜蘭縣,羅東鎮,賢文里,112,1109,482,119,601,31,632
公投第７案,宜蘭縣,羅東鎮,賢文里,113,1083,453,115,568,41,609
公投第７案,宜蘭縣,羅東鎮,公正里,114,1404,585,168,753,58,811
公投第７案,宜蘭縣,羅東鎮,公正里,115,1288,516,177,693,46,739
公投第７案,宜蘭縣,羅東鎮,集祥里,116,1183,368,130,498,48,546
公投第７案,宜蘭縣,羅東鎮,信義里,117,1105,494,131,625,35,660
公投第７案,宜蘭縣,羅東鎮,信義里,118,987,423,138,561,41,602
公投第７案,宜蘭縣,羅東鎮,信義里,119,773,335,98,433,39,472
公投第７案,宜蘭縣,羅東鎮,樹林里,120,1366,651,166,817,46,863
公投第７案,宜蘭縣,羅東鎮,樹林里,121,907,423,129,552,31,583
公投第７案,宜蘭縣,羅東鎮,樹林里,122,1158,563,120,683,34,717
公投第７案,宜蘭縣,羅東鎮,竹林里,123,977,397,128,525,40,565
公投第７案,宜蘭縣,羅東鎮,竹林里,124,972,373,110,483,46,529
公投第７案,宜蘭縣,羅東鎮,竹林里,125,977,420,125,545,31,576
公投第７案,宜蘭縣,羅東鎮,仁愛里,126,1398,594,169,763,60,823
公投第７案,宜蘭縣,羅東鎮,仁愛里,127,1022,425,124,549,25,574
公投第７案,宜蘭縣,羅東鎮,仁愛里,128,1131,500,136,636,55,691
公投第７案,宜蘭縣,蘇澳鎮,龍德里,129,1194,482,136,618,54,672
公投第７案,宜蘭縣,蘇澳鎮,龍德里,130,1128,431,125,556,35,591
公投第７案,宜蘭縣,蘇澳鎮,龍德里,131,1042,491,104,595,48,643
公投第７案,宜蘭縣,蘇澳鎮,頂寮里,132,997,422,123,545,39,584
公投第７案,宜蘭縣,蘇澳鎮,永榮里,133,1303,540,145,685,52,737
公投第７案,宜蘭縣,蘇澳鎮,永榮里,134,1260,535,142,677,70,747
公投第７案,宜蘭縣,蘇澳鎮,永榮里,135,1130,472,107,579,59,638
公投第７案,宜蘭縣,蘇澳鎮,存仁里,136,559,220,58,278,37,315
公投第７案,宜蘭縣,蘇澳鎮,存仁里,137,351,107,50,157,23,180
公投第７案,宜蘭縣,蘇澳鎮,港邊里,138,889,325,108,433,56,489
公投第７案,宜蘭縣,蘇澳鎮,港邊里,139,434,172,50,222,21,243
公投第７案,宜蘭縣,蘇澳鎮,隘丁里,140,835,364,114,478,26,504
公投第７案,宜蘭縣,蘇澳鎮,隘丁里,141,975,398,116,514,39,553
公投第７案,宜蘭縣,蘇澳鎮,隘丁里,142,1135,471,136,607,65,672
公投第７案,宜蘭縣,蘇澳鎮,新城里,143,788,368,116,484,27,511
公投第７案,宜蘭縣,蘇澳鎮,新城里,144,469,164,54,218,32,250
公投第７案,宜蘭縣,蘇澳鎮,聖愛里,145,811,310,89,399,32,431
公投第７案,宜蘭縣,蘇澳鎮,聖愛里,146,867,356,84,440,19,459
公投第７案,宜蘭縣,蘇澳鎮,聖愛里,147,1139,469,126,595,46,641
公投第７案,宜蘭縣,蘇澳鎮,聖湖里,148,1146,471,97,568,34,602
公投第７案,宜蘭縣,蘇澳鎮,聖湖里,149,1154,486,108,594,58,652
公投第７案,宜蘭縣,蘇澳鎮,蘇西里,150,908,333,82,415,23,438
公投第７案,宜蘭縣,蘇澳鎮,蘇西里,151,656,273,68,341,23,364
公投第７案,宜蘭縣,蘇澳鎮,蘇西里,152,834,352,114,466,51,517
公投第７案,宜蘭縣,蘇澳鎮,蘇北里,153,1025,466,99,565,40,605
公投第７案,宜蘭縣,蘇澳鎮,蘇南里,154,455,176,72,248,16,264
公投第７案,宜蘭縣,蘇澳鎮,蘇東里,155,535,219,67,286,27,313
公投第７案,宜蘭縣,蘇澳鎮,長安里,156,536,250,64,314,25,339
公投第７案,宜蘭縣,蘇澳鎮,永光里,157,451,198,56,254,19,273
公投第７案,宜蘭縣,蘇澳鎮,永春里,158,593,231,64,295,35,330
公投第７案,宜蘭縣,蘇澳鎮,永樂里,159,441,175,46,221,26,247
公投第７案,宜蘭縣,蘇澳鎮,南安里,160,954,391,109,500,50,550
公投第７案,宜蘭縣,蘇澳鎮,南正里,161,952,374,81,455,63,518
公投第７案,宜蘭縣,蘇澳鎮,南成里,162,1125,390,128,518,70,588
公投第７案,宜蘭縣,蘇澳鎮,南興里,163,763,288,73,361,67,428
公投第７案,宜蘭縣,蘇澳鎮,南興里,164,706,210,63,273,39,312
公投第７案,宜蘭縣,蘇澳鎮,南寧里,165,1068,349,103,452,64,516
公投第７案,宜蘭縣,蘇澳鎮,南建里,166,666,246,90,336,52,388
公投第７案,宜蘭縣,蘇澳鎮,南建里,167,574,189,65,254,71,325
公投第７案,宜蘭縣,蘇澳鎮,東澳里,168,351,97,27,124,11,135
公投第７案,宜蘭縣,蘇澳鎮,南強里,169,717,279,83,362,43,405
公投第７案,宜蘭縣,蘇澳鎮,朝陽里,170,373,122,16,138,14,152
公投第７案,宜蘭縣,蘇澳鎮,朝陽里,171,223,57,20,77,12,89
公投第７案,宜蘭縣,頭城鎮,石城里,172,292,68,27,95,9,104
公投第７案,宜蘭縣,頭城鎮,大里里,173,688,251,75,326,42,368
公投第７案,宜蘭縣,頭城鎮,龜山里,174,688,283,79,362,34,396
公投第７案,宜蘭縣,頭城鎮,大溪里,175,879,281,111,392,51,443
公投第７案,宜蘭縣,頭城鎮,合興里,176,335,141,41,182,22,204
公投第７案,宜蘭縣,頭城鎮,更新里,177,624,254,101,355,38,393
公投第７案,宜蘭縣,頭城鎮,更新里,178,732,226,76,302,41,343
公投第７案,宜蘭縣,頭城鎮,外澳里,179,892,286,85,371,48,419
公投第７案,宜蘭縣,頭城鎮,港口里,180,690,217,67,284,29,313
公投第７案,宜蘭縣,頭城鎮,武營里,181,842,339,71,410,42,452
公投第７案,宜蘭縣,頭城鎮,武營里,182,736,300,76,376,34,410
公投第７案,宜蘭縣,頭城鎮,大坑里,183,788,296,67,363,31,394
公投第７案,宜蘭縣,頭城鎮,大坑里,184,560,206,58,264,22,286
公投第７案,宜蘭縣,頭城鎮,城東里,185,712,308,83,391,32,423
公投第７案,宜蘭縣,頭城鎮,城北里,186,502,226,57,283,38,321
公投第７案,宜蘭縣,頭城鎮,城西里,187,569,264,63,327,30,357
公投第７案,宜蘭縣,頭城鎮,城南里,188,633,255,63,318,43,361
公投第７案,宜蘭縣,頭城鎮,竹安里,189,1132,350,104,454,74,528
公投第７案,宜蘭縣,頭城鎮,竹安里,190,1035,360,93,453,42,495
公投第７案,宜蘭縣,頭城鎮,新建里,191,847,371,100,471,32,503
公投第７案,宜蘭縣,頭城鎮,新建里,192,1172,484,131,615,44,659
公投第７案,宜蘭縣,頭城鎮,拔雅里,193,896,357,80,437,26,463
公投第７案,宜蘭縣,頭城鎮,拔雅里,194,1075,490,106,596,30,626
公投第７案,宜蘭縣,頭城鎮,福成里,195,931,369,115,484,62,546
公投第７案,宜蘭縣,頭城鎮,金面里,196,1021,398,106,504,58,562
公投第７案,宜蘭縣,頭城鎮,金面里,197,709,235,59,294,53,347
公投第７案,宜蘭縣,頭城鎮,金盈里,198,689,324,83,407,35,442
公投第７案,宜蘭縣,頭城鎮,頂埔里,199,615,276,68,344,40,384
公投第７案,宜蘭縣,頭城鎮,頂埔里,200,759,301,64,365,50,415
公投第７案,宜蘭縣,頭城鎮,下埔里,201,917,389,114,503,59,562
公投第７案,宜蘭縣,頭城鎮,中崙里,202,1045,432,106,538,63,601
公投第７案,宜蘭縣,頭城鎮,二城里,203,1130,463,119,582,55,637
公投第７案,宜蘭縣,礁溪鄉,白雲村,204,1122,390,102,492,37,529
公投第７案,宜蘭縣,礁溪鄉,白雲村,205,505,186,51,237,29,266
公投第７案,宜蘭縣,礁溪鄉,玉石村,206,988,348,119,467,42,509
公投第７案,宜蘭縣,礁溪鄉,玉石村,207,971,378,91,469,43,512
公投第７案,宜蘭縣,礁溪鄉,德陽村,208,1246,436,131,567,50,617
公投第７案,宜蘭縣,礁溪鄉,德陽村,209,1655,556,183,739,35,774
公投第７案,宜蘭縣,礁溪鄉,德陽村,210,1132,386,91,477,35,512
公投第７案,宜蘭縣,礁溪鄉,大忠村,211,783,331,78,409,29,438
公投第７案,宜蘭縣,礁溪鄉,大忠村,212,928,347,112,459,39,498
公投第７案,宜蘭縣,礁溪鄉,大忠村,213,848,348,69,417,37,454
公投第７案,宜蘭縣,礁溪鄉,大義村,214,663,297,89,386,31,417
公投第７案,宜蘭縣,礁溪鄉,六結村,215,608,261,62,323,16,339
公投第７案,宜蘭縣,礁溪鄉,六結村,216,833,338,90,428,36,464
公投第７案,宜蘭縣,礁溪鄉,二龍村,217,1233,415,124,539,15,554
公投第７案,宜蘭縣,礁溪鄉,時潮村,218,854,327,106,433,45,478
公投第７案,宜蘭縣,礁溪鄉,時潮村,219,575,214,65,279,21,300
公投第７案,宜蘭縣,礁溪鄉,玉田村,220,835,320,105,425,41,466
公投第７案,宜蘭縣,礁溪鄉,玉田村,221,1305,536,159,695,48,743
公投第７案,宜蘭縣,礁溪鄉,三民村,222,830,318,103,421,39,460
公投第７案,宜蘭縣,礁溪鄉,三民村,223,649,285,97,382,45,427
公投第７案,宜蘭縣,礁溪鄉,三民村,224,923,314,84,398,45,443
公投第７案,宜蘭縣,礁溪鄉,林美村,225,1177,389,101,490,40,530
公投第７案,宜蘭縣,礁溪鄉,白鵝村,226,840,337,84,421,40,461
公投第７案,宜蘭縣,礁溪鄉,玉光村,227,1051,423,123,546,28,574
公投第７案,宜蘭縣,礁溪鄉,光武村,228,1339,469,140,609,46,655
公投第７案,宜蘭縣,礁溪鄉,吳沙村,229,1194,533,121,654,48,702
公投第７案,宜蘭縣,礁溪鄉,吳沙村,230,1314,517,175,692,80,772
公投第７案,宜蘭縣,礁溪鄉,龍潭村,231,1125,413,147,560,27,587
公投第７案,宜蘭縣,礁溪鄉,龍潭村,232,1207,530,125,655,65,720
公投第７案,宜蘭縣,礁溪鄉,龍潭村,233,979,386,104,490,58,548
公投第７案,宜蘭縣,礁溪鄉,匏崙村,234,954,386,133,519,65,584
公投第７案,宜蘭縣,礁溪鄉,二結村,235,418,148,64,212,10,222
公投第７案,宜蘭縣,壯圍鄉,吉祥村,236,1435,574,191,765,97,862
公投第７案,宜蘭縣,壯圍鄉,吉祥村,237,1049,425,144,569,55,624
公投第７案,宜蘭縣,壯圍鄉,古結村,238,1068,457,127,584,71,655
公投第７案,宜蘭縣,壯圍鄉,美福村,239,868,324,78,402,96,498
公投第７案,宜蘭縣,壯圍鄉,美福村,240,967,362,107,469,40,509
公投第７案,宜蘭縣,壯圍鄉,新南村,241,940,398,110,508,67,575
公投第７案,宜蘭縣,壯圍鄉,東港村,242,975,338,85,423,31,454
公投第７案,宜蘭縣,壯圍鄉,復興村,243,797,318,99,417,72,489
公投第７案,宜蘭縣,壯圍鄉,復興村,244,808,337,72,409,56,465
公投第７案,宜蘭縣,壯圍鄉,過嶺村,245,911,333,123,456,81,537
公投第７案,宜蘭縣,壯圍鄉,過嶺村,246,612,230,50,280,36,316
公投第７案,宜蘭縣,壯圍鄉,永鎮村,247,790,344,107,451,51,502
公投第７案,宜蘭縣,壯圍鄉,忠孝村,248,878,341,127,468,56,524
公投第７案,宜蘭縣,壯圍鄉,忠孝村,249,723,340,80,420,43,463
公投第７案,宜蘭縣,壯圍鄉,忠孝村,250,737,243,85,328,29,357
公投第７案,宜蘭縣,壯圍鄉,古亭村,251,686,267,87,354,59,413
公投第７案,宜蘭縣,壯圍鄉,古亭村,252,895,358,68,426,12,438
公投第７案,宜蘭縣,壯圍鄉,功勞村,253,1237,549,131,680,74,754
公投第７案,宜蘭縣,壯圍鄉,美城村,254,1134,470,120,590,60,650
公投第７案,宜蘭縣,壯圍鄉,美城村,255,1107,427,129,556,57,613
公投第７案,宜蘭縣,壯圍鄉,新社村,256,1057,459,111,570,27,597
公投第７案,宜蘭縣,壯圍鄉,大福村,257,1051,379,105,484,46,530
公投第７案,宜蘭縣,壯圍鄉,大福村,258,722,276,74,350,47,397
公投第７案,宜蘭縣,員山鄉,員山村,259,1393,540,150,690,25,715
公投第７案,宜蘭縣,員山鄉,員山村,260,895,338,94,432,27,459
公投第７案,宜蘭縣,員山鄉,員山村,261,1231,475,115,590,79,669
公投第７案,宜蘭縣,員山鄉,員山村,262,1098,429,95,524,34,558
公投第７案,宜蘭縣,員山鄉,員山村,263,1031,403,91,494,34,528
公投第７案,宜蘭縣,員山鄉,尚德村,264,1030,391,93,484,70,554
公投第７案,宜蘭縣,員山鄉,尚德村,265,1168,356,147,503,41,544
公投第７案,宜蘭縣,員山鄉,惠好村,266,809,309,95,404,55,459
公投第７案,宜蘭縣,員山鄉,惠好村,267,778,324,71,395,52,447
公投第７案,宜蘭縣,員山鄉,七賢村,268,1465,634,154,788,55,843
公投第７案,宜蘭縣,員山鄉,深溝村,269,979,415,111,526,52,578
公投第７案,宜蘭縣,員山鄉,深溝村,270,860,359,73,432,46,478
公投第７案,宜蘭縣,員山鄉,蓁巷村,271,1205,406,111,517,80,597
公投第７案,宜蘭縣,員山鄉,內城村,272,1082,415,110,525,83,608
公投第７案,宜蘭縣,員山鄉,內城村,273,412,160,52,212,31,243
公投第７案,宜蘭縣,員山鄉,中華村,274,403,126,40,166,19,185
公投第７案,宜蘭縣,員山鄉,中華村,275,232,61,26,87,17,104
公投第７案,宜蘭縣,員山鄉,永和村,276,944,396,60,456,48,504
公投第７案,宜蘭縣,員山鄉,永和村,277,894,335,116,451,45,496
公投第７案,宜蘭縣,員山鄉,頭分村,278,1356,519,154,673,79,752
公投第７案,宜蘭縣,員山鄉,枕山村,279,780,299,106,405,48,453
公投第７案,宜蘭縣,員山鄉,枕山村,280,932,361,144,505,83,588
公投第７案,宜蘭縣,員山鄉,枕山村,281,583,187,78,265,35,300
公投第７案,宜蘭縣,員山鄉,同樂村,282,900,352,85,437,67,504
公投第７案,宜蘭縣,員山鄉,同樂村,283,747,278,88,366,37,403
公投第７案,宜蘭縣,員山鄉,同樂村,284,788,307,72,379,50,429
公投第７案,宜蘭縣,員山鄉,湖東村,285,884,304,109,413,50,463
公投第７案,宜蘭縣,員山鄉,逸仙村,286,857,302,91,393,15,408
公投第７案,宜蘭縣,員山鄉,湖北村,287,1016,355,104,459,26,485
公投第７案,宜蘭縣,員山鄉,湖西村,288,690,207,58,265,40,305
公投第７案,宜蘭縣,員山鄉,湖西村,289,689,241,65,306,54,360
公投第７案,宜蘭縣,冬山鄉,珍珠村,290,807,347,97,444,42,486
公投第７案,宜蘭縣,冬山鄉,珍珠村,291,817,344,96,440,17,457
公投第７案,宜蘭縣,冬山鄉,補城村,292,1156,504,111,615,43,658
公投第７案,宜蘭縣,冬山鄉,三奇村,293,892,348,88,436,36,472
公投第７案,宜蘭縣,冬山鄉,大興村,294,897,382,115,497,32,529
公投第７案,宜蘭縣,冬山鄉,東城村,295,1392,606,170,776,51,827
公投第７案,宜蘭縣,冬山鄉,香和村,296,1471,607,185,792,47,839
公投第７案,宜蘭縣,冬山鄉,香和村,297,1435,472,130,602,31,633
公投第７案,宜蘭縣,冬山鄉,南興村,298,1519,573,159,732,36,768
公投第７案,宜蘭縣,冬山鄉,南興村,299,1456,628,159,787,30,817
公投第７案,宜蘭縣,冬山鄉,安平村,300,711,295,92,387,41,428
公投第７案,宜蘭縣,冬山鄉,冬山村,301,694,305,73,378,27,405
公投第７案,宜蘭縣,冬山鄉,太和村,302,1526,689,220,909,46,955
公投第７案,宜蘭縣,冬山鄉,八寶村,303,884,348,101,449,32,481
公投第７案,宜蘭縣,冬山鄉,丸山村,304,1465,533,118,651,63,714
公投第７案,宜蘭縣,冬山鄉,中山村,305,488,187,51,238,38,276
公投第７案,宜蘭縣,冬山鄉,順安村,306,1218,464,129,593,55,648
公投第７案,宜蘭縣,冬山鄉,順安村,307,1291,479,135,614,42,656
公投第７案,宜蘭縣,冬山鄉,順安村,308,1324,491,137,628,35,663
公投第７案,宜蘭縣,冬山鄉,順安村,309,1160,428,106,534,38,572
公投第７案,宜蘭縣,冬山鄉,永美村,310,1246,484,141,625,46,671
公投第７案,宜蘭縣,冬山鄉,永美村,311,1754,650,191,841,34,875
公投第７案,宜蘭縣,冬山鄉,武淵村,312,1217,452,129,581,61,642
公投第７案,宜蘭縣,冬山鄉,群英村,313,1495,535,139,674,46,720
公投第７案,宜蘭縣,冬山鄉,群英村,314,937,373,100,473,37,510
公投第７案,宜蘭縣,冬山鄉,群英村,315,1101,411,111,522,31,553
公投第７案,宜蘭縣,冬山鄉,群英村,316,1118,396,124,520,60,580
公投第７案,宜蘭縣,冬山鄉,清溝村,317,1301,558,141,699,49,748
公投第７案,宜蘭縣,冬山鄉,清溝村,318,1225,487,116,603,25,628
公投第７案,宜蘭縣,冬山鄉,清溝村,319,1206,494,164,658,44,702
公投第７案,宜蘭縣,冬山鄉,鹿埔村,320,1278,449,151,600,33,633
公投第７案,宜蘭縣,冬山鄉,鹿埔村,321,1151,432,125,557,37,594
公投第７案,宜蘭縣,冬山鄉,得安村,322,1094,408,91,499,42,541
公投第７案,宜蘭縣,冬山鄉,廣興村,323,1247,512,148,660,46,706
公投第７案,宜蘭縣,冬山鄉,廣興村,324,1247,455,130,585,42,627
公投第７案,宜蘭縣,冬山鄉,廣安村,325,979,404,99,503,26,529
公投第７案,宜蘭縣,冬山鄉,廣安村,326,698,322,80,402,22,424
公投第７案,宜蘭縣,冬山鄉,柯林村,327,1726,654,162,816,49,865
公投第７案,宜蘭縣,冬山鄉,大進村,328,782,246,72,318,16,334
公投第７案,宜蘭縣,五結鄉,三興村,329,1076,384,90,474,57,531
公投第７案,宜蘭縣,五結鄉,三興村,330,944,344,116,460,23,483
公投第７案,宜蘭縣,五結鄉,二結村,331,836,351,79,430,20,450
公投第７案,宜蘭縣,五結鄉,二結村,332,937,381,108,489,41,530
公投第７案,宜蘭縣,五結鄉,鎮安村,333,1255,481,137,618,34,652
公投第７案,宜蘭縣,五結鄉,鎮安村,334,1270,454,164,618,67,685
公投第７案,宜蘭縣,五結鄉,上四村,335,801,297,72,369,24,393
公投第７案,宜蘭縣,五結鄉,上四村,336,802,320,64,384,33,417
公投第７案,宜蘭縣,五結鄉,中興村,337,1306,493,124,617,33,650
公投第７案,宜蘭縣,五結鄉,四結村,338,1190,450,130,580,46,626
公投第７案,宜蘭縣,五結鄉,四結村,339,1316,515,126,641,25,666
公投第７案,宜蘭縣,五結鄉,福興村,340,965,400,89,489,30,519
公投第７案,宜蘭縣,五結鄉,福興村,341,814,320,84,404,31,435
公投第７案,宜蘭縣,五結鄉,五結村,342,1254,459,131,590,50,640
公投第７案,宜蘭縣,五結鄉,五結村,343,1060,444,108,552,52,604
公投第７案,宜蘭縣,五結鄉,五結村,344,1323,534,153,687,36,723
公投第７案,宜蘭縣,五結鄉,協和村,345,1120,468,130,598,43,641
公投第７案,宜蘭縣,五結鄉,協和村,346,893,370,81,451,24,475
公投第７案,宜蘭縣,五結鄉,協和村,347,1220,460,144,604,41,645
公投第７案,宜蘭縣,五結鄉,大吉村,348,924,413,102,515,21,536
公投第７案,宜蘭縣,五結鄉,大吉村,349,933,414,105,519,42,561
公投第７案,宜蘭縣,五結鄉,大吉村,350,986,421,83,504,24,528
公投第７案,宜蘭縣,五結鄉,大吉村,351,748,286,85,371,37,408
公投第７案,宜蘭縣,五結鄉,孝威村,352,1550,572,178,750,82,832
公投第７案,宜蘭縣,五結鄉,錦眾村,353,629,257,71,328,27,355
公投第７案,宜蘭縣,五結鄉,錦眾村,354,806,329,79,408,33,441
公投第７案,宜蘭縣,五結鄉,利澤村,355,956,326,126,452,44,496
公投第７案,宜蘭縣,五結鄉,利澤村,356,1066,404,119,523,40,563
公投第７案,宜蘭縣,五結鄉,成興村,357,1513,544,141,685,64,749
公投第７案,宜蘭縣,五結鄉,成興村,358,1566,583,200,783,42,825
公投第７案,宜蘭縣,五結鄉,季新村,359,894,349,94,443,55,498
公投第７案,宜蘭縣,五結鄉,季新村,360,1235,389,131,520,61,581
公投第７案,宜蘭縣,五結鄉,季新村,361,704,281,76,357,39,396
公投第７案,宜蘭縣,三星鄉,員山村,362,215,79,21,100,14,114
公投第７案,宜蘭縣,三星鄉,天山村,363,523,159,48,207,34,241
公投第７案,宜蘭縣,三星鄉,天福村,364,745,236,97,333,57,390
公投第７案,宜蘭縣,三星鄉,萬德村,365,617,210,57,267,36,303
公投第７案,宜蘭縣,三星鄉,貴林村,366,497,162,63,225,38,263
公投第７案,宜蘭縣,三星鄉,萬富村,367,735,258,95,353,58,411
公投第７案,宜蘭縣,三星鄉,雙賢村,368,583,227,52,279,45,324
公投第７案,宜蘭縣,三星鄉,人和村,369,436,170,35,205,29,234
公投第７案,宜蘭縣,三星鄉,義德村,370,1224,464,114,578,60,638
公投第７案,宜蘭縣,三星鄉,集慶村,371,1151,400,105,505,39,544
公投第７案,宜蘭縣,三星鄉,月眉村,372,870,350,88,438,38,476
公投第７案,宜蘭縣,三星鄉,拱照村,373,1284,380,109,489,43,532
公投第７案,宜蘭縣,三星鄉,行健村,374,897,358,123,481,49,530
公投第７案,宜蘭縣,三星鄉,大隱村,375,1439,588,136,724,49,773
公投第７案,宜蘭縣,三星鄉,大隱村,376,1445,530,153,683,53,736
公投第７案,宜蘭縣,三星鄉,大隱村,377,1402,530,163,693,37,730
公投第７案,宜蘭縣,三星鄉,大義村,378,1230,427,164,591,49,640
公投第７案,宜蘭縣,三星鄉,尚武村,379,774,303,77,380,52,432
公投第７案,宜蘭縣,三星鄉,大洲村,380,827,332,95,427,50,477
公投第７案,宜蘭縣,三星鄉,大洲村,381,736,273,87,360,31,391
公投第７案,宜蘭縣,三星鄉,尾塹村,382,1421,552,139,691,63,754
公投第７案,宜蘭縣,大同鄉,寒溪村,383,893,235,76,311,47,358
公投第７案,宜蘭縣,大同鄉,崙埤村,384,632,332,82,414,45,459
公投第７案,宜蘭縣,大同鄉,松羅村,385,684,232,44,276,18,294
公投第７案,宜蘭縣,大同鄉,復興村,386,264,123,26,149,26,175
公投第７案,宜蘭縣,大同鄉,英士村,387,337,99,12,111,4,115
公投第７案,宜蘭縣,大同鄉,樂水村,388,404,107,25,132,7,139
公投第７案,宜蘭縣,大同鄉,太平村,389,55,17,4,21,5,26
公投第７案,宜蘭縣,大同鄉,茂安村,390,199,86,46,132,21,153
公投第７案,宜蘭縣,大同鄉,四季村,391,787,177,54,231,17,248
公投第７案,宜蘭縣,大同鄉,南山村,392,680,236,74,310,50,360
公投第７案,宜蘭縣,南澳鄉,東岳村,393,444,176,40,216,9,225
公投第７案,宜蘭縣,南澳鄉,南澳村,394,1210,484,86,570,23,593
公投第７案,宜蘭縣,南澳鄉,碧候村,395,962,426,85,511,73,584
公投第７案,宜蘭縣,南澳鄉,金岳村,396,411,123,23,146,4,150
公投第７案,宜蘭縣,南澳鄉,武塔村,397,447,240,51,291,17,308
公投第７案,宜蘭縣,南澳鄉,金洋村,398,475,254,79,333,35,368
公投第７案,宜蘭縣,南澳鄉,澳花村,399,695,304,65,369,42,411
公投第７案,新竹縣,竹北市,鹿場里,1,1319,677,154,831,23,854
公投第７案,新竹縣,竹北市,鹿場里,2,1321,604,169,773,28,801
公投第７案,新竹縣,竹北市,鹿場里,3,1272,602,164,766,32,798
公投第７案,新竹縣,竹北市,鹿場里,4,1467,672,139,811,31,842
公投第７案,新竹縣,竹北市,鹿場里,5,1226,530,148,678,13,691
公投第７案,新竹縣,竹北市,鹿場里,6,1412,617,164,781,15,796
公投第７案,新竹縣,竹北市,鹿場里,7,1400,695,170,865,9,874
公投第７案,新竹縣,竹北市,東平里,8,1415,657,193,850,28,878
公投第７案,新竹縣,竹北市,東平里,9,1361,615,148,763,26,789
公投第７案,新竹縣,竹北市,東平里,10,1515,650,159,809,19,828
公投第７案,新竹縣,竹北市,東平里,11,1495,678,185,863,23,886
公投第７案,新竹縣,竹北市,東平里,12,1417,630,186,816,22,838
公投第７案,新竹縣,竹北市,東平里,13,1548,642,213,855,29,884
公投第７案,新竹縣,竹北市,東平里,14,1434,568,190,758,26,784
公投第７案,新竹縣,竹北市,中興里,15,1385,605,171,776,32,808
公投第７案,新竹縣,竹北市,中興里,16,1247,614,147,761,30,791
公投第７案,新竹縣,竹北市,中興里,17,1373,593,184,777,19,796
公投第７案,新竹縣,竹北市,中興里,18,1345,657,177,834,23,857
公投第７案,新竹縣,竹北市,中興里,19,1165,529,104,633,36,669
公投第７案,新竹縣,竹北市,隘口里,20,1164,564,145,709,36,745
公投第７案,新竹縣,竹北市,隘口里,21,1212,568,152,720,34,754
公投第７案,新竹縣,竹北市,東海里,22,1507,601,129,730,28,758
公投第７案,新竹縣,竹北市,東海里,23,1576,657,216,873,35,908
公投第７案,新竹縣,竹北市,東興里,24,1464,644,156,800,28,828
公投第７案,新竹縣,竹北市,東興里,25,1428,638,151,789,28,817
公投第７案,新竹縣,竹北市,東興里,26,1442,532,179,711,18,729
公投第７案,新竹縣,竹北市,東興里,27,1415,646,143,789,50,839
公投第７案,新竹縣,竹北市,北興里,28,1666,669,162,831,17,848
公投第７案,新竹縣,竹北市,北興里,29,1751,699,197,896,41,937
公投第７案,新竹縣,竹北市,十興里,30,1196,558,146,704,30,734
公投第７案,新竹縣,竹北市,十興里,31,1235,576,146,722,20,742
公投第７案,新竹縣,竹北市,十興里,32,1204,527,134,661,21,682
公投第７案,新竹縣,竹北市,十興里,33,1308,629,137,766,27,793
公投第７案,新竹縣,竹北市,十興里,34,1233,547,141,688,14,702
公投第７案,新竹縣,竹北市,興安里,35,1129,525,122,647,25,672
公投第７案,新竹縣,竹北市,興安里,36,1069,543,94,637,22,659
公投第７案,新竹縣,竹北市,興安里,37,1114,567,108,675,36,711
公投第７案,新竹縣,竹北市,文化里,38,1103,530,116,646,24,670
公投第７案,新竹縣,竹北市,文化里,39,1029,532,112,644,26,670
公投第７案,新竹縣,竹北市,文化里,40,1133,555,145,700,32,732
公投第７案,新竹縣,竹北市,斗崙里,41,1301,600,132,732,24,756
公投第７案,新竹縣,竹北市,斗崙里,42,1798,813,182,995,49,1044
公投第７案,新竹縣,竹北市,斗崙里,43,1427,656,158,814,34,848
公投第７案,新竹縣,竹北市,斗崙里,44,1462,722,154,876,35,911
公投第７案,新竹縣,竹北市,中崙里,45,1342,672,157,829,27,856
公投第７案,新竹縣,竹北市,中崙里,46,1480,722,143,865,29,894
公投第７案,新竹縣,竹北市,中崙里,47,1645,735,169,904,24,928
公投第７案,新竹縣,竹北市,中崙里,48,1256,628,153,781,22,803
公投第７案,新竹縣,竹北市,北崙里,49,1181,545,145,690,30,720
公投第７案,新竹縣,竹北市,北崙里,50,1329,674,147,821,41,862
公投第７案,新竹縣,竹北市,北崙里,51,1228,602,153,755,24,779
公投第７案,新竹縣,竹北市,新崙里,52,1552,671,175,846,30,876
公投第７案,新竹縣,竹北市,新崙里,53,1480,679,183,862,31,893
公投第７案,新竹縣,竹北市,新崙里,54,1487,598,172,770,31,801
公投第７案,新竹縣,竹北市,新崙里,55,1470,623,146,769,38,807
公投第７案,新竹縣,竹北市,竹北里,56,1477,619,136,755,31,786
公投第７案,新竹縣,竹北市,竹北里,57,1611,757,183,940,42,982
公投第７案,新竹縣,竹北市,竹北里,58,1555,682,165,847,59,906
公投第７案,新竹縣,竹北市,竹北里,59,1468,629,135,764,36,800
公投第７案,新竹縣,竹北市,竹仁里,60,1509,692,156,848,47,895
公投第７案,新竹縣,竹北市,竹仁里,61,1602,680,167,847,45,892
公投第７案,新竹縣,竹北市,竹仁里,62,1448,659,159,818,48,866
公投第７案,新竹縣,竹北市,竹仁里,63,1318,612,130,742,53,795
公投第７案,新竹縣,竹北市,竹仁里,64,1634,778,171,949,52,1001
公投第７案,新竹縣,竹北市,竹仁里,65,1345,568,158,726,46,772
公投第７案,新竹縣,竹北市,福德里,66,958,504,103,607,27,634
公投第７案,新竹縣,竹北市,福德里,67,1112,548,121,669,33,702
公投第７案,新竹縣,竹北市,福德里,68,1134,476,134,610,59,669
公投第７案,新竹縣,竹北市,竹義里,69,1483,671,156,827,26,853
公投第７案,新竹縣,竹北市,竹義里,70,1332,578,134,712,37,749
公投第７案,新竹縣,竹北市,竹義里,71,1482,596,138,734,28,762
公投第７案,新竹縣,竹北市,竹義里,72,1449,465,134,599,21,620
公投第７案,新竹縣,竹北市,泰和里,73,1319,572,122,694,22,716
公投第７案,新竹縣,竹北市,泰和里,74,1332,559,133,692,32,724
公投第７案,新竹縣,竹北市,泰和里,75,1412,558,150,708,42,750
公投第７案,新竹縣,竹北市,泰和里,76,1640,672,159,831,46,877
公投第７案,新竹縣,竹北市,新社里,77,1323,572,141,713,43,756
公投第７案,新竹縣,竹北市,新社里,78,1428,649,155,804,47,851
公投第７案,新竹縣,竹北市,新社里,79,1533,696,156,852,46,898
公投第７案,新竹縣,竹北市,新社里,80,1346,556,114,670,27,697
公投第７案,新竹縣,竹北市,新社里,81,1219,504,114,618,51,669
公投第７案,新竹縣,竹北市,新國里,82,1466,674,161,835,57,892
公投第７案,新竹縣,竹北市,新國里,83,1147,486,116,602,30,632
公投第７案,新竹縣,竹北市,新國里,84,1529,591,126,717,35,752
公投第７案,新竹縣,竹北市,新國里,85,1522,697,136,833,45,878
公投第７案,新竹縣,竹北市,聯興里,86,1383,638,145,783,46,829
公投第７案,新竹縣,竹北市,聯興里,87,1569,686,178,864,32,896
公投第７案,新竹縣,竹北市,聯興里,88,1506,629,130,759,25,784
公投第７案,新竹縣,竹北市,麻園里,89,877,373,93,466,40,506
公投第７案,新竹縣,竹北市,麻園里,90,1074,472,113,585,40,625
公投第７案,新竹縣,竹北市,溪州里,91,1089,537,132,669,33,702
公投第７案,新竹縣,竹北市,溪州里,92,1336,592,143,735,58,793
公投第７案,新竹縣,竹北市,新庄里,93,1058,418,120,538,63,601
公投第７案,新竹縣,竹北市,白地里,94,937,455,120,575,51,626
公投第７案,新竹縣,竹北市,白地里,95,1206,524,132,656,36,692
公投第７案,新竹縣,竹北市,新港里,96,1205,492,142,634,47,681
公投第７案,新竹縣,竹北市,大眉里,97,1718,773,196,969,59,1028
公投第７案,新竹縣,竹北市,大義里,98,917,366,112,478,45,523
公投第７案,新竹縣,竹北市,大義里,99,668,293,83,376,28,404
公投第７案,新竹縣,竹北市,尚義里,100,824,340,83,423,30,453
公投第７案,新竹縣,竹北市,尚義里,101,782,316,83,399,65,464
公投第７案,新竹縣,竹北市,崇義里,102,977,435,110,545,55,600
公投第７案,新竹縣,竹北市,崇義里,103,937,345,86,431,15,446
公投第７案,新竹縣,竹東鎮,上坪里,104,309,121,24,145,7,152
公投第７案,新竹縣,竹東鎮,瑞峰里,105,416,145,46,191,24,215
公投第７案,新竹縣,竹東鎮,軟橋里,106,386,155,33,188,4,192
公投第７案,新竹縣,竹東鎮,員崠里,107,950,367,79,446,21,467
公投第７案,新竹縣,竹東鎮,員崠里,108,1275,535,107,642,15,657
公投第７案,新竹縣,竹東鎮,上舘里,109,1213,509,116,625,32,657
公投第７案,新竹縣,竹東鎮,上舘里,110,1548,697,134,831,34,865
公投第７案,新竹縣,竹東鎮,上舘里,111,1246,510,87,597,26,623
公投第７案,新竹縣,竹東鎮,上舘里,112,1252,444,94,538,37,575
公投第７案,新竹縣,竹東鎮,上舘里,113,1359,573,101,674,44,718
公投第７案,新竹縣,竹東鎮,上舘里,114,1255,502,131,633,36,669
公投第７案,新竹縣,竹東鎮,上舘里,115,1304,598,123,721,29,750
公投第７案,新竹縣,竹東鎮,東寧里,116,1292,575,121,696,33,729
公投第７案,新竹縣,竹東鎮,東寧里,117,1111,456,84,540,14,554
公投第７案,新竹縣,竹東鎮,東寧里,118,880,410,76,486,36,522
公投第７案,新竹縣,竹東鎮,中正里,119,670,313,63,376,16,392
公投第７案,新竹縣,竹東鎮,中正里,120,1244,582,113,695,30,725
公投第７案,新竹縣,竹東鎮,大鄉里,121,1126,462,101,563,44,607
公投第７案,新竹縣,竹東鎮,大鄉里,122,1073,456,95,551,38,589
公投第７案,新竹縣,竹東鎮,大鄉里,123,1215,516,140,656,39,695
公投第７案,新竹縣,竹東鎮,大鄉里,124,1155,561,84,645,15,660
公投第７案,新竹縣,竹東鎮,中山里,125,852,353,92,445,40,485
公投第７案,新竹縣,竹東鎮,中山里,126,875,384,111,495,31,526
公投第７案,新竹縣,竹東鎮,南華里,127,1070,496,125,621,33,654
公投第７案,新竹縣,竹東鎮,東華里,128,704,286,68,354,24,378
公投第７案,新竹縣,竹東鎮,商華里,129,951,293,58,351,31,382
公投第７案,新竹縣,竹東鎮,商華里,130,984,432,104,536,19,555
公投第７案,新竹縣,竹東鎮,商華里,131,1113,380,82,462,10,472
公投第７案,新竹縣,竹東鎮,竹東里,132,595,265,71,336,20,356
公投第７案,新竹縣,竹東鎮,竹東里,133,762,334,94,428,40,468
公投第７案,新竹縣,竹東鎮,忠孝里,134,763,319,88,407,15,422
公投第７案,新竹縣,竹東鎮,忠孝里,135,813,307,98,405,15,420
公投第７案,新竹縣,竹東鎮,鷄林里,136,1310,480,117,597,22,619
公投第７案,新竹縣,竹東鎮,鷄林里,137,1434,552,116,668,36,704
公投第７案,新竹縣,竹東鎮,鷄林里,138,1131,485,123,608,31,639
公投第７案,新竹縣,竹東鎮,仁愛里,139,967,424,81,505,23,528
公投第７案,新竹縣,竹東鎮,仁愛里,140,1196,455,125,580,32,612
公投第７案,新竹縣,竹東鎮,仁愛里,141,1154,512,108,620,34,654
公投第７案,新竹縣,竹東鎮,榮樂里,142,715,315,87,402,37,439
公投第７案,新竹縣,竹東鎮,榮樂里,143,685,284,87,371,10,381
公投第７案,新竹縣,竹東鎮,榮華里,144,1352,554,120,674,44,718
公投第７案,新竹縣,竹東鎮,榮華里,145,1407,630,116,746,60,806
公投第７案,新竹縣,竹東鎮,榮華里,146,1362,581,148,729,1,730
公投第７案,新竹縣,竹東鎮,榮華里,147,1330,600,115,715,37,752
公投第７案,新竹縣,竹東鎮,榮華里,148,1441,592,152,744,49,793
公投第７案,新竹縣,竹東鎮,五豐里,149,1248,503,111,614,12,626
公投第７案,新竹縣,竹東鎮,五豐里,150,1263,434,102,536,29,565
公投第７案,新竹縣,竹東鎮,五豐里,151,1232,466,103,569,21,590
公投第７案,新竹縣,竹東鎮,五豐里,152,1143,421,100,521,20,541
公投第７案,新竹縣,竹東鎮,五豐里,153,1529,658,142,800,30,830
公投第７案,新竹縣,竹東鎮,五豐里,154,1140,483,111,594,32,626
公投第７案,新竹縣,竹東鎮,陸豐里,155,570,271,76,347,17,364
公投第７案,新竹縣,竹東鎮,三重里,156,1345,519,115,634,22,656
公投第７案,新竹縣,竹東鎮,三重里,157,1381,536,134,670,61,731
公投第７案,新竹縣,竹東鎮,三重里,158,1379,603,111,714,50,764
公投第７案,新竹縣,竹東鎮,三重里,159,1033,455,103,558,43,601
公投第７案,新竹縣,竹東鎮,三重里,160,1066,455,99,554,27,581
公投第７案,新竹縣,竹東鎮,二重里,161,938,416,100,516,38,554
公投第７案,新竹縣,竹東鎮,二重里,162,952,447,99,546,40,586
公投第７案,新竹縣,竹東鎮,二重里,163,1468,685,158,843,41,884
公投第７案,新竹縣,竹東鎮,二重里,164,1915,737,197,934,42,976
公投第７案,新竹縣,竹東鎮,二重里,165,1220,480,115,595,37,632
公投第７案,新竹縣,竹東鎮,二重里,166,1166,414,94,508,23,531
公投第７案,新竹縣,竹東鎮,二重里,167,1492,556,131,687,25,712
公投第７案,新竹縣,竹東鎮,二重里,168,1245,448,164,612,40,652
公投第７案,新竹縣,竹東鎮,頭重里,169,1083,472,119,591,34,625
公投第７案,新竹縣,竹東鎮,頭重里,170,1102,461,115,576,29,605
公投第７案,新竹縣,竹東鎮,頭重里,171,1068,454,103,557,20,577
公投第７案,新竹縣,竹東鎮,頭重里,172,1097,475,121,596,29,625
公投第７案,新竹縣,竹東鎮,員山里,173,962,375,83,458,21,479
公投第７案,新竹縣,竹東鎮,員山里,174,909,383,111,494,24,518
公投第７案,新竹縣,竹東鎮,柯湖里,175,603,234,45,279,23,302
公投第７案,新竹縣,新埔鎮,新埔里,176,983,462,86,548,38,586
公投第７案,新竹縣,新埔鎮,新生里,177,597,261,81,342,27,369
公投第７案,新竹縣,新埔鎮,新民里,178,1070,478,100,578,17,595
公投第７案,新竹縣,新埔鎮,田新里,179,935,410,83,493,33,526
公投第７案,新竹縣,新埔鎮,田新里,180,753,326,81,407,26,433
公投第７案,新竹縣,新埔鎮,田新里,181,838,440,93,533,18,551
公投第７案,新竹縣,新埔鎮,旱坑里,182,924,404,84,488,32,520
公投第７案,新竹縣,新埔鎮,旱坑里,183,905,356,66,422,26,448
公投第７案,新竹縣,新埔鎮,五埔里,184,948,419,98,517,21,538
公投第７案,新竹縣,新埔鎮,五埔里,185,1017,455,98,553,41,594
公投第７案,新竹縣,新埔鎮,四座里,186,1176,548,127,675,38,713
公投第７案,新竹縣,新埔鎮,四座里,187,1122,487,153,640,58,698
公投第７案,新竹縣,新埔鎮,四座里,188,1022,345,95,440,14,454
公投第７案,新竹縣,新埔鎮,照門里,189,1429,535,134,669,42,711
公投第７案,新竹縣,新埔鎮,清水里,190,451,221,54,275,30,305
公投第７案,新竹縣,新埔鎮,鹿鳴里,191,724,284,95,379,31,410
公投第７案,新竹縣,新埔鎮,新北里,192,617,292,70,362,30,392
公投第７案,新竹縣,新埔鎮,巨埔里,193,1144,501,129,630,48,678
公投第７案,新竹縣,新埔鎮,內立里,194,1139,494,117,611,45,656
公投第７案,新竹縣,新埔鎮,寶石里,195,861,390,76,466,15,481
公投第７案,新竹縣,新埔鎮,文山里,196,1093,439,99,538,19,557
公投第７案,新竹縣,新埔鎮,文山里,197,978,371,102,473,35,508
公投第７案,新竹縣,新埔鎮,文山里,198,1040,403,77,480,26,506
公投第７案,新竹縣,新埔鎮,文山里,199,1160,462,117,579,41,620
公投第７案,新竹縣,新埔鎮,上寮里,200,950,452,96,548,27,575
公投第７案,新竹縣,新埔鎮,上寮里,201,882,388,82,470,27,497
公投第７案,新竹縣,新埔鎮,下寮里,202,1281,530,151,681,57,738
公投第７案,新竹縣,新埔鎮,下寮里,203,1212,507,104,611,40,651
公投第７案,新竹縣,新埔鎮,南平里,204,1013,362,85,447,38,485
公投第７案,新竹縣,新埔鎮,北平里,205,630,305,66,371,31,402
公投第７案,新竹縣,關西鎮,東興里,206,480,248,35,283,24,307
公投第７案,新竹縣,關西鎮,西安里,207,903,407,102,509,32,541
公投第７案,新竹縣,關西鎮,西安里,208,1020,453,110,563,31,594
公投第７案,新竹縣,關西鎮,南雄里,209,705,293,67,360,17,377
公投第７案,新竹縣,關西鎮,北斗里,210,1056,438,110,548,29,577
公投第７案,新竹縣,關西鎮,北斗里,211,1275,532,129,661,39,700
公投第７案,新竹縣,關西鎮,北斗里,212,1287,582,130,712,42,754
公投第７案,新竹縣,關西鎮,北山里,213,771,361,80,441,25,466
公投第７案,新竹縣,關西鎮,仁安里,214,1046,427,104,531,38,569
公投第７案,新竹縣,關西鎮,南山里,215,1030,440,127,567,35,602
公投第７案,新竹縣,關西鎮,東安里,216,1208,548,103,651,36,687
公投第７案,新竹縣,關西鎮,東安里,217,1095,429,64,493,37,530
公投第７案,新竹縣,關西鎮,東安里,218,1350,534,144,678,33,711
公投第７案,新竹縣,關西鎮,東山里,219,846,427,85,512,24,536
公投第７案,新竹縣,關西鎮,東光里,220,1362,559,129,688,55,743
公投第７案,新竹縣,關西鎮,南新里,221,903,340,83,423,24,447
公投第７案,新竹縣,關西鎮,新富里,222,551,202,49,251,16,267
公投第７案,新竹縣,關西鎮,玉山里,223,461,148,32,180,11,191
公投第７案,新竹縣,關西鎮,金山里,224,572,245,46,291,28,319
公投第７案,新竹縣,關西鎮,錦山里,225,943,377,108,485,22,507
公投第７案,新竹縣,關西鎮,大同里,226,808,330,104,434,35,469
公投第７案,新竹縣,關西鎮,石光里,227,923,469,92,561,21,582
公投第７案,新竹縣,關西鎮,石光里,228,903,415,84,499,35,534
公投第７案,新竹縣,關西鎮,東平里,229,977,439,98,537,39,576
公投第７案,新竹縣,關西鎮,上林里,230,824,372,101,473,32,505
公投第７案,新竹縣,關西鎮,新力里,231,559,270,57,327,16,343
公投第７案,新竹縣,關西鎮,南和里,232,854,429,78,507,27,534
公投第７案,新竹縣,湖口鄉,和興村,233,1393,526,143,669,37,706
公投第７案,新竹縣,湖口鄉,和興村,234,1505,662,180,842,26,868
公投第７案,新竹縣,湖口鄉,東興村,235,1188,574,161,735,25,760
公投第７案,新竹縣,湖口鄉,東興村,236,1267,539,141,680,46,726
公投第７案,新竹縣,湖口鄉,東興村,237,1668,731,166,897,34,931
公投第７案,新竹縣,湖口鄉,德盛村,238,1719,767,183,950,49,999
公投第７案,新竹縣,湖口鄉,德盛村,239,1162,550,129,679,39,718
公投第７案,新竹縣,湖口鄉,德盛村,240,1833,730,164,894,43,937
公投第７案,新竹縣,湖口鄉,愛勢村,241,1444,617,161,778,41,819
公投第７案,新竹縣,湖口鄉,愛勢村,242,1347,639,126,765,73,838
公投第７案,新竹縣,湖口鄉,愛勢村,243,1202,562,109,671,15,686
公投第７案,新竹縣,湖口鄉,仁勢村,244,851,387,95,482,37,519
公投第７案,新竹縣,湖口鄉,孝勢村,245,1272,577,141,718,50,768
公投第７案,新竹縣,湖口鄉,中勢村,246,1275,556,127,683,38,721
公投第７案,新竹縣,湖口鄉,中勢村,247,1560,737,190,927,45,972
公投第７案,新竹縣,湖口鄉,中正村,248,1147,521,139,660,72,732
公投第７案,新竹縣,湖口鄉,中正村,249,1729,773,155,928,48,976
公投第７案,新竹縣,湖口鄉,信勢村,250,1402,579,132,711,43,754
公投第７案,新竹縣,湖口鄉,信勢村,251,1183,540,115,655,53,708
公投第７案,新竹縣,湖口鄉,信勢村,252,1282,614,123,737,39,776
公投第７案,新竹縣,湖口鄉,信勢村,253,1335,610,146,756,47,803
公投第７案,新竹縣,湖口鄉,信義村,254,1493,717,170,887,40,927
公投第７案,新竹縣,湖口鄉,信義村,255,1877,809,163,972,16,988
公投第７案,新竹縣,湖口鄉,波羅村,256,1082,526,114,640,32,672
公投第７案,新竹縣,湖口鄉,波羅村,257,1115,492,152,644,42,686
公投第７案,新竹縣,湖口鄉,長嶺村,258,1193,469,100,569,32,601
公投第７案,新竹縣,湖口鄉,長嶺村,259,1947,813,151,964,38,1002
公投第７案,新竹縣,湖口鄉,長安村,260,1125,495,135,630,48,678
公投第７案,新竹縣,湖口鄉,湖口村,261,1050,461,105,566,45,611
公投第７案,新竹縣,湖口鄉,湖口村,262,1733,783,170,953,46,999
公投第７案,新竹縣,湖口鄉,湖鏡村,263,1284,597,127,724,35,759
公投第７案,新竹縣,湖口鄉,湖鏡村,264,1062,515,90,605,26,631
公投第７案,新竹縣,湖口鄉,湖南村,265,1547,689,126,815,48,863
公投第７案,新竹縣,湖口鄉,中興村,266,1494,570,131,701,36,737
公投第７案,新竹縣,湖口鄉,中興村,267,1634,640,125,765,24,789
公投第７案,新竹縣,湖口鄉,中興村,268,1444,564,85,649,18,667
公投第７案,新竹縣,湖口鄉,中興村,269,1324,548,124,672,22,694
公投第７案,新竹縣,湖口鄉,鳳凰村,270,1058,463,108,571,30,601
公投第７案,新竹縣,湖口鄉,鳳凰村,271,1220,406,76,482,24,506
公投第７案,新竹縣,湖口鄉,鳳凰村,272,1333,571,142,713,33,746
公投第７案,新竹縣,湖口鄉,鳳凰村,273,1461,593,124,717,49,766
公投第７案,新竹縣,湖口鄉,勝利村,274,1429,581,144,725,21,746
公投第７案,新竹縣,湖口鄉,勝利村,275,1506,570,117,687,18,705
公投第７案,新竹縣,湖口鄉,勝利村,276,1103,535,100,635,35,670
公投第７案,新竹縣,湖口鄉,鳳山村,277,1495,541,165,706,35,741
公投第７案,新竹縣,湖口鄉,鳳山村,278,752,337,67,404,30,434
公投第７案,新竹縣,湖口鄉,鳳山村,279,986,429,90,519,25,544
公投第７案,新竹縣,新豐鄉,福興村,280,1080,419,107,526,51,577
公投第７案,新竹縣,新豐鄉,青埔村,281,887,329,115,444,24,468
公投第７案,新竹縣,新豐鄉,青埔村,282,954,399,107,506,29,535
公投第７案,新竹縣,新豐鄉,中崙村,283,1003,422,100,522,26,548
公投第７案,新竹縣,新豐鄉,中崙村,284,1106,467,103,570,34,604
公投第７案,新竹縣,新豐鄉,中崙村,285,1123,497,130,627,32,659
公投第７案,新竹縣,新豐鄉,瑞興村,286,891,385,98,483,39,522
公投第７案,新竹縣,新豐鄉,瑞興村,287,874,334,82,416,24,440
公投第７案,新竹縣,新豐鄉,後湖村,288,824,331,98,429,30,459
公投第７案,新竹縣,新豐鄉,後湖村,289,975,384,83,467,22,489
公投第７案,新竹縣,新豐鄉,坡頭村,290,847,349,80,429,48,477
公投第７案,新竹縣,新豐鄉,埔和村,291,1477,598,156,754,79,833
公投第７案,新竹縣,新豐鄉,埔和村,292,1266,451,160,611,50,661
公投第７案,新竹縣,新豐鄉,新豐村,293,1029,390,103,493,66,559
公投第７案,新竹縣,新豐鄉,新豐村,294,1063,391,135,526,49,575
公投第７案,新竹縣,新豐鄉,員山村,295,1055,455,104,559,27,586
公投第７案,新竹縣,新豐鄉,員山村,296,1445,683,105,788,19,807
公投第７案,新竹縣,新豐鄉,忠孝村,297,1413,692,142,834,31,865
公投第７案,新竹縣,新豐鄉,忠孝村,298,971,473,115,588,30,618
公投第７案,新竹縣,新豐鄉,忠孝村,299,1135,536,86,622,26,648
公投第７案,新竹縣,新豐鄉,山崎村,300,1269,514,129,643,37,680
公投第７案,新竹縣,新豐鄉,山崎村,301,1257,540,138,678,32,710
公投第７案,新竹縣,新豐鄉,山崎村,302,1662,775,155,930,42,972
公投第７案,新竹縣,新豐鄉,上坑村,303,1486,595,166,761,12,773
公投第７案,新竹縣,新豐鄉,鳳坑村,304,1067,490,119,609,58,667
公投第７案,新竹縣,新豐鄉,重興村,305,1302,608,125,733,53,786
公投第７案,新竹縣,新豐鄉,重興村,306,1410,570,158,728,60,788
公投第７案,新竹縣,新豐鄉,重興村,307,1267,523,132,655,40,695
公投第７案,新竹縣,新豐鄉,重興村,308,1258,484,107,591,41,632
公投第７案,新竹縣,新豐鄉,崎頂村,309,1217,467,106,573,20,593
公投第７案,新竹縣,新豐鄉,崎頂村,310,1456,614,152,766,36,802
公投第７案,新竹縣,新豐鄉,松林村,311,1157,541,108,649,31,680
公投第７案,新竹縣,新豐鄉,松林村,312,1089,442,101,543,29,572
公投第７案,新竹縣,新豐鄉,松林村,313,1160,522,110,632,16,648
公投第７案,新竹縣,新豐鄉,松林村,314,976,493,96,589,19,608
公投第７案,新竹縣,新豐鄉,松柏村,315,1443,634,138,772,38,810
公投第７案,新竹縣,新豐鄉,松柏村,316,1247,479,125,604,21,625
公投第７案,新竹縣,新豐鄉,松柏村,317,1411,638,128,766,23,789
公投第７案,新竹縣,新豐鄉,松柏村,318,1238,585,110,695,41,736
公投第７案,新竹縣,芎林鄉,華龍村,319,417,176,58,234,9,243
公投第７案,新竹縣,芎林鄉,五龍村,320,534,275,75,350,22,372
公投第７案,新竹縣,芎林鄉,秀湖村,321,963,431,104,535,30,565
公投第７案,新竹縣,芎林鄉,永興村,322,418,194,56,250,21,271
公投第７案,新竹縣,芎林鄉,石潭村,323,1312,548,131,679,41,720
公投第７案,新竹縣,芎林鄉,石潭村,324,1354,507,129,636,41,677
公投第７案,新竹縣,芎林鄉,新鳳村,325,785,342,90,432,38,470
公投第７案,新竹縣,芎林鄉,新鳳村,326,797,377,78,455,34,489
公投第７案,新竹縣,芎林鄉,中坑村,327,623,284,68,352,22,374
公投第７案,新竹縣,芎林鄉,水坑村,328,759,321,84,405,30,435
公投第７案,新竹縣,芎林鄉,文林村,329,1272,499,113,612,33,645
公投第７案,新竹縣,芎林鄉,文林村,330,1129,529,108,637,36,673
公投第７案,新竹縣,芎林鄉,芎林村,331,713,328,90,418,27,445
公投第７案,新竹縣,芎林鄉,芎林村,332,839,390,91,481,40,521
公投第７案,新竹縣,芎林鄉,上山村,333,1123,559,142,701,32,733
公投第７案,新竹縣,芎林鄉,上山村,334,981,462,100,562,16,578
公投第７案,新竹縣,芎林鄉,上山村,335,1078,468,142,610,46,656
公投第７案,新竹縣,芎林鄉,上山村,336,1094,462,106,568,28,596
公投第７案,新竹縣,芎林鄉,下山村,337,1102,479,130,609,46,655
公投第７案,新竹縣,橫山鄉,橫山村,338,1231,569,137,706,46,752
公投第７案,新竹縣,橫山鄉,橫山村,339,1041,470,111,581,44,625
公投第７案,新竹縣,橫山鄉,橫山村,340,1132,520,134,654,32,686
公投第７案,新竹縣,橫山鄉,田寮村,341,859,395,76,471,34,505
公投第７案,新竹縣,橫山鄉,南昌村,342,204,81,22,103,14,117
公投第７案,新竹縣,橫山鄉,豐鄉村,343,222,72,19,91,9,100
公投第７案,新竹縣,橫山鄉,豐田村,344,338,154,41,195,22,217
公投第７案,新竹縣,橫山鄉,內灣村,345,916,389,72,461,31,492
公投第７案,新竹縣,橫山鄉,力行村,346,573,193,35,228,10,238
公投第７案,新竹縣,橫山鄉,力行村,347,275,141,35,176,12,188
公投第７案,新竹縣,橫山鄉,福興村,348,463,172,39,211,15,226
公投第７案,新竹縣,橫山鄉,沙坑村,349,690,333,67,400,38,438
公投第７案,新竹縣,橫山鄉,沙坑村,350,288,100,30,130,11,141
公投第７案,新竹縣,橫山鄉,新興村,351,685,342,76,418,24,442
公投第７案,新竹縣,橫山鄉,新興村,352,868,415,94,509,28,537
公投第７案,新竹縣,橫山鄉,大肚村,353,1561,727,178,905,60,965
公投第７案,新竹縣,北埔鄉,北埔村,354,1158,442,105,547,17,564
公投第７案,新竹縣,北埔鄉,南興村,355,1238,543,146,689,44,733
公投第７案,新竹縣,北埔鄉,大湖村,356,580,248,71,319,18,337
公投第７案,新竹縣,北埔鄉,埔尾村,357,931,422,92,514,25,539
公投第７案,新竹縣,北埔鄉,埔尾村,358,1653,724,146,870,60,930
公投第７案,新竹縣,北埔鄉,水磜村,359,845,376,80,456,27,483
公投第７案,新竹縣,北埔鄉,南埔村,360,384,167,32,199,9,208
公投第７案,新竹縣,北埔鄉,大林村,361,763,349,61,410,9,419
公投第７案,新竹縣,北埔鄉,南坑村,362,333,142,30,172,13,185
公投第７案,新竹縣,北埔鄉,外坪村,363,295,122,19,141,5,146
公投第７案,新竹縣,寶山鄉,雙溪村,364,1158,503,121,624,43,667
公投第７案,新竹縣,寶山鄉,雙溪村,365,1437,632,167,799,24,823
公投第７案,新竹縣,寶山鄉,雙新村,366,1470,631,161,792,45,837
公投第７案,新竹縣,寶山鄉,雙新村,367,1170,521,141,662,46,708
公投第７案,新竹縣,寶山鄉,大崎村,368,1900,838,208,1046,54,1100
公投第７案,新竹縣,寶山鄉,三峰村,369,1056,412,101,513,24,537
公投第７案,新竹縣,寶山鄉,新城村,370,1205,562,146,708,49,757
公投第７案,新竹縣,寶山鄉,寶斗村,371,766,345,67,412,28,440
公投第７案,新竹縣,寶山鄉,深井村,372,846,413,72,485,32,517
公投第７案,新竹縣,寶山鄉,寶山村,373,804,372,89,461,28,489
公投第７案,新竹縣,寶山鄉,油田村,374,607,288,60,348,13,361
公投第７案,新竹縣,寶山鄉,山湖村,375,554,256,84,340,12,352
公投第７案,新竹縣,峨眉鄉,峨眉村,376,879,427,98,525,45,570
公投第７案,新竹縣,峨眉鄉,中盛村,377,683,309,82,391,40,431
公投第７案,新竹縣,峨眉鄉,石井村,378,604,267,78,345,20,365
公投第７案,新竹縣,峨眉鄉,七星村,379,339,145,36,181,18,199
公投第７案,新竹縣,峨眉鄉,七星村,380,276,82,26,108,6,114
公投第７案,新竹縣,峨眉鄉,富興村,381,1406,639,143,782,75,857
公投第７案,新竹縣,峨眉鄉,湖光村,382,462,219,46,265,24,289
公投第７案,新竹縣,峨眉鄉,湖光村,383,419,150,61,211,14,225
公投第７案,新竹縣,尖石鄉,嘉樂村,384,474,141,36,177,8,185
公投第７案,新竹縣,尖石鄉,嘉樂村,385,357,140,22,162,6,168
公投第７案,新竹縣,尖石鄉,義興村,386,225,80,16,96,14,110
公投第７案,新竹縣,尖石鄉,義興村,387,374,130,33,163,5,168
公投第７案,新竹縣,尖石鄉,新樂村,388,773,250,48,298,7,305
公投第７案,新竹縣,尖石鄉,新樂村,389,490,160,36,196,16,212
公投第７案,新竹縣,尖石鄉,錦屏村,390,531,141,35,176,4,180
公投第７案,新竹縣,尖石鄉,錦屏村,391,660,211,44,255,5,260
公投第７案,新竹縣,尖石鄉,梅花村,392,613,250,93,343,57,400
公投第７案,新竹縣,尖石鄉,玉峰村,393,593,206,49,255,2,257
公投第７案,新竹縣,尖石鄉,玉峰村,394,575,191,48,239,19,258
公投第７案,新竹縣,尖石鄉,玉峰村,395,126,68,9,77,7,84
公投第７案,新竹縣,尖石鄉,秀巒村,396,499,132,29,161,4,165
公投第７案,新竹縣,尖石鄉,秀巒村,397,785,153,51,204,14,218
公投第７案,新竹縣,尖石鄉,秀巒村,398,289,105,16,121,42,163
公投第７案,新竹縣,五峰鄉,大隘村,399,672,255,74,329,28,357
公投第７案,新竹縣,五峰鄉,大隘村,400,713,228,63,291,12,303
公投第７案,新竹縣,五峰鄉,桃山村,401,594,158,32,190,6,196
公投第７案,新竹縣,五峰鄉,桃山村,402,896,285,63,348,18,366
公投第７案,新竹縣,五峰鄉,花園村,403,727,210,66,276,5,281
公投第７案,新竹縣,五峰鄉,竹林村,404,395,106,33,139,6,145
公投第７案,苗栗縣,苗栗市,中苗里,1,1087,509,88,597,28,625
公投第７案,苗栗縣,苗栗市,青苗里,2,1018,456,82,538,33,571
公投第７案,苗栗縣,苗栗市,維祥里,3,1156,522,95,617,17,634
公投第７案,苗栗縣,苗栗市,維祥里,4,1118,496,88,584,27,611
公投第７案,苗栗縣,苗栗市,維祥里,5,1084,487,115,602,41,643
公投第７案,苗栗縣,苗栗市,維新里,6,1203,572,113,685,33,718
公投第７案,苗栗縣,苗栗市,維新里,7,1306,628,114,742,33,775
公投第７案,苗栗縣,苗栗市,維新里,8,1193,537,141,678,38,716
公投第７案,苗栗縣,苗栗市,玉清里,9,1115,529,108,637,19,656
公投第７案,苗栗縣,苗栗市,玉清里,10,1119,540,106,646,39,685
公投第７案,苗栗縣,苗栗市,玉華里,11,1132,530,138,668,28,696
公投第７案,苗栗縣,苗栗市,玉華里,12,1289,598,112,710,31,741
公投第７案,苗栗縣,苗栗市,玉華里,13,1264,619,111,730,29,759
公投第７案,苗栗縣,苗栗市,綠苗里,14,870,396,77,473,19,492
公投第７案,苗栗縣,苗栗市,高苗里,15,1008,406,80,486,27,513
公投第７案,苗栗縣,苗栗市,高苗里,16,1078,451,94,545,24,569
公投第７案,苗栗縣,苗栗市,高苗里,17,1077,520,105,625,20,645
公投第７案,苗栗縣,苗栗市,新苗里,18,880,386,88,474,33,507
公投第７案,苗栗縣,苗栗市,玉苗里,19,894,364,94,458,45,503
公投第７案,苗栗縣,苗栗市,大同里,20,522,239,47,286,18,304
公投第７案,苗栗縣,苗栗市,恭敬里,21,1376,661,160,821,50,871
公投第７案,苗栗縣,苗栗市,水源里,22,1391,611,112,723,27,750
公投第７案,苗栗縣,苗栗市,水源里,23,1081,492,109,601,47,648
公投第７案,苗栗縣,苗栗市,勝利里,24,1272,551,128,679,30,709
公投第７案,苗栗縣,苗栗市,勝利里,25,1112,546,130,676,34,710
公投第７案,苗栗縣,苗栗市,勝利里,26,813,438,89,527,17,544
公投第７案,苗栗縣,苗栗市,勝利里,27,767,329,89,418,19,437
公投第７案,苗栗縣,苗栗市,清華里,28,1010,444,102,546,17,563
公投第７案,苗栗縣,苗栗市,清華里,29,1182,535,99,634,32,666
公投第７案,苗栗縣,苗栗市,清華里,30,965,445,93,538,17,555
公投第７案,苗栗縣,苗栗市,上苗里,31,607,293,58,351,13,364
公投第７案,苗栗縣,苗栗市,上苗里,32,990,478,103,581,31,612
公投第７案,苗栗縣,苗栗市,北苗里,33,1230,510,114,624,42,666
公投第７案,苗栗縣,苗栗市,北苗里,34,1372,635,126,761,32,793
公投第７案,苗栗縣,苗栗市,北苗里,35,1213,573,99,672,33,705
公投第７案,苗栗縣,苗栗市,北苗里,36,1272,593,100,693,31,724
公投第７案,苗栗縣,苗栗市,嘉盛里,37,1221,597,127,724,26,750
公投第７案,苗栗縣,苗栗市,嘉盛里,38,1104,490,123,613,32,645
公投第７案,苗栗縣,苗栗市,嘉盛里,39,1171,495,92,587,18,605
公投第７案,苗栗縣,苗栗市,福星里,40,1392,608,141,749,35,784
公投第７案,苗栗縣,苗栗市,福星里,41,1356,609,150,759,36,795
公投第７案,苗栗縣,苗栗市,福星里,42,1387,626,129,755,48,803
公投第７案,苗栗縣,苗栗市,福安里,43,1206,551,106,657,34,691
公投第７案,苗栗縣,苗栗市,福安里,44,1004,481,123,604,34,638
公投第７案,苗栗縣,苗栗市,福安里,45,1202,509,131,640,33,673
公投第７案,苗栗縣,苗栗市,嘉新里,46,1052,505,113,618,24,642
公投第７案,苗栗縣,苗栗市,嘉新里,47,873,430,91,521,22,543
公投第７案,苗栗縣,苗栗市,嘉新里,48,975,524,110,634,19,653
公投第７案,苗栗縣,苗栗市,建功里,49,1003,514,99,613,30,643
公投第７案,苗栗縣,苗栗市,建功里,50,1000,472,90,562,19,581
公投第７案,苗栗縣,苗栗市,建功里,51,1047,481,81,562,28,590
公投第７案,苗栗縣,苗栗市,建功里,52,1025,509,84,593,33,626
公投第７案,苗栗縣,苗栗市,福麗里,53,1130,499,98,597,14,611
公投第７案,苗栗縣,苗栗市,福麗里,54,1146,534,99,633,21,654
公投第７案,苗栗縣,苗栗市,福麗里,55,1432,654,136,790,44,834
公投第７案,苗栗縣,苗栗市,福麗里,56,1492,557,110,667,29,696
公投第７案,苗栗縣,苗栗市,文山里,57,1125,540,125,665,25,690
公投第７案,苗栗縣,苗栗市,文山里,58,1241,549,116,665,30,695
公投第７案,苗栗縣,苗栗市,文山里,59,1278,597,132,729,38,767
公投第７案,苗栗縣,苗栗市,文聖里,60,1293,584,107,691,22,713
公投第７案,苗栗縣,苗栗市,文聖里,61,1342,559,125,684,28,712
公投第７案,苗栗縣,苗栗市,文聖里,62,857,365,90,455,25,480
公投第７案,苗栗縣,苗栗市,新川里,63,1180,507,105,612,35,647
公投第７案,苗栗縣,苗栗市,南勢里,64,1072,490,114,604,32,636
公投第７案,苗栗縣,苗栗市,南勢里,65,912,399,64,463,19,482
公投第７案,苗栗縣,苗栗市,新英里,66,796,327,73,400,26,426
公投第７案,苗栗縣,苗栗市,新英里,67,869,334,78,412,18,430
公投第７案,苗栗縣,公館鄉,館中村,68,789,365,112,477,43,520
公投第７案,苗栗縣,公館鄉,館中村,69,792,405,84,489,32,521
公投第７案,苗栗縣,公館鄉,館東村,70,1117,505,147,652,65,717
公投第７案,苗栗縣,公館鄉,館東村,71,1255,574,157,731,54,785
公投第７案,苗栗縣,公館鄉,館南村,72,1141,532,118,650,34,684
公投第７案,苗栗縣,公館鄉,館南村,73,1172,532,125,657,30,687
公投第７案,苗栗縣,公館鄉,館南村,74,1100,542,120,662,33,695
公投第７案,苗栗縣,公館鄉,中義村,75,1232,496,115,611,41,652
公投第７案,苗栗縣,公館鄉,中義村,76,1081,431,96,527,42,569
公投第７案,苗栗縣,公館鄉,玉泉村,77,1250,628,101,729,46,775
公投第７案,苗栗縣,公館鄉,玉泉村,78,1081,480,118,598,33,631
公投第７案,苗栗縣,公館鄉,大坑村,79,964,403,100,503,50,553
公投第７案,苗栗縣,公館鄉,福基村,80,1038,459,126,585,47,632
公投第７案,苗栗縣,公館鄉,福德村,81,360,159,53,212,15,227
公投第７案,苗栗縣,公館鄉,福星村,82,865,362,93,455,43,498
公投第７案,苗栗縣,公館鄉,福星村,83,1166,496,122,618,34,652
公投第７案,苗栗縣,公館鄉,石墻村,84,719,333,81,414,16,430
公投第７案,苗栗縣,公館鄉,石墻村,85,788,326,76,402,33,435
公投第７案,苗栗縣,公館鄉,開礦村,86,303,140,35,175,27,202
公投第７案,苗栗縣,公館鄉,五谷村,87,1322,614,142,756,38,794
公投第７案,苗栗縣,公館鄉,五谷村,88,933,401,97,498,37,535
公投第７案,苗栗縣,公館鄉,玉谷村,89,1455,616,131,747,45,792
公投第７案,苗栗縣,公館鄉,鶴岡村,90,1615,753,181,934,65,999
公投第７案,苗栗縣,公館鄉,鶴山村,91,1451,628,134,762,43,805
公投第７案,苗栗縣,公館鄉,尖山村,92,1462,666,166,832,50,882
公投第７案,苗栗縣,公館鄉,仁安村,93,1317,552,144,696,41,737
公投第７案,苗栗縣,公館鄉,南河村,94,221,103,20,123,8,131
公投第７案,苗栗縣,公館鄉,北河村,95,329,133,33,166,9,175
公投第７案,苗栗縣,頭屋鄉,頭屋村,96,1335,751,98,849,44,893
公投第７案,苗栗縣,頭屋鄉,頭屋村,97,1168,637,144,781,48,829
公投第７案,苗栗縣,頭屋鄉,獅潭村,98,792,386,110,496,20,516
公投第７案,苗栗縣,頭屋鄉,獅潭村,99,918,515,105,620,38,658
公投第７案,苗栗縣,頭屋鄉,北坑村,100,725,364,74,438,24,462
公投第７案,苗栗縣,頭屋鄉,曲洞村,101,899,445,89,534,22,556
公投第７案,苗栗縣,頭屋鄉,飛鳳村,102,369,139,32,171,10,181
公投第７案,苗栗縣,頭屋鄉,象山村,103,844,377,110,487,17,504
公投第７案,苗栗縣,頭屋鄉,象山村,104,1007,469,99,568,25,593
公投第７案,苗栗縣,頭屋鄉,明德村,105,794,394,78,472,28,500
公投第７案,苗栗縣,頭屋鄉,明德村,106,211,120,23,143,14,157
公投第７案,苗栗縣,頭屋鄉,鳴鳳村,107,328,169,50,219,18,237
公投第７案,苗栗縣,銅鑼鄉,銅鑼村,108,887,438,85,523,25,548
公投第７案,苗栗縣,銅鑼鄉,銅鑼村,109,1052,492,101,593,37,630
公投第７案,苗栗縣,銅鑼鄉,銅鑼村,110,1347,648,151,799,27,826
公投第７案,苗栗縣,銅鑼鄉,銅鑼村,111,1177,529,116,645,27,672
公投第７案,苗栗縣,銅鑼鄉,樟樹村,112,1268,528,122,650,33,683
公投第７案,苗栗縣,銅鑼鄉,九湖村,113,1185,440,111,551,26,577
公投第７案,苗栗縣,銅鑼鄉,福興村,114,1029,484,79,563,33,596
公投第７案,苗栗縣,銅鑼鄉,朝陽村,115,905,421,74,495,26,521
公投第７案,苗栗縣,銅鑼鄉,朝陽村,116,750,347,92,439,27,466
公投第７案,苗栗縣,銅鑼鄉,竹森村,117,1080,437,95,532,32,564
公投第７案,苗栗縣,銅鑼鄉,中平村,118,1108,450,118,568,33,601
公投第７案,苗栗縣,銅鑼鄉,中平村,119,862,376,56,432,25,457
公投第７案,苗栗縣,銅鑼鄉,中平村,120,1216,500,125,625,22,647
公投第７案,苗栗縣,銅鑼鄉,興隆村,121,588,223,54,277,26,303
公投第７案,苗栗縣,銅鑼鄉,盛隆村,122,429,165,43,208,26,234
公投第７案,苗栗縣,銅鑼鄉,新隆村,123,541,248,50,298,19,317
公投第７案,苗栗縣,三義鄉,廣盛村,124,853,405,84,489,34,523
公投第７案,苗栗縣,三義鄉,廣盛村,125,983,500,88,588,23,611
公投第７案,苗栗縣,三義鄉,廣盛村,126,1080,509,104,613,35,648
公投第７案,苗栗縣,三義鄉,廣盛村,127,1216,514,112,626,22,648
公投第７案,苗栗縣,三義鄉,勝興村,128,1017,493,85,578,25,603
公投第７案,苗栗縣,三義鄉,勝興村,129,1180,504,96,600,32,632
公投第７案,苗栗縣,三義鄉,勝興村,130,1198,573,96,669,15,684
公投第７案,苗栗縣,三義鄉,龍騰村,131,417,185,39,224,17,241
公投第７案,苗栗縣,三義鄉,双湖村,132,991,386,96,482,33,515
公投第７案,苗栗縣,三義鄉,双湖村,133,834,389,88,477,12,489
公投第７案,苗栗縣,三義鄉,双潭村,134,622,276,66,342,24,366
公投第７案,苗栗縣,三義鄉,双潭村,135,749,348,79,427,32,459
公投第７案,苗栗縣,三義鄉,西湖村,136,692,364,75,439,21,460
公投第７案,苗栗縣,三義鄉,西湖村,137,759,406,94,500,35,535
公投第７案,苗栗縣,三義鄉,鯉魚潭村,138,629,258,54,312,23,335
公投第７案,苗栗縣,三義鄉,鯉魚潭村,139,669,278,78,356,30,386
公投第７案,苗栗縣,西湖鄉,高埔村,140,601,253,58,311,14,325
公投第７案,苗栗縣,西湖鄉,下埔村,141,566,277,45,322,19,341
公投第７案,苗栗縣,西湖鄉,五湖村,142,843,371,93,464,26,490
公投第７案,苗栗縣,西湖鄉,四湖村,143,648,259,70,329,13,342
公投第７案,苗栗縣,西湖鄉,三湖村,144,936,360,95,455,19,474
公投第７案,苗栗縣,西湖鄉,龍洞村,145,461,199,42,241,6,247
公投第７案,苗栗縣,西湖鄉,金獅村,146,515,237,45,282,13,295
公投第７案,苗栗縣,西湖鄉,湖東村,147,1141,464,102,566,49,615
公投第７案,苗栗縣,西湖鄉,二湖村,148,671,304,67,371,25,396
公投第７案,苗栗縣,通霄鎮,通東里,149,1142,429,150,579,72,651
公投第７案,苗栗縣,通霄鎮,通西里,150,884,381,129,510,62,572
公投第７案,苗栗縣,通霄鎮,通西里,151,1068,412,127,539,60,599
公投第７案,苗栗縣,通霄鎮,平元里,152,1009,402,125,527,39,566
公投第７案,苗栗縣,通霄鎮,平元里,153,859,385,131,516,45,561
公投第７案,苗栗縣,通霄鎮,平安里,154,1040,518,41,559,42,601
公投第７案,苗栗縣,通霄鎮,平安里,155,1008,320,89,409,11,420
公投第７案,苗栗縣,通霄鎮,圳頭里,156,686,273,83,356,52,408
公投第７案,苗栗縣,通霄鎮,梅南里,157,761,333,119,452,51,503
公投第７案,苗栗縣,通霄鎮,梅南里,158,790,292,82,374,23,397
公投第７案,苗栗縣,通霄鎮,通南里,159,966,352,128,480,50,530
公投第７案,苗栗縣,通霄鎮,通南里,160,972,350,98,448,55,503
公投第７案,苗栗縣,通霄鎮,通南里,161,771,295,87,382,50,432
公投第７案,苗栗縣,通霄鎮,內湖里,162,758,235,62,297,31,328
公投第７案,苗栗縣,通霄鎮,內湖里,163,1078,403,142,545,37,582
公投第７案,苗栗縣,通霄鎮,楓樹里,164,459,135,40,175,24,199
公投第７案,苗栗縣,通霄鎮,烏眉里,165,894,322,82,404,45,449
公投第７案,苗栗縣,通霄鎮,福龍里,166,402,120,31,151,8,159
公投第７案,苗栗縣,通霄鎮,福源里,167,802,313,92,405,29,434
公投第７案,苗栗縣,通霄鎮,城北里,168,684,254,69,323,24,347
公投第７案,苗栗縣,通霄鎮,城南里,169,943,313,90,403,37,440
公投第７案,苗栗縣,通霄鎮,南和里,170,790,316,101,417,60,477
公投第７案,苗栗縣,通霄鎮,福興里,171,673,260,59,319,12,331
公投第７案,苗栗縣,通霄鎮,坪頂里,172,1232,483,114,597,51,648
公投第７案,苗栗縣,通霄鎮,五南里,173,1286,544,148,692,64,756
公投第７案,苗栗縣,通霄鎮,五北里,174,649,259,90,349,38,387
公投第７案,苗栗縣,通霄鎮,五北里,175,769,286,78,364,22,386
公投第７案,苗栗縣,通霄鎮,通灣里,176,1148,430,138,568,62,630
公投第７案,苗栗縣,通霄鎮,通灣里,177,1138,387,128,515,60,575
公投第７案,苗栗縣,通霄鎮,新埔里,178,1121,377,123,500,43,543
公投第７案,苗栗縣,通霄鎮,內島里,179,769,326,83,409,18,427
公投第７案,苗栗縣,通霄鎮,白東里,180,616,201,81,282,15,297
公投第７案,苗栗縣,通霄鎮,白東里,181,799,322,81,403,34,437
公投第７案,苗栗縣,通霄鎮,白西里,182,743,286,61,347,25,372
公投第７案,苗栗縣,苑裡鎮,苑東里,183,873,345,130,475,47,522
公投第７案,苗栗縣,苑裡鎮,苑東里,184,1346,590,157,747,42,789
公投第７案,苗栗縣,苑裡鎮,苑南里,185,951,438,128,566,52,618
公投第７案,苗栗縣,苑裡鎮,苑南里,186,615,235,71,306,13,319
公投第７案,苗栗縣,苑裡鎮,苑北里,187,878,372,110,482,67,549
公投第７案,苗栗縣,苑裡鎮,西平里,188,767,346,94,440,28,468
公投第７案,苗栗縣,苑裡鎮,西平里,189,776,299,99,398,35,433
公投第７案,苗栗縣,苑裡鎮,苑港里,190,1231,458,116,574,59,633
公投第７案,苗栗縣,苑裡鎮,西勢里,191,1145,483,148,631,40,671
公投第７案,苗栗縣,苑裡鎮,西勢里,192,850,344,90,434,34,468
公投第７案,苗栗縣,苑裡鎮,海岸里,193,1052,399,132,531,48,579
公投第７案,苗栗縣,苑裡鎮,房裡里,194,1114,460,141,601,38,639
公投第７案,苗栗縣,苑裡鎮,房裡里,195,1136,476,140,616,59,675
公投第７案,苗栗縣,苑裡鎮,客庄里,196,1194,482,138,620,42,662
公投第７案,苗栗縣,苑裡鎮,客庄里,197,1579,684,165,849,53,902
公投第７案,苗栗縣,苑裡鎮,客庄里,198,1149,513,144,657,54,711
公投第７案,苗栗縣,苑裡鎮,中正里,199,1057,452,136,588,52,640
公投第７案,苗栗縣,苑裡鎮,中正里,200,1101,414,108,522,17,539
公投第７案,苗栗縣,苑裡鎮,苑坑里,201,912,287,95,382,42,424
公投第７案,苗栗縣,苑裡鎮,水坡里,202,652,254,77,331,33,364
公投第７案,苗栗縣,苑裡鎮,新復里,203,1348,572,148,720,59,779
公投第７案,苗栗縣,苑裡鎮,山脚里,204,733,239,83,322,21,343
公投第７案,苗栗縣,苑裡鎮,山脚里,205,662,259,57,316,12,328
公投第７案,苗栗縣,苑裡鎮,舊社里,206,893,390,83,473,43,516
公投第７案,苗栗縣,苑裡鎮,舊社里,207,910,414,88,502,43,545
公投第７案,苗栗縣,苑裡鎮,福田里,208,1270,489,138,627,67,694
公投第７案,苗栗縣,苑裡鎮,石鎮里,209,545,219,49,268,24,292
公投第７案,苗栗縣,苑裡鎮,蕉埔里,210,792,369,81,450,52,502
公投第７案,苗栗縣,苑裡鎮,南勢里,211,726,297,86,383,34,417
公投第７案,苗栗縣,苑裡鎮,泰田里,212,827,266,59,325,16,341
公投第７案,苗栗縣,苑裡鎮,泰田里,213,782,326,88,414,49,463
公投第７案,苗栗縣,苑裡鎮,上舘里,214,788,320,90,410,25,435
公投第７案,苗栗縣,苑裡鎮,上舘里,215,846,327,94,421,40,461
公投第７案,苗栗縣,苑裡鎮,玉田里,216,828,359,102,461,43,504
公投第７案,苗栗縣,苑裡鎮,玉田里,217,943,419,99,518,32,550
公投第７案,苗栗縣,苑裡鎮,社苓里,218,1082,478,129,607,25,632
公投第７案,苗栗縣,苑裡鎮,社苓里,219,1234,528,166,694,55,749
公投第７案,苗栗縣,苑裡鎮,山柑里,220,1434,589,143,732,52,784
公投第７案,苗栗縣,苑裡鎮,田心里,221,987,428,105,533,35,568
公投第７案,苗栗縣,苑裡鎮,田心里,222,882,379,144,523,39,562
公投第７案,苗栗縣,後龍鎮,南龍里,223,590,236,74,310,31,341
公投第７案,苗栗縣,後龍鎮,南龍里,224,883,406,105,511,47,558
公投第７案,苗栗縣,後龍鎮,中龍里,225,793,348,97,445,49,494
公投第７案,苗栗縣,後龍鎮,北龍里,226,732,311,98,409,30,439
公投第７案,苗栗縣,後龍鎮,北龍里,227,592,237,88,325,33,358
公投第７案,苗栗縣,後龍鎮,大庄里,228,1113,477,145,622,41,663
公投第７案,苗栗縣,後龍鎮,大庄里,229,1195,516,111,627,50,677
公投第７案,苗栗縣,後龍鎮,大庄里,230,997,477,102,579,41,620
公投第７案,苗栗縣,後龍鎮,大庄里,231,913,328,78,406,29,435
公投第７案,苗栗縣,後龍鎮,東明里,232,641,241,66,307,28,335
公投第７案,苗栗縣,後龍鎮,東明里,233,848,330,76,406,31,437
公投第７案,苗栗縣,後龍鎮,灣寶里,234,1264,486,140,626,76,702
公投第７案,苗栗縣,後龍鎮,海寶里,235,965,364,92,456,33,489
公投第７案,苗栗縣,後龍鎮,豐富里,236,1216,641,151,792,60,852
公投第７案,苗栗縣,後龍鎮,校椅里,237,977,416,89,505,28,533
公投第７案,苗栗縣,後龍鎮,埔頂里,238,943,320,102,422,53,475
公投第７案,苗栗縣,後龍鎮,埔頂里,239,910,352,118,470,51,521
公投第７案,苗栗縣,後龍鎮,埔頂里,240,851,352,77,429,45,474
公投第７案,苗栗縣,後龍鎮,新民里,241,725,335,82,417,33,450
公投第７案,苗栗縣,後龍鎮,新民里,242,650,281,68,349,40,389
公投第７案,苗栗縣,後龍鎮,復興里,243,706,254,68,322,46,368
公投第７案,苗栗縣,後龍鎮,大山里,244,748,292,88,380,51,431
公投第７案,苗栗縣,後龍鎮,大山里,245,801,277,63,340,35,375
公投第７案,苗栗縣,後龍鎮,溪洲里,246,1107,448,129,577,48,625
公投第７案,苗栗縣,後龍鎮,溪洲里,247,1197,473,121,594,55,649
公投第７案,苗栗縣,後龍鎮,外埔里,248,1036,392,93,485,41,526
公投第７案,苗栗縣,後龍鎮,海埔里,249,913,281,92,373,39,412
公投第７案,苗栗縣,後龍鎮,秀水里,250,719,325,77,402,38,440
公投第７案,苗栗縣,後龍鎮,水尾里,251,1037,419,94,513,86,599
公投第７案,苗栗縣,後龍鎮,龍津里,252,601,234,57,291,15,306
公投第７案,苗栗縣,後龍鎮,龍坑里,253,1269,411,125,536,42,578
公投第７案,苗栗縣,後龍鎮,福寧里,254,735,263,71,334,22,356
公投第７案,苗栗縣,後龍鎮,中和里,255,422,99,36,135,9,144
公投第７案,苗栗縣,後龍鎮,中和里,256,625,264,74,338,20,358
公投第７案,苗栗縣,後龍鎮,南港里,257,1234,402,123,525,50,575
公投第７案,苗栗縣,造橋鄉,造橋村,258,1171,590,122,712,52,764
公投第７案,苗栗縣,造橋鄉,造橋村,259,889,403,89,492,33,525
公投第７案,苗栗縣,造橋鄉,平興村,260,479,186,32,218,18,236
公投第７案,苗栗縣,造橋鄉,豐湖村,261,1024,451,107,558,44,602
公投第７案,苗栗縣,造橋鄉,大西村,262,1214,447,156,603,54,657
公投第７案,苗栗縣,造橋鄉,大西村,263,1071,426,97,523,39,562
公投第７案,苗栗縣,造橋鄉,大西村,264,1157,452,103,555,51,606
公投第７案,苗栗縣,造橋鄉,錦水村,265,512,224,47,271,26,297
公投第７案,苗栗縣,造橋鄉,大龍村,266,491,245,44,289,21,310
公投第７案,苗栗縣,造橋鄉,朝陽村,267,1272,581,131,712,54,766
公投第７案,苗栗縣,造橋鄉,談文村,268,785,333,85,418,33,451
公投第７案,苗栗縣,造橋鄉,龍昇村,269,962,406,143,549,90,639
公投第７案,苗栗縣,竹南鎮,竹南里,270,1086,475,144,619,32,651
公投第７案,苗栗縣,竹南鎮,竹南里,271,826,375,80,455,31,486
公投第７案,苗栗縣,竹南鎮,照南里,272,1051,409,98,507,46,553
公投第７案,苗栗縣,竹南鎮,照南里,273,1235,573,121,694,40,734
公投第７案,苗栗縣,竹南鎮,照南里,274,1016,441,115,556,58,614
公投第７案,苗栗縣,竹南鎮,正南里,275,1472,572,169,741,55,796
公投第７案,苗栗縣,竹南鎮,正南里,276,1301,494,115,609,27,636
公投第７案,苗栗縣,竹南鎮,新南里,277,1544,581,160,741,38,779
公投第７案,苗栗縣,竹南鎮,新南里,278,1512,639,162,801,29,830
公投第７案,苗栗縣,竹南鎮,新南里,279,1463,568,158,726,48,774
公投第７案,苗栗縣,竹南鎮,大厝里,280,1073,433,105,538,30,568
公投第７案,苗栗縣,竹南鎮,大厝里,281,1453,649,151,800,34,834
公投第７案,苗栗縣,竹南鎮,大厝里,282,1245,593,128,721,33,754
公投第７案,苗栗縣,竹南鎮,大厝里,283,1487,710,153,863,26,889
公投第７案,苗栗縣,竹南鎮,營盤里,284,1018,431,134,565,40,605
公投第７案,苗栗縣,竹南鎮,營盤里,285,1105,501,129,630,26,656
公投第７案,苗栗縣,竹南鎮,營盤里,286,1322,511,148,659,41,700
公投第７案,苗栗縣,竹南鎮,聖福里,287,1140,516,123,639,21,660
公投第７案,苗栗縣,竹南鎮,聖福里,288,1067,514,108,622,33,655
公投第７案,苗栗縣,竹南鎮,聖福里,289,1136,546,133,679,38,717
公投第７案,苗栗縣,竹南鎮,竹興里,290,1253,509,100,609,44,653
公投第７案,苗栗縣,竹南鎮,竹興里,291,963,386,87,473,40,513
公投第７案,苗栗縣,竹南鎮,竹興里,292,1021,407,109,516,40,556
公投第７案,苗栗縣,竹南鎮,龍山里,293,1154,521,126,647,45,692
公投第７案,苗栗縣,竹南鎮,龍山里,294,1042,455,118,573,23,596
公投第７案,苗栗縣,竹南鎮,天文里,295,1293,584,125,709,34,743
公投第７案,苗栗縣,竹南鎮,天文里,296,816,382,81,463,17,480
公投第７案,苗栗縣,竹南鎮,龍鳳里,297,989,432,92,524,38,562
公投第７案,苗栗縣,竹南鎮,龍鳳里,298,1122,551,97,648,29,677
公投第７案,苗栗縣,竹南鎮,山佳里,299,1111,393,94,487,36,523
公投第７案,苗栗縣,竹南鎮,山佳里,300,1036,485,87,572,44,616
公投第７案,苗栗縣,竹南鎮,山佳里,301,1112,430,101,531,29,560
公投第７案,苗栗縣,竹南鎮,山佳里,302,1348,591,91,682,18,700
公投第７案,苗栗縣,竹南鎮,佳興里,303,1114,506,115,621,21,642
公投第７案,苗栗縣,竹南鎮,佳興里,304,1119,481,149,630,40,670
公投第７案,苗栗縣,竹南鎮,佳興里,305,878,389,86,475,26,501
公投第７案,苗栗縣,竹南鎮,中港里,306,1059,505,101,606,45,651
公投第７案,苗栗縣,竹南鎮,中華里,307,869,364,111,475,40,515
公投第７案,苗栗縣,竹南鎮,中華里,308,800,327,92,419,23,442
公投第７案,苗栗縣,竹南鎮,中華里,309,1165,548,130,678,34,712
公投第７案,苗栗縣,竹南鎮,中英里,310,791,347,81,428,34,462
公投第７案,苗栗縣,竹南鎮,中英里,311,677,266,83,349,24,373
公投第７案,苗栗縣,竹南鎮,中美里,312,797,390,86,476,41,517
公投第７案,苗栗縣,竹南鎮,中美里,313,1191,520,100,620,33,653
公投第７案,苗栗縣,竹南鎮,開元里,314,1027,422,97,519,16,535
公投第７案,苗栗縣,竹南鎮,海口里,315,1341,611,129,740,51,791
公投第７案,苗栗縣,竹南鎮,海口里,316,1378,540,112,652,51,703
公投第７案,苗栗縣,竹南鎮,海口里,317,1216,521,133,654,27,681
公投第７案,苗栗縣,竹南鎮,港墘里,318,1570,638,154,792,30,822
公投第７案,苗栗縣,竹南鎮,港墘里,319,538,244,58,302,28,330
公投第７案,苗栗縣,竹南鎮,公舘里,320,1166,439,93,532,13,545
公投第７案,苗栗縣,竹南鎮,大埔里,321,1488,579,166,745,31,776
公投第７案,苗栗縣,竹南鎮,大埔里,322,1449,585,113,698,22,720
公投第７案,苗栗縣,竹南鎮,大埔里,323,1182,473,124,597,64,661
公投第７案,苗栗縣,竹南鎮,頂埔里,324,1175,474,134,608,60,668
公投第７案,苗栗縣,竹南鎮,頂埔里,325,983,420,100,520,37,557
公投第７案,苗栗縣,竹南鎮,崎頂里,326,492,245,41,286,23,309
公投第７案,苗栗縣,竹南鎮,崎頂里,327,1074,461,128,589,33,622
公投第７案,苗栗縣,竹南鎮,崎頂里,328,852,315,113,428,40,468
公投第７案,苗栗縣,竹南鎮,崎頂里,329,1297,542,120,662,29,691
公投第７案,苗栗縣,竹南鎮,公義里,330,1028,412,105,517,41,558
公投第７案,苗栗縣,頭份市,流東里,331,915,362,89,451,46,497
公投第７案,苗栗縣,頭份市,流東里,332,1292,557,140,697,38,735
公投第７案,苗栗縣,頭份市,珊湖里,333,928,117,411,528,24,552
公投第７案,苗栗縣,頭份市,珊湖里,334,835,331,64,395,11,406
公投第７案,苗栗縣,頭份市,斗煥里,335,1070,459,101,560,27,587
公投第７案,苗栗縣,頭份市,斗煥里,336,879,336,82,418,12,430
公投第７案,苗栗縣,頭份市,斗煥里,337,1039,398,99,497,41,538
公投第７案,苗栗縣,頭份市,新華里,338,1129,500,109,609,49,658
公投第７案,苗栗縣,頭份市,新華里,339,1041,446,91,537,35,572
公投第７案,苗栗縣,頭份市,新華里,340,1546,573,159,732,57,789
公投第７案,苗栗縣,頭份市,興隆里,341,935,319,115,434,29,463
公投第７案,苗栗縣,頭份市,興隆里,342,1180,449,126,575,42,617
公投第７案,苗栗縣,頭份市,興隆里,343,1499,598,119,717,40,757
公投第７案,苗栗縣,頭份市,興隆里,344,747,339,50,389,15,404
公投第７案,苗栗縣,頭份市,上埔里,345,1406,590,140,730,18,748
公投第７案,苗栗縣,頭份市,上埔里,346,1193,499,124,623,48,671
公投第７案,苗栗縣,頭份市,土牛里,347,948,409,113,522,30,552
公投第７案,苗栗縣,頭份市,頭份里,348,869,368,69,437,27,464
公投第７案,苗栗縣,頭份市,頭份里,349,1142,510,124,634,32,666
公投第７案,苗栗縣,頭份市,頭份里,350,1286,543,133,676,22,698
公投第７案,苗栗縣,頭份市,忠孝里,351,903,416,88,504,32,536
公投第７案,苗栗縣,頭份市,忠孝里,352,1186,567,129,696,39,735
公投第７案,苗栗縣,頭份市,忠孝里,353,1016,488,80,568,20,588
公投第７案,苗栗縣,頭份市,自強里,354,985,435,97,532,28,560
公投第７案,苗栗縣,頭份市,自強里,355,1037,450,87,537,27,564
公投第７案,苗栗縣,頭份市,信義里,356,947,365,72,437,27,464
公投第７案,苗栗縣,頭份市,仁愛里,357,890,409,77,486,33,519
公投第７案,苗栗縣,頭份市,仁愛里,358,646,288,86,374,32,406
公投第７案,苗栗縣,頭份市,上興里,359,975,409,129,538,42,580
公投第７案,苗栗縣,頭份市,上興里,360,1015,303,74,377,15,392
公投第７案,苗栗縣,頭份市,下興里,361,1399,656,160,816,48,864
公投第７案,苗栗縣,頭份市,下興里,362,1143,520,125,645,40,685
公投第７案,苗栗縣,頭份市,和平里,363,1030,508,118,626,43,669
公投第７案,苗栗縣,頭份市,山下里,364,1338,614,126,740,32,772
公投第７案,苗栗縣,頭份市,山下里,365,1450,629,128,757,15,772
公投第７案,苗栗縣,頭份市,山下里,366,1042,504,83,587,18,605
公投第７案,苗栗縣,頭份市,後庄里,367,1326,636,131,767,30,797
公投第７案,苗栗縣,頭份市,後庄里,368,1270,656,119,775,26,801
公投第７案,苗栗縣,頭份市,後庄里,369,1288,557,122,679,34,713
公投第７案,苗栗縣,頭份市,合興里,370,1243,573,108,681,34,715
公投第７案,苗栗縣,頭份市,合興里,371,1280,611,116,727,25,752
公投第７案,苗栗縣,頭份市,文化里,372,1618,698,157,855,51,906
公投第７案,苗栗縣,頭份市,文化里,373,1759,748,152,900,33,933
公投第７案,苗栗縣,頭份市,中興里,374,1264,586,128,714,36,750
公投第７案,苗栗縣,頭份市,中興里,375,1326,616,117,733,32,765
公投第７案,苗栗縣,頭份市,蟠桃里,376,1551,721,127,848,29,877
公投第７案,苗栗縣,頭份市,蟠桃里,377,1574,638,138,776,35,811
公投第７案,苗栗縣,頭份市,建國里,378,1262,560,128,688,31,719
公投第７案,苗栗縣,頭份市,建國里,379,1171,545,105,650,36,686
公投第７案,苗栗縣,頭份市,建國里,380,1074,535,122,657,36,693
公投第７案,苗栗縣,頭份市,成功里,381,1141,535,140,675,28,703
公投第７案,苗栗縣,頭份市,成功里,382,1259,557,141,698,32,730
公投第７案,苗栗縣,頭份市,成功里,383,1186,522,104,626,29,655
公投第７案,苗栗縣,頭份市,民族里,384,1121,458,101,559,24,583
公投第７案,苗栗縣,頭份市,民族里,385,847,378,88,466,20,486
公投第７案,苗栗縣,頭份市,民權里,386,993,467,107,574,24,598
公投第７案,苗栗縣,頭份市,民權里,387,1055,440,105,545,25,570
公投第７案,苗栗縣,頭份市,東庄里,388,1655,654,125,779,47,826
公投第７案,苗栗縣,頭份市,東庄里,389,1799,776,153,929,60,989
公投第７案,苗栗縣,頭份市,田寮里,390,1141,518,116,634,28,662
公投第７案,苗栗縣,頭份市,田寮里,391,1431,580,160,740,41,781
公投第７案,苗栗縣,頭份市,田寮里,392,1412,522,105,627,23,650
公投第７案,苗栗縣,頭份市,民生里,393,1074,425,105,530,34,564
公投第７案,苗栗縣,頭份市,民生里,394,1245,587,116,703,39,742
公投第７案,苗栗縣,頭份市,蘆竹里,395,1344,585,167,752,48,800
公投第７案,苗栗縣,頭份市,尖山里,396,1363,655,142,797,46,843
公投第７案,苗栗縣,頭份市,廣興里,397,898,421,99,520,42,562
公投第７案,苗栗縣,頭份市,尖下里,398,1182,532,127,659,49,708
公投第７案,苗栗縣,頭份市,尖下里,399,1413,598,145,743,30,773
公投第７案,苗栗縣,頭份市,濫坑里,400,991,468,121,589,27,616
公投第７案,苗栗縣,頭份市,濫坑里,401,1180,521,142,663,32,695
公投第７案,苗栗縣,三灣鄉,三灣村,402,996,462,97,559,36,595
公投第７案,苗栗縣,三灣鄉,三灣村,403,1205,495,137,632,59,691
公投第７案,苗栗縣,三灣鄉,內灣村,404,635,274,80,354,33,387
公投第７案,苗栗縣,三灣鄉,銅鏡村,405,862,351,103,454,39,493
公投第７案,苗栗縣,三灣鄉,頂寮村,406,238,92,17,109,9,118
公投第７案,苗栗縣,三灣鄉,北埔村,407,541,215,55,270,23,293
公投第７案,苗栗縣,三灣鄉,大河村,408,578,217,59,276,22,298
公投第７案,苗栗縣,三灣鄉,大坪村,409,405,192,60,252,26,278
公投第７案,苗栗縣,三灣鄉,永和村,410,392,166,43,209,13,222
公投第７案,苗栗縣,南庄鄉,東村,411,1155,473,115,588,51,639
公投第７案,苗栗縣,南庄鄉,西村,412,650,252,72,324,43,367
公投第７案,苗栗縣,南庄鄉,南江村,413,1353,407,234,641,58,699
公投第７案,苗栗縣,南庄鄉,田美村,414,813,276,50,326,29,355
公投第７案,苗栗縣,南庄鄉,獅山村,415,837,274,61,335,22,357
公投第７案,苗栗縣,南庄鄉,南富村,416,1093,446,103,549,25,574
公投第７案,苗栗縣,南庄鄉,員林村,417,1048,390,130,520,50,570
公投第７案,苗栗縣,南庄鄉,蓬萊村,418,872,340,80,420,27,447
公投第７案,苗栗縣,南庄鄉,東河村,419,963,246,48,294,6,300
公投第７案,苗栗縣,大湖鄉,大湖村,420,744,312,70,382,21,403
公投第７案,苗栗縣,大湖鄉,大湖村,421,881,388,73,461,24,485
公投第７案,苗栗縣,大湖鄉,明湖村,422,596,253,53,306,33,339
公投第７案,苗栗縣,大湖鄉,大寮村,423,1260,477,121,598,54,652
公投第７案,苗栗縣,大湖鄉,靜湖村,424,867,362,71,433,22,455
公投第７案,苗栗縣,大湖鄉,靜湖村,425,923,407,72,479,31,510
公投第７案,苗栗縣,大湖鄉,富興村,426,1395,528,137,665,72,737
公投第７案,苗栗縣,大湖鄉,大南村,427,561,149,38,187,15,202
公投第７案,苗栗縣,大湖鄉,南湖村,428,638,274,77,351,19,370
公投第７案,苗栗縣,大湖鄉,東興村,429,754,299,69,368,32,400
公投第７案,苗栗縣,大湖鄉,武榮村,430,501,186,48,234,13,247
公投第７案,苗栗縣,大湖鄉,義和村,431,652,270,55,325,33,358
公投第７案,苗栗縣,大湖鄉,義和村,432,843,313,75,388,20,408
公投第７案,苗栗縣,大湖鄉,栗林村,433,1020,449,91,540,38,578
公投第７案,苗栗縣,大湖鄉,新開村,434,1018,461,87,548,31,579
公投第７案,苗栗縣,獅潭鄉,百壽村,435,328,108,13,121,6,127
公投第７案,苗栗縣,獅潭鄉,永興村,436,565,178,40,218,30,248
公投第７案,苗栗縣,獅潭鄉,新店村,437,911,389,86,475,49,524
公投第７案,苗栗縣,獅潭鄉,和興村,438,568,197,54,251,17,268
公投第７案,苗栗縣,獅潭鄉,豐林村,439,580,265,56,321,20,341
公投第７案,苗栗縣,獅潭鄉,新豐村,440,333,139,22,161,5,166
公投第７案,苗栗縣,獅潭鄉,竹木村,441,683,276,53,329,16,345
公投第７案,苗栗縣,卓蘭鎮,老庄里,442,961,468,76,544,42,586
公投第７案,苗栗縣,卓蘭鎮,老庄里,443,1017,414,108,522,50,572
公投第７案,苗栗縣,卓蘭鎮,新榮里,444,1095,498,151,649,51,700
公投第７案,苗栗縣,卓蘭鎮,中街里,445,745,341,82,423,24,447
公投第７案,苗栗縣,卓蘭鎮,新厝里,446,783,325,80,405,24,429
公投第７案,苗栗縣,卓蘭鎮,新厝里,447,745,281,59,340,16,356
公投第７案,苗栗縣,卓蘭鎮,豐田里,448,999,383,77,460,22,482
公投第７案,苗栗縣,卓蘭鎮,西坪里,449,671,324,66,390,28,418
公投第７案,苗栗縣,卓蘭鎮,苗豐里,450,734,358,80,438,41,479
公投第７案,苗栗縣,卓蘭鎮,上新里,451,865,398,95,493,43,536
公投第７案,苗栗縣,卓蘭鎮,上新里,452,828,381,103,484,36,520
公投第７案,苗栗縣,卓蘭鎮,上新里,453,386,181,36,217,27,244
公投第７案,苗栗縣,卓蘭鎮,內灣里,454,688,328,80,408,36,444
公投第７案,苗栗縣,卓蘭鎮,內灣里,455,792,348,109,457,34,491
公投第７案,苗栗縣,卓蘭鎮,內灣里,456,729,330,79,409,21,430
公投第７案,苗栗縣,卓蘭鎮,坪林里,457,1093,388,100,488,24,512
公投第７案,苗栗縣,卓蘭鎮,坪林里,458,615,287,51,338,7,345
公投第７案,苗栗縣,卓蘭鎮,西坪里,459,86,39,2,41,2,43
公投第７案,苗栗縣,卓蘭鎮,景山里,460,940,410,87,497,10,507
公投第７案,苗栗縣,泰安鄉,八卦村,461,325,109,28,137,10,147
公投第７案,苗栗縣,泰安鄉,錦水村,462,484,207,56,263,22,285
公投第７案,苗栗縣,泰安鄉,錦水村,463,666,344,98,442,44,486
公投第７案,苗栗縣,泰安鄉,清安村,464,574,282,70,352,38,390
公投第７案,苗栗縣,泰安鄉,清安村,465,333,138,22,160,11,171
公投第７案,苗栗縣,泰安鄉,大興村,466,495,272,51,323,12,335
公投第７案,苗栗縣,泰安鄉,中興村,467,544,290,70,360,32,392
公投第７案,苗栗縣,泰安鄉,梅園村,468,500,173,48,221,15,236
公投第７案,苗栗縣,泰安鄉,象鼻村,469,670,332,96,428,51,479
公投第７案,苗栗縣,泰安鄉,士林村,470,589,371,77,448,5,453
公投第７案,彰化縣,彰化市,桃源里,1,871,382,98,480,33,513
公投第７案,彰化縣,彰化市,桃源里,2,751,263,65,328,34,362
公投第７案,彰化縣,彰化市,桃源里,3,923,450,120,570,38,608
公投第７案,彰化縣,彰化市,東興里,4,779,323,116,439,45,484
公投第７案,彰化縣,彰化市,東興里,5,779,345,100,445,36,481
公投第７案,彰化縣,彰化市,華北里,6,720,293,90,383,41,424
公投第７案,彰化縣,彰化市,華北里,7,749,318,92,410,35,445
公投第７案,彰化縣,彰化市,華陽里,8,767,385,82,467,33,500
公投第７案,彰化縣,彰化市,華陽里,9,1047,463,131,594,59,653
公投第７案,彰化縣,彰化市,大同里,10,1027,426,119,545,37,582
公投第７案,彰化縣,彰化市,永生里,11,1249,521,132,653,62,715
公投第７案,彰化縣,彰化市,建寶里,12,1136,511,146,657,40,697
公投第７案,彰化縣,彰化市,建寶里,13,1169,533,135,668,55,723
公投第７案,彰化縣,彰化市,光南里,14,766,362,96,458,25,483
公投第７案,彰化縣,彰化市,光南里,15,643,284,72,356,22,378
公投第７案,彰化縣,彰化市,介壽里,16,1251,566,121,687,55,742
公投第７案,彰化縣,彰化市,介壽里,17,1301,366,111,477,31,508
公投第７案,彰化縣,彰化市,延平里,18,1280,595,132,727,41,768
公投第７案,彰化縣,彰化市,延平里,19,1179,559,127,686,40,726
公投第７案,彰化縣,彰化市,延平里,20,1168,537,119,656,32,688
公投第７案,彰化縣,彰化市,延平里,21,1218,536,135,671,44,715
公投第７案,彰化縣,彰化市,延平里,22,1351,688,132,820,50,870
公投第７案,彰化縣,彰化市,延平里,23,1204,530,163,693,29,722
公投第７案,彰化縣,彰化市,延平里,24,1189,567,122,689,18,707
公投第７案,彰化縣,彰化市,延和里,25,1207,509,125,634,52,686
公投第７案,彰化縣,彰化市,延和里,26,1161,544,95,639,52,691
公投第７案,彰化縣,彰化市,延和里,27,1166,454,162,616,38,654
公投第７案,彰化縣,彰化市,延和里,28,1362,643,143,786,48,834
公投第７案,彰化縣,彰化市,南興里,29,1236,559,173,732,38,770
公投第７案,彰化縣,彰化市,南興里,30,1065,491,122,613,41,654
公投第７案,彰化縣,彰化市,南興里,31,1199,537,131,668,55,723
公投第７案,彰化縣,彰化市,南興里,32,1233,561,152,713,31,744
公投第７案,彰化縣,彰化市,南興里,33,1245,573,119,692,29,721
公投第７案,彰化縣,彰化市,南興里,34,1153,519,151,670,34,704
公投第７案,彰化縣,彰化市,南瑤里,35,1045,441,110,551,42,593
公投第７案,彰化縣,彰化市,南瑤里,36,1097,476,137,613,19,632
公投第７案,彰化縣,彰化市,南瑤里,37,1190,521,131,652,40,692
公投第７案,彰化縣,彰化市,南瑤里,38,1106,510,143,653,40,693
公投第７案,彰化縣,彰化市,南瑤里,39,1097,510,120,630,32,662
公投第７案,彰化縣,彰化市,南瑤里,40,1048,464,133,597,44,641
公投第７案,彰化縣,彰化市,南瑤里,41,980,485,103,588,30,618
公投第７案,彰化縣,彰化市,成功里,42,707,324,98,422,22,444
公投第７案,彰化縣,彰化市,成功里,43,809,366,91,457,32,489
公投第７案,彰化縣,彰化市,福安里,44,1008,447,135,582,48,630
公投第７案,彰化縣,彰化市,西安里,45,901,360,103,463,50,513
公投第７案,彰化縣,彰化市,西安里,46,951,408,111,519,29,548
公投第７案,彰化縣,彰化市,西安里,47,1076,499,117,616,33,649
公投第７案,彰化縣,彰化市,彰安里,48,1022,394,135,529,34,563
公投第７案,彰化縣,彰化市,彰安里,49,894,380,109,489,46,535
公投第７案,彰化縣,彰化市,彰安里,50,1016,454,134,588,38,626
公投第７案,彰化縣,彰化市,中央里,51,771,340,111,451,44,495
公投第７案,彰化縣,彰化市,富貴里,52,868,366,118,484,43,527
公投第７案,彰化縣,彰化市,民權里,53,1135,487,142,629,60,689
公投第７案,彰化縣,彰化市,萬壽里,54,910,363,132,495,61,556
公投第７案,彰化縣,彰化市,長樂里,55,1004,442,128,570,33,603
公投第７案,彰化縣,彰化市,西興里,56,1077,508,118,626,45,671
公投第７案,彰化縣,彰化市,西興里,57,1258,644,131,775,53,828
公投第７案,彰化縣,彰化市,西興里,58,1025,512,108,620,32,652
公投第７案,彰化縣,彰化市,西勢里,59,1177,565,122,687,56,743
公投第７案,彰化縣,彰化市,西勢里,60,1262,553,121,674,43,717
公投第７案,彰化縣,彰化市,西勢里,61,1209,572,134,706,51,757
公投第７案,彰化縣,彰化市,忠權里,62,1041,507,120,627,34,661
公投第７案,彰化縣,彰化市,忠權里,63,1075,516,111,627,38,665
公投第７案,彰化縣,彰化市,忠權里,64,1029,439,93,532,59,591
公投第７案,彰化縣,彰化市,忠孝里,65,1203,496,129,625,74,699
公投第７案,彰化縣,彰化市,五權里,66,1014,431,116,547,38,585
公投第７案,彰化縣,彰化市,五權里,67,1069,483,126,609,37,646
公投第７案,彰化縣,彰化市,五權里,68,969,390,83,473,24,497
公投第７案,彰化縣,彰化市,五權里,69,1105,445,110,555,38,593
公投第７案,彰化縣,彰化市,平和里,70,981,469,114,583,40,623
公投第７案,彰化縣,彰化市,平和里,71,1095,500,237,737,52,789
公投第７案,彰化縣,彰化市,平和里,72,1087,534,122,656,23,679
公投第７案,彰化縣,彰化市,平和里,73,1050,472,128,600,37,637
公投第７案,彰化縣,彰化市,崙平里,74,1252,582,138,720,52,772
公投第７案,彰化縣,彰化市,崙平里,75,1113,473,111,584,34,618
公投第７案,彰化縣,彰化市,崙平里,76,1009,494,114,608,27,635
公投第７案,彰化縣,彰化市,崙平里,77,999,436,107,543,35,578
公投第７案,彰化縣,彰化市,崙平里,78,997,439,106,545,25,570
公投第７案,彰化縣,彰化市,向陽里,79,1145,566,141,707,41,748
公投第７案,彰化縣,彰化市,向陽里,80,1227,558,136,694,24,718
公投第７案,彰化縣,彰化市,向陽里,81,1208,561,158,719,33,752
公投第７案,彰化縣,彰化市,向陽里,82,1598,730,157,887,40,927
公投第７案,彰化縣,彰化市,莿桐里,83,890,425,87,512,37,549
公投第７案,彰化縣,彰化市,莿桐里,84,1104,540,135,675,32,707
公投第７案,彰化縣,彰化市,莿桐里,85,1097,498,109,607,25,632
公投第７案,彰化縣,彰化市,南美里,86,799,356,77,433,34,467
公投第７案,彰化縣,彰化市,南美里,87,1000,474,99,573,46,619
公投第７案,彰化縣,彰化市,南安里,88,1153,481,126,607,67,674
公投第７案,彰化縣,彰化市,南安里,89,977,442,117,559,44,603
公投第７案,彰化縣,彰化市,東芳里,90,1201,501,143,644,52,696
公投第７案,彰化縣,彰化市,東芳里,91,1057,456,160,616,47,663
公投第７案,彰化縣,彰化市,東芳里,92,1238,513,144,657,68,725
公投第７案,彰化縣,彰化市,磚磘里,93,1210,550,153,703,44,747
公投第７案,彰化縣,彰化市,磚磘里,94,1026,492,107,599,37,636
公投第７案,彰化縣,彰化市,磚磘里,95,1061,534,121,655,36,691
公投第７案,彰化縣,彰化市,卦山里,96,1213,540,134,674,49,723
公投第７案,彰化縣,彰化市,卦山里,97,1264,578,152,730,38,768
公投第７案,彰化縣,彰化市,光復里,98,691,317,100,417,46,463
公投第７案,彰化縣,彰化市,永福里,99,893,413,121,534,42,576
公投第７案,彰化縣,彰化市,光華里,100,733,314,96,410,47,457
公投第７案,彰化縣,彰化市,中正里,101,692,301,110,411,33,444
公投第７案,彰化縣,彰化市,中正里,102,728,325,78,403,31,434
公投第７案,彰化縣,彰化市,中山里,103,773,368,111,479,33,512
公投第７案,彰化縣,彰化市,龍山里,104,975,386,90,476,14,490
公投第７案,彰化縣,彰化市,龍山里,105,908,397,114,511,44,555
公投第７案,彰化縣,彰化市,新興里,106,1156,505,159,664,6,670
公投第７案,彰化縣,彰化市,新興里,107,1235,544,161,705,49,754
公投第７案,彰化縣,彰化市,新興里,108,1376,567,146,713,51,764
公投第７案,彰化縣,彰化市,新興里,109,1389,607,149,756,33,789
公投第７案,彰化縣,彰化市,新華里,110,846,396,121,517,42,559
公投第７案,彰化縣,彰化市,新華里,111,859,424,100,524,30,554
公投第７案,彰化縣,彰化市,興北里,112,781,338,119,457,28,485
公投第７案,彰化縣,彰化市,興北里,113,875,379,105,484,34,518
公投第７案,彰化縣,彰化市,信義里,114,816,347,109,456,29,485
公投第７案,彰化縣,彰化市,民生里,115,687,305,92,397,38,435
公投第７案,彰化縣,彰化市,民生里,116,727,352,87,439,34,473
公投第７案,彰化縣,彰化市,文化里,117,662,303,96,399,26,425
公投第７案,彰化縣,彰化市,文化里,118,633,303,81,384,21,405
公投第７案,彰化縣,彰化市,陽明里,119,906,417,133,550,37,587
公投第７案,彰化縣,彰化市,陽明里,120,853,353,98,451,39,490
公投第７案,彰化縣,彰化市,萬安里,121,1027,478,129,607,37,644
公投第７案,彰化縣,彰化市,萬安里,122,993,489,101,590,43,633
公投第７案,彰化縣,彰化市,萬安里,123,848,376,102,478,45,523
公投第７案,彰化縣,彰化市,萬安里,124,1118,559,123,682,22,704
公投第７案,彰化縣,彰化市,下廍里,125,1263,540,147,687,74,761
公投第７案,彰化縣,彰化市,下廍里,126,1268,626,132,758,39,797
公投第７案,彰化縣,彰化市,下廍里,127,1258,569,146,715,57,772
公投第７案,彰化縣,彰化市,下廍里,128,1212,580,136,716,29,745
公投第７案,彰化縣,彰化市,茄苳里,129,924,427,95,522,51,573
公投第７案,彰化縣,彰化市,茄南里,130,939,456,113,569,28,597
公投第７案,彰化縣,彰化市,茄南里,131,953,464,125,589,56,645
公投第７案,彰化縣,彰化市,茄南里,132,981,511,99,610,40,650
公投第７案,彰化縣,彰化市,寶廍里,133,1249,579,134,713,66,779
公投第７案,彰化縣,彰化市,古夷里,134,817,365,95,460,50,510
公投第７案,彰化縣,彰化市,古夷里,135,872,386,101,487,46,533
公投第７案,彰化縣,彰化市,古夷里,136,689,308,63,371,28,399
公投第７案,彰化縣,彰化市,阿夷里,137,1156,569,118,687,28,715
公投第７案,彰化縣,彰化市,阿夷里,138,1291,583,124,707,31,738
公投第７案,彰化縣,彰化市,阿夷里,139,1139,516,116,632,27,659
公投第７案,彰化縣,彰化市,阿夷里,140,1125,538,115,653,42,695
公投第７案,彰化縣,彰化市,阿夷里,141,1258,546,104,650,53,703
公投第７案,彰化縣,彰化市,阿夷里,142,1123,510,116,626,37,663
公投第７案,彰化縣,彰化市,阿夷里,143,1175,517,138,655,46,701
公投第７案,彰化縣,彰化市,和調里,144,862,417,124,541,29,570
公投第７案,彰化縣,彰化市,和調里,145,872,377,112,489,39,528
公投第７案,彰化縣,彰化市,和調里,146,897,456,110,566,15,581
公投第７案,彰化縣,彰化市,復興里,147,1003,450,88,538,21,559
公投第７案,彰化縣,彰化市,復興里,148,915,393,93,486,22,508
公投第７案,彰化縣,彰化市,復興里,149,1158,501,125,626,42,668
公投第７案,彰化縣,彰化市,復興里,150,1084,533,115,648,36,684
公投第７案,彰化縣,彰化市,中庄里,151,1372,575,146,721,59,780
公投第７案,彰化縣,彰化市,中庄里,152,1113,498,137,635,42,677
公投第７案,彰化縣,彰化市,竹中里,153,800,402,81,483,24,507
公投第７案,彰化縣,彰化市,竹中里,154,885,402,109,511,42,553
公投第７案,彰化縣,彰化市,香山里,155,1000,487,106,593,13,606
公投第７案,彰化縣,彰化市,香山里,156,1159,487,99,586,43,629
公投第７案,彰化縣,彰化市,香山里,157,1123,497,108,605,36,641
公投第７案,彰化縣,彰化市,牛埔里,158,907,398,144,542,61,603
公投第７案,彰化縣,彰化市,牛埔里,159,989,401,95,496,65,561
公投第７案,彰化縣,彰化市,牛埔里,160,1012,457,115,572,66,638
公投第７案,彰化縣,彰化市,台鳳里,161,1033,418,101,519,27,546
公投第７案,彰化縣,彰化市,台鳳里,162,1116,526,114,640,40,680
公投第７案,彰化縣,彰化市,台鳳里,163,1154,565,118,683,26,709
公投第７案,彰化縣,彰化市,台鳳里,164,1064,514,117,631,36,667
公投第７案,彰化縣,彰化市,國聖里,165,770,362,105,467,36,503
公投第７案,彰化縣,彰化市,國聖里,166,889,402,131,533,24,557
公投第７案,彰化縣,彰化市,國聖里,167,786,368,81,449,53,502
公投第７案,彰化縣,彰化市,福山里,168,1120,427,140,567,52,619
公投第７案,彰化縣,彰化市,福山里,169,1269,538,110,648,29,677
公投第７案,彰化縣,彰化市,福山里,170,1159,527,132,659,46,705
公投第７案,彰化縣,彰化市,福山里,171,1184,519,154,673,54,727
公投第７案,彰化縣,彰化市,福山里,172,1089,465,132,597,38,635
公投第７案,彰化縣,彰化市,福山里,173,968,421,116,537,52,589
公投第７案,彰化縣,彰化市,安溪里,174,930,430,87,517,28,545
公投第７案,彰化縣,彰化市,安溪里,175,973,449,115,564,31,595
公投第７案,彰化縣,彰化市,三村里,176,1184,451,125,576,31,607
公投第７案,彰化縣,彰化市,大竹里,177,1002,444,120,564,51,615
公投第７案,彰化縣,彰化市,大竹里,178,1148,520,98,618,22,640
公投第７案,彰化縣,彰化市,大竹里,179,1112,494,105,599,47,646
公投第７案,彰化縣,彰化市,田中里,180,907,488,89,577,44,621
公投第７案,彰化縣,彰化市,快官里,181,1112,526,97,623,58,681
公投第７案,彰化縣,彰化市,竹巷里,182,823,315,73,388,36,424
公投第７案,彰化縣,彰化市,福田里,183,1276,587,97,684,71,755
公投第７案,彰化縣,彰化市,石牌里,184,1161,485,115,600,59,659
公投第７案,彰化縣,花壇鄉,花壇村,185,901,389,107,496,43,539
公投第７案,彰化縣,花壇鄉,花壇村,186,1042,495,107,602,30,632
公投第７案,彰化縣,花壇鄉,花壇村,187,1314,534,107,641,18,659
公投第７案,彰化縣,花壇鄉,金墩村,188,808,345,96,441,48,489
公投第７案,彰化縣,花壇鄉,金墩村,189,1019,420,118,538,50,588
公投第７案,彰化縣,花壇鄉,中庄村,190,1144,485,147,632,69,701
公投第７案,彰化縣,花壇鄉,中庄村,191,1240,582,63,645,81,726
公投第７案,彰化縣,花壇鄉,崙雅村,192,1425,638,163,801,81,882
公投第７案,彰化縣,花壇鄉,劉厝村,193,1095,498,123,621,65,686
公投第７案,彰化縣,花壇鄉,南口村,194,910,401,107,508,38,546
公投第７案,彰化縣,花壇鄉,南口村,195,982,434,114,548,29,577
公投第７案,彰化縣,花壇鄉,北口村,196,1070,426,122,548,22,570
公投第７案,彰化縣,花壇鄉,北口村,197,700,285,66,351,20,371
公投第７案,彰化縣,花壇鄉,中口村,198,764,368,91,459,41,500
公投第７案,彰化縣,花壇鄉,文德村,199,953,430,125,555,48,603
公投第７案,彰化縣,花壇鄉,文德村,200,974,434,95,529,26,555
公投第７案,彰化縣,花壇鄉,文德村,201,1111,460,127,587,61,648
公投第７案,彰化縣,花壇鄉,白沙村,202,1101,508,102,610,63,673
公投第７案,彰化縣,花壇鄉,白沙村,203,1110,473,92,565,43,608
公投第７案,彰化縣,花壇鄉,白沙村,204,1262,560,116,676,59,735
公投第７案,彰化縣,花壇鄉,白沙村,205,1103,471,144,615,26,641
公投第７案,彰化縣,花壇鄉,岩竹村,206,1347,483,137,620,77,697
公投第７案,彰化縣,花壇鄉,長沙村,207,1169,470,107,577,57,634
公投第７案,彰化縣,花壇鄉,長沙村,208,1274,572,139,711,53,764
公投第７案,彰化縣,花壇鄉,長沙村,209,1280,622,126,748,43,791
公投第７案,彰化縣,花壇鄉,長沙村,210,1244,569,104,673,48,721
公投第７案,彰化縣,花壇鄉,橋頭村,211,1159,482,139,621,58,679
公投第７案,彰化縣,花壇鄉,橋頭村,212,1042,512,107,619,40,659
公投第７案,彰化縣,花壇鄉,橋頭村,213,1111,465,116,581,43,624
公投第７案,彰化縣,花壇鄉,灣雅村,214,893,415,106,521,46,567
公投第７案,彰化縣,花壇鄉,灣東村,215,953,401,102,503,62,565
公投第７案,彰化縣,花壇鄉,三春村,216,987,398,83,481,36,517
公投第７案,彰化縣,花壇鄉,三春村,217,925,432,110,542,56,598
公投第７案,彰化縣,花壇鄉,永春村,218,951,423,76,499,24,523
公投第７案,彰化縣,花壇鄉,永春村,219,955,406,110,516,28,544
公投第７案,彰化縣,花壇鄉,長春村,220,895,363,89,452,28,480
公投第７案,彰化縣,花壇鄉,長春村,221,711,304,76,380,32,412
公投第７案,彰化縣,芬園鄉,舊社村,222,958,411,76,487,47,534
公投第７案,彰化縣,芬園鄉,舊社村,223,794,327,73,400,54,454
公投第７案,彰化縣,芬園鄉,大埔村,224,1415,543,122,665,82,747
公投第７案,彰化縣,芬園鄉,竹林村,225,927,428,112,540,29,569
公投第７案,彰化縣,芬園鄉,竹林村,226,831,371,67,438,36,474
公投第７案,彰化縣,芬園鄉,楓坑村,227,570,243,55,298,22,320
公投第７案,彰化縣,芬園鄉,社口村,228,1227,466,123,589,46,635
公投第７案,彰化縣,芬園鄉,社口村,229,1238,504,108,612,68,680
公投第７案,彰化縣,芬園鄉,茄荖村,230,1362,579,144,723,62,785
公投第７案,彰化縣,芬園鄉,茄荖村,231,989,411,106,517,64,581
公投第７案,彰化縣,芬園鄉,嘉興村,232,1054,514,103,617,49,666
公投第７案,彰化縣,芬園鄉,嘉興村,233,607,308,63,371,27,398
公投第７案,彰化縣,芬園鄉,芬園村,234,882,406,89,495,39,534
公投第７案,彰化縣,芬園鄉,縣庄村,235,1143,433,96,529,31,560
公投第７案,彰化縣,芬園鄉,圳墘村,236,661,233,46,279,22,301
公投第７案,彰化縣,芬園鄉,溪頭村,237,838,323,83,406,3,409
公投第７案,彰化縣,芬園鄉,溪頭村,238,847,308,103,411,32,443
公投第７案,彰化縣,芬園鄉,進芬村,239,987,435,95,530,62,592
公投第７案,彰化縣,芬園鄉,同安村,240,1217,416,145,561,69,630
公投第７案,彰化縣,芬園鄉,中崙村,241,865,295,79,374,69,443
公投第７案,彰化縣,芬園鄉,大竹村,242,996,392,88,480,47,527
公投第７案,彰化縣,鹿港鎮,大有里,243,1140,503,155,658,53,711
公投第７案,彰化縣,鹿港鎮,中興里,244,511,214,61,275,29,304
公投第７案,彰化縣,鹿港鎮,洛津里,245,857,304,71,375,25,400
公投第７案,彰化縣,鹿港鎮,順興里,246,946,435,119,554,55,609
公投第７案,彰化縣,鹿港鎮,埔崙里,247,945,425,103,528,35,563
公投第７案,彰化縣,鹿港鎮,埔崙里,248,1097,483,115,598,50,648
公投第７案,彰化縣,鹿港鎮,埔崙里,249,1479,545,127,672,38,710
公投第７案,彰化縣,鹿港鎮,埔崙里,250,1425,622,149,771,82,853
公投第７案,彰化縣,鹿港鎮,新宮里,251,880,396,98,494,68,562
公投第７案,彰化縣,鹿港鎮,玉順里,252,1183,459,132,591,67,658
公投第７案,彰化縣,鹿港鎮,東石里,253,1047,451,122,573,72,645
公投第７案,彰化縣,鹿港鎮,東石里,254,1097,426,114,540,22,562
公投第７案,彰化縣,鹿港鎮,東石里,255,1030,449,98,547,46,593
公投第７案,彰化縣,鹿港鎮,東石里,256,1161,509,115,624,42,666
公投第７案,彰化縣,鹿港鎮,郭厝里,257,540,232,56,288,52,340
公投第７案,彰化縣,鹿港鎮,永安里,258,1135,474,127,601,44,645
公投第７案,彰化縣,鹿港鎮,永安里,259,1155,481,128,609,57,666
公投第７案,彰化縣,鹿港鎮,永安里,260,1127,538,115,653,43,696
公投第７案,彰化縣,鹿港鎮,永安里,261,1045,445,131,576,47,623
公投第７案,彰化縣,鹿港鎮,景福里,262,1127,452,149,601,64,665
公投第７案,彰化縣,鹿港鎮,泰興里,263,1178,549,145,694,77,771
公投第７案,彰化縣,鹿港鎮,長興里,264,284,124,28,152,17,169
公投第７案,彰化縣,鹿港鎮,興化里,265,584,236,74,310,35,345
公投第７案,彰化縣,鹿港鎮,龍山里,266,659,312,83,395,38,433
公投第７案,彰化縣,鹿港鎮,菜園里,267,915,368,101,469,16,485
公投第７案,彰化縣,鹿港鎮,街尾里,268,1079,487,123,610,64,674
公投第７案,彰化縣,鹿港鎮,街尾里,269,1129,534,127,661,69,730
公投第７案,彰化縣,鹿港鎮,詔安里,270,1273,508,128,636,67,703
公投第７案,彰化縣,鹿港鎮,詔安里,271,706,282,52,334,37,371
公投第７案,彰化縣,鹿港鎮,海埔里,272,1137,442,95,537,93,630
公投第７案,彰化縣,鹿港鎮,海埔里,273,1195,495,120,615,47,662
公投第７案,彰化縣,鹿港鎮,海埔里,274,1225,504,111,615,46,661
公投第７案,彰化縣,鹿港鎮,洋厝里,275,957,478,97,575,55,630
公投第７案,彰化縣,鹿港鎮,洋厝里,276,758,274,64,338,64,402
公投第７案,彰化縣,鹿港鎮,洋厝里,277,723,303,65,368,62,430
公投第７案,彰化縣,鹿港鎮,草中里,278,984,443,63,506,31,537
公投第７案,彰化縣,鹿港鎮,草中里,279,1018,488,105,593,52,645
公投第７案,彰化縣,鹿港鎮,草中里,280,1165,479,116,595,50,645
公投第７案,彰化縣,鹿港鎮,頭南里,281,1161,472,98,570,44,614
公投第７案,彰化縣,鹿港鎮,頭南里,282,1020,418,96,514,42,556
公投第７案,彰化縣,鹿港鎮,山崙里,283,1068,447,114,561,54,615
公投第７案,彰化縣,鹿港鎮,山崙里,284,1024,467,99,566,39,605
公投第７案,彰化縣,鹿港鎮,山崙里,285,974,414,101,515,84,599
公投第７案,彰化縣,鹿港鎮,頂番里,286,1505,607,129,736,80,816
公投第７案,彰化縣,鹿港鎮,頂番里,287,1092,477,89,566,37,603
公投第７案,彰化縣,鹿港鎮,頂番里,288,1223,572,117,689,53,742
公投第７案,彰化縣,鹿港鎮,頭崙里,289,1572,575,117,692,39,731
公投第７案,彰化縣,鹿港鎮,頭崙里,290,1003,469,104,573,46,619
公投第７案,彰化縣,鹿港鎮,溝墘里,291,933,439,86,525,30,555
公投第７案,彰化縣,鹿港鎮,溝墘里,292,1093,479,129,608,55,663
公投第７案,彰化縣,鹿港鎮,溝墘里,293,907,386,101,487,18,505
公投第７案,彰化縣,鹿港鎮,溝墘里,294,1219,498,130,628,44,672
公投第７案,彰化縣,鹿港鎮,廖厝里,295,1397,684,145,829,58,887
公投第７案,彰化縣,鹿港鎮,廖厝里,296,1229,550,138,688,33,721
公投第７案,彰化縣,鹿港鎮,廖厝里,297,1444,642,102,744,39,783
公投第７案,彰化縣,鹿港鎮,東崎里,298,1227,525,151,676,58,734
公投第７案,彰化縣,鹿港鎮,東崎里,299,1187,519,133,652,59,711
公投第７案,彰化縣,鹿港鎮,東崎里,300,1296,555,108,663,21,684
公投第７案,彰化縣,鹿港鎮,東崎里,301,1451,523,160,683,70,753
公投第７案,彰化縣,鹿港鎮,頂厝里,302,1299,530,140,670,65,735
公投第７案,彰化縣,鹿港鎮,頂厝里,303,1298,635,126,761,40,801
公投第７案,彰化縣,鹿港鎮,頂厝里,304,1458,639,150,789,50,839
公投第７案,彰化縣,鹿港鎮,頂厝里,305,1138,485,136,621,46,667
公投第７案,彰化縣,鹿港鎮,頂厝里,306,1170,507,117,624,58,682
公投第７案,彰化縣,鹿港鎮,頂厝里,307,1221,556,130,686,55,741
公投第７案,彰化縣,福興鄉,三汴村,308,1363,508,182,690,52,742
公投第７案,彰化縣,福興鄉,萬豐村,309,821,348,90,438,34,472
公投第７案,彰化縣,福興鄉,元中村,310,1256,495,97,592,67,659
公投第７案,彰化縣,福興鄉,外中村,311,1166,410,130,540,93,633
公投第７案,彰化縣,福興鄉,外埔村,312,1464,586,120,706,57,763
公投第７案,彰化縣,福興鄉,大崙村,313,1251,491,130,621,43,664
公投第７案,彰化縣,福興鄉,番婆村,314,1465,570,143,713,61,774
公投第７案,彰化縣,福興鄉,番婆村,315,960,346,94,440,29,469
公投第７案,彰化縣,福興鄉,橋頭村,316,1323,504,129,633,82,715
公投第７案,彰化縣,福興鄉,橋頭村,317,1365,538,155,693,60,753
公投第７案,彰化縣,福興鄉,社尾村,318,1458,466,156,622,33,655
公投第７案,彰化縣,福興鄉,番社村,319,1492,530,167,697,91,788
公投第７案,彰化縣,福興鄉,西勢村,320,888,322,80,402,23,425
公投第７案,彰化縣,福興鄉,西勢村,321,1054,445,125,570,58,628
公投第７案,彰化縣,福興鄉,同安村,322,1043,372,101,473,49,522
公投第７案,彰化縣,福興鄉,同安村,323,1340,511,162,673,66,739
公投第７案,彰化縣,福興鄉,秀厝村,324,1085,405,111,516,40,556
公投第７案,彰化縣,福興鄉,秀厝村,325,1392,529,125,654,50,704
公投第７案,彰化縣,福興鄉,福興村,326,1316,580,114,694,80,774
公投第７案,彰化縣,福興鄉,福興村,327,1255,556,156,712,48,760
公投第７案,彰化縣,福興鄉,福興村,328,1101,504,120,624,48,672
公投第７案,彰化縣,福興鄉,福南村,329,1167,490,88,578,78,656
公投第７案,彰化縣,福興鄉,福南村,330,1393,532,123,655,82,737
公投第７案,彰化縣,福興鄉,鎮平村,331,1216,516,117,633,59,692
公投第７案,彰化縣,福興鄉,三和村,332,1063,491,86,577,55,632
公投第７案,彰化縣,福興鄉,二港村,333,1306,513,125,638,68,706
公投第７案,彰化縣,福興鄉,福寶村,334,1287,422,120,542,53,595
公投第７案,彰化縣,福興鄉,頂粘村,335,994,398,120,518,40,558
公投第７案,彰化縣,福興鄉,頂粘村,336,1311,546,124,670,71,741
公投第７案,彰化縣,福興鄉,廈粘村,337,926,398,95,493,56,549
公投第７案,彰化縣,福興鄉,廈粘村,338,995,379,96,475,46,521
公投第７案,彰化縣,福興鄉,麥厝村,339,1079,500,113,613,78,691
公投第７案,彰化縣,福興鄉,麥厝村,340,1150,426,102,528,77,605
公投第７案,彰化縣,秀水鄉,秀水村,341,1066,483,110,593,75,668
公投第７案,彰化縣,秀水鄉,秀水村,342,620,274,85,359,38,397
公投第７案,彰化縣,秀水鄉,安溪村,343,876,341,86,427,15,442
公投第７案,彰化縣,秀水鄉,安溪村,344,1196,550,147,697,41,738
公投第７案,彰化縣,秀水鄉,莊雅村,345,1369,599,147,746,44,790
公投第７案,彰化縣,秀水鄉,莊雅村,346,1273,555,154,709,46,755
公投第７案,彰化縣,秀水鄉,陝西村,347,1433,619,138,757,48,805
公投第７案,彰化縣,秀水鄉,金興村,348,967,435,115,550,20,570
公投第７案,彰化縣,秀水鄉,金興村,349,921,407,106,513,22,535
公投第７案,彰化縣,秀水鄉,安東村,350,689,329,74,403,30,433
公投第７案,彰化縣,秀水鄉,安東村,351,688,290,88,378,43,421
公投第７案,彰化縣,秀水鄉,安東村,352,1252,582,148,730,52,782
公投第７案,彰化縣,秀水鄉,安東村,353,1281,521,126,647,35,682
公投第７案,彰化縣,秀水鄉,鶴鳴村,354,754,317,82,399,20,419
公投第７案,彰化縣,秀水鄉,鶴鳴村,355,1024,430,102,532,50,582
公投第７案,彰化縣,秀水鄉,鶴鳴村,356,1433,605,128,733,29,762
公投第７案,彰化縣,秀水鄉,馬興村,357,1366,655,173,828,45,873
公投第７案,彰化縣,秀水鄉,馬興村,358,895,397,107,504,41,545
公投第７案,彰化縣,秀水鄉,義興村,359,1386,558,125,683,71,754
公投第７案,彰化縣,秀水鄉,福安村,360,896,385,105,490,55,545
公投第７案,彰化縣,秀水鄉,福安村,361,804,382,113,495,34,529
公投第７案,彰化縣,秀水鄉,福安村,362,827,411,80,491,26,517
公投第７案,彰化縣,秀水鄉,福安村,363,996,447,96,543,50,593
公投第７案,彰化縣,秀水鄉,福安村,364,931,466,101,567,49,616
公投第７案,彰化縣,秀水鄉,埔崙村,365,715,297,78,375,30,405
公投第７案,彰化縣,秀水鄉,埔崙村,366,1229,550,163,713,54,767
公投第７案,彰化縣,秀水鄉,曾厝村,367,890,350,81,431,27,458
公投第７案,彰化縣,秀水鄉,曾厝村,368,811,371,103,474,35,509
公投第７案,彰化縣,秀水鄉,金陵村,369,786,349,104,453,33,486
公投第７案,彰化縣,秀水鄉,金陵村,370,931,419,93,512,30,542
公投第７案,彰化縣,秀水鄉,下崙村,371,1265,563,139,702,66,768
公投第７案,彰化縣,秀水鄉,下崙村,372,824,353,72,425,35,460
公投第７案,彰化縣,和美鎮,竹營里,373,1341,542,143,685,54,739
公投第７案,彰化縣,和美鎮,竹營里,374,1480,594,125,719,51,770
公投第７案,彰化縣,和美鎮,竹營里,375,1529,655,161,816,37,853
公投第７案,彰化縣,和美鎮,竹營里,376,1711,654,162,816,20,836
公投第７案,彰化縣,和美鎮,和東里,377,1057,454,123,577,37,614
公投第７案,彰化縣,和美鎮,和東里,378,1032,469,103,572,38,610
公投第７案,彰化縣,和美鎮,和東里,379,1015,473,92,565,61,626
公投第７案,彰化縣,和美鎮,和東里,380,1209,548,137,685,46,731
公投第７案,彰化縣,和美鎮,和南里,381,430,182,47,229,22,251
公投第７案,彰化縣,和美鎮,和北里,382,856,374,78,452,15,467
公投第７案,彰化縣,和美鎮,和北里,383,966,475,82,557,26,583
公投第７案,彰化縣,和美鎮,和西里,384,1059,435,129,564,19,583
公投第７案,彰化縣,和美鎮,和西里,385,1117,488,115,603,35,638
公投第７案,彰化縣,和美鎮,和西里,386,1066,444,108,552,42,594
公投第７案,彰化縣,和美鎮,四張里,387,1252,510,121,631,42,673
公投第７案,彰化縣,和美鎮,四張里,388,1528,632,132,764,42,806
公投第７案,彰化縣,和美鎮,頭前里,389,826,373,97,470,27,497
公投第７案,彰化縣,和美鎮,頭前里,390,854,391,67,458,21,479
公投第７案,彰化縣,和美鎮,面前里,391,1387,573,113,686,54,740
公投第７案,彰化縣,和美鎮,面前里,392,765,362,91,453,24,477
公投第７案,彰化縣,和美鎮,鎮平里,393,1438,595,109,704,46,750
公投第７案,彰化縣,和美鎮,鎮平里,394,1396,630,135,765,66,831
公投第７案,彰化縣,和美鎮,大霞里,395,658,272,87,359,20,379
公投第７案,彰化縣,和美鎮,大霞里,396,809,398,80,478,36,514
公投第７案,彰化縣,和美鎮,源埤里,397,932,384,89,473,9,482
公投第７案,彰化縣,和美鎮,源埤里,398,888,368,80,448,38,486
公投第７案,彰化縣,和美鎮,南佃里,399,1144,510,149,659,40,699
公投第７案,彰化縣,和美鎮,南佃里,400,1077,486,86,572,38,610
公投第７案,彰化縣,和美鎮,雅溝里,401,1349,530,126,656,51,707
公投第７案,彰化縣,和美鎮,山犁里,402,1155,549,130,679,44,723
公投第７案,彰化縣,和美鎮,山犁里,403,1253,542,117,659,36,695
公投第７案,彰化縣,和美鎮,山犁里,404,1252,548,97,645,40,685
公投第７案,彰化縣,和美鎮,山犁里,405,1474,634,125,759,23,782
公投第７案,彰化縣,和美鎮,仁愛里,406,1396,558,102,660,33,693
公投第７案,彰化縣,和美鎮,仁愛里,407,1348,577,113,690,38,728
公投第７案,彰化縣,和美鎮,嘉犁里,408,999,481,114,595,25,620
公投第７案,彰化縣,和美鎮,嘉犁里,409,911,397,108,505,42,547
公投第７案,彰化縣,和美鎮,詔安里,410,1005,418,139,557,32,589
公投第７案,彰化縣,和美鎮,詔安里,411,967,422,102,524,38,562
公投第７案,彰化縣,和美鎮,鐵山里,412,1308,571,153,724,38,762
公投第７案,彰化縣,和美鎮,鐵山里,413,1324,570,143,713,33,746
公投第７案,彰化縣,和美鎮,柑井里,414,1102,461,152,613,43,656
公投第７案,彰化縣,和美鎮,柑井里,415,1124,530,33,563,46,609
公投第７案,彰化縣,和美鎮,柑井里,416,1211,540,117,657,46,703
公投第７案,彰化縣,和美鎮,竹園里,417,884,436,120,556,30,586
公投第７案,彰化縣,和美鎮,新庄里,418,1119,448,146,594,57,651
公投第７案,彰化縣,和美鎮,新庄里,419,1300,561,118,679,54,733
公投第７案,彰化縣,和美鎮,犁盛里,420,1104,466,103,569,37,606
公投第７案,彰化縣,和美鎮,犁盛里,421,1213,563,134,697,41,738
公投第７案,彰化縣,和美鎮,中寮里,422,1127,408,121,529,44,573
公投第７案,彰化縣,和美鎮,中圍里,423,919,384,86,470,51,521
公投第７案,彰化縣,和美鎮,中圍里,424,987,443,105,548,48,596
公投第７案,彰化縣,和美鎮,中圍里,425,958,431,128,559,32,591
公投第７案,彰化縣,和美鎮,糖友里,426,1362,603,137,740,49,789
公投第７案,彰化縣,和美鎮,糖友里,427,1461,627,139,766,28,794
公投第７案,彰化縣,和美鎮,糖友里,428,1405,632,140,772,28,800
公投第７案,彰化縣,和美鎮,還社里,429,860,385,107,492,29,521
公投第７案,彰化縣,和美鎮,塗厝里,430,875,380,77,457,15,472
公投第７案,彰化縣,和美鎮,塗厝里,431,871,369,96,465,39,504
公投第７案,彰化縣,和美鎮,地潭里,432,883,416,96,512,38,550
公投第７案,彰化縣,和美鎮,湖內里,433,1224,474,132,606,57,663
公投第７案,彰化縣,和美鎮,嘉寶里,434,1075,444,108,552,46,598
公投第７案,彰化縣,和美鎮,嘉寶里,435,956,410,100,510,34,544
公投第７案,彰化縣,和美鎮,月眉里,436,1037,428,106,534,46,580
公投第７案,彰化縣,和美鎮,月眉里,437,1011,445,101,546,19,565
公投第７案,彰化縣,和美鎮,月眉里,438,1023,414,106,520,50,570
公投第７案,彰化縣,和美鎮,好修里,439,719,302,67,369,22,391
公投第７案,彰化縣,和美鎮,好修里,440,913,377,94,471,46,517
公投第７案,彰化縣,伸港鄉,大同村,441,1182,480,81,561,31,592
公投第７案,彰化縣,伸港鄉,大同村,442,1166,584,96,680,37,717
公投第７案,彰化縣,伸港鄉,海尾村,443,966,431,87,518,41,559
公投第７案,彰化縣,伸港鄉,海尾村,444,873,368,79,447,40,487
公投第７案,彰化縣,伸港鄉,全興村,445,812,368,84,452,40,492
公投第７案,彰化縣,伸港鄉,全興村,446,875,385,77,462,30,492
公投第７案,彰化縣,伸港鄉,溪底村,447,904,383,76,459,45,504
公投第７案,彰化縣,伸港鄉,溪底村,448,1008,430,89,519,41,560
公投第７案,彰化縣,伸港鄉,定興村,449,1154,524,113,637,49,686
公投第７案,彰化縣,伸港鄉,定興村,450,1486,580,137,717,67,784
公投第７案,彰化縣,伸港鄉,什股村,451,1095,463,92,555,53,608
公投第７案,彰化縣,伸港鄉,什股村,452,1087,484,52,536,23,559
公投第７案,彰化縣,伸港鄉,泉州村,453,1085,487,107,594,53,647
公投第７案,彰化縣,伸港鄉,泉州村,454,908,434,72,506,37,543
公投第７案,彰化縣,伸港鄉,泉厝村,455,1264,621,99,720,37,757
公投第７案,彰化縣,伸港鄉,曾家村,456,854,348,75,423,47,470
公投第７案,彰化縣,伸港鄉,曾家村,457,846,336,62,398,29,427
公投第７案,彰化縣,伸港鄉,蚵寮村,458,1143,421,95,516,93,609
公投第７案,彰化縣,伸港鄉,新港村,459,1357,592,128,720,29,749
公投第７案,彰化縣,伸港鄉,新港村,460,1349,533,154,687,75,762
公投第７案,彰化縣,伸港鄉,新港村,461,1154,509,121,630,46,676
公投第７案,彰化縣,伸港鄉,新港村,462,1279,536,127,663,33,696
公投第７案,彰化縣,伸港鄉,埤墘村,463,1317,601,127,728,49,777
公投第７案,彰化縣,伸港鄉,七嘉村,464,990,459,104,563,43,606
公投第７案,彰化縣,伸港鄉,七嘉村,465,852,397,74,471,31,502
公投第７案,彰化縣,伸港鄉,七嘉村,466,1178,616,27,643,32,675
公投第７案,彰化縣,伸港鄉,汴頭村,467,1088,444,107,551,70,621
公投第７案,彰化縣,伸港鄉,汴頭村,468,1135,486,108,594,53,647
公投第７案,彰化縣,線西鄉,線西村,469,1071,482,103,585,25,610
公投第７案,彰化縣,線西鄉,線西村,470,1166,536,115,651,37,688
公投第７案,彰化縣,線西鄉,頂庄村,471,1269,574,115,689,63,752
公投第７案,彰化縣,線西鄉,寓埔村,472,1138,488,121,609,43,652
公投第７案,彰化縣,線西鄉,寓埔村,473,1128,534,117,651,68,719
公投第７案,彰化縣,線西鄉,塭仔村,474,1275,569,115,684,80,764
公投第７案,彰化縣,線西鄉,溝內村,475,1187,543,106,649,58,707
公投第７案,彰化縣,線西鄉,下犁村,476,991,454,104,558,45,603
公投第７案,彰化縣,線西鄉,下犁村,477,938,402,101,503,58,561
公投第７案,彰化縣,線西鄉,頂犁村,478,1276,515,118,633,46,679
公投第７案,彰化縣,線西鄉,頂犁村,479,1285,591,118,709,47,756
公投第７案,彰化縣,線西鄉,德興村,480,1341,673,134,807,67,874
公投第７案,彰化縣,員林市,崙雅里,481,1087,462,77,539,21,560
公投第７案,彰化縣,員林市,崙雅里,482,1353,522,145,667,34,701
公投第７案,彰化縣,員林市,振興里,483,1313,510,135,645,57,702
公投第７案,彰化縣,員林市,振興里,484,1328,477,94,571,32,603
公投第７案,彰化縣,員林市,林厝里,485,1055,436,136,572,29,601
公投第７案,彰化縣,員林市,林厝里,486,959,401,85,486,38,524
公投第７案,彰化縣,員林市,林厝里,487,772,330,88,418,33,451
公投第７案,彰化縣,員林市,出水里,488,831,373,96,469,40,509
公投第７案,彰化縣,員林市,出水里,489,854,269,63,332,12,344
公投第７案,彰化縣,員林市,湖水里,490,1190,385,109,494,38,532
公投第７案,彰化縣,員林市,大峯里,491,726,318,60,378,16,394
公投第７案,彰化縣,員林市,鎮興里,492,1124,449,125,574,56,630
公投第７案,彰化縣,員林市,鎮興里,493,860,318,77,395,58,453
公投第７案,彰化縣,員林市,浮圳里,494,1122,533,112,645,36,681
公投第７案,彰化縣,員林市,浮圳里,495,1075,471,122,593,44,637
公投第７案,彰化縣,員林市,西東里,496,993,370,116,486,64,550
公投第７案,彰化縣,員林市,西東里,497,967,389,90,479,26,505
公投第７案,彰化縣,員林市,南東里,498,1008,381,143,524,53,577
公投第７案,彰化縣,員林市,南東里,499,804,314,98,412,45,457
公投第７案,彰化縣,員林市,中東里,500,867,365,90,455,29,484
公投第７案,彰化縣,員林市,中東里,501,885,370,72,442,27,469
公投第７案,彰化縣,員林市,東北里,502,1097,384,73,457,15,472
公投第７案,彰化縣,員林市,東北里,503,1255,518,120,638,30,668
公投第７案,彰化縣,員林市,東和里,504,1063,436,129,565,49,614
公投第７案,彰化縣,員林市,民生里,505,925,296,198,494,24,518
公投第７案,彰化縣,員林市,民生里,506,947,400,120,520,35,555
公投第７案,彰化縣,員林市,民生里,507,916,408,113,521,27,548
公投第７案,彰化縣,員林市,黎明里,508,862,364,83,447,31,478
公投第７案,彰化縣,員林市,黎明里,509,987,422,123,545,18,563
公投第７案,彰化縣,員林市,惠來里,510,1085,451,103,554,41,595
公投第７案,彰化縣,員林市,惠來里,511,1110,514,104,618,21,639
公投第７案,彰化縣,員林市,惠來里,512,1095,437,105,542,17,559
公投第７案,彰化縣,員林市,惠來里,513,1278,592,154,746,36,782
公投第７案,彰化縣,員林市,惠來里,514,1109,507,109,616,37,653
公投第７案,彰化縣,員林市,中央里,515,1055,427,112,539,63,602
公投第７案,彰化縣,員林市,中央里,516,876,365,109,474,28,502
公投第７案,彰化縣,員林市,溝皂里,517,1115,383,128,511,45,556
公投第７案,彰化縣,員林市,溝皂里,518,1186,532,112,644,45,689
公投第７案,彰化縣,員林市,大饒里,519,995,460,102,562,38,600
公投第７案,彰化縣,員林市,大饒里,520,999,400,100,500,13,513
公投第７案,彰化縣,員林市,大饒里,521,1201,500,132,632,27,659
公投第７案,彰化縣,員林市,大明里,522,1342,574,129,703,29,732
公投第７案,彰化縣,員林市,大明里,523,1086,444,107,551,26,577
公投第７案,彰化縣,員林市,萬年里,524,854,337,95,432,27,459
公投第７案,彰化縣,員林市,萬年里,525,1064,454,108,562,28,590
公投第７案,彰化縣,員林市,萬年里,526,879,399,108,507,11,518
公投第７案,彰化縣,員林市,萬年里,527,827,444,84,528,33,561
公投第７案,彰化縣,員林市,中正里,528,867,365,79,444,13,457
公投第７案,彰化縣,員林市,中正里,529,1201,513,128,641,37,678
公投第７案,彰化縣,員林市,中正里,530,1106,479,122,601,40,641
公投第７案,彰化縣,員林市,仁美里,531,845,348,114,462,41,503
公投第７案,彰化縣,員林市,仁美里,532,894,394,98,492,33,525
公投第７案,彰化縣,員林市,仁美里,533,849,381,89,470,31,501
公投第７案,彰化縣,員林市,新興里,534,747,339,93,432,42,474
公投第７案,彰化縣,員林市,和平里,535,884,407,117,524,27,551
公投第７案,彰化縣,員林市,和平里,536,900,363,81,444,33,477
公投第７案,彰化縣,員林市,和平里,537,1040,412,107,519,27,546
公投第７案,彰化縣,員林市,光明里,538,831,325,118,443,19,462
公投第７案,彰化縣,員林市,中山里,539,591,270,74,344,35,379
公投第７案,彰化縣,員林市,三條里,540,1330,534,146,680,43,723
公投第７案,彰化縣,員林市,三條里,541,1295,571,125,696,29,725
公投第７案,彰化縣,員林市,忠孝里,542,1283,537,131,668,47,715
公投第７案,彰化縣,員林市,忠孝里,543,943,416,116,532,35,567
公投第７案,彰化縣,員林市,仁愛里,544,1388,623,182,805,42,847
公投第７案,彰化縣,員林市,三和里,545,1176,526,120,646,31,677
公投第７案,彰化縣,員林市,三和里,546,867,334,68,402,10,412
公投第７案,彰化縣,員林市,三和里,547,1121,442,136,578,43,621
公投第７案,彰化縣,員林市,三和里,548,1190,491,101,592,39,631
公投第７案,彰化縣,員林市,三和里,549,945,419,110,529,36,565
公投第７案,彰化縣,員林市,三和里,550,906,418,95,513,32,545
公投第７案,彰化縣,員林市,三橋里,551,978,414,137,551,45,596
公投第７案,彰化縣,員林市,三橋里,552,949,433,81,514,42,556
公投第７案,彰化縣,員林市,三橋里,553,949,439,85,524,28,552
公投第７案,彰化縣,員林市,三愛里,554,1006,439,93,532,29,561
公投第７案,彰化縣,員林市,三愛里,555,889,386,101,487,41,528
公投第７案,彰化縣,員林市,三愛里,556,923,413,118,531,21,552
公投第７案,彰化縣,員林市,三信里,557,1209,563,146,709,37,746
公投第７案,彰化縣,員林市,三信里,558,1075,478,134,612,38,650
公投第７案,彰化縣,員林市,三多里,559,1342,650,142,792,33,825
公投第７案,彰化縣,員林市,三多里,560,1039,508,137,645,43,688
公投第７案,彰化縣,員林市,三義里,561,1131,467,110,577,53,630
公投第７案,彰化縣,員林市,三義里,562,1356,534,127,661,39,700
公投第７案,彰化縣,員林市,新生里,563,1370,587,131,718,51,769
公投第７案,彰化縣,員林市,新生里,564,1090,465,127,592,40,632
公投第７案,彰化縣,員林市,新生里,565,821,412,98,510,22,532
公投第７案,彰化縣,員林市,新生里,566,910,412,94,506,35,541
公投第７案,彰化縣,員林市,南平里,567,1203,515,131,646,44,690
公投第７案,彰化縣,員林市,南平里,568,1378,586,144,730,48,778
公投第７案,彰化縣,員林市,南平里,569,1352,590,154,744,29,773
公投第７案,彰化縣,員林市,南平里,570,1060,475,151,626,21,647
公投第７案,彰化縣,員林市,南興里,571,1317,566,116,682,38,720
公投第７案,彰化縣,員林市,南興里,572,1120,443,128,571,40,611
公投第７案,彰化縣,員林市,南興里,573,1025,422,93,515,41,556
公投第７案,彰化縣,員林市,南興里,574,1097,465,120,585,45,630
公投第７案,彰化縣,員林市,源潭里,575,859,387,109,496,34,530
公投第７案,彰化縣,員林市,源潭里,576,837,344,90,434,33,467
公投第７案,彰化縣,員林市,大埔里,577,1090,506,129,635,52,687
公投第７案,彰化縣,員林市,大埔里,578,1073,432,116,548,62,610
公投第７案,彰化縣,大村鄉,大村村,579,1426,671,176,847,54,901
公投第７案,彰化縣,大村鄉,大村村,580,1726,819,177,996,79,1075
公投第７案,彰化縣,大村鄉,茄苳村,581,797,358,101,459,46,505
公投第７案,彰化縣,大村鄉,茄苳村,582,745,319,77,396,17,413
公投第７案,彰化縣,大村鄉,田洋村,583,1125,518,113,631,61,692
公投第７案,彰化縣,大村鄉,貢旗村,584,1486,616,153,769,90,859
公投第７案,彰化縣,大村鄉,南勢村,585,1426,636,142,778,57,835
公投第７案,彰化縣,大村鄉,大橋村,586,824,368,119,487,36,523
公投第７案,彰化縣,大村鄉,大橋村,587,1177,458,104,562,39,601
公投第７案,彰化縣,大村鄉,加錫村,588,1478,660,153,813,68,881
公投第７案,彰化縣,大村鄉,大崙村,589,779,306,84,390,16,406
公投第７案,彰化縣,大村鄉,大崙村,590,812,381,83,464,46,510
公投第７案,彰化縣,大村鄉,新興村,591,1161,510,105,615,33,648
公投第７案,彰化縣,大村鄉,擺塘村,592,1238,517,116,633,23,656
公投第７案,彰化縣,大村鄉,擺塘村,593,1259,530,149,679,47,726
公投第７案,彰化縣,大村鄉,過溝村,594,1412,623,148,771,49,820
公投第７案,彰化縣,大村鄉,過溝村,595,1401,627,137,764,23,787
公投第７案,彰化縣,大村鄉,村上村,596,1395,631,144,775,65,840
公投第７案,彰化縣,大村鄉,美港村,597,996,418,125,543,58,601
公投第７案,彰化縣,大村鄉,美港村,598,1047,467,110,577,34,611
公投第７案,彰化縣,大村鄉,美港村,599,985,452,96,548,37,585
公投第７案,彰化縣,大村鄉,黃厝村,600,1054,497,125,622,36,658
公投第７案,彰化縣,大村鄉,黃厝村,601,1200,544,125,669,42,711
公投第７案,彰化縣,大村鄉,福興村,602,1003,446,104,550,68,618
公投第７案,彰化縣,大村鄉,福興村,603,1046,419,114,533,40,573
公投第７案,彰化縣,大村鄉,平和村,604,1189,550,114,664,48,712
公投第７案,彰化縣,大村鄉,平和村,605,1305,552,106,658,53,711
公投第７案,彰化縣,永靖鄉,浮圳村,606,1255,493,101,594,68,662
公投第７案,彰化縣,永靖鄉,東寧村,607,889,401,92,493,49,542
公投第７案,彰化縣,永靖鄉,東寧村,608,1026,433,105,538,39,577
公投第７案,彰化縣,永靖鄉,光雲村,609,724,326,84,410,40,450
公投第７案,彰化縣,永靖鄉,光雲村,610,924,409,104,513,39,552
公投第７案,彰化縣,永靖鄉,五汴村,611,659,295,86,381,39,420
公投第７案,彰化縣,永靖鄉,五汴村,612,734,320,85,405,27,432
公投第７案,彰化縣,永靖鄉,永興村,613,758,267,65,332,21,353
公投第７案,彰化縣,永靖鄉,永興村,614,848,408,97,505,43,548
公投第７案,彰化縣,永靖鄉,崙子村,615,1404,531,158,689,77,766
公投第７案,彰化縣,永靖鄉,永東村,616,792,401,105,506,43,549
公投第７案,彰化縣,永靖鄉,永西村,617,695,320,80,400,44,444
公投第７案,彰化縣,永靖鄉,永西村,618,821,399,70,469,40,509
公投第７案,彰化縣,永靖鄉,永南村,619,1064,491,113,604,66,670
公投第７案,彰化縣,永靖鄉,永南村,620,840,343,111,454,31,485
公投第７案,彰化縣,永靖鄉,永北村,621,1079,481,136,617,41,658
公投第７案,彰化縣,永靖鄉,永北村,622,1048,496,121,617,37,654
公投第７案,彰化縣,永靖鄉,港西村,623,960,473,102,575,35,610
公投第７案,彰化縣,永靖鄉,港西村,624,798,356,95,451,28,479
公投第７案,彰化縣,永靖鄉,五福村,625,796,398,109,507,24,531
公投第７案,彰化縣,永靖鄉,五福村,626,662,271,69,340,38,378
公投第７案,彰化縣,永靖鄉,湳港村,627,1040,434,128,562,47,609
公投第７案,彰化縣,永靖鄉,新莊村,628,1025,433,110,543,44,587
公投第７案,彰化縣,永靖鄉,瑚璉村,629,1357,657,147,804,57,861
公投第７案,彰化縣,永靖鄉,瑚璉村,630,1236,550,121,671,74,745
公投第７案,彰化縣,永靖鄉,獨鰲村,631,871,342,88,430,43,473
公投第７案,彰化縣,永靖鄉,敦厚村,632,706,281,63,344,39,383
公投第７案,彰化縣,永靖鄉,崙美村,633,770,376,82,458,27,485
公投第７案,彰化縣,永靖鄉,同安村,634,669,330,80,410,30,440
公投第７案,彰化縣,永靖鄉,同仁村,635,862,363,88,451,44,495
公投第７案,彰化縣,永靖鄉,湳墘村,636,847,356,84,440,32,472
公投第７案,彰化縣,永靖鄉,四芳村,637,668,321,63,384,45,429
公投第７案,彰化縣,永靖鄉,福興村,638,1073,426,92,518,26,544
公投第７案,彰化縣,永靖鄉,竹子村,639,1339,451,142,593,59,652
公投第７案,彰化縣,溪湖鎮,光平里,640,1221,485,145,630,48,678
公投第７案,彰化縣,溪湖鎮,平和里,641,638,297,77,374,35,409
公投第７案,彰化縣,溪湖鎮,太平里,642,817,376,66,442,43,485
公投第７案,彰化縣,溪湖鎮,太平里,643,968,458,90,548,39,587
公投第７案,彰化縣,溪湖鎮,光華里,644,448,227,51,278,17,295
公投第７案,彰化縣,溪湖鎮,湖東里,645,1123,430,105,535,29,564
公投第７案,彰化縣,溪湖鎮,湖東里,646,1166,471,142,613,44,657
公投第７案,彰化縣,溪湖鎮,湖東里,647,1151,468,120,588,30,618
公投第７案,彰化縣,溪湖鎮,湖東里,648,1249,557,127,684,39,723
公投第７案,彰化縣,溪湖鎮,中山里,649,1146,503,123,626,51,677
公投第７案,彰化縣,溪湖鎮,中山里,650,1199,529,124,653,53,706
公投第７案,彰化縣,溪湖鎮,西溪里,651,895,385,90,475,46,521
公投第７案,彰化縣,溪湖鎮,西溪里,652,964,437,113,550,16,566
公投第７案,彰化縣,溪湖鎮,中竹里,653,851,384,90,474,24,498
公投第７案,彰化縣,溪湖鎮,東寮里,654,1072,466,109,575,37,612
公投第７案,彰化縣,溪湖鎮,東寮里,655,1113,513,107,620,48,668
公投第７案,彰化縣,溪湖鎮,東寮里,656,1090,494,128,622,32,654
公投第７案,彰化縣,溪湖鎮,西寮里,657,1193,583,95,678,38,716
公投第７案,彰化縣,溪湖鎮,西寮里,658,952,448,95,543,48,591
公投第７案,彰化縣,溪湖鎮,大突里,659,1172,493,123,616,61,677
公投第７案,彰化縣,溪湖鎮,大突里,660,1027,458,99,557,35,592
公投第７案,彰化縣,溪湖鎮,大突里,661,1188,579,120,699,47,746
公投第７案,彰化縣,溪湖鎮,北勢里,662,1403,554,149,703,49,752
公投第７案,彰化縣,溪湖鎮,汴頭里,663,1397,501,141,642,73,715
公投第７案,彰化縣,溪湖鎮,汴頭里,664,1636,710,147,857,51,908
公投第７案,彰化縣,溪湖鎮,大竹里,665,1298,563,139,702,73,775
公投第７案,彰化縣,溪湖鎮,大竹里,666,1214,557,96,653,46,699
公投第７案,彰化縣,溪湖鎮,湖西里,667,1297,589,142,731,45,776
公投第７案,彰化縣,溪湖鎮,湖西里,668,968,457,99,556,49,605
公投第７案,彰化縣,溪湖鎮,田中里,669,839,370,98,468,35,503
公投第７案,彰化縣,溪湖鎮,河東里,670,907,387,125,512,37,549
公投第７案,彰化縣,溪湖鎮,河東里,671,898,330,91,421,19,440
公投第７案,彰化縣,溪湖鎮,頂庄里,672,650,344,76,420,29,449
公投第７案,彰化縣,溪湖鎮,忠覺里,673,1279,526,128,654,83,737
公投第７案,彰化縣,溪湖鎮,湳底里,674,730,329,93,422,44,466
公投第７案,彰化縣,溪湖鎮,大庭里,675,1407,634,120,754,61,815
公投第７案,彰化縣,溪湖鎮,媽厝里,676,1273,437,141,578,59,637
公投第７案,彰化縣,溪湖鎮,番婆里,677,988,414,101,515,24,539
公投第７案,彰化縣,溪湖鎮,番婆里,678,754,348,85,433,48,481
公投第７案,彰化縣,溪湖鎮,西勢里,679,1052,353,127,480,45,525
公投第７案,彰化縣,溪湖鎮,西勢里,680,1149,513,77,590,31,621
公投第７案,彰化縣,溪湖鎮,東溪里,681,1365,609,182,791,71,862
公投第７案,彰化縣,埔鹽鄉,埔鹽村,682,958,442,109,551,42,593
公投第７案,彰化縣,埔鹽鄉,埔鹽村,683,754,373,89,462,30,492
公投第７案,彰化縣,埔鹽鄉,埔南村,684,757,371,103,474,27,501
公投第７案,彰化縣,埔鹽鄉,埔南村,685,806,373,97,470,32,502
公投第７案,彰化縣,埔鹽鄉,廍子村,686,1280,603,107,710,51,761
公投第７案,彰化縣,埔鹽鄉,出水村,687,928,421,87,508,40,548
公投第７案,彰化縣,埔鹽鄉,南港村,688,895,415,122,537,56,593
公投第７案,彰化縣,埔鹽鄉,南港村,689,815,373,100,473,53,526
公投第７案,彰化縣,埔鹽鄉,打廉村,690,957,433,92,525,35,560
公投第７案,彰化縣,埔鹽鄉,豐澤村,691,1338,580,106,686,100,786
公投第７案,彰化縣,埔鹽鄉,崑崙村,692,1106,484,113,597,38,635
公投第７案,彰化縣,埔鹽鄉,角樹村,693,690,363,75,438,35,473
公投第７案,彰化縣,埔鹽鄉,瓦磘村,694,1230,537,117,654,50,704
公投第７案,彰化縣,埔鹽鄉,好修村,695,847,387,76,463,23,486
公投第７案,彰化縣,埔鹽鄉,好修村,696,897,448,98,546,16,562
公投第７案,彰化縣,埔鹽鄉,西湖村,697,882,384,102,486,43,529
公投第７案,彰化縣,埔鹽鄉,西湖村,698,1180,558,120,678,38,716
公投第７案,彰化縣,埔鹽鄉,大有村,699,1215,488,143,631,74,705
公投第７案,彰化縣,埔鹽鄉,新興村,700,422,236,23,259,22,281
公投第７案,彰化縣,埔鹽鄉,永平村,701,1106,509,69,578,42,620
公投第７案,彰化縣,埔鹽鄉,永樂村,702,874,402,101,503,60,563
公投第７案,彰化縣,埔鹽鄉,石埤村,703,1445,627,152,779,83,862
公投第７案,彰化縣,埔鹽鄉,天盛村,704,875,393,91,484,60,544
公投第７案,彰化縣,埔鹽鄉,太平村,705,837,332,68,400,47,447
公投第７案,彰化縣,埔鹽鄉,太平村,706,685,324,61,385,27,412
公投第７案,彰化縣,埔鹽鄉,新水村,707,733,359,75,434,33,467
公投第７案,彰化縣,埔鹽鄉,新水村,708,798,321,102,423,72,495
公投第７案,彰化縣,埔鹽鄉,三省村,709,1381,606,137,743,52,795
公投第７案,彰化縣,埔鹽鄉,南新村,710,1335,534,130,664,42,706
公投第７案,彰化縣,埔心鄉,東門村,711,1139,516,118,634,75,709
公投第７案,彰化縣,埔心鄉,東門村,712,1217,520,128,648,76,724
公投第７案,彰化縣,埔心鄉,東門村,713,1248,564,139,703,60,763
公投第７案,彰化縣,埔心鄉,埔心村,714,1248,550,174,724,74,798
公投第７案,彰化縣,埔心鄉,義民村,715,916,396,126,522,42,564
公投第７案,彰化縣,埔心鄉,義民村,716,625,302,82,384,27,411
公投第７案,彰化縣,埔心鄉,油車村,717,1271,514,144,658,74,732
公投第７案,彰化縣,埔心鄉,瓦北村,718,608,288,63,351,25,376
公投第７案,彰化縣,埔心鄉,瓦北村,719,1132,532,135,667,65,732
公投第７案,彰化縣,埔心鄉,瓦中村,720,1027,456,129,585,53,638
公投第７案,彰化縣,埔心鄉,瓦中村,721,926,431,114,545,45,590
公投第７案,彰化縣,埔心鄉,瓦南村,722,778,335,91,426,56,482
公投第７案,彰化縣,埔心鄉,瓦南村,723,660,310,82,392,33,425
公投第７案,彰化縣,埔心鄉,經口村,724,1330,620,147,767,53,820
公投第７案,彰化縣,埔心鄉,經口村,725,991,433,119,552,26,578
公投第７案,彰化縣,埔心鄉,太平村,726,985,445,110,555,33,588
公投第７案,彰化縣,埔心鄉,太平村,727,1034,444,115,559,36,595
公投第７案,彰化縣,埔心鄉,大華村,728,612,285,70,355,40,395
公投第７案,彰化縣,埔心鄉,仁里村,729,1236,595,132,727,63,790
公投第７案,彰化縣,埔心鄉,舊舘村,730,775,332,108,440,46,486
公投第７案,彰化縣,埔心鄉,舊舘村,731,738,348,107,455,41,496
公投第７案,彰化縣,埔心鄉,南舘村,732,1036,458,143,601,39,640
公投第７案,彰化縣,埔心鄉,新舘村,733,975,375,114,489,69,558
公投第７案,彰化縣,埔心鄉,芎蕉村,734,885,352,130,482,42,524
公投第７案,彰化縣,埔心鄉,芎蕉村,735,939,404,131,535,54,589
公投第７案,彰化縣,埔心鄉,羅厝村,736,689,303,71,374,38,412
公投第７案,彰化縣,埔心鄉,羅厝村,737,659,302,61,363,25,388
公投第７案,彰化縣,埔心鄉,梧鳳村,738,910,371,88,459,37,496
公投第７案,彰化縣,埔心鄉,二重村,739,1352,613,201,814,78,892
公投第７案,彰化縣,埔心鄉,埤霞村,740,759,320,89,409,33,442
公投第７案,彰化縣,埔心鄉,埤脚村,741,942,439,83,522,45,567
公投第７案,彰化縣,田中鎮,香山里,742,854,311,79,390,86,476
公投第７案,彰化縣,田中鎮,碧峰里,743,963,369,76,445,46,491
公投第７案,彰化縣,田中鎮,碧峰里,744,175,28,12,40,5,45
公投第７案,彰化縣,田中鎮,東源里,745,739,292,68,360,34,394
公投第７案,彰化縣,田中鎮,復興里,746,826,328,78,406,32,438
公投第７案,彰化縣,田中鎮,復興里,747,741,320,84,404,42,446
公投第７案,彰化縣,田中鎮,平和里,748,506,173,33,206,9,215
公投第７案,彰化縣,田中鎮,平和里,749,1001,367,100,467,52,519
公投第７案,彰化縣,田中鎮,頂潭里,750,1281,544,128,672,74,746
公投第７案,彰化縣,田中鎮,新庄里,751,1035,439,109,548,46,594
公投第７案,彰化縣,田中鎮,新庄里,752,1327,565,167,732,48,780
公投第７案,彰化縣,田中鎮,中潭里,753,844,389,98,487,32,519
公投第７案,彰化縣,田中鎮,中潭里,754,913,385,93,478,44,522
公投第７案,彰化縣,田中鎮,龍潭里,755,613,298,66,364,39,403
公投第７案,彰化縣,田中鎮,北路里,756,1382,594,152,746,70,816
公投第７案,彰化縣,田中鎮,北路里,757,1034,523,106,629,45,674
公投第７案,彰化縣,田中鎮,北路里,758,935,460,116,576,41,617
公投第７案,彰化縣,田中鎮,西路里,759,1301,530,68,598,53,651
公投第７案,彰化縣,田中鎮,西路里,760,1100,490,133,623,36,659
公投第７案,彰化縣,田中鎮,東路里,761,1071,472,118,590,50,640
公投第７案,彰化縣,田中鎮,南路里,762,1163,521,146,667,57,724
公投第７案,彰化縣,田中鎮,中路里,763,809,394,101,495,39,534
公投第７案,彰化縣,田中鎮,中路里,764,1155,612,30,642,56,698
公投第７案,彰化縣,田中鎮,梅州里,765,1270,518,127,645,84,729
公投第７案,彰化縣,田中鎮,三安里,766,870,370,86,456,40,496
公投第７案,彰化縣,田中鎮,三安里,767,736,313,79,392,30,422
公投第７案,彰化縣,田中鎮,大崙里,768,1335,500,145,645,48,693
公投第７案,彰化縣,田中鎮,沙崙里,769,876,353,94,447,44,491
公投第７案,彰化縣,田中鎮,沙崙里,770,898,331,107,438,52,490
公投第７案,彰化縣,田中鎮,新民里,771,1298,592,143,735,19,754
公投第７案,彰化縣,田中鎮,新民里,772,1451,576,166,742,71,813
公投第７案,彰化縣,田中鎮,新民里,773,1475,625,150,775,60,835
公投第７案,彰化縣,田中鎮,三民里,774,766,275,80,355,46,401
公投第７案,彰化縣,田中鎮,三民里,775,810,346,54,400,39,439
公投第７案,彰化縣,田中鎮,三光里,776,953,398,114,512,57,569
公投第７案,彰化縣,田中鎮,大社里,777,885,395,98,493,61,554
公投第７案,彰化縣,社頭鄉,社頭村,778,791,316,109,425,38,463
公投第７案,彰化縣,社頭鄉,社頭村,779,984,415,109,524,36,560
公投第７案,彰化縣,社頭鄉,社頭村,780,990,386,109,495,16,511
公投第７案,彰化縣,社頭鄉,廣興村,781,1016,455,122,577,52,629
公投第７案,彰化縣,社頭鄉,廣興村,782,1091,492,136,628,31,659
公投第７案,彰化縣,社頭鄉,廣興村,783,1236,536,141,677,66,743
公投第７案,彰化縣,社頭鄉,廣興村,784,1203,530,90,620,29,649
公投第７案,彰化縣,社頭鄉,東興村,785,753,313,91,404,24,428
公投第７案,彰化縣,社頭鄉,東興村,786,725,273,83,356,30,386
公投第７案,彰化縣,社頭鄉,松竹村,787,1023,446,109,555,69,624
公投第７案,彰化縣,社頭鄉,舊社村,788,562,264,80,344,34,378
公投第７案,彰化縣,社頭鄉,舊社村,789,1049,435,111,546,32,578
公投第７案,彰化縣,社頭鄉,廣福村,790,933,422,101,523,36,559
公投第７案,彰化縣,社頭鄉,橋頭村,791,990,448,112,560,45,605
公投第７案,彰化縣,社頭鄉,橋頭村,792,1076,425,100,525,37,562
公投第７案,彰化縣,社頭鄉,新厝村,793,742,341,88,429,19,448
公投第７案,彰化縣,社頭鄉,新厝村,794,672,279,65,344,18,362
公投第７案,彰化縣,社頭鄉,張厝村,795,1235,495,96,591,37,628
公投第７案,彰化縣,社頭鄉,湳底村,796,750,317,97,414,37,451
公投第７案,彰化縣,社頭鄉,湳底村,797,895,360,95,455,30,485
公投第７案,彰化縣,社頭鄉,仁雅村,798,688,313,52,365,21,386
公投第７案,彰化縣,社頭鄉,仁雅村,799,870,367,76,443,34,477
公投第７案,彰化縣,社頭鄉,仁雅村,800,1140,532,124,656,23,679
公投第７案,彰化縣,社頭鄉,里仁村,801,985,415,134,549,34,583
公投第７案,彰化縣,社頭鄉,美雅村,802,1266,606,131,737,49,786
公投第７案,彰化縣,社頭鄉,崙雅村,803,937,399,115,514,38,552
公投第７案,彰化縣,社頭鄉,清水村,804,1219,538,109,647,43,690
公投第７案,彰化縣,社頭鄉,山湖村,805,1165,472,129,601,70,671
公投第７案,彰化縣,社頭鄉,埤斗村,806,986,428,110,538,46,584
公投第７案,彰化縣,社頭鄉,仁和村,807,724,333,95,428,30,458
公投第７案,彰化縣,社頭鄉,平和村,808,1015,471,79,550,40,590
公投第７案,彰化縣,社頭鄉,協和村,809,1116,423,118,541,31,572
公投第７案,彰化縣,社頭鄉,協和村,810,1061,400,121,521,53,574
公投第７案,彰化縣,社頭鄉,泰安村,811,992,448,111,559,43,602
公投第７案,彰化縣,社頭鄉,朝興村,812,1092,429,116,545,26,571
公投第７案,彰化縣,社頭鄉,龍井村,813,828,367,94,461,44,505
公投第７案,彰化縣,社頭鄉,湳雅村,814,787,296,76,372,53,425
公投第７案,彰化縣,社頭鄉,湳雅村,815,719,267,55,322,22,344
公投第７案,彰化縣,二水鄉,復興村,816,1028,410,131,541,66,607
公投第７案,彰化縣,二水鄉,十五村,817,689,307,79,386,47,433
公投第７案,彰化縣,二水鄉,合和村,818,871,325,99,424,46,470
公投第７案,彰化縣,二水鄉,上豊村,819,953,426,83,509,52,561
公投第７案,彰化縣,二水鄉,過圳村,820,624,209,82,291,49,340
公投第７案,彰化縣,二水鄉,五伯村,821,645,310,77,387,41,428
公投第７案,彰化縣,二水鄉,文化村,822,986,494,115,609,40,649
公投第７案,彰化縣,二水鄉,光化村,823,943,434,122,556,63,619
公投第７案,彰化縣,二水鄉,聖化村,824,455,204,57,261,2,263
公投第７案,彰化縣,二水鄉,二水村,825,831,401,117,518,38,556
公投第７案,彰化縣,二水鄉,惠民村,826,831,380,88,468,33,501
公投第７案,彰化縣,二水鄉,裕民村,827,1013,400,130,530,21,551
公投第７案,彰化縣,二水鄉,大園村,828,796,312,123,435,70,505
公投第７案,彰化縣,二水鄉,修仁村,829,781,319,86,405,50,455
公投第７案,彰化縣,二水鄉,合興村,830,692,258,73,331,18,349
公投第７案,彰化縣,二水鄉,源泉村,831,635,271,69,340,30,370
公投第７案,彰化縣,二水鄉,倡和村,832,566,223,76,299,28,327
公投第７案,彰化縣,北斗鎮,中寮里,833,925,358,84,442,72,514
公投第７案,彰化縣,北斗鎮,中寮里,834,869,385,94,479,52,531
公投第７案,彰化縣,北斗鎮,中寮里,835,855,396,114,510,42,552
公投第７案,彰化縣,北斗鎮,大道里,836,1065,494,133,627,46,673
公投第７案,彰化縣,北斗鎮,大道里,837,828,343,98,441,60,501
公投第７案,彰化縣,北斗鎮,西德里,838,1124,505,117,622,51,673
公投第７案,彰化縣,北斗鎮,西德里,839,1096,496,124,620,46,666
公投第７案,彰化縣,北斗鎮,西德里,840,1213,530,135,665,42,707
公投第７案,彰化縣,北斗鎮,西德里,841,1164,470,106,576,69,645
公投第７案,彰化縣,北斗鎮,西安里,842,730,308,70,378,27,405
公投第７案,彰化縣,北斗鎮,西安里,843,878,383,88,471,27,498
公投第７案,彰化縣,北斗鎮,光復里,844,833,394,83,477,34,511
公投第７案,彰化縣,北斗鎮,光復里,845,957,441,95,536,33,569
公投第７案,彰化縣,北斗鎮,新政里,846,783,332,77,409,30,439
公投第７案,彰化縣,北斗鎮,重慶里,847,573,228,58,286,28,314
公投第７案,彰化縣,北斗鎮,五權里,848,672,271,74,345,38,383
公投第７案,彰化縣,北斗鎮,七星里,849,695,266,73,339,39,378
公投第７案,彰化縣,北斗鎮,七星里,850,747,290,76,366,35,401
公投第７案,彰化縣,北斗鎮,居仁里,851,643,322,65,387,23,410
公投第７案,彰化縣,北斗鎮,居仁里,852,662,296,70,366,40,406
公投第７案,彰化縣,北斗鎮,東光里,853,1085,501,129,630,54,684
公投第７案,彰化縣,北斗鎮,東光里,854,1121,491,120,611,54,665
公投第７案,彰化縣,北斗鎮,文昌里,855,830,388,82,470,38,508
公投第７案,彰化縣,北斗鎮,文昌里,856,975,402,104,506,40,546
公投第７案,彰化縣,北斗鎮,文昌里,857,1212,506,123,629,31,660
公投第７案,彰化縣,北斗鎮,中和里,858,1302,582,128,710,70,780
公投第７案,彰化縣,北斗鎮,新生里,859,1077,410,89,499,32,531
公投第７案,彰化縣,北斗鎮,新生里,860,917,369,76,445,61,506
公投第７案,彰化縣,北斗鎮,大新里,861,825,342,83,425,32,457
公投第７案,彰化縣,北斗鎮,大新里,862,937,416,91,507,48,555
公投第７案,彰化縣,田尾鄉,田尾村,863,1284,474,145,619,39,658
公投第７案,彰化縣,田尾鄉,溪畔村,864,1187,518,147,665,60,725
公投第７案,彰化縣,田尾鄉,打簾村,865,1033,445,124,569,40,609
公投第７案,彰化縣,田尾鄉,打簾村,866,696,322,66,388,38,426
公投第７案,彰化縣,田尾鄉,正義村,867,872,422,82,504,32,536
公投第７案,彰化縣,田尾鄉,北曾村,868,680,298,43,341,21,362
公投第７案,彰化縣,田尾鄉,北曾村,869,875,383,126,509,45,554
公投第７案,彰化縣,田尾鄉,南曾村,870,1337,476,139,615,87,702
公投第７案,彰化縣,田尾鄉,饒平村,871,1376,658,133,791,47,838
公投第７案,彰化縣,田尾鄉,饒平村,872,1186,586,113,699,38,737
公投第７案,彰化縣,田尾鄉,豐田村,873,874,467,94,561,44,605
公投第７案,彰化縣,田尾鄉,仁里村,874,647,255,74,329,27,356
公投第７案,彰化縣,田尾鄉,仁里村,875,959,419,107,526,42,568
公投第７案,彰化縣,田尾鄉,新厝村,876,263,101,31,132,10,142
公投第７案,彰化縣,田尾鄉,溪頂村,877,618,245,63,308,26,334
公投第７案,彰化縣,田尾鄉,柳鳳村,878,938,428,120,548,32,580
公投第７案,彰化縣,田尾鄉,陸豐村,879,880,449,75,524,39,563
公投第７案,彰化縣,田尾鄉,海豐村,880,804,312,84,396,34,430
公投第７案,彰化縣,田尾鄉,海豐村,881,592,238,67,305,21,326
公投第７案,彰化縣,田尾鄉,睦宜村,882,1079,499,109,608,73,681
公投第７案,彰化縣,田尾鄉,新生村,883,1336,588,148,736,44,780
公投第７案,彰化縣,田尾鄉,北鎮村,884,1198,492,112,604,47,651
公投第７案,彰化縣,田尾鄉,南鎮村,885,621,248,71,319,35,354
公投第７案,彰化縣,田尾鄉,福田村,886,760,305,78,383,26,409
公投第７案,彰化縣,田尾鄉,新興村,887,1084,498,136,634,67,701
公投第７案,彰化縣,埤頭鄉,和豊村,888,1178,417,107,524,58,582
公投第７案,彰化縣,埤頭鄉,和豊村,889,1290,225,400,625,43,668
公投第７案,彰化縣,埤頭鄉,興農村,890,973,385,84,469,57,526
公投第７案,彰化縣,埤頭鄉,興農村,891,783,289,93,382,33,415
公投第７案,彰化縣,埤頭鄉,埤頭村,892,733,295,71,366,48,414
公投第７案,彰化縣,埤頭鄉,埤頭村,893,899,365,93,458,67,525
公投第７案,彰化縣,埤頭鄉,豊崙村,894,965,403,95,498,48,546
公投第７案,彰化縣,埤頭鄉,豊崙村,895,1356,554,106,660,50,710
公投第７案,彰化縣,埤頭鄉,崙子村,896,1265,514,108,622,65,687
公投第７案,彰化縣,埤頭鄉,永豊村,897,877,390,88,478,59,537
公投第７案,彰化縣,埤頭鄉,永豊村,898,705,274,59,333,49,382
公投第７案,彰化縣,埤頭鄉,合興村,899,1062,489,108,597,40,637
公投第７案,彰化縣,埤頭鄉,合興村,900,1300,554,130,684,56,740
公投第７案,彰化縣,埤頭鄉,合興村,901,923,396,78,474,61,535
公投第７案,彰化縣,埤頭鄉,平原村,902,1085,408,99,507,33,540
公投第７案,彰化縣,埤頭鄉,平原村,903,1103,498,102,600,53,653
公投第７案,彰化縣,埤頭鄉,崙腳村,904,735,272,70,342,33,375
公投第７案,彰化縣,埤頭鄉,元埔村,905,574,220,58,278,38,316
公投第７案,彰化縣,埤頭鄉,芙朝村,906,767,288,52,340,43,383
公投第７案,彰化縣,埤頭鄉,芙朝村,907,737,271,78,349,58,407
公投第７案,彰化縣,埤頭鄉,新庄村,908,1058,318,118,436,54,490
公投第７案,彰化縣,埤頭鄉,陸嘉村,909,826,279,81,360,66,426
公投第７案,彰化縣,埤頭鄉,竹圍村,910,1082,381,94,475,72,547
公投第７案,彰化縣,埤頭鄉,中和村,911,737,326,72,398,48,446
公投第７案,彰化縣,埤頭鄉,中和村,912,711,284,67,351,22,373
公投第７案,彰化縣,埤頭鄉,庄內村,913,1043,392,136,528,65,593
公投第７案,彰化縣,埤頭鄉,大湖村,914,910,332,81,413,24,437
公投第７案,彰化縣,溪州鄉,溪厝村,915,778,327,68,395,36,431
公投第７案,彰化縣,溪州鄉,溪厝村,916,1061,364,109,473,23,496
公投第７案,彰化縣,溪州鄉,坑厝村,917,701,225,66,291,33,324
公投第７案,彰化縣,溪州鄉,瓦厝村,918,879,376,101,477,53,530
公投第７案,彰化縣,溪州鄉,溪州村,919,654,303,87,390,41,431
公投第７案,彰化縣,溪州鄉,溪州村,920,878,371,83,454,35,489
公投第７案,彰化縣,溪州鄉,尾厝村,921,942,423,114,537,43,580
公投第７案,彰化縣,溪州鄉,尾厝村,922,871,359,78,437,32,469
公投第７案,彰化縣,溪州鄉,東州村,923,1047,396,97,493,25,518
公投第７案,彰化縣,溪州鄉,東州村,924,858,372,81,453,50,503
公投第７案,彰化縣,溪州鄉,舊眉村,925,1409,462,114,576,65,641
公投第７案,彰化縣,溪州鄉,圳寮村,926,792,277,80,357,22,379
公投第７案,彰化縣,溪州鄉,圳寮村,927,714,249,87,336,50,386
公投第７案,彰化縣,溪州鄉,西畔村,928,1109,375,107,482,55,537
公投第７案,彰化縣,溪州鄉,西畔村,929,962,290,91,381,43,424
公投第７案,彰化縣,溪州鄉,柑園村,930,1157,376,95,471,56,527
公投第７案,彰化縣,溪州鄉,成功村,931,952,368,80,448,42,490
公投第７案,彰化縣,溪州鄉,成功村,932,887,340,98,438,39,477
公投第７案,彰化縣,溪州鄉,大庄村,933,866,270,67,337,43,380
公投第７案,彰化縣,溪州鄉,大庄村,934,1010,327,86,413,68,481
公投第７案,彰化縣,溪州鄉,榮光村,935,853,303,93,396,26,422
公投第７案,彰化縣,溪州鄉,潮洋村,936,843,298,75,373,63,436
公投第７案,彰化縣,溪州鄉,張厝村,937,711,186,47,233,11,244
公投第７案,彰化縣,溪州鄉,菜公村,938,851,313,89,402,65,467
公投第７案,彰化縣,溪州鄉,三條村,939,883,301,76,377,29,406
公投第７案,彰化縣,溪州鄉,三圳村,940,1247,420,103,523,50,573
公投第７案,彰化縣,溪州鄉,水尾村,941,1490,598,157,755,79,834
公投第７案,彰化縣,二林鎮,豐田里,942,731,236,54,290,22,312
公投第７案,彰化縣,二林鎮,豐田里,943,1025,437,104,541,46,587
公投第７案,彰化縣,二林鎮,豐田里,944,784,329,102,431,21,452
公投第７案,彰化縣,二林鎮,東和里,945,892,380,99,479,36,515
公投第７案,彰化縣,二林鎮,東和里,946,1256,507,149,656,61,717
公投第７案,彰化縣,二林鎮,南光里,947,1043,430,88,518,52,570
公投第７案,彰化縣,二林鎮,南光里,948,1076,495,114,609,40,649
公投第７案,彰化縣,二林鎮,南光里,949,1082,477,101,578,57,635
公投第７案,彰化縣,二林鎮,西平里,950,1427,564,137,701,57,758
公投第７案,彰化縣,二林鎮,北平里,951,1030,373,86,459,67,526
公投第７案,彰化縣,二林鎮,北平里,952,1033,373,106,479,55,534
公投第７案,彰化縣,二林鎮,北平里,953,977,413,85,498,50,548
公投第７案,彰化縣,二林鎮,中西里,954,683,259,65,324,27,351
公投第７案,彰化縣,二林鎮,中西里,955,975,382,88,470,40,510
公投第７案,彰化縣,二林鎮,廣興里,956,1336,429,97,526,70,596
公投第７案,彰化縣,二林鎮,香田里,957,1019,329,96,425,60,485
公投第７案,彰化縣,二林鎮,外竹里,958,1003,309,86,395,46,441
公投第７案,彰化縣,二林鎮,興華里,959,1151,493,94,587,59,646
公投第７案,彰化縣,二林鎮,東興里,960,1598,655,158,813,96,909
公投第７案,彰化縣,二林鎮,後厝里,961,1488,598,144,742,54,796
公投第７案,彰化縣,二林鎮,後厝里,962,1771,780,73,853,53,906
公投第７案,彰化縣,二林鎮,頂厝里,963,1360,428,115,543,43,586
公投第７案,彰化縣,二林鎮,趙甲里,964,1613,557,134,691,62,753
公投第７案,彰化縣,二林鎮,振興里,965,1228,455,101,556,78,634
公投第７案,彰化縣,二林鎮,萬興里,966,771,356,60,416,22,438
公投第７案,彰化縣,二林鎮,永興里,967,858,359,100,459,39,498
公投第７案,彰化縣,二林鎮,永興里,968,661,245,51,296,1,297
公投第７案,彰化縣,二林鎮,西庄里,969,1268,451,104,555,67,622
公投第７案,彰化縣,二林鎮,梅芳里,970,1081,390,88,478,28,506
公投第７案,彰化縣,二林鎮,華崙里,971,1213,453,97,550,33,583
公投第７案,彰化縣,二林鎮,華崙里,972,1328,548,126,674,68,742
公投第７案,彰化縣,二林鎮,華崙里,973,1118,373,90,463,71,534
公投第７案,彰化縣,二林鎮,萬合里,974,1157,389,100,489,45,534
公投第７案,彰化縣,二林鎮,東勢里,975,972,348,94,442,46,488
公投第７案,彰化縣,二林鎮,大永里,976,902,358,84,442,43,485
公投第７案,彰化縣,二林鎮,原斗里,977,1273,562,133,695,98,793
公投第７案,彰化縣,二林鎮,西斗里,978,1087,414,95,509,39,548
公投第７案,彰化縣,二林鎮,東華里,979,987,397,105,502,76,578
公投第７案,彰化縣,二林鎮,復豐里,980,719,204,65,269,24,293
公投第７案,彰化縣,大城鄉,山腳村,981,1288,301,69,370,29,399
公投第７案,彰化縣,大城鄉,潭墘村,982,1104,277,74,351,74,425
公投第７案,彰化縣,大城鄉,大城村,983,964,380,95,475,62,537
公投第７案,彰化縣,大城鄉,東城村,984,1312,438,110,548,59,607
公投第７案,彰化縣,大城鄉,西城村,985,853,243,61,304,62,366
公投第７案,彰化縣,大城鄉,上山村,986,518,132,28,160,21,181
公投第７案,彰化縣,大城鄉,上山村,987,574,182,42,224,25,249
公投第７案,彰化縣,大城鄉,永和村,988,702,181,56,237,31,268
公投第７案,彰化縣,大城鄉,公館村,989,376,78,23,101,15,116
公投第７案,彰化縣,大城鄉,公館村,990,693,163,32,195,19,214
公投第７案,彰化縣,大城鄉,豐美村,991,877,270,66,336,48,384
公投第７案,彰化縣,大城鄉,三豐村,992,655,126,40,166,18,184
公投第７案,彰化縣,大城鄉,菜寮村,993,1103,327,48,375,30,405
公投第７案,彰化縣,大城鄉,東港村,994,1192,305,74,379,30,409
公投第７案,彰化縣,大城鄉,西港村,995,917,273,60,333,28,361
公投第７案,彰化縣,大城鄉,頂庄村,996,686,168,30,198,27,225
公投第７案,彰化縣,大城鄉,臺西村,997,899,209,45,254,20,274
公投第７案,彰化縣,芳苑鄉,芳苑村,998,940,225,54,279,51,330
公投第７案,彰化縣,芳苑鄉,芳中村,999,403,104,25,129,23,152
公投第７案,彰化縣,芳苑鄉,仁愛村,1000,756,276,61,337,36,373
公投第７案,彰化縣,芳苑鄉,信義村,1001,548,118,34,152,26,178
公投第７案,彰化縣,芳苑鄉,後寮村,1002,997,380,81,461,58,519
公投第７案,彰化縣,芳苑鄉,三合村,1003,1300,408,108,516,70,586
公投第７案,彰化縣,芳苑鄉,三合村,1004,859,323,66,389,53,442
公投第７案,彰化縣,芳苑鄉,永興村,1005,734,268,63,331,16,347
公投第７案,彰化縣,芳苑鄉,永興村,1006,636,245,34,279,25,304
公投第７案,彰化縣,芳苑鄉,新街村,1007,808,251,63,314,65,379
公投第７案,彰化縣,芳苑鄉,路上村,1008,668,216,37,253,42,295
公投第７案,彰化縣,芳苑鄉,路平村,1009,744,275,73,348,29,377
公投第７案,彰化縣,芳苑鄉,三成村,1010,1026,323,76,399,86,485
公投第７案,彰化縣,芳苑鄉,福榮村,1011,586,168,37,205,9,214
公投第７案,彰化縣,芳苑鄉,頂廍村,1012,593,222,51,273,40,313
公投第７案,彰化縣,芳苑鄉,王功村,1013,1071,356,109,465,113,578
公投第７案,彰化縣,芳苑鄉,王功村,1014,1060,363,84,447,114,561
公投第７案,彰化縣,芳苑鄉,博愛村,1015,708,241,50,291,24,315
公投第７案,彰化縣,芳苑鄉,和平村,1016,735,226,67,293,61,354
公投第７案,彰化縣,芳苑鄉,興仁村,1017,571,220,53,273,58,331
公投第７案,彰化縣,芳苑鄉,興仁村,1018,729,239,37,276,32,308
公投第７案,彰化縣,芳苑鄉,民生村,1019,674,224,60,284,64,348
公投第７案,彰化縣,芳苑鄉,新寶村,1020,846,313,85,398,40,438
公投第７案,彰化縣,芳苑鄉,新寶村,1021,806,326,76,402,51,453
公投第７案,彰化縣,芳苑鄉,五俊村,1022,470,124,34,158,8,166
公投第７案,彰化縣,芳苑鄉,草湖村,1023,1124,466,74,540,74,614
公投第７案,彰化縣,芳苑鄉,草湖村,1024,317,110,17,127,25,152
公投第７案,彰化縣,芳苑鄉,建平村,1025,1158,351,87,438,55,493
公投第７案,彰化縣,芳苑鄉,建平村,1026,967,334,75,409,19,428
公投第７案,彰化縣,芳苑鄉,崙腳村,1027,762,293,60,353,41,394
公投第７案,彰化縣,芳苑鄉,文津村,1028,1086,341,82,423,54,477
公投第７案,彰化縣,芳苑鄉,新生村,1029,747,286,60,346,21,367
公投第７案,彰化縣,芳苑鄉,新生村,1030,653,197,40,237,28,265
公投第７案,彰化縣,芳苑鄉,漢寶村,1031,872,362,89,451,61,512
公投第７案,彰化縣,芳苑鄉,漢寶村,1032,1235,567,127,694,49,743
公投第７案,彰化縣,芳苑鄉,漢寶村,1033,1102,408,171,579,64,643
公投第７案,彰化縣,竹塘鄉,竹元村,1034,1168,482,114,596,72,668
公投第７案,彰化縣,竹塘鄉,竹塘村,1035,965,382,116,498,40,538
公投第７案,彰化縣,竹塘鄉,竹塘村,1036,960,416,125,541,56,597
公投第７案,彰化縣,竹塘鄉,小西村,1037,743,338,90,428,55,483
公投第７案,彰化縣,竹塘鄉,民靖村,1038,751,243,56,299,38,337
公投第７案,彰化縣,竹塘鄉,五庄村,1039,792,271,66,337,43,380
公投第７案,彰化縣,竹塘鄉,五庄村,1040,733,234,62,296,13,309
公投第７案,彰化縣,竹塘鄉,樹腳村,1041,657,242,55,297,50,347
公投第７案,彰化縣,竹塘鄉,田頭村,1042,1063,416,81,497,31,528
公投第７案,彰化縣,竹塘鄉,新廣村,1043,1114,454,104,558,76,634
公投第７案,彰化縣,竹塘鄉,溪墘村,1044,506,218,78,296,46,342
公投第７案,彰化縣,竹塘鄉,竹林村,1045,823,294,80,374,45,419
公投第７案,彰化縣,竹塘鄉,土庫村,1046,654,225,73,298,31,329
公投第７案,彰化縣,竹塘鄉,內新村,1047,577,178,40,218,26,244
公投第７案,彰化縣,竹塘鄉,長安村,1048,772,278,78,356,51,407
公投第７案,彰化縣,竹塘鄉,永安村,1049,543,166,46,212,37,249
公投第７案,南投縣,南投市,龍泉里,1,927,425,99,524,24,548
公投第７案,南投縣,南投市,康壽里,2,667,340,87,427,27,454
公投第７案,南投縣,南投市,康壽里,3,773,377,75,452,25,477
公投第７案,南投縣,南投市,三民里,4,818,383,95,478,35,513
公投第７案,南投縣,南投市,仁和里,5,525,272,63,335,21,356
公投第７案,南投縣,南投市,南投里,6,575,275,77,352,29,381
公投第７案,南投縣,南投市,彰仁里,7,368,191,52,243,10,253
公投第７案,南投縣,南投市,崇文里,8,956,466,112,578,54,632
公投第７案,南投縣,南投市,三興里,9,1245,522,112,634,22,656
公投第７案,南投縣,南投市,三興里,10,1484,996,122,1118,22,1140
公投第７案,南投縣,南投市,三興里,11,1191,622,121,743,36,779
公投第７案,南投縣,南投市,三興里,12,1506,715,150,865,51,916
公投第７案,南投縣,南投市,三和里,13,1070,502,140,642,33,675
公投第７案,南投縣,南投市,三和里,14,670,327,65,392,26,418
公投第７案,南投縣,南投市,三和里,15,1050,534,121,655,38,693
公投第７案,南投縣,南投市,嘉興里,16,1122,468,99,567,47,614
公投第７案,南投縣,南投市,嘉興里,17,984,419,108,527,31,558
公投第７案,南投縣,南投市,嘉和里,18,1062,552,102,654,22,676
公投第７案,南投縣,南投市,嘉和里,19,1053,486,107,593,45,638
公投第７案,南投縣,南投市,嘉和里,20,1104,325,347,672,30,702
公投第７案,南投縣,南投市,嘉和里,21,1192,542,112,654,37,691
公投第７案,南投縣,南投市,平和里,22,960,419,92,511,36,547
公投第７案,南投縣,南投市,平和里,23,906,435,82,517,41,558
公投第７案,南投縣,南投市,平和里,24,957,445,104,549,42,591
公投第７案,南投縣,南投市,平和里,25,997,480,132,612,40,652
公投第７案,南投縣,南投市,平和里,26,1008,483,108,591,36,627
公投第７案,南投縣,南投市,平和里,27,1164,534,119,653,33,686
公投第７案,南投縣,南投市,振興里,28,587,293,43,336,18,354
公投第７案,南投縣,南投市,振興里,29,734,284,89,373,29,402
公投第７案,南投縣,南投市,振興里,30,724,319,70,389,33,422
公投第７案,南投縣,南投市,千秋里,31,1003,482,85,567,29,596
公投第７案,南投縣,南投市,軍功里,32,1356,626,123,749,42,791
公投第７案,南投縣,南投市,軍功里,33,1373,588,119,707,40,747
公投第７案,南投縣,南投市,軍功里,34,1452,621,151,772,34,806
公投第７案,南投縣,南投市,軍功里,35,362,162,26,188,9,197
公投第７案,南投縣,南投市,東山里,36,389,170,40,210,24,234
公投第７案,南投縣,南投市,營南里,37,1276,643,146,789,42,831
公投第７案,南投縣,南投市,營南里,38,1089,543,125,668,37,705
公投第７案,南投縣,南投市,營北里,39,921,458,95,553,40,593
公投第７案,南投縣,南投市,營北里,40,892,514,95,609,25,634
公投第７案,南投縣,南投市,營北里,41,1050,567,84,651,36,687
公投第７案,南投縣,南投市,營北里,42,1078,573,91,664,19,683
公投第７案,南投縣,南投市,營北里,43,1078,543,89,632,35,667
公投第７案,南投縣,南投市,營北里,44,861,500,99,599,23,622
公投第７案,南投縣,南投市,內興里,45,1221,565,107,672,55,727
公投第７案,南投縣,南投市,內興里,46,1105,515,107,622,24,646
公投第７案,南投縣,南投市,內興里,47,1230,587,137,724,29,753
公投第７案,南投縣,南投市,內興里,48,1092,564,86,650,25,675
公投第７案,南投縣,南投市,內興里,49,1286,686,110,796,25,821
公投第７案,南投縣,南投市,內興里,50,655,358,63,421,29,450
公投第７案,南投縣,南投市,內新里,51,719,366,85,451,24,475
公投第７案,南投縣,南投市,內新里,52,720,340,56,396,21,417
公投第７案,南投縣,南投市,光輝里,53,509,272,54,326,16,342
公投第７案,南投縣,南投市,光榮里,54,492,231,38,269,10,279
公投第７案,南投縣,南投市,光榮里,55,616,315,45,360,17,377
公投第７案,南投縣,南投市,光明里,56,1010,519,87,606,30,636
公投第７案,南投縣,南投市,光華里,57,848,439,55,494,17,511
公投第７案,南投縣,南投市,漳興里,58,1387,675,147,822,65,887
公投第７案,南投縣,南投市,漳興里,59,1245,632,137,769,34,803
公投第７案,南投縣,南投市,漳和里,60,1199,556,107,663,27,690
公投第７案,南投縣,南投市,漳和里,61,1288,598,139,737,40,777
公投第７案,南投縣,南投市,漳和里,62,1040,480,104,584,40,624
公投第７案,南投縣,南投市,漳和里,63,1070,510,107,617,47,664
公投第７案,南投縣,南投市,漳和里,64,1299,673,116,789,33,822
公投第７案,南投縣,南投市,漳和里,65,1122,571,118,689,30,719
公投第７案,南投縣,南投市,平山里,66,1414,664,138,802,40,842
公投第７案,南投縣,南投市,平山里,67,1121,528,97,625,36,661
公投第７案,南投縣,南投市,平山里,68,1434,648,145,793,24,817
公投第７案,南投縣,南投市,平山里,69,1393,611,130,741,32,773
公投第７案,南投縣,南投市,新興里,70,1059,462,115,577,14,591
公投第７案,南投縣,南投市,新興里,71,1218,553,119,672,33,705
公投第７案,南投縣,南投市,新興里,72,1293,543,108,651,17,668
公投第７案,南投縣,南投市,新興里,73,1337,535,115,650,37,687
公投第７案,南投縣,南投市,永豐里,74,876,412,107,519,27,546
公投第７案,南投縣,南投市,永豐里,75,971,438,99,537,26,563
公投第７案,南投縣,南投市,永豐里,76,1012,429,134,563,30,593
公投第７案,南投縣,南投市,福興里,77,973,421,77,498,38,536
公投第７案,南投縣,南投市,福興里,78,1002,475,122,597,32,629
公投第７案,南投縣,南投市,福興里,79,1024,455,115,570,38,608
公投第７案,南投縣,南投市,鳳山里,80,1122,398,108,506,88,594
公投第７案,南投縣,南投市,永興里,81,790,280,85,365,32,397
公投第７案,南投縣,南投市,鳳鳴里,82,647,210,40,250,24,274
公投第７案,南投縣,南投市,福山里,83,950,408,81,489,41,530
公投第７案,南投縣,南投市,福山里,84,980,410,75,485,22,507
公投第７案,南投縣,埔里鎮,東門里,85,828,393,73,466,35,501
公投第７案,南投縣,埔里鎮,東門里,86,786,366,80,446,39,485
公投第７案,南投縣,埔里鎮,東門里,87,1062,470,102,572,37,609
公投第７案,南投縣,埔里鎮,杷城里,88,1201,608,121,729,39,768
公投第７案,南投縣,埔里鎮,杷城里,89,1415,605,134,739,32,771
公投第７案,南投縣,埔里鎮,枇杷里,90,1282,580,106,686,26,712
公投第７案,南投縣,埔里鎮,枇杷里,91,859,394,66,460,38,498
公投第７案,南投縣,埔里鎮,枇杷里,92,1288,563,124,687,62,749
公投第７案,南投縣,埔里鎮,枇杷里,93,1330,625,113,738,27,765
公投第７案,南投縣,埔里鎮,枇杷里,94,1416,609,112,721,45,766
公投第７案,南投縣,埔里鎮,枇杷里,95,1283,491,103,594,39,633
公投第７案,南投縣,埔里鎮,水頭里,96,1151,600,27,627,71,698
公投第７案,南投縣,埔里鎮,水頭里,97,1193,498,105,603,31,634
公投第７案,南投縣,埔里鎮,水頭里,98,1471,665,129,794,56,850
公投第７案,南投縣,埔里鎮,麒麟里,99,1044,413,68,481,52,533
公投第７案,南投縣,埔里鎮,珠格里,100,1122,521,99,620,49,669
公投第７案,南投縣,埔里鎮,溪南里,101,1129,569,109,678,47,725
公投第７案,南投縣,埔里鎮,西門里,102,901,393,78,471,14,485
公投第７案,南投縣,埔里鎮,西門里,103,997,427,77,504,43,547
公投第７案,南投縣,埔里鎮,西門里,104,1209,532,112,644,40,684
公投第７案,南投縣,埔里鎮,南門里,105,838,429,87,516,30,546
公投第７案,南投縣,埔里鎮,北門里,106,1226,481,90,571,42,613
公投第７案,南投縣,埔里鎮,北門里,107,1263,613,130,743,42,785
公投第７案,南投縣,埔里鎮,北安里,108,1045,524,86,610,29,639
公投第７案,南投縣,埔里鎮,北安里,109,1120,566,91,657,37,694
公投第７案,南投縣,埔里鎮,北安里,110,1062,528,124,652,40,692
公投第７案,南投縣,埔里鎮,北梅里,111,1022,474,83,557,28,585
公投第７案,南投縣,埔里鎮,北梅里,112,1051,466,104,570,28,598
公投第７案,南投縣,埔里鎮,北梅里,113,1106,488,96,584,32,616
公投第７案,南投縣,埔里鎮,泰安里,114,1098,493,89,582,18,600
公投第７案,南投縣,埔里鎮,泰安里,115,1067,525,77,602,31,633
公投第７案,南投縣,埔里鎮,大湳里,116,725,305,70,375,55,430
公投第７案,南投縣,埔里鎮,大湳里,117,905,435,76,511,25,536
公投第７案,南投縣,埔里鎮,蜈蚣里,118,1179,498,101,599,41,640
公投第７案,南投縣,埔里鎮,蜈蚣里,119,944,357,102,459,33,492
公投第７案,南投縣,埔里鎮,蜈蚣里,120,465,203,41,244,25,269
公投第７案,南投縣,埔里鎮,同聲里,121,1133,500,97,597,42,639
公投第７案,南投縣,埔里鎮,同聲里,122,1100,456,84,540,38,578
公投第７案,南投縣,埔里鎮,清新里,123,1155,516,112,628,49,677
公投第７案,南投縣,埔里鎮,清新里,124,1254,513,118,631,39,670
公投第７案,南投縣,埔里鎮,清新里,125,1296,541,103,644,54,698
公投第７案,南投縣,埔里鎮,薰化里,126,1023,489,136,625,37,662
公投第７案,南投縣,埔里鎮,大城里,127,964,395,51,446,18,464
公投第７案,南投縣,埔里鎮,大城里,128,986,457,84,541,28,569
公投第７案,南投縣,埔里鎮,大城里,129,1016,491,103,594,22,616
公投第７案,南投縣,埔里鎮,大城里,130,898,388,102,490,42,532
公投第７案,南投縣,埔里鎮,大城里,131,980,464,94,558,36,594
公投第７案,南投縣,埔里鎮,大城里,132,933,344,99,443,22,465
公投第７案,南投縣,埔里鎮,籃城里,133,929,490,126,616,34,650
公投第７案,南投縣,埔里鎮,桃米里,134,1032,454,98,552,38,590
公投第７案,南投縣,埔里鎮,成功里,135,315,118,18,136,12,148
公投第７案,南投縣,埔里鎮,南村里,136,1363,552,120,672,44,716
公投第７案,南投縣,埔里鎮,愛蘭里,137,725,350,59,409,29,438
公投第７案,南投縣,埔里鎮,愛蘭里,138,705,313,94,407,21,428
公投第７案,南投縣,埔里鎮,鐵山里,139,751,390,70,460,29,489
公投第７案,南投縣,埔里鎮,鐵山里,140,932,427,76,503,31,534
公投第７案,南投縣,埔里鎮,房里里,141,956,435,102,537,31,568
公投第７案,南投縣,埔里鎮,房里里,142,376,68,30,98,13,111
公投第７案,南投縣,埔里鎮,向善里,143,682,298,71,369,38,407
公投第７案,南投縣,埔里鎮,一新里,144,990,558,37,595,53,648
公投第７案,南投縣,埔里鎮,合成里,145,1324,500,105,605,69,674
公投第７案,南投縣,埔里鎮,合成里,146,298,107,26,133,13,146
公投第７案,南投縣,埔里鎮,廣成里,147,1170,511,86,597,55,652
公投第７案,南投縣,埔里鎮,史港里,148,604,270,61,331,22,353
公投第７案,南投縣,埔里鎮,福興里,149,999,420,106,526,30,556
公投第７案,南投縣,埔里鎮,牛眠里,150,923,369,59,428,25,453
公投第７案,南投縣,埔里鎮,牛眠里,151,887,424,85,509,27,536
公投第７案,南投縣,埔里鎮,牛眠里,152,981,396,96,492,24,516
公投第７案,南投縣,草屯鎮,玉峰里,153,998,487,98,585,17,602
公投第７案,南投縣,草屯鎮,玉峰里,154,1127,499,102,601,23,624
公投第７案,南投縣,草屯鎮,明正里,155,1401,500,205,705,24,729
公投第７案,南投縣,草屯鎮,明正里,156,1110,434,144,578,35,613
公投第７案,南投縣,草屯鎮,明正里,157,1285,578,142,720,40,760
公投第７案,南投縣,草屯鎮,炎峰里,158,936,418,87,505,28,533
公投第７案,南投縣,草屯鎮,炎峰里,159,1141,487,128,615,46,661
公投第７案,南投縣,草屯鎮,中正里,160,705,340,81,421,23,444
公投第７案,南投縣,草屯鎮,和平里,161,1121,524,123,647,17,664
公投第７案,南投縣,草屯鎮,中山里,162,877,440,116,556,31,587
公投第７案,南投縣,草屯鎮,中山里,163,1401,647,137,784,40,824
公投第７案,南投縣,草屯鎮,敦和里,164,1267,532,123,655,40,695
公投第７案,南投縣,草屯鎮,敦和里,165,1214,577,84,661,60,721
公投第７案,南投縣,草屯鎮,敦和里,166,1259,553,128,681,65,746
公投第７案,南投縣,草屯鎮,敦和里,167,1442,711,133,844,26,870
公投第７案,南投縣,草屯鎮,敦和里,168,1273,613,107,720,42,762
公投第７案,南投縣,草屯鎮,山腳里,169,1145,528,91,619,35,654
公投第７案,南投縣,草屯鎮,山腳里,170,1279,577,110,687,24,711
公投第７案,南投縣,草屯鎮,山腳里,171,1158,515,96,611,28,639
公投第７案,南投縣,草屯鎮,山腳里,172,1335,727,112,839,46,885
公投第７案,南投縣,草屯鎮,山腳里,173,1178,605,126,731,32,763
公投第７案,南投縣,草屯鎮,山腳里,174,1327,673,70,743,39,782
公投第７案,南投縣,草屯鎮,新厝里,175,1000,462,109,571,19,590
公投第７案,南投縣,草屯鎮,新厝里,176,1257,584,100,684,26,710
公投第７案,南投縣,草屯鎮,新厝里,177,883,449,90,539,23,562
公投第７案,南投縣,草屯鎮,上林里,178,1121,504,101,605,26,631
公投第７案,南投縣,草屯鎮,上林里,179,1043,498,93,591,30,621
公投第７案,南投縣,草屯鎮,上林里,180,979,491,94,585,20,605
公投第７案,南投縣,草屯鎮,碧峰里,181,1048,420,79,499,24,523
公投第７案,南投縣,草屯鎮,碧峰里,182,1009,435,92,527,41,568
公投第７案,南投縣,草屯鎮,碧峰里,183,1138,503,85,588,17,605
公投第７案,南投縣,草屯鎮,碧峰里,184,1197,489,152,641,31,672
公投第７案,南投縣,草屯鎮,碧洲里,185,1364,634,133,767,37,804
公投第７案,南投縣,草屯鎮,碧洲里,186,1059,511,92,603,40,643
公投第７案,南投縣,草屯鎮,復興里,187,1108,464,150,614,39,653
公投第７案,南投縣,草屯鎮,復興里,188,879,398,74,472,29,501
公投第７案,南投縣,草屯鎮,復興里,189,957,442,85,527,38,565
公投第７案,南投縣,草屯鎮,御史里,190,1395,520,118,638,21,659
公投第７案,南投縣,草屯鎮,御史里,191,1101,537,110,647,35,682
公投第７案,南投縣,草屯鎮,御史里,192,1297,547,119,666,35,701
公投第７案,南投縣,草屯鎮,御史里,193,877,291,74,365,25,390
公投第７案,南投縣,草屯鎮,御史里,194,1376,519,125,644,41,685
公投第７案,南投縣,草屯鎮,新豐里,195,1008,515,96,611,40,651
公投第７案,南投縣,草屯鎮,新豐里,196,1080,528,98,626,38,664
公投第７案,南投縣,草屯鎮,新豐里,197,1017,418,102,520,43,563
公投第７案,南投縣,草屯鎮,新豐里,198,961,459,111,570,43,613
公投第７案,南投縣,草屯鎮,新庄里,199,1160,549,116,665,44,709
公投第７案,南投縣,草屯鎮,新庄里,200,1121,508,110,618,26,644
公投第７案,南投縣,草屯鎮,新庄里,201,1243,551,121,672,29,701
公投第７案,南投縣,草屯鎮,加老里,202,932,407,122,529,21,550
公投第７案,南投縣,草屯鎮,加老里,203,1323,655,161,816,42,858
公投第７案,南投縣,草屯鎮,石川里,204,1518,590,145,735,33,768
公投第７案,南投縣,草屯鎮,北投里,205,923,403,126,529,40,569
公投第７案,南投縣,草屯鎮,北投里,206,970,396,103,499,31,530
公投第７案,南投縣,草屯鎮,北投里,207,1026,417,121,538,27,565
公投第７案,南投縣,草屯鎮,富寮里,208,1466,611,144,755,70,825
公投第７案,南投縣,草屯鎮,富寮里,209,1180,527,112,639,35,674
公投第７案,南投縣,草屯鎮,富寮里,210,1006,474,122,596,18,614
公投第７案,南投縣,草屯鎮,富寮里,211,1000,397,78,475,31,506
公投第７案,南投縣,草屯鎮,富寮里,212,1128,543,118,661,27,688
公投第７案,南投縣,草屯鎮,富寮里,213,623,255,70,325,11,336
公投第７案,南投縣,草屯鎮,北勢里,214,707,286,87,373,48,421
公投第７案,南投縣,草屯鎮,北勢里,215,719,297,66,363,24,387
公投第７案,南投縣,草屯鎮,北勢里,216,527,205,33,238,20,258
公投第７案,南投縣,草屯鎮,中原里,217,1183,541,115,656,52,708
公投第７案,南投縣,草屯鎮,中原里,218,869,416,81,497,26,523
公投第７案,南投縣,草屯鎮,南埔里,219,1132,447,100,547,10,557
公投第７案,南投縣,草屯鎮,南埔里,220,949,422,100,522,44,566
公投第７案,南投縣,草屯鎮,南埔里,221,965,458,105,563,11,574
公投第７案,南投縣,草屯鎮,南埔里,222,1068,419,111,530,32,562
公投第７案,南投縣,草屯鎮,坪頂里,223,1024,477,115,592,34,626
公投第７案,南投縣,草屯鎮,土城里,224,642,272,53,325,27,352
公投第７案,南投縣,草屯鎮,土城里,225,1017,423,78,501,37,538
公投第７案,南投縣,草屯鎮,平林里,226,1092,494,90,584,38,622
公投第７案,南投縣,草屯鎮,雙冬里,227,1170,499,105,604,50,654
公投第７案,南投縣,草屯鎮,雙冬里,228,1106,504,100,604,58,662
公投第７案,南投縣,竹山鎮,竹山里,229,1170,538,120,658,46,704
公投第７案,南投縣,竹山鎮,竹山里,230,850,392,101,493,39,532
公投第７案,南投縣,竹山鎮,中正里,231,621,253,60,313,29,342
公投第７案,南投縣,竹山鎮,中山里,232,905,390,83,473,25,498
公投第７案,南投縣,竹山鎮,中山里,233,1099,427,82,509,47,556
公投第７案,南投縣,竹山鎮,中山里,234,1214,480,105,585,56,641
公投第７案,南投縣,竹山鎮,中山里,235,1287,602,119,721,56,777
公投第７案,南投縣,竹山鎮,雲林里,236,1191,528,113,641,46,687
公投第７案,南投縣,竹山鎮,雲林里,237,1118,363,108,471,66,537
公投第７案,南投縣,竹山鎮,雲林里,238,1278,571,124,695,26,721
公投第７案,南投縣,竹山鎮,竹圍里,239,1153,498,127,625,50,675
公投第７案,南投縣,竹山鎮,竹圍里,240,1243,81,501,582,67,649
公投第７案,南投縣,竹山鎮,桂林里,241,1308,577,97,674,47,721
公投第７案,南投縣,竹山鎮,桂林里,242,1358,540,138,678,42,720
公投第７案,南投縣,竹山鎮,桂林里,243,1044,440,86,526,46,572
公投第７案,南投縣,竹山鎮,下坪里,244,511,254,41,295,26,321
公投第７案,南投縣,竹山鎮,下坪里,245,682,306,46,352,8,360
公投第７案,南投縣,竹山鎮,中和里,246,989,360,103,463,23,486
公投第７案,南投縣,竹山鎮,中崎里,247,1378,594,120,714,31,745
公投第７案,南投縣,竹山鎮,秀林里,248,217,82,25,107,4,111
公投第７案,南投縣,竹山鎮,秀林里,249,479,217,46,263,25,288
公投第７案,南投縣,竹山鎮,大鞍里,250,430,143,41,184,14,198
公投第７案,南投縣,竹山鎮,延和里,251,1437,147,604,751,56,807
公投第７案,南投縣,竹山鎮,延和里,252,1286,585,144,729,42,771
公投第７案,南投縣,竹山鎮,延和里,253,1080,511,110,621,35,656
公投第７案,南投縣,竹山鎮,延和里,254,1070,458,104,562,33,595
公投第７案,南投縣,竹山鎮,延祥里,255,1295,595,107,702,44,746
公投第７案,南投縣,竹山鎮,延祥里,256,1047,453,108,561,28,589
公投第７案,南投縣,竹山鎮,延祥里,257,1300,562,126,688,33,721
公投第７案,南投縣,竹山鎮,延正里,258,908,327,79,406,22,428
公投第７案,南投縣,竹山鎮,延正里,259,821,295,85,380,41,421
公投第７案,南投縣,竹山鎮,延平里,260,1320,585,141,726,39,765
公投第７案,南投縣,竹山鎮,延平里,261,967,374,85,459,30,489
公投第７案,南投縣,竹山鎮,延平里,262,595,234,38,272,18,290
公投第７案,南投縣,竹山鎮,延山里,263,859,337,80,417,57,474
公投第７案,南投縣,竹山鎮,山崇里,264,1196,470,120,590,58,648
公投第７案,南投縣,竹山鎮,山崇里,265,649,279,60,339,30,369
公投第７案,南投縣,竹山鎮,社寮里,266,1341,558,135,693,50,743
公投第７案,南投縣,竹山鎮,中央里,267,1222,442,103,545,66,611
公投第７案,南投縣,竹山鎮,富州里,268,602,264,57,321,26,347
公投第７案,南投縣,竹山鎮,田子里,269,617,263,54,317,29,346
公投第７案,南投縣,竹山鎮,硘磘里,270,793,350,89,439,51,490
公投第７案,南投縣,竹山鎮,硘磘里,271,922,399,78,477,18,495
公投第７案,南投縣,竹山鎮,德興里,272,366,150,25,175,19,194
公投第７案,南投縣,竹山鎮,德興里,273,509,193,23,216,9,225
公投第７案,南投縣,竹山鎮,福興里,274,193,83,12,95,9,104
公投第７案,南投縣,竹山鎮,福興里,275,406,191,41,232,19,251
公投第７案,南投縣,竹山鎮,鯉魚里,276,495,188,41,229,23,252
公投第７案,南投縣,竹山鎮,鯉魚里,277,307,85,12,97,9,106
公投第７案,南投縣,竹山鎮,坪頂里,278,440,186,29,215,19,234
公投第７案,南投縣,竹山鎮,瑞竹里,279,577,232,42,274,39,313
公投第７案,南投縣,竹山鎮,桶頭里,280,486,124,55,179,34,213
公投第７案,南投縣,竹山鎮,桶頭里,281,403,103,29,132,16,148
公投第７案,南投縣,集集鎮,集集里,282,1070,509,86,595,49,644
公投第７案,南投縣,集集鎮,和平里,283,918,439,99,538,23,561
公投第７案,南投縣,集集鎮,林尾里,284,581,264,58,322,26,348
公投第７案,南投縣,集集鎮,田寮里,285,1194,556,120,676,38,714
公投第７案,南投縣,集集鎮,隘寮里,286,488,157,42,199,21,220
公投第７案,南投縣,集集鎮,玉映里,287,504,233,45,278,35,313
公投第７案,南投縣,集集鎮,吳厝里,288,910,390,97,487,76,563
公投第７案,南投縣,集集鎮,八張里,289,773,360,73,433,52,485
公投第７案,南投縣,集集鎮,八張里,290,709,298,79,377,25,402
公投第７案,南投縣,集集鎮,永昌里,291,960,420,87,507,24,531
公投第７案,南投縣,集集鎮,廣明里,292,503,199,57,256,19,275
公投第７案,南投縣,集集鎮,廣明里,293,419,31,159,190,21,211
公投第７案,南投縣,集集鎮,富山里,294,582,212,43,255,9,264
公投第７案,南投縣,名間鄉,南雅村,295,1050,537,142,679,51,730
公投第７案,南投縣,名間鄉,中正村,296,920,416,95,511,43,554
公投第７案,南投縣,名間鄉,中正村,297,727,361,78,439,35,474
公投第７案,南投縣,名間鄉,中正村,298,861,441,80,521,32,553
公投第７案,南投縣,名間鄉,中正村,299,897,409,81,490,30,520
公投第７案,南投縣,名間鄉,中山村,300,1055,493,116,609,39,648
公投第７案,南投縣,名間鄉,中山村,301,1184,531,111,642,56,698
公投第７案,南投縣,名間鄉,濁水村,302,783,322,89,411,35,446
公投第７案,南投縣,名間鄉,濁水村,303,781,368,81,449,40,489
公投第７案,南投縣,名間鄉,新民村,304,977,417,78,495,36,531
公投第７案,南投縣,名間鄉,炭寮村,305,1015,409,94,503,59,562
公投第７案,南投縣,名間鄉,新街村,306,914,429,95,524,22,546
公投第７案,南投縣,名間鄉,新街村,307,1028,441,105,546,17,563
公投第７案,南投縣,名間鄉,新街村,308,1018,477,105,582,31,613
公投第７案,南投縣,名間鄉,新街村,309,1274,561,133,694,62,756
公投第７案,南投縣,名間鄉,東湖村,310,755,329,87,416,38,454
公投第７案,南投縣,名間鄉,東湖村,311,895,440,106,546,46,592
公投第７案,南投縣,名間鄉,仁和村,312,892,442,56,498,25,523
公投第７案,南投縣,名間鄉,萬丹村,313,951,402,92,494,57,551
公投第７案,南投縣,名間鄉,田仔村,314,1261,535,130,665,59,724
公投第７案,南投縣,名間鄉,大坑村,315,768,313,94,407,36,443
公投第７案,南投縣,名間鄉,大庄村,316,962,416,115,531,53,584
公投第７案,南投縣,名間鄉,大庄村,317,867,383,94,477,56,533
公投第７案,南投縣,名間鄉,廍下村,318,930,408,94,502,62,564
公投第７案,南投縣,名間鄉,赤水村,319,641,256,75,331,57,388
公投第７案,南投縣,名間鄉,赤水村,320,530,204,50,254,27,281
公投第７案,南投縣,名間鄉,竹圍村,321,931,394,98,492,63,555
公投第７案,南投縣,名間鄉,三崙村,322,1127,507,112,619,52,671
公投第７案,南投縣,名間鄉,三崙村,323,443,211,50,261,33,294
公投第７案,南投縣,名間鄉,松山村,324,870,402,91,493,39,532
公投第７案,南投縣,名間鄉,松山村,325,621,274,60,334,56,390
公投第７案,南投縣,名間鄉,松柏村,326,1179,454,114,568,37,605
公投第７案,南投縣,名間鄉,崁腳村,327,881,441,73,514,44,558
公投第７案,南投縣,名間鄉,埔中村,328,876,451,93,544,52,596
公投第７案,南投縣,名間鄉,新厝村,329,783,345,69,414,60,474
公投第７案,南投縣,名間鄉,新光村,330,778,326,54,380,39,419
公投第７案,南投縣,名間鄉,新光村,331,983,401,97,498,43,541
公投第７案,南投縣,鹿谷鄉,鹿谷村,332,934,383,64,447,37,484
公投第７案,南投縣,鹿谷鄉,鹿谷村,333,940,403,93,496,41,537
公投第７案,南投縣,鹿谷鄉,彰雅村,334,852,347,83,430,25,455
公投第７案,南投縣,鹿谷鄉,彰雅村,335,451,167,24,191,16,207
公投第７案,南投縣,鹿谷鄉,廣興村,336,810,386,71,457,32,489
公投第７案,南投縣,鹿谷鄉,廣興村,337,1142,562,107,669,43,712
公投第７案,南投縣,鹿谷鄉,永隆村,338,766,285,57,342,21,363
公投第７案,南投縣,鹿谷鄉,永隆村,339,884,396,80,476,41,517
公投第７案,南投縣,鹿谷鄉,鳳凰村,340,811,333,96,429,30,459
公投第７案,南投縣,鹿谷鄉,鳳凰村,341,581,207,49,256,20,276
公投第７案,南投縣,鹿谷鄉,內湖村,342,578,221,54,275,19,294
公投第７案,南投縣,鹿谷鄉,內湖村,343,467,226,35,261,18,279
公投第７案,南投縣,鹿谷鄉,和雅村,344,622,283,42,325,21,346
公投第７案,南投縣,鹿谷鄉,竹林村,345,740,294,66,360,21,381
公投第７案,南投縣,鹿谷鄉,竹林村,346,767,311,85,396,35,431
公投第７案,南投縣,鹿谷鄉,竹豐村,347,909,401,87,488,42,530
公投第７案,南投縣,鹿谷鄉,初鄉村,348,713,291,54,345,25,370
公投第７案,南投縣,鹿谷鄉,初鄉村,349,717,266,42,308,28,336
公投第７案,南投縣,鹿谷鄉,秀峰村,350,794,295,74,369,31,400
公投第７案,南投縣,鹿谷鄉,清水村,351,726,251,70,321,14,335
公投第７案,南投縣,鹿谷鄉,瑞田村,352,737,235,50,285,27,312
公投第７案,南投縣,中寮鄉,廣興村,353,822,371,88,459,46,505
公投第７案,南投縣,中寮鄉,崁頂村,354,253,123,22,145,10,155
公投第７案,南投縣,中寮鄉,崁頂村,355,221,75,14,89,6,95
公投第７案,南投縣,中寮鄉,八仙村,356,353,130,24,154,2,156
公投第７案,南投縣,中寮鄉,八仙村,357,427,164,43,207,29,236
公投第７案,南投縣,中寮鄉,福盛村,358,406,172,42,214,13,227
公投第７案,南投縣,中寮鄉,福盛村,359,307,115,33,148,12,160
公投第７案,南投縣,中寮鄉,和興村,360,661,308,60,368,32,400
公投第７案,南投縣,中寮鄉,復興村,361,290,143,32,175,18,193
公投第７案,南投縣,中寮鄉,永平村,362,973,437,112,549,23,572
公投第７案,南投縣,中寮鄉,永平村,363,754,352,77,429,26,455
公投第７案,南投縣,中寮鄉,中寮村,364,662,277,64,341,27,368
公投第７案,南投縣,中寮鄉,廣福村,365,490,185,30,215,14,229
公投第７案,南投縣,中寮鄉,永福村,366,335,134,26,160,15,175
公投第７案,南投縣,中寮鄉,永福村,367,990,468,71,539,36,575
公投第７案,南投縣,中寮鄉,義和村,368,461,209,64,273,19,292
公投第７案,南投縣,中寮鄉,義和村,369,614,276,71,347,32,379
公投第７案,南投縣,中寮鄉,清水村,370,895,368,84,452,64,516
公投第７案,南投縣,中寮鄉,內城村,371,465,190,44,234,32,266
公投第７案,南投縣,中寮鄉,龍安村,372,682,284,69,353,49,402
公投第７案,南投縣,中寮鄉,爽文村,373,490,221,40,261,42,303
公投第７案,南投縣,中寮鄉,龍岩村,374,643,282,69,351,45,396
公投第７案,南投縣,中寮鄉,永芳村,375,459,221,45,266,18,284
公投第７案,南投縣,中寮鄉,永和村,376,528,196,48,244,23,267
公投第７案,南投縣,魚池鄉,魚池村,377,922,397,85,482,39,521
公投第７案,南投縣,魚池鄉,魚池村,378,1098,465,131,596,50,646
公投第７案,南投縣,魚池鄉,東池村,379,720,290,70,360,26,386
公投第７案,南投縣,魚池鄉,東池村,380,860,381,92,473,34,507
公投第７案,南投縣,魚池鄉,大林村,381,514,196,44,240,21,261
公投第７案,南投縣,魚池鄉,大林村,382,574,228,48,276,7,283
公投第７案,南投縣,魚池鄉,東光村,383,1249,502,127,629,45,674
公投第７案,南投縣,魚池鄉,共和村,384,293,149,27,176,16,192
公投第７案,南投縣,魚池鄉,共和村,385,513,207,53,260,18,278
公投第７案,南投縣,魚池鄉,共和村,386,186,67,27,94,8,102
公投第７案,南投縣,魚池鄉,新城村,387,841,317,84,401,29,430
公投第７案,南投縣,魚池鄉,新城村,388,270,122,33,155,13,168
公投第７案,南投縣,魚池鄉,新城村,389,275,108,29,137,15,152
公投第７案,南投縣,魚池鄉,大雁村,390,282,95,25,120,10,130
公投第７案,南投縣,魚池鄉,大雁村,391,392,150,29,179,8,187
公投第７案,南投縣,魚池鄉,五城村,392,556,241,38,279,24,303
公投第７案,南投縣,魚池鄉,五城村,393,176,71,13,84,12,96
公投第７案,南投縣,魚池鄉,中明村,394,578,214,41,255,16,271
公投第７案,南投縣,魚池鄉,中明村,395,439,161,46,207,17,224
公投第７案,南投縣,魚池鄉,水社村,396,844,407,67,474,26,500
公投第７案,南投縣,魚池鄉,日月村,397,868,387,43,430,36,466
公投第７案,南投縣,魚池鄉,頭社村,398,405,155,16,171,18,189
公投第７案,南投縣,魚池鄉,頭社村,399,537,215,69,284,21,305
公投第７案,南投縣,魚池鄉,武登村,400,335,142,28,170,14,184
公投第７案,南投縣,魚池鄉,武登村,401,231,79,12,91,13,104
公投第７案,南投縣,國姓鄉,國姓村,402,964,457,95,552,48,600
公投第７案,南投縣,國姓鄉,國姓村,403,736,322,70,392,24,416
公投第７案,南投縣,國姓鄉,石門村,404,801,362,67,429,44,473
公投第７案,南投縣,國姓鄉,石門村,405,964,444,75,519,10,529
公投第７案,南投縣,國姓鄉,大旗村,406,686,302,58,360,26,386
公投第７案,南投縣,國姓鄉,長流村,407,661,280,53,333,29,362
公投第７案,南投縣,國姓鄉,長流村,408,730,290,56,346,35,381
公投第７案,南投縣,國姓鄉,長豐村,409,774,308,79,387,47,434
公投第７案,南投縣,國姓鄉,長福村,410,706,327,82,409,14,423
公投第７案,南投縣,國姓鄉,北港村,411,1012,417,118,535,39,574
公投第７案,南投縣,國姓鄉,北港村,412,868,289,81,370,21,391
公投第７案,南投縣,國姓鄉,福龜村,413,918,478,62,540,21,561
公投第７案,南投縣,國姓鄉,福龜村,414,937,407,76,483,44,527
公投第７案,南投縣,國姓鄉,乾溝村,415,815,327,72,399,52,451
公投第７案,南投縣,國姓鄉,柑林村,416,1134,528,109,637,43,680
公投第７案,南投縣,國姓鄉,大石村,417,714,296,66,362,17,379
公投第７案,南投縣,國姓鄉,北山村,418,1095,464,109,573,40,613
公投第７案,南投縣,國姓鄉,北山村,419,448,181,37,218,19,237
公投第７案,南投縣,國姓鄉,南港村,420,1064,452,82,534,36,570
公投第７案,南投縣,國姓鄉,南港村,421,570,234,43,277,20,297
公投第７案,南投縣,水里鄉,水里村,422,757,330,60,390,30,420
公投第７案,南投縣,水里鄉,新城村,423,554,244,41,285,29,314
公投第７案,南投縣,水里鄉,新城村,424,999,426,113,539,39,578
公投第７案,南投縣,水里鄉,中央村,425,616,250,46,296,16,312
公投第７案,南投縣,水里鄉,城中村,426,875,411,74,485,25,510
公投第７案,南投縣,水里鄉,農富村,427,480,232,41,273,9,282
公投第７案,南投縣,水里鄉,車埕村,428,450,184,39,223,23,246
公投第７案,南投縣,水里鄉,新興村,429,643,265,51,316,38,354
公投第７案,南投縣,水里鄉,北埔村,430,1004,455,104,559,29,588
公投第７案,南投縣,水里鄉,南光村,431,741,322,57,379,18,397
公投第７案,南投縣,水里鄉,南光村,432,802,344,107,451,19,470
公投第７案,南投縣,水里鄉,鉅工村,433,998,480,115,595,45,640
公投第７案,南投縣,水里鄉,永豐村,434,800,306,83,389,50,439
公投第７案,南投縣,水里鄉,永豐村,435,589,267,76,343,21,364
公投第７案,南投縣,水里鄉,民和村,436,887,340,82,422,46,468
公投第７案,南投縣,水里鄉,頂崁村,437,1217,491,95,586,49,635
公投第７案,南投縣,水里鄉,新山村,438,205,61,11,72,0,72
公投第７案,南投縣,水里鄉,郡坑村,439,330,160,28,188,21,209
公投第７案,南投縣,水里鄉,上安村,440,1100,434,98,532,28,560
公投第７案,南投縣,水里鄉,興隆村,441,275,80,8,88,3,91
公投第７案,南投縣,水里鄉,永興村,442,318,107,17,124,5,129
公投第７案,南投縣,水里鄉,玉峰村,443,818,322,76,398,46,444
公投第７案,南投縣,信義鄉,明德村,444,1201,473,113,586,95,681
公投第７案,南投縣,信義鄉,明德村,445,329,131,19,150,16,166
公投第７案,南投縣,信義鄉,愛國村,446,516,181,65,246,18,264
公投第７案,南投縣,信義鄉,自強村,447,424,137,34,171,20,191
公投第７案,南投縣,信義鄉,自強村,448,321,129,17,146,6,152
公投第７案,南投縣,信義鄉,豐丘村,449,648,292,56,348,29,377
公投第７案,南投縣,信義鄉,新鄉村,450,584,261,69,330,94,424
公投第７案,南投縣,信義鄉,羅娜村,451,1376,270,51,321,15,336
公投第７案,南投縣,信義鄉,望美村,452,979,319,79,398,21,419
公投第７案,南投縣,信義鄉,望美村,453,530,250,66,316,76,392
公投第７案,南投縣,信義鄉,同富村,454,961,348,84,432,51,483
公投第７案,南投縣,信義鄉,同富村,455,464,199,36,235,20,255
公投第７案,南投縣,信義鄉,神木村,456,517,228,48,276,27,303
公投第７案,南投縣,信義鄉,神木村,457,149,61,17,78,9,87
公投第７案,南投縣,信義鄉,東埔村,458,1020,468,135,603,148,751
公投第７案,南投縣,信義鄉,人和村,459,929,377,96,473,162,635
公投第７案,南投縣,信義鄉,人和村,460,274,92,24,116,7,123
公投第７案,南投縣,信義鄉,地利村,461,900,472,91,563,66,629
公投第７案,南投縣,信義鄉,雙龍村,462,617,311,86,397,54,451
公投第７案,南投縣,信義鄉,潭南村,463,560,247,73,320,27,347
公投第７案,南投縣,仁愛鄉,南豐村,464,973,402,87,489,29,518
公投第７案,南投縣,仁愛鄉,南豐村,465,296,116,21,137,13,150
公投第７案,南投縣,仁愛鄉,大同村,466,900,337,48,385,13,398
公投第７案,南投縣,仁愛鄉,大同村,467,460,238,43,281,17,298
公投第７案,南投縣,仁愛鄉,大同村,468,305,151,28,179,4,183
公投第７案,南投縣,仁愛鄉,榮興村,469,58,18,0,18,2,20
公投第７案,南投縣,仁愛鄉,春陽村,470,952,304,53,357,11,368
公投第７案,南投縣,仁愛鄉,精英村,471,679,134,99,233,4,237
公投第７案,南投縣,仁愛鄉,都達村,472,623,265,52,317,52,369
公投第７案,南投縣,仁愛鄉,合作村,473,597,123,37,160,2,162
公投第７案,南投縣,仁愛鄉,發祥村,474,384,191,36,227,20,247
公投第７案,南投縣,仁愛鄉,發祥村,475,121,47,11,58,4,62
公投第７案,南投縣,仁愛鄉,發祥村,476,264,112,15,127,5,132
公投第７案,南投縣,仁愛鄉,力行村,477,509,287,58,345,37,382
公投第７案,南投縣,仁愛鄉,翠華村,478,338,147,36,183,24,207
公投第７案,南投縣,仁愛鄉,翠華村,479,169,82,6,88,4,92
公投第７案,南投縣,仁愛鄉,親愛村,480,613,229,41,270,23,293
公投第７案,南投縣,仁愛鄉,親愛村,481,404,134,40,174,16,190
公投第７案,南投縣,仁愛鄉,親愛村,482,134,60,12,72,5,77
公投第７案,南投縣,仁愛鄉,萬豐村,483,630,244,85,329,61,390
公投第７案,南投縣,仁愛鄉,法治村,484,763,230,57,287,6,293
公投第７案,南投縣,仁愛鄉,中正村,485,889,462,66,528,36,564
公投第７案,南投縣,仁愛鄉,互助村,486,672,315,76,391,47,438
公投第７案,南投縣,仁愛鄉,互助村,487,447,204,49,253,19,272
公投第７案,南投縣,仁愛鄉,新生村,488,409,255,34,289,13,302
公投第７案,雲林縣,麥寮鄉,麥豐村,1,1497,438,131,569,68,637
公投第７案,雲林縣,麥寮鄉,麥豐村,2,1738,619,197,816,56,872
公投第７案,雲林縣,麥寮鄉,麥豐村,3,1921,655,218,873,84,957
公投第７案,雲林縣,麥寮鄉,麥豐村,4,1832,592,173,765,64,829
公投第７案,雲林縣,麥寮鄉,麥津村,5,1340,421,118,539,67,606
公投第７案,雲林縣,麥寮鄉,麥津村,6,1138,364,117,481,70,551
公投第７案,雲林縣,麥寮鄉,麥津村,7,1551,538,157,695,61,756
公投第７案,雲林縣,麥寮鄉,瓦磘村,8,715,191,78,269,42,311
公投第７案,雲林縣,麥寮鄉,瓦磘村,9,1194,324,118,442,48,490
公投第７案,雲林縣,麥寮鄉,興華村,10,1023,326,106,432,57,489
公投第７案,雲林縣,麥寮鄉,興華村,11,1558,429,113,542,45,587
公投第７案,雲林縣,麥寮鄉,海豐村,12,1187,304,137,441,34,475
公投第７案,雲林縣,麥寮鄉,海豐村,13,983,288,100,388,32,420
公投第７案,雲林縣,麥寮鄉,後安村,14,1363,445,147,592,74,666
公投第７案,雲林縣,麥寮鄉,後安村,15,1596,506,162,668,88,756
公投第７案,雲林縣,麥寮鄉,中興村,16,1469,604,149,753,109,862
公投第７案,雲林縣,麥寮鄉,三盛村,17,964,288,83,371,48,419
公投第７案,雲林縣,麥寮鄉,三盛村,18,1038,304,74,378,51,429
公投第７案,雲林縣,麥寮鄉,崙後村,19,1230,454,96,550,70,620
公投第７案,雲林縣,麥寮鄉,崙後村,20,1329,476,137,613,55,668
公投第７案,雲林縣,麥寮鄉,橋頭村,21,1129,385,130,515,87,602
公投第７案,雲林縣,麥寮鄉,橋頭村,22,1241,470,129,599,86,685
公投第７案,雲林縣,麥寮鄉,橋頭村,23,1471,571,142,713,93,806
公投第７案,雲林縣,麥寮鄉,新吉村,24,1107,428,129,557,69,626
公投第７案,雲林縣,麥寮鄉,施厝村,25,1636,607,231,838,79,917
公投第７案,雲林縣,麥寮鄉,施厝村,26,1755,599,166,765,62,827
公投第７案,雲林縣,麥寮鄉,雷厝村,27,1158,434,123,557,43,600
公投第７案,雲林縣,麥寮鄉,雷厝村,28,956,377,98,475,39,514
公投第７案,雲林縣,臺西鄉,臺西村,29,1238,521,91,612,65,677
公投第７案,雲林縣,臺西鄉,海南村,30,1091,378,95,473,49,522
公投第７案,雲林縣,臺西鄉,海北村,31,1098,401,109,510,67,577
公投第７案,雲林縣,臺西鄉,海口村,32,1048,309,86,395,42,437
公投第７案,雲林縣,臺西鄉,海口村,33,1025,347,81,428,64,492
公投第７案,雲林縣,臺西鄉,山寮村,34,850,304,71,375,57,432
公投第７案,雲林縣,臺西鄉,溪頂村,35,1460,413,143,556,85,641
公投第７案,雲林縣,臺西鄉,牛厝村,36,1180,273,91,364,73,437
公投第７案,雲林縣,臺西鄉,牛厝村,37,710,166,34,200,35,235
公投第７案,雲林縣,臺西鄉,泉州村,38,620,160,41,201,11,212
公投第７案,雲林縣,臺西鄉,五榔村,39,449,150,34,184,29,213
公投第７案,雲林縣,臺西鄉,光華村,40,687,184,50,234,43,277
公投第７案,雲林縣,臺西鄉,五港村,41,1247,391,99,490,67,557
公投第７案,雲林縣,臺西鄉,五港村,42,583,160,24,184,22,206
公投第７案,雲林縣,臺西鄉,富琦村,43,1042,370,107,477,49,526
公投第７案,雲林縣,臺西鄉,富琦村,44,472,156,34,190,29,219
公投第７案,雲林縣,臺西鄉,永豐村,45,1409,416,101,517,27,544
公投第７案,雲林縣,臺西鄉,和豐村,46,1061,375,96,471,90,561
公投第７案,雲林縣,臺西鄉,和豐村,47,993,281,78,359,38,397
公投第７案,雲林縣,臺西鄉,和豐村,48,1013,308,105,413,79,492
公投第７案,雲林縣,臺西鄉,蚊港村,49,1233,418,116,534,48,582
公投第７案,雲林縣,臺西鄉,蚊港村,50,616,198,42,240,24,264
公投第７案,雲林縣,東勢鄉,月眉村,51,1207,384,99,483,53,536
公投第７案,雲林縣,東勢鄉,復興村,52,540,247,51,298,28,326
公投第７案,雲林縣,東勢鄉,嘉隆村,53,896,259,82,341,30,371
公投第７案,雲林縣,東勢鄉,嘉隆村,54,728,280,66,346,47,393
公投第７案,雲林縣,東勢鄉,東南村,55,1533,625,168,793,75,868
公投第７案,雲林縣,東勢鄉,東北村,56,1203,488,134,622,92,714
公投第７案,雲林縣,東勢鄉,龍潭村,57,817,251,83,334,57,391
公投第７案,雲林縣,東勢鄉,程海村,58,546,241,50,291,34,325
公投第７案,雲林縣,東勢鄉,昌南村,59,853,285,83,368,70,438
公投第７案,雲林縣,東勢鄉,安南村,60,856,215,79,294,65,359
公投第７案,雲林縣,東勢鄉,同安村,61,923,310,80,390,56,446
公投第７案,雲林縣,東勢鄉,同安村,62,1022,352,86,438,54,492
公投第７案,雲林縣,東勢鄉,四美村,63,634,183,35,218,22,240
公投第７案,雲林縣,東勢鄉,四美村,64,394,118,22,140,21,161
公投第７案,雲林縣,東勢鄉,新坤村,65,1087,304,63,367,38,405
公投第７案,雲林縣,褒忠鄉,中民村,66,923,363,85,448,62,510
公投第７案,雲林縣,褒忠鄉,中民村,67,993,430,107,537,47,584
公投第７案,雲林縣,褒忠鄉,埔姜村,68,748,280,81,361,30,391
公投第７案,雲林縣,褒忠鄉,埔姜村,69,702,257,66,323,20,343
公投第７案,雲林縣,褒忠鄉,中勝村,70,752,269,65,334,22,356
公投第７案,雲林縣,褒忠鄉,中勝村,71,756,302,74,376,28,404
公投第７案,雲林縣,褒忠鄉,馬鳴村,72,490,186,52,238,14,252
公投第７案,雲林縣,褒忠鄉,馬鳴村,73,1034,307,94,401,32,433
公投第７案,雲林縣,褒忠鄉,新湖村,74,470,170,39,209,22,231
公投第７案,雲林縣,褒忠鄉,新湖村,75,737,266,82,348,26,374
公投第７案,雲林縣,褒忠鄉,有才村,76,878,326,82,408,31,439
公投第７案,雲林縣,褒忠鄉,田洋村,77,778,261,77,338,52,390
公投第７案,雲林縣,褒忠鄉,龍岩村,78,1224,400,119,519,63,582
公投第７案,雲林縣,褒忠鄉,潮厝村,79,896,252,104,356,62,418
公投第７案,雲林縣,土庫鎮,忠正里,80,809,354,101,455,57,512
公投第７案,雲林縣,土庫鎮,順天里,81,896,363,114,477,62,539
公投第７案,雲林縣,土庫鎮,宮北里,82,687,280,81,361,37,398
公投第７案,雲林縣,土庫鎮,宮北里,83,702,362,77,439,31,470
公投第７案,雲林縣,土庫鎮,越港里,84,1032,491,110,601,35,636
公投第７案,雲林縣,土庫鎮,溪邊里,85,697,243,71,314,57,371
公投第７案,雲林縣,土庫鎮,溪邊里,86,427,157,34,191,34,225
公投第７案,雲林縣,土庫鎮,石廟里,87,1451,618,169,787,55,842
公投第７案,雲林縣,土庫鎮,石廟里,88,1283,538,154,692,26,718
公投第７案,雲林縣,土庫鎮,興新里,89,634,201,71,272,7,279
公投第７案,雲林縣,土庫鎮,興新里,90,796,304,84,388,33,421
公投第７案,雲林縣,土庫鎮,奮起里,91,745,231,54,285,45,330
公投第７案,雲林縣,土庫鎮,奮起里,92,576,200,70,270,18,288
公投第７案,雲林縣,土庫鎮,埤腳里,93,743,243,58,301,55,356
公投第７案,雲林縣,土庫鎮,埤腳里,94,534,175,49,224,12,236
公投第７案,雲林縣,土庫鎮,後埔里,95,1199,367,100,467,79,546
公投第７案,雲林縣,土庫鎮,後埔里,96,1077,357,113,470,69,539
公投第７案,雲林縣,土庫鎮,崙內里,97,819,249,52,301,32,333
公投第７案,雲林縣,土庫鎮,崙內里,98,684,256,70,326,42,368
公投第７案,雲林縣,土庫鎮,大荖里,99,843,312,91,403,53,456
公投第７案,雲林縣,土庫鎮,東平里,100,916,321,89,410,75,485
公投第７案,雲林縣,土庫鎮,東平里,101,948,303,110,413,50,463
公投第７案,雲林縣,土庫鎮,南平里,102,914,340,91,431,35,466
公投第７案,雲林縣,土庫鎮,南平里,103,860,332,66,398,66,464
公投第７案,雲林縣,土庫鎮,西平里,104,929,312,100,412,59,471
公投第７案,雲林縣,土庫鎮,西平里,105,875,283,83,366,51,417
公投第７案,雲林縣,土庫鎮,北平里,106,896,270,59,329,32,361
公投第７案,雲林縣,土庫鎮,新庄里,107,757,226,63,289,52,341
公投第７案,雲林縣,土庫鎮,新庄里,108,683,214,70,284,43,327
公投第７案,雲林縣,虎尾鎮,東仁里,109,1347,559,142,701,43,744
公投第７案,雲林縣,虎尾鎮,東仁里,110,1258,533,155,688,51,739
公投第７案,雲林縣,虎尾鎮,新興里,111,785,309,89,398,27,425
公投第７案,雲林縣,虎尾鎮,新興里,112,890,306,90,396,42,438
公投第７案,雲林縣,虎尾鎮,公安里,113,1413,606,163,769,47,816
公投第７案,雲林縣,虎尾鎮,公安里,114,1431,651,158,809,51,860
公投第７案,雲林縣,虎尾鎮,德興里,115,1224,483,127,610,50,660
公投第７案,雲林縣,虎尾鎮,德興里,116,1325,478,127,605,37,642
公投第７案,雲林縣,虎尾鎮,中山里,117,941,397,108,505,63,568
公投第７案,雲林縣,虎尾鎮,西安里,118,1613,681,154,835,21,856
公投第７案,雲林縣,虎尾鎮,西安里,119,1641,612,173,785,35,820
公投第７案,雲林縣,虎尾鎮,立仁里,120,1200,570,128,698,45,743
公投第７案,雲林縣,虎尾鎮,立仁里,121,1294,524,154,678,78,756
公投第７案,雲林縣,虎尾鎮,立仁里,122,1273,554,124,678,35,713
公投第７案,雲林縣,虎尾鎮,安慶里,123,1438,659,151,810,46,856
公投第７案,雲林縣,虎尾鎮,平和里,124,1361,628,127,755,32,787
公投第７案,雲林縣,虎尾鎮,平和里,125,1444,648,183,831,37,868
公投第７案,雲林縣,虎尾鎮,平和里,126,1490,708,185,893,36,929
公投第７案,雲林縣,虎尾鎮,興南里,127,1307,623,165,788,47,835
公投第７案,雲林縣,虎尾鎮,興南里,128,967,360,112,472,17,489
公投第７案,雲林縣,虎尾鎮,新吉里,129,1865,745,171,916,47,963
公投第７案,雲林縣,虎尾鎮,新吉里,130,1880,745,228,973,45,1018
公投第７案,雲林縣,虎尾鎮,穎川里,131,1099,414,115,529,38,567
公投第７案,雲林縣,虎尾鎮,穎川里,132,901,369,103,472,15,487
公投第７案,雲林縣,虎尾鎮,延平里,133,1120,425,93,518,47,565
公投第７案,雲林縣,虎尾鎮,建國里,134,545,192,42,234,8,242
公投第７案,雲林縣,虎尾鎮,埒內里,135,1420,545,144,689,59,748
公投第７案,雲林縣,虎尾鎮,埒內里,136,1248,461,108,569,31,600
公投第７案,雲林縣,虎尾鎮,堀頭里,137,799,316,85,401,16,417
公投第７案,雲林縣,虎尾鎮,安溪里,138,836,312,86,398,48,446
公投第７案,雲林縣,虎尾鎮,安溪里,139,924,313,91,404,44,448
公投第７案,雲林縣,虎尾鎮,興中里,140,1648,511,156,667,27,694
公投第７案,雲林縣,虎尾鎮,廉使里,141,1616,508,165,673,99,772
公投第７案,雲林縣,虎尾鎮,廉使里,142,1546,528,170,698,50,748
公投第７案,雲林縣,虎尾鎮,惠來里,143,1283,489,102,591,34,625
公投第７案,雲林縣,虎尾鎮,惠來里,144,1078,375,105,480,34,514
公投第７案,雲林縣,虎尾鎮,頂溪里,145,1313,442,107,549,50,599
公投第７案,雲林縣,虎尾鎮,頂溪里,146,1284,432,128,560,34,594
公投第７案,雲林縣,虎尾鎮,中溪里,147,1356,517,130,647,81,728
公投第７案,雲林縣,虎尾鎮,下溪里,148,1504,585,134,719,79,798
公投第７案,雲林縣,虎尾鎮,東屯里,149,1224,398,105,503,36,539
公投第７案,雲林縣,虎尾鎮,西屯里,150,1509,537,115,652,56,708
公投第７案,雲林縣,虎尾鎮,芳草里,151,855,211,95,306,57,363
公投第７案,雲林縣,虎尾鎮,墾地里,152,1549,492,145,637,81,718
公投第７案,雲林縣,虎尾鎮,北溪里,153,851,294,66,360,31,391
公投第７案,雲林縣,虎尾鎮,三合里,154,1272,476,86,562,74,636
公投第７案,雲林縣,四湖鄉,四湖村,155,1082,323,89,412,66,478
公投第７案,雲林縣,四湖鄉,四湖村,156,676,247,68,315,48,363
公投第７案,雲林縣,四湖鄉,湖西村,157,862,319,67,386,19,405
公投第７案,雲林縣,四湖鄉,湖西村,158,477,113,27,140,20,160
公投第７案,雲林縣,四湖鄉,湖西村,159,952,374,98,472,30,502
公投第７案,雲林縣,四湖鄉,新庄村,160,650,168,53,221,13,234
公投第７案,雲林縣,四湖鄉,溪底村,161,969,300,87,387,16,403
公投第７案,雲林縣,四湖鄉,鹿場村,162,925,248,91,339,33,372
公投第７案,雲林縣,四湖鄉,蔡厝村,163,914,301,60,361,18,379
公投第７案,雲林縣,四湖鄉,湖寮村,164,759,151,41,192,49,241
公投第７案,雲林縣,四湖鄉,施湖村,165,1219,313,86,399,47,446
公投第７案,雲林縣,四湖鄉,羊調村,166,937,224,48,272,47,319
公投第７案,雲林縣,四湖鄉,內湖村,167,773,165,37,202,15,217
公投第７案,雲林縣,四湖鄉,飛東村,168,555,141,41,182,43,225
公投第７案,雲林縣,四湖鄉,飛沙村,169,876,205,64,269,28,297
公投第７案,雲林縣,四湖鄉,三姓村,170,360,102,16,118,21,139
公投第７案,雲林縣,四湖鄉,崙北村,171,885,171,41,212,51,263
公投第７案,雲林縣,四湖鄉,崙北村,172,833,198,50,248,38,286
公投第７案,雲林縣,四湖鄉,崙南村,173,785,161,121,282,39,321
公投第７案,雲林縣,四湖鄉,廣溝村,174,705,227,65,292,44,336
公投第７案,雲林縣,四湖鄉,箔子村,175,927,204,52,256,26,282
公投第７案,雲林縣,四湖鄉,箔東村,176,1058,246,61,307,69,376
公投第７案,雲林縣,四湖鄉,林厝村,177,1071,268,79,347,58,405
公投第７案,雲林縣,四湖鄉,林東村,178,1022,201,52,253,14,267
公投第７案,雲林縣,四湖鄉,溪尾村,179,711,182,58,240,37,277
公投第７案,雲林縣,元長鄉,長南村,180,915,319,84,403,37,440
公投第７案,雲林縣,元長鄉,長南村,181,1284,409,122,531,34,565
公投第７案,雲林縣,元長鄉,長南村,182,1150,366,97,463,45,508
公投第７案,雲林縣,元長鄉,長北村,183,744,211,63,274,47,321
公投第７案,雲林縣,元長鄉,長北村,184,790,268,69,337,54,391
公投第７案,雲林縣,元長鄉,子茂村,185,1356,358,121,479,76,555
公投第７案,雲林縣,元長鄉,後湖村,186,739,214,77,291,65,356
公投第７案,雲林縣,元長鄉,山內村,187,965,228,103,331,33,364
公投第７案,雲林縣,元長鄉,合和村,188,1080,299,95,394,70,464
公投第７案,雲林縣,元長鄉,五塊村,189,948,272,66,338,44,382
公投第７案,雲林縣,元長鄉,潭西村,190,762,154,57,211,32,243
公投第７案,雲林縣,元長鄉,潭東村,191,582,198,46,244,25,269
公投第７案,雲林縣,元長鄉,客厝村,192,865,230,61,291,14,305
公投第７案,雲林縣,元長鄉,卓運村,193,362,61,10,71,6,77
公投第７案,雲林縣,元長鄉,頂寮村,194,1162,301,90,391,34,425
公投第７案,雲林縣,元長鄉,下寮村,195,1527,437,130,567,45,612
公投第７案,雲林縣,元長鄉,龍岩村,196,1006,316,105,421,66,487
公投第７案,雲林縣,元長鄉,西莊村,197,855,261,64,325,24,349
公投第７案,雲林縣,元長鄉,鹿北村,198,1181,382,101,483,74,557
公投第７案,雲林縣,元長鄉,鹿南村,199,864,253,64,317,39,356
公投第７案,雲林縣,元長鄉,瓦磘村,200,667,169,59,228,36,264
公投第７案,雲林縣,元長鄉,瓦磘村,201,878,238,75,313,29,342
公投第７案,雲林縣,元長鄉,內寮村,202,610,137,24,161,11,172
公投第７案,雲林縣,元長鄉,崙仔村,203,837,253,81,334,64,398
公投第７案,雲林縣,元長鄉,新吉村,204,701,249,64,313,39,352
公投第７案,雲林縣,口湖鄉,口湖村,205,1134,388,124,512,63,575
公投第７案,雲林縣,口湖鄉,湖東村,206,1225,458,111,569,97,666
公投第７案,雲林縣,口湖鄉,頂湖村,207,647,182,51,233,38,271
公投第７案,雲林縣,口湖鄉,埔南村,208,709,247,65,312,27,339
公投第７案,雲林縣,口湖鄉,埔北村,209,900,280,76,356,70,426
公投第７案,雲林縣,口湖鄉,謝厝村,210,1011,330,100,430,63,493
公投第７案,雲林縣,口湖鄉,蚵寮村,211,1437,401,95,496,24,520
公投第７案,雲林縣,口湖鄉,下崙村,212,848,187,49,236,9,245
公投第７案,雲林縣,口湖鄉,下崙村,213,1193,322,93,415,33,448
公投第７案,雲林縣,口湖鄉,崙中村,214,759,181,45,226,62,288
公投第７案,雲林縣,口湖鄉,崙中村,215,815,249,68,317,50,367
公投第７案,雲林縣,口湖鄉,崙東村,216,1460,484,131,615,90,705
公投第７案,雲林縣,口湖鄉,青蚶村,217,556,123,31,154,11,165
公投第７案,雲林縣,口湖鄉,港東村,218,1532,524,110,634,63,697
公投第７案,雲林縣,口湖鄉,港西村,219,847,253,88,341,18,359
公投第７案,雲林縣,口湖鄉,台子村,220,374,134,24,158,24,182
公投第７案,雲林縣,口湖鄉,台子村,221,1508,488,166,654,176,830
公投第７案,雲林縣,口湖鄉,成龍村,222,951,373,79,452,70,522
公投第７案,雲林縣,口湖鄉,梧南村,223,910,323,122,445,80,525
公投第７案,雲林縣,口湖鄉,梧南村,224,879,367,88,455,52,507
公投第７案,雲林縣,口湖鄉,梧北村,225,1213,360,97,457,129,586
公投第７案,雲林縣,口湖鄉,水井村,226,952,326,77,403,54,457
公投第７案,雲林縣,口湖鄉,後厝村,227,720,251,76,327,61,388
公投第７案,雲林縣,口湖鄉,湖口村,228,1006,256,78,334,32,366
公投第７案,雲林縣,口湖鄉,過港村,229,607,161,36,197,9,206
公投第７案,雲林縣,水林鄉,水北村,230,1355,427,115,542,60,602
公投第７案,雲林縣,水林鄉,水北村,231,887,304,84,388,16,404
公投第７案,雲林縣,水林鄉,水南村,232,1234,486,113,599,59,658
公投第７案,雲林縣,水林鄉,水南村,233,763,266,58,324,22,346
公投第７案,雲林縣,水林鄉,萬興村,234,721,193,70,263,44,307
公投第７案,雲林縣,水林鄉,尖山村,235,647,175,40,215,10,225
公投第７案,雲林縣,水林鄉,大溝村,236,989,283,91,374,59,433
公投第７案,雲林縣,水林鄉,順興村,237,837,217,61,278,25,303
公投第７案,雲林縣,水林鄉,大山村,238,1081,286,66,352,17,369
公投第７案,雲林縣,水林鄉,後寮村,239,704,212,60,272,44,316
公投第７案,雲林縣,水林鄉,春埔村,240,1006,310,98,408,82,490
公投第７案,雲林縣,水林鄉,西井村,241,651,201,46,247,12,259
公投第７案,雲林縣,水林鄉,車港村,242,607,166,42,208,27,235
公投第７案,雲林縣,水林鄉,蘇秦村,243,1033,278,92,370,59,429
公投第７案,雲林縣,水林鄉,灣東村,244,631,151,35,186,11,197
公投第７案,雲林縣,水林鄉,灣西村,245,961,282,79,361,54,415
公投第７案,雲林縣,水林鄉,蕃薯村,246,951,254,87,341,77,418
公投第７案,雲林縣,水林鄉,山腳村,247,838,261,73,334,25,359
公投第７案,雲林縣,水林鄉,松北村,248,1055,322,83,405,95,500
公投第７案,雲林縣,水林鄉,松中村,249,512,105,30,135,32,167
公投第７案,雲林縣,水林鄉,松西村,250,671,174,36,210,19,229
公投第７案,雲林縣,水林鄉,欍埔村,251,693,132,38,170,43,213
公投第７案,雲林縣,水林鄉,塭底村,252,689,144,48,192,47,239
公投第７案,雲林縣,水林鄉,海埔村,253,1022,331,94,425,68,493
公投第７案,雲林縣,水林鄉,土厝村,254,1191,341,90,431,38,469
公投第７案,雲林縣,水林鄉,溪墘村,255,779,298,65,363,41,404
公投第７案,雲林縣,北港鎮,東陽里,256,724,285,84,369,58,427
公投第７案,雲林縣,北港鎮,光民里,257,688,287,79,366,61,427
公投第７案,雲林縣,北港鎮,東華里,258,452,182,43,225,41,266
公投第７案,雲林縣,北港鎮,南安里,259,866,334,105,439,68,507
公投第７案,雲林縣,北港鎮,中和里,260,336,121,36,157,20,177
公投第７案,雲林縣,北港鎮,義民里,261,395,156,31,187,30,217
公投第７案,雲林縣,北港鎮,共榮里,262,376,172,38,210,27,237
公投第７案,雲林縣,北港鎮,西勢里,263,950,379,116,495,50,545
公投第７案,雲林縣,北港鎮,仁和里,264,512,207,69,276,44,320
公投第７案,雲林縣,北港鎮,賜福里,265,324,135,36,171,27,198
公投第７案,雲林縣,北港鎮,公舘里,266,546,209,58,267,31,298
公投第７案,雲林縣,北港鎮,大同里,267,433,188,48,236,22,258
公投第７案,雲林縣,北港鎮,大同里,268,751,277,93,370,61,431
公投第７案,雲林縣,北港鎮,仁安里,269,442,196,51,247,26,273
公投第７案,雲林縣,北港鎮,華勝里,270,1151,485,118,603,63,666
公投第７案,雲林縣,北港鎮,華勝里,271,1224,507,143,650,61,711
公投第７案,雲林縣,北港鎮,華勝里,272,1211,477,118,595,50,645
公投第７案,雲林縣,北港鎮,華勝里,273,1326,535,135,670,84,754
公投第７案,雲林縣,北港鎮,光復里,274,744,332,99,431,47,478
公投第７案,雲林縣,北港鎮,光復里,275,977,457,108,565,62,627
公投第７案,雲林縣,北港鎮,扶朝里,276,960,347,113,460,66,526
公投第７案,雲林縣,北港鎮,水埔里,277,494,136,30,166,6,172
公投第７案,雲林縣,北港鎮,新街里,278,1364,591,143,734,52,786
公投第７案,雲林縣,北港鎮,新街里,279,1123,468,112,580,59,639
公投第７案,雲林縣,北港鎮,新街里,280,1451,589,164,753,65,818
公投第７案,雲林縣,北港鎮,新街里,281,1162,496,131,627,65,692
公投第７案,雲林縣,北港鎮,新街里,282,1130,401,142,543,42,585
公投第７案,雲林縣,北港鎮,劉厝里,283,1149,407,116,523,45,568
公投第７案,雲林縣,北港鎮,後溝里,284,533,160,44,204,36,240
公投第７案,雲林縣,北港鎮,後溝里,285,433,190,55,245,21,266
公投第７案,雲林縣,北港鎮,新厝里,286,377,145,24,169,9,178
公投第７案,雲林縣,北港鎮,府番里,287,809,254,71,325,23,348
公投第７案,雲林縣,北港鎮,草湖里,288,1397,449,119,568,75,643
公投第７案,雲林縣,北港鎮,溝皂里,289,1145,346,93,439,89,528
公投第７案,雲林縣,北港鎮,番溝里,290,828,193,58,251,62,313
公投第７案,雲林縣,北港鎮,大北里,291,557,155,43,198,22,220
公投第７案,雲林縣,北港鎮,好收里,292,1060,338,113,451,48,499
公投第７案,雲林縣,北港鎮,好收里,293,577,185,64,249,30,279
公投第７案,雲林縣,北港鎮,樹腳里,294,931,262,82,344,66,410
公投第７案,雲林縣,北港鎮,樹腳里,295,1018,401,104,505,44,549
公投第７案,雲林縣,北港鎮,樹腳里,296,1032,403,119,522,26,548
公投第７案,雲林縣,崙背鄉,東明村,297,1176,456,129,585,69,654
公投第７案,雲林縣,崙背鄉,西榮村,298,1439,500,150,650,43,693
公投第７案,雲林縣,崙背鄉,南陽村,299,1027,442,96,538,60,598
公投第７案,雲林縣,崙背鄉,南陽村,300,1259,519,125,644,46,690
公投第７案,雲林縣,崙背鄉,崙前村,301,1058,375,114,489,31,520
公投第７案,雲林縣,崙背鄉,崙前村,302,998,320,98,418,29,447
公投第７案,雲林縣,崙背鄉,羅厝村,303,968,321,92,413,36,449
公投第７案,雲林縣,崙背鄉,羅厝村,304,1055,384,120,504,47,551
公投第７案,雲林縣,崙背鄉,港尾村,305,1315,401,150,551,69,620
公投第７案,雲林縣,崙背鄉,阿勸村,306,1027,220,75,295,27,322
公投第７案,雲林縣,崙背鄉,阿勸村,307,997,393,112,505,82,587
公投第７案,雲林縣,崙背鄉,五魁村,308,807,261,128,389,35,424
公投第７案,雲林縣,崙背鄉,大有村,309,698,189,77,266,18,284
公投第７案,雲林縣,崙背鄉,大有村,310,804,220,97,317,49,366
公投第７案,雲林縣,崙背鄉,豐榮村,311,867,274,93,367,40,407
公投第７案,雲林縣,崙背鄉,豐榮村,312,886,261,52,313,26,339
公投第７案,雲林縣,崙背鄉,草湖村,313,1476,399,121,520,91,611
公投第７案,雲林縣,崙背鄉,舊庄村,314,1159,263,68,331,43,374
公投第７案,雲林縣,崙背鄉,水尾村,315,1220,432,130,562,98,660
公投第７案,雲林縣,崙背鄉,枋南村,316,814,295,79,374,31,405
公投第７案,雲林縣,二崙鄉,崙東村,317,1463,468,139,607,37,644
公投第７案,雲林縣,二崙鄉,崙西村,318,1738,549,175,724,52,776
公投第７案,雲林縣,二崙鄉,來惠村,319,625,187,57,244,51,295
公投第７案,雲林縣,二崙鄉,來惠村,320,1018,350,83,433,67,500
公投第７案,雲林縣,二崙鄉,三和村,321,448,122,30,152,4,156
公投第７案,雲林縣,二崙鄉,三和村,322,1048,278,81,359,38,397
公投第７案,雲林縣,二崙鄉,湳仔村,323,1161,426,132,558,74,632
公投第７案,雲林縣,二崙鄉,田尾村,324,991,349,114,463,43,506
公投第７案,雲林縣,二崙鄉,田尾村,325,849,331,102,433,65,498
公投第７案,雲林縣,二崙鄉,定安村,326,890,306,92,398,52,450
公投第７案,雲林縣,二崙鄉,永定村,327,1427,482,129,611,98,709
公投第７案,雲林縣,二崙鄉,大華村,328,891,291,92,383,32,415
公投第７案,雲林縣,二崙鄉,義庄村,329,757,220,67,287,28,315
公投第７案,雲林縣,二崙鄉,楊賢村,330,1497,472,151,623,103,726
公投第７案,雲林縣,二崙鄉,港後村,331,1171,349,137,486,69,555
公投第７案,雲林縣,二崙鄉,港後村,332,686,265,85,350,53,403
公投第７案,雲林縣,二崙鄉,大義村,333,864,226,68,294,92,386
公投第７案,雲林縣,二崙鄉,油車村,334,1073,423,125,548,67,615
公投第７案,雲林縣,二崙鄉,油車村,335,696,203,49,252,22,274
公投第７案,雲林縣,二崙鄉,大庄村,336,1271,311,80,391,53,444
公投第７案,雲林縣,二崙鄉,庄西村,337,912,261,93,354,53,407
公投第７案,雲林縣,二崙鄉,大同村,338,861,243,98,341,35,376
公投第７案,雲林縣,二崙鄉,復興村,339,1030,291,102,393,59,452
公投第７案,雲林縣,西螺鎮,振興里,340,1590,566,70,636,60,696
公投第７案,雲林縣,西螺鎮,大園里,341,1741,688,211,899,85,984
公投第７案,雲林縣,西螺鎮,廣福里,342,1080,521,123,644,53,697
公投第７案,雲林縣,西螺鎮,廣福里,343,1040,487,111,598,48,646
公投第７案,雲林縣,西螺鎮,正興里,344,1346,578,134,712,28,740
公投第７案,雲林縣,西螺鎮,正興里,345,1625,670,158,828,48,876
公投第７案,雲林縣,西螺鎮,永安里,346,354,165,42,207,11,218
公投第７案,雲林縣,西螺鎮,中和里,347,580,220,60,280,38,318
公投第７案,雲林縣,西螺鎮,福興里,348,591,267,76,343,30,373
公投第７案,雲林縣,西螺鎮,光華里,349,1050,438,129,567,52,619
公投第７案,雲林縣,西螺鎮,中興里,350,1147,496,153,649,57,706
公投第７案,雲林縣,西螺鎮,中興里,351,1602,639,158,797,65,862
公投第７案,雲林縣,西螺鎮,漢光里,352,1452,558,147,705,50,755
公投第７案,雲林縣,西螺鎮,漢光里,353,1578,610,203,813,81,894
公投第７案,雲林縣,西螺鎮,漢光里,354,1305,525,101,626,21,647
公投第７案,雲林縣,西螺鎮,新安里,355,1327,425,136,561,36,597
公投第７案,雲林縣,西螺鎮,新豐里,356,1516,566,162,728,51,779
公投第７案,雲林縣,西螺鎮,大新里,357,828,243,66,309,23,332
公投第７案,雲林縣,西螺鎮,大新里,358,788,211,54,265,18,283
公投第７案,雲林縣,西螺鎮,埤頭里,359,863,289,94,383,67,450
公投第７案,雲林縣,西螺鎮,東興里,360,984,343,107,450,65,515
公投第７案,雲林縣,西螺鎮,鹿場里,361,1514,514,161,675,138,813
公投第７案,雲林縣,西螺鎮,廣興里,362,870,301,113,414,52,466
公投第７案,雲林縣,西螺鎮,頂湳里,363,971,375,90,465,51,516
公投第７案,雲林縣,西螺鎮,吳厝里,364,1304,399,132,531,51,582
公投第７案,雲林縣,西螺鎮,九隆里,365,726,263,50,313,34,347
公投第７案,雲林縣,西螺鎮,下湳里,366,823,329,78,407,42,449
公投第７案,雲林縣,西螺鎮,七座里,367,886,275,55,330,16,346
公投第７案,雲林縣,西螺鎮,公舘里,368,1373,478,131,609,76,685
公投第７案,雲林縣,西螺鎮,詔安里,369,983,377,95,472,59,531
公投第７案,雲林縣,西螺鎮,河南里,370,1014,390,103,493,52,545
公投第７案,雲林縣,西螺鎮,安定里,371,939,316,80,396,82,478
公投第７案,雲林縣,西螺鎮,安定里,372,866,306,80,386,42,428
公投第７案,雲林縣,西螺鎮,福田里,373,1486,490,134,624,98,722
公投第７案,雲林縣,莿桐鄉,莿桐村,374,1507,576,195,771,79,850
公投第７案,雲林縣,莿桐鄉,莿桐村,375,1300,528,126,654,42,696
公投第７案,雲林縣,莿桐鄉,莿桐村,376,1272,515,165,680,83,763
公投第７案,雲林縣,莿桐鄉,甘厝村,377,861,294,102,396,62,458
公投第７案,雲林縣,莿桐鄉,甘西村,378,1565,521,146,667,65,732
公投第７案,雲林縣,莿桐鄉,興桐村,379,577,199,58,257,20,277
公投第７案,雲林縣,莿桐鄉,興桐村,380,636,179,78,257,44,301
公投第７案,雲林縣,莿桐鄉,義和村,381,1110,379,116,495,78,573
公投第７案,雲林縣,莿桐鄉,埔子村,382,973,400,122,522,65,587
公投第７案,雲林縣,莿桐鄉,埔子村,383,985,372,110,482,67,549
公投第７案,雲林縣,莿桐鄉,大美村,384,1707,694,213,907,103,1010
公投第７案,雲林縣,莿桐鄉,大美村,385,1284,496,144,640,89,729
公投第７案,雲林縣,莿桐鄉,埔尾村,386,1293,496,168,664,72,736
公投第７案,雲林縣,莿桐鄉,興貴村,387,900,360,92,452,58,510
公投第７案,雲林縣,莿桐鄉,興貴村,388,1040,407,114,521,98,619
公投第７案,雲林縣,莿桐鄉,饒平村,389,1165,443,110,553,29,582
公投第７案,雲林縣,莿桐鄉,四合村,390,871,333,102,435,57,492
公投第７案,雲林縣,莿桐鄉,四合村,391,885,391,95,486,49,535
公投第７案,雲林縣,莿桐鄉,麻園村,392,1489,510,149,659,71,730
公投第７案,雲林縣,莿桐鄉,五華村,393,1347,467,117,584,92,676
公投第７案,雲林縣,莿桐鄉,六合村,394,1150,465,138,603,64,667
公投第７案,雲林縣,莿桐鄉,六合村,395,653,279,67,346,41,387
公投第７案,雲林縣,林內鄉,林南村,396,1036,466,131,597,58,655
公投第７案,雲林縣,林內鄉,林中村,397,1490,612,137,749,87,836
公投第７案,雲林縣,林內鄉,林中村,398,1491,577,143,720,83,803
公投第７案,雲林縣,林內鄉,林中村,399,671,240,57,297,56,353
公投第７案,雲林縣,林內鄉,林北村,400,1436,606,148,754,109,863
公投第７案,雲林縣,林內鄉,林北村,401,751,313,77,390,52,442
公投第７案,雲林縣,林內鄉,坪頂村,402,535,206,63,269,24,293
公投第７案,雲林縣,林內鄉,林茂村,403,811,280,64,344,43,387
公投第７案,雲林縣,林內鄉,九芎村,404,1339,536,145,681,85,766
公投第７案,雲林縣,林內鄉,九芎村,405,1286,510,114,624,75,699
公投第７案,雲林縣,林內鄉,湖本村,406,646,242,77,319,36,355
公投第７案,雲林縣,林內鄉,烏塗村,407,1158,443,129,572,78,650
公投第７案,雲林縣,林內鄉,烏麻村,408,1090,448,111,559,56,615
公投第７案,雲林縣,林內鄉,重興村,409,950,403,109,512,69,581
公投第７案,雲林縣,林內鄉,重興村,410,861,320,96,416,31,447
公投第７案,雲林縣,斗六市,信義里,411,644,266,63,329,9,338
公投第７案,雲林縣,斗六市,四維里,412,617,247,73,320,21,341
公投第７案,雲林縣,斗六市,太平里,413,764,381,90,471,30,501
公投第７案,雲林縣,斗六市,中和里,414,784,336,122,458,29,487
公投第７案,雲林縣,斗六市,光興里,415,760,302,107,409,28,437
公投第７案,雲林縣,斗六市,鎮西里,416,1881,868,207,1075,59,1134
公投第７案,雲林縣,斗六市,鎮西里,417,1829,754,190,944,48,992
公投第７案,雲林縣,斗六市,鎮東里,418,1255,609,123,732,41,773
公投第７案,雲林縣,斗六市,鎮東里,419,1090,576,98,674,29,703
公投第７案,雲林縣,斗六市,文化里,420,1103,521,116,637,37,674
公投第７案,雲林縣,斗六市,文化里,421,1176,551,114,665,40,705
公投第７案,雲林縣,斗六市,三平里,422,1529,686,138,824,21,845
公投第７案,雲林縣,斗六市,三平里,423,1335,635,112,747,40,787
公投第７案,雲林縣,斗六市,三平里,424,1770,802,181,983,54,1037
公投第７案,雲林縣,斗六市,明德里,425,1308,550,165,715,29,744
公投第７案,雲林縣,斗六市,明德里,426,2171,915,190,1105,70,1175
公投第７案,雲林縣,斗六市,鎮北里,427,1193,524,139,663,43,706
公投第７案,雲林縣,斗六市,鎮北里,428,1572,757,174,931,49,980
公投第７案,雲林縣,斗六市,公誠里,429,1009,419,108,527,27,554
公投第７案,雲林縣,斗六市,公誠里,430,1195,586,118,704,40,744
公投第７案,雲林縣,斗六市,忠孝里,431,1415,635,173,808,54,862
公投第７案,雲林縣,斗六市,仁愛里,432,1101,491,151,642,35,677
公投第７案,雲林縣,斗六市,八德里,433,1648,668,175,843,31,874
公投第７案,雲林縣,斗六市,八德里,434,1588,643,129,772,32,804
公投第７案,雲林縣,斗六市,公正里,435,1392,656,142,798,29,827
公投第７案,雲林縣,斗六市,公正里,436,1422,649,148,797,33,830
公投第７案,雲林縣,斗六市,重光里,437,1187,455,80,535,27,562
公投第７案,雲林縣,斗六市,重光里,438,1142,453,110,563,29,592
公投第７案,雲林縣,斗六市,林頭里,439,1421,686,152,838,51,889
公投第７案,雲林縣,斗六市,林頭里,440,1261,554,141,695,25,720
公投第７案,雲林縣,斗六市,林頭里,441,1506,600,155,755,32,787
公投第７案,雲林縣,斗六市,成功里,442,1214,556,126,682,32,714
公投第７案,雲林縣,斗六市,成功里,443,1362,642,163,805,64,869
公投第７案,雲林縣,斗六市,鎮南里,444,1097,458,123,581,14,595
公投第７案,雲林縣,斗六市,鎮南里,445,1262,567,127,694,28,722
公投第７案,雲林縣,斗六市,鎮南里,446,1154,499,106,605,28,633
公投第７案,雲林縣,斗六市,社口里,447,847,374,82,456,51,507
公投第７案,雲林縣,斗六市,社口里,448,1439,638,153,791,32,823
公投第７案,雲林縣,斗六市,龍潭里,449,1747,817,192,1009,50,1059
公投第７案,雲林縣,斗六市,嘉東里,450,1418,628,136,764,44,808
公投第７案,雲林縣,斗六市,崙峰里,451,1112,400,188,588,44,632
公投第７案,雲林縣,斗六市,崙峰里,452,1302,600,113,713,38,751
公投第７案,雲林縣,斗六市,溝埧里,453,669,313,91,404,23,427
公投第７案,雲林縣,斗六市,江厝里,454,752,326,72,398,32,430
公投第７案,雲林縣,斗六市,江厝里,455,1450,615,119,734,23,757
公投第７案,雲林縣,斗六市,三光里,456,555,220,62,282,37,319
公投第７案,雲林縣,斗六市,久安里,457,1470,599,123,722,44,766
公投第７案,雲林縣,斗六市,久安里,458,927,480,51,531,32,563
公投第７案,雲林縣,斗六市,虎溪里,459,1893,873,180,1053,50,1103
公投第７案,雲林縣,斗六市,虎溪里,460,1708,706,196,902,85,987
公投第７案,雲林縣,斗六市,虎溪里,461,1773,673,159,832,37,869
公投第７案,雲林縣,斗六市,保庄里,462,1412,647,149,796,45,841
公投第７案,雲林縣,斗六市,保庄里,463,1354,608,193,801,28,829
公投第７案,雲林縣,斗六市,保庄里,464,1267,532,135,667,25,692
公投第７案,雲林縣,斗六市,保庄里,465,1273,505,148,653,26,679
公投第７案,雲林縣,斗六市,長平里,466,1748,677,157,834,72,906
公投第７案,雲林縣,斗六市,榴中里,467,1238,503,159,662,66,728
公投第７案,雲林縣,斗六市,榴中里,468,1648,691,147,838,54,892
公投第７案,雲林縣,斗六市,榴中里,469,1520,678,177,855,62,917
公投第７案,雲林縣,斗六市,榴北里,470,1087,428,105,533,30,563
公投第７案,雲林縣,斗六市,榴南里,471,1904,827,188,1015,58,1073
公投第７案,雲林縣,斗六市,梅林里,472,702,321,65,386,38,424
公投第７案,雲林縣,斗六市,梅林里,473,1111,446,141,587,54,641
公投第７案,雲林縣,斗六市,湖山里,474,1123,396,107,503,30,533
公投第７案,雲林縣,斗六市,長安里,475,1146,464,99,563,25,588
公投第７案,雲林縣,斗六市,長安里,476,1786,711,172,883,48,931
公投第７案,雲林縣,斗六市,溪洲里,477,1023,412,126,538,42,580
公投第７案,雲林縣,斗六市,溪洲里,478,2072,830,232,1062,86,1148
公投第７案,雲林縣,斗六市,十三里,479,1128,439,115,554,20,574
公投第７案,雲林縣,大埤鄉,北和村,480,750,301,68,369,34,403
公投第７案,雲林縣,大埤鄉,吉田村,481,719,247,78,325,25,350
公投第７案,雲林縣,大埤鄉,豐岡村,482,603,237,55,292,20,312
公投第７案,雲林縣,大埤鄉,聯美村,483,1106,331,132,463,56,519
公投第７案,雲林縣,大埤鄉,南和村,484,1495,547,153,700,71,771
公投第７案,雲林縣,大埤鄉,南和村,485,600,255,70,325,31,356
公投第７案,雲林縣,大埤鄉,大德村,486,1004,422,120,542,47,589
公投第７案,雲林縣,大埤鄉,松竹村,487,948,259,84,343,19,362
公投第７案,雲林縣,大埤鄉,豐田村,488,1539,634,138,772,59,831
公投第７案,雲林縣,大埤鄉,尚義村,489,1430,509,114,623,63,686
公投第７案,雲林縣,大埤鄉,尚義村,490,465,157,46,203,30,233
公投第７案,雲林縣,大埤鄉,嘉興村,491,1307,487,107,594,50,644
公投第７案,雲林縣,大埤鄉,嘉興村,492,474,163,54,217,23,240
公投第７案,雲林縣,大埤鄉,三結村,493,1220,492,156,648,81,729
公投第７案,雲林縣,大埤鄉,怡然村,494,733,257,67,324,19,343
公投第７案,雲林縣,大埤鄉,北鎮村,495,681,268,63,331,34,365
公投第７案,雲林縣,大埤鄉,興安村,496,712,211,56,267,29,296
公投第７案,雲林縣,大埤鄉,西鎮村,497,723,211,90,301,47,348
公投第７案,雲林縣,斗南鎮,東仁里,498,1166,541,106,647,40,687
公投第７案,雲林縣,斗南鎮,西岐里,499,1135,518,140,658,30,688
公投第７案,雲林縣,斗南鎮,西岐里,500,975,460,112,572,29,601
公投第７案,雲林縣,斗南鎮,大同里,501,1459,661,151,812,42,854
公投第７案,雲林縣,斗南鎮,大同里,502,1351,590,160,750,42,792
公投第７案,雲林縣,斗南鎮,南昌里,503,1321,565,123,688,49,737
公投第７案,雲林縣,斗南鎮,南昌里,504,907,366,80,446,50,496
公投第７案,雲林縣,斗南鎮,北銘里,505,1473,674,156,830,88,918
公投第７案,雲林縣,斗南鎮,中天里,506,1277,564,181,745,57,802
公投第７案,雲林縣,斗南鎮,林子里,507,1333,506,152,658,91,749
公投第７案,雲林縣,斗南鎮,石龜里,508,777,305,68,373,36,409
公投第７案,雲林縣,斗南鎮,石溪里,509,877,331,112,443,35,478
公投第７案,雲林縣,斗南鎮,靖興里,510,899,367,81,448,42,490
公投第７案,雲林縣,斗南鎮,新南里,511,688,224,54,278,37,315
公投第７案,雲林縣,斗南鎮,阿丹里,512,1147,417,84,501,33,534
公投第７案,雲林縣,斗南鎮,將軍里,513,1709,646,211,857,85,942
公投第７案,雲林縣,斗南鎮,舊社里,514,1042,453,138,591,38,629
公投第７案,雲林縣,斗南鎮,舊社里,515,1631,635,177,812,59,871
公投第７案,雲林縣,斗南鎮,明昌里,516,1702,773,176,949,80,1029
公投第７案,雲林縣,斗南鎮,明昌里,517,1564,641,208,849,63,912
公投第７案,雲林縣,斗南鎮,僑真里,518,910,328,75,403,23,426
公投第７案,雲林縣,斗南鎮,僑真里,519,1276,677,143,820,49,869
公投第７案,雲林縣,斗南鎮,大東里,520,897,302,61,363,22,385
公投第７案,雲林縣,斗南鎮,埤麻里,521,803,309,85,394,29,423
公投第７案,雲林縣,斗南鎮,西伯里,522,866,364,90,454,50,504
公投第７案,雲林縣,斗南鎮,新崙里,523,852,355,95,450,52,502
公投第７案,雲林縣,斗南鎮,新崙里,524,671,273,63,336,43,379
公投第７案,雲林縣,斗南鎮,東明里,525,981,382,99,481,22,503
公投第７案,雲林縣,斗南鎮,新光里,526,1129,385,107,492,27,519
公投第７案,雲林縣,斗南鎮,新光里,527,1586,672,172,844,93,937
公投第７案,雲林縣,斗南鎮,田頭里,528,1243,591,154,745,8,753
公投第７案,雲林縣,斗南鎮,田頭里,529,984,349,94,443,18,461
公投第７案,雲林縣,斗南鎮,小東里,530,1507,580,164,744,67,811
公投第７案,雲林縣,古坑鄉,棋盤村,531,1126,435,118,553,61,614
公投第７案,雲林縣,古坑鄉,棋盤村,532,994,393,82,475,46,521
公投第７案,雲林縣,古坑鄉,新庄村,533,1517,538,170,708,48,756
公投第７案,雲林縣,古坑鄉,東和村,534,1302,525,127,652,42,694
公投第７案,雲林縣,古坑鄉,東和村,535,1772,642,172,814,53,867
公投第７案,雲林縣,古坑鄉,荷苞村,536,1122,440,128,568,77,645
公投第７案,雲林縣,古坑鄉,荷苞村,537,304,70,19,89,4,93
公投第７案,雲林縣,古坑鄉,高林村,538,1169,492,109,601,77,678
公投第７案,雲林縣,古坑鄉,水碓村,539,1255,453,125,578,68,646
公投第７案,雲林縣,古坑鄉,田心村,540,1078,468,144,612,40,652
公投第７案,雲林縣,古坑鄉,古坑村,541,943,345,70,415,24,439
公投第７案,雲林縣,古坑鄉,古坑村,542,1300,480,124,604,66,670
公投第７案,雲林縣,古坑鄉,朝陽村,543,964,348,84,432,46,478
公投第７案,雲林縣,古坑鄉,朝陽村,544,1144,461,109,570,46,616
公投第７案,雲林縣,古坑鄉,西平村,545,1482,601,121,722,64,786
公投第７案,雲林縣,古坑鄉,湳仔村,546,688,294,54,348,37,385
公投第７案,雲林縣,古坑鄉,永光村,547,998,356,90,446,45,491
公投第７案,雲林縣,古坑鄉,永光村,548,1140,481,127,608,43,651
公投第７案,雲林縣,古坑鄉,永昌村,549,1102,427,114,541,48,589
公投第７案,雲林縣,古坑鄉,永昌村,550,956,375,102,477,20,497
公投第７案,雲林縣,古坑鄉,麻園村,551,695,258,81,339,25,364
公投第７案,雲林縣,古坑鄉,崁腳村,552,1233,372,190,562,17,579
公投第７案,雲林縣,古坑鄉,華南村,553,285,77,25,102,4,106
公投第７案,雲林縣,古坑鄉,華山村,554,734,204,52,256,10,266
公投第７案,雲林縣,古坑鄉,桂林村,555,1150,431,118,549,84,633
公投第７案,雲林縣,古坑鄉,樟湖村,556,453,160,51,211,19,230
公投第７案,雲林縣,古坑鄉,草嶺村,557,571,195,51,246,31,277
公投第７案,嘉義縣,太保市,太保里,1,1210,481,114,595,82,677
公投第７案,嘉義縣,太保市,太保里,2,1076,433,109,542,35,577
公投第７案,嘉義縣,太保市,後庄里,3,488,160,45,205,29,234
公投第７案,嘉義縣,太保市,前潭里,4,1475,484,162,646,67,713
公投第７案,嘉義縣,太保市,後潭里,5,790,263,60,323,32,355
公投第７案,嘉義縣,太保市,後潭里,6,883,321,75,396,44,440
公投第７案,嘉義縣,太保市,梅埔里,7,758,280,51,331,51,382
公投第７案,嘉義縣,太保市,梅埔里,8,389,112,32,144,7,151
公投第７案,嘉義縣,太保市,春珠里,9,1101,340,113,453,55,508
公投第７案,嘉義縣,太保市,崙頂里,10,853,322,79,401,10,411
公投第７案,嘉義縣,太保市,安仁里,11,224,56,23,79,13,92
公投第７案,嘉義縣,太保市,安仁里,12,662,215,46,261,57,318
公投第７案,嘉義縣,太保市,安仁里,13,1630,758,164,922,41,963
公投第７案,嘉義縣,太保市,東勢里,14,913,312,81,393,27,420
公投第７案,嘉義縣,太保市,東勢里,15,779,343,75,418,15,433
公投第７案,嘉義縣,太保市,新埤里,16,1278,459,143,602,102,704
公投第７案,嘉義縣,太保市,舊埤里,17,819,279,77,356,29,385
公投第７案,嘉義縣,太保市,舊埤里,18,1573,578,152,730,40,770
公投第７案,嘉義縣,太保市,田尾里,19,481,193,37,230,29,259
公投第７案,嘉義縣,太保市,田尾里,20,245,111,23,134,6,140
公投第７案,嘉義縣,太保市,港尾里,21,317,127,26,153,16,169
公投第７案,嘉義縣,太保市,港尾里,22,258,93,17,110,7,117
公投第７案,嘉義縣,太保市,過溝里,23,611,229,49,278,55,333
公投第７案,嘉義縣,太保市,過溝里,24,1526,571,213,784,44,828
公投第７案,嘉義縣,太保市,過溝里,25,1196,469,156,625,30,655
公投第７案,嘉義縣,太保市,麻寮里,26,1536,582,181,763,84,847
公投第７案,嘉義縣,太保市,麻寮里,27,1481,570,171,741,85,826
公投第７案,嘉義縣,太保市,麻寮里,28,1450,583,146,729,62,791
公投第７案,嘉義縣,太保市,南新里,29,840,283,86,369,21,390
公投第７案,嘉義縣,太保市,南新里,30,989,361,118,479,22,501
公投第７案,嘉義縣,太保市,北新里,31,1529,606,144,750,95,845
公投第７案,嘉義縣,太保市,北新里,32,1511,587,180,767,78,845
公投第７案,嘉義縣,太保市,埤鄉里,33,697,212,69,281,41,322
公投第７案,嘉義縣,鹿草鄉,後寮村,34,522,141,51,192,48,240
公投第７案,嘉義縣,鹿草鄉,鹿東村,35,563,200,55,255,44,299
公投第７案,嘉義縣,鹿草鄉,鹿草村,36,1304,424,133,557,81,638
公投第７案,嘉義縣,鹿草鄉,西井村,37,1312,436,156,592,65,657
公投第７案,嘉義縣,鹿草鄉,豊稠村,38,320,101,26,127,1,128
公投第７案,嘉義縣,鹿草鄉,豊稠村,39,418,88,18,106,4,110
公投第７案,嘉義縣,鹿草鄉,重寮村,40,1025,305,71,376,61,437
公投第７案,嘉義縣,鹿草鄉,施家村,41,451,129,35,164,21,185
公投第７案,嘉義縣,鹿草鄉,下潭村,42,830,278,70,348,95,443
公投第７案,嘉義縣,鹿草鄉,光潭村,43,1050,315,91,406,83,489
公投第７案,嘉義縣,鹿草鄉,碧潭村,44,972,283,60,343,57,400
公投第７案,嘉義縣,鹿草鄉,松竹村,45,962,296,76,372,68,440
公投第７案,嘉義縣,鹿草鄉,竹山村,46,678,256,65,321,55,376
公投第７案,嘉義縣,鹿草鄉,竹山村,47,262,86,21,107,28,135
公投第７案,嘉義縣,鹿草鄉,後堀村,48,906,270,69,339,50,389
公投第７案,嘉義縣,鹿草鄉,後堀村,49,306,78,16,94,11,105
公投第７案,嘉義縣,鹿草鄉,三角村,50,1062,364,102,466,68,534
公投第７案,嘉義縣,鹿草鄉,三角村,51,373,119,54,173,22,195
公投第７案,嘉義縣,鹿草鄉,下麻村,52,324,121,31,152,23,175
公投第７案,嘉義縣,鹿草鄉,下麻村,53,297,107,20,127,19,146
公投第７案,嘉義縣,水上鄉,水上村,54,1024,377,100,477,26,503
公投第７案,嘉義縣,水上鄉,水上村,55,1015,429,129,558,54,612
公投第７案,嘉義縣,水上鄉,水上村,56,1932,682,195,877,63,940
公投第７案,嘉義縣,水上鄉,水頭村,57,1170,490,140,630,49,679
公投第７案,嘉義縣,水上鄉,水頭村,58,1305,552,136,688,77,765
公投第７案,嘉義縣,水上鄉,粗溪村,59,1242,426,131,557,59,616
公投第７案,嘉義縣,水上鄉,粗溪村,60,324,107,35,142,18,160
公投第７案,嘉義縣,水上鄉,下寮村,61,622,233,69,302,22,324
公投第７案,嘉義縣,水上鄉,下寮村,62,1216,448,101,549,89,638
公投第７案,嘉義縣,水上鄉,三和村,63,1020,420,105,525,33,558
公投第７案,嘉義縣,水上鄉,三和村,64,771,352,91,443,37,480
公投第７案,嘉義縣,水上鄉,回歸村,65,441,202,50,252,24,276
公投第７案,嘉義縣,水上鄉,大堀村,66,626,285,73,358,48,406
公投第７案,嘉義縣,水上鄉,大堀村,67,570,238,66,304,33,337
公投第７案,嘉義縣,水上鄉,大堀村,68,368,126,44,170,22,192
公投第７案,嘉義縣,水上鄉,大崙村,69,1037,339,103,442,92,534
公投第７案,嘉義縣,水上鄉,大崙村,70,1065,391,116,507,68,575
公投第７案,嘉義縣,水上鄉,塗溝村,71,802,332,104,436,72,508
公投第７案,嘉義縣,水上鄉,龍德村,72,1948,670,202,872,40,912
公投第７案,嘉義縣,水上鄉,溪洲村,73,1028,359,101,460,61,521
公投第７案,嘉義縣,水上鄉,三鎮村,74,641,279,67,346,25,371
公投第７案,嘉義縣,水上鄉,靖和村,75,408,174,37,211,14,225
公投第７案,嘉義縣,水上鄉,南和村,76,794,309,105,414,43,457
公投第７案,嘉義縣,水上鄉,南和村,77,569,175,56,231,38,269
公投第７案,嘉義縣,水上鄉,柳新村,78,806,315,97,412,39,451
公投第７案,嘉義縣,水上鄉,柳新村,79,960,412,97,509,42,551
公投第７案,嘉義縣,水上鄉,柳林村,80,2035,769,235,1004,108,1112
公投第７案,嘉義縣,水上鄉,柳鄉村,81,1987,694,225,919,91,1010
公投第７案,嘉義縣,水上鄉,內溪村,82,1154,462,118,580,21,601
公投第７案,嘉義縣,水上鄉,寬士村,83,2208,791,240,1031,77,1108
公投第７案,嘉義縣,水上鄉,寬士村,84,2102,668,206,874,62,936
公投第７案,嘉義縣,水上鄉,民生村,85,1309,465,126,591,61,652
公投第７案,嘉義縣,水上鄉,民生村,86,1671,622,205,827,80,907
公投第７案,嘉義縣,水上鄉,義興村,87,822,320,82,402,40,442
公投第７案,嘉義縣,水上鄉,中庄村,88,1772,578,203,781,54,835
公投第７案,嘉義縣,水上鄉,忠和村,89,1919,673,229,902,87,989
公投第７案,嘉義縣,水上鄉,南鄉村,90,912,267,72,339,27,366
公投第７案,嘉義縣,水上鄉,三界村,91,992,365,83,448,23,471
公投第７案,嘉義縣,水上鄉,國姓村,92,1270,354,128,482,81,563
公投第７案,嘉義縣,民雄鄉,東榮村,93,1267,527,146,673,57,730
公投第７案,嘉義縣,民雄鄉,東榮村,94,1030,381,109,490,34,524
公投第７案,嘉義縣,民雄鄉,中樂村,95,1590,664,187,851,88,939
公投第７案,嘉義縣,民雄鄉,西安村,96,1673,628,150,778,37,815
公投第７案,嘉義縣,民雄鄉,西安村,97,1718,683,211,894,80,974
公投第７案,嘉義縣,民雄鄉,寮頂村,98,1040,447,117,564,50,614
公投第７案,嘉義縣,民雄鄉,寮頂村,99,1100,420,107,527,65,592
公投第７案,嘉義縣,民雄鄉,福權村,100,1559,532,188,720,79,799
公投第７案,嘉義縣,民雄鄉,東湖村,101,1862,648,198,846,92,938
公投第７案,嘉義縣,民雄鄉,頂崙村,102,1435,575,167,742,67,809
公投第７案,嘉義縣,民雄鄉,菁埔村,103,1751,564,199,763,144,907
公投第７案,嘉義縣,民雄鄉,中和村,104,933,372,91,463,57,520
公投第７案,嘉義縣,民雄鄉,平和村,105,827,334,124,458,58,516
公投第７案,嘉義縣,民雄鄉,西昌村,106,843,261,79,340,51,391
公投第７案,嘉義縣,民雄鄉,豊收村,107,1774,660,206,866,71,937
公投第７案,嘉義縣,民雄鄉,豊收村,108,385,122,41,163,19,182
公投第７案,嘉義縣,民雄鄉,三興村,109,1306,548,158,706,40,746
公投第７案,嘉義縣,民雄鄉,東興村,110,535,208,70,278,42,320
公投第７案,嘉義縣,民雄鄉,鎮北村,111,1055,416,117,533,80,613
公投第７案,嘉義縣,民雄鄉,北斗村,112,1476,567,161,728,66,794
公投第７案,嘉義縣,民雄鄉,北斗村,113,1583,580,150,730,64,794
公投第７案,嘉義縣,民雄鄉,北斗村,114,758,237,74,311,32,343
公投第７案,嘉義縣,民雄鄉,北斗村,115,1354,489,127,616,58,674
公投第７案,嘉義縣,民雄鄉,双福村,116,1202,479,139,618,66,684
公投第７案,嘉義縣,民雄鄉,双福村,117,1175,457,144,601,45,646
公投第７案,嘉義縣,民雄鄉,福樂村,118,1423,519,149,668,57,725
公投第７案,嘉義縣,民雄鄉,福樂村,119,1612,654,145,799,46,845
公投第７案,嘉義縣,民雄鄉,福樂村,120,1695,673,208,881,40,921
公投第７案,嘉義縣,民雄鄉,福樂村,121,1665,573,142,715,43,758
公投第７案,嘉義縣,民雄鄉,大崎村,122,1019,361,72,433,57,490
公投第７案,嘉義縣,民雄鄉,大崎村,123,1352,507,136,643,63,706
公投第７案,嘉義縣,民雄鄉,秀林村,124,1620,625,194,819,70,889
公投第７案,嘉義縣,民雄鄉,秀林村,125,943,333,107,440,33,473
公投第７案,嘉義縣,民雄鄉,松山村,126,1720,544,194,738,55,793
公投第７案,嘉義縣,民雄鄉,興中村,127,1875,630,224,854,100,954
公投第７案,嘉義縣,民雄鄉,興南村,128,1305,524,148,672,56,728
公投第７案,嘉義縣,民雄鄉,興南村,129,1441,507,163,670,68,738
公投第７案,嘉義縣,民雄鄉,金興村,130,1413,522,159,681,71,752
公投第７案,嘉義縣,民雄鄉,金興村,131,1560,579,166,745,79,824
公投第７案,嘉義縣,民雄鄉,福興村,132,2004,777,222,999,115,1114
公投第７案,嘉義縣,民雄鄉,文隆村,133,1354,586,143,729,67,796
公投第７案,嘉義縣,民雄鄉,文隆村,134,1076,442,116,558,40,598
公投第７案,嘉義縣,民雄鄉,山中村,135,1629,593,188,781,131,912
公投第７案,嘉義縣,民雄鄉,山中村,136,1977,720,193,913,81,994
公投第７案,嘉義縣,民雄鄉,中央村,137,1295,427,171,598,90,688
公投第７案,嘉義縣,新港鄉,宮前村,138,1087,420,104,524,33,557
公投第７案,嘉義縣,新港鄉,宮前村,139,1116,531,131,662,73,735
公投第７案,嘉義縣,新港鄉,宮後村,140,740,284,76,360,48,408
公投第７案,嘉義縣,新港鄉,宮後村,141,827,277,87,364,72,436
公投第７案,嘉義縣,新港鄉,大興村,142,704,290,93,383,48,431
公投第７案,嘉義縣,新港鄉,大興村,143,768,319,105,424,49,473
公投第７案,嘉義縣,新港鄉,福德村,144,761,312,98,410,45,455
公投第７案,嘉義縣,新港鄉,福德村,145,850,288,77,365,67,432
公投第７案,嘉義縣,新港鄉,古民村,146,1327,464,152,616,77,693
公投第７案,嘉義縣,新港鄉,中庄村,147,756,286,65,351,65,416
公投第７案,嘉義縣,新港鄉,中庄村,148,816,312,64,376,85,461
公投第７案,嘉義縣,新港鄉,大潭村,149,667,198,72,270,32,302
公投第７案,嘉義縣,新港鄉,大潭村,150,942,327,106,433,47,480
公投第７案,嘉義縣,新港鄉,西庄村,151,918,289,85,374,64,438
公投第７案,嘉義縣,新港鄉,埤子村,152,554,163,47,210,13,223
公投第７案,嘉義縣,新港鄉,南崙村,153,929,300,92,392,45,437
公投第７案,嘉義縣,新港鄉,北崙村,154,487,137,34,171,34,205
公投第７案,嘉義縣,新港鄉,海瀛村,155,487,179,52,231,39,270
公投第７案,嘉義縣,新港鄉,月眉村,156,836,237,107,344,51,395
公投第７案,嘉義縣,新港鄉,月眉村,157,845,288,112,400,65,465
公投第７案,嘉義縣,新港鄉,月潭村,158,834,322,85,407,45,452
公投第７案,嘉義縣,新港鄉,月潭村,159,753,288,79,367,58,425
公投第７案,嘉義縣,新港鄉,溪北村,160,1328,475,157,632,66,698
公投第７案,嘉義縣,新港鄉,菜公村,161,969,385,108,493,58,551
公投第７案,嘉義縣,新港鄉,中洋村,162,1043,422,120,542,74,616
公投第７案,嘉義縣,新港鄉,三間村,163,1400,606,166,772,67,839
公投第７案,嘉義縣,新港鄉,安和村,164,1017,256,56,312,31,343
公投第７案,嘉義縣,新港鄉,潭大村,165,1132,344,114,458,49,507
公投第７案,嘉義縣,新港鄉,南港村,166,1037,353,117,470,67,537
公投第７案,嘉義縣,新港鄉,板頭村,167,563,214,70,284,49,333
公投第７案,嘉義縣,新港鄉,共和村,168,849,305,83,388,20,408
公投第７案,嘉義縣,大林鎮,東林里,169,483,169,61,230,34,264
公投第７案,嘉義縣,大林鎮,西林里,170,1823,744,199,943,68,1011
公投第７案,嘉義縣,大林鎮,吉林里,171,955,369,116,485,23,508
公投第７案,嘉義縣,大林鎮,平林里,172,1436,517,150,667,46,713
公投第７案,嘉義縣,大林鎮,平林里,173,1390,535,128,663,57,720
公投第７案,嘉義縣,大林鎮,平林里,174,1512,603,163,766,79,845
公投第７案,嘉義縣,大林鎮,平林里,175,1536,623,181,804,55,859
公投第７案,嘉義縣,大林鎮,明華里,176,1165,412,95,507,37,544
公投第７案,嘉義縣,大林鎮,明和里,177,1730,724,202,926,79,1005
公投第７案,嘉義縣,大林鎮,排路里,178,602,173,48,221,15,236
公投第７案,嘉義縣,大林鎮,西結里,179,716,222,74,296,62,358
公投第７案,嘉義縣,大林鎮,湖北里,180,625,153,39,192,10,202
公投第７案,嘉義縣,大林鎮,大糖里,181,193,54,13,67,1,68
公投第７案,嘉義縣,大林鎮,大美里,182,1642,528,156,684,67,751
公投第７案,嘉義縣,大林鎮,過溪里,183,1465,530,157,687,69,756
公投第７案,嘉義縣,大林鎮,中坑里,184,928,302,62,364,46,410
公投第７案,嘉義縣,大林鎮,中坑里,185,361,109,27,136,23,159
公投第７案,嘉義縣,大林鎮,上林里,186,814,258,73,331,22,353
公投第７案,嘉義縣,大林鎮,中林里,187,1579,536,148,684,35,719
公投第７案,嘉義縣,大林鎮,三和里,188,2041,804,152,956,92,1048
公投第７案,嘉義縣,大林鎮,溝背里,189,931,329,92,421,54,475
公投第７案,嘉義縣,大林鎮,義和里,190,675,260,48,308,37,345
公投第７案,嘉義縣,大林鎮,內林里,191,655,237,51,288,28,316
公投第７案,嘉義縣,大林鎮,三角里,192,833,303,62,365,38,403
公投第７案,嘉義縣,大林鎮,三村里,193,832,343,108,451,49,500
公投第７案,嘉義縣,溪口鄉,溪東村,194,1318,513,140,653,95,748
公投第７案,嘉義縣,溪口鄉,溪西村,195,677,270,69,339,52,391
公投第７案,嘉義縣,溪口鄉,溪北村,196,417,142,41,183,16,199
公投第７案,嘉義縣,溪口鄉,溪北村,197,273,104,27,131,16,147
公投第７案,嘉義縣,溪口鄉,柳溝村,198,908,346,124,470,58,528
公投第７案,嘉義縣,溪口鄉,柳溝村,199,386,117,33,150,11,161
公投第７案,嘉義縣,溪口鄉,疊溪村,200,1039,388,123,511,68,579
公投第７案,嘉義縣,溪口鄉,妙崙村,201,708,220,53,273,55,328
公投第７案,嘉義縣,溪口鄉,坪頂村,202,909,281,91,372,19,391
公投第７案,嘉義縣,溪口鄉,柴林村,203,786,301,85,386,43,429
公投第７案,嘉義縣,溪口鄉,林腳村,204,807,251,84,335,47,382
公投第７案,嘉義縣,溪口鄉,美南村,205,1168,336,79,415,17,432
公投第７案,嘉義縣,溪口鄉,美北村,206,1052,364,134,498,87,585
公投第７案,嘉義縣,溪口鄉,本厝村,207,565,174,62,236,49,285
公投第７案,嘉義縣,溪口鄉,本厝村,208,388,151,30,181,24,205
公投第７案,嘉義縣,溪口鄉,游西村,209,701,214,43,257,24,281
公投第７案,嘉義縣,溪口鄉,游東村,210,1003,274,86,360,35,395
公投第７案,嘉義縣,梅山鄉,梅東村,211,1041,379,106,485,31,516
公投第７案,嘉義縣,梅山鄉,梅東村,212,1245,487,161,648,84,732
公投第７案,嘉義縣,梅山鄉,梅南村,213,917,409,102,511,54,565
公投第７案,嘉義縣,梅山鄉,梅北村,214,1189,450,128,578,52,630
公投第７案,嘉義縣,梅山鄉,梅北村,215,1388,571,146,717,69,786
公投第７案,嘉義縣,梅山鄉,梅北村,216,1827,709,172,881,69,950
公投第７案,嘉義縣,梅山鄉,過山村,217,545,238,66,304,39,343
公投第７案,嘉義縣,梅山鄉,圳南村,218,407,121,27,148,35,183
公投第７案,嘉義縣,梅山鄉,圳北村,219,636,227,86,313,26,339
公投第７案,嘉義縣,梅山鄉,双溪村,220,576,218,63,281,48,329
公投第７案,嘉義縣,梅山鄉,大南村,221,1674,647,175,822,89,911
公投第７案,嘉義縣,梅山鄉,安靖村,222,858,279,69,348,11,359
公投第７案,嘉義縣,梅山鄉,永興村,223,526,200,93,293,41,334
公投第７案,嘉義縣,梅山鄉,半天村,224,372,116,33,149,31,180
公投第７案,嘉義縣,梅山鄉,太平村,225,506,194,36,230,24,254
公投第７案,嘉義縣,梅山鄉,太興村,226,433,229,41,270,34,304
公投第７案,嘉義縣,梅山鄉,龍眼村,227,404,121,26,147,14,161
公投第７案,嘉義縣,梅山鄉,碧湖村,228,293,97,27,124,21,145
公投第７案,嘉義縣,梅山鄉,瑞峯村,229,712,329,75,404,43,447
公投第７案,嘉義縣,梅山鄉,瑞里村,230,602,258,82,340,33,373
公投第７案,嘉義縣,梅山鄉,太和村,231,515,182,46,228,22,250
公投第７案,嘉義縣,梅山鄉,太和村,232,417,127,25,152,12,164
公投第７案,嘉義縣,朴子市,安福里,233,1183,477,116,593,49,642
公投第７案,嘉義縣,朴子市,安福里,234,755,270,104,374,45,419
公投第７案,嘉義縣,朴子市,平和里,235,1253,502,125,627,42,669
公投第７案,嘉義縣,朴子市,平和里,236,1078,461,115,576,66,642
公投第７案,嘉義縣,朴子市,內厝里,237,1117,467,142,609,76,685
公投第７案,嘉義縣,朴子市,開元里,238,387,160,50,210,20,230
公投第７案,嘉義縣,朴子市,順天里,239,633,302,14,316,43,359
公投第７案,嘉義縣,朴子市,中正里,240,650,249,76,325,36,361
公投第７案,嘉義縣,朴子市,博厚里,241,825,371,96,467,50,517
公投第７案,嘉義縣,朴子市,文化里,242,810,312,80,392,52,444
公投第７案,嘉義縣,朴子市,文化里,243,940,393,92,485,62,547
公投第７案,嘉義縣,朴子市,永和里,244,905,326,99,425,53,478
公投第７案,嘉義縣,朴子市,永和里,245,1605,537,167,704,58,762
公投第７案,嘉義縣,朴子市,竹圍里,246,1479,632,152,784,61,845
公投第７案,嘉義縣,朴子市,竹圍里,247,1218,486,149,635,64,699
公投第７案,嘉義縣,朴子市,竹圍里,248,1496,610,179,789,67,856
公投第７案,嘉義縣,朴子市,新寮里,249,667,240,78,318,34,352
公投第７案,嘉義縣,朴子市,双溪里,250,627,167,52,219,26,245
公投第７案,嘉義縣,朴子市,溪口里,251,791,267,82,349,46,395
公投第７案,嘉義縣,朴子市,德興里,252,1034,361,110,471,102,573
公投第７案,嘉義縣,朴子市,仁和里,253,1710,606,166,772,29,801
公投第７案,嘉義縣,朴子市,大鄉里,254,1671,581,131,712,46,758
公投第７案,嘉義縣,朴子市,大鄉里,255,1547,463,100,563,51,614
公投第７案,嘉義縣,朴子市,大葛里,256,1602,449,133,582,61,643
公投第７案,嘉義縣,朴子市,大葛里,257,1302,584,120,704,32,736
公投第７案,嘉義縣,朴子市,佳禾里,258,740,262,69,331,45,376
公投第７案,嘉義縣,朴子市,竹村里,259,1054,447,106,553,66,619
公投第７案,嘉義縣,朴子市,崁前里,260,907,261,74,335,15,350
公投第７案,嘉義縣,朴子市,崁後里,261,720,209,59,268,36,304
公投第７案,嘉義縣,朴子市,順安里,262,251,93,30,123,24,147
公投第７案,嘉義縣,朴子市,德家里,263,767,211,49,260,74,334
公投第７案,嘉義縣,朴子市,新庄里,264,702,236,105,341,48,389
公投第７案,嘉義縣,朴子市,梅華里,265,1038,320,108,428,57,485
公投第７案,嘉義縣,朴子市,松華里,266,1228,276,86,362,27,389
公投第７案,嘉義縣,朴子市,南竹里,267,499,165,41,206,51,257
公投第７案,嘉義縣,六腳鄉,蒜頭村,268,1165,348,92,440,38,478
公投第７案,嘉義縣,六腳鄉,蒜東村,269,825,205,38,243,19,262
公投第７案,嘉義縣,六腳鄉,蒜南村,270,850,268,58,326,34,360
公投第７案,嘉義縣,六腳鄉,工廠村,271,222,83,30,113,19,132
公投第７案,嘉義縣,六腳鄉,灣南村,272,1216,401,124,525,60,585
公投第７案,嘉義縣,六腳鄉,灣北村,273,1200,309,75,384,51,435
公投第７案,嘉義縣,六腳鄉,雙涵村,274,877,269,79,348,61,409
公投第７案,嘉義縣,六腳鄉,塗師村,275,644,189,41,230,43,273
公投第７案,嘉義縣,六腳鄉,三義村,276,594,147,41,188,17,205
公投第７案,嘉義縣,六腳鄉,三義村,277,167,32,4,36,2,38
公投第７案,嘉義縣,六腳鄉,正義村,278,204,43,24,67,1,68
公投第７案,嘉義縣,六腳鄉,正義村,279,234,68,14,82,8,90
公投第７案,嘉義縣,六腳鄉,正義村,280,361,93,21,114,7,121
公投第７案,嘉義縣,六腳鄉,正義村,281,592,214,61,275,54,329
公投第７案,嘉義縣,六腳鄉,溪厝村,282,619,200,72,272,38,310
公投第７案,嘉義縣,六腳鄉,港美村,283,714,184,38,222,47,269
公投第７案,嘉義縣,六腳鄉,豐美村,284,1051,351,77,428,57,485
公投第７案,嘉義縣,六腳鄉,六斗村,285,934,323,97,420,62,482
公投第７案,嘉義縣,六腳鄉,崙陽村,286,1044,358,90,448,63,511
公投第７案,嘉義縣,六腳鄉,蘇厝村,287,1476,422,117,539,42,581
公投第７案,嘉義縣,六腳鄉,竹本村,288,618,158,35,193,22,215
公投第７案,嘉義縣,六腳鄉,永賢村,289,478,91,21,112,50,162
公投第７案,嘉義縣,六腳鄉,魚寮村,290,642,147,42,189,43,232
公投第７案,嘉義縣,六腳鄉,潭墘村,291,883,194,55,249,12,261
公投第７案,嘉義縣,六腳鄉,六腳村,292,739,279,27,306,4,310
公投第７案,嘉義縣,六腳鄉,六南村,293,554,144,46,190,25,215
公投第７案,嘉義縣,六腳鄉,崩山村,294,649,139,42,181,19,200
公投第７案,嘉義縣,六腳鄉,古林村,295,689,168,31,199,32,231
公投第７案,嘉義縣,六腳鄉,更寮村,296,455,107,39,146,25,171
公投第７案,嘉義縣,六腳鄉,更寮村,297,125,24,9,33,4,37
公投第７案,嘉義縣,東石鄉,東石村,298,1915,545,148,693,105,798
公投第７案,嘉義縣,東石鄉,猿樹村,299,938,241,66,307,60,367
公投第７案,嘉義縣,東石鄉,型厝村,300,1366,262,77,339,36,375
公投第７案,嘉義縣,東石鄉,塭港村,301,1676,428,130,558,8,566
公投第７案,嘉義縣,東石鄉,三家村,302,1151,289,85,374,92,466
公投第７案,嘉義縣,東石鄉,永屯村,303,716,189,53,242,79,321
公投第７案,嘉義縣,東石鄉,海埔村,304,387,94,21,115,9,124
公投第７案,嘉義縣,東石鄉,龍港村,305,864,178,36,214,12,226
公投第７案,嘉義縣,東石鄉,副瀨村,306,910,195,56,251,15,266
公投第７案,嘉義縣,東石鄉,下揖村,307,760,177,48,225,15,240
公投第７案,嘉義縣,東石鄉,頂揖村,308,166,52,22,74,11,85
公投第７案,嘉義縣,東石鄉,頂揖村,309,212,51,12,63,14,77
公投第７案,嘉義縣,東石鄉,溪下村,310,993,227,54,281,41,322
公投第７案,嘉義縣,東石鄉,港口村,311,306,76,19,95,14,109
公投第７案,嘉義縣,東石鄉,鰲鼓村,312,1046,242,69,311,100,411
公投第７案,嘉義縣,東石鄉,鰲鼓村,313,235,46,15,61,29,90
公投第７案,嘉義縣,東石鄉,港墘村,314,1226,343,104,447,106,553
公投第７案,嘉義縣,東石鄉,蔦松村,315,843,233,66,299,62,361
公投第７案,嘉義縣,東石鄉,圍潭村,316,693,198,49,247,31,278
公投第７案,嘉義縣,東石鄉,洲仔村,317,839,285,64,349,63,412
公投第７案,嘉義縣,東石鄉,東崙村,318,363,112,19,131,14,145
公投第７案,嘉義縣,東石鄉,東崙村,319,321,81,18,99,9,108
公投第７案,嘉義縣,東石鄉,西崙村,320,1083,377,119,496,99,595
公投第７案,嘉義縣,東石鄉,塭仔村,321,901,272,85,357,54,411
公投第７案,嘉義縣,東石鄉,網寮村,322,1216,274,59,333,32,365
公投第７案,嘉義縣,東石鄉,掌潭村,323,418,148,56,204,45,249
公投第７案,嘉義縣,東石鄉,掌潭村,324,371,120,26,146,9,155
公投第７案,嘉義縣,布袋鎮,岱江里,325,614,216,43,259,34,293
公投第７案,嘉義縣,布袋鎮,九龍里,326,372,126,22,148,18,166
公投第７案,嘉義縣,布袋鎮,岑海里,327,914,339,68,407,98,505
公投第７案,嘉義縣,布袋鎮,岑海里,328,1198,435,104,539,94,633
公投第７案,嘉義縣,布袋鎮,興中里,329,1113,364,74,438,83,521
公投第７案,嘉義縣,布袋鎮,光復里,330,992,362,98,460,78,538
公投第７案,嘉義縣,布袋鎮,光復里,331,689,248,61,309,16,325
公投第７案,嘉義縣,布袋鎮,見龍里,332,882,303,87,390,68,458
公投第７案,嘉義縣,布袋鎮,新厝里,333,731,269,72,341,38,379
公投第７案,嘉義縣,布袋鎮,龍江里,334,779,308,72,380,34,414
公投第７案,嘉義縣,布袋鎮,振寮里,335,762,243,55,298,42,340
公投第７案,嘉義縣,布袋鎮,西安里,336,1184,375,95,470,50,520
公投第７案,嘉義縣,布袋鎮,中安里,337,1423,363,126,489,67,556
公投第７案,嘉義縣,布袋鎮,東安里,338,1351,366,100,466,65,531
公投第７案,嘉義縣,布袋鎮,樹林里,339,275,80,20,100,7,107
公投第７案,嘉義縣,布袋鎮,樹林里,340,243,67,28,95,14,109
公投第７案,嘉義縣,布袋鎮,貴舍里,341,661,221,58,279,84,363
公投第７案,嘉義縣,布袋鎮,永安里,342,1145,386,106,492,50,542
公投第７案,嘉義縣,布袋鎮,東港里,343,936,285,98,383,31,414
公投第７案,嘉義縣,布袋鎮,東港里,344,958,320,88,408,45,453
公投第７案,嘉義縣,布袋鎮,江山里,345,298,95,24,119,15,134
公投第７案,嘉義縣,布袋鎮,菜舖里,346,428,168,40,208,35,243
公投第７案,嘉義縣,布袋鎮,考試里,347,121,39,7,46,4,50
公投第７案,嘉義縣,布袋鎮,考試里,348,174,37,7,44,5,49
公投第７案,嘉義縣,布袋鎮,新岑里,349,953,316,82,398,53,451
公投第７案,嘉義縣,布袋鎮,新民里,350,1292,479,136,615,77,692
公投第７案,嘉義縣,布袋鎮,復興里,351,1127,425,110,535,67,602
公投第７案,嘉義縣,布袋鎮,復興里,352,1244,428,111,539,37,576
公投第７案,嘉義縣,布袋鎮,好美里,353,1106,329,95,424,28,452
公投第７案,嘉義縣,義竹鄉,岸腳村,354,482,170,33,203,27,230
公投第７案,嘉義縣,義竹鄉,岸腳村,355,223,93,21,114,17,131
公投第７案,嘉義縣,義竹鄉,義竹村,356,1529,569,163,732,78,810
公投第７案,嘉義縣,義竹鄉,六桂村,357,1175,465,113,578,74,652
公投第７案,嘉義縣,義竹鄉,仁里村,358,886,390,103,493,50,543
公投第７案,嘉義縣,義竹鄉,傳芳村,359,743,228,69,297,38,335
公投第７案,嘉義縣,義竹鄉,頭竹村,360,1236,454,130,584,90,674
公投第７案,嘉義縣,義竹鄉,五厝村,361,377,146,25,171,23,194
公投第７案,嘉義縣,義竹鄉,中平村,362,338,110,22,132,20,152
公投第７案,嘉義縣,義竹鄉,中平村,363,102,45,12,57,2,59
公投第７案,嘉義縣,義竹鄉,埤前村,364,763,244,57,301,26,327
公投第７案,嘉義縣,義竹鄉,平溪村,365,429,161,49,210,30,240
公投第７案,嘉義縣,義竹鄉,後鎮村,366,427,150,38,188,18,206
公投第７案,嘉義縣,義竹鄉,北華村,367,607,208,67,275,55,330
公投第７案,嘉義縣,義竹鄉,新店村,368,1486,504,113,617,43,660
公投第７案,嘉義縣,義竹鄉,東過村,369,835,316,98,414,60,474
公投第７案,嘉義縣,義竹鄉,西過村,370,816,231,60,291,62,353
公投第７案,嘉義縣,義竹鄉,官和村,371,833,242,80,322,59,381
公投第７案,嘉義縣,義竹鄉,官順村,372,433,156,42,198,13,211
公投第７案,嘉義縣,義竹鄉,新富村,373,558,188,40,228,8,236
公投第７案,嘉義縣,義竹鄉,東光村,374,602,210,65,275,35,310
公投第７案,嘉義縣,義竹鄉,東光村,375,140,41,9,50,1,51
公投第７案,嘉義縣,義竹鄉,東榮村,376,393,119,30,149,26,175
公投第７案,嘉義縣,義竹鄉,龍蛟村,377,585,217,41,258,25,283
公投第７案,嘉義縣,義竹鄉,溪洲村,378,526,123,29,152,9,161
公投第７案,嘉義縣,義竹鄉,溪洲村,379,123,38,17,55,12,67
公投第７案,嘉義縣,中埔鄉,富收村,380,1046,305,84,389,13,402
公投第７案,嘉義縣,中埔鄉,富收村,381,1788,584,162,746,91,837
公投第７案,嘉義縣,中埔鄉,和睦村,382,1730,526,194,720,47,767
公投第７案,嘉義縣,中埔鄉,和睦村,383,1581,552,157,709,63,772
公投第７案,嘉義縣,中埔鄉,和美村,384,1594,487,148,635,44,679
公投第７案,嘉義縣,中埔鄉,和美村,385,1801,640,194,834,48,882
公投第７案,嘉義縣,中埔鄉,和美村,386,1862,678,160,838,79,917
公投第７案,嘉義縣,中埔鄉,和美村,387,1803,571,171,742,33,775
公投第７案,嘉義縣,中埔鄉,和興村,388,1481,557,151,708,60,768
公投第７案,嘉義縣,中埔鄉,和興村,389,1366,515,139,654,64,718
公投第７案,嘉義縣,中埔鄉,和興村,390,1599,476,159,635,74,709
公投第７案,嘉義縣,中埔鄉,和興村,391,1196,428,116,544,38,582
公投第７案,嘉義縣,中埔鄉,中埔村,392,1809,566,168,734,85,819
公投第７案,嘉義縣,中埔鄉,塩舘村,393,953,318,104,422,29,451
公投第７案,嘉義縣,中埔鄉,金蘭村,394,1441,464,138,602,66,668
公投第７案,嘉義縣,中埔鄉,隆興村,395,1882,627,170,797,68,865
公投第７案,嘉義縣,中埔鄉,義仁村,396,1470,379,99,478,25,503
公投第７案,嘉義縣,中埔鄉,社口村,397,1699,552,118,670,80,750
公投第７案,嘉義縣,中埔鄉,社口村,398,422,134,24,158,15,173
公投第７案,嘉義縣,中埔鄉,灣潭村,399,1030,338,106,444,70,514
公投第７案,嘉義縣,中埔鄉,裕民村,400,879,266,78,344,47,391
公投第７案,嘉義縣,中埔鄉,龍門村,401,828,247,59,306,12,318
公投第７案,嘉義縣,中埔鄉,石硦村,402,881,361,82,443,54,497
公投第７案,嘉義縣,中埔鄉,石硦村,403,296,95,36,131,17,148
公投第７案,嘉義縣,中埔鄉,頂埔村,404,979,287,101,388,91,479
公投第７案,嘉義縣,中埔鄉,同仁村,405,1268,377,111,488,35,523
公投第７案,嘉義縣,中埔鄉,同仁村,406,670,137,40,177,11,188
公投第７案,嘉義縣,中埔鄉,深坑村,407,754,293,78,371,60,431
公投第７案,嘉義縣,中埔鄉,三層村,408,648,257,60,317,39,356
公投第７案,嘉義縣,中埔鄉,瑞豐村,409,741,217,57,274,19,293
公投第７案,嘉義縣,中埔鄉,沄水村,410,518,181,28,209,4,213
公投第７案,嘉義縣,中埔鄉,沄水村,411,482,152,54,206,35,241
公投第７案,嘉義縣,中埔鄉,東興村,412,348,112,23,135,8,143
公投第７案,嘉義縣,中埔鄉,中崙村,413,294,106,25,131,14,145
公投第７案,嘉義縣,竹崎鄉,竹崎村,414,1312,473,126,599,43,642
公投第７案,嘉義縣,竹崎鄉,竹崎村,415,1210,487,109,596,25,621
公投第７案,嘉義縣,竹崎鄉,和平村,416,991,390,108,498,56,554
公投第７案,嘉義縣,竹崎鄉,和平村,417,1207,438,116,554,42,596
公投第７案,嘉義縣,竹崎鄉,坑頭村,418,752,203,84,287,15,302
公投第７案,嘉義縣,竹崎鄉,沙坑村,419,833,323,103,426,57,483
公投第７案,嘉義縣,竹崎鄉,獅埜村,420,1220,459,149,608,80,688
公投第７案,嘉義縣,竹崎鄉,義和村,421,616,258,59,317,18,335
公投第７案,嘉義縣,竹崎鄉,義仁村,422,1031,356,113,469,59,528
公投第７案,嘉義縣,竹崎鄉,灣橋村,423,1292,423,114,537,129,666
公投第７案,嘉義縣,竹崎鄉,灣橋村,424,1995,813,211,1024,69,1093
公投第７案,嘉義縣,竹崎鄉,灣橋村,425,1996,672,180,852,25,877
公投第７案,嘉義縣,竹崎鄉,鹿滿村,426,1449,536,141,677,80,757
公投第７案,嘉義縣,竹崎鄉,紫雲村,427,1420,536,123,659,33,692
公投第７案,嘉義縣,竹崎鄉,內埔村,428,1590,595,179,774,65,839
公投第７案,嘉義縣,竹崎鄉,昇平村,429,771,274,78,352,39,391
公投第７案,嘉義縣,竹崎鄉,昇平村,430,1014,307,120,427,55,482
公投第７案,嘉義縣,竹崎鄉,桃源村,431,327,72,24,96,11,107
公投第７案,嘉義縣,竹崎鄉,桃源村,432,687,260,66,326,30,356
公投第７案,嘉義縣,竹崎鄉,白杞村,433,641,217,51,268,23,291
公投第７案,嘉義縣,竹崎鄉,塘興村,434,474,183,34,217,6,223
公投第７案,嘉義縣,竹崎鄉,塘興村,435,383,138,19,157,30,187
公投第７案,嘉義縣,竹崎鄉,義隆村,436,619,263,56,319,55,374
公投第７案,嘉義縣,竹崎鄉,龍山村,437,214,76,12,88,10,98
公投第７案,嘉義縣,竹崎鄉,龍山村,438,1568,551,163,714,103,817
公投第７案,嘉義縣,竹崎鄉,文峯村,439,658,204,50,254,37,291
公投第７案,嘉義縣,竹崎鄉,金獅村,440,434,171,52,223,31,254
公投第７案,嘉義縣,竹崎鄉,復金村,441,917,350,83,433,57,490
公投第７案,嘉義縣,竹崎鄉,復金村,442,981,318,109,427,43,470
公投第７案,嘉義縣,竹崎鄉,緞繻村,443,789,233,59,292,20,312
公投第７案,嘉義縣,竹崎鄉,緞繻村,444,108,23,2,25,3,28
公投第７案,嘉義縣,竹崎鄉,仁壽村,445,235,42,5,47,2,49
公投第７案,嘉義縣,竹崎鄉,中和村,446,331,100,31,131,5,136
公投第７案,嘉義縣,竹崎鄉,中和村,447,450,188,70,258,15,273
公投第７案,嘉義縣,竹崎鄉,光華村,448,462,140,26,166,7,173
公投第７案,嘉義縣,竹崎鄉,光華村,449,251,75,14,89,15,104
公投第７案,嘉義縣,番路鄉,江西村,450,1174,499,136,635,71,706
公投第７案,嘉義縣,番路鄉,內甕村,451,449,199,45,244,13,257
公投第７案,嘉義縣,番路鄉,新福村,452,753,326,73,399,43,442
公投第７案,嘉義縣,番路鄉,新福村,453,551,186,46,232,28,260
公投第７案,嘉義縣,番路鄉,下坑村,454,1791,749,170,919,82,1001
公投第７案,嘉義縣,番路鄉,番路村,455,849,353,124,477,61,538
公投第７案,嘉義縣,番路鄉,民和村,456,866,350,90,440,49,489
公投第７案,嘉義縣,番路鄉,觸口村,457,800,348,60,408,31,439
公投第７案,嘉義縣,番路鄉,觸口村,458,444,155,58,213,37,250
公投第７案,嘉義縣,番路鄉,大湖村,459,635,182,43,225,19,244
公投第７案,嘉義縣,番路鄉,公田村,460,319,112,19,131,12,143
公投第７案,嘉義縣,番路鄉,公田村,461,642,310,40,350,27,377
公投第７案,嘉義縣,番路鄉,公興村,462,509,165,37,202,26,228
公投第７案,嘉義縣,番路鄉,草山村,463,162,68,10,78,0,78
公投第７案,嘉義縣,番路鄉,草山村,464,212,87,17,104,9,113
公投第７案,嘉義縣,大埔鄉,大埔村,465,1468,568,147,715,87,802
公投第７案,嘉義縣,大埔鄉,和平村,466,320,92,4,96,15,111
公投第７案,嘉義縣,大埔鄉,和平村,467,304,119,40,159,8,167
公投第７案,嘉義縣,大埔鄉,永樂村,468,184,74,15,89,4,93
公投第７案,嘉義縣,大埔鄉,永樂村,469,234,106,37,143,11,154
公投第７案,嘉義縣,大埔鄉,茄苳村,470,495,186,41,227,9,236
公投第７案,嘉義縣,大埔鄉,茄苳村,471,199,81,19,100,2,102
公投第７案,嘉義縣,大埔鄉,茄苳村,472,226,71,20,91,10,101
公投第７案,嘉義縣,大埔鄉,西興村,473,569,258,69,327,21,348
公投第７案,嘉義縣,阿里山鄉,中山村,474,371,130,29,159,8,167
公投第７案,嘉義縣,阿里山鄉,中正村,475,197,65,10,75,9,84
公投第７案,嘉義縣,阿里山鄉,香林村,476,152,61,5,66,3,69
公投第７案,嘉義縣,阿里山鄉,十字村,477,231,59,10,69,5,74
公投第７案,嘉義縣,阿里山鄉,十字村,478,72,16,4,20,1,21
公投第７案,嘉義縣,阿里山鄉,豐山村,479,311,98,12,110,3,113
公投第７案,嘉義縣,阿里山鄉,來吉村,480,306,128,22,150,14,164
公投第７案,嘉義縣,阿里山鄉,樂野村,481,970,342,62,404,7,411
公投第７案,嘉義縣,阿里山鄉,達邦村,482,827,23,70,93,361,454
公投第７案,嘉義縣,阿里山鄉,里佳村,483,238,92,20,112,2,114
公投第７案,嘉義縣,阿里山鄉,山美村,484,479,87,23,110,7,117
公投第７案,嘉義縣,阿里山鄉,新美村,485,291,77,12,89,5,94
公投第７案,嘉義縣,阿里山鄉,茶山村,486,246,117,18,135,22,157
公投第７案,屏東縣,屏東市,端正里,1,237,82,36,118,10,128
公投第７案,屏東縣,屏東市,武廟里,2,294,100,39,139,26,165
公投第７案,屏東縣,屏東市,大同里,3,582,206,77,283,12,295
公投第７案,屏東縣,屏東市,光榮里,4,713,281,91,372,25,397
公投第７案,屏東縣,屏東市,民權里,5,572,213,69,282,33,315
公投第７案,屏東縣,屏東市,泰安里,6,455,210,57,267,13,280
公投第７案,屏東縣,屏東市,文明里,7,249,123,19,142,1,143
公投第７案,屏東縣,屏東市,維新里,8,1315,392,115,507,31,538
公投第７案,屏東縣,屏東市,維新里,9,1373,414,170,584,38,622
公投第７案,屏東縣,屏東市,大埔里,10,713,312,86,398,40,438
公投第７案,屏東縣,屏東市,必信里,11,573,248,69,317,48,365
公投第７案,屏東縣,屏東市,崇禮里,12,297,128,48,176,23,199
公投第７案,屏東縣,屏東市,崇智里,13,409,202,56,258,23,281
公投第７案,屏東縣,屏東市,慶春里,14,286,98,44,142,18,160
公投第７案,屏東縣,屏東市,楠樹里,15,421,150,55,205,19,224
公投第７案,屏東縣,屏東市,扶風里,16,569,232,78,310,13,323
公投第７案,屏東縣,屏東市,安樂里,17,459,155,76,231,18,249
公投第７案,屏東縣,屏東市,平和里,18,672,294,100,394,19,413
公投第７案,屏東縣,屏東市,金泉里,19,668,276,103,379,44,423
公投第７案,屏東縣,屏東市,勝豐里,20,411,170,51,221,14,235
公投第７案,屏東縣,屏東市,橋南里,21,768,295,110,405,34,439
公投第７案,屏東縣,屏東市,橋南里,22,786,335,72,407,29,436
公投第７案,屏東縣,屏東市,橋北里,23,890,382,102,484,36,520
公投第７案,屏東縣,屏東市,大連里,24,1353,578,141,719,41,760
公投第７案,屏東縣,屏東市,大連里,25,1386,353,336,689,34,723
公投第７案,屏東縣,屏東市,大連里,26,1413,581,140,721,37,758
公投第７案,屏東縣,屏東市,大連里,27,1272,530,123,653,36,689
公投第７案,屏東縣,屏東市,大連里,28,1287,539,123,662,29,691
公投第７案,屏東縣,屏東市,大連里,29,1311,584,128,712,45,757
公投第７案,屏東縣,屏東市,大連里,30,1285,503,164,667,24,691
公投第７案,屏東縣,屏東市,豐田里,31,1297,541,137,678,52,730
公投第７案,屏東縣,屏東市,豐田里,32,1361,555,126,681,33,714
公投第７案,屏東縣,屏東市,豐田里,33,1381,519,147,666,44,710
公投第７案,屏東縣,屏東市,豐榮里,34,1258,527,158,685,51,736
公投第７案,屏東縣,屏東市,豐榮里,35,1259,462,170,632,52,684
公投第７案,屏東縣,屏東市,豐源里,36,1076,432,108,540,41,581
公投第７案,屏東縣,屏東市,豐源里,37,1162,503,124,627,39,666
公投第７案,屏東縣,屏東市,豐源里,38,1318,556,152,708,35,743
公投第７案,屏東縣,屏東市,長春里,39,939,381,102,483,40,523
公投第７案,屏東縣,屏東市,長春里,40,972,418,110,528,33,561
公投第７案,屏東縣,屏東市,瑞光里,41,1535,648,174,822,39,861
公投第７案,屏東縣,屏東市,瑞光里,42,1419,515,132,647,41,688
公投第７案,屏東縣,屏東市,瑞光里,43,1398,539,111,650,22,672
公投第７案,屏東縣,屏東市,瑞光里,44,1405,541,144,685,57,742
公投第７案,屏東縣,屏東市,瑞光里,45,1486,635,147,782,33,815
公投第７案,屏東縣,屏東市,湖南里,46,1061,409,127,536,56,592
公投第７案,屏東縣,屏東市,湖西里,47,1540,496,140,636,104,740
公投第７案,屏東縣,屏東市,歸心里,48,1141,380,113,493,18,511
公投第７案,屏東縣,屏東市,清溪里,49,1247,469,105,574,37,611
公投第７案,屏東縣,屏東市,清溪里,50,1446,562,130,692,40,732
公投第７案,屏東縣,屏東市,清溪里,51,1303,549,148,697,42,739
公投第７案,屏東縣,屏東市,大武里,52,1253,522,119,641,44,685
公投第７案,屏東縣,屏東市,大武里,53,1315,561,102,663,49,712
公投第７案,屏東縣,屏東市,大武里,54,1425,512,174,686,41,727
公投第７案,屏東縣,屏東市,大武里,55,1423,546,139,685,21,706
公投第７案,屏東縣,屏東市,大武里,56,1400,577,145,722,53,775
公投第７案,屏東縣,屏東市,大武里,57,1359,561,180,741,43,784
公投第７案,屏東縣,屏東市,崇武里,58,1328,576,103,679,36,715
公投第７案,屏東縣,屏東市,崇武里,59,1539,653,121,774,44,818
公投第７案,屏東縣,屏東市,凌雲里,60,391,108,24,132,3,135
公投第７案,屏東縣,屏東市,永昌里,61,200,75,29,104,12,116
公投第７案,屏東縣,屏東市,永順里,62,328,114,27,141,25,166
公投第７案,屏東縣,屏東市,鵬程里,63,231,103,15,118,3,121
公投第７案,屏東縣,屏東市,安鎮里,64,945,366,84,450,49,499
公投第７案,屏東縣,屏東市,安鎮里,65,1053,381,115,496,54,550
公投第７案,屏東縣,屏東市,永光里,66,1043,370,99,469,58,527
公投第７案,屏東縣,屏東市,長安里,67,1061,388,101,489,69,558
公投第７案,屏東縣,屏東市,長安里,68,876,306,105,411,39,450
公投第７案,屏東縣,屏東市,前進里,69,1468,593,69,662,105,767
公投第７案,屏東縣,屏東市,前進里,70,1454,510,139,649,67,716
公投第７案,屏東縣,屏東市,大洲里,71,1205,467,138,605,23,628
公投第７案,屏東縣,屏東市,新興里,72,1284,460,133,593,35,628
公投第７案,屏東縣,屏東市,新興里,73,1219,477,103,580,32,612
公投第７案,屏東縣,屏東市,公館里,74,1544,617,172,789,78,867
公投第７案,屏東縣,屏東市,新生里,75,1485,549,178,727,83,810
公投第７案,屏東縣,屏東市,新生里,76,1387,554,151,705,64,769
公投第７案,屏東縣,屏東市,新生里,77,953,360,89,449,31,480
公投第７案,屏東縣,屏東市,新生里,78,1603,631,205,836,47,883
公投第７案,屏東縣,屏東市,頂宅里,79,535,193,57,250,34,284
公投第７案,屏東縣,屏東市,頂柳里,80,1119,431,105,536,39,575
公投第７案,屏東縣,屏東市,大湖里,81,847,359,86,445,27,472
公投第７案,屏東縣,屏東市,大湖里,82,923,364,115,479,63,542
公投第７案,屏東縣,屏東市,龍華里,83,1227,436,135,571,38,609
公投第７案,屏東縣,屏東市,龍華里,84,1039,386,125,511,54,565
公投第７案,屏東縣,屏東市,玉成里,85,1485,539,146,685,100,785
公投第７案,屏東縣,屏東市,擇仁里,86,867,328,85,413,57,470
公投第７案,屏東縣,屏東市,建國里,87,918,378,111,489,31,520
公投第７案,屏東縣,屏東市,萬年里,88,663,233,70,303,40,343
公投第７案,屏東縣,屏東市,厚生里,89,1215,412,111,523,19,542
公投第７案,屏東縣,屏東市,厚生里,90,1628,548,172,720,68,788
公投第７案,屏東縣,屏東市,一心里,91,1209,522,108,630,45,675
公投第７案,屏東縣,屏東市,義勇里,92,1110,550,121,671,22,693
公投第７案,屏東縣,屏東市,光華里,93,684,218,85,303,19,322
公投第７案,屏東縣,屏東市,永安里,94,1349,431,105,536,30,566
公投第７案,屏東縣,屏東市,永安里,95,1457,525,126,651,63,714
公投第７案,屏東縣,屏東市,永安里,96,1447,581,170,751,47,798
公投第７案,屏東縣,屏東市,永安里,97,1354,500,128,628,29,657
公投第７案,屏東縣,屏東市,永安里,98,1583,630,190,820,63,883
公投第７案,屏東縣,屏東市,崇蘭里,99,1707,693,133,826,24,850
公投第７案,屏東縣,屏東市,崇蘭里,100,1637,639,116,755,27,782
公投第７案,屏東縣,屏東市,崇蘭里,101,1459,547,147,694,9,703
公投第７案,屏東縣,屏東市,崇蘭里,102,1759,750,147,897,47,944
公投第７案,屏東縣,屏東市,崇蘭里,103,1950,801,156,957,42,999
公投第７案,屏東縣,屏東市,崇蘭里,104,1729,713,151,864,50,914
公投第７案,屏東縣,屏東市,崇蘭里,105,1592,608,134,742,25,767
公投第７案,屏東縣,屏東市,潭墘里,106,1437,558,122,680,41,721
公投第７案,屏東縣,屏東市,潭墘里,107,1204,488,83,571,29,600
公投第７案,屏東縣,屏東市,潭墘里,108,1340,580,120,700,35,735
公投第７案,屏東縣,屏東市,潭墘里,109,1322,552,133,685,32,717
公投第７案,屏東縣,屏東市,潭墘里,110,1462,559,113,672,39,711
公投第７案,屏東縣,屏東市,潭墘里,111,3241,1269,246,1515,49,1564
公投第７案,屏東縣,屏東市,潭墘里,112,1477,599,94,693,26,719
公投第７案,屏東縣,屏東市,永城里,113,821,301,61,362,26,388
公投第７案,屏東縣,屏東市,永城里,114,1099,355,77,432,17,449
公投第７案,屏東縣,屏東市,空翔里,115,1688,698,125,823,47,870
公投第７案,屏東縣,屏東市,廣興里,116,1167,442,93,535,46,581
公投第７案,屏東縣,屏東市,廣興里,117,915,335,101,436,52,488
公投第７案,屏東縣,屏東市,勝利里,118,1683,400,91,491,38,529
公投第７案,屏東縣,屏東市,勝利里,119,1497,594,123,717,16,733
公投第７案,屏東縣,屏東市,勝利里,120,1129,410,123,533,30,563
公投第７案,屏東縣,屏東市,勝利里,121,1232,523,101,624,41,665
公投第７案,屏東縣,屏東市,斯文里,122,853,338,88,426,33,459
公投第７案,屏東縣,屏東市,斯文里,123,869,376,108,484,20,504
公投第７案,屏東縣,屏東市,華山里,124,1169,505,120,625,44,669
公投第７案,屏東縣,屏東市,華山里,125,1058,457,98,555,30,585
公投第７案,屏東縣,屏東市,華山里,126,1344,483,137,620,51,671
公投第７案,屏東縣,屏東市,華山里,127,1299,516,150,666,24,690
公投第７案,屏東縣,屏東市,溝美里,128,1204,440,95,535,33,568
公投第７案,屏東縣,屏東市,溝美里,129,1123,435,108,543,40,583
公投第７案,屏東縣,屏東市,三山里,130,1318,429,124,553,32,585
公投第７案,屏東縣,屏東市,海豐里,131,865,374,86,460,54,514
公投第７案,屏東縣,屏東市,仁義里,132,1100,359,85,444,27,471
公投第７案,屏東縣,屏東市,北興里,133,1215,433,106,539,26,565
公投第７案,屏東縣,屏東市,北興里,134,1370,542,143,685,42,727
公投第７案,屏東縣,屏東市,北興里,135,1240,493,121,614,13,627
公投第７案,屏東縣,屏東市,北興里,136,1168,486,131,617,49,666
公投第７案,屏東縣,屏東市,北興里,137,1079,455,96,551,25,576
公投第７案,屏東縣,屏東市,北勢里,138,1289,561,123,684,53,737
公投第７案,屏東縣,屏東市,北勢里,139,1115,435,107,542,29,571
公投第７案,屏東縣,屏東市,中正里,140,1491,592,200,792,50,842
公投第７案,屏東縣,屏東市,中正里,141,1411,525,116,641,37,678
公投第７案,屏東縣,屏東市,中正里,142,1803,679,182,861,37,898
公投第７案,屏東縣,屏東市,興樂里,143,744,329,69,398,28,426
公投第７案,屏東縣,屏東市,明正里,144,678,269,70,339,26,365
公投第７案,屏東縣,屏東市,太平里,145,681,277,87,364,29,393
公投第７案,屏東縣,屏東市,信和里,146,1535,506,115,621,32,653
公投第７案,屏東縣,屏東市,和興里,147,954,381,104,485,59,544
公投第７案,屏東縣,屏東市,仁愛里,148,1018,441,127,568,43,611
公投第７案,屏東縣,屏東市,仁愛里,149,1154,486,135,621,31,652
公投第７案,屏東縣,潮州鎮,潮州里,150,504,198,70,268,37,305
公投第７案,屏東縣,潮州鎮,光華里,151,1711,600,150,750,50,800
公投第７案,屏東縣,潮州鎮,光華里,152,1634,608,171,779,28,807
公投第７案,屏東縣,潮州鎮,光華里,153,1414,503,112,615,28,643
公投第７案,屏東縣,潮州鎮,同榮里,154,603,223,96,319,57,376
公投第７案,屏東縣,潮州鎮,彭城里,155,896,343,86,429,57,486
公投第７案,屏東縣,潮州鎮,三星里,156,1285,479,132,611,62,673
公投第７案,屏東縣,潮州鎮,三星里,157,1744,672,144,816,65,881
公投第７案,屏東縣,潮州鎮,三星里,158,1071,363,96,459,52,511
公投第７案,屏東縣,潮州鎮,三星里,159,1209,516,128,644,63,707
公投第７案,屏東縣,潮州鎮,三共里,160,1159,433,129,562,45,607
公投第７案,屏東縣,潮州鎮,三共里,161,1296,496,118,614,60,674
公投第７案,屏東縣,潮州鎮,三共里,162,1466,602,135,737,51,788
公投第７案,屏東縣,潮州鎮,三共里,163,1130,440,143,583,63,646
公投第７案,屏東縣,潮州鎮,三共里,164,1439,571,153,724,46,770
公投第７案,屏東縣,潮州鎮,三和里,165,897,386,85,471,51,522
公投第７案,屏東縣,潮州鎮,三和里,166,1225,518,119,637,48,685
公投第７案,屏東縣,潮州鎮,九塊里,167,1158,434,109,543,42,585
公投第７案,屏東縣,潮州鎮,九塊里,168,481,136,47,183,34,217
公投第７案,屏東縣,潮州鎮,新生里,169,972,383,107,490,57,547
公投第７案,屏東縣,潮州鎮,新榮里,170,1245,517,163,680,47,727
公投第７案,屏東縣,潮州鎮,五魁里,171,1415,547,138,685,58,743
公投第７案,屏東縣,潮州鎮,蓬萊里,172,1255,413,108,521,13,534
公投第７案,屏東縣,潮州鎮,蓬萊里,173,1058,346,83,429,27,456
公投第７案,屏東縣,潮州鎮,八爺里,174,1187,444,129,573,37,610
公投第７案,屏東縣,潮州鎮,八爺里,175,1083,433,106,539,67,606
公投第７案,屏東縣,潮州鎮,永春里,176,1590,559,148,707,39,746
公投第７案,屏東縣,潮州鎮,永春里,177,1543,715,159,874,69,943
公投第７案,屏東縣,潮州鎮,永春里,178,1631,595,161,756,51,807
公投第７案,屏東縣,潮州鎮,永春里,179,1159,497,91,588,33,621
公投第７案,屏東縣,潮州鎮,永春里,180,1099,462,122,584,34,618
公投第７案,屏東縣,潮州鎮,富春里,181,1200,423,115,538,52,590
公投第７案,屏東縣,潮州鎮,光春里,182,1391,519,120,639,65,704
公投第７案,屏東縣,潮州鎮,興美里,183,881,369,74,443,62,505
公投第７案,屏東縣,潮州鎮,檨子里,184,454,131,40,171,21,192
公投第７案,屏東縣,潮州鎮,泗林里,185,1658,328,175,503,95,598
公投第７案,屏東縣,潮州鎮,四春里,186,822,274,70,344,37,381
公投第７案,屏東縣,潮州鎮,四春里,187,948,283,91,374,14,388
公投第７案,屏東縣,潮州鎮,崙東里,188,1194,352,97,449,29,478
公投第７案,屏東縣,潮州鎮,崙東里,189,337,129,30,159,32,191
公投第７案,屏東縣,東港鎮,新勝里,190,981,410,114,524,63,587
公投第７案,屏東縣,東港鎮,新勝里,191,1070,431,134,565,64,629
公投第７案,屏東縣,東港鎮,頂新里,192,527,233,60,293,48,341
公投第７案,屏東縣,東港鎮,頂中里,193,395,149,48,197,40,237
公投第７案,屏東縣,東港鎮,東和里,194,659,235,65,300,38,338
公投第７案,屏東縣,東港鎮,興台里,195,513,202,44,246,31,277
公投第７案,屏東縣,東港鎮,興東里,196,1732,656,167,823,61,884
公投第７案,屏東縣,東港鎮,興東里,197,1779,720,173,893,56,949
公投第７案,屏東縣,東港鎮,興東里,198,1270,471,124,595,47,642
公投第７案,屏東縣,東港鎮,興東里,199,1327,486,147,633,64,697
公投第７案,屏東縣,東港鎮,興東里,200,1242,480,143,623,72,695
公投第７案,屏東縣,東港鎮,興東里,201,1607,654,124,778,101,879
公投第７案,屏東縣,東港鎮,興農里,202,1305,469,109,578,38,616
公投第７案,屏東縣,東港鎮,中興里,203,695,286,66,352,39,391
公投第７案,屏東縣,東港鎮,朝安里,204,1076,437,125,562,98,660
公投第７案,屏東縣,東港鎮,朝安里,205,567,190,60,250,39,289
公投第７案,屏東縣,東港鎮,八德里,206,806,286,77,363,41,404
公投第７案,屏東縣,東港鎮,東隆里,207,1227,464,142,606,77,683
公投第７案,屏東縣,東港鎮,豐漁里,208,599,197,65,262,59,321
公投第７案,屏東縣,東港鎮,盛漁里,209,1354,390,110,500,49,549
公投第７案,屏東縣,東港鎮,興漁里,210,734,256,76,332,56,388
公投第７案,屏東縣,東港鎮,興漁里,211,1107,405,111,516,119,635
公投第７案,屏東縣,東港鎮,鎮海里,212,1198,406,97,503,87,590
公投第７案,屏東縣,東港鎮,鎮海里,213,1614,544,146,690,131,821
公投第７案,屏東縣,東港鎮,嘉蓮里,214,826,289,81,370,50,420
公投第７案,屏東縣,東港鎮,嘉蓮里,215,912,360,95,455,63,518
公投第７案,屏東縣,東港鎮,南平里,216,432,130,46,176,48,224
公投第７案,屏東縣,東港鎮,南平里,217,1204,429,122,551,130,681
公投第７案,屏東縣,東港鎮,船頭里,218,1304,525,146,671,57,728
公投第７案,屏東縣,東港鎮,船頭里,219,1317,522,148,670,75,745
公投第７案,屏東縣,東港鎮,船頭里,220,1387,530,134,664,42,706
公投第７案,屏東縣,東港鎮,船頭里,221,1310,443,108,551,44,595
公投第７案,屏東縣,東港鎮,下廍里,222,1228,421,123,544,42,586
公投第７案,屏東縣,東港鎮,下廍里,223,766,233,81,314,59,373
公投第７案,屏東縣,東港鎮,大潭里,224,823,305,102,407,66,473
公投第７案,屏東縣,東港鎮,大潭里,225,755,203,44,247,19,266
公投第７案,屏東縣,東港鎮,興和里,226,1094,425,134,559,60,619
公投第７案,屏東縣,東港鎮,共和里,227,753,277,64,341,28,369
公投第７案,屏東縣,恆春鎮,城南里,228,902,324,90,414,26,440
公投第７案,屏東縣,恆春鎮,城北里,229,969,411,97,508,45,553
公投第７案,屏東縣,恆春鎮,城北里,230,1280,476,101,577,48,625
公投第７案,屏東縣,恆春鎮,城西里,231,1133,554,20,574,32,606
公投第７案,屏東縣,恆春鎮,網紗里,232,1552,504,98,602,13,615
公投第７案,屏東縣,恆春鎮,網紗里,233,1485,455,105,560,55,615
公投第７案,屏東縣,恆春鎮,仁壽里,234,896,348,100,448,33,481
公投第７案,屏東縣,恆春鎮,茄湖里,235,531,169,51,220,25,245
公投第７案,屏東縣,恆春鎮,頭溝里,236,478,160,41,201,8,209
公投第７案,屏東縣,恆春鎮,四溝里,237,1020,348,106,454,35,489
公投第７案,屏東縣,恆春鎮,德和里,238,924,306,100,406,28,434
公投第７案,屏東縣,恆春鎮,龍水里,239,1079,349,80,429,17,446
公投第７案,屏東縣,恆春鎮,山海里,240,775,209,45,254,22,276
公投第７案,屏東縣,恆春鎮,山海里,241,813,314,69,383,50,433
公投第７案,屏東縣,恆春鎮,大光里,242,1104,386,88,474,45,519
公投第７案,屏東縣,恆春鎮,大光里,243,1110,345,100,445,45,490
公投第７案,屏東縣,恆春鎮,水泉里,244,692,183,53,236,61,297
公投第７案,屏東縣,恆春鎮,水泉里,245,708,190,39,229,10,239
公投第７案,屏東縣,恆春鎮,山腳里,246,1505,530,134,664,36,700
公投第７案,屏東縣,恆春鎮,山腳里,247,1111,382,83,465,47,512
公投第７案,屏東縣,恆春鎮,山腳里,248,1543,551,121,672,36,708
公投第７案,屏東縣,恆春鎮,南灣里,249,828,245,55,300,19,319
公投第７案,屏東縣,恆春鎮,南灣里,250,844,318,94,412,27,439
公投第７案,屏東縣,恆春鎮,墾丁里,251,1253,456,102,558,45,603
公投第７案,屏東縣,恆春鎮,鵝鑾里,252,1126,396,83,479,34,513
公投第７案,屏東縣,萬丹鄉,香社村,253,1527,443,128,571,60,631
公投第７案,屏東縣,萬丹鄉,新庄村,254,1147,385,113,498,65,563
公投第７案,屏東縣,萬丹鄉,新庄村,255,949,289,109,398,47,445
公投第７案,屏東縣,萬丹鄉,新鐘村,256,990,349,92,441,35,476
公投第７案,屏東縣,萬丹鄉,新鐘村,257,1022,317,86,403,14,417
公投第７案,屏東縣,萬丹鄉,水仙村,258,545,248,61,309,58,367
公投第７案,屏東縣,萬丹鄉,興全村,259,1159,459,123,582,85,667
公投第７案,屏東縣,萬丹鄉,興安村,260,837,320,97,417,78,495
公投第７案,屏東縣,萬丹鄉,甘棠村,261,392,141,43,184,14,198
公投第７案,屏東縣,萬丹鄉,萬惠村,262,847,357,93,450,34,484
公投第７案,屏東縣,萬丹鄉,萬全村,263,1149,442,84,526,54,580
公投第７案,屏東縣,萬丹鄉,萬全村,264,1131,433,120,553,53,606
公投第７案,屏東縣,萬丹鄉,萬全村,265,1178,441,119,560,48,608
公投第７案,屏東縣,萬丹鄉,萬後村,266,711,294,92,386,39,425
公投第７案,屏東縣,萬丹鄉,萬安村,267,595,235,82,317,26,343
公投第７案,屏東縣,萬丹鄉,萬生村,268,1403,597,148,745,56,801
公投第７案,屏東縣,萬丹鄉,寶厝村,269,1094,416,89,505,28,533
公投第７案,屏東縣,萬丹鄉,寶厝村,270,1158,470,126,596,35,631
公投第７案,屏東縣,萬丹鄉,四維村,271,963,403,142,545,54,599
公投第７案,屏東縣,萬丹鄉,四維村,272,1062,379,111,490,56,546
公投第７案,屏東縣,萬丹鄉,竹林村,273,1684,584,208,792,89,881
公投第７案,屏東縣,萬丹鄉,水泉村,274,1702,610,137,747,41,788
公投第７案,屏東縣,萬丹鄉,田厝村,275,976,337,120,457,49,506
公投第７案,屏東縣,萬丹鄉,崙頂村,276,1013,365,126,491,65,556
公投第７案,屏東縣,萬丹鄉,崙頂村,277,847,231,116,347,35,382
公投第７案,屏東縣,萬丹鄉,厦北村,278,1570,576,206,782,130,912
公投第７案,屏東縣,萬丹鄉,厦南村,279,1411,481,141,622,70,692
公投第７案,屏東縣,萬丹鄉,後村村,280,1046,404,115,519,78,597
公投第７案,屏東縣,萬丹鄉,灣內村,281,1385,457,145,602,30,632
公投第７案,屏東縣,萬丹鄉,上村村,282,804,300,83,383,62,445
公投第７案,屏東縣,萬丹鄉,加興村,283,1284,462,150,612,83,695
公投第７案,屏東縣,萬丹鄉,社口村,284,1430,513,137,650,50,700
公投第７案,屏東縣,萬丹鄉,磚寮村,285,960,415,119,534,64,598
公投第７案,屏東縣,萬丹鄉,社皮村,286,786,332,96,428,48,476
公投第７案,屏東縣,萬丹鄉,社皮村,287,1158,421,150,571,79,650
公投第７案,屏東縣,萬丹鄉,社中村,288,1647,507,133,640,67,707
公投第７案,屏東縣,萬丹鄉,社上村,289,1666,542,152,694,80,774
公投第７案,屏東縣,萬丹鄉,廣安村,290,1023,430,119,549,73,622
公投第７案,屏東縣,萬丹鄉,廣安村,291,1227,507,144,651,65,716
公投第７案,屏東縣,長治鄉,進興村,292,1018,390,115,505,63,568
公投第７案,屏東縣,長治鄉,進興村,293,1614,635,160,795,84,879
公投第７案,屏東縣,長治鄉,新潭村,294,1848,787,164,951,101,1052
公投第７案,屏東縣,長治鄉,新潭村,295,1707,670,179,849,71,920
公投第７案,屏東縣,長治鄉,潭頭村,296,972,429,94,523,30,553
公投第７案,屏東縣,長治鄉,潭頭村,297,989,388,125,513,53,566
公投第７案,屏東縣,長治鄉,香楊村,298,735,313,86,399,46,445
公投第７案,屏東縣,長治鄉,香楊村,299,1813,629,197,826,68,894
公投第７案,屏東縣,長治鄉,長興村,300,1073,470,127,597,52,649
公投第７案,屏東縣,長治鄉,崙上村,301,1654,605,200,805,100,905
公投第７案,屏東縣,長治鄉,德榮村,302,1205,460,147,607,72,679
公投第７案,屏東縣,長治鄉,德和村,303,758,302,85,387,44,431
公投第７案,屏東縣,長治鄉,復興村,304,1492,513,182,695,110,805
公投第７案,屏東縣,長治鄉,德成村,305,884,355,94,449,54,503
公投第７案,屏東縣,長治鄉,德協村,306,1090,451,114,565,55,620
公投第７案,屏東縣,長治鄉,繁榮村,307,1422,446,137,583,101,684
公投第７案,屏東縣,長治鄉,繁昌村,308,845,304,101,405,56,461
公投第７案,屏東縣,長治鄉,繁昌村,309,925,348,116,464,69,533
公投第７案,屏東縣,長治鄉,繁隆村,310,1138,423,95,518,96,614
公投第７案,屏東縣,長治鄉,繁華村,311,1242,432,153,585,108,693
公投第７案,屏東縣,長治鄉,繁華村,312,1159,324,101,425,21,446
公投第７案,屏東縣,長治鄉,榮華村,313,673,295,72,367,35,402
公投第７案,屏東縣,麟洛鄉,新田村,314,788,314,94,408,37,445
公投第７案,屏東縣,麟洛鄉,新田村,315,1386,602,158,760,24,784
公投第７案,屏東縣,麟洛鄉,麟頂村,316,957,433,103,536,43,579
公投第７案,屏東縣,麟洛鄉,麟蹄村,317,731,315,80,395,49,444
公投第７案,屏東縣,麟洛鄉,麟蹄村,318,806,349,97,446,58,504
公投第７案,屏東縣,麟洛鄉,麟趾村,319,1207,410,126,536,22,558
公投第７案,屏東縣,麟洛鄉,麟趾村,320,1340,592,129,721,87,808
公投第７案,屏東縣,麟洛鄉,田中村,321,1221,498,145,643,60,703
公投第７案,屏東縣,麟洛鄉,田心村,322,851,309,89,398,15,413
公投第７案,屏東縣,麟洛鄉,田道村,323,683,255,56,311,13,324
公投第７案,屏東縣,九如鄉,九清村,324,1491,548,184,732,100,832
公投第７案,屏東縣,九如鄉,九塊村,325,1375,515,146,661,70,731
公投第７案,屏東縣,九如鄉,九明村,326,1678,572,160,732,53,785
公投第７案,屏東縣,九如鄉,大坵村,327,1166,473,129,602,76,678
公投第７案,屏東縣,九如鄉,玉水村,328,1276,393,104,497,52,549
公投第７案,屏東縣,九如鄉,玉泉村,329,1033,398,113,511,68,579
公投第７案,屏東縣,九如鄉,玉泉村,330,577,298,69,367,30,397
公投第７案,屏東縣,九如鄉,東寧村,331,649,262,74,336,62,398
公投第７案,屏東縣,九如鄉,東寧村,332,1999,724,220,944,145,1089
公投第７案,屏東縣,九如鄉,東寧村,333,1766,657,177,834,86,920
公投第７案,屏東縣,九如鄉,三塊村,334,1600,652,65,717,108,825
公投第７案,屏東縣,九如鄉,耆老村,335,1248,450,133,583,97,680
公投第７案,屏東縣,九如鄉,後庄村,336,1792,595,255,850,188,1038
公投第７案,屏東縣,九如鄉,洽興村,337,1482,571,147,718,92,810
公投第７案,屏東縣,里港鄉,玉田村,338,1552,630,189,819,92,911
公投第７案,屏東縣,里港鄉,玉田村,339,1480,542,164,706,82,788
公投第７案,屏東縣,里港鄉,塔樓村,340,1534,452,170,622,55,677
公投第７案,屏東縣,里港鄉,潮厝村,341,1578,566,179,745,105,850
公投第７案,屏東縣,里港鄉,大平村,342,1127,512,88,600,65,665
公投第７案,屏東縣,里港鄉,永春村,343,845,351,98,449,46,495
公投第７案,屏東縣,里港鄉,春林村,344,1282,461,143,604,65,669
公投第７案,屏東縣,里港鄉,過江村,345,981,391,118,509,57,566
公投第７案,屏東縣,里港鄉,過江村,346,1031,414,108,522,73,595
公投第７案,屏東縣,里港鄉,鐵店村,347,1423,546,149,695,108,803
公投第７案,屏東縣,里港鄉,茄苳村,348,363,101,42,143,23,166
公投第７案,屏東縣,里港鄉,茄苳村,349,1203,441,143,584,113,697
公投第７案,屏東縣,里港鄉,載興村,350,1027,449,114,563,73,636
公投第７案,屏東縣,里港鄉,載興村,351,1384,430,158,588,59,647
公投第７案,屏東縣,里港鄉,土庫村,352,1512,524,160,684,80,764
公投第７案,屏東縣,里港鄉,土庫村,353,522,240,45,285,23,308
公投第７案,屏東縣,里港鄉,三廍村,354,822,308,91,399,60,459
公投第７案,屏東縣,里港鄉,三廍村,355,1007,337,102,439,88,527
公投第７案,屏東縣,里港鄉,中和村,356,956,335,130,465,72,537
公投第７案,屏東縣,里港鄉,瀰力村,357,499,196,62,258,24,282
公投第７案,屏東縣,鹽埔鄉,鹽北村,358,951,348,94,442,34,476
公投第７案,屏東縣,鹽埔鄉,鹽北村,359,899,302,91,393,31,424
公投第７案,屏東縣,鹽埔鄉,鹽中村,360,1116,343,94,437,31,468
公投第７案,屏東縣,鹽埔鄉,鹽中村,361,1241,448,118,566,54,620
公投第７案,屏東縣,鹽埔鄉,鹽南村,362,770,268,66,334,54,388
公投第７案,屏東縣,鹽埔鄉,鹽南村,363,962,363,88,451,49,500
公投第７案,屏東縣,鹽埔鄉,仕絨村,364,1041,426,137,563,67,630
公投第７案,屏東縣,鹽埔鄉,高朗村,365,1367,493,142,635,72,707
公投第７案,屏東縣,鹽埔鄉,高朗村,366,1465,485,110,595,60,655
公投第７案,屏東縣,鹽埔鄉,振興村,367,894,286,79,365,54,419
公投第７案,屏東縣,鹽埔鄉,振興村,368,958,326,65,391,6,397
公投第７案,屏東縣,鹽埔鄉,久愛村,369,924,327,77,404,86,490
公投第７案,屏東縣,鹽埔鄉,新圍村,370,1598,511,133,644,40,684
公投第７案,屏東縣,鹽埔鄉,新圍村,371,1550,521,193,714,115,829
公投第７案,屏東縣,鹽埔鄉,新二村,372,1127,416,99,515,85,600
公投第７案,屏東縣,鹽埔鄉,新二村,373,1150,476,108,584,84,668
公投第７案,屏東縣,鹽埔鄉,新二村,374,1233,470,131,601,71,672
公投第７案,屏東縣,鹽埔鄉,彭厝村,375,984,409,102,511,80,591
公投第７案,屏東縣,鹽埔鄉,洛陽村,376,1619,600,188,788,66,854
公投第７案,屏東縣,鹽埔鄉,永隆村,377,553,218,53,271,34,305
公投第７案,屏東縣,高樹鄉,高樹村,378,883,337,129,466,79,545
公投第７案,屏東縣,高樹鄉,高樹村,379,1255,316,114,430,25,455
公投第７案,屏東縣,高樹鄉,長榮村,380,1278,433,141,574,37,611
公投第７案,屏東縣,高樹鄉,東興村,381,738,220,70,290,24,314
公投第７案,屏東縣,高樹鄉,東振村,382,585,165,69,234,14,248
公投第７案,屏東縣,高樹鄉,源泉村,383,1012,348,107,455,136,591
公投第７案,屏東縣,高樹鄉,建興村,384,1148,369,104,473,90,563
公投第７案,屏東縣,高樹鄉,大埔村,385,591,186,70,256,34,290
公投第７案,屏東縣,高樹鄉,菜寮村,386,786,229,73,302,49,351
公投第７案,屏東縣,高樹鄉,司馬村,387,649,183,60,243,19,262
公投第７案,屏東縣,高樹鄉,舊寮村,388,1229,331,95,426,74,500
公投第７案,屏東縣,高樹鄉,新豐村,389,1446,403,122,525,55,580
公投第７案,屏東縣,高樹鄉,泰山村,390,899,248,78,326,18,344
公投第７案,屏東縣,高樹鄉,泰山村,391,922,318,104,422,49,471
公投第７案,屏東縣,高樹鄉,南華村,392,1259,391,121,512,88,600
公投第７案,屏東縣,高樹鄉,廣福村,393,1056,289,68,357,25,382
公投第７案,屏東縣,高樹鄉,廣興村,394,1116,414,123,537,68,605
公投第７案,屏東縣,高樹鄉,舊庄村,395,1020,349,139,488,78,566
公投第７案,屏東縣,高樹鄉,田子村,396,1055,380,108,488,84,572
公投第７案,屏東縣,高樹鄉,鹽樹村,397,738,285,95,380,42,422
公投第７案,屏東縣,高樹鄉,鹽樹村,398,493,154,35,189,32,221
公投第７案,屏東縣,高樹鄉,新南村,399,1539,550,201,751,105,856
公投第７案,屏東縣,萬巒鄉,萬巒村,400,1239,410,119,529,40,569
公投第７案,屏東縣,萬巒鄉,萬全村,401,759,276,88,364,61,425
公投第７案,屏東縣,萬巒鄉,萬和村,402,932,372,93,465,88,553
公投第７案,屏東縣,萬巒鄉,萬和村,403,769,309,91,400,63,463
公投第７案,屏東縣,萬巒鄉,鹿寮村,404,920,331,98,429,76,505
公投第７案,屏東縣,萬巒鄉,硫黃村,405,560,229,60,289,35,324
公投第７案,屏東縣,萬巒鄉,泗溝村,406,1120,381,96,477,21,498
公投第７案,屏東縣,萬巒鄉,五溝村,407,1048,337,112,449,31,480
公投第７案,屏東縣,萬巒鄉,成德村,408,1438,354,219,573,40,613
公投第７案,屏東縣,萬巒鄉,赤山村,409,834,253,99,352,63,415
公投第７案,屏東縣,萬巒鄉,赤山村,410,813,273,86,359,64,423
公投第７案,屏東縣,萬巒鄉,萬金村,411,1020,317,71,388,43,431
公投第７案,屏東縣,萬巒鄉,萬金村,412,1007,379,124,503,72,575
公投第７案,屏東縣,萬巒鄉,佳佐村,413,1648,481,147,628,101,729
公投第７案,屏東縣,萬巒鄉,佳和村,414,1437,485,166,651,65,716
公投第７案,屏東縣,萬巒鄉,新厝村,415,1228,355,118,473,22,495
公投第７案,屏東縣,萬巒鄉,新置村,416,597,253,55,308,51,359
公投第７案,屏東縣,萬巒鄉,新置村,417,576,207,57,264,50,314
公投第７案,屏東縣,內埔鄉,內埔村,418,1305,440,115,555,44,599
公投第７案,屏東縣,內埔鄉,內埔村,419,1287,422,103,525,44,569
公投第７案,屏東縣,內埔鄉,內埔村,420,1387,484,115,599,18,617
公投第７案,屏東縣,內埔鄉,內田村,421,1540,507,150,657,53,710
公投第７案,屏東縣,內埔鄉,內田村,422,1605,543,149,692,52,744
公投第７案,屏東縣,內埔鄉,興南村,423,1326,472,118,590,59,649
公投第７案,屏東縣,內埔鄉,義亭村,424,591,221,67,288,46,334
公投第７案,屏東縣,內埔鄉,美和村,425,1123,378,101,479,47,526
公投第７案,屏東縣,內埔鄉,美和村,426,1079,401,89,490,19,509
公投第７案,屏東縣,內埔鄉,和興村,427,1485,562,143,705,64,769
公投第７案,屏東縣,內埔鄉,和興村,428,1248,534,119,653,44,697
公投第７案,屏東縣,內埔鄉,東寧村,429,1569,567,152,719,55,774
公投第７案,屏東縣,內埔鄉,東寧村,430,1493,512,143,655,59,714
公投第７案,屏東縣,內埔鄉,東寧村,431,1420,426,173,599,16,615
公投第７案,屏東縣,內埔鄉,豐田村,432,1334,479,131,610,85,695
公投第７案,屏東縣,內埔鄉,豐田村,433,1519,519,140,659,78,737
公投第７案,屏東縣,內埔鄉,振豐村,434,784,298,76,374,49,423
公投第７案,屏東縣,內埔鄉,振豐村,435,888,350,86,436,65,501
公投第７案,屏東縣,內埔鄉,富田村,436,747,193,51,244,12,256
公投第７案,屏東縣,內埔鄉,富田村,437,1168,328,101,429,26,455
公投第７案,屏東縣,內埔鄉,竹圍村,438,546,217,62,279,33,312
公投第７案,屏東縣,內埔鄉,竹圍村,439,1278,448,130,578,58,636
公投第７案,屏東縣,內埔鄉,東勢村,440,1348,410,122,532,47,579
公投第７案,屏東縣,內埔鄉,東勢村,441,1550,425,135,560,87,647
公投第７案,屏東縣,內埔鄉,東片村,442,947,376,121,497,76,573
公投第７案,屏東縣,內埔鄉,上樹村,443,1097,372,110,482,82,564
公投第７案,屏東縣,內埔鄉,老埤村,444,1128,315,109,424,51,475
公投第７案,屏東縣,內埔鄉,老埤村,445,1253,298,82,380,24,404
公投第７案,屏東縣,內埔鄉,中林村,446,1525,393,119,512,29,541
公投第７案,屏東縣,內埔鄉,龍泉村,447,1215,445,102,547,89,636
公投第７案,屏東縣,內埔鄉,龍泉村,448,1216,370,92,462,28,490
公投第７案,屏東縣,內埔鄉,龍潭村,449,1353,450,100,550,36,586
公投第７案,屏東縣,內埔鄉,龍潭村,450,1026,364,84,448,40,488
公投第７案,屏東縣,內埔鄉,建興村,451,862,285,64,349,29,378
公投第７案,屏東縣,內埔鄉,大新村,452,921,234,83,317,32,349
公投第７案,屏東縣,內埔鄉,大新村,453,854,312,67,379,24,403
公投第７案,屏東縣,內埔鄉,黎明村,454,1230,385,95,480,37,517
公投第７案,屏東縣,內埔鄉,黎明村,455,1204,353,91,444,26,470
公投第７案,屏東縣,內埔鄉,隘寮村,456,1301,393,95,488,45,533
公投第７案,屏東縣,內埔鄉,水門村,457,806,327,73,400,46,446
公投第７案,屏東縣,竹田鄉,竹田村,458,1503,577,179,756,79,835
公投第７案,屏東縣,竹田鄉,竹南村,459,899,383,124,507,44,551
公投第７案,屏東縣,竹田鄉,糶糴村,460,716,332,78,410,40,450
公投第７案,屏東縣,竹田鄉,履豐村,461,581,257,85,342,40,382
公投第７案,屏東縣,竹田鄉,頭崙村,462,1327,487,154,641,102,743
公投第７案,屏東縣,竹田鄉,二崙村,463,997,388,148,536,84,620
公投第７案,屏東縣,竹田鄉,美崙村,464,649,261,56,317,24,341
公投第７案,屏東縣,竹田鄉,南勢村,465,476,262,58,320,25,345
公投第７案,屏東縣,竹田鄉,西勢村,466,1259,534,143,677,60,737
公投第７案,屏東縣,竹田鄉,西勢村,467,1227,455,120,575,66,641
公投第７案,屏東縣,竹田鄉,福田村,468,504,227,56,283,39,322
公投第７案,屏東縣,竹田鄉,永豐村,469,860,324,87,411,50,461
公投第７案,屏東縣,竹田鄉,六巷村,470,800,298,89,387,20,407
公投第７案,屏東縣,竹田鄉,泗洲村,471,1134,434,161,595,59,654
公投第７案,屏東縣,竹田鄉,大湖村,472,1229,458,138,596,66,662
公投第７案,屏東縣,竹田鄉,鳳明村,473,1192,436,117,553,69,622
公投第７案,屏東縣,新埤鄉,新埤村,474,1712,564,166,730,44,774
公投第７案,屏東縣,新埤鄉,新埤村,475,314,108,38,146,27,173
公投第７案,屏東縣,新埤鄉,建功村,476,752,288,82,370,37,407
公投第７案,屏東縣,新埤鄉,建功村,477,334,129,31,160,23,183
公投第７案,屏東縣,新埤鄉,打鐵村,478,957,353,118,471,64,535
公投第７案,屏東縣,新埤鄉,南豐村,479,764,308,88,396,55,451
公投第７案,屏東縣,新埤鄉,萬隆村,480,373,130,51,181,32,213
公投第７案,屏東縣,新埤鄉,萬隆村,481,678,216,64,280,33,313
公投第７案,屏東縣,新埤鄉,萬隆村,482,701,225,66,291,23,314
公投第７案,屏東縣,新埤鄉,餉潭村,483,1323,373,107,480,55,535
公投第７案,屏東縣,新埤鄉,箕湖村,484,541,219,51,270,39,309
公投第７案,屏東縣,新埤鄉,箕湖村,485,584,183,47,230,33,263
公投第７案,屏東縣,枋寮鄉,枋寮村,486,1213,481,123,604,75,679
公投第７案,屏東縣,枋寮鄉,新龍村,487,891,329,114,443,69,512
公投第７案,屏東縣,枋寮鄉,保生村,488,970,308,92,400,96,496
公投第７案,屏東縣,枋寮鄉,中寮村,489,629,243,59,302,32,334
公投第７案,屏東縣,枋寮鄉,安樂村,490,840,340,94,434,35,469
公投第７案,屏東縣,枋寮鄉,安樂村,491,774,314,81,395,43,438
公投第７案,屏東縣,枋寮鄉,隆山村,492,1379,471,158,629,82,711
公投第７案,屏東縣,枋寮鄉,隆山村,493,1502,602,137,739,68,807
公投第７案,屏東縣,枋寮鄉,隆山村,494,1276,432,142,574,80,654
公投第７案,屏東縣,枋寮鄉,天時村,495,964,347,101,448,67,515
公投第７案,屏東縣,枋寮鄉,天時村,496,1005,401,106,507,97,604
公投第７案,屏東縣,枋寮鄉,地利村,497,734,250,54,304,23,327
公投第７案,屏東縣,枋寮鄉,地利村,498,725,270,76,346,62,408
公投第７案,屏東縣,枋寮鄉,人和村,499,1046,339,101,440,73,513
公投第７案,屏東縣,枋寮鄉,人和村,500,1067,417,111,528,75,603
公投第７案,屏東縣,枋寮鄉,內寮村,501,718,159,55,214,63,277
公投第７案,屏東縣,枋寮鄉,新開村,502,903,304,73,377,49,426
公投第７案,屏東縣,枋寮鄉,東海村,503,1387,455,151,606,84,690
公投第７案,屏東縣,枋寮鄉,東海村,504,1367,501,149,650,88,738
公投第７案,屏東縣,枋寮鄉,大庄村,505,618,249,89,338,46,384
公投第７案,屏東縣,枋寮鄉,太源村,506,959,287,62,349,35,384
公投第７案,屏東縣,枋寮鄉,玉泉村,507,427,168,40,208,28,236
公投第７案,屏東縣,新園鄉,瓦磘村,508,820,332,94,426,46,472
公投第７案,屏東縣,新園鄉,瓦磘村,509,843,376,73,449,60,509
公投第７案,屏東縣,新園鄉,仙吉村,510,1242,479,108,587,56,643
公投第７案,屏東縣,新園鄉,仙吉村,511,1290,555,127,682,58,740
公投第７案,屏東縣,新園鄉,田洋村,512,1073,401,111,512,53,565
公投第７案,屏東縣,新園鄉,田洋村,513,1088,420,142,562,97,659
公投第７案,屏東縣,新園鄉,港墘村,514,845,294,82,376,44,420
公投第７案,屏東縣,新園鄉,內庄村,515,862,317,95,412,52,464
公投第７案,屏東縣,新園鄉,新東村,516,1183,389,126,515,73,588
公投第７案,屏東縣,新園鄉,新東村,517,1109,388,129,517,94,611
公投第７案,屏東縣,新園鄉,新園村,518,1119,366,102,468,14,482
公投第７案,屏東縣,新園鄉,新園村,519,1152,395,133,528,37,565
公投第７案,屏東縣,新園鄉,港西村,520,1030,396,115,511,58,569
公投第７案,屏東縣,新園鄉,港西村,521,1104,391,109,500,88,588
公投第７案,屏東縣,新園鄉,烏龍村,522,1240,389,115,504,0,504
公投第７案,屏東縣,新園鄉,興龍村,523,1120,299,96,395,26,421
公投第７案,屏東縣,新園鄉,興龍村,524,1074,425,126,551,73,624
公投第７案,屏東縣,新園鄉,中洲村,525,849,275,76,351,46,397
公投第７案,屏東縣,新園鄉,中洲村,526,749,253,95,348,64,412
公投第７案,屏東縣,新園鄉,南龍村,527,1416,481,152,633,83,716
公投第７案,屏東縣,新園鄉,五房村,528,895,317,95,412,71,483
公投第７案,屏東縣,新園鄉,五房村,529,933,376,82,458,62,520
公投第７案,屏東縣,新園鄉,五房村,530,972,354,102,456,52,508
公投第７案,屏東縣,新園鄉,鹽埔村,531,1454,393,130,523,83,606
公投第７案,屏東縣,新園鄉,鹽埔村,532,1653,628,175,803,162,965
公投第７案,屏東縣,新園鄉,鹽埔村,533,1270,412,111,523,110,633
公投第７案,屏東縣,新園鄉,共和村,534,1123,401,129,530,144,674
公投第７案,屏東縣,新園鄉,共和村,535,1198,372,120,492,122,614
公投第７案,屏東縣,崁頂鄉,崁頂村,536,1190,428,89,517,45,562
公投第７案,屏東縣,崁頂鄉,崁頂村,537,1044,431,100,531,57,588
公投第７案,屏東縣,崁頂鄉,園寮村,538,818,307,97,404,49,453
公投第７案,屏東縣,崁頂鄉,園寮村,539,1214,432,138,570,53,623
公投第７案,屏東縣,崁頂鄉,力社村,540,1325,443,120,563,31,594
公投第７案,屏東縣,崁頂鄉,圍內村,541,1253,512,120,632,67,699
公投第７案,屏東縣,崁頂鄉,洲子村,542,1039,388,90,478,50,528
公投第７案,屏東縣,崁頂鄉,北勢村,543,813,261,77,338,49,387
公投第７案,屏東縣,崁頂鄉,北勢村,544,736,241,71,312,20,332
公投第７案,屏東縣,崁頂鄉,越溪村,545,934,368,118,486,40,526
公投第７案,屏東縣,崁頂鄉,港東村,546,900,310,108,418,53,471
公投第７案,屏東縣,崁頂鄉,港東村,547,1004,375,103,478,49,527
公投第７案,屏東縣,林邊鄉,林邊村,548,1458,579,170,749,121,870
公投第７案,屏東縣,林邊鄉,光林村,549,891,359,110,469,51,520
公投第７案,屏東縣,林邊鄉,光林村,550,695,309,65,374,42,416
公投第７案,屏東縣,林邊鄉,永樂村,551,1015,392,139,531,73,604
公投第７案,屏東縣,林邊鄉,永樂村,552,1171,489,131,620,52,672
公投第７案,屏東縣,林邊鄉,永樂村,553,1003,373,98,471,54,525
公投第７案,屏東縣,林邊鄉,中林村,554,725,293,116,409,50,459
公投第７案,屏東縣,林邊鄉,仁和村,555,841,309,113,422,68,490
公投第７案,屏東縣,林邊鄉,仁和村,556,793,321,90,411,60,471
公投第７案,屏東縣,林邊鄉,田厝村,557,919,399,91,490,56,546
公投第７案,屏東縣,林邊鄉,崎峯村,558,1283,454,122,576,63,639
公投第７案,屏東縣,林邊鄉,水利村,559,783,250,76,326,45,371
公投第７案,屏東縣,林邊鄉,水利村,560,1033,327,84,411,54,465
公投第７案,屏東縣,林邊鄉,竹林村,561,1186,414,119,533,102,635
公投第７案,屏東縣,林邊鄉,竹林村,562,773,263,90,353,67,420
公投第７案,屏東縣,林邊鄉,鎮安村,563,1122,366,107,473,33,506
公投第７案,屏東縣,南州鄉,溪洲村,564,872,322,82,404,45,449
公投第７案,屏東縣,南州鄉,溪洲村,565,794,315,79,394,42,436
公投第７案,屏東縣,南州鄉,溪南村,566,962,393,107,500,56,556
公投第７案,屏東縣,南州鄉,七塊村,567,1033,397,119,516,62,578
公投第７案,屏東縣,南州鄉,萬華村,568,1007,358,103,461,50,511
公投第７案,屏東縣,南州鄉,仁里村,569,466,180,69,249,22,271
公投第７案,屏東縣,南州鄉,溪北村,570,708,299,66,365,42,407
公投第７案,屏東縣,南州鄉,米崙村,571,1044,404,120,524,67,591
公投第７案,屏東縣,南州鄉,壽元村,572,1071,306,84,390,39,429
公投第７案,屏東縣,南州鄉,同安村,573,979,313,87,400,37,437
公投第７案,屏東縣,南州鄉,南安村,574,543,192,50,242,31,273
公投第７案,屏東縣,佳冬鄉,佳冬村,575,1472,475,136,611,76,687
公投第７案,屏東縣,佳冬鄉,六根村,576,1360,398,116,514,79,593
公投第７案,屏東縣,佳冬鄉,賴家村,577,804,297,97,394,69,463
公投第７案,屏東縣,佳冬鄉,萬建村,578,925,302,103,405,81,486
公投第７案,屏東縣,佳冬鄉,萬建村,579,855,277,68,345,19,364
公投第７案,屏東縣,佳冬鄉,石光村,580,981,341,82,423,57,480
公投第７案,屏東縣,佳冬鄉,石光村,581,1007,339,92,431,56,487
公投第７案,屏東縣,佳冬鄉,玉光村,582,872,357,85,442,63,505
公投第７案,屏東縣,佳冬鄉,玉光村,583,1255,384,111,495,76,571
公投第７案,屏東縣,佳冬鄉,昌隆村,584,995,369,80,449,96,545
公投第７案,屏東縣,佳冬鄉,豐隆村,585,734,194,57,251,27,278
公投第７案,屏東縣,佳冬鄉,大同村,586,1178,350,92,442,36,478
公投第７案,屏東縣,佳冬鄉,羌園村,587,1095,333,107,440,60,500
公投第７案,屏東縣,佳冬鄉,燄溫村,588,1097,402,130,532,116,648
公投第７案,屏東縣,佳冬鄉,塭豐村,589,1273,452,141,593,62,655
公投第７案,屏東縣,佳冬鄉,塭豐村,590,1160,430,147,577,77,654
公投第７案,屏東縣,琉球鄉,本福村,591,1111,323,73,396,47,443
公投第７案,屏東縣,琉球鄉,本福村,592,972,297,72,369,55,424
公投第７案,屏東縣,琉球鄉,中福村,593,1278,464,103,567,82,649
公投第７案,屏東縣,琉球鄉,漁福村,594,976,349,64,413,82,495
公投第７案,屏東縣,琉球鄉,大福村,595,1658,538,149,687,87,774
公投第７案,屏東縣,琉球鄉,南福村,596,1146,312,69,381,58,439
公投第７案,屏東縣,琉球鄉,天福村,597,1079,308,63,371,48,419
公投第７案,屏東縣,琉球鄉,上福村,598,1613,398,69,467,29,496
公投第７案,屏東縣,琉球鄉,杉福村,599,873,317,64,381,63,444
公投第７案,屏東縣,車城鄉,海口村,600,737,208,60,268,41,309
公投第７案,屏東縣,車城鄉,田中村,601,647,154,49,203,38,241
公投第７案,屏東縣,車城鄉,福興村,602,491,159,36,195,21,216
公投第７案,屏東縣,車城鄉,福興村,603,856,285,81,366,32,398
公投第７案,屏東縣,車城鄉,福安村,604,554,159,55,214,10,224
公投第７案,屏東縣,車城鄉,統埔村,605,388,106,28,134,5,139
公投第７案,屏東縣,車城鄉,溫泉村,606,922,251,79,330,34,364
公投第７案,屏東縣,車城鄉,保力村,607,597,143,31,174,8,182
公投第７案,屏東縣,車城鄉,保力村,608,623,134,35,169,9,178
公投第７案,屏東縣,車城鄉,新街村,609,425,136,29,165,26,191
公投第７案,屏東縣,車城鄉,埔墘村,610,428,165,29,194,21,215
公投第７案,屏東縣,車城鄉,射寮村,611,504,123,30,153,11,164
公投第７案,屏東縣,車城鄉,後灣村,612,423,144,38,182,23,205
公投第７案,屏東縣,滿州鄉,滿州村,613,1575,534,140,674,49,723
公投第７案,屏東縣,滿州鄉,里德村,614,420,146,29,175,9,184
公投第７案,屏東縣,滿州鄉,响林村,615,602,256,64,320,29,349
公投第７案,屏東縣,滿州鄉,永靖村,616,1302,350,83,433,24,457
公投第７案,屏東縣,滿州鄉,港口村,617,1314,429,114,543,60,603
公投第７案,屏東縣,滿州鄉,長樂村,618,1308,287,73,360,30,390
公投第７案,屏東縣,滿州鄉,九棚村,619,367,95,26,121,14,135
公投第７案,屏東縣,滿州鄉,港仔村,620,318,114,27,141,25,166
公投第７案,屏東縣,枋山鄉,枋山村,621,604,267,69,336,31,367
公投第７案,屏東縣,枋山鄉,枋山村,622,428,178,48,226,33,259
公投第７案,屏東縣,枋山鄉,加祿村,623,928,396,115,511,67,578
公投第７案,屏東縣,枋山鄉,加祿村,624,972,339,96,435,21,456
公投第７案,屏東縣,枋山鄉,楓港村,625,1041,304,91,395,61,456
公投第７案,屏東縣,枋山鄉,善餘村,626,883,205,65,270,23,293
公投第７案,屏東縣,三地門鄉,大社村,627,616,193,48,241,18,259
公投第７案,屏東縣,三地門鄉,德文村,628,572,223,66,289,58,347
公投第７案,屏東縣,三地門鄉,達來村,629,323,103,23,126,15,141
公投第７案,屏東縣,三地門鄉,三地村,630,1448,575,159,734,59,793
公投第７案,屏東縣,三地門鄉,賽嘉村,631,726,166,40,206,7,213
公投第７案,屏東縣,三地門鄉,口社村,632,554,199,61,260,27,287
公投第７案,屏東縣,三地門鄉,馬兒村,633,346,125,40,165,15,180
公投第７案,屏東縣,三地門鄉,安坡村,634,458,118,37,155,1,156
公投第７案,屏東縣,三地門鄉,青山村,635,692,280,66,346,11,357
公投第７案,屏東縣,三地門鄉,青葉村,636,638,313,66,379,68,447
公投第７案,屏東縣,霧臺鄉,霧台村,637,346,191,46,237,29,266
公投第７案,屏東縣,霧臺鄉,霧台村,638,677,262,61,323,14,337
公投第７案,屏東縣,霧臺鄉,霧台村,639,162,40,9,49,0,49
公投第７案,屏東縣,霧臺鄉,吉露村,640,189,71,15,86,4,90
公投第７案,屏東縣,霧臺鄉,阿禮村,641,296,151,24,175,35,210
公投第７案,屏東縣,霧臺鄉,好茶村,642,483,194,62,256,11,267
公投第７案,屏東縣,霧臺鄉,佳暮村,643,347,100,32,132,2,134
公投第７案,屏東縣,霧臺鄉,大武村,644,450,142,52,194,14,208
公投第７案,屏東縣,瑪家鄉,瑪家村,645,455,163,49,212,2,214
公投第７案,屏東縣,瑪家鄉,北葉村,646,821,357,140,497,45,542
公投第７案,屏東縣,瑪家鄉,三和村,647,635,296,95,391,72,463
公投第７案,屏東縣,瑪家鄉,三和村,648,695,388,94,482,33,515
公投第７案,屏東縣,瑪家鄉,三和村,649,671,330,68,398,29,427
公投第７案,屏東縣,瑪家鄉,凉山村,650,1057,323,91,414,12,426
公投第７案,屏東縣,瑪家鄉,佳義村,651,900,381,84,465,18,483
公投第７案,屏東縣,瑪家鄉,排灣村,652,429,156,36,192,12,204
公投第７案,屏東縣,泰武鄉,佳平村,653,669,286,58,344,12,356
公投第７案,屏東縣,泰武鄉,佳平村,654,190,62,23,85,8,93
公投第７案,屏東縣,泰武鄉,武潭村,655,922,406,126,532,75,607
公投第７案,屏東縣,泰武鄉,平和村,656,598,292,94,386,57,443
公投第７案,屏東縣,泰武鄉,萬安村,657,771,386,66,452,51,503
公投第７案,屏東縣,泰武鄉,佳興村,658,414,188,65,253,49,302
公投第７案,屏東縣,泰武鄉,泰武村,659,780,275,83,358,35,393
公投第７案,屏東縣,來義鄉,來義村,660,917,417,73,490,101,591
公投第７案,屏東縣,來義鄉,義林村,661,361,136,32,168,12,180
公投第７案,屏東縣,來義鄉,義林村,662,216,59,13,72,2,74
公投第７案,屏東縣,來義鄉,丹林村,663,445,268,43,311,25,336
公投第７案,屏東縣,來義鄉,丹林村,664,280,131,23,154,28,182
公投第７案,屏東縣,來義鄉,古樓村,665,1097,511,88,599,50,649
公投第７案,屏東縣,來義鄉,文樂村,666,840,407,84,491,69,560
公投第７案,屏東縣,來義鄉,望嘉村,667,889,311,88,399,23,422
公投第７案,屏東縣,來義鄉,南和村,668,1212,415,110,525,52,577
公投第７案,屏東縣,春日鄉,春日村,669,909,147,40,187,6,193
公投第７案,屏東縣,春日鄉,古華村,670,663,126,56,182,18,200
公投第７案,屏東縣,春日鄉,士文村,671,304,34,6,40,0,40
公投第７案,屏東縣,春日鄉,七佳村,672,928,262,58,320,19,339
公投第７案,屏東縣,春日鄉,歸崇村,673,641,120,32,152,10,162
公投第７案,屏東縣,春日鄉,力里村,674,478,78,23,101,3,104
公投第７案,屏東縣,獅子鄉,楓林村,675,751,291,42,333,21,354
公投第７案,屏東縣,獅子鄉,丹路村,676,776,267,59,326,28,354
公投第７案,屏東縣,獅子鄉,草埔村,677,711,222,33,255,16,271
公投第７案,屏東縣,獅子鄉,內文村,678,243,108,44,152,30,182
公投第７案,屏東縣,獅子鄉,竹坑村,679,325,132,35,167,11,178
公投第７案,屏東縣,獅子鄉,獅子村,680,476,102,24,126,5,131
公投第７案,屏東縣,獅子鄉,內獅村,681,602,185,37,222,11,233
公投第７案,屏東縣,獅子鄉,南世村,682,346,102,13,115,7,122
公投第７案,屏東縣,牡丹鄉,石門村,683,342,104,28,132,11,143
公投第７案,屏東縣,牡丹鄉,石門村,684,1306,518,93,611,52,663
公投第７案,屏東縣,牡丹鄉,牡丹村,685,693,135,26,161,6,167
公投第７案,屏東縣,牡丹鄉,東源村,686,437,120,31,151,9,160
公投第７案,屏東縣,牡丹鄉,旭海村,687,392,149,36,185,9,194
公投第７案,屏東縣,牡丹鄉,高士村,688,593,217,47,264,10,274
公投第７案,屏東縣,牡丹鄉,四林村,689,551,105,19,124,7,131
公投第７案,臺東縣,臺東市,文化里,1,874,332,72,404,24,428
公投第７案,臺東縣,臺東市,民族里,2,1469,688,148,836,68,904
公投第７案,臺東縣,臺東市,自強里,3,1259,523,142,665,30,695
公投第７案,臺東縣,臺東市,自強里,4,1399,564,161,725,39,764
公投第７案,臺東縣,臺東市,自強里,5,1363,665,130,795,45,840
公投第７案,臺東縣,臺東市,民生里,6,1651,682,166,848,43,891
公投第７案,臺東縣,臺東市,民生里,7,1490,693,179,872,53,925
公投第７案,臺東縣,臺東市,寶桑里,8,859,347,69,416,29,445
公投第７案,臺東縣,臺東市,民權里,9,890,422,86,508,28,536
公投第７案,臺東縣,臺東市,四維里,10,651,263,78,341,35,376
公投第７案,臺東縣,臺東市,中華里,11,1650,582,184,766,57,823
公投第７案,臺東縣,臺東市,仁愛里,12,724,318,99,417,33,450
公投第７案,臺東縣,臺東市,強國里,13,632,286,67,353,28,381
公投第７案,臺東縣,臺東市,大同里,14,771,346,79,425,37,462
公投第７案,臺東縣,臺東市,成功里,15,798,297,83,380,27,407
公投第７案,臺東縣,臺東市,建國里,16,1299,488,145,633,87,720
公投第７案,臺東縣,臺東市,中正里,17,811,366,89,455,32,487
公投第７案,臺東縣,臺東市,中山里,18,764,366,85,451,38,489
公投第７案,臺東縣,臺東市,興國里,19,784,300,75,375,18,393
公投第７案,臺東縣,臺東市,鐵花里,20,427,159,33,192,15,207
公投第７案,臺東縣,臺東市,東海里,21,1292,487,115,602,36,638
公投第７案,臺東縣,臺東市,東海里,22,1501,671,143,814,21,835
公投第７案,臺東縣,臺東市,復國里,23,601,227,49,276,20,296
公投第７案,臺東縣,臺東市,復興里,24,417,164,31,195,8,203
公投第７案,臺東縣,臺東市,新興里,25,1001,431,82,513,42,555
公投第７案,臺東縣,臺東市,新生里,26,1638,725,181,906,45,951
公投第７案,臺東縣,臺東市,新生里,27,1576,670,152,822,49,871
公投第７案,臺東縣,臺東市,新生里,28,1595,704,133,837,59,896
公投第７案,臺東縣,臺東市,新生里,29,1734,767,152,919,48,967
公投第７案,臺東縣,臺東市,中心里,30,1476,646,145,791,52,843
公投第７案,臺東縣,臺東市,中心里,31,1545,723,156,879,47,926
公投第７案,臺東縣,臺東市,馬蘭里,32,1313,611,129,740,47,787
公投第７案,臺東縣,臺東市,馬蘭里,33,1338,652,126,778,38,816
公投第７案,臺東縣,臺東市,光明里,34,1312,572,104,676,30,706
公投第７案,臺東縣,臺東市,光明里,35,1265,538,140,678,46,724
公投第７案,臺東縣,臺東市,豐年里,36,1407,464,150,614,63,677
公投第７案,臺東縣,臺東市,豐年里,37,1552,596,121,717,40,757
公投第７案,臺東縣,臺東市,豐樂里,38,1445,610,129,739,72,811
公投第７案,臺東縣,臺東市,永樂里,39,2098,921,206,1127,62,1189
公投第７案,臺東縣,臺東市,康樂里,40,1324,567,137,704,79,783
公投第７案,臺東縣,臺東市,豐榮里,41,1598,688,115,803,38,841
公投第７案,臺東縣,臺東市,豐榮里,42,1513,623,122,745,29,774
公投第７案,臺東縣,臺東市,豐榮里,43,1679,654,121,775,69,844
公投第７案,臺東縣,臺東市,豐榮里,44,1414,518,155,673,65,738
公投第７案,臺東縣,臺東市,豐榮里,45,1798,735,163,898,54,952
公投第７案,臺東縣,臺東市,豐谷里,46,1749,579,156,735,63,798
公投第７案,臺東縣,臺東市,豐谷里,47,1709,693,155,848,90,938
公投第７案,臺東縣,臺東市,豐谷里,48,1629,648,123,771,53,824
公投第７案,臺東縣,臺東市,豐里里,49,1116,411,116,527,63,590
公投第７案,臺東縣,臺東市,豐里里,50,1259,413,99,512,28,540
公投第７案,臺東縣,臺東市,豐原里,51,1232,408,104,512,36,548
公投第７案,臺東縣,臺東市,富岡里,52,1505,501,162,663,108,771
公投第７案,臺東縣,臺東市,富豐里,53,836,269,78,347,57,404
公投第７案,臺東縣,臺東市,南榮里,54,1294,556,128,684,48,732
公投第７案,臺東縣,臺東市,南榮里,55,1350,526,140,666,55,721
公投第７案,臺東縣,臺東市,岩灣里,56,2162,940,186,1126,70,1196
公投第７案,臺東縣,臺東市,卑南里,57,1627,758,170,928,35,963
公投第７案,臺東縣,臺東市,卑南里,58,1140,488,119,607,54,661
公投第７案,臺東縣,臺東市,南王里,59,1359,537,116,653,45,698
公投第７案,臺東縣,臺東市,南王里,60,1329,532,151,683,56,739
公投第７案,臺東縣,臺東市,豐田里,61,990,381,97,478,37,515
公投第７案,臺東縣,臺東市,豐田里,62,1038,420,107,527,58,585
公投第７案,臺東縣,臺東市,新園里,63,1597,594,164,758,76,834
公投第７案,臺東縣,臺東市,建和里,64,1385,533,132,665,80,745
公投第７案,臺東縣,臺東市,建興里,65,939,308,83,391,17,408
公投第７案,臺東縣,臺東市,建業里,66,1258,382,104,486,62,548
公投第７案,臺東縣,臺東市,知本里,67,1350,478,147,625,11,636
公投第７案,臺東縣,臺東市,建農里,68,1058,370,78,448,27,475
公投第７案,臺東縣,臺東市,建農里,69,895,258,78,336,30,366
公投第７案,臺東縣,成功鎮,信義里,70,516,173,43,216,43,259
公投第７案,臺東縣,成功鎮,信義里,71,960,366,154,520,64,584
公投第７案,臺東縣,成功鎮,信義里,72,365,86,17,103,15,118
公投第７案,臺東縣,成功鎮,和平里,73,747,218,69,287,58,345
公投第７案,臺東縣,成功鎮,忠仁里,74,339,102,31,133,26,159
公投第７案,臺東縣,成功鎮,忠仁里,75,995,340,82,422,29,451
公投第７案,臺東縣,成功鎮,忠仁里,76,863,333,98,431,53,484
公投第７案,臺東縣,成功鎮,忠智里,77,931,386,76,462,45,507
公投第７案,臺東縣,成功鎮,忠智里,78,970,370,73,443,33,476
公投第７案,臺東縣,成功鎮,三民里,79,1365,489,98,587,104,691
公投第７案,臺東縣,成功鎮,三民里,80,1366,525,118,643,78,721
公投第７案,臺東縣,成功鎮,三仙里,81,516,153,48,201,62,263
公投第７案,臺東縣,成功鎮,三仙里,82,887,225,68,293,82,375
公投第７案,臺東縣,成功鎮,忠孝里,83,488,127,46,173,44,217
公投第７案,臺東縣,成功鎮,忠孝里,84,481,116,38,154,41,195
公投第７案,臺東縣,成功鎮,博愛里,85,373,58,15,73,2,75
公投第７案,臺東縣,成功鎮,博愛里,86,264,90,32,122,23,145
公投第７案,臺東縣,關山鎮,里壠里,87,909,415,96,511,25,536
公投第７案,臺東縣,關山鎮,里壠里,88,790,265,52,317,20,337
公投第７案,臺東縣,關山鎮,中福里,89,828,379,85,464,36,500
公投第７案,臺東縣,關山鎮,新福里,90,887,270,76,346,23,369
公投第７案,臺東縣,關山鎮,豐泉里,91,1137,495,96,591,26,617
公投第７案,臺東縣,關山鎮,月眉里,92,732,252,66,318,32,350
公投第７案,臺東縣,關山鎮,德高里,93,912,343,90,433,35,468
公投第７案,臺東縣,關山鎮,德高里,94,779,233,46,279,20,299
公投第７案,臺東縣,關山鎮,電光里,95,535,164,24,188,15,203
公投第７案,臺東縣,卑南鄉,賓朗村,96,1041,413,129,542,58,600
公投第７案,臺東縣,卑南鄉,賓朗村,97,1165,440,87,527,40,567
公投第７案,臺東縣,卑南鄉,美農村,98,219,56,20,76,20,96
公投第７案,臺東縣,卑南鄉,美農村,99,460,152,33,185,29,214
公投第７案,臺東縣,卑南鄉,美農村,100,387,112,28,140,15,155
公投第７案,臺東縣,卑南鄉,初鹿村,101,767,248,57,305,25,330
公投第７案,臺東縣,卑南鄉,初鹿村,102,503,192,42,234,36,270
公投第７案,臺東縣,卑南鄉,明峰村,103,727,233,74,307,39,346
公投第７案,臺東縣,卑南鄉,明峰村,104,436,157,39,196,33,229
公投第７案,臺東縣,卑南鄉,嘉豐村,105,261,49,36,85,11,96
公投第７案,臺東縣,卑南鄉,嘉豐村,106,215,69,34,103,12,115
公投第７案,臺東縣,卑南鄉,太平村,107,1442,609,134,743,60,803
公投第７案,臺東縣,卑南鄉,太平村,108,527,208,42,250,12,262
公投第７案,臺東縣,卑南鄉,太平村,109,1046,397,124,521,58,579
公投第７案,臺東縣,卑南鄉,泰安村,110,1110,399,125,524,72,596
公投第７案,臺東縣,卑南鄉,利嘉村,111,1105,462,110,572,56,628
公投第７案,臺東縣,卑南鄉,東興村,112,1167,467,132,599,129,728
公投第７案,臺東縣,卑南鄉,溫泉村,113,968,305,113,418,52,470
公投第７案,臺東縣,卑南鄉,溫泉村,114,159,42,13,55,2,57
公投第７案,臺東縣,卑南鄉,富山村,115,488,163,37,200,19,219
公投第７案,臺東縣,卑南鄉,富源村,116,347,150,36,186,18,204
公投第７案,臺東縣,卑南鄉,利吉村,117,436,170,33,203,23,226
公投第７案,臺東縣,鹿野鄉,鹿野村,118,522,146,35,181,8,189
公投第７案,臺東縣,鹿野鄉,鹿野村,119,574,213,69,282,25,307
公投第７案,臺東縣,鹿野鄉,龍田村,120,1055,288,88,376,38,414
公投第７案,臺東縣,鹿野鄉,永安村,121,1104,373,104,477,37,514
公投第７案,臺東縣,鹿野鄉,永安村,122,342,115,25,140,14,154
公投第７案,臺東縣,鹿野鄉,瑞隆村,123,895,283,92,375,44,419
公投第７案,臺東縣,鹿野鄉,瑞源村,124,864,267,94,361,48,409
公投第７案,臺東縣,鹿野鄉,瑞和村,125,675,174,69,243,45,288
公投第７案,臺東縣,鹿野鄉,瑞豐村,126,435,146,50,196,17,213
公投第７案,臺東縣,鹿野鄉,瑞豐村,127,470,109,48,157,23,180
公投第７案,臺東縣,池上鄉,福原村,128,992,355,78,433,28,461
公投第７案,臺東縣,池上鄉,福原村,129,929,385,78,463,47,510
公投第７案,臺東縣,池上鄉,福文村,130,434,145,41,186,24,210
公投第７案,臺東縣,池上鄉,福文村,131,703,203,70,273,33,306
公投第７案,臺東縣,池上鄉,慶豐村,132,654,201,40,241,20,261
公投第７案,臺東縣,池上鄉,大坡村,133,324,86,27,113,15,128
公投第７案,臺東縣,池上鄉,大埔村,134,794,245,77,322,36,358
公投第７案,臺東縣,池上鄉,新興村,135,856,314,60,374,40,414
公投第７案,臺東縣,池上鄉,錦園村,136,344,106,22,128,13,141
公投第７案,臺東縣,池上鄉,萬安村,137,311,128,24,152,19,171
公投第７案,臺東縣,池上鄉,富興村,138,386,82,36,118,18,136
公投第７案,臺東縣,池上鄉,振興村,139,435,103,32,135,18,153
公投第７案,臺東縣,東河鄉,都蘭村,140,290,79,20,99,23,122
公投第７案,臺東縣,東河鄉,都蘭村,141,620,241,57,298,38,336
公投第７案,臺東縣,東河鄉,都蘭村,142,1196,469,166,635,104,739
公投第７案,臺東縣,東河鄉,興昌村,143,918,255,81,336,92,428
公投第７案,臺東縣,東河鄉,隆昌村,144,555,174,39,213,44,257
公投第７案,臺東縣,東河鄉,東河村,145,977,276,87,363,30,393
公投第７案,臺東縣,東河鄉,泰源村,146,1197,219,60,279,13,292
公投第７案,臺東縣,東河鄉,北源村,147,867,143,37,180,29,209
公投第７案,臺東縣,東河鄉,北源村,148,345,99,30,129,19,148
公投第７案,臺東縣,東河鄉,北源村,149,408,109,39,148,20,168
公投第７案,臺東縣,東河鄉,尚德村,150,262,85,20,105,9,114
公投第７案,臺東縣,長濱鄉,寧埔村,151,536,189,71,260,49,309
公投第７案,臺東縣,長濱鄉,寧埔村,152,689,157,34,191,28,219
公投第７案,臺東縣,長濱鄉,竹湖村,153,913,291,105,396,103,499
公投第７案,臺東縣,長濱鄉,長濱村,154,1268,336,65,401,24,425
公投第７案,臺東縣,長濱鄉,長濱村,155,725,194,83,277,58,335
公投第７案,臺東縣,長濱鄉,忠勇村,156,532,100,27,127,6,133
公投第７案,臺東縣,長濱鄉,三間村,157,660,165,53,218,61,279
公投第７案,臺東縣,長濱鄉,三間村,158,336,53,8,61,4,65
公投第７案,臺東縣,長濱鄉,三間村,159,195,43,7,50,14,64
公投第７案,臺東縣,長濱鄉,樟原村,160,25,10,1,11,2,13
公投第７案,臺東縣,長濱鄉,樟原村,161,605,148,42,190,60,250
公投第７案,臺東縣,太麻里鄉,美和村,162,722,272,64,336,48,384
公投第７案,臺東縣,太麻里鄉,美和村,163,575,209,59,268,21,289
公投第７案,臺東縣,太麻里鄉,三和村,164,623,210,68,278,32,310
公投第７案,臺東縣,太麻里鄉,華源村,165,622,187,56,243,51,294
公投第７案,臺東縣,太麻里鄉,北里村,166,560,159,35,194,13,207
公投第７案,臺東縣,太麻里鄉,大王村,167,957,336,89,425,100,525
公投第７案,臺東縣,太麻里鄉,大王村,168,809,226,95,321,36,357
公投第７案,臺東縣,太麻里鄉,泰和村,169,673,290,81,371,43,414
公投第７案,臺東縣,太麻里鄉,泰和村,170,737,265,65,330,49,379
公投第７案,臺東縣,太麻里鄉,香蘭村,171,424,151,55,206,32,238
公投第７案,臺東縣,太麻里鄉,香蘭村,172,374,104,53,157,22,179
公投第７案,臺東縣,太麻里鄉,金崙村,173,829,202,55,257,20,277
公投第７案,臺東縣,太麻里鄉,金崙村,174,869,212,51,263,6,269
公投第７案,臺東縣,太麻里鄉,多良村,175,223,47,13,60,4,64
公投第７案,臺東縣,太麻里鄉,多良村,176,669,259,59,318,44,362
公投第７案,臺東縣,大武鄉,南興村,177,568,209,57,266,66,332
公投第７案,臺東縣,大武鄉,尚武村,178,1474,445,124,569,151,720
公投第７案,臺東縣,大武鄉,大武村,179,1327,466,130,596,110,706
公投第７案,臺東縣,大武鄉,大鳥村,180,1134,319,104,423,110,533
公投第７案,臺東縣,大武鄉,大竹村,181,386,118,34,152,61,213
公投第７案,臺東縣,大武鄉,大竹村,182,377,101,36,137,30,167
公投第７案,臺東縣,綠島鄉,南寮村,183,1474,470,99,569,30,599
公投第７案,臺東縣,綠島鄉,中寮村,184,1082,361,78,439,34,473
公投第７案,臺東縣,綠島鄉,公舘村,185,813,282,76,358,23,381
公投第７案,臺東縣,綠島鄉,公舘村,186,210,70,23,93,3,96
公投第７案,臺東縣,海端鄉,加拿村,187,497,169,58,227,36,263
公投第７案,臺東縣,海端鄉,崁頂村,188,569,222,73,295,35,330
公投第７案,臺東縣,海端鄉,海端村,189,971,318,103,421,58,479
公投第７案,臺東縣,海端鄉,廣原村,190,728,270,83,353,40,393
公投第７案,臺東縣,海端鄉,霧鹿村,191,259,91,33,124,16,140
公投第７案,臺東縣,海端鄉,利稻村,192,254,81,33,114,12,126
公投第７案,臺東縣,延平鄉,桃源村,193,1014,342,101,443,59,502
公投第７案,臺東縣,延平鄉,紅葉村,194,426,169,61,230,66,296
公投第７案,臺東縣,延平鄉,永康村,195,315,148,35,183,24,207
公投第７案,臺東縣,延平鄉,武陵村,196,579,160,55,215,15,230
公投第７案,臺東縣,延平鄉,鸞山村,197,596,189,59,248,26,274
公投第７案,臺東縣,金峰鄉,嘉蘭村,198,1241,355,118,473,62,535
公投第７案,臺東縣,金峰鄉,正興村,199,601,251,59,310,34,344
公投第７案,臺東縣,金峰鄉,新興村,200,520,266,75,341,52,393
公投第７案,臺東縣,金峰鄉,賓茂村,201,336,127,35,162,27,189
公投第７案,臺東縣,金峰鄉,歷坵村,202,330,91,31,122,30,152
公投第７案,臺東縣,達仁鄉,安朔村,203,246,101,27,128,26,154
公投第７案,臺東縣,達仁鄉,安朔村,204,340,178,29,207,11,218
公投第７案,臺東縣,達仁鄉,南田村,205,296,138,43,181,14,195
公投第７案,臺東縣,達仁鄉,森永村,206,429,188,39,227,37,264
公投第７案,臺東縣,達仁鄉,新化村,207,331,144,40,184,27,211
公投第７案,臺東縣,達仁鄉,台坂村,208,628,167,67,234,23,257
公投第７案,臺東縣,達仁鄉,土坂村,209,867,324,92,416,50,466
公投第７案,臺東縣,蘭嶼鄉,椰油村,210,943,252,87,339,29,368
公投第７案,臺東縣,蘭嶼鄉,紅頭村,211,1238,372,114,486,23,509
公投第７案,臺東縣,蘭嶼鄉,東清村,212,1240,223,117,340,21,361
公投第７案,臺東縣,蘭嶼鄉,朗島村,213,760,173,66,239,40,279
公投第７案,花蓮縣,花蓮市,民德里,1,1522,669,159,828,33,861
公投第７案,花蓮縣,花蓮市,民勤里,2,1114,511,114,625,26,651
公投第７案,花蓮縣,花蓮市,民勤里,3,670,283,74,357,19,376
公投第７案,花蓮縣,花蓮市,民勤里,4,1397,594,119,713,24,737
公投第７案,花蓮縣,花蓮市,民意里,5,470,179,41,220,18,238
公投第７案,花蓮縣,花蓮市,民意里,6,838,347,59,406,25,431
公投第７案,花蓮縣,花蓮市,民意里,7,721,250,39,289,11,300
公投第７案,花蓮縣,花蓮市,民心里,8,918,409,85,494,34,528
公投第７案,花蓮縣,花蓮市,民享里,9,1539,625,148,773,35,808
公投第７案,花蓮縣,花蓮市,民享里,10,1403,577,110,687,58,745
公投第７案,花蓮縣,花蓮市,民孝里,11,1068,441,99,540,24,564
公投第７案,花蓮縣,花蓮市,民孝里,12,1167,515,105,620,23,643
公投第７案,花蓮縣,花蓮市,民孝里,13,1259,578,119,697,51,748
公投第７案,花蓮縣,花蓮市,民運里,14,1071,440,101,541,71,612
公投第７案,花蓮縣,花蓮市,民運里,15,925,393,98,491,36,527
公投第７案,花蓮縣,花蓮市,民政里,16,1141,530,137,667,43,710
公投第７案,花蓮縣,花蓮市,民政里,17,1163,471,98,569,26,595
公投第７案,花蓮縣,花蓮市,民政里,18,1279,590,111,701,39,740
公投第７案,花蓮縣,花蓮市,民立里,19,1512,559,130,689,26,715
公投第７案,花蓮縣,花蓮市,民樂里,20,615,251,62,313,20,333
公投第７案,花蓮縣,花蓮市,民有里,21,606,246,90,336,12,348
公投第７案,花蓮縣,花蓮市,民主里,22,559,218,46,264,14,278
公投第７案,花蓮縣,花蓮市,民族里,23,442,189,40,229,17,246
公投第７案,花蓮縣,花蓮市,民生里,24,1114,438,94,532,29,561
公投第７案,花蓮縣,花蓮市,民權里,25,416,177,35,212,23,235
公投第７案,花蓮縣,花蓮市,主商里,26,577,255,78,333,18,351
公投第７案,花蓮縣,花蓮市,主勤里,27,810,383,85,468,26,494
公投第７案,花蓮縣,花蓮市,主工里,28,538,240,50,290,20,310
公投第７案,花蓮縣,花蓮市,主信里,29,566,227,56,283,26,309
公投第７案,花蓮縣,花蓮市,主義里,30,469,201,38,239,7,246
公投第７案,花蓮縣,花蓮市,主睦里,31,565,254,51,305,18,323
公投第７案,花蓮縣,花蓮市,主計里,32,816,310,57,367,33,400
公投第７案,花蓮縣,花蓮市,主和里,33,911,357,78,435,41,476
公投第７案,花蓮縣,花蓮市,主和里,34,1029,413,84,497,40,537
公投第７案,花蓮縣,花蓮市,主和里,35,1043,480,97,577,38,615
公投第７案,花蓮縣,花蓮市,主學里,36,856,390,82,472,16,488
公投第７案,花蓮縣,花蓮市,主學里,37,979,396,120,516,30,546
公投第７案,花蓮縣,花蓮市,主農里,38,1331,567,139,706,45,751
公投第７案,花蓮縣,花蓮市,主農里,39,1228,546,116,662,30,692
公投第７案,花蓮縣,花蓮市,主農里,40,955,417,97,514,30,544
公投第７案,花蓮縣,花蓮市,主安里,41,1268,505,107,612,28,640
公投第７案,花蓮縣,花蓮市,主安里,42,1230,489,127,616,29,645
公投第７案,花蓮縣,花蓮市,主權里,43,1369,603,119,722,49,771
公投第７案,花蓮縣,花蓮市,主權里,44,1435,502,107,609,29,638
公投第７案,花蓮縣,花蓮市,主權里,45,1164,488,120,608,32,640
公投第７案,花蓮縣,花蓮市,主權里,46,1249,566,124,690,45,735
公投第７案,花蓮縣,花蓮市,主力里,47,1184,497,109,606,50,656
公投第７案,花蓮縣,花蓮市,主力里,48,1490,608,134,742,40,782
公投第７案,花蓮縣,花蓮市,國風里,49,1022,519,89,608,34,642
公投第７案,花蓮縣,花蓮市,國風里,50,1135,476,125,601,36,637
公投第７案,花蓮縣,花蓮市,國風里,51,1084,484,96,580,30,610
公投第７案,花蓮縣,花蓮市,國威里,52,1339,376,91,467,32,499
公投第７案,花蓮縣,花蓮市,國威里,53,501,237,51,288,12,300
公投第７案,花蓮縣,花蓮市,國治里,54,904,395,81,476,21,497
公投第７案,花蓮縣,花蓮市,國安里,55,490,228,61,289,15,304
公投第７案,花蓮縣,花蓮市,國光里,56,1192,441,99,540,25,565
公投第７案,花蓮縣,花蓮市,國防里,57,869,335,80,415,20,435
公投第７案,花蓮縣,花蓮市,國華里,58,1267,547,90,637,37,674
公投第７案,花蓮縣,花蓮市,國華里,59,959,415,96,511,41,552
公投第７案,花蓮縣,花蓮市,國魂里,60,993,438,76,514,26,540
公投第７案,花蓮縣,花蓮市,國魂里,61,982,406,99,505,47,552
公投第７案,花蓮縣,花蓮市,國聯里,62,1311,486,117,603,15,618
公投第７案,花蓮縣,花蓮市,國聯里,63,1455,553,144,697,50,747
公投第７案,花蓮縣,花蓮市,國盛里,64,1151,417,101,518,18,536
公投第７案,花蓮縣,花蓮市,國盛里,65,1237,473,116,589,21,610
公投第７案,花蓮縣,花蓮市,國盛里,66,1339,500,107,607,37,644
公投第７案,花蓮縣,花蓮市,國強里,67,715,327,64,391,23,414
公投第７案,花蓮縣,花蓮市,國強里,68,1000,421,98,519,34,553
公投第７案,花蓮縣,花蓮市,國富里,69,1410,529,134,663,35,698
公投第７案,花蓮縣,花蓮市,國富里,70,1303,551,120,671,13,684
公投第７案,花蓮縣,花蓮市,國富里,71,1256,537,103,640,32,672
公投第７案,花蓮縣,花蓮市,國富里,72,1105,477,117,594,42,636
公投第７案,花蓮縣,花蓮市,國裕里,73,1089,424,112,536,21,557
公投第７案,花蓮縣,花蓮市,國裕里,74,1043,403,91,494,18,512
公投第７案,花蓮縣,花蓮市,國裕里,75,1080,515,80,595,25,620
公投第７案,花蓮縣,花蓮市,國裕里,76,971,443,79,522,27,549
公投第７案,花蓮縣,花蓮市,國慶里,77,1068,472,104,576,34,610
公投第７案,花蓮縣,花蓮市,國興里,78,1379,552,114,666,24,690
公投第７案,花蓮縣,花蓮市,國興里,79,1362,539,133,672,45,717
公投第７案,花蓮縣,花蓮市,國興里,80,1323,596,127,723,33,756
公投第７案,花蓮縣,花蓮市,國福里,81,1482,488,142,630,44,674
公投第７案,花蓮縣,新城鄉,新城村,82,367,160,37,197,17,214
公投第７案,花蓮縣,新城鄉,新城村,83,929,357,73,430,9,439
公投第７案,花蓮縣,新城鄉,順安村,84,590,231,75,306,48,354
公投第７案,花蓮縣,新城鄉,順安村,85,307,111,41,152,21,173
公投第７案,花蓮縣,新城鄉,康樂村,86,260,117,23,140,20,160
公投第７案,花蓮縣,新城鄉,康樂村,87,1283,544,119,663,57,720
公投第７案,花蓮縣,新城鄉,康樂村,88,885,357,64,421,19,440
公投第７案,花蓮縣,新城鄉,大漢村,89,770,331,81,412,26,438
公投第７案,花蓮縣,新城鄉,大漢村,90,1363,558,125,683,58,741
公投第７案,花蓮縣,新城鄉,大漢村,91,366,145,38,183,9,192
公投第７案,花蓮縣,新城鄉,北埔村,92,1163,433,115,548,43,591
公投第７案,花蓮縣,新城鄉,北埔村,93,1605,639,154,793,45,838
公投第７案,花蓮縣,新城鄉,北埔村,94,1194,492,102,594,43,637
公投第７案,花蓮縣,新城鄉,佳林村,95,979,429,80,509,43,552
公投第７案,花蓮縣,新城鄉,嘉里村,96,1485,648,140,788,33,821
公投第７案,花蓮縣,新城鄉,嘉里村,97,1070,437,87,524,35,559
公投第７案,花蓮縣,新城鄉,嘉里村,98,1164,497,111,608,26,634
公投第７案,花蓮縣,新城鄉,嘉新村,99,880,340,76,416,51,467
公投第７案,花蓮縣,新城鄉,嘉新村,100,369,137,34,171,18,189
公投第７案,花蓮縣,秀林鄉,和平村,101,867,322,88,410,30,440
公投第７案,花蓮縣,秀林鄉,和平村,102,575,196,71,267,24,291
公投第７案,花蓮縣,秀林鄉,崇德村,103,1373,353,113,466,50,516
公投第７案,花蓮縣,秀林鄉,富世村,104,1644,520,112,632,72,704
公投第７案,花蓮縣,秀林鄉,富世村,105,162,69,11,80,9,89
公投第７案,花蓮縣,秀林鄉,秀林村,106,384,119,49,168,25,193
公投第７案,花蓮縣,秀林鄉,秀林村,107,1382,445,90,535,39,574
公投第７案,花蓮縣,秀林鄉,景美村,108,1125,383,99,482,26,508
公投第７案,花蓮縣,秀林鄉,景美村,109,627,216,58,274,11,285
公投第７案,花蓮縣,秀林鄉,佳民村,110,987,443,106,549,52,601
公投第７案,花蓮縣,秀林鄉,水源村,111,1139,485,124,609,90,699
公投第７案,花蓮縣,秀林鄉,銅門村,112,1213,471,94,565,8,573
公投第７案,花蓮縣,秀林鄉,文蘭村,113,754,285,73,358,28,386
公投第７案,花蓮縣,秀林鄉,文蘭村,114,330,108,21,129,13,142
公投第７案,花蓮縣,吉安鄉,永安村,115,1059,420,100,520,34,554
公投第７案,花蓮縣,吉安鄉,永安村,116,983,436,80,516,29,545
公投第７案,花蓮縣,吉安鄉,永安村,117,1031,452,76,528,34,562
公投第７案,花蓮縣,吉安鄉,永安村,118,1105,427,110,537,27,564
公投第７案,花蓮縣,吉安鄉,太昌村,119,1107,439,102,541,33,574
公投第７案,花蓮縣,吉安鄉,太昌村,120,1179,430,127,557,30,587
公投第７案,花蓮縣,吉安鄉,太昌村,121,1453,481,128,609,54,663
公投第７案,花蓮縣,吉安鄉,慶豐村,122,1432,666,130,796,44,840
公投第７案,花蓮縣,吉安鄉,慶豐村,123,1320,575,125,700,27,727
公投第７案,花蓮縣,吉安鄉,慶豐村,124,1356,538,120,658,23,681
公投第７案,花蓮縣,吉安鄉,慶豐村,125,1295,533,98,631,30,661
公投第７案,花蓮縣,吉安鄉,慶豐村,126,1467,620,127,747,50,797
公投第７案,花蓮縣,吉安鄉,吉安村,127,1515,609,146,755,29,784
公投第７案,花蓮縣,吉安鄉,吉安村,128,1063,492,103,595,35,630
公投第７案,花蓮縣,吉安鄉,吉安村,129,1284,458,88,546,17,563
公投第７案,花蓮縣,吉安鄉,吉安村,130,1380,621,122,743,30,773
公投第７案,花蓮縣,吉安鄉,福興村,131,1297,535,149,684,47,731
公投第７案,花蓮縣,吉安鄉,福興村,132,1662,617,161,778,64,842
公投第７案,花蓮縣,吉安鄉,南華村,133,1563,503,174,677,71,748
公投第７案,花蓮縣,吉安鄉,干城村,134,1288,473,104,577,43,620
公投第７案,花蓮縣,吉安鄉,永興村,135,907,371,101,472,30,502
公投第７案,花蓮縣,吉安鄉,永興村,136,917,360,91,451,22,473
公投第７案,花蓮縣,吉安鄉,永興村,137,1021,400,103,503,23,526
公投第７案,花蓮縣,吉安鄉,稻香村,138,1033,472,106,578,36,614
公投第７案,花蓮縣,吉安鄉,稻香村,139,966,420,88,508,42,550
公投第７案,花蓮縣,吉安鄉,稻香村,140,1188,484,90,574,50,624
公投第７案,花蓮縣,吉安鄉,南昌村,141,1480,624,114,738,25,763
公投第７案,花蓮縣,吉安鄉,南昌村,142,1393,536,107,643,32,675
公投第７案,花蓮縣,吉安鄉,南昌村,143,1193,465,97,562,30,592
公投第７案,花蓮縣,吉安鄉,宜昌村,144,1445,539,122,661,32,693
公投第７案,花蓮縣,吉安鄉,宜昌村,145,1301,513,133,646,67,713
公投第７案,花蓮縣,吉安鄉,宜昌村,146,1215,519,126,645,48,693
公投第７案,花蓮縣,吉安鄉,北昌村,147,1135,473,105,578,31,609
公投第７案,花蓮縣,吉安鄉,北昌村,148,1223,567,102,669,26,695
公投第７案,花蓮縣,吉安鄉,北昌村,149,1274,543,115,658,40,698
公投第７案,花蓮縣,吉安鄉,北昌村,150,1124,456,98,554,37,591
公投第７案,花蓮縣,吉安鄉,北昌村,151,1158,521,107,628,24,652
公投第７案,花蓮縣,吉安鄉,北昌村,152,1157,509,111,620,25,645
公投第７案,花蓮縣,吉安鄉,勝安村,153,1258,550,112,662,24,686
公投第７案,花蓮縣,吉安鄉,勝安村,154,1257,515,124,639,28,667
公投第７案,花蓮縣,吉安鄉,勝安村,155,1245,518,110,628,21,649
公投第７案,花蓮縣,吉安鄉,勝安村,156,1166,512,127,639,7,646
公投第７案,花蓮縣,吉安鄉,仁里村,157,1358,539,122,661,48,709
公投第７案,花蓮縣,吉安鄉,仁里村,158,1214,508,90,598,32,630
公投第７案,花蓮縣,吉安鄉,仁里村,159,1151,449,109,558,51,609
公投第７案,花蓮縣,吉安鄉,仁里村,160,1157,484,130,614,27,641
公投第７案,花蓮縣,吉安鄉,仁里村,161,1161,513,109,622,34,656
公投第７案,花蓮縣,吉安鄉,東昌村,162,1304,567,133,700,36,736
公投第７案,花蓮縣,吉安鄉,東昌村,163,1367,536,137,673,44,717
公投第７案,花蓮縣,吉安鄉,東昌村,164,1411,490,135,625,40,665
公投第７案,花蓮縣,吉安鄉,東昌村,165,1409,536,96,632,28,660
公投第７案,花蓮縣,吉安鄉,仁安村,166,1125,399,97,496,37,533
公投第７案,花蓮縣,吉安鄉,仁安村,167,1213,478,126,604,66,670
公投第７案,花蓮縣,吉安鄉,仁和村,168,1141,478,114,592,32,624
公投第７案,花蓮縣,吉安鄉,仁和村,169,1156,436,78,514,16,530
公投第７案,花蓮縣,吉安鄉,仁和村,170,1092,442,79,521,44,565
公投第７案,花蓮縣,吉安鄉,仁和村,171,1026,328,105,433,31,464
公投第７案,花蓮縣,吉安鄉,光華村,172,804,337,68,405,13,418
公投第７案,花蓮縣,吉安鄉,光華村,173,1132,475,116,591,34,625
公投第７案,花蓮縣,壽豐鄉,溪口村,174,1052,365,102,467,36,503
公投第７案,花蓮縣,壽豐鄉,樹湖村,175,357,159,37,196,22,218
公投第７案,花蓮縣,壽豐鄉,豐山村,176,1022,381,91,472,44,516
公投第７案,花蓮縣,壽豐鄉,豐山村,177,875,391,115,506,41,547
公投第７案,花蓮縣,壽豐鄉,豐裡村,178,691,291,93,384,39,423
公投第７案,花蓮縣,壽豐鄉,豐裡村,179,708,235,67,302,21,323
公投第７案,花蓮縣,壽豐鄉,豐坪村,180,894,331,99,430,43,473
公投第７案,花蓮縣,壽豐鄉,壽豐村,181,746,304,75,379,31,410
公投第７案,花蓮縣,壽豐鄉,壽豐村,182,881,344,91,435,37,472
公投第７案,花蓮縣,壽豐鄉,共和村,183,695,338,57,395,36,431
公投第７案,花蓮縣,壽豐鄉,光榮村,184,816,319,120,439,72,511
公投第７案,花蓮縣,壽豐鄉,池南村,185,773,277,70,347,48,395
公投第７案,花蓮縣,壽豐鄉,平和村,186,1029,404,122,526,54,580
公投第７案,花蓮縣,壽豐鄉,平和村,187,407,190,41,231,26,257
公投第７案,花蓮縣,壽豐鄉,志學村,188,1139,485,118,603,45,648
公投第７案,花蓮縣,壽豐鄉,志學村,189,996,400,140,540,34,574
公投第７案,花蓮縣,壽豐鄉,志學村,190,414,136,40,176,11,187
公投第７案,花蓮縣,壽豐鄉,米棧村,191,270,116,35,151,6,157
公投第７案,花蓮縣,壽豐鄉,月眉村,192,836,363,83,446,40,486
公投第７案,花蓮縣,壽豐鄉,鹽寮村,193,507,217,68,285,21,306
公投第７案,花蓮縣,壽豐鄉,水璉村,194,739,216,60,276,39,315
公投第７案,花蓮縣,鳳林鎮,鳳仁里,195,1192,559,117,676,62,738
公投第７案,花蓮縣,鳳林鎮,鳳義里,196,639,247,58,305,20,325
公投第７案,花蓮縣,鳳林鎮,鳳禮里,197,601,290,68,358,42,400
公投第７案,花蓮縣,鳳林鎮,鳳智里,198,1137,558,122,680,46,726
公投第７案,花蓮縣,鳳林鎮,鳳信里,199,742,290,78,368,49,417
公投第７案,花蓮縣,鳳林鎮,鳳信里,200,610,277,45,322,27,349
公投第７案,花蓮縣,鳳林鎮,山興里,201,295,112,42,154,38,192
公投第７案,花蓮縣,鳳林鎮,山興里,202,218,54,10,64,2,66
公投第７案,花蓮縣,鳳林鎮,大榮里,203,720,226,53,279,22,301
公投第７案,花蓮縣,鳳林鎮,大榮里,204,528,200,62,262,23,285
公投第７案,花蓮縣,鳳林鎮,北林里,205,560,210,61,271,18,289
公投第７案,花蓮縣,鳳林鎮,南平里,206,541,208,32,240,51,291
公投第７案,花蓮縣,鳳林鎮,林榮里,207,818,333,77,410,54,464
公投第７案,花蓮縣,鳳林鎮,長橋里,208,984,311,66,377,30,407
公投第７案,花蓮縣,鳳林鎮,森榮里,209,91,34,6,40,9,49
公投第７案,花蓮縣,光復鄉,大華村,210,1295,522,132,654,65,719
公投第７案,花蓮縣,光復鄉,大安村,211,859,373,89,462,35,497
公投第７案,花蓮縣,光復鄉,大平村,212,958,352,96,448,122,570
公投第７案,花蓮縣,光復鄉,大馬村,213,1011,370,127,497,93,590
公投第７案,花蓮縣,光復鄉,大同村,214,1041,439,103,542,61,603
公投第７案,花蓮縣,光復鄉,東富村,215,821,292,89,381,67,448
公投第７案,花蓮縣,光復鄉,東富村,216,188,28,6,34,1,35
公投第７案,花蓮縣,光復鄉,西富村,217,514,208,46,254,28,282
公投第７案,花蓮縣,光復鄉,西富村,218,446,103,43,146,12,158
公投第７案,花蓮縣,光復鄉,南富村,219,851,303,83,386,45,431
公投第７案,花蓮縣,光復鄉,北富村,220,932,243,76,319,25,344
公投第７案,花蓮縣,光復鄉,大進村,221,471,212,38,250,18,268
公投第７案,花蓮縣,光復鄉,大全村,222,640,251,61,312,46,358
公投第７案,花蓮縣,光復鄉,大全村,223,116,35,7,42,3,45
公投第７案,花蓮縣,光復鄉,大興村,224,496,116,19,135,10,145
公投第７案,花蓮縣,光復鄉,大富村,225,324,106,30,136,10,146
公投第７案,花蓮縣,光復鄉,大豐村,226,454,126,32,158,18,176
公投第７案,花蓮縣,豐濱鄉,靜浦村,227,717,194,66,260,82,342
公投第７案,花蓮縣,豐濱鄉,港口村,228,751,170,87,257,47,304
公投第７案,花蓮縣,豐濱鄉,豐濱村,229,613,176,63,239,48,287
公投第７案,花蓮縣,豐濱鄉,豐濱村,230,809,283,56,339,23,362
公投第７案,花蓮縣,豐濱鄉,豐濱村,231,357,44,9,53,2,55
公投第７案,花蓮縣,豐濱鄉,新社村,232,669,207,71,278,62,340
公投第７案,花蓮縣,豐濱鄉,磯崎村,233,479,162,34,196,12,208
公投第７案,花蓮縣,萬榮鄉,西林村,234,1072,398,124,522,72,594
公投第７案,花蓮縣,萬榮鄉,見晴村,235,560,163,42,205,13,218
公投第７案,花蓮縣,萬榮鄉,萬榮村,236,773,337,91,428,30,458
公投第７案,花蓮縣,萬榮鄉,明利村,237,661,179,60,239,12,251
公投第７案,花蓮縣,萬榮鄉,馬遠村,238,442,161,43,204,19,223
公投第７案,花蓮縣,萬榮鄉,馬遠村,239,675,200,81,281,66,347
公投第７案,花蓮縣,萬榮鄉,紅葉村,240,1086,434,184,618,119,737
公投第７案,花蓮縣,瑞穗鄉,瑞穗村,241,813,357,73,430,39,469
公投第７案,花蓮縣,瑞穗鄉,瑞穗村,242,1091,448,98,546,63,609
公投第７案,花蓮縣,瑞穗鄉,瑞美村,243,839,371,72,443,33,476
公投第７案,花蓮縣,瑞穗鄉,瑞美村,244,975,405,101,506,51,557
公投第７案,花蓮縣,瑞穗鄉,瑞良村,245,546,180,54,234,20,254
公投第７案,花蓮縣,瑞穗鄉,瑞祥村,246,1002,413,98,511,59,570
公投第７案,花蓮縣,瑞穗鄉,瑞北村,247,593,177,61,238,38,276
公投第７案,花蓮縣,瑞穗鄉,舞鶴村,248,965,362,117,479,73,552
公投第７案,花蓮縣,瑞穗鄉,鶴岡村,249,863,316,108,424,52,476
公投第７案,花蓮縣,瑞穗鄉,奇美村,250,340,58,14,72,5,77
公投第７案,花蓮縣,瑞穗鄉,富源村,251,764,250,72,322,32,354
公投第７案,花蓮縣,瑞穗鄉,富民村,252,868,139,16,155,15,170
公投第７案,花蓮縣,瑞穗鄉,富興村,253,620,140,26,166,13,179
公投第７案,花蓮縣,玉里鎮,中城里,254,1008,423,90,513,35,548
公投第７案,花蓮縣,玉里鎮,中城里,255,939,439,83,522,34,556
公投第７案,花蓮縣,玉里鎮,中城里,256,1256,505,82,587,71,658
公投第７案,花蓮縣,玉里鎮,中城里,257,929,375,89,464,42,506
公投第７案,花蓮縣,玉里鎮,中城里,258,979,414,88,502,33,535
公投第７案,花蓮縣,玉里鎮,國武里,259,1244,566,125,691,39,730
公投第７案,花蓮縣,玉里鎮,啟模里,260,847,295,82,377,39,416
公投第７案,花蓮縣,玉里鎮,啟模里,261,772,262,71,333,47,380
公投第７案,花蓮縣,玉里鎮,泰昌里,262,558,209,46,255,22,277
公投第７案,花蓮縣,玉里鎮,泰昌里,263,800,194,47,241,20,261
公投第７案,花蓮縣,玉里鎮,永昌里,264,1286,438,99,537,58,595
公投第７案,花蓮縣,玉里鎮,源城里,265,1246,407,116,523,76,599
公投第７案,花蓮縣,玉里鎮,長良里,266,647,201,89,290,56,346
公投第７案,花蓮縣,玉里鎮,樂合里,267,990,171,31,202,16,218
公投第７案,花蓮縣,玉里鎮,東豐里,268,530,155,51,206,57,263
公投第７案,花蓮縣,玉里鎮,觀音里,269,979,232,84,316,41,357
公投第７案,花蓮縣,玉里鎮,觀音里,270,557,175,53,228,92,320
公投第７案,花蓮縣,玉里鎮,松浦里,271,434,116,26,142,15,157
公投第７案,花蓮縣,玉里鎮,松浦里,272,1065,214,85,299,62,361
公投第７案,花蓮縣,玉里鎮,春日里,273,866,274,95,369,92,461
公投第７案,花蓮縣,玉里鎮,德武里,274,769,209,68,277,38,315
公投第７案,花蓮縣,玉里鎮,三民里,275,869,266,72,338,32,370
公投第７案,花蓮縣,玉里鎮,大禹里,276,1080,322,80,402,44,446
公投第７案,花蓮縣,富里鄉,吳江村,277,467,144,36,180,18,198
公投第７案,花蓮縣,富里鄉,東里村,278,1032,286,72,358,49,407
公投第７案,花蓮縣,富里鄉,萬寧村,279,638,206,35,241,35,276
公投第７案,花蓮縣,富里鄉,新興村,280,591,204,46,250,72,322
公投第７案,花蓮縣,富里鄉,竹田村,281,1087,435,100,535,56,591
公投第７案,花蓮縣,富里鄉,羅山村,282,431,159,45,204,20,224
公投第７案,花蓮縣,富里鄉,石牌村,283,893,323,65,388,46,434
公投第７案,花蓮縣,富里鄉,明里村,284,361,100,30,130,19,149
公投第７案,花蓮縣,富里鄉,富里村,285,1362,386,107,493,47,540
公投第７案,花蓮縣,富里鄉,永豐村,286,458,171,46,217,21,238
公投第７案,花蓮縣,富里鄉,豐南村,287,621,125,36,161,34,195
公投第７案,花蓮縣,富里鄉,富南村,288,493,163,57,220,23,243
公投第７案,花蓮縣,富里鄉,學田村,289,631,207,61,268,30,298
公投第７案,花蓮縣,卓溪鄉,崙山村,290,533,208,58,266,16,282
公投第７案,花蓮縣,卓溪鄉,立山村,291,522,214,75,289,37,326
公投第７案,花蓮縣,卓溪鄉,立山村,292,493,127,37,164,17,181
公投第７案,花蓮縣,卓溪鄉,太平村,293,701,316,84,400,38,438
公投第７案,花蓮縣,卓溪鄉,卓溪村,294,746,323,69,392,51,443
公投第７案,花蓮縣,卓溪鄉,卓清村,295,616,222,106,328,58,386
公投第７案,花蓮縣,卓溪鄉,卓清村,296,405,96,17,113,16,129
公投第７案,花蓮縣,卓溪鄉,古風村,297,329,131,32,163,16,179
公投第７案,花蓮縣,卓溪鄉,古風村,298,428,174,27,201,17,218
公投第７案,花蓮縣,卓溪鄉,古風村,299,174,78,10,88,10,98
公投第７案,澎湖縣,馬公市,復興里,1,481,161,50,211,13,224
公投第７案,澎湖縣,馬公市,長安里,2,558,219,44,263,19,282
公投第７案,澎湖縣,馬公市,中央里,3,533,175,43,218,45,263
公投第７案,澎湖縣,馬公市,啟明里,4,922,318,98,416,31,447
公投第７案,澎湖縣,馬公市,重慶里,5,1021,392,107,499,37,536
公投第７案,澎湖縣,馬公市,中興里,6,793,289,81,370,32,402
公投第７案,澎湖縣,馬公市,光復里,7,954,371,90,461,47,508
公投第７案,澎湖縣,馬公市,光復里,8,1001,328,132,460,30,490
公投第７案,澎湖縣,馬公市,光明里,9,1192,393,97,490,38,528
公投第７案,澎湖縣,馬公市,光榮里,10,1402,502,113,615,41,656
公投第７案,澎湖縣,馬公市,光榮里,11,1389,563,102,665,27,692
公投第７案,澎湖縣,馬公市,光榮里,12,1339,523,127,650,38,688
公投第７案,澎湖縣,馬公市,朝陽里,13,1254,422,115,537,44,581
公投第７案,澎湖縣,馬公市,朝陽里,14,1194,439,109,548,51,599
公投第７案,澎湖縣,馬公市,朝陽里,15,1393,484,136,620,52,672
公投第７案,澎湖縣,馬公市,朝陽里,16,1440,570,136,706,41,747
公投第７案,澎湖縣,馬公市,陽明里,17,1215,423,111,534,56,590
公投第７案,澎湖縣,馬公市,陽明里,18,1284,493,87,580,51,631
公投第７案,澎湖縣,馬公市,重光里,19,1512,562,138,700,51,751
公投第７案,澎湖縣,馬公市,西衛里,20,1181,413,94,507,64,571
公投第７案,澎湖縣,馬公市,西衛里,21,1348,506,117,623,44,667
公投第７案,澎湖縣,馬公市,西衛里,22,1391,557,127,684,29,713
公投第７案,澎湖縣,馬公市,西衛里,23,2124,687,221,908,30,938
公投第７案,澎湖縣,馬公市,西文里,24,1500,555,118,673,66,739
公投第７案,澎湖縣,馬公市,西文里,25,1582,622,118,740,35,775
公投第７案,澎湖縣,馬公市,東文里,26,1638,615,146,761,35,796
公投第７案,澎湖縣,馬公市,東文里,27,1554,614,145,759,47,806
公投第７案,澎湖縣,馬公市,案山里,28,980,290,59,349,26,375
公投第７案,澎湖縣,馬公市,案山里,29,892,335,81,416,29,445
公投第７案,澎湖縣,馬公市,光華里,30,778,263,44,307,14,321
公投第７案,澎湖縣,馬公市,前寮里,31,930,364,70,434,35,469
公投第７案,澎湖縣,馬公市,石泉里,32,1481,676,137,813,42,855
公投第７案,澎湖縣,馬公市,石泉里,33,1128,496,79,575,16,591
公投第７案,澎湖縣,馬公市,菜園里,34,415,159,34,193,23,216
公投第７案,澎湖縣,馬公市,東衛里,35,1120,441,76,517,40,557
公投第７案,澎湖縣,馬公市,東衛里,36,950,406,86,492,22,514
公投第７案,澎湖縣,馬公市,安宅里,37,627,210,45,255,25,280
公投第７案,澎湖縣,馬公市,興仁里,38,1055,400,87,487,24,511
公投第７案,澎湖縣,馬公市,烏崁里,39,989,389,85,474,40,514
公投第７案,澎湖縣,馬公市,鐵線里,40,591,237,60,297,32,329
公投第７案,澎湖縣,馬公市,鎖港里,41,1387,457,138,595,62,657
公投第７案,澎湖縣,馬公市,鎖港里,42,1079,323,97,420,52,472
公投第７案,澎湖縣,馬公市,山水里,43,797,292,64,356,41,397
公投第７案,澎湖縣,馬公市,山水里,44,903,301,56,357,22,379
公投第７案,澎湖縣,馬公市,五德里,45,376,120,32,152,22,174
公投第７案,澎湖縣,馬公市,井垵里,46,371,137,37,174,20,194
公投第７案,澎湖縣,馬公市,嵵裡里,47,1173,346,77,423,17,440
公投第７案,澎湖縣,馬公市,風櫃里,48,1389,331,89,420,24,444
公投第７案,澎湖縣,馬公市,虎井里,49,761,117,41,158,55,213
公投第７案,澎湖縣,馬公市,桶盤里,50,288,122,32,154,22,176
公投第７案,澎湖縣,湖西鄉,湖西村,51,1120,441,73,514,58,572
公投第７案,澎湖縣,湖西鄉,湖東村,52,332,94,34,128,12,140
公投第７案,澎湖縣,湖西鄉,青螺村,53,242,66,18,84,4,88
公投第７案,澎湖縣,湖西鄉,白坑村,54,293,71,21,92,7,99
公投第７案,澎湖縣,湖西鄉,南寮村,55,666,181,45,226,48,274
公投第７案,澎湖縣,湖西鄉,北寮村,56,326,114,23,137,25,162
公投第７案,澎湖縣,湖西鄉,紅羅村,57,732,211,38,249,16,265
公投第７案,澎湖縣,湖西鄉,西溪村,58,651,233,41,274,23,297
公投第７案,澎湖縣,湖西鄉,成功村,59,744,241,53,294,13,307
公投第７案,澎湖縣,湖西鄉,東石村,60,134,53,17,70,4,74
公投第７案,澎湖縣,湖西鄉,沙港村,61,794,204,36,240,18,258
公投第７案,澎湖縣,湖西鄉,中西村,62,216,67,10,77,2,79
公投第７案,澎湖縣,湖西鄉,鼎灣村,63,664,145,41,186,7,193
公投第７案,澎湖縣,湖西鄉,潭邊村,64,279,103,21,124,6,130
公投第７案,澎湖縣,湖西鄉,許家村,65,296,119,19,138,7,145
公投第７案,澎湖縣,湖西鄉,城北村,66,257,102,12,114,4,118
公投第７案,澎湖縣,湖西鄉,太武村,67,89,20,6,26,1,27
公投第７案,澎湖縣,湖西鄉,隘門村,68,815,266,88,354,28,382
公投第７案,澎湖縣,湖西鄉,林投村,69,975,303,55,358,20,378
公投第７案,澎湖縣,湖西鄉,尖山村,70,648,209,71,280,34,314
公投第７案,澎湖縣,湖西鄉,龍門村,71,893,257,71,328,27,355
公投第７案,澎湖縣,湖西鄉,龍門村,72,846,268,88,356,82,438
公投第７案,澎湖縣,湖西鄉,菓葉村,73,729,188,49,237,13,250
公投第７案,澎湖縣,白沙鄉,中屯村,74,514,174,64,238,17,255
公投第７案,澎湖縣,白沙鄉,講美村,75,657,254,51,305,22,327
公投第７案,澎湖縣,白沙鄉,城前村,76,109,60,8,68,4,72
公投第７案,澎湖縣,白沙鄉,鎮海村,77,156,51,9,60,5,65
公投第７案,澎湖縣,白沙鄉,港子村,78,293,86,27,113,7,120
公投第７案,澎湖縣,白沙鄉,岐頭村,79,231,53,14,67,1,68
公投第７案,澎湖縣,白沙鄉,小赤村,80,161,57,19,76,10,86
公投第７案,澎湖縣,白沙鄉,赤崁村,81,1705,568,158,726,56,782
公投第７案,澎湖縣,白沙鄉,瓦硐村,82,285,89,22,111,10,121
公投第７案,澎湖縣,白沙鄉,後寮村,83,723,156,47,203,8,211
公投第７案,澎湖縣,白沙鄉,通梁村,84,774,201,54,255,30,285
公投第７案,澎湖縣,白沙鄉,吉貝村,85,1429,276,102,378,108,486
公投第７案,澎湖縣,白沙鄉,鳥嶼村,86,1084,360,71,431,67,498
公投第７案,澎湖縣,白沙鄉,員貝村,87,251,100,20,120,5,125
公投第７案,澎湖縣,白沙鄉,大倉村,88,253,50,22,72,16,88
公投第７案,澎湖縣,西嶼鄉,橫礁村,89,283,32,8,40,1,41
公投第７案,澎湖縣,西嶼鄉,合界村,90,424,86,16,102,19,121
公投第７案,澎湖縣,西嶼鄉,竹灣村,91,826,178,50,228,56,284
公投第７案,澎湖縣,西嶼鄉,小門村,92,282,73,21,94,9,103
公投第７案,澎湖縣,西嶼鄉,大池村,93,661,163,42,205,47,252
公投第７案,澎湖縣,西嶼鄉,二崁村,94,141,14,8,22,5,27
公投第７案,澎湖縣,西嶼鄉,池東村,95,635,142,24,166,8,174
公投第７案,澎湖縣,西嶼鄉,池西村,96,216,46,15,61,5,66
公投第７案,澎湖縣,西嶼鄉,赤馬村,97,572,83,23,106,23,129
公投第７案,澎湖縣,西嶼鄉,內垵村,98,1267,322,80,402,94,496
公投第７案,澎湖縣,西嶼鄉,外垵村,99,942,228,40,268,28,296
公投第７案,澎湖縣,西嶼鄉,外垵村,100,1133,274,82,356,72,428
公投第７案,澎湖縣,望安鄉,東安村,101,734,248,50,298,29,327
公投第７案,澎湖縣,望安鄉,西安村,102,454,144,22,166,24,190
公投第７案,澎湖縣,望安鄉,中社村,103,300,62,19,81,11,92
公投第７案,澎湖縣,望安鄉,水垵村,104,471,164,36,200,37,237
公投第７案,澎湖縣,望安鄉,將軍村,105,672,158,25,183,19,202
公投第７案,澎湖縣,望安鄉,將軍村,106,742,182,71,253,45,298
公投第７案,澎湖縣,望安鄉,東吉村,107,264,77,16,93,15,108
公投第７案,澎湖縣,望安鄉,東坪村,108,476,130,32,162,7,169
公投第７案,澎湖縣,望安鄉,西坪村,109,208,25,11,36,4,40
公投第７案,澎湖縣,望安鄉,花嶼村,110,307,66,20,86,5,91
公投第７案,澎湖縣,七美鄉,東湖村,111,248,48,14,62,5,67
公投第７案,澎湖縣,七美鄉,西湖村,112,581,143,29,172,32,204
公投第７案,澎湖縣,七美鄉,中和村,113,641,142,51,193,30,223
公投第７案,澎湖縣,七美鄉,平和村,114,382,85,26,111,2,113
公投第７案,澎湖縣,七美鄉,海豐村,115,351,55,11,66,6,72
公投第７案,澎湖縣,七美鄉,南港村,116,1171,239,49,288,27,315
公投第７案,基隆市,中正區,長潭里,1,466,180,50,230,16,246
公投第７案,基隆市,中正區,砂子里,2,1262,390,113,503,19,522
公投第７案,基隆市,中正區,砂子里,3,1171,364,128,492,63,555
公投第７案,基隆市,中正區,砂子里,4,2823,847,178,1025,28,1053
公投第７案,基隆市,中正區,八斗里,5,1474,430,152,582,46,628
公投第７案,基隆市,中正區,碧砂里,6,1271,390,101,491,59,550
公投第７案,基隆市,中正區,新富里,7,2707,862,228,1090,70,1160
公投第７案,基隆市,中正區,新富里,8,1545,570,141,711,39,750
公投第７案,基隆市,中正區,新富里,9,761,223,33,256,15,271
公投第７案,基隆市,中正區,新豐里,10,1352,509,119,628,13,641
公投第７案,基隆市,中正區,新豐里,11,1413,523,103,626,13,639
公投第７案,基隆市,中正區,新豐里,12,2665,903,199,1102,41,1143
公投第７案,基隆市,中正區,平寮里,13,1261,400,123,523,67,590
公投第７案,基隆市,中正區,社寮里,14,1753,595,205,800,71,871
公投第７案,基隆市,中正區,和憲里,15,984,308,96,404,38,442
公投第７案,基隆市,中正區,海濱里,16,1166,395,82,477,28,505
公投第７案,基隆市,中正區,正濱里,17,973,338,98,436,31,467
公投第７案,基隆市,中正區,中正里,18,1694,460,133,593,22,615
公投第７案,基隆市,中正區,中濱里,19,1270,465,137,602,30,632
公投第７案,基隆市,中正區,建國里,20,1090,438,107,545,23,568
公投第７案,基隆市,中正區,建國里,21,870,339,90,429,18,447
公投第７案,基隆市,中正區,砂灣里,22,1138,426,107,533,38,571
公投第７案,基隆市,中正區,砂灣里,23,862,315,80,395,42,437
公投第７案,基隆市,中正區,真砂里,24,1341,538,133,671,61,732
公投第７案,基隆市,中正區,正砂里,25,859,340,84,424,46,470
公投第７案,基隆市,中正區,正砂里,26,1457,510,127,637,25,662
公投第７案,基隆市,中正區,中砂里,27,1594,469,119,588,62,650
公投第７案,基隆市,中正區,入船里,28,802,299,88,387,40,427
公投第７案,基隆市,中正區,正船里,29,1267,442,127,569,48,617
公投第７案,基隆市,中正區,中船里,30,1175,429,129,558,61,619
公投第７案,基隆市,中正區,港通里,31,1210,504,122,626,51,677
公投第７案,基隆市,中正區,義重里,32,1037,358,128,486,53,539
公投第７案,基隆市,中正區,正義里,33,1219,462,120,582,52,634
公投第７案,基隆市,中正區,信義里,34,904,318,99,417,17,434
公投第７案,基隆市,中正區,德義里,35,709,301,104,405,34,439
公投第７案,基隆市,信義區,仁壽里,36,1096,431,121,552,36,588
公投第７案,基隆市,信義區,仁義里,37,1232,560,143,703,34,737
公投第７案,基隆市,信義區,義昭里,38,1184,483,126,609,22,631
公投第７案,基隆市,信義區,義幸里,39,1133,492,108,600,63,663
公投第７案,基隆市,信義區,義幸里,40,1188,496,122,618,38,656
公投第７案,基隆市,信義區,義民里,41,725,307,84,391,30,421
公投第７案,基隆市,信義區,義和里,42,1524,522,156,678,42,720
公投第７案,基隆市,信義區,智慧里,43,736,298,67,365,34,399
公投第７案,基隆市,信義區,智誠里,44,611,235,58,293,18,311
公投第７案,基隆市,信義區,智誠里,45,951,319,90,409,16,425
公投第７案,基隆市,信義區,禮儀里,46,1616,645,156,801,32,833
公投第７案,基隆市,信義區,禮東里,47,1516,640,143,783,32,815
公投第７案,基隆市,信義區,信綠里,48,1049,404,103,507,29,536
公投第７案,基隆市,信義區,信綠里,49,1069,416,108,524,28,552
公投第７案,基隆市,信義區,東信里,50,727,317,80,397,23,420
公投第７案,基隆市,信義區,東信里,51,929,435,83,518,23,541
公投第７案,基隆市,信義區,東信里,52,1118,514,142,656,34,690
公投第７案,基隆市,信義區,東信里,53,1339,573,138,711,40,751
公投第７案,基隆市,信義區,東光里,54,999,407,76,483,20,503
公投第７案,基隆市,信義區,東光里,55,764,304,61,365,15,380
公投第７案,基隆市,信義區,東明里,56,1555,570,138,708,38,746
公投第７案,基隆市,信義區,東明里,57,2015,778,158,936,30,966
公投第７案,基隆市,信義區,東安里,58,1268,547,127,674,42,716
公投第７案,基隆市,信義區,東安里,59,1569,625,163,788,39,827
公投第７案,基隆市,信義區,孝賢里,60,1985,723,172,895,58,953
公投第７案,基隆市,信義區,孝賢里,61,1476,651,126,777,24,801
公投第７案,基隆市,信義區,孝忠里,62,1493,674,137,811,31,842
公投第７案,基隆市,信義區,孝忠里,63,1249,600,125,725,26,751
公投第７案,基隆市,信義區,孝忠里,64,1559,618,144,762,25,787
公投第７案,基隆市,信義區,孝忠里,65,1168,450,92,542,14,556
公投第７案,基隆市,信義區,孝忠里,66,1602,684,114,798,26,824
公投第７案,基隆市,信義區,孝德里,67,1485,519,123,642,37,679
公投第７案,基隆市,信義區,孝德里,68,1009,395,80,475,25,500
公投第７案,基隆市,信義區,孝深里,69,2016,679,138,817,47,864
公投第７案,基隆市,信義區,孝深里,70,1764,570,119,689,34,723
公投第７案,基隆市,信義區,孝岡里,71,1295,529,129,658,37,695
公投第７案,基隆市,仁愛區,林泉里,72,1782,572,154,726,94,820
公投第７案,基隆市,仁愛區,花崗里,73,1055,435,116,551,46,597
公投第７案,基隆市,仁愛區,虹橋里,74,1558,534,149,683,37,720
公投第７案,基隆市,仁愛區,水錦里,75,1736,675,168,843,41,884
公投第７案,基隆市,仁愛區,智仁里,76,1243,526,165,691,42,733
公投第７案,基隆市,仁愛區,智仁里,77,1109,457,128,585,41,626
公投第７案,基隆市,仁愛區,和明里,78,1684,782,150,932,39,971
公投第７案,基隆市,仁愛區,忠勇里,79,919,353,104,457,41,498
公投第７案,基隆市,仁愛區,玉田里,80,991,353,117,470,20,490
公投第７案,基隆市,仁愛區,仁德里,81,876,346,95,441,18,459
公投第７案,基隆市,仁愛區,博愛里,82,1046,443,115,558,46,604
公投第７案,基隆市,仁愛區,博愛里,83,434,196,46,242,21,263
公投第７案,基隆市,仁愛區,福仁里,84,764,307,80,387,59,446
公投第７案,基隆市,仁愛區,誠仁里,85,968,359,116,475,21,496
公投第７案,基隆市,仁愛區,吉仁里,86,1326,456,147,603,75,678
公投第７案,基隆市,仁愛區,吉仁里,87,1315,404,103,507,34,541
公投第７案,基隆市,仁愛區,育仁里,88,775,304,104,408,39,447
公投第７案,基隆市,仁愛區,英仁里,89,652,242,81,323,50,373
公投第７案,基隆市,仁愛區,英仁里,90,674,275,74,349,27,376
公投第７案,基隆市,仁愛區,龍門里,91,789,287,86,373,36,409
公投第７案,基隆市,仁愛區,德厚里,92,1715,642,193,835,66,901
公投第７案,基隆市,仁愛區,曲水里,93,849,306,105,411,41,452
公投第７案,基隆市,仁愛區,崇文里,94,875,362,82,444,25,469
公投第７案,基隆市,仁愛區,文安里,95,851,312,80,392,41,433
公投第７案,基隆市,仁愛區,兆連里,96,735,325,75,400,26,426
公投第７案,基隆市,仁愛區,獅球里,97,1009,360,109,469,65,534
公投第７案,基隆市,仁愛區,書院里,98,1082,374,116,490,38,528
公投第７案,基隆市,仁愛區,朝棟里,99,1278,465,128,593,69,662
公投第７案,基隆市,仁愛區,朝棟里,100,1519,701,126,827,48,875
公投第７案,基隆市,仁愛區,光華里,101,1336,432,118,550,44,594
公投第７案,基隆市,仁愛區,光華里,102,1178,493,144,637,62,699
公投第７案,基隆市,仁愛區,明德里,103,708,247,92,339,43,382
公投第７案,基隆市,仁愛區,同風里,104,567,247,81,328,26,354
公投第７案,基隆市,仁愛區,文昌里,105,751,246,106,352,58,410
公投第７案,基隆市,仁愛區,新店里,106,589,244,80,324,29,353
公投第７案,基隆市,中山區,新建里,107,796,303,73,376,21,397
公投第７案,基隆市,中山區,安民里,108,1036,478,115,593,44,637
公投第７案,基隆市,中山區,安平里,109,756,287,104,391,41,432
公投第７案,基隆市,中山區,中山里,110,957,282,105,387,19,406
公投第７案,基隆市,中山區,民治里,111,802,308,87,395,10,405
公投第７案,基隆市,中山區,中興里,112,1263,507,125,632,44,676
公投第７案,基隆市,中山區,仁正里,113,778,342,77,419,23,442
公投第７案,基隆市,中山區,健民里,114,1180,443,134,577,81,658
公投第７案,基隆市,中山區,通化里,115,990,343,90,433,29,462
公投第７案,基隆市,中山區,居仁里,116,1332,404,101,505,36,541
公投第７案,基隆市,中山區,通明里,117,848,292,78,370,22,392
公投第７案,基隆市,中山區,通明里,118,922,329,85,414,13,427
公投第７案,基隆市,中山區,和平里,119,459,193,67,260,11,271
公投第７案,基隆市,中山區,仙洞里,120,574,196,56,252,27,279
公投第７案,基隆市,中山區,太白里,121,877,336,81,417,37,454
公投第７案,基隆市,中山區,協和里,122,1584,496,175,671,38,709
公投第７案,基隆市,中山區,文化里,123,1319,358,89,447,34,481
公投第７案,基隆市,中山區,德安里,124,1938,715,214,929,57,986
公投第７案,基隆市,中山區,德安里,125,1877,655,195,850,49,899
公投第７案,基隆市,中山區,德和里,126,2088,854,214,1068,37,1105
公投第７案,基隆市,中山區,德和里,127,1946,774,210,984,38,1022
公投第７案,基隆市,中山區,德和里,128,1353,557,154,711,52,763
公投第７案,基隆市,中山區,中和里,129,1317,496,131,627,45,672
公投第７案,基隆市,中山區,中和里,130,870,337,126,463,33,496
公投第７案,基隆市,中山區,中和里,131,1322,582,112,694,26,720
公投第７案,基隆市,中山區,中和里,132,1295,438,129,567,20,587
公投第７案,基隆市,中山區,中和里,133,756,338,103,441,18,459
公投第７案,基隆市,中山區,和慶里,134,1602,526,155,681,28,709
公投第７案,基隆市,中山區,和慶里,135,1568,552,151,703,42,745
公投第７案,基隆市,中山區,和慶里,136,1404,520,179,699,37,736
公投第７案,基隆市,中山區,和慶里,137,1909,655,169,824,26,850
公投第７案,基隆市,中山區,西康里,138,1642,534,150,684,79,763
公投第７案,基隆市,中山區,西定里,139,932,331,80,411,19,430
公投第７案,基隆市,中山區,西華里,140,849,365,105,470,43,513
公投第７案,基隆市,中山區,西榮里,141,715,274,105,379,49,428
公投第７案,基隆市,安樂區,新西里,142,1361,471,130,601,61,662
公投第７案,基隆市,安樂區,西川里,143,1213,430,113,543,35,578
公投第７案,基隆市,安樂區,定國里,144,1026,334,84,418,34,452
公投第７案,基隆市,安樂區,定邦里,145,1038,434,110,544,82,626
公投第７案,基隆市,安樂區,慈仁里,146,897,335,123,458,58,516
公投第７案,基隆市,安樂區,干城里,147,1401,535,148,683,57,740
公投第７案,基隆市,安樂區,干城里,148,641,156,48,204,9,213
公投第７案,基隆市,安樂區,永康里,149,1472,510,176,686,50,736
公投第７案,基隆市,安樂區,永康里,150,472,186,49,235,25,260
公投第７案,基隆市,安樂區,安和里,151,841,352,111,463,28,491
公投第７案,基隆市,安樂區,樂一里,152,571,212,64,276,27,303
公投第７案,基隆市,安樂區,嘉仁里,153,1901,659,182,841,40,881
公投第７案,基隆市,安樂區,嘉仁里,154,1349,476,177,653,42,695
公投第７案,基隆市,安樂區,三民里,155,1225,453,128,581,41,622
公投第７案,基隆市,安樂區,三民里,156,1351,547,155,702,40,742
公投第７案,基隆市,安樂區,壯觀里,157,1601,701,170,871,41,912
公投第７案,基隆市,安樂區,壯觀里,158,2513,1028,218,1246,43,1289
公投第７案,基隆市,安樂區,四維里,159,1613,667,160,827,45,872
公投第７案,基隆市,安樂區,四維里,160,1731,723,167,890,46,936
公投第７案,基隆市,安樂區,四維里,161,1424,623,189,812,29,841
公投第７案,基隆市,安樂區,五福里,162,1806,681,177,858,49,907
公投第７案,基隆市,安樂區,五福里,163,1679,695,183,878,63,941
公投第７案,基隆市,安樂區,六合里,164,1902,751,212,963,43,1006
公投第７案,基隆市,安樂區,六合里,165,2040,795,195,990,38,1028
公投第７案,基隆市,安樂區,七賢里,166,1313,526,143,669,45,714
公投第７案,基隆市,安樂區,七賢里,167,1243,443,144,587,20,607
公投第７案,基隆市,安樂區,長樂里,168,1759,706,152,858,30,888
公投第７案,基隆市,安樂區,長樂里,169,694,324,89,413,24,437
公投第７案,基隆市,安樂區,長樂里,170,866,412,112,524,25,549
公投第７案,基隆市,安樂區,鶯歌里,171,1557,490,141,631,26,657
公投第７案,基隆市,安樂區,鶯歌里,172,1411,521,161,682,27,709
公投第７案,基隆市,安樂區,鶯安里,173,1568,699,165,864,25,889
公投第７案,基隆市,安樂區,鶯安里,174,1400,564,129,693,32,725
公投第７案,基隆市,安樂區,鶯安里,175,1531,638,121,759,12,771
公投第７案,基隆市,安樂區,興寮里,176,1673,627,137,764,26,790
公投第７案,基隆市,安樂區,興寮里,177,1054,412,108,520,38,558
公投第７案,基隆市,安樂區,興寮里,178,1923,635,143,778,29,807
公投第７案,基隆市,安樂區,外寮里,179,1960,769,221,990,56,1046
公投第７案,基隆市,安樂區,外寮里,180,1962,741,178,919,61,980
公投第７案,基隆市,安樂區,新崙里,181,2117,818,222,1040,55,1095
公投第７案,基隆市,安樂區,新崙里,182,1829,692,153,845,26,871
公投第７案,基隆市,安樂區,武崙里,183,1529,595,112,707,29,736
公投第７案,基隆市,安樂區,武崙里,184,1869,733,176,909,36,945
公投第７案,基隆市,安樂區,武崙里,185,1140,519,85,604,15,619
公投第７案,基隆市,安樂區,中崙里,186,1641,725,71,796,51,847
公投第７案,基隆市,安樂區,內寮里,187,1279,482,142,624,36,660
公投第７案,基隆市,安樂區,內寮里,188,1360,556,118,674,22,696
公投第７案,基隆市,安樂區,內寮里,189,1399,571,146,717,43,760
公投第７案,基隆市,安樂區,內寮里,190,1251,501,106,607,29,636
公投第７案,基隆市,暖暖區,八西里,191,1431,515,133,648,53,701
公投第７案,基隆市,暖暖區,八中里,192,456,152,42,194,6,200
公投第７案,基隆市,暖暖區,八堵里,193,637,246,78,324,28,352
公投第７案,基隆市,暖暖區,八南里,194,735,307,88,395,25,420
公投第７案,基隆市,暖暖區,過港里,195,1078,386,93,479,27,506
公投第７案,基隆市,暖暖區,過港里,196,1238,458,132,590,43,633
公投第７案,基隆市,暖暖區,過港里,197,1325,505,133,638,41,679
公投第７案,基隆市,暖暖區,暖暖里,198,1475,574,154,728,42,770
公投第７案,基隆市,暖暖區,暖暖里,199,1179,393,102,495,33,528
公投第７案,基隆市,暖暖區,暖同里,200,1110,500,106,606,40,646
公投第７案,基隆市,暖暖區,暖同里,201,1443,502,119,621,27,648
公投第７案,基隆市,暖暖區,暖東里,202,415,149,54,203,19,222
公投第７案,基隆市,暖暖區,暖西里,203,1378,523,112,635,21,656
公投第７案,基隆市,暖暖區,暖西里,204,1570,603,179,782,26,808
公投第７案,基隆市,暖暖區,暖西里,205,1603,703,186,889,44,933
公投第７案,基隆市,暖暖區,碇內里,206,1267,535,142,677,41,718
公投第７案,基隆市,暖暖區,碇內里,207,1359,559,122,681,33,714
公投第７案,基隆市,暖暖區,碇和里,208,970,446,94,540,19,559
公投第７案,基隆市,暖暖區,碇和里,209,1002,426,67,493,22,515
公投第７案,基隆市,暖暖區,碇和里,210,944,346,98,444,24,468
公投第７案,基隆市,暖暖區,碇祥里,211,1500,633,165,798,43,841
公投第７案,基隆市,暖暖區,碇祥里,212,1442,455,94,549,28,577
公投第７案,基隆市,暖暖區,碇祥里,213,1165,487,111,598,25,623
公投第７案,基隆市,暖暖區,碇祥里,214,1610,622,160,782,21,803
公投第７案,基隆市,暖暖區,碇安里,215,1328,561,129,690,31,721
公投第７案,基隆市,暖暖區,碇安里,216,1173,463,103,566,20,586
公投第７案,基隆市,暖暖區,碇安里,217,1019,469,93,562,36,598
公投第７案,基隆市,暖暖區,碇安里,218,1373,572,121,693,24,717
公投第７案,基隆市,七堵區,長興里,219,1258,504,157,661,60,721
公投第７案,基隆市,七堵區,長興里,220,1237,501,143,644,41,685
公投第７案,基隆市,七堵區,長興里,221,1259,511,116,627,17,644
公投第７案,基隆市,七堵區,正光里,222,1120,390,119,509,46,555
公投第７案,基隆市,七堵區,正光里,223,1344,469,116,585,54,639
公投第７案,基隆市,七堵區,正明里,224,1011,451,125,576,41,617
公投第７案,基隆市,七堵區,正明里,225,925,332,108,440,20,460
公投第７案,基隆市,七堵區,富民里,226,1735,723,186,909,61,970
公投第７案,基隆市,七堵區,富民里,227,1833,756,217,973,60,1033
公投第７案,基隆市,七堵區,永平里,228,938,356,106,462,26,488
公投第７案,基隆市,七堵區,永平里,229,962,417,105,522,50,572
公投第７案,基隆市,七堵區,永安里,230,1191,511,104,615,39,654
公投第７案,基隆市,七堵區,永安里,231,999,412,103,515,48,563
公投第７案,基隆市,七堵區,八德里,232,282,110,20,130,7,137
公投第７案,基隆市,七堵區,八德里,233,1243,462,127,589,53,642
公投第７案,基隆市,七堵區,自強里,234,1092,402,115,517,42,559
公投第７案,基隆市,七堵區,泰安里,235,1246,481,148,629,40,669
公投第７案,基隆市,七堵區,泰安里,236,1722,637,186,823,41,864
公投第７案,基隆市,七堵區,泰安里,237,1318,517,128,645,38,683
公投第７案,基隆市,七堵區,六堵里,238,975,348,89,437,18,455
公投第７案,基隆市,七堵區,六堵里,239,1285,507,138,645,26,671
公投第７案,基隆市,七堵區,堵南里,240,1077,369,100,469,48,517
公投第７案,基隆市,七堵區,堵南里,241,989,333,105,438,30,468
公投第７案,基隆市,七堵區,長安里,242,1193,430,124,554,38,592
公投第７案,基隆市,七堵區,長安里,243,1273,454,164,618,45,663
公投第７案,基隆市,七堵區,堵北里,244,1774,692,187,879,67,946
公投第７案,基隆市,七堵區,堵北里,245,1689,647,185,832,59,891
公投第７案,基隆市,七堵區,百福里,246,1355,506,125,631,61,692
公投第７案,基隆市,七堵區,百福里,247,1512,547,162,709,54,763
公投第７案,基隆市,七堵區,百福里,248,1486,513,157,670,25,695
公投第７案,基隆市,七堵區,百福里,249,1706,656,149,805,31,836
公投第７案,基隆市,七堵區,實踐里,250,1384,557,141,698,53,751
公投第７案,基隆市,七堵區,實踐里,251,1045,443,140,583,42,625
公投第７案,基隆市,七堵區,實踐里,252,1374,540,154,694,37,731
公投第７案,基隆市,七堵區,瑪南里,253,428,163,46,209,9,218
公投第７案,基隆市,七堵區,瑪東里,254,326,132,40,172,24,196
公投第７案,基隆市,七堵區,瑪西里,255,351,193,38,231,16,247
公投第７案,基隆市,七堵區,友一里,256,1871,688,154,842,33,875
公投第７案,基隆市,七堵區,友二里,257,448,148,43,191,6,197
公投第７案,新竹市,東區,育賢里,1,1512,377,101,478,15,493
公投第７案,新竹市,東區,親仁里,2,953,441,117,558,25,583
公投第７案,新竹市,東區,親仁里,3,729,316,81,397,23,420
公投第７案,新竹市,東區,東門里,4,566,244,84,328,24,352
公投第７案,新竹市,東區,成功里,5,640,258,90,348,19,367
公投第７案,新竹市,東區,榮光里,6,305,109,43,152,19,171
公投第７案,新竹市,東區,中正里,7,563,231,92,323,15,338
公投第７案,新竹市,東區,錦華里,8,741,307,85,392,13,405
公投第７案,新竹市,東區,錦華里,9,1041,452,126,578,10,588
公投第７案,新竹市,東區,文華里,10,1615,677,161,838,23,861
公投第７案,新竹市,東區,文華里,11,1287,566,138,704,36,740
公投第７案,新竹市,東區,文華里,12,1554,678,183,861,17,878
公投第７案,新竹市,東區,復中里,13,1388,633,154,787,15,802
公投第７案,新竹市,東區,復中里,14,1419,617,183,800,30,830
公投第７案,新竹市,東區,復中里,15,1355,547,156,703,50,753
公投第７案,新竹市,東區,復興里,16,1490,621,169,790,30,820
公投第７案,新竹市,東區,復興里,17,1615,708,169,877,22,899
公投第７案,新竹市,東區,復興里,18,1672,712,197,909,44,953
公投第７案,新竹市,東區,三民里,19,1062,468,114,582,29,611
公投第７案,新竹市,東區,三民里,20,1315,558,153,711,40,751
公投第７案,新竹市,東區,三民里,21,1000,441,116,557,37,594
公投第７案,新竹市,東區,三民里,22,1337,589,165,754,35,789
公投第７案,新竹市,東區,東園里,23,1747,743,162,905,29,934
公投第７案,新竹市,東區,東園里,24,1600,716,206,922,34,956
公投第７案,新竹市,東區,東園里,25,1158,500,129,629,27,656
公投第７案,新竹市,東區,東園里,26,828,390,126,516,26,542
公投第７案,新竹市,東區,公園里,27,1573,649,180,829,41,870
公投第７案,新竹市,東區,公園里,28,1550,678,170,848,40,888
公投第７案,新竹市,東區,建華里,29,1317,523,174,697,24,721
公投第７案,新竹市,東區,建華里,30,1040,436,168,604,39,643
公投第７案,新竹市,東區,東山里,31,935,416,108,524,17,541
公投第７案,新竹市,東區,東山里,32,1074,456,118,574,21,595
公投第７案,新竹市,東區,東山里,33,1133,533,124,657,35,692
公投第７案,新竹市,東區,綠水里,34,1262,571,138,709,49,758
公投第７案,新竹市,東區,綠水里,35,1199,516,142,658,20,678
公投第７案,新竹市,東區,綠水里,36,1226,563,157,720,30,750
公投第７案,新竹市,東區,綠水里,37,1377,655,174,829,47,876
公投第７案,新竹市,東區,綠水里,38,991,475,130,605,25,630
公投第７案,新竹市,東區,東勢里,39,1271,520,169,689,72,761
公投第７案,新竹市,東區,東勢里,40,1012,516,110,626,25,651
公投第７案,新竹市,東區,光復里,41,1001,418,116,534,54,588
公投第７案,新竹市,東區,光復里,42,1603,619,188,807,47,854
公投第７案,新竹市,東區,前溪里,43,1236,468,173,641,41,682
公投第７案,新竹市,東區,前溪里,44,1532,560,143,703,36,739
公投第７案,新竹市,東區,水源里,45,1306,540,137,677,39,716
公投第７案,新竹市,東區,水源里,46,1073,456,115,571,59,630
公投第７案,新竹市,東區,水源里,47,952,384,118,502,13,515
公投第７案,新竹市,東區,千甲里,48,1298,447,132,579,26,605
公投第７案,新竹市,東區,千甲里,49,778,330,67,397,14,411
公投第７案,新竹市,東區,豐功里,50,1195,500,172,672,34,706
公投第７案,新竹市,東區,豐功里,51,1569,620,193,813,54,867
公投第７案,新竹市,東區,豐功里,52,1533,737,182,919,39,958
公投第７案,新竹市,東區,武功里,53,1336,633,134,767,45,812
公投第７案,新竹市,東區,武功里,54,1367,663,110,773,38,811
公投第７案,新竹市,東區,武功里,55,1289,621,134,755,31,786
公投第７案,新竹市,東區,軍功里,56,960,392,112,504,23,527
公投第７案,新竹市,東區,軍功里,57,843,396,117,513,21,534
公投第７案,新竹市,東區,軍功里,58,948,416,113,529,40,569
公投第７案,新竹市,東區,立功里,59,915,410,73,483,30,513
公投第７案,新竹市,東區,建功里,60,1801,845,153,998,33,1031
公投第７案,新竹市,東區,建功里,61,1079,478,112,590,23,613
公投第７案,新竹市,東區,建功里,62,676,340,62,402,11,413
公投第７案,新竹市,東區,光明里,63,1132,508,129,637,37,674
公投第７案,新竹市,東區,光明里,64,251,94,42,136,12,148
公投第７案,新竹市,東區,光明里,65,1620,683,193,876,47,923
公投第７案,新竹市,東區,龍山里,66,1479,591,176,767,31,798
公投第７案,新竹市,東區,龍山里,67,1402,549,175,724,30,754
公投第７案,新竹市,東區,龍山里,68,1280,531,158,689,40,729
公投第７案,新竹市,東區,龍山里,69,1228,535,169,704,21,725
公投第７案,新竹市,東區,龍山里,70,1157,437,177,614,9,623
公投第７案,新竹市,東區,龍山里,71,1354,502,247,749,19,768
公投第７案,新竹市,東區,科園里,72,1334,629,209,838,28,866
公投第７案,新竹市,東區,科園里,73,1234,566,129,695,25,720
公投第７案,新竹市,東區,科園里,74,1398,668,169,837,30,867
公投第７案,新竹市,東區,科園里,75,928,383,154,537,30,567
公投第７案,新竹市,東區,科園里,76,1368,675,147,822,23,845
公投第７案,新竹市,東區,埔頂里,77,1215,467,130,597,20,617
公投第７案,新竹市,東區,埔頂里,78,1067,389,112,501,31,532
公投第７案,新竹市,東區,埔頂里,79,1194,464,177,641,15,656
公投第７案,新竹市,東區,埔頂里,80,1193,482,140,622,18,640
公投第７案,新竹市,東區,新莊里,81,1388,581,165,746,59,805
公投第７案,新竹市,東區,新莊里,82,1267,550,155,705,28,733
公投第７案,新竹市,東區,新莊里,83,1299,583,122,705,25,730
公投第７案,新竹市,東區,新莊里,84,1288,560,148,708,32,740
公投第７案,新竹市,東區,關新里,85,1228,537,188,725,19,744
公投第７案,新竹市,東區,關新里,86,1135,516,161,677,11,688
公投第７案,新竹市,東區,關新里,87,1237,567,194,761,23,784
公投第７案,新竹市,東區,關東里,88,1135,473,99,572,34,606
公投第７案,新竹市,東區,關東里,89,1165,464,103,567,18,585
公投第７案,新竹市,東區,關東里,90,1124,474,124,598,18,616
公投第７案,新竹市,東區,關東里,91,1210,539,130,669,43,712
公投第７案,新竹市,東區,金山里,92,1323,537,140,677,34,711
公投第７案,新竹市,東區,金山里,93,1207,506,104,610,20,630
公投第７案,新竹市,東區,金山里,94,1264,448,144,592,28,620
公投第７案,新竹市,東區,金山里,95,1248,546,136,682,23,705
公投第７案,新竹市,東區,仙水里,96,1400,665,158,823,35,858
公投第７案,新竹市,東區,仙水里,97,1473,645,200,845,21,866
公投第７案,新竹市,東區,仙水里,98,1367,587,147,734,37,771
公投第７案,新竹市,東區,仙宮里,99,1233,547,132,679,18,697
公投第７案,新竹市,東區,關帝里,100,507,199,56,255,14,269
公投第７案,新竹市,東區,南門里,101,714,294,92,386,33,419
公投第７案,新竹市,東區,南市里,102,875,338,124,462,51,513
公投第７案,新竹市,東區,福德里,103,1396,597,152,749,43,792
公投第７案,新竹市,東區,振興里,104,1232,470,143,613,37,650
公投第７案,新竹市,東區,振興里,105,1323,515,162,677,40,717
公投第７案,新竹市,東區,振興里,106,1516,533,121,654,18,672
公投第７案,新竹市,東區,振興里,107,1453,569,134,703,44,747
公投第７案,新竹市,東區,新興里,108,880,348,130,478,39,517
公投第７案,新竹市,東區,新興里,109,1058,448,85,533,27,560
公投第７案,新竹市,東區,新興里,110,1061,426,141,567,30,597
公投第７案,新竹市,東區,寺前里,111,710,273,95,368,33,401
公投第７案,新竹市,東區,竹蓮里,112,752,299,106,405,48,453
公投第７案,新竹市,東區,下竹里,113,475,226,56,282,18,300
公投第７案,新竹市,東區,頂竹里,114,880,329,99,428,36,464
公投第７案,新竹市,東區,頂竹里,115,989,413,118,531,33,564
公投第７案,新竹市,東區,頂竹里,116,1059,456,119,575,37,612
公投第７案,新竹市,東區,南大里,117,607,232,96,328,41,369
公投第７案,新竹市,東區,南大里,118,815,341,104,445,29,474
公投第７案,新竹市,東區,新光里,119,777,361,85,446,34,480
公投第７案,新竹市,東區,新光里,120,1399,516,129,645,30,675
公投第７案,新竹市,東區,新光里,121,1216,492,147,639,37,676
公投第７案,新竹市,東區,光鎮里,122,1062,404,115,519,35,554
公投第７案,新竹市,東區,光鎮里,123,1046,453,121,574,23,597
公投第７案,新竹市,東區,光鎮里,124,1332,546,119,665,16,681
公投第７案,新竹市,東區,高峰里,125,1350,560,170,730,46,776
公投第７案,新竹市,東區,高峰里,126,1438,553,154,707,17,724
公投第７案,新竹市,東區,高峰里,127,1414,520,156,676,42,718
公投第７案,新竹市,東區,高峰里,128,1476,644,164,808,27,835
公投第７案,新竹市,東區,湖濱里,129,1326,604,171,775,41,816
公投第７案,新竹市,東區,湖濱里,130,927,442,120,562,13,575
公投第７案,新竹市,東區,湖濱里,131,1273,525,163,688,20,708
公投第７案,新竹市,東區,柴橋里,132,1315,503,139,642,44,686
公投第７案,新竹市,東區,柴橋里,133,1413,604,165,769,23,792
公投第７案,新竹市,東區,柴橋里,134,1064,473,118,591,20,611
公投第７案,新竹市,東區,柴橋里,135,1244,577,181,758,23,781
公投第７案,新竹市,東區,明湖里,136,1160,466,113,579,8,587
公投第７案,新竹市,東區,明湖里,137,1398,525,138,663,17,680
公投第７案,新竹市,東區,明湖里,138,1384,439,116,555,14,569
公投第７案,新竹市,東區,明湖里,139,874,400,112,512,27,539
公投第７案,新竹市,北區,中央里,140,477,166,59,225,10,235
公投第７案,新竹市,北區,西門里,141,535,226,73,299,22,321
公投第７案,新竹市,北區,潛園里,142,746,269,123,392,52,444
公投第７案,新竹市,北區,石坊里,143,546,211,53,264,15,279
公投第７案,新竹市,北區,仁德里,144,711,328,85,413,29,442
公投第７案,新竹市,北區,崇禮里,145,1143,404,128,532,34,566
公投第７案,新竹市,北區,興南里,146,1370,522,152,674,39,713
公投第７案,新竹市,北區,育英里,147,1390,547,171,718,39,757
公投第７案,新竹市,北區,育英里,148,962,409,104,513,22,535
公投第７案,新竹市,北區,育英里,149,1237,508,143,651,14,665
公投第７案,新竹市,北區,台溪里,150,1604,591,155,746,42,788
公投第７案,新竹市,北區,曲溪里,151,758,274,75,349,12,361
公投第７案,新竹市,北區,曲溪里,152,1320,525,110,635,29,664
公投第７案,新竹市,北區,曲溪里,153,1519,576,139,715,48,763
公投第７案,新竹市,北區,曲溪里,154,347,92,36,128,5,133
公投第７案,新竹市,北區,曲溪里,155,1212,549,129,678,37,715
公投第７案,新竹市,北區,西雅里,156,1484,565,158,723,45,768
公投第７案,新竹市,北區,西雅里,157,1428,542,180,722,50,772
公投第７案,新竹市,北區,客雅里,158,1128,472,130,602,24,626
公投第７案,新竹市,北區,客雅里,159,638,263,69,332,15,347
公投第７案,新竹市,北區,中雅里,160,1222,579,85,664,42,706
公投第７案,新竹市,北區,中雅里,161,1076,459,98,557,22,579
公投第７案,新竹市,北區,中雅里,162,937,455,120,575,22,597
公投第７案,新竹市,北區,南勢里,163,1394,562,140,702,45,747
公投第７案,新竹市,北區,南勢里,164,1568,575,159,734,34,768
公投第７案,新竹市,北區,南勢里,165,1159,501,145,646,59,705
公投第７案,新竹市,北區,大鵬里,166,252,87,15,102,3,105
公投第７案,新竹市,北區,大同里,167,761,347,93,440,26,466
公投第７案,新竹市,北區,中山里,168,788,323,113,436,32,468
公投第７案,新竹市,北區,中興里,169,561,265,60,325,34,359
公投第７案,新竹市,北區,新民里,170,1558,587,153,740,84,824
公投第７案,新竹市,北區,長和里,171,1398,503,144,647,27,674
公投第７案,新竹市,北區,北門里,172,957,397,103,500,33,533
公投第７案,新竹市,北區,民富里,173,1195,523,117,640,43,683
公投第７案,新竹市,北區,民富里,174,1236,443,135,578,31,609
公投第７案,新竹市,北區,民富里,175,1255,458,146,604,48,652
公投第７案,新竹市,北區,民富里,176,1114,467,133,600,23,623
公投第７案,新竹市,北區,磐石里,177,1396,566,158,724,26,750
公投第７案,新竹市,北區,磐石里,178,1456,585,190,775,61,836
公投第７案,新竹市,北區,磐石里,179,1374,575,134,709,30,739
公投第７案,新竹市,北區,磐石里,180,1070,439,95,534,39,573
公投第７案,新竹市,北區,新雅里,181,1142,455,124,579,60,639
公投第７案,新竹市,北區,新雅里,182,1103,431,101,532,23,555
公投第７案,新竹市,北區,新雅里,183,1190,453,157,610,67,677
公投第７案,新竹市,北區,新雅里,184,1089,535,110,645,26,671
公投第７案,新竹市,北區,文雅里,185,1272,454,120,574,16,590
公投第７案,新竹市,北區,文雅里,186,1306,531,164,695,47,742
公投第７案,新竹市,北區,文雅里,187,1328,560,144,704,41,745
公投第７案,新竹市,北區,水田里,188,1457,585,132,717,31,748
公投第７案,新竹市,北區,水田里,189,1492,578,196,774,56,830
公投第７案,新竹市,北區,光田里,190,1160,515,139,654,49,703
公投第７案,新竹市,北區,光田里,191,971,399,132,531,40,571
公投第７案,新竹市,北區,光華里,192,1401,324,90,414,22,436
公投第７案,新竹市,北區,光華里,193,1340,566,164,730,34,764
公投第７案,新竹市,北區,光華里,194,1371,602,140,742,53,795
公投第７案,新竹市,北區,金華里,195,1267,516,144,660,17,677
公投第７案,新竹市,北區,金華里,196,1073,500,137,637,27,664
公投第７案,新竹市,北區,金華里,197,1159,487,156,643,34,677
公投第７案,新竹市,北區,金華里,198,1294,533,140,673,16,689
公投第７案,新竹市,北區,湳雅里,199,1442,593,163,756,41,797
公投第７案,新竹市,北區,湳雅里,200,1270,540,168,708,19,727
公投第７案,新竹市,北區,金雅里,201,1179,520,166,686,36,722
公投第７案,新竹市,北區,金雅里,202,949,449,114,563,33,596
公投第７案,新竹市,北區,湳中里,203,1163,488,147,635,34,669
公投第７案,新竹市,北區,湳中里,204,1334,556,134,690,21,711
公投第７案,新竹市,北區,湳中里,205,1415,589,165,754,39,793
公投第７案,新竹市,北區,湳中里,206,1305,577,176,753,36,789
公投第７案,新竹市,北區,湳中里,207,1200,537,114,651,31,682
公投第７案,新竹市,北區,舊社里,208,1106,474,116,590,23,613
公投第７案,新竹市,北區,舊社里,209,1044,484,121,605,22,627
公投第７案,新竹市,北區,舊社里,210,1061,454,139,593,34,627
公投第７案,新竹市,北區,舊社里,211,1518,659,171,830,64,894
公投第７案,新竹市,北區,舊社里,212,1220,561,158,719,39,758
公投第７案,新竹市,北區,金竹里,213,1475,642,179,821,18,839
公投第７案,新竹市,北區,金竹里,214,1373,554,149,703,42,745
公投第７案,新竹市,北區,金竹里,215,1450,630,169,799,19,818
公投第７案,新竹市,北區,金竹里,216,1423,649,148,797,30,827
公投第７案,新竹市,北區,武陵里,217,1059,504,84,588,14,602
公投第７案,新竹市,北區,武陵里,218,1130,558,93,651,34,685
公投第７案,新竹市,北區,武陵里,219,1208,614,110,724,28,752
公投第７案,新竹市,北區,武陵里,220,1226,634,104,738,25,763
公投第７案,新竹市,北區,福林里,221,1175,489,145,634,30,664
公投第７案,新竹市,北區,福林里,222,1371,571,156,727,24,751
公投第７案,新竹市,北區,福林里,223,1306,529,142,671,43,714
公投第７案,新竹市,北區,境福里,224,1340,521,150,671,23,694
公投第７案,新竹市,北區,境福里,225,1111,473,154,627,57,684
公投第７案,新竹市,北區,境福里,226,1197,562,157,719,44,763
公投第７案,新竹市,北區,境福里,227,1008,455,84,539,35,574
公投第７案,新竹市,北區,士林里,228,946,366,113,479,21,500
公投第７案,新竹市,北區,士林里,229,705,306,85,391,31,422
公投第７案,新竹市,北區,古賢里,230,848,340,115,455,50,505
公投第７案,新竹市,北區,南寮里,231,1295,537,122,659,26,685
公投第７案,新竹市,北區,南寮里,232,1467,578,119,697,42,739
公投第７案,新竹市,北區,南寮里,233,1659,574,136,710,37,747
公投第７案,新竹市,北區,南寮里,234,1297,490,141,631,43,674
公投第７案,新竹市,北區,康樂里,235,1374,549,171,720,69,789
公投第７案,新竹市,北區,康樂里,236,1457,626,151,777,66,843
公投第７案,新竹市,北區,中寮里,237,1072,512,94,606,26,632
公投第７案,新竹市,北區,中寮里,238,1350,541,134,675,50,725
公投第７案,新竹市,北區,中寮里,239,971,447,123,570,32,602
公投第７案,新竹市,北區,海濱里,240,1450,610,172,782,68,850
公投第７案,新竹市,北區,海濱里,241,895,386,89,475,31,506
公投第７案,新竹市,北區,海濱里,242,1378,599,125,724,32,756
公投第７案,新竹市,北區,港北里,243,1609,583,186,769,70,839
公投第７案,新竹市,北區,舊港里,244,594,247,64,311,35,346
公投第７案,新竹市,香山區,頂埔里,245,1443,578,143,721,56,777
公投第７案,新竹市,香山區,頂埔里,246,1241,512,133,645,40,685
公投第７案,新竹市,香山區,頂埔里,247,1194,536,85,621,22,643
公投第７案,新竹市,香山區,頂埔里,248,1081,475,111,586,11,597
公投第７案,新竹市,香山區,頂福里,249,807,364,72,436,21,457
公投第７案,新竹市,香山區,頂福里,250,1760,722,183,905,49,954
公投第７案,新竹市,香山區,頂福里,251,1635,721,163,884,31,915
公投第７案,新竹市,香山區,中埔里,252,1473,644,173,817,37,854
公投第７案,新竹市,香山區,中埔里,253,1408,619,150,769,19,788
公投第７案,新竹市,香山區,牛埔里,254,1318,483,114,597,19,616
公投第７案,新竹市,香山區,牛埔里,255,1337,564,153,717,34,751
公投第７案,新竹市,香山區,牛埔里,256,1862,856,170,1026,30,1056
公投第７案,新竹市,香山區,埔前里,257,1067,440,127,567,19,586
公投第７案,新竹市,香山區,埔前里,258,863,397,104,501,28,529
公投第７案,新竹市,香山區,埔前里,259,1198,518,164,682,54,736
公投第７案,新竹市,香山區,樹下里,260,1138,488,156,644,45,689
公投第７案,新竹市,香山區,樹下里,261,957,476,119,595,52,647
公投第７案,新竹市,香山區,浸水里,262,1348,586,141,727,70,797
公投第７案,新竹市,香山區,浸水里,263,1023,509,117,626,55,681
公投第７案,新竹市,香山區,虎林里,264,970,416,103,519,23,542
公投第７案,新竹市,香山區,虎林里,265,1318,546,157,703,45,748
公投第７案,新竹市,香山區,虎山里,266,1088,428,136,564,42,606
公投第７案,新竹市,香山區,虎山里,267,903,339,68,407,22,429
公投第７案,新竹市,香山區,虎山里,268,1012,405,148,553,34,587
公投第７案,新竹市,香山區,虎山里,269,1014,430,113,543,34,577
公投第７案,新竹市,香山區,虎山里,270,1238,534,142,676,24,700
公投第７案,新竹市,香山區,港南里,271,1182,466,125,591,68,659
公投第７案,新竹市,香山區,港南里,272,1331,626,155,781,68,849
公投第７案,新竹市,香山區,東香里,273,976,474,120,594,23,617
公投第７案,新竹市,香山區,東香里,274,834,358,74,432,15,447
公投第７案,新竹市,香山區,東香里,275,919,406,92,498,31,529
公投第７案,新竹市,香山區,東香里,276,1188,511,155,666,34,700
公投第７案,新竹市,香山區,香村里,277,1086,480,104,584,41,625
公投第７案,新竹市,香山區,香村里,278,1144,536,133,669,47,716
公投第７案,新竹市,香山區,香村里,279,1112,516,108,624,33,657
公投第７案,新竹市,香山區,香山里,280,1476,653,155,808,43,851
公投第７案,新竹市,香山區,香山里,281,1291,550,140,690,27,717
公投第７案,新竹市,香山區,香山里,282,1464,696,170,866,39,905
公投第７案,新竹市,香山區,大庄里,283,1427,607,135,742,81,823
公投第７案,新竹市,香山區,大庄里,284,1336,567,147,714,27,741
公投第７案,新竹市,香山區,美山里,285,1131,387,137,524,35,559
公投第７案,新竹市,香山區,朝山里,286,1070,464,122,586,63,649
公投第７案,新竹市,香山區,朝山里,287,1006,448,111,559,58,617
公投第７案,新竹市,香山區,海山里,288,1223,442,98,540,21,561
公投第７案,新竹市,香山區,海山里,289,1119,472,109,581,25,606
公投第７案,新竹市,香山區,鹽水里,290,1400,517,136,653,31,684
公投第７案,新竹市,香山區,內湖里,291,1627,579,142,721,30,751
公投第７案,新竹市,香山區,內湖里,292,1289,489,120,609,35,644
公投第７案,新竹市,香山區,內湖里,293,1409,538,134,672,43,715
公投第７案,新竹市,香山區,南港里,294,814,301,94,395,20,415
公投第７案,新竹市,香山區,中隘里,295,719,301,78,379,21,400
公投第７案,新竹市,香山區,中隘里,296,1065,383,100,483,17,500
公投第７案,新竹市,香山區,南隘里,297,776,331,68,399,29,428
公投第７案,新竹市,香山區,大湖里,298,890,382,98,480,33,513
公投第７案,新竹市,香山區,茄苳里,299,896,339,89,428,19,447
公投第７案,嘉義市,東區,短竹里,1,1025,419,121,540,31,571
公投第７案,嘉義市,東區,短竹里,2,1276,496,136,632,26,658
公投第７案,嘉義市,東區,蘭潭里,3,974,348,104,452,43,495
公投第７案,嘉義市,東區,蘭潭里,4,1175,522,149,671,47,718
公投第７案,嘉義市,東區,東川里,5,702,308,89,397,34,431
公投第７案,嘉義市,東區,東川里,6,1092,441,108,549,26,575
公投第７案,嘉義市,東區,鹿寮里,7,1023,339,97,436,14,450
公投第７案,嘉義市,東區,盧厝里,8,1816,696,172,868,67,935
公投第７案,嘉義市,東區,文雅里,9,1936,782,214,996,64,1060
公投第７案,嘉義市,東區,文雅里,10,1698,704,200,904,26,930
公投第７案,嘉義市,東區,王田里,11,1221,514,151,665,28,693
公投第７案,嘉義市,東區,王田里,12,1113,433,138,571,26,597
公投第７案,嘉義市,東區,長竹里,13,1452,593,185,778,43,821
公投第７案,嘉義市,東區,長竹里,14,1395,716,90,806,42,848
公投第７案,嘉義市,東區,後庄里,15,1453,497,154,651,47,698
公投第７案,嘉義市,東區,後庄里,16,1094,432,102,534,19,553
公投第７案,嘉義市,東區,後庄里,17,1420,601,146,747,36,783
公投第７案,嘉義市,東區,新店里,18,1552,637,222,859,48,907
公投第７案,嘉義市,東區,新店里,19,1558,631,191,822,63,885
公投第７案,嘉義市,東區,新店里,20,1062,438,140,578,37,615
公投第７案,嘉義市,東區,圳頭里,21,1199,475,132,607,48,655
公投第７案,嘉義市,東區,圳頭里,22,1236,523,123,646,27,673
公投第７案,嘉義市,東區,圳頭里,23,890,353,90,443,22,465
公投第７案,嘉義市,東區,圳頭里,24,880,397,99,496,38,534
公投第７案,嘉義市,東區,中山里,25,1189,474,137,611,19,630
公投第７案,嘉義市,東區,中山里,26,669,271,92,363,13,376
公投第７案,嘉義市,東區,太平里,27,1435,594,143,737,44,781
公投第７案,嘉義市,東區,太平里,28,1349,596,180,776,37,813
公投第７案,嘉義市,東區,太平里,29,1455,545,186,731,29,760
公投第７案,嘉義市,東區,東興里,30,915,371,114,485,39,524
公投第７案,嘉義市,東區,東興里,31,952,348,131,479,30,509
公投第７案,嘉義市,東區,華南里,32,941,354,127,481,45,526
公投第７案,嘉義市,東區,華南里,33,1080,391,131,522,23,545
公投第７案,嘉義市,東區,中央里,34,1157,395,118,513,24,537
公投第７案,嘉義市,東區,中央里,35,1053,436,140,576,23,599
公投第７案,嘉義市,東區,朝陽里,36,967,322,106,428,25,453
公投第７案,嘉義市,東區,朝陽里,37,1091,374,137,511,33,544
公投第７案,嘉義市,東區,民族里,38,961,402,110,512,53,565
公投第７案,嘉義市,東區,民族里,39,863,246,80,326,28,354
公投第７案,嘉義市,東區,過溝里,40,1023,440,118,558,54,612
公投第７案,嘉義市,東區,過溝里,41,1078,417,147,564,80,644
公投第７案,嘉義市,東區,新開里,42,938,356,107,463,19,482
公投第７案,嘉義市,東區,新開里,43,1049,405,131,536,29,565
公投第７案,嘉義市,東區,宣信里,44,1360,483,146,629,75,704
公投第７案,嘉義市,東區,興南里,45,1615,501,192,693,95,788
公投第７案,嘉義市,東區,豐年里,46,1267,452,167,619,53,672
公投第７案,嘉義市,東區,芳草里,47,1579,522,160,682,71,753
公投第７案,嘉義市,東區,芳草里,48,1831,679,188,867,74,941
公投第７案,嘉義市,東區,芳安里,49,977,418,100,518,35,553
公投第７案,嘉義市,東區,芳安里,50,1169,395,160,555,34,589
公投第７案,嘉義市,東區,頂寮里,51,1238,506,146,652,85,737
公投第７案,嘉義市,東區,頂寮里,52,1266,530,127,657,22,679
公投第７案,嘉義市,東區,安寮里,53,1429,505,113,618,42,660
公投第７案,嘉義市,東區,安寮里,54,1288,540,132,672,23,695
公投第７案,嘉義市,東區,安業里,55,980,384,120,504,34,538
公投第７案,嘉義市,東區,安業里,56,922,344,98,442,22,464
公投第７案,嘉義市,東區,興村里,57,1133,479,129,608,54,662
公投第７案,嘉義市,東區,興村里,58,1235,522,123,645,47,692
公投第７案,嘉義市,東區,興村里,59,1525,612,152,764,21,785
公投第７案,嘉義市,東區,興安里,60,1170,441,115,556,50,606
公投第７案,嘉義市,東區,興安里,61,1177,507,165,672,65,737
公投第７案,嘉義市,東區,興仁里,62,1207,494,124,618,55,673
公投第７案,嘉義市,東區,興仁里,63,1272,528,145,673,50,723
公投第７案,嘉義市,東區,興仁里,64,1188,444,156,600,70,670
公投第７案,嘉義市,東區,北門里,65,1172,423,124,547,29,576
公投第７案,嘉義市,東區,北門里,66,1020,416,141,557,38,595
公投第７案,嘉義市,東區,林森里,67,1332,554,150,704,55,759
公投第７案,嘉義市,東區,林森里,68,1011,427,154,581,39,620
公投第７案,嘉義市,東區,中庄里,69,1682,624,176,800,76,876
公投第７案,嘉義市,東區,中庄里,70,1567,686,105,791,66,857
公投第７案,嘉義市,東區,頂庄里,71,1207,510,106,616,21,637
公投第７案,嘉義市,東區,頂庄里,72,981,435,101,536,20,556
公投第７案,嘉義市,東區,義教里,73,1395,539,138,677,48,725
公投第７案,嘉義市,東區,義教里,74,1434,465,164,629,14,643
公投第７案,嘉義市,東區,仁義里,75,1404,451,138,589,25,614
公投第７案,嘉義市,東區,仁義里,76,1428,593,142,735,43,778
公投第７案,嘉義市,東區,後湖里,77,1823,545,151,696,51,747
公投第７案,嘉義市,東區,後湖里,78,1570,547,170,717,39,756
公投第７案,嘉義市,東區,荖藤里,79,1282,436,146,582,59,641
公投第７案,嘉義市,東區,荖藤里,80,1571,718,152,870,58,928
公投第７案,嘉義市,東區,荖藤里,81,1533,571,155,726,31,757
公投第７案,嘉義市,西區,書院里,82,885,334,99,433,18,451
公投第７案,嘉義市,西區,書院里,83,1109,433,113,546,57,603
公投第７案,嘉義市,西區,永和里,84,1020,320,128,448,42,490
公投第７案,嘉義市,西區,永和里,85,925,437,96,533,44,577
公投第７案,嘉義市,西區,新富里,86,1671,486,190,676,34,710
公投第７案,嘉義市,西區,文化里,87,1215,471,143,614,29,643
公投第７案,嘉義市,西區,文化里,88,1036,379,120,499,22,521
公投第７案,嘉義市,西區,西榮里,89,1129,389,137,526,32,558
公投第７案,嘉義市,西區,西榮里,90,1127,397,142,539,28,567
公投第７案,嘉義市,西區,番社里,91,1415,507,188,695,42,737
公投第７案,嘉義市,西區,國華里,92,1366,501,152,653,26,679
公投第７案,嘉義市,西區,大溪里,93,1053,439,141,580,61,641
公投第７案,嘉義市,西區,大溪里,94,1067,435,95,530,24,554
公投第７案,嘉義市,西區,磚磘里,95,1575,514,154,668,31,699
公投第７案,嘉義市,西區,磚磘里,96,1865,706,215,921,47,968
公投第７案,嘉義市,西區,福全里,97,1196,446,98,544,45,589
公投第７案,嘉義市,西區,福全里,98,1280,449,118,567,24,591
公投第７案,嘉義市,西區,福全里,99,1629,651,158,809,66,875
公投第７案,嘉義市,西區,福安里,100,1393,558,170,728,75,803
公投第７案,嘉義市,西區,福安里,101,1077,452,138,590,35,625
公投第７案,嘉義市,西區,福安里,102,1694,604,157,761,36,797
公投第７案,嘉義市,西區,新西里,103,841,343,102,445,80,525
公投第７案,嘉義市,西區,新西里,104,1183,425,126,551,6,557
公投第７案,嘉義市,西區,港坪里,105,1000,451,115,566,31,597
公投第７案,嘉義市,西區,港坪里,106,1095,469,131,600,24,624
公投第７案,嘉義市,西區,港坪里,107,1256,534,157,691,35,726
公投第７案,嘉義市,西區,頭港里,108,962,407,100,507,52,559
公投第７案,嘉義市,西區,頭港里,109,865,384,129,513,20,533
公投第７案,嘉義市,西區,西平里,110,1396,509,146,655,65,720
公投第７案,嘉義市,西區,西平里,111,1799,733,173,906,68,974
公投第７案,嘉義市,西區,劉厝里,112,1505,544,145,689,37,726
公投第７案,嘉義市,西區,劉厝里,113,1698,657,162,819,65,884
公投第７案,嘉義市,西區,劉厝里,114,1854,738,184,922,20,942
公投第７案,嘉義市,西區,劉厝里,115,1537,522,129,651,14,665
公投第７案,嘉義市,西區,自強里,116,1604,629,103,732,89,821
公投第７案,嘉義市,西區,美源里,117,944,431,102,533,61,594
公投第７案,嘉義市,西區,美源里,118,1627,657,187,844,83,927
公投第７案,嘉義市,西區,美源里,119,1144,490,131,621,52,673
公投第７案,嘉義市,西區,湖內里,120,1362,536,154,690,50,740
公投第７案,嘉義市,西區,湖內里,121,1279,515,143,658,39,697
公投第７案,嘉義市,西區,湖內里,122,1702,681,194,875,70,945
公投第７案,嘉義市,西區,獅子里,123,1358,589,153,742,54,796
公投第７案,嘉義市,西區,獅子里,124,1360,601,164,765,66,831
公投第７案,嘉義市,西區,紅瓦里,125,1589,637,195,832,64,896
公投第７案,嘉義市,西區,光路里,126,1280,576,140,716,43,759
公投第７案,嘉義市,西區,光路里,127,1220,435,120,555,30,585
公投第７案,嘉義市,西區,光路里,128,1172,513,123,636,28,664
公投第７案,嘉義市,西區,光路里,129,1320,563,123,686,45,731
公投第７案,嘉義市,西區,福民里,130,1185,576,138,714,35,749
公投第７案,嘉義市,西區,福民里,131,1278,519,186,705,60,765
公投第７案,嘉義市,西區,福民里,132,1394,464,128,592,28,620
公投第７案,嘉義市,西區,福民里,133,1540,650,167,817,59,876
公投第７案,嘉義市,西區,車店里,134,1548,638,157,795,73,868
公投第７案,嘉義市,西區,車店里,135,1295,523,123,646,37,683
公投第７案,嘉義市,西區,車店里,136,1318,594,155,749,48,797
公投第７案,嘉義市,西區,車店里,137,1545,634,160,794,59,853
公投第７案,嘉義市,西區,垂楊里,138,736,271,58,329,24,353
公投第７案,嘉義市,西區,垂楊里,139,1168,440,122,562,19,581
公投第７案,嘉義市,西區,培元里,140,756,338,104,442,32,474
公投第７案,嘉義市,西區,培元里,141,869,397,60,457,15,472
公投第７案,嘉義市,西區,育英里,142,983,412,118,530,48,578
公投第７案,嘉義市,西區,育英里,143,828,336,88,424,45,469
公投第７案,嘉義市,西區,致遠里,144,1775,797,141,938,40,978
公投第７案,嘉義市,西區,翠岱里,145,1419,607,115,722,41,763
公投第７案,嘉義市,西區,導明里,146,779,288,90,378,13,391
公投第７案,嘉義市,西區,導明里,147,855,314,77,391,17,408
公投第７案,嘉義市,西區,北榮里,148,1146,479,117,596,77,673
公投第７案,嘉義市,西區,北榮里,149,1111,440,144,584,32,616
公投第７案,嘉義市,西區,慶安里,150,767,342,102,444,48,492
公投第７案,嘉義市,西區,慶安里,151,817,285,73,358,26,384
公投第７案,嘉義市,西區,香湖里,152,770,291,96,387,60,447
公投第７案,嘉義市,西區,重興里,153,1135,346,109,455,26,481
公投第７案,嘉義市,西區,重興里,154,835,282,87,369,86,455
公投第７案,嘉義市,西區,後驛里,155,1182,406,108,514,43,557
公投第７案,嘉義市,西區,後驛里,156,944,284,115,399,39,438
公投第７案,嘉義市,西區,湖邊里,157,997,358,103,461,35,496
公投第７案,嘉義市,西區,湖邊里,158,1074,395,128,523,32,555
公投第７案,嘉義市,西區,竹圍里,159,1460,450,149,599,24,623
公投第７案,嘉義市,西區,竹圍里,160,1352,508,136,644,33,677
公投第７案,嘉義市,西區,竹圍里,161,1499,572,180,752,51,803
公投第７案,嘉義市,西區,保生里,162,1262,451,145,596,103,699
公投第７案,嘉義市,西區,保生里,163,1299,483,150,633,30,663
公投第７案,嘉義市,西區,保生里,164,1734,583,190,773,61,834
公投第７案,嘉義市,西區,保安里,165,1674,622,129,751,34,785
公投第７案,嘉義市,西區,保安里,166,1540,580,153,733,30,763
公投第７案,嘉義市,西區,北新里,167,1056,447,122,569,27,596
公投第７案,嘉義市,西區,新厝里,168,1467,555,192,747,105,852
公投第７案,嘉義市,西區,新厝里,169,1431,520,157,677,67,744
公投第７案,嘉義市,西區,新厝里,170,1234,558,138,696,74,770
公投第７案,嘉義市,西區,保福里,171,1266,475,133,608,33,641
公投第７案,嘉義市,西區,保福里,172,1211,490,137,627,34,661
公投第７案,嘉義市,西區,保福里,173,1121,469,141,610,25,635
公投第７案,嘉義市,西區,竹村里,174,1155,384,119,503,21,524
公投第７案,嘉義市,西區,北湖里,175,1546,587,208,795,124,919
公投第７案,嘉義市,西區,北湖里,176,1322,482,138,620,30,650
公投第７案,嘉義市,西區,下埤里,177,1549,619,177,796,89,885
公投第７案,臺北市,北投區,建民里,1,1313,556,178,734,68,802
公投第７案,臺北市,北投區,建民里,2,1403,582,237,819,45,864
公投第７案,臺北市,北投區,建民里,3,1081,427,184,611,55,666
公投第７案,臺北市,北投區,文林里,4,1209,510,164,674,52,726
公投第７案,臺北市,北投區,文林里,5,1326,530,188,718,54,772
公投第７案,臺北市,北投區,文林里,6,1263,525,178,703,62,765
公投第７案,臺北市,北投區,石牌里,7,1580,670,222,892,59,951
公投第７案,臺北市,北投區,石牌里,8,1577,672,211,883,45,928
公投第７案,臺北市,北投區,石牌里,9,1483,632,183,815,70,885
公投第７案,臺北市,北投區,福興里,10,1461,605,166,771,42,813
公投第７案,臺北市,北投區,福興里,11,1466,571,198,769,71,840
公投第７案,臺北市,北投區,福興里,12,1620,689,205,894,63,957
公投第７案,臺北市,北投區,福興里,13,1543,593,174,767,29,796
公投第７案,臺北市,北投區,榮光里,14,1513,561,185,746,69,815
公投第７案,臺北市,北投區,榮光里,15,1534,645,173,818,48,866
公投第７案,臺北市,北投區,榮光里,16,1650,722,185,907,75,982
公投第７案,臺北市,北投區,榮光里,17,1533,651,174,825,43,868
公投第７案,臺北市,北投區,榮華里,18,1702,670,214,884,53,937
公投第７案,臺北市,北投區,榮華里,19,1721,678,239,917,55,972
公投第７案,臺北市,北投區,榮華里,20,1575,644,252,896,64,960
公投第７案,臺北市,北投區,榮華里,21,1530,632,196,828,74,902
公投第７案,臺北市,北投區,裕民里,22,1728,725,210,935,67,1002
公投第７案,臺北市,北投區,裕民里,23,1702,697,207,904,73,977
公投第７案,臺北市,北投區,裕民里,24,1696,652,232,884,72,956
公投第７案,臺北市,北投區,裕民里,25,1684,592,170,762,36,798
公投第７案,臺北市,北投區,振華里,26,1717,750,205,955,73,1028
公投第７案,臺北市,北投區,振華里,27,1605,664,210,874,45,919
公投第７案,臺北市,北投區,振華里,28,1723,717,214,931,53,984
公投第７案,臺北市,北投區,振華里,29,1597,683,233,916,62,978
公投第７案,臺北市,北投區,永和里,30,1700,677,235,912,50,962
公投第７案,臺北市,北投區,永和里,31,1544,578,192,770,43,813
公投第７案,臺北市,北投區,永和里,32,1635,618,194,812,58,870
公投第７案,臺北市,北投區,永和里,33,1495,639,181,820,37,857
公投第７案,臺北市,北投區,永和里,34,1619,685,213,898,32,930
公投第７案,臺北市,北投區,永欣里,35,1683,657,250,907,49,956
公投第７案,臺北市,北投區,永欣里,36,1662,618,187,805,65,870
公投第７案,臺北市,北投區,永欣里,37,1850,654,201,855,42,897
公投第７案,臺北市,北投區,永欣里,38,1674,615,211,826,26,852
公投第７案,臺北市,北投區,永明里,39,1511,681,180,861,55,916
公投第７案,臺北市,北投區,永明里,40,1393,551,179,730,26,756
公投第７案,臺北市,北投區,永明里,41,1279,603,150,753,57,810
公投第７案,臺北市,北投區,東華里,42,1122,471,114,585,36,621
公投第７案,臺北市,北投區,東華里,43,1238,646,157,803,56,859
公投第７案,臺北市,北投區,東華里,44,1477,651,201,852,60,912
公投第７案,臺北市,北投區,吉利里,45,1495,650,190,840,72,912
公投第７案,臺北市,北投區,吉利里,46,1469,672,200,872,45,917
公投第７案,臺北市,北投區,吉利里,47,1462,640,161,801,59,860
公投第７案,臺北市,北投區,吉利里,48,1431,618,163,781,69,850
公投第７案,臺北市,北投區,吉慶里,49,1486,583,109,692,46,738
公投第７案,臺北市,北投區,吉慶里,50,1449,615,206,821,60,881
公投第７案,臺北市,北投區,吉慶里,51,1456,606,188,794,37,831
公投第７案,臺北市,北投區,尊賢里,52,1311,527,166,693,34,727
公投第７案,臺北市,北投區,尊賢里,53,1356,564,154,718,64,782
公投第７案,臺北市,北投區,尊賢里,54,1338,544,182,726,38,764
公投第７案,臺北市,北投區,立賢里,55,1525,636,183,819,31,850
公投第７案,臺北市,北投區,立賢里,56,1620,635,186,821,47,868
公投第７案,臺北市,北投區,立賢里,57,1499,599,145,744,32,776
公投第７案,臺北市,北投區,立農里,58,1497,678,160,838,36,874
公投第７案,臺北市,北投區,立農里,59,1624,652,202,854,60,914
公投第７案,臺北市,北投區,立農里,60,1536,590,164,754,85,839
公投第７案,臺北市,北投區,立農里,61,1469,624,194,818,82,900
公投第７案,臺北市,北投區,立農里,62,1598,619,216,835,54,889
公投第７案,臺北市,北投區,八仙里,63,1690,665,207,872,37,909
公投第７案,臺北市,北投區,八仙里,64,1599,613,195,808,98,906
公投第７案,臺北市,北投區,八仙里,65,1634,652,211,863,71,934
公投第７案,臺北市,北投區,洲美里,66,1660,610,214,824,55,879
公投第７案,臺北市,北投區,奇岩里,67,1900,710,217,927,64,991
公投第７案,臺北市,北投區,奇岩里,68,1797,728,237,965,61,1026
公投第７案,臺北市,北投區,奇岩里,69,1832,719,260,979,77,1056
公投第７案,臺北市,北投區,奇岩里,70,1784,751,232,983,63,1046
公投第７案,臺北市,北投區,奇岩里,71,1732,709,241,950,57,1007
公投第７案,臺北市,北投區,清江里,72,2035,393,102,495,60,555
公投第７案,臺北市,北投區,清江里,73,1504,607,181,788,76,864
公投第７案,臺北市,北投區,清江里,74,1683,720,200,920,79,999
公投第７案,臺北市,北投區,清江里,75,1635,613,206,819,83,902
公投第７案,臺北市,北投區,清江里,76,1613,634,197,831,69,900
公投第７案,臺北市,北投區,中央里,77,1483,589,144,733,37,770
公投第７案,臺北市,北投區,中央里,78,1500,588,207,795,46,841
公投第７案,臺北市,北投區,中央里,79,1483,614,183,797,70,867
公投第７案,臺北市,北投區,中央里,80,1544,601,210,811,62,873
公投第７案,臺北市,北投區,中央里,81,1532,528,151,679,75,754
公投第７案,臺北市,北投區,長安里,82,1819,726,232,958,68,1026
公投第７案,臺北市,北投區,長安里,83,1863,624,258,882,80,962
公投第７案,臺北市,北投區,長安里,84,1872,623,234,857,31,888
公投第７案,臺北市,北投區,大同里,85,1627,617,202,819,59,878
公投第７案,臺北市,北投區,大同里,86,1696,647,192,839,38,877
公投第７案,臺北市,北投區,大同里,87,1841,709,240,949,61,1010
公投第７案,臺北市,北投區,溫泉里,88,1324,536,154,690,62,752
公投第７案,臺北市,北投區,溫泉里,89,1504,591,149,740,45,785
公投第７案,臺北市,北投區,溫泉里,90,1511,611,178,789,57,846
公投第７案,臺北市,北投區,溫泉里,91,1615,649,248,897,51,948
公投第７案,臺北市,北投區,林泉里,92,1270,492,132,624,38,662
公投第７案,臺北市,北投區,林泉里,93,1492,516,170,686,37,723
公投第７案,臺北市,北投區,中心里,94,1429,514,192,706,49,755
公投第７案,臺北市,北投區,中心里,95,1567,621,167,788,23,811
公投第７案,臺北市,北投區,中心里,96,1388,555,174,729,49,778
公投第７案,臺北市,北投區,中心里,97,1448,538,165,703,25,728
公投第７案,臺北市,北投區,中庸里,98,1356,498,171,669,55,724
公投第７案,臺北市,北投區,中庸里,99,1308,542,144,686,47,733
公投第７案,臺北市,北投區,中庸里,100,1165,497,138,635,52,687
公投第７案,臺北市,北投區,開明里,101,1429,611,157,768,67,835
公投第７案,臺北市,北投區,開明里,102,1472,601,148,749,36,785
公投第７案,臺北市,北投區,開明里,103,1508,670,201,871,64,935
公投第７案,臺北市,北投區,開明里,104,1480,586,193,779,61,840
公投第７案,臺北市,北投區,中和里,105,1142,425,144,569,47,616
公投第７案,臺北市,北投區,中和里,106,1554,615,159,774,47,821
公投第７案,臺北市,北投區,中和里,107,1669,699,206,905,93,998
公投第７案,臺北市,北投區,智仁里,108,1823,768,207,975,75,1050
公投第７案,臺北市,北投區,智仁里,109,1739,682,168,850,101,951
公投第７案,臺北市,北投區,智仁里,110,1771,696,192,888,64,952
公投第７案,臺北市,北投區,秀山里,111,1468,572,153,725,50,775
公投第７案,臺北市,北投區,秀山里,112,1469,585,175,760,42,802
公投第７案,臺北市,北投區,文化里,113,1094,568,100,668,43,711
公投第７案,臺北市,北投區,文化里,114,1101,544,115,659,42,701
公投第７案,臺北市,北投區,文化里,115,1422,742,69,811,55,866
公投第７案,臺北市,北投區,豐年里,116,1390,600,119,719,57,776
公投第７案,臺北市,北投區,豐年里,117,1307,555,157,712,67,779
公投第７案,臺北市,北投區,豐年里,118,1215,536,153,689,81,770
公投第７案,臺北市,北投區,稻香里,119,1642,637,166,803,42,845
公投第７案,臺北市,北投區,稻香里,120,1623,659,136,795,34,829
公投第７案,臺北市,北投區,稻香里,121,1621,653,177,830,65,895
公投第７案,臺北市,北投區,桃源里,122,1367,551,165,716,21,737
公投第７案,臺北市,北投區,桃源里,123,1309,477,183,660,57,717
公投第７案,臺北市,北投區,桃源里,124,1356,571,168,739,32,771
公投第７案,臺北市,北投區,桃源里,125,1365,545,152,697,54,751
公投第７案,臺北市,北投區,一德里,126,1613,601,209,810,47,857
公投第７案,臺北市,北投區,一德里,127,1590,553,170,723,39,762
公投第７案,臺北市,北投區,一德里,128,1662,687,216,903,67,970
公投第７案,臺北市,北投區,一德里,129,1622,660,213,873,58,931
公投第７案,臺北市,北投區,關渡里,130,1820,670,264,934,43,977
公投第７案,臺北市,北投區,關渡里,131,1615,667,204,871,67,938
公投第７案,臺北市,北投區,關渡里,132,1612,532,150,682,70,752
公投第７案,臺北市,北投區,關渡里,133,1652,745,90,835,78,913
公投第７案,臺北市,北投區,關渡里,134,1666,684,195,879,33,912
公投第７案,臺北市,北投區,關渡里,135,1641,632,203,835,51,886
公投第７案,臺北市,北投區,泉源里,136,528,215,64,279,40,319
公投第７案,臺北市,北投區,泉源里,137,1642,531,178,709,75,784
公投第７案,臺北市,北投區,湖山里,138,829,347,87,434,35,469
公投第７案,臺北市,北投區,湖山里,139,690,280,71,351,31,382
公投第７案,臺北市,北投區,大屯里,140,1067,416,116,532,52,584
公投第７案,臺北市,北投區,湖田里,141,892,366,90,456,51,507
公投第７案,臺北市,士林區,仁勇里,142,1695,613,243,856,83,939
公投第７案,臺北市,士林區,仁勇里,143,1720,706,216,922,93,1015
公投第７案,臺北市,士林區,義信里,144,1288,519,150,669,76,745
公投第７案,臺北市,士林區,義信里,145,1546,576,220,796,63,859
公投第７案,臺北市,士林區,福林里,146,652,303,77,380,31,411
公投第７案,臺北市,士林區,福林里,147,870,352,95,447,38,485
公投第７案,臺北市,士林區,福林里,148,1137,442,214,656,50,706
公投第７案,臺北市,士林區,福德里,149,1050,444,157,601,63,664
公投第７案,臺北市,士林區,福德里,150,1031,449,134,583,59,642
公投第７案,臺北市,士林區,福德里,151,1075,442,159,601,33,634
公投第７案,臺北市,士林區,福德里,152,2175,363,108,471,49,520
公投第７案,臺北市,士林區,福志里,153,1775,678,202,880,70,950
公投第７案,臺北市,士林區,福志里,154,1669,731,107,838,44,882
公投第７案,臺北市,士林區,福志里,155,1665,689,260,949,68,1017
公投第７案,臺北市,士林區,福志里,156,1648,683,272,955,65,1020
公投第７案,臺北市,士林區,舊佳里,157,1246,521,157,678,30,708
公投第７案,臺北市,士林區,舊佳里,158,1419,541,194,735,77,812
公投第７案,臺北市,士林區,舊佳里,159,1327,515,183,698,77,775
公投第７案,臺北市,士林區,舊佳里,160,1573,643,254,897,79,976
公投第７案,臺北市,士林區,福佳里,161,1470,628,170,798,73,871
公投第７案,臺北市,士林區,福佳里,162,1775,695,253,948,27,975
公投第７案,臺北市,士林區,福佳里,163,1692,705,233,938,55,993
公投第７案,臺北市,士林區,福佳里,164,1842,749,263,1012,56,1068
公投第７案,臺北市,士林區,後港里,165,1166,512,153,665,50,715
公投第７案,臺北市,士林區,後港里,166,1687,601,197,798,76,874
公投第７案,臺北市,士林區,後港里,167,1624,634,215,849,71,920
公投第７案,臺北市,士林區,後港里,168,1477,622,204,826,97,923
公投第７案,臺北市,士林區,後港里,169,1250,500,199,699,52,751
公投第７案,臺北市,士林區,福中里,170,1434,580,185,765,92,857
公投第７案,臺北市,士林區,福中里,171,1452,602,208,810,62,872
公投第７案,臺北市,士林區,福中里,172,1533,670,221,891,70,961
公投第７案,臺北市,士林區,福中里,173,1515,652,198,850,77,927
公投第７案,臺北市,士林區,前港里,174,1203,494,178,672,59,731
公投第７案,臺北市,士林區,前港里,175,1487,652,194,846,81,927
公投第７案,臺北市,士林區,前港里,176,1252,514,161,675,37,712
公投第７案,臺北市,士林區,百齡里,177,1536,595,205,800,58,858
公投第７案,臺北市,士林區,百齡里,178,1556,589,277,866,77,943
公投第７案,臺北市,士林區,百齡里,179,1511,618,209,827,52,879
公投第７案,臺北市,士林區,百齡里,180,1572,665,228,893,74,967
公投第７案,臺北市,士林區,承德里,181,1668,693,187,880,79,959
公投第７案,臺北市,士林區,承德里,182,1685,668,189,857,102,959
公投第７案,臺北市,士林區,承德里,183,1568,626,188,814,73,887
公投第７案,臺北市,士林區,福華里,184,1327,508,174,682,47,729
公投第７案,臺北市,士林區,福華里,185,1338,520,156,676,42,718
公投第７案,臺北市,士林區,福華里,186,1515,564,181,745,60,805
公投第７案,臺北市,士林區,福華里,187,1452,618,188,806,69,875
公投第７案,臺北市,士林區,明勝里,188,1448,606,181,787,60,847
公投第７案,臺北市,士林區,明勝里,189,1521,628,205,833,56,889
公投第７案,臺北市,士林區,明勝里,190,1461,561,217,778,41,819
公投第７案,臺北市,士林區,福順里,191,1541,547,217,764,68,832
公投第７案,臺北市,士林區,福順里,192,1611,499,192,691,59,750
公投第７案,臺北市,士林區,福順里,193,1595,624,202,826,75,901
公投第７案,臺北市,士林區,富光里,194,1685,647,180,827,39,866
公投第７案,臺北市,士林區,富光里,195,1816,660,226,886,84,970
公投第７案,臺北市,士林區,富光里,196,1687,639,230,869,91,960
公投第７案,臺北市,士林區,葫蘆里,197,1646,643,202,845,88,933
公投第７案,臺北市,士林區,葫蘆里,198,1643,644,174,818,64,882
公投第７案,臺北市,士林區,葫蘆里,199,1687,733,177,910,57,967
公投第７案,臺北市,士林區,葫蘆里,200,1655,667,226,893,79,972
公投第７案,臺北市,士林區,葫東里,201,1779,646,240,886,30,916
公投第７案,臺北市,士林區,葫東里,202,1855,740,266,1006,68,1074
公投第７案,臺北市,士林區,社子里,203,1350,547,176,723,58,781
公投第７案,臺北市,士林區,社子里,204,1455,548,158,706,30,736
公投第７案,臺北市,士林區,社子里,205,1497,485,161,646,74,720
公投第７案,臺北市,士林區,社子里,206,1398,442,161,603,64,667
公投第７案,臺北市,士林區,社新里,207,1747,699,247,946,80,1026
公投第７案,臺北市,士林區,社新里,208,1465,564,182,746,81,827
公投第７案,臺北市,士林區,社新里,209,1530,585,210,795,71,866
公投第７案,臺北市,士林區,社新里,210,1855,671,213,884,83,967
公投第７案,臺北市,士林區,社新里,211,1444,550,195,745,78,823
公投第７案,臺北市,士林區,社園里,212,1563,572,174,746,85,831
公投第７案,臺北市,士林區,社園里,213,1482,574,195,769,78,847
公投第７案,臺北市,士林區,社園里,214,1552,565,199,764,98,862
公投第７案,臺北市,士林區,社園里,215,1790,704,228,932,78,1010
公投第７案,臺北市,士林區,永倫里,216,1628,599,172,771,83,854
公投第７案,臺北市,士林區,永倫里,217,1337,590,90,680,78,758
公投第７案,臺北市,士林區,永倫里,218,1750,682,214,896,93,989
公投第７案,臺北市,士林區,永倫里,219,1668,592,197,789,105,894
公投第７案,臺北市,士林區,福安里,220,1403,433,153,586,83,669
公投第７案,臺北市,士林區,福安里,221,1468,441,204,645,58,703
公投第７案,臺北市,士林區,福安里,222,1471,480,175,655,41,696
公投第７案,臺北市,士林區,富洲里,223,1666,611,179,790,94,884
公投第７案,臺北市,士林區,富洲里,224,1587,559,203,762,61,823
公投第７案,臺北市,士林區,富洲里,225,1987,667,214,881,71,952
公投第７案,臺北市,士林區,岩山里,226,1271,470,132,602,22,624
公投第７案,臺北市,士林區,岩山里,227,1728,738,223,961,75,1036
公投第７案,臺北市,士林區,名山里,228,1630,688,217,905,72,977
公投第７案,臺北市,士林區,名山里,229,1619,657,235,892,61,953
公投第７案,臺北市,士林區,名山里,230,1425,598,177,775,43,818
公投第７案,臺北市,士林區,名山里,231,1623,693,235,928,69,997
公投第７案,臺北市,士林區,聖山里,232,1564,639,233,872,50,922
公投第７案,臺北市,士林區,聖山里,233,1376,636,201,837,201,1038
公投第７案,臺北市,士林區,聖山里,234,1517,733,164,897,43,940
公投第７案,臺北市,士林區,芝山里,235,1729,638,235,873,43,916
公投第７案,臺北市,士林區,芝山里,236,1511,692,185,877,49,926
公投第７案,臺北市,士林區,芝山里,237,1811,787,230,1017,52,1069
公投第７案,臺北市,士林區,芝山里,238,1533,646,173,819,44,863
公投第７案,臺北市,士林區,東山里,239,1657,786,227,1013,61,1074
公投第７案,臺北市,士林區,東山里,240,1499,633,170,803,44,847
公投第７案,臺北市,士林區,東山里,241,1402,586,158,744,65,809
公投第７案,臺北市,士林區,德行里,242,1273,552,211,763,68,831
公投第７案,臺北市,士林區,德行里,243,1273,546,165,711,49,760
公投第７案,臺北市,士林區,德行里,244,1316,522,198,720,54,774
公投第７案,臺北市,士林區,德華里,245,1659,672,217,889,68,957
公投第７案,臺北市,士林區,德華里,246,1749,676,240,916,41,957
公投第７案,臺北市,士林區,德華里,247,1552,595,220,815,70,885
公投第７案,臺北市,士林區,忠誠里,248,1529,671,175,846,50,896
公投第７案,臺北市,士林區,忠誠里,249,1644,655,217,872,37,909
公投第７案,臺北市,士林區,忠誠里,250,1779,707,238,945,62,1007
公投第７案,臺北市,士林區,蘭雅里,251,1597,635,225,860,50,910
公投第７案,臺北市,士林區,蘭雅里,252,1454,578,186,764,70,834
公投第７案,臺北市,士林區,蘭雅里,253,1582,662,252,914,48,962
公投第７案,臺北市,士林區,蘭雅里,254,1518,649,205,854,47,901
公投第７案,臺北市,士林區,蘭雅里,255,1501,555,190,745,26,771
公投第７案,臺北市,士林區,蘭興里,256,1420,606,197,803,51,854
公投第７案,臺北市,士林區,蘭興里,257,1494,616,188,804,63,867
公投第７案,臺北市,士林區,蘭興里,258,1568,685,215,900,58,958
公投第７案,臺北市,士林區,蘭興里,259,1208,517,206,723,42,765
公投第７案,臺北市,士林區,三玉里,260,1826,704,240,944,68,1012
公投第７案,臺北市,士林區,三玉里,261,1647,653,222,875,61,936
公投第７案,臺北市,士林區,三玉里,262,1654,679,198,877,66,943
公投第７案,臺北市,士林區,天福里,263,1550,676,202,878,47,925
公投第７案,臺北市,士林區,天福里,264,1298,574,188,762,53,815
公投第７案,臺北市,士林區,天福里,265,1297,558,185,743,51,794
公投第７案,臺北市,士林區,天福里,266,1352,557,157,714,49,763
公投第７案,臺北市,士林區,天祿里,267,1522,608,214,822,49,871
公投第７案,臺北市,士林區,天祿里,268,1602,577,246,823,88,911
公投第７案,臺北市,士林區,天祿里,269,1441,549,223,772,63,835
公投第７案,臺北市,士林區,天壽里,270,1325,503,171,674,26,700
公投第７案,臺北市,士林區,天壽里,271,1567,642,209,851,48,899
公投第７案,臺北市,士林區,天壽里,272,1518,600,210,810,34,844
公投第７案,臺北市,士林區,天和里,273,1549,667,223,890,54,944
公投第７案,臺北市,士林區,天和里,274,1652,660,228,888,34,922
公投第７案,臺北市,士林區,天和里,275,1766,768,221,989,74,1063
公投第７案,臺北市,士林區,天和里,276,1638,638,220,858,31,889
公投第７案,臺北市,士林區,天山里,277,1491,657,186,843,53,896
公投第７案,臺北市,士林區,天山里,278,1521,638,198,836,38,874
公投第７案,臺北市,士林區,天山里,279,1351,604,165,769,56,825
公投第７案,臺北市,士林區,天山里,280,1742,654,220,874,34,908
公投第７案,臺北市,士林區,天玉里,281,1585,630,220,850,63,913
公投第７案,臺北市,士林區,天玉里,282,1521,644,191,835,54,889
公投第７案,臺北市,士林區,天玉里,283,1543,623,192,815,49,864
公投第７案,臺北市,士林區,天玉里,284,1404,607,179,786,45,831
公投第７案,臺北市,士林區,天玉里,285,1541,637,214,851,44,895
公投第７案,臺北市,士林區,天母里,286,1584,633,194,827,62,889
公投第７案,臺北市,士林區,天母里,287,1519,625,224,849,59,908
公投第７案,臺北市,士林區,天母里,288,1482,547,189,736,30,766
公投第７案,臺北市,士林區,天母里,289,1243,505,154,659,57,716
公投第７案,臺北市,士林區,永福里,290,1156,451,160,611,53,664
公投第７案,臺北市,士林區,公館里,291,1262,452,161,613,69,682
公投第７案,臺北市,士林區,新安里,292,889,353,138,491,40,531
公投第７案,臺北市,士林區,新安里,293,858,337,200,537,46,583
公投第７案,臺北市,士林區,陽明里,294,945,328,156,484,51,535
公投第７案,臺北市,士林區,陽明里,295,960,370,110,480,32,512
公投第７案,臺北市,士林區,陽明里,296,876,359,93,452,44,496
公投第７案,臺北市,士林區,菁山里,297,556,234,100,334,29,363
公投第７案,臺北市,士林區,菁山里,298,919,396,115,511,61,572
公投第７案,臺北市,士林區,平等里,299,1360,568,231,799,102,901
公投第７案,臺北市,士林區,溪山里,300,1355,534,202,736,90,826
公投第７案,臺北市,士林區,翠山里,301,1252,548,151,699,44,743
公投第７案,臺北市,士林區,翠山里,302,1182,561,128,689,50,739
公投第７案,臺北市,士林區,臨溪里,303,1431,516,130,646,29,675
公投第７案,臺北市,士林區,臨溪里,304,1240,485,144,629,36,665
公投第７案,臺北市,內湖區,西湖里,305,1661,628,175,803,34,837
公投第７案,臺北市,內湖區,西湖里,306,1602,610,219,829,64,893
公投第７案,臺北市,內湖區,西湖里,307,1655,717,195,912,99,1011
公投第７案,臺北市,內湖區,西湖里,308,1582,682,217,899,51,950
公投第７案,臺北市,內湖區,西康里,309,1688,701,183,884,37,921
公投第７案,臺北市,內湖區,西康里,310,1737,621,314,935,58,993
公投第７案,臺北市,內湖區,西康里,311,1809,788,213,1001,63,1064
公投第７案,臺北市,內湖區,西康里,312,1376,567,160,727,59,786
公投第７案,臺北市,內湖區,西康里,313,1747,770,199,969,91,1060
公投第７案,臺北市,內湖區,西安里,314,1389,621,185,806,27,833
公投第７案,臺北市,內湖區,西安里,315,1454,681,179,860,43,903
公投第７案,臺北市,內湖區,西安里,316,1468,645,232,877,54,931
公投第７案,臺北市,內湖區,西安里,317,1603,734,224,958,46,1004
公投第７案,臺北市,內湖區,港墘里,318,1795,729,226,955,31,986
公投第７案,臺北市,內湖區,港墘里,319,1737,795,229,1024,60,1084
公投第７案,臺北市,內湖區,港墘里,320,1744,748,215,963,80,1043
公投第７案,臺北市,內湖區,港都里,321,1661,720,192,912,64,976
公投第７案,臺北市,內湖區,港都里,322,1577,636,232,868,50,918
公投第７案,臺北市,內湖區,港都里,323,1494,675,206,881,26,907
公投第７案,臺北市,內湖區,港富里,324,1626,703,187,890,60,950
公投第７案,臺北市,內湖區,港富里,325,1641,702,198,900,72,972
公投第７案,臺北市,內湖區,港富里,326,1554,680,178,858,62,920
公投第７案,臺北市,內湖區,港富里,327,1728,772,240,1012,55,1067
公投第７案,臺北市,內湖區,港富里,328,1736,718,207,925,58,983
公投第７案,臺北市,內湖區,港華里,329,1461,600,290,890,44,934
公投第７案,臺北市,內湖區,港華里,330,1509,646,186,832,41,873
公投第７案,臺北市,內湖區,港華里,331,1358,537,201,738,25,763
公投第７案,臺北市,內湖區,港華里,332,1761,753,196,949,42,991
公投第７案,臺北市,內湖區,港華里,333,1651,702,197,899,33,932
公投第７案,臺北市,內湖區,內湖里,334,1809,817,192,1009,71,1080
公投第７案,臺北市,內湖區,內湖里,335,1773,781,188,969,58,1027
公投第７案,臺北市,內湖區,內湖里,336,1890,794,199,993,50,1043
公投第７案,臺北市,內湖區,湖濱里,337,1760,804,273,1077,62,1139
公投第７案,臺北市,內湖區,湖濱里,338,1645,751,186,937,35,972
公投第７案,臺北市,內湖區,湖濱里,339,1324,632,156,788,25,813
公投第７案,臺北市,內湖區,湖濱里,340,1072,515,122,637,32,669
公投第７案,臺北市,內湖區,湖濱里,341,1509,457,355,812,39,851
公投第７案,臺北市,內湖區,紫星里,342,1715,712,222,934,58,992
公投第７案,臺北市,內湖區,紫星里,343,1774,762,219,981,57,1038
公投第７案,臺北市,內湖區,紫星里,344,1796,818,248,1066,67,1133
公投第７案,臺北市,內湖區,紫星里,345,1784,734,241,975,36,1011
公投第７案,臺北市,內湖區,大湖里,346,1417,599,218,817,61,878
公投第７案,臺北市,內湖區,大湖里,347,1699,695,236,931,40,971
公投第７案,臺北市,內湖區,大湖里,348,1719,788,235,1023,56,1079
公投第７案,臺北市,內湖區,金龍里,349,1715,718,234,952,28,980
公投第７案,臺北市,內湖區,金龍里,350,1634,627,163,790,34,824
公投第７案,臺北市,內湖區,金龍里,351,1435,587,156,743,74,817
公投第７案,臺北市,內湖區,金瑞里,352,1440,632,151,783,27,810
公投第７案,臺北市,內湖區,金瑞里,353,1446,674,176,850,30,880
公投第７案,臺北市,內湖區,金瑞里,354,1657,659,179,838,60,898
公投第７案,臺北市,內湖區,金瑞里,355,1261,558,151,709,70,779
公投第７案,臺北市,內湖區,碧山里,356,456,152,56,208,28,236
公投第７案,臺北市,內湖區,碧山里,357,1433,712,190,902,40,942
公投第７案,臺北市,內湖區,碧山里,358,1485,643,215,858,39,897
公投第７案,臺北市,內湖區,碧山里,359,1590,676,194,870,41,911
公投第７案,臺北市,內湖區,碧山里,360,1219,584,145,729,52,781
公投第７案,臺北市,內湖區,紫雲里,361,1732,723,190,913,58,971
公投第７案,臺北市,內湖區,紫雲里,362,1727,801,170,971,29,1000
公投第７案,臺北市,內湖區,紫雲里,363,1637,714,201,915,55,970
公投第７案,臺北市,內湖區,清白里,364,1453,619,167,786,47,833
公投第７案,臺北市,內湖區,清白里,365,1617,690,179,869,30,899
公投第７案,臺北市,內湖區,清白里,366,1604,709,163,872,27,899
公投第７案,臺北市,內湖區,清白里,367,1406,657,195,852,33,885
公投第７案,臺北市,內湖區,清白里,368,1353,584,183,767,43,810
公投第７案,臺北市,內湖區,葫洲里,369,1724,797,191,988,52,1040
公投第７案,臺北市,內湖區,葫洲里,370,1378,602,186,788,44,832
公投第７案,臺北市,內湖區,葫洲里,371,1403,658,152,810,39,849
公投第７案,臺北市,內湖區,葫洲里,372,1547,658,168,826,35,861
公投第７案,臺北市,內湖區,紫陽里,373,1718,738,238,976,55,1031
公投第７案,臺北市,內湖區,紫陽里,374,1813,748,238,986,50,1036
公投第７案,臺北市,內湖區,紫陽里,375,1791,819,233,1052,64,1116
公投第７案,臺北市,內湖區,紫陽里,376,1855,826,247,1073,52,1125
公投第７案,臺北市,內湖區,瑞陽里,377,1731,770,190,960,32,992
公投第７案,臺北市,內湖區,瑞陽里,378,1593,767,196,963,57,1020
公投第７案,臺北市,內湖區,瑞陽里,379,1869,795,160,955,56,1011
公投第７案,臺北市,內湖區,瑞陽里,380,1687,767,191,958,57,1015
公投第７案,臺北市,內湖區,瑞光里,381,1530,650,209,859,33,892
公投第７案,臺北市,內湖區,瑞光里,382,1300,602,143,745,55,800
公投第７案,臺北市,內湖區,瑞光里,383,1314,665,133,798,45,843
公投第７案,臺北市,內湖區,五分里,384,1433,546,154,700,28,728
公投第７案,臺北市,內湖區,五分里,385,1450,621,125,746,45,791
公投第７案,臺北市,內湖區,五分里,386,1608,679,179,858,67,925
公投第７案,臺北市,內湖區,五分里,387,1414,641,151,792,42,834
公投第７案,臺北市,內湖區,五分里,388,1492,647,176,823,41,864
公投第７案,臺北市,內湖區,五分里,389,1528,609,161,770,34,804
公投第７案,臺北市,內湖區,東湖里,390,1692,721,206,927,50,977
公投第７案,臺北市,內湖區,東湖里,391,1556,668,205,873,52,925
公投第７案,臺北市,內湖區,東湖里,392,1637,680,186,866,27,893
公投第７案,臺北市,內湖區,東湖里,393,1749,686,215,901,44,945
公投第７案,臺北市,內湖區,樂康里,394,1220,504,134,638,36,674
公投第７案,臺北市,內湖區,樂康里,395,1600,659,204,863,57,920
公投第７案,臺北市,內湖區,樂康里,396,1473,639,161,800,49,849
公投第７案,臺北市,內湖區,樂康里,397,1498,619,184,803,58,861
公投第７案,臺北市,內湖區,樂康里,398,1557,692,155,847,44,891
公投第７案,臺北市,內湖區,內溝里,399,1674,675,186,861,38,899
公投第７案,臺北市,內湖區,內溝里,400,1728,776,209,985,49,1034
公投第７案,臺北市,內湖區,內溝里,401,788,260,98,358,40,398
公投第７案,臺北市,內湖區,週美里,402,1542,571,232,803,66,869
公投第７案,臺北市,內湖區,週美里,403,1676,596,189,785,58,843
公投第７案,臺北市,內湖區,週美里,404,1360,481,183,664,23,687
公投第７案,臺北市,內湖區,週美里,405,1259,612,149,761,30,791
公投第７案,臺北市,內湖區,週美里,406,1301,567,130,697,15,712
公投第７案,臺北市,內湖區,行善里,407,1251,454,154,608,35,643
公投第７案,臺北市,內湖區,行善里,408,1502,619,168,787,63,850
公投第７案,臺北市,內湖區,行善里,409,1596,679,169,848,42,890
公投第７案,臺北市,內湖區,行善里,410,1649,710,200,910,21,931
公投第７案,臺北市,內湖區,石潭里,411,1774,744,174,918,57,975
公投第７案,臺北市,內湖區,石潭里,412,1746,688,187,875,43,918
公投第７案,臺北市,內湖區,湖興里,413,1473,613,159,772,25,797
公投第７案,臺北市,內湖區,湖興里,414,2824,710,188,898,71,969
公投第７案,臺北市,內湖區,湖興里,415,1849,671,233,904,48,952
公投第７案,臺北市,內湖區,湖興里,416,1530,601,176,777,69,846
公投第７案,臺北市,內湖區,湖元里,417,1656,682,194,876,61,937
公投第７案,臺北市,內湖區,湖元里,418,1457,609,199,808,41,849
公投第７案,臺北市,內湖區,湖元里,419,1695,752,204,956,57,1013
公投第７案,臺北市,內湖區,安湖里,420,1663,744,201,945,39,984
公投第７案,臺北市,內湖區,安湖里,421,1654,709,181,890,54,944
公投第７案,臺北市,內湖區,安湖里,422,1642,726,200,926,54,980
公投第７案,臺北市,內湖區,安湖里,423,1685,708,208,916,38,954
公投第７案,臺北市,內湖區,秀湖里,424,1862,745,245,990,56,1046
公投第７案,臺北市,內湖區,秀湖里,425,1900,847,222,1069,59,1128
公投第７案,臺北市,內湖區,秀湖里,426,1790,847,221,1068,67,1135
公投第７案,臺北市,內湖區,安泰里,427,1417,610,145,755,59,814
公投第７案,臺北市,內湖區,安泰里,428,1694,707,207,914,52,966
公投第７案,臺北市,內湖區,安泰里,429,1676,664,182,846,67,913
公投第７案,臺北市,內湖區,金湖里,430,1643,670,216,886,26,912
公投第７案,臺北市,內湖區,金湖里,431,1588,696,184,880,50,930
公投第７案,臺北市,內湖區,金湖里,432,1603,719,176,895,58,953
公投第７案,臺北市,內湖區,金湖里,433,1629,730,169,899,46,945
公投第７案,臺北市,內湖區,金湖里,434,1646,773,186,959,54,1013
公投第７案,臺北市,內湖區,康寧里,435,1883,784,207,991,50,1041
公投第７案,臺北市,內湖區,康寧里,436,1434,590,175,765,53,818
公投第７案,臺北市,內湖區,康寧里,437,1418,619,147,766,35,801
公投第７案,臺北市,內湖區,康寧里,438,1373,603,149,752,65,817
公投第７案,臺北市,內湖區,康寧里,439,1349,605,143,748,69,817
公投第７案,臺北市,內湖區,明湖里,440,1511,680,194,874,60,934
公投第７案,臺北市,內湖區,明湖里,441,1563,722,180,902,64,966
公投第７案,臺北市,內湖區,明湖里,442,1550,681,174,855,49,904
公投第７案,臺北市,內湖區,蘆洲里,443,1157,472,130,602,52,654
公投第７案,臺北市,內湖區,麗山里,444,1768,720,247,967,50,1017
公投第７案,臺北市,內湖區,麗山里,445,1664,745,174,919,54,973
公投第７案,臺北市,內湖區,麗山里,446,1743,738,215,953,69,1022
公投第７案,臺北市,內湖區,寶湖里,447,1480,672,169,841,24,865
公投第７案,臺北市,內湖區,寶湖里,448,1589,693,223,916,57,973
公投第７案,臺北市,內湖區,寶湖里,449,1371,592,167,759,34,793
公投第７案,臺北市,內湖區,寶湖里,450,1575,728,200,928,46,974
公投第７案,臺北市,內湖區,寶湖里,451,1377,634,151,785,14,799
公投第７案,臺北市,內湖區,南湖里,452,1469,713,194,907,65,972
公投第７案,臺北市,內湖區,南湖里,453,1529,709,209,918,21,939
公投第７案,臺北市,內湖區,南湖里,454,1649,752,197,949,56,1005
公投第７案,臺北市,南港區,南港里,455,1280,495,138,633,29,662
公投第７案,臺北市,南港區,南港里,456,1351,557,163,720,28,748
公投第７案,臺北市,南港區,南港里,457,1345,584,149,733,42,775
公投第７案,臺北市,南港區,南港里,458,1679,515,184,699,47,746
公投第７案,臺北市,南港區,中南里,459,1680,613,214,827,77,904
公投第７案,臺北市,南港區,中南里,460,1635,626,160,786,49,835
公投第７案,臺北市,南港區,三重里,461,1459,587,178,765,46,811
公投第７案,臺北市,南港區,三重里,462,1706,720,196,916,32,948
公投第７案,臺北市,南港區,三重里,463,1674,656,185,841,103,944
公投第７案,臺北市,南港區,三重里,464,1491,754,53,807,20,827
公投第７案,臺北市,南港區,新富里,465,1086,521,142,663,42,705
公投第７案,臺北市,南港區,新富里,466,1202,575,147,722,57,779
公投第７案,臺北市,南港區,新富里,467,1198,508,157,665,59,724
公投第７案,臺北市,南港區,中研里,468,1430,543,163,706,33,739
公投第７案,臺北市,南港區,中研里,469,1275,520,210,730,56,786
公投第７案,臺北市,南港區,中研里,470,1344,634,181,815,52,867
公投第７案,臺北市,南港區,中研里,471,1391,594,183,777,43,820
公投第７案,臺北市,南港區,中研里,472,1342,656,136,792,30,822
公投第７案,臺北市,南港區,中研里,473,1389,568,150,718,38,756
公投第７案,臺北市,南港區,九如里,474,1426,621,192,813,40,853
公投第７案,臺北市,南港區,九如里,475,1359,665,129,794,22,816
公投第７案,臺北市,南港區,九如里,476,1366,581,158,739,53,792
公投第７案,臺北市,南港區,九如里,477,1441,647,165,812,26,838
公投第７案,臺北市,南港區,舊莊里,478,1529,582,193,775,61,836
公投第７案,臺北市,南港區,舊莊里,479,1618,623,180,803,51,854
公投第７案,臺北市,南港區,舊莊里,480,1545,527,161,688,64,752
公投第７案,臺北市,南港區,舊莊里,481,1569,663,180,843,56,899
公投第７案,臺北市,南港區,舊莊里,482,1661,637,161,798,36,834
公投第７案,臺北市,南港區,東新里,483,1518,558,182,740,52,792
公投第７案,臺北市,南港區,東新里,484,1552,679,208,887,69,956
公投第７案,臺北市,南港區,東新里,485,1658,660,168,828,27,855
公投第７案,臺北市,南港區,東新里,486,1608,670,210,880,58,938
公投第７案,臺北市,南港區,重陽里,487,1475,595,167,762,39,801
公投第７案,臺北市,南港區,重陽里,488,1722,782,232,1014,44,1058
公投第７案,臺北市,南港區,重陽里,489,1383,660,192,852,31,883
公投第７案,臺北市,南港區,東明里,490,1397,626,153,779,45,824
公投第７案,臺北市,南港區,東明里,491,1352,588,162,750,56,806
公投第７案,臺北市,南港區,東明里,492,1344,602,161,763,46,809
公投第７案,臺北市,南港區,西新里,493,1385,517,172,689,28,717
公投第７案,臺北市,南港區,西新里,494,1399,575,166,741,49,790
公投第７案,臺北市,南港區,西新里,495,1381,517,158,675,38,713
公投第７案,臺北市,南港區,玉成里,496,1548,636,185,821,41,862
公投第７案,臺北市,南港區,玉成里,497,1190,493,117,610,31,641
公投第７案,臺北市,南港區,玉成里,498,1490,630,196,826,38,864
公投第７案,臺北市,南港區,合成里,499,1096,494,144,638,24,662
公投第７案,臺北市,南港區,合成里,500,1238,573,151,724,24,748
公投第７案,臺北市,南港區,合成里,501,1271,586,150,736,29,765
公投第７案,臺北市,南港區,合成里,502,1146,493,129,622,49,671
公投第７案,臺北市,南港區,合成里,503,1232,488,170,658,38,696
公投第７案,臺北市,南港區,新光里,504,1649,627,167,794,28,822
公投第７案,臺北市,南港區,新光里,505,1688,743,192,935,49,984
公投第７案,臺北市,南港區,聯成里,506,1503,664,187,851,39,890
公投第７案,臺北市,南港區,聯成里,507,1542,618,194,812,35,847
公投第７案,臺北市,南港區,聯成里,508,1463,634,181,815,53,868
公投第７案,臺北市,南港區,萬福里,509,1195,517,162,679,74,753
公投第７案,臺北市,南港區,萬福里,510,1254,509,214,723,15,738
公投第７案,臺北市,南港區,萬福里,511,1356,604,130,734,48,782
公投第７案,臺北市,南港區,鴻福里,512,1363,598,180,778,56,834
公投第７案,臺北市,南港區,鴻福里,513,1317,614,170,784,44,828
公投第７案,臺北市,南港區,鴻福里,514,1331,587,152,739,31,770
公投第７案,臺北市,南港區,百福里,515,1610,662,204,866,64,930
公投第７案,臺北市,南港區,百福里,516,1542,629,182,811,27,838
公投第７案,臺北市,南港區,百福里,517,1581,667,198,865,68,933
公投第７案,臺北市,南港區,成福里,518,1225,574,146,720,43,763
公投第７案,臺北市,南港區,成福里,519,1264,583,167,750,52,802
公投第７案,臺北市,南港區,成福里,520,1649,730,195,925,81,1006
公投第７案,臺北市,南港區,成福里,521,1267,594,134,728,23,751
公投第７案,臺北市,南港區,成福里,522,1336,590,139,729,38,767
公投第７案,臺北市,南港區,仁福里,523,1162,554,131,685,27,712
公投第７案,臺北市,南港區,仁福里,524,1045,463,117,580,30,610
公投第７案,臺北市,南港區,仁福里,525,1351,649,158,807,56,863
公投第７案,臺北市,南港區,仁福里,526,1358,613,128,741,29,770
公投第７案,臺北市,松山區,莊敬里,527,1583,702,172,874,49,923
公投第７案,臺北市,松山區,莊敬里,528,1691,712,197,909,72,981
公投第７案,臺北市,松山區,莊敬里,529,1386,605,146,751,42,793
公投第７案,臺北市,松山區,東榮里,530,1362,575,191,766,60,826
公投第７案,臺北市,松山區,東榮里,531,1399,594,194,788,54,842
公投第７案,臺北市,松山區,東榮里,532,1324,552,201,753,52,805
公投第７案,臺北市,松山區,東榮里,533,1296,560,213,773,57,830
公投第７案,臺北市,松山區,東榮里,534,1386,587,214,801,49,850
公投第７案,臺北市,松山區,三民里,535,1529,674,228,902,77,979
公投第７案,臺北市,松山區,三民里,536,1416,619,160,779,38,817
公投第７案,臺北市,松山區,三民里,537,1619,648,194,842,64,906
公投第７案,臺北市,松山區,三民里,538,1386,579,202,781,57,838
公投第７案,臺北市,松山區,新益里,539,1380,646,196,842,47,889
公投第７案,臺北市,松山區,新益里,540,1357,579,188,767,45,812
公投第７案,臺北市,松山區,新益里,541,1296,608,157,765,52,817
公投第７案,臺北市,松山區,富錦里,542,1632,727,180,907,74,981
公投第７案,臺北市,松山區,富錦里,543,1414,597,181,778,45,823
公投第７案,臺北市,松山區,富錦里,544,1404,594,202,796,51,847
公投第７案,臺北市,松山區,新東里,545,1365,615,160,775,74,849
公投第７案,臺北市,松山區,新東里,546,1431,595,199,794,67,861
公投第７案,臺北市,松山區,新東里,547,1483,621,217,838,64,902
公投第７案,臺北市,松山區,富泰里,548,1293,596,165,761,51,812
公投第７案,臺北市,松山區,富泰里,549,1410,601,155,756,49,805
公投第７案,臺北市,松山區,富泰里,550,1307,582,164,746,46,792
公投第７案,臺北市,松山區,介壽里,551,1242,531,201,732,55,787
公投第７案,臺北市,松山區,介壽里,552,1192,537,164,701,27,728
公投第７案,臺北市,松山區,介壽里,553,1276,562,181,743,55,798
公投第７案,臺北市,松山區,精忠里,554,1201,492,175,667,31,698
公投第７案,臺北市,松山區,精忠里,555,1318,573,174,747,45,792
公投第７案,臺北市,松山區,精忠里,556,1157,509,173,682,41,723
公投第７案,臺北市,松山區,東光里,557,1157,465,182,647,13,660
公投第７案,臺北市,松山區,東光里,558,1357,621,156,777,56,833
公投第７案,臺北市,松山區,東光里,559,1215,451,132,583,32,615
公投第７案,臺北市,松山區,東光里,560,1345,559,186,745,34,779
公投第７案,臺北市,松山區,東光里,561,1237,531,176,707,41,748
公投第７案,臺北市,松山區,龍田里,562,1393,718,134,852,32,884
公投第７案,臺北市,松山區,龍田里,563,1331,603,205,808,47,855
公投第７案,臺北市,松山區,龍田里,564,1550,715,204,919,55,974
公投第７案,臺北市,松山區,龍田里,565,1308,612,115,727,15,742
公投第７案,臺北市,松山區,龍田里,566,1490,714,115,829,45,874
公投第７案,臺北市,松山區,龍田里,567,1406,672,175,847,45,892
公投第７案,臺北市,松山區,東昌里,568,1191,537,190,727,41,768
公投第７案,臺北市,松山區,東昌里,569,1095,453,167,620,37,657
公投第７案,臺北市,松山區,東勢里,570,1198,494,168,662,44,706
公投第７案,臺北市,松山區,東勢里,571,1265,545,152,697,48,745
公投第７案,臺北市,松山區,東勢里,572,1225,513,162,675,44,719
公投第７案,臺北市,松山區,中華里,573,1698,752,246,998,52,1050
公投第７案,臺北市,松山區,中華里,574,1819,777,205,982,56,1038
公投第７案,臺北市,松山區,中華里,575,1754,766,233,999,61,1060
公投第７案,臺北市,松山區,民有里,576,1361,586,221,807,38,845
公投第７案,臺北市,松山區,民有里,577,1189,553,151,704,28,732
公投第７案,臺北市,松山區,民有里,578,1214,515,180,695,51,746
公投第７案,臺北市,松山區,民有里,579,1284,544,157,701,61,762
公投第７案,臺北市,松山區,民有里,580,1297,574,178,752,49,801
公投第７案,臺北市,松山區,民有里,581,1330,527,194,721,33,754
公投第７案,臺北市,松山區,民福里,582,1396,655,155,810,54,864
公投第７案,臺北市,松山區,民福里,583,1480,647,149,796,27,823
公投第７案,臺北市,松山區,民福里,584,1419,650,178,828,34,862
公投第７案,臺北市,松山區,民福里,585,1390,615,171,786,58,844
公投第７案,臺北市,松山區,松基里,586,1525,664,202,866,47,913
公投第７案,臺北市,松山區,松基里,587,1633,663,199,862,39,901
公投第７案,臺北市,松山區,慈祐里,588,2677,625,216,841,49,890
公投第７案,臺北市,松山區,慈祐里,589,1281,530,183,713,62,775
公投第７案,臺北市,松山區,慈祐里,590,1469,491,175,666,52,718
公投第７案,臺北市,松山區,慈祐里,591,1700,675,219,894,70,964
公投第７案,臺北市,松山區,安平里,592,1503,605,173,778,38,816
公投第７案,臺北市,松山區,安平里,593,1309,529,168,697,46,743
公投第７案,臺北市,松山區,安平里,594,1376,592,178,770,64,834
公投第７案,臺北市,松山區,安平里,595,1654,678,214,892,52,944
公投第７案,臺北市,松山區,安平里,596,1601,635,196,831,79,910
公投第７案,臺北市,松山區,鵬程里,597,1496,695,145,840,38,878
公投第７案,臺北市,松山區,鵬程里,598,1598,735,204,939,74,1013
公投第７案,臺北市,松山區,鵬程里,599,1751,784,211,995,60,1055
公投第７案,臺北市,松山區,自強里,600,1557,771,155,926,43,969
公投第７案,臺北市,松山區,自強里,601,1686,900,169,1069,49,1118
公投第７案,臺北市,松山區,自強里,602,1707,874,127,1001,51,1052
公投第７案,臺北市,松山區,自強里,603,1854,1038,86,1124,66,1190
公投第７案,臺北市,松山區,自強里,604,1740,709,221,930,48,978
公投第７案,臺北市,松山區,吉祥里,605,1494,607,209,816,70,886
公投第７案,臺北市,松山區,吉祥里,606,1453,652,174,826,47,873
公投第７案,臺北市,松山區,吉祥里,607,1458,619,194,813,52,865
公投第７案,臺北市,松山區,吉祥里,608,1536,645,196,841,52,893
公投第７案,臺北市,松山區,吉祥里,609,1463,637,205,842,40,882
公投第７案,臺北市,松山區,新聚里,610,1790,696,222,918,40,958
公投第７案,臺北市,松山區,新聚里,611,1679,670,284,954,53,1007
公投第７案,臺北市,松山區,新聚里,612,1785,646,222,868,74,942
公投第７案,臺北市,松山區,新聚里,613,1793,693,246,939,71,1010
公投第７案,臺北市,松山區,復盛里,614,1381,585,192,777,44,821
公投第７案,臺北市,松山區,復盛里,615,1279,570,156,726,47,773
公投第７案,臺北市,松山區,復盛里,616,1681,717,227,944,70,1014
公投第７案,臺北市,松山區,復盛里,617,1232,575,153,728,46,774
公投第７案,臺北市,松山區,中正里,618,1533,628,198,826,59,885
公投第７案,臺北市,松山區,中正里,619,1540,652,238,890,55,945
公投第７案,臺北市,松山區,中正里,620,1716,672,236,908,48,956
公投第７案,臺北市,松山區,中正里,621,1664,637,236,873,51,924
公投第７案,臺北市,松山區,中正里,622,1350,565,172,737,39,776
公投第７案,臺北市,松山區,中崙里,623,1837,758,241,999,47,1046
公投第７案,臺北市,松山區,中崙里,624,1558,595,185,780,76,856
公投第７案,臺北市,松山區,美仁里,625,1420,637,182,819,51,870
公投第７案,臺北市,松山區,美仁里,626,1474,624,168,792,50,842
公投第７案,臺北市,松山區,吉仁里,627,1591,640,217,857,52,909
公投第７案,臺北市,松山區,吉仁里,628,1726,727,213,940,59,999
公投第７案,臺北市,松山區,敦化里,629,1452,604,203,807,41,848
公投第７案,臺北市,松山區,敦化里,630,1482,579,206,785,46,831
公投第７案,臺北市,松山區,敦化里,631,1460,598,220,818,47,865
公投第７案,臺北市,松山區,敦化里,632,1398,553,194,747,53,800
公投第７案,臺北市,松山區,復源里,633,1423,618,186,804,46,850
公投第７案,臺北市,松山區,復源里,634,1226,563,149,712,20,732
公投第７案,臺北市,松山區,復建里,635,1158,516,142,658,46,704
公投第７案,臺北市,松山區,復建里,636,1426,591,188,779,43,822
公投第７案,臺北市,松山區,復建里,637,1177,511,160,671,21,692
公投第７案,臺北市,松山區,復勢里,638,1363,542,197,739,57,796
公投第７案,臺北市,松山區,復勢里,639,1240,557,173,730,41,771
公投第７案,臺北市,松山區,復勢里,640,1375,609,187,796,57,853
公投第７案,臺北市,松山區,復勢里,641,1377,593,187,780,44,824
公投第７案,臺北市,松山區,福成里,642,1225,500,144,644,28,672
公投第７案,臺北市,松山區,福成里,643,1017,434,174,608,38,646
公投第７案,臺北市,信義區,西村里,644,2476,592,173,765,30,795
公投第７案,臺北市,信義區,西村里,645,1381,713,137,850,21,871
公投第７案,臺北市,信義區,西村里,646,1294,639,124,763,56,819
公投第７案,臺北市,信義區,正和里,647,1351,580,174,754,43,797
公投第７案,臺北市,信義區,正和里,648,1296,578,145,723,40,763
公投第７案,臺北市,信義區,正和里,649,1302,598,153,751,51,802
公投第７案,臺北市,信義區,興隆里,650,1025,414,109,523,64,587
公投第７案,臺北市,信義區,興隆里,651,1421,569,178,747,33,780
公投第７案,臺北市,信義區,中興里,652,1501,629,175,804,45,849
公投第７案,臺北市,信義區,中興里,653,1575,593,182,775,38,813
公投第７案,臺北市,信義區,新仁里,654,1516,675,165,840,28,868
公投第７案,臺北市,信義區,新仁里,655,1382,605,173,778,28,806
公投第７案,臺北市,信義區,興雅里,656,1128,477,128,605,52,657
公投第７案,臺北市,信義區,興雅里,657,1397,555,185,740,53,793
公投第７案,臺北市,信義區,興雅里,658,1161,582,159,741,47,788
公投第７案,臺北市,信義區,興雅里,659,1368,647,102,749,40,789
公投第７案,臺北市,信義區,敦厚里,660,1049,480,116,596,26,622
公投第７案,臺北市,信義區,敦厚里,661,1308,562,161,723,42,765
公投第７案,臺北市,信義區,敦厚里,662,1154,516,159,675,52,727
公投第７案,臺北市,信義區,敦厚里,663,1078,481,162,643,22,665
公投第７案,臺北市,信義區,廣居里,664,1375,579,175,754,54,808
公投第７案,臺北市,信義區,廣居里,665,1448,624,187,811,46,857
公投第７案,臺北市,信義區,廣居里,666,1250,552,168,720,26,746
公投第７案,臺北市,信義區,廣居里,667,1381,607,179,786,35,821
公投第７案,臺北市,信義區,廣居里,668,1213,545,155,700,51,751
公投第７案,臺北市,信義區,安康里,669,1373,599,211,810,43,853
公投第７案,臺北市,信義區,安康里,670,1226,546,163,709,43,752
公投第７案,臺北市,信義區,安康里,671,1117,473,154,627,25,652
公投第７案,臺北市,信義區,安康里,672,1123,521,133,654,45,699
公投第７案,臺北市,信義區,安康里,673,1200,529,154,683,44,727
公投第７案,臺北市,信義區,安康里,674,1335,527,150,677,33,710
公投第７案,臺北市,信義區,安康里,675,1332,546,149,695,34,729
公投第７案,臺北市,信義區,六藝里,676,1648,740,217,957,70,1027
公投第７案,臺北市,信義區,六藝里,677,1542,611,196,807,71,878
公投第７案,臺北市,信義區,雅祥里,678,1228,504,168,672,60,732
公投第７案,臺北市,信義區,雅祥里,679,1731,681,256,937,59,996
公投第７案,臺北市,信義區,雅祥里,680,1403,625,165,790,44,834
公投第７案,臺北市,信義區,五常里,681,1929,766,219,985,85,1070
公投第７案,臺北市,信義區,五常里,682,1300,578,167,745,51,796
公投第７案,臺北市,信義區,五全里,683,1486,590,155,745,37,782
公投第７案,臺北市,信義區,五全里,684,1532,539,171,710,63,773
公投第７案,臺北市,信義區,五全里,685,1387,597,207,804,62,866
公投第７案,臺北市,信義區,永吉里,686,1195,462,132,594,63,657
公投第７案,臺北市,信義區,永吉里,687,1068,433,117,550,39,589
公投第７案,臺北市,信義區,永吉里,688,1273,459,160,619,49,668
公投第７案,臺北市,信義區,長春里,689,1329,609,169,778,62,840
公投第７案,臺北市,信義區,長春里,690,1311,513,148,661,50,711
公投第７案,臺北市,信義區,長春里,691,1258,497,150,647,54,701
公投第７案,臺北市,信義區,四育里,692,1277,533,173,706,68,774
公投第７案,臺北市,信義區,四育里,693,1285,592,167,759,54,813
公投第７案,臺北市,信義區,四育里,694,1161,515,181,696,46,742
公投第７案,臺北市,信義區,四育里,695,1299,509,176,685,42,727
公投第７案,臺北市,信義區,四維里,696,1243,523,152,675,43,718
公投第７案,臺北市,信義區,四維里,697,1197,497,165,662,31,693
公投第７案,臺北市,信義區,四維里,698,1224,550,189,739,24,763
公投第７案,臺北市,信義區,四維里,699,1147,454,129,583,44,627
公投第７案,臺北市,信義區,永春里,700,1045,450,128,578,20,598
公投第７案,臺北市,信義區,永春里,701,1096,533,118,651,23,674
公投第７案,臺北市,信義區,永春里,702,1115,476,145,621,11,632
公投第７案,臺北市,信義區,永春里,703,1117,444,155,599,43,642
公投第７案,臺北市,信義區,富台里,704,1019,395,110,505,26,531
公投第７案,臺北市,信義區,富台里,705,1346,601,138,739,53,792
公投第７案,臺北市,信義區,富台里,706,1405,595,144,739,46,785
公投第７案,臺北市,信義區,國業里,707,1356,582,171,753,40,793
公投第７案,臺北市,信義區,國業里,708,1250,584,186,770,31,801
公投第７案,臺北市,信義區,國業里,709,1254,576,158,734,43,777
公投第７案,臺北市,信義區,國業里,710,1317,576,142,718,33,751
公投第７案,臺北市,信義區,國業里,711,1271,584,172,756,48,804
公投第７案,臺北市,信義區,松隆里,712,979,393,125,518,31,549
公投第７案,臺北市,信義區,松隆里,713,1025,413,120,533,41,574
公投第７案,臺北市,信義區,松友里,714,1512,579,139,718,32,750
公投第７案,臺北市,信義區,松友里,715,1483,649,204,853,37,890
公投第７案,臺北市,信義區,松友里,716,1359,617,175,792,40,832
公投第７案,臺北市,信義區,松友里,717,1387,620,184,804,23,827
公投第７案,臺北市,信義區,松光里,718,1455,579,178,757,29,786
公投第７案,臺北市,信義區,松光里,719,1461,602,210,812,31,843
公投第７案,臺北市,信義區,松光里,720,1532,686,181,867,49,916
公投第７案,臺北市,信義區,中坡里,721,1043,477,150,627,42,669
公投第７案,臺北市,信義區,中坡里,722,875,380,128,508,45,553
公投第７案,臺北市,信義區,中坡里,723,927,399,99,498,22,520
公投第７案,臺北市,信義區,中坡里,724,1119,465,150,615,68,683
公投第７案,臺北市,信義區,中行里,725,1463,606,200,806,58,864
公投第７案,臺北市,信義區,中行里,726,1293,572,205,777,42,819
公投第７案,臺北市,信義區,中行里,727,1553,646,177,823,56,879
公投第７案,臺北市,信義區,中行里,728,1360,182,562,744,35,779
公投第７案,臺北市,信義區,中行里,729,1392,599,167,766,68,834
公投第７案,臺北市,信義區,大道里,730,1377,598,167,765,23,788
公投第７案,臺北市,信義區,大道里,731,1377,586,170,756,17,773
公投第７案,臺北市,信義區,大道里,732,1269,453,189,642,29,671
公投第７案,臺北市,信義區,大道里,733,1407,624,154,778,65,843
公投第７案,臺北市,信義區,大仁里,734,1172,492,153,645,39,684
公投第７案,臺北市,信義區,大仁里,735,1182,527,126,653,23,676
公投第７案,臺北市,信義區,大仁里,736,1255,528,167,695,58,753
公投第７案,臺北市,信義區,景新里,737,1689,658,175,833,37,870
公投第７案,臺北市,信義區,景新里,738,1605,648,187,835,30,865
公投第７案,臺北市,信義區,景新里,739,1143,501,123,624,36,660
公投第７案,臺北市,信義區,惠安里,740,1440,583,157,740,37,777
公投第７案,臺北市,信義區,惠安里,741,1495,643,166,809,52,861
公投第７案,臺北市,信義區,惠安里,742,1514,665,191,856,56,912
公投第７案,臺北市,信義區,惠安里,743,1449,591,141,732,53,785
公投第７案,臺北市,信義區,三張里,744,1401,618,172,790,59,849
公投第７案,臺北市,信義區,三張里,745,1181,483,119,602,24,626
公投第７案,臺北市,信義區,三張里,746,1376,674,160,834,16,850
公投第７案,臺北市,信義區,三張里,747,1422,643,179,822,49,871
公投第７案,臺北市,信義區,三張里,748,1267,580,125,705,20,725
公投第７案,臺北市,信義區,三張里,749,1220,486,141,627,26,653
公投第７案,臺北市,信義區,三犁里,750,1562,606,165,771,24,795
公投第７案,臺北市,信義區,三犁里,751,1455,605,158,763,27,790
公投第７案,臺北市,信義區,三犁里,752,1605,664,168,832,47,879
公投第７案,臺北市,信義區,六合里,753,1626,793,163,956,25,981
公投第７案,臺北市,信義區,六合里,754,1561,702,179,881,52,933
公投第７案,臺北市,信義區,六合里,755,1547,563,156,719,27,746
公投第７案,臺北市,信義區,六合里,756,1336,592,138,730,31,761
公投第７案,臺北市,信義區,泰和里,757,1314,511,118,629,42,671
公投第７案,臺北市,信義區,泰和里,758,1297,522,132,654,44,698
公投第７案,臺北市,信義區,泰和里,759,1366,541,157,698,60,758
公投第７案,臺北市,信義區,泰和里,760,1472,597,203,800,41,841
公投第７案,臺北市,信義區,泰和里,761,1450,634,154,788,49,837
公投第７案,臺北市,信義區,景聯里,762,1328,561,158,719,53,772
公投第７案,臺北市,信義區,景聯里,763,1399,608,192,800,57,857
公投第７案,臺北市,信義區,景聯里,764,1373,580,186,766,76,842
公投第７案,臺北市,信義區,景勤里,765,1099,472,105,577,30,607
公投第７案,臺北市,信義區,景勤里,766,1226,515,150,665,43,708
公投第７案,臺北市,信義區,景勤里,767,1267,533,118,651,22,673
公投第７案,臺北市,信義區,雙和里,768,1531,651,198,849,59,908
公投第７案,臺北市,信義區,雙和里,769,1438,655,170,825,48,873
公投第７案,臺北市,信義區,雙和里,770,1657,681,174,855,31,886
公投第７案,臺北市,信義區,雙和里,771,1621,702,217,919,51,970
公投第７案,臺北市,信義區,嘉興里,772,1508,639,215,854,26,880
公投第７案,臺北市,信義區,嘉興里,773,1334,594,180,774,35,809
公投第７案,臺北市,信義區,黎順里,774,1246,424,121,545,47,592
公投第７案,臺北市,信義區,黎順里,775,1196,546,167,713,43,756
公投第７案,臺北市,信義區,黎順里,776,1220,535,160,695,21,716
公投第７案,臺北市,信義區,黎平里,777,1538,634,178,812,28,840
公投第７案,臺北市,信義區,黎平里,778,1565,670,181,851,62,913
公投第７案,臺北市,信義區,黎平里,779,1621,617,172,789,89,878
公投第７案,臺北市,信義區,黎平里,780,1486,619,165,784,54,838
公投第７案,臺北市,信義區,黎忠里,781,1507,631,143,774,29,803
公投第７案,臺北市,信義區,黎忠里,782,1516,653,185,838,59,897
公投第７案,臺北市,信義區,黎忠里,783,1287,597,156,753,66,819
公投第７案,臺北市,信義區,黎安里,784,1050,392,122,514,47,561
公投第７案,臺北市,信義區,黎安里,785,801,370,91,461,36,497
公投第７案,臺北市,中山區,正守里,786,1522,655,170,825,41,866
公投第７案,臺北市,中山區,正守里,787,1332,510,193,703,37,740
公投第７案,臺北市,中山區,正義里,788,1656,588,194,782,54,836
公投第７案,臺北市,中山區,正義里,789,1367,492,171,663,48,711
公投第７案,臺北市,中山區,正義里,790,1732,620,211,831,57,888
公投第７案,臺北市,中山區,正得里,791,1634,695,184,879,58,937
公投第７案,臺北市,中山區,正得里,792,1650,611,231,842,52,894
公投第７案,臺北市,中山區,民安里,793,1392,559,217,776,37,813
公投第７案,臺北市,中山區,民安里,794,1177,496,196,692,34,726
公投第７案,臺北市,中山區,民安里,795,1477,613,199,812,55,867
公投第７案,臺北市,中山區,康樂里,796,1063,398,133,531,50,581
公投第７案,臺北市,中山區,康樂里,797,1296,523,140,663,42,705
公投第７案,臺北市,中山區,中山里,798,1330,542,139,681,30,711
公投第７案,臺北市,中山區,中山里,799,1483,537,216,753,52,805
公投第７案,臺北市,中山區,中山里,800,1542,619,169,788,43,831
公投第７案,臺北市,中山區,中山里,801,1710,670,204,874,66,940
公投第７案,臺北市,中山區,聚盛里,802,1315,472,166,638,32,670
公投第７案,臺北市,中山區,聚盛里,803,1245,484,150,634,66,700
公投第７案,臺北市,中山區,聚盛里,804,1262,518,129,647,37,684
公投第７案,臺北市,中山區,集英里,805,1518,594,218,812,58,870
公投第７案,臺北市,中山區,集英里,806,1522,608,202,810,69,879
公投第７案,臺北市,中山區,集英里,807,1580,525,227,752,76,828
公投第７案,臺北市,中山區,集英里,808,1529,626,185,811,37,848
公投第７案,臺北市,中山區,聚葉里,809,1221,460,162,622,43,665
公投第７案,臺北市,中山區,聚葉里,810,1221,507,163,670,55,725
公投第７案,臺北市,中山區,聚葉里,811,1139,446,99,545,29,574
公投第７案,臺北市,中山區,恆安里,812,1407,534,199,733,69,802
公投第７案,臺北市,中山區,恆安里,813,1321,551,146,697,40,737
公投第７案,臺北市,中山區,恆安里,814,1578,583,163,746,42,788
公投第７案,臺北市,中山區,晴光里,815,1739,656,182,838,51,889
公投第７案,臺北市,中山區,晴光里,816,1637,605,202,807,52,859
公投第７案,臺北市,中山區,晴光里,817,1541,579,192,771,73,844
公投第７案,臺北市,中山區,圓山里,818,1210,503,161,664,56,720
公投第７案,臺北市,中山區,圓山里,819,1331,506,168,674,48,722
公投第７案,臺北市,中山區,圓山里,820,1224,456,134,590,60,650
公投第７案,臺北市,中山區,新庄里,821,1585,651,188,839,65,904
公投第７案,臺北市,中山區,新庄里,822,1523,641,229,870,80,950
公投第７案,臺北市,中山區,新庄里,823,1368,614,166,780,58,838
公投第７案,臺北市,中山區,劍潭里,824,1805,837,138,975,55,1030
公投第７案,臺北市,中山區,劍潭里,825,1404,681,107,788,39,827
公投第７案,臺北市,中山區,大直里,826,1708,753,266,1019,47,1066
公投第７案,臺北市,中山區,大直里,827,1451,641,191,832,57,889
公投第７案,臺北市,中山區,大直里,828,1684,731,223,954,81,1035
公投第７案,臺北市,中山區,大直里,829,1585,689,162,851,38,889
公投第７案,臺北市,中山區,大直里,830,1391,581,186,767,70,837
公投第７案,臺北市,中山區,成功里,831,1375,650,191,841,72,913
公投第７案,臺北市,中山區,成功里,832,1472,653,212,865,19,884
公投第７案,臺北市,中山區,成功里,833,1327,542,152,694,46,740
公投第７案,臺北市,中山區,成功里,834,1401,640,143,783,35,818
公投第７案,臺北市,中山區,永安里,835,1423,614,167,781,54,835
公投第７案,臺北市,中山區,永安里,836,1569,630,245,875,48,923
公投第７案,臺北市,中山區,永安里,837,1651,690,226,916,34,950
公投第７案,臺北市,中山區,永安里,838,1624,749,103,852,31,883
公投第７案,臺北市,中山區,永安里,839,1713,732,254,986,57,1043
公投第７案,臺北市,中山區,金泰里,840,1647,746,188,934,50,984
公投第７案,臺北市,中山區,金泰里,841,1762,693,217,910,46,956
公投第７案,臺北市,中山區,金泰里,842,1399,666,152,818,43,861
公投第７案,臺北市,中山區,金泰里,843,1489,672,193,865,47,912
公投第７案,臺北市,中山區,北安里,844,1269,596,179,775,35,810
公投第７案,臺北市,中山區,北安里,845,998,478,108,586,44,630
公投第７案,臺北市,中山區,新喜里,846,1472,612,156,768,58,826
公投第７案,臺北市,中山區,新喜里,847,1517,539,213,752,55,807
公投第７案,臺北市,中山區,新喜里,848,1704,736,208,944,76,1020
公投第７案,臺北市,中山區,新福里,849,1603,586,280,866,67,933
公投第７案,臺北市,中山區,新福里,850,1432,538,167,705,78,783
公投第７案,臺北市,中山區,新福里,851,1500,613,218,831,64,895
公投第７案,臺北市,中山區,松江里,852,1332,575,181,756,40,796
公投第７案,臺北市,中山區,松江里,853,1450,598,225,823,54,877
公投第７案,臺北市,中山區,松江里,854,1434,596,212,808,51,859
公投第７案,臺北市,中山區,松江里,855,1419,539,195,734,31,765
公投第７案,臺北市,中山區,新生里,856,1292,479,194,673,41,714
公投第７案,臺北市,中山區,新生里,857,1526,573,204,777,57,834
公投第７案,臺北市,中山區,新生里,858,1582,533,187,720,59,779
公投第７案,臺北市,中山區,中庄里,859,1588,567,187,754,70,824
公投第７案,臺北市,中山區,中庄里,860,1463,566,196,762,77,839
公投第７案,臺北市,中山區,中庄里,861,1533,522,204,726,59,785
公投第７案,臺北市,中山區,大佳里,862,944,352,131,483,55,538
公投第７案,臺北市,中山區,行政里,863,1745,737,278,1015,72,1087
公投第７案,臺北市,中山區,行政里,864,1679,581,207,788,53,841
公投第７案,臺北市,中山區,行政里,865,3419,562,188,750,53,803
公投第７案,臺北市,中山區,行仁里,866,1387,570,185,755,75,830
公投第７案,臺北市,中山區,行仁里,867,1672,699,209,908,71,979
公投第７案,臺北市,中山區,行仁里,868,1319,519,175,694,74,768
公投第７案,臺北市,中山區,行仁里,869,1364,532,172,704,60,764
公投第７案,臺北市,中山區,行仁里,870,1461,574,186,760,51,811
公投第７案,臺北市,中山區,行孝里,871,1173,484,167,651,44,695
公投第７案,臺北市,中山區,行孝里,872,1171,440,135,575,50,625
公投第７案,臺北市,中山區,行孝里,873,1310,514,179,693,51,744
公投第７案,臺北市,中山區,下埤里,874,1373,621,159,780,46,826
公投第７案,臺北市,中山區,下埤里,875,1290,556,173,729,33,762
公投第７案,臺北市,中山區,下埤里,876,1346,573,184,757,62,819
公投第７案,臺北市,中山區,下埤里,877,1468,598,228,826,70,896
公投第７案,臺北市,中山區,下埤里,878,1178,515,151,666,38,704
公投第７案,臺北市,中山區,江寧里,879,1654,681,235,916,59,975
公投第７案,臺北市,中山區,江寧里,880,1464,612,179,791,68,859
公投第７案,臺北市,中山區,江寧里,881,1450,541,213,754,34,788
公投第７案,臺北市,中山區,江寧里,882,1534,590,213,803,68,871
公投第７案,臺北市,中山區,江山里,883,1703,678,234,912,39,951
公投第７案,臺北市,中山區,江山里,884,1610,650,213,863,83,946
公投第７案,臺北市,中山區,江山里,885,1653,608,241,849,77,926
公投第７案,臺北市,中山區,江山里,886,1694,658,280,938,67,1005
公投第７案,臺北市,中山區,中吉里,887,1623,628,222,850,66,916
公投第７案,臺北市,中山區,中吉里,888,1618,621,266,887,62,949
公投第７案,臺北市,中山區,中吉里,889,1583,592,225,817,53,870
公投第７案,臺北市,中山區,中原里,890,1605,629,266,895,68,963
公投第７案,臺北市,中山區,中原里,891,1398,600,228,828,52,880
公投第７案,臺北市,中山區,中原里,892,1526,686,234,920,61,981
公投第７案,臺北市,中山區,興亞里,893,1555,603,242,845,60,905
公投第７案,臺北市,中山區,興亞里,894,1597,646,194,840,45,885
公投第７案,臺北市,中山區,興亞里,895,1587,625,227,852,79,931
公投第７案,臺北市,中山區,中央里,896,1587,693,198,891,65,956
公投第７案,臺北市,中山區,中央里,897,1546,646,219,865,77,942
公投第７案,臺北市,中山區,朱馥里,898,1322,550,150,700,52,752
公投第７案,臺北市,中山區,朱馥里,899,1267,533,161,694,45,739
公投第７案,臺北市,中山區,朱馥里,900,1210,526,132,658,20,678
公投第７案,臺北市,中山區,朱馥里,901,1295,546,143,689,57,746
公投第７案,臺北市,中山區,龍洲里,902,1467,650,181,831,57,888
公投第７案,臺北市,中山區,龍洲里,903,1491,700,156,856,43,899
公投第７案,臺北市,中山區,龍洲里,904,1516,839,136,975,59,1034
公投第７案,臺北市,中山區,朱園里,905,1384,526,183,709,40,749
公投第７案,臺北市,中山區,朱園里,906,1138,509,172,681,45,726
公投第７案,臺北市,中山區,朱園里,907,1513,560,203,763,35,798
公投第７案,臺北市,中山區,埤頭里,908,1559,677,186,863,60,923
公投第７案,臺北市,中山區,埤頭里,909,1429,607,195,802,73,875
公投第７案,臺北市,中山區,朱崙里,910,1245,538,198,736,35,771
公投第７案,臺北市,中山區,朱崙里,911,1214,543,170,713,48,761
公投第７案,臺北市,中山區,力行里,912,1394,574,216,790,45,835
公投第７案,臺北市,中山區,力行里,913,1336,529,136,665,20,685
公投第７案,臺北市,中山區,力行里,914,1227,483,192,675,42,717
公投第７案,臺北市,中山區,力行里,915,1382,583,196,779,38,817
公投第７案,臺北市,中山區,復華里,916,1436,586,178,764,63,827
公投第７案,臺北市,中山區,復華里,917,1405,539,166,705,31,736
公投第７案,臺北市,中山區,復華里,918,1259,554,136,690,36,726
公投第７案,臺北市,大同區,玉泉里,919,1261,488,191,679,72,751
公投第７案,臺北市,大同區,玉泉里,920,1352,545,227,772,61,833
公投第７案,臺北市,大同區,建明里,921,1462,566,209,775,61,836
公投第７案,臺北市,大同區,建明里,922,1510,618,185,803,64,867
公投第７案,臺北市,大同區,建功里,923,1496,530,211,741,36,777
公投第７案,臺北市,大同區,建功里,924,1329,520,183,703,49,752
公投第７案,臺北市,大同區,建功里,925,1307,519,174,693,73,766
公投第７案,臺北市,大同區,建泰里,926,1065,440,137,577,52,629
公投第７案,臺北市,大同區,建泰里,927,1085,424,153,577,37,614
公投第７案,臺北市,大同區,建泰里,928,1047,421,186,607,52,659
公投第７案,臺北市,大同區,永樂里,929,1215,452,142,594,37,631
公投第７案,臺北市,大同區,永樂里,930,1117,457,194,651,33,684
公投第７案,臺北市,大同區,永樂里,931,1186,506,160,666,66,732
公投第７案,臺北市,大同區,永樂里,932,1185,473,191,664,57,721
公投第７案,臺北市,大同區,朝陽里,933,1359,546,172,718,43,761
公投第７案,臺北市,大同區,朝陽里,934,1273,508,174,682,33,715
公投第７案,臺北市,大同區,朝陽里,935,1291,567,171,738,52,790
公投第７案,臺北市,大同區,星明里,936,1288,487,180,667,43,710
公投第７案,臺北市,大同區,星明里,937,1245,542,182,724,51,775
公投第７案,臺北市,大同區,星明里,938,1261,553,182,735,58,793
公投第７案,臺北市,大同區,星明里,939,1348,529,170,699,29,728
公投第７案,臺北市,大同區,光能里,940,1676,640,254,894,86,980
公投第７案,臺北市,大同區,光能里,941,1311,567,186,753,50,803
公投第７案,臺北市,大同區,光能里,942,1316,541,171,712,80,792
公投第７案,臺北市,大同區,大有里,943,1409,556,199,755,71,826
公投第７案,臺北市,大同區,大有里,944,1436,592,218,810,63,873
公投第７案,臺北市,大同區,大有里,945,1408,541,232,773,62,835
公投第７案,臺北市,大同區,延平里,946,1276,492,194,686,45,731
公投第７案,臺北市,大同區,延平里,947,1110,491,119,610,16,626
公投第７案,臺北市,大同區,延平里,948,1324,522,197,719,36,755
公投第７案,臺北市,大同區,雙連里,949,1016,405,134,539,49,588
公投第７案,臺北市,大同區,雙連里,950,1028,444,158,602,38,640
公投第７案,臺北市,大同區,雙連里,951,1158,514,155,669,54,723
公投第７案,臺北市,大同區,雙連里,952,1138,497,142,639,59,698
公投第７案,臺北市,大同區,雙連里,953,1214,514,161,675,62,737
公投第７案,臺北市,大同區,雙連里,954,1090,428,159,587,28,615
公投第７案,臺北市,大同區,雙連里,955,1305,595,176,771,58,829
公投第７案,臺北市,大同區,南芳里,956,1167,460,132,592,29,621
公投第７案,臺北市,大同區,南芳里,957,1148,476,156,632,53,685
公投第７案,臺北市,大同區,南芳里,958,1203,523,149,672,51,723
公投第７案,臺北市,大同區,民權里,959,1441,532,192,724,43,767
公投第７案,臺北市,大同區,民權里,960,1315,549,210,759,64,823
公投第７案,臺北市,大同區,民權里,961,1393,561,164,725,72,797
公投第７案,臺北市,大同區,民權里,962,1278,529,174,703,59,762
公投第７案,臺北市,大同區,景星里,963,1246,467,147,614,51,665
公投第７案,臺北市,大同區,景星里,964,1142,433,155,588,68,656
公投第７案,臺北市,大同區,隆和里,965,1336,568,196,764,56,820
公投第７案,臺北市,大同區,隆和里,966,1363,565,205,770,64,834
公投第７案,臺北市,大同區,蓬萊里,967,1476,598,194,792,36,828
公投第７案,臺北市,大同區,蓬萊里,968,1418,559,224,783,52,835
公投第７案,臺北市,大同區,蓬萊里,969,1460,555,190,745,34,779
公投第７案,臺北市,大同區,國順里,970,1222,407,154,561,51,612
公投第７案,臺北市,大同區,國順里,971,1246,425,140,565,88,653
公投第７案,臺北市,大同區,國慶里,972,1256,487,207,694,71,765
公投第７案,臺北市,大同區,國慶里,973,1289,536,170,706,31,737
公投第７案,臺北市,大同區,國慶里,974,1340,500,178,678,23,701
公投第７案,臺北市,大同區,揚雅里,975,1555,554,220,774,64,838
公投第７案,臺北市,大同區,揚雅里,976,2459,582,168,750,70,820
公投第７案,臺北市,大同區,斯文里,977,1108,356,123,479,58,537
公投第７案,臺北市,大同區,斯文里,978,867,317,114,431,53,484
公投第７案,臺北市,大同區,斯文里,979,1329,548,211,759,60,819
公投第７案,臺北市,大同區,斯文里,980,1162,452,170,622,31,653
公投第７案,臺北市,大同區,鄰江里,981,1434,525,191,716,69,785
公投第７案,臺北市,大同區,鄰江里,982,1351,548,177,725,64,789
公投第７案,臺北市,大同區,鄰江里,983,1531,545,205,750,43,793
公投第７案,臺北市,大同區,鄰江里,984,1507,522,200,722,18,740
公投第７案,臺北市,大同區,至聖里,985,1488,565,220,785,56,841
公投第７案,臺北市,大同區,至聖里,986,1384,578,186,764,88,852
公投第７案,臺北市,大同區,至聖里,987,1460,586,181,767,79,846
公投第７案,臺北市,大同區,至聖里,988,1371,590,191,781,62,843
公投第７案,臺北市,大同區,至聖里,989,1439,559,189,748,35,783
公投第７案,臺北市,大同區,老師里,990,1376,533,220,753,73,826
公投第７案,臺北市,大同區,老師里,991,1366,513,176,689,83,772
公投第７案,臺北市,大同區,老師里,992,1218,526,201,727,59,786
公投第７案,臺北市,大同區,老師里,993,1235,527,142,669,59,728
公投第７案,臺北市,大同區,重慶里,994,1364,544,145,689,28,717
公投第７案,臺北市,大同區,重慶里,995,1408,604,212,816,79,895
公投第７案,臺北市,大同區,重慶里,996,1450,584,200,784,62,846
公投第７案,臺北市,大同區,重慶里,997,1429,619,200,819,68,887
公投第７案,臺北市,大同區,保安里,998,1170,482,168,650,65,715
公投第７案,臺北市,大同區,保安里,999,1245,464,190,654,79,733
公投第７案,臺北市,大同區,保安里,1000,1215,514,203,717,69,786
公投第７案,臺北市,中正區,水源里,1001,1308,553,192,745,39,784
公投第７案,臺北市,中正區,水源里,1002,1317,501,166,667,70,737
公投第７案,臺北市,中正區,富水里,1003,1069,515,113,628,33,661
公投第７案,臺北市,中正區,富水里,1004,1128,490,101,591,41,632
公投第７案,臺北市,中正區,文盛里,1005,1053,437,157,594,49,643
公投第７案,臺北市,中正區,文盛里,1006,1048,442,137,579,22,601
公投第７案,臺北市,中正區,林興里,1007,1297,561,123,684,52,736
公投第７案,臺北市,中正區,林興里,1008,1193,571,123,694,23,717
公投第７案,臺北市,中正區,林興里,1009,1500,687,232,919,52,971
公投第７案,臺北市,中正區,河堤里,1010,1346,548,162,710,36,746
公投第７案,臺北市,中正區,河堤里,1011,1283,541,164,705,23,728
公投第７案,臺北市,中正區,河堤里,1012,1450,620,161,781,45,826
公投第７案,臺北市,中正區,頂東里,1013,1433,601,206,807,44,851
公投第７案,臺北市,中正區,頂東里,1014,1309,603,211,814,45,859
公投第７案,臺北市,中正區,頂東里,1015,1386,603,175,778,32,810
公投第７案,臺北市,中正區,頂東里,1016,1201,526,161,687,45,732
公投第７案,臺北市,中正區,網溪里,1017,1336,596,174,770,48,818
公投第７案,臺北市,中正區,網溪里,1018,1358,566,215,781,48,829
公投第７案,臺北市,中正區,網溪里,1019,1177,500,165,665,49,714
公投第７案,臺北市,中正區,網溪里,1020,1236,595,161,756,31,787
公投第７案,臺北市,中正區,板溪里,1021,1478,610,199,809,48,857
公投第７案,臺北市,中正區,板溪里,1022,1474,649,193,842,31,873
公投第７案,臺北市,中正區,螢圃里,1023,1172,487,163,650,40,690
公投第７案,臺北市,中正區,螢圃里,1024,1310,549,187,736,35,771
公投第７案,臺北市,中正區,螢圃里,1025,1263,563,143,706,55,761
公投第７案,臺北市,中正區,螢圃里,1026,1169,479,177,656,45,701
公投第７案,臺北市,中正區,螢雪里,1027,1391,620,125,745,29,774
公投第７案,臺北市,中正區,螢雪里,1028,1201,507,143,650,30,680
公投第７案,臺北市,中正區,螢雪里,1029,1324,564,180,744,41,785
公投第７案,臺北市,中正區,永功里,1030,1216,475,148,623,60,683
公投第７案,臺北市,中正區,永功里,1031,1183,493,144,637,44,681
公投第７案,臺北市,中正區,永功里,1032,1469,600,214,814,75,889
公投第７案,臺北市,中正區,永功里,1033,1411,594,171,765,54,819
公投第７案,臺北市,中正區,永昌里,1034,1398,598,169,767,77,844
公投第７案,臺北市,中正區,永昌里,1035,1479,624,152,776,68,844
公投第７案,臺北市,中正區,永昌里,1036,1620,677,149,826,77,903
公投第７案,臺北市,中正區,龍興里,1037,1041,438,131,569,18,587
公投第７案,臺北市,中正區,龍興里,1038,1056,410,158,568,14,582
公投第７案,臺北市,中正區,龍興里,1039,1063,482,155,637,41,678
公投第７案,臺北市,中正區,忠勤里,1040,1591,535,151,686,60,746
公投第７案,臺北市,中正區,忠勤里,1041,1502,499,138,637,71,708
公投第７案,臺北市,中正區,忠勤里,1042,1331,518,126,644,70,714
公投第７案,臺北市,中正區,忠勤里,1043,1441,588,164,752,66,818
公投第７案,臺北市,中正區,廈安里,1044,1273,571,161,732,56,788
公投第７案,臺北市,中正區,廈安里,1045,1133,478,150,628,56,684
公投第７案,臺北市,中正區,廈安里,1046,1156,515,135,650,39,689
公投第７案,臺北市,中正區,愛國里,1047,1377,548,191,739,58,797
公投第７案,臺北市,中正區,愛國里,1048,1266,530,178,708,70,778
公投第７案,臺北市,中正區,南門里,1049,1111,526,135,661,48,709
公投第７案,臺北市,中正區,南門里,1050,1124,491,141,632,26,658
公投第７案,臺北市,中正區,龍光里,1051,1373,645,158,803,43,846
公投第７案,臺北市,中正區,龍光里,1052,1351,604,182,786,50,836
公投第７案,臺北市,中正區,南福里,1053,1495,642,201,843,35,878
公投第７案,臺北市,中正區,南福里,1054,1436,716,198,914,55,969
公投第７案,臺北市,中正區,南福里,1055,1516,664,166,830,34,864
公投第７案,臺北市,中正區,南福里,1056,1374,589,172,761,43,804
公投第７案,臺北市,中正區,南福里,1057,1522,604,177,781,47,828
公投第７案,臺北市,中正區,南福里,1058,1336,579,175,754,39,793
公投第７案,臺北市,中正區,龍福里,1059,1551,671,197,868,41,909
公投第７案,臺北市,中正區,龍福里,1060,1594,660,225,885,67,952
公投第７案,臺北市,中正區,龍福里,1061,1503,599,207,806,70,876
公投第７案,臺北市,中正區,新營里,1062,1455,642,176,818,46,864
公投第７案,臺北市,中正區,新營里,1063,1439,635,184,819,25,844
公投第７案,臺北市,中正區,新營里,1064,1469,629,191,820,44,864
公投第７案,臺北市,中正區,新營里,1065,1430,675,148,823,39,862
公投第７案,臺北市,中正區,新營里,1066,1444,645,188,833,52,885
公投第７案,臺北市,中正區,建國里,1067,1254,554,155,709,21,730
公投第７案,臺北市,中正區,光復里,1068,932,428,99,527,47,574
公投第７案,臺北市,中正區,光復里,1069,1055,447,151,598,46,644
公投第７案,臺北市,中正區,光復里,1070,1226,519,167,686,35,721
公投第７案,臺北市,中正區,黎明里,1071,1390,526,158,684,48,732
公投第７案,臺北市,中正區,黎明里,1072,1336,575,158,733,42,775
公投第７案,臺北市,中正區,梅花里,1073,1419,513,188,701,49,750
公投第７案,臺北市,中正區,梅花里,1074,1361,592,206,798,47,845
公投第７案,臺北市,中正區,幸福里,1075,2520,900,192,1092,49,1141
公投第７案,臺北市,中正區,幸福里,1076,1224,515,166,681,21,702
公投第７案,臺北市,中正區,幸福里,1077,1272,483,167,650,5,655
公投第７案,臺北市,中正區,幸市里,1078,1400,515,253,768,42,810
公投第７案,臺北市,中正區,幸市里,1079,1319,508,184,692,30,722
公投第７案,臺北市,中正區,幸市里,1080,1232,536,176,712,46,758
公投第７案,臺北市,中正區,東門里,1081,1265,587,171,758,41,799
公投第７案,臺北市,中正區,東門里,1082,1055,502,146,648,27,675
公投第７案,臺北市,中正區,東門里,1083,954,390,149,539,27,566
公投第７案,臺北市,中正區,文北里,1084,1018,454,125,579,33,612
公投第７案,臺北市,中正區,文北里,1085,1431,593,188,781,48,829
公投第７案,臺北市,中正區,文北里,1086,1271,464,154,618,52,670
公投第７案,臺北市,中正區,文北里,1087,983,415,154,569,44,613
公投第７案,臺北市,中正區,文祥里,1088,1594,622,234,856,44,900
公投第７案,臺北市,中正區,文祥里,1089,1565,747,65,812,53,865
公投第７案,臺北市,中正區,文祥里,1090,1650,691,216,907,38,945
公投第７案,臺北市,中正區,文祥里,1091,1600,617,219,836,44,880
公投第７案,臺北市,中正區,三愛里,1092,1391,559,195,754,24,778
公投第７案,臺北市,中正區,三愛里,1093,1769,703,255,958,42,1000
公投第７案,臺北市,中正區,三愛里,1094,1487,580,244,824,54,878
公投第７案,臺北市,中正區,三愛里,1095,1291,554,195,749,41,790
公投第７案,臺北市,中正區,三愛里,1096,1289,527,214,741,33,774
公投第７案,臺北市,萬華區,福星里,1097,1305,568,185,753,56,809
公投第７案,臺北市,萬華區,福星里,1098,1183,395,141,536,69,605
公投第７案,臺北市,萬華區,福星里,1099,1176,474,130,604,30,634
公投第７案,臺北市,萬華區,福星里,1100,1169,412,150,562,30,592
公投第７案,臺北市,萬華區,萬壽里,1101,1457,500,188,688,46,734
公投第７案,臺北市,萬華區,萬壽里,1102,1563,506,180,686,64,750
公投第７案,臺北市,萬華區,西門里,1103,1771,608,192,800,36,836
公投第７案,臺北市,萬華區,西門里,1104,1615,588,193,781,53,834
公投第７案,臺北市,萬華區,新起里,1105,1478,564,182,746,78,824
公投第７案,臺北市,萬華區,新起里,1106,1462,569,175,744,27,771
公投第７案,臺北市,萬華區,新起里,1107,1507,517,149,666,69,735
公投第７案,臺北市,萬華區,新起里,1108,1347,537,207,744,51,795
公投第７案,臺北市,萬華區,菜園里,1109,1367,492,177,669,54,723
公投第７案,臺北市,萬華區,菜園里,1110,1277,522,208,730,51,781
公投第７案,臺北市,萬華區,菜園里,1111,1395,525,227,752,50,802
公投第７案,臺北市,萬華區,菜園里,1112,1450,530,193,723,55,778
公投第７案,臺北市,萬華區,青山里,1113,1340,487,154,641,51,692
公投第７案,臺北市,萬華區,青山里,1114,1242,448,165,613,52,665
公投第７案,臺北市,萬華區,青山里,1115,1286,449,184,633,78,711
公投第７案,臺北市,萬華區,青山里,1116,1324,501,148,649,50,699
公投第７案,臺北市,萬華區,富民里,1117,1619,557,223,780,78,858
公投第７案,臺北市,萬華區,富民里,1118,1352,436,170,606,68,674
公投第７案,臺北市,萬華區,富民里,1119,1440,511,186,697,54,751
公投第７案,臺北市,萬華區,福音里,1120,1194,486,179,665,51,716
公投第７案,臺北市,萬華區,福音里,1121,1083,475,143,618,73,691
公投第７案,臺北市,萬華區,福音里,1122,1237,442,166,608,69,677
公投第７案,臺北市,萬華區,仁德里,1123,1625,616,210,826,60,886
公投第７案,臺北市,萬華區,仁德里,1124,1324,539,190,729,72,801
公投第７案,臺北市,萬華區,仁德里,1125,1352,559,175,734,58,792
公投第７案,臺北市,萬華區,富福里,1126,2630,490,193,683,57,740
公投第７案,臺北市,萬華區,富福里,1127,1504,606,225,831,69,900
公投第７案,臺北市,萬華區,富福里,1128,1425,515,193,708,64,772
公投第７案,臺北市,萬華區,柳鄉里,1129,1591,542,181,723,79,802
公投第７案,臺北市,萬華區,柳鄉里,1130,1474,578,145,723,81,804
公投第７案,臺北市,萬華區,柳鄉里,1131,1612,575,166,741,83,824
公投第７案,臺北市,萬華區,華江里,1132,1447,559,182,741,65,806
公投第７案,臺北市,萬華區,華江里,1133,1491,639,174,813,53,866
公投第７案,臺北市,萬華區,華江里,1134,1500,635,190,825,55,880
公投第７案,臺北市,萬華區,華江里,1135,1582,664,199,863,71,934
公投第７案,臺北市,萬華區,華江里,1136,1623,612,202,814,102,916
公投第７案,臺北市,萬華區,糖廍里,1137,1228,466,157,623,32,655
公投第７案,臺北市,萬華區,糖廍里,1138,1268,510,153,663,64,727
公投第７案,臺北市,萬華區,糖廍里,1139,1207,511,154,665,62,727
公投第７案,臺北市,萬華區,糖廍里,1140,1188,499,175,674,39,713
公投第７案,臺北市,萬華區,綠堤里,1141,1474,551,187,738,54,792
公投第７案,臺北市,萬華區,綠堤里,1142,1304,471,102,573,23,596
公投第７案,臺北市,萬華區,綠堤里,1143,1082,334,78,412,45,457
公投第７案,臺北市,萬華區,頂碩里,1144,1052,365,142,507,42,549
公投第７案,臺北市,萬華區,頂碩里,1145,1135,411,165,576,57,633
公投第７案,臺北市,萬華區,頂碩里,1146,1225,450,184,634,59,693
公投第７案,臺北市,萬華區,頂碩里,1147,1583,585,181,766,68,834
公投第７案,臺北市,萬華區,頂碩里,1148,1403,533,190,723,54,777
公投第７案,臺北市,萬華區,雙園里,1149,1406,550,195,745,64,809
公投第７案,臺北市,萬華區,雙園里,1150,1401,575,183,758,56,814
公投第７案,臺北市,萬華區,雙園里,1151,1188,484,151,635,66,701
公投第７案,臺北市,萬華區,和平里,1152,1597,572,192,764,80,844
公投第７案,臺北市,萬華區,和平里,1153,1290,554,169,723,69,792
公投第７案,臺北市,萬華區,和平里,1154,1746,602,203,805,22,827
公投第７案,臺北市,萬華區,和平里,1155,1595,544,168,712,41,753
公投第７案,臺北市,萬華區,和德里,1156,1701,727,96,823,109,932
公投第７案,臺北市,萬華區,和德里,1157,1339,419,159,578,85,663
公投第７案,臺北市,萬華區,和德里,1158,1484,514,143,657,76,733
公投第７案,臺北市,萬華區,和德里,1159,1604,637,196,833,79,912
公投第７案,臺北市,萬華區,全德里,1160,1197,479,171,650,41,691
公投第７案,臺北市,萬華區,全德里,1161,1347,485,178,663,76,739
公投第７案,臺北市,萬華區,全德里,1162,1223,575,156,731,48,779
公投第７案,臺北市,萬華區,日善里,1163,1036,443,120,563,39,602
公投第７案,臺北市,萬華區,日善里,1164,1035,442,156,598,67,665
公投第７案,臺北市,萬華區,日善里,1165,1141,506,139,645,55,700
公投第７案,臺北市,萬華區,忠德里,1166,1271,550,152,702,36,738
公投第７案,臺北市,萬華區,忠德里,1167,1328,531,185,716,88,804
公投第７案,臺北市,萬華區,忠德里,1168,1286,539,176,715,40,755
公投第７案,臺北市,萬華區,錦德里,1169,1679,687,220,907,89,996
公投第７案,臺北市,萬華區,錦德里,1170,1619,648,196,844,69,913
公投第７案,臺北市,萬華區,錦德里,1171,1625,609,133,742,70,812
公投第７案,臺北市,萬華區,孝德里,1172,1623,663,213,876,73,949
公投第７案,臺北市,萬華區,孝德里,1173,1280,505,146,651,70,721
公投第７案,臺北市,萬華區,壽德里,1174,1608,649,176,825,66,891
公投第７案,臺北市,萬華區,壽德里,1175,1453,592,198,790,62,852
公投第７案,臺北市,萬華區,壽德里,1176,1472,654,199,853,57,910
公投第７案,臺北市,萬華區,銘德里,1177,1373,570,191,761,35,796
公投第７案,臺北市,萬華區,銘德里,1178,1394,546,152,698,73,771
公投第７案,臺北市,萬華區,銘德里,1179,1427,547,148,695,33,728
公投第７案,臺北市,萬華區,保德里,1180,1342,555,207,762,61,823
公投第７案,臺北市,萬華區,保德里,1181,1569,654,194,848,82,930
公投第７案,臺北市,萬華區,榮德里,1182,1514,523,172,695,55,750
公投第７案,臺北市,萬華區,榮德里,1183,1720,611,173,784,42,826
公投第７案,臺北市,萬華區,華中里,1184,1461,641,202,843,77,920
公投第７案,臺北市,萬華區,華中里,1185,1264,490,156,646,32,678
公投第７案,臺北市,萬華區,華中里,1186,1334,572,192,764,57,821
公投第７案,臺北市,萬華區,華中里,1187,1446,586,189,775,39,814
公投第７案,臺北市,萬華區,興德里,1188,1307,491,144,635,41,676
公投第７案,臺北市,萬華區,興德里,1189,1420,586,167,753,84,837
公投第７案,臺北市,萬華區,興德里,1190,1427,544,160,704,34,738
公投第７案,臺北市,萬華區,日祥里,1191,956,403,99,502,42,544
公投第７案,臺北市,萬華區,日祥里,1192,1352,579,150,729,65,794
公投第７案,臺北市,萬華區,日祥里,1193,1370,597,125,722,54,776
公投第７案,臺北市,萬華區,日祥里,1194,1222,601,91,692,41,733
公投第７案,臺北市,萬華區,忠貞里,1195,1375,619,107,726,52,778
公投第７案,臺北市,萬華區,忠貞里,1196,1463,528,269,797,62,859
公投第７案,臺北市,萬華區,忠貞里,1197,1527,581,155,736,43,779
公投第７案,臺北市,萬華區,新忠里,1198,1485,626,126,752,52,804
公投第７案,臺北市,萬華區,新忠里,1199,1591,805,133,938,43,981
公投第７案,臺北市,萬華區,新和里,1200,1394,729,153,882,34,916
公投第７案,臺北市,萬華區,新和里,1201,1522,661,160,821,38,859
公投第７案,臺北市,萬華區,新和里,1202,1661,816,149,965,38,1003
公投第７案,臺北市,萬華區,新和里,1203,1561,750,161,911,26,937
公投第７案,臺北市,萬華區,新和里,1204,1406,676,171,847,53,900
公投第７案,臺北市,萬華區,新安里,1205,1498,508,144,652,40,692
公投第７案,臺北市,萬華區,新安里,1206,1478,488,148,636,67,703
公投第７案,臺北市,萬華區,新安里,1207,1170,456,132,588,67,655
公投第７案,臺北市,萬華區,新安里,1208,1376,636,137,773,44,817
公投第７案,臺北市,萬華區,凌霄里,1209,1093,492,99,591,21,612
公投第７案,臺北市,萬華區,凌霄里,1210,1084,495,128,623,58,681
公投第７案,臺北市,萬華區,凌霄里,1211,1119,507,120,627,49,676
公投第７案,臺北市,萬華區,騰雲里,1212,1381,646,169,815,44,859
公投第７案,臺北市,萬華區,騰雲里,1213,1396,621,155,776,40,816
公投第７案,臺北市,大安區,德安里,1214,1184,457,160,617,29,646
公投第７案,臺北市,大安區,德安里,1215,1197,469,145,614,38,652
公投第７案,臺北市,大安區,德安里,1216,1221,504,168,672,25,697
公投第７案,臺北市,大安區,德安里,1217,1246,578,132,710,29,739
公投第７案,臺北市,大安區,仁慈里,1218,1478,652,222,874,45,919
公投第７案,臺北市,大安區,仁慈里,1219,1314,505,191,696,56,752
公投第７案,臺北市,大安區,仁慈里,1220,1594,691,223,914,47,961
公投第７案,臺北市,大安區,和安里,1221,1429,610,215,825,28,853
公投第７案,臺北市,大安區,和安里,1222,1452,661,190,851,26,877
公投第７案,臺北市,大安區,和安里,1223,1551,627,229,856,29,885
公投第７案,臺北市,大安區,和安里,1224,1335,598,175,773,54,827
公投第７案,臺北市,大安區,民炤里,1225,1196,474,138,612,29,641
公投第７案,臺北市,大安區,民炤里,1226,1339,505,197,702,30,732
公投第７案,臺北市,大安區,民炤里,1227,1448,559,213,772,33,805
公投第７案,臺北市,大安區,民炤里,1228,1373,580,164,744,54,798
公投第７案,臺北市,大安區,民炤里,1229,1439,594,174,768,71,839
公投第７案,臺北市,大安區,仁愛里,1230,1174,444,162,606,12,618
公投第７案,臺北市,大安區,仁愛里,1231,1144,420,158,578,24,602
公投第７案,臺北市,大安區,仁愛里,1232,1119,448,118,566,34,600
公投第７案,臺北市,大安區,仁愛里,1233,1024,357,105,462,37,499
公投第７案,臺北市,大安區,義村里,1234,1032,492,116,608,20,628
公投第７案,臺北市,大安區,義村里,1235,1319,646,108,754,40,794
公投第７案,臺北市,大安區,義村里,1236,1369,623,172,795,45,840
公投第７案,臺北市,大安區,義村里,1237,1347,518,229,747,54,801
公投第７案,臺北市,大安區,民輝里,1238,1655,556,257,813,50,863
公投第７案,臺北市,大安區,民輝里,1239,1595,569,203,772,33,805
公投第７案,臺北市,大安區,民輝里,1240,1429,552,186,738,40,778
公投第７案,臺北市,大安區,民輝里,1241,1309,496,161,657,25,682
公投第７案,臺北市,大安區,昌隆里,1242,1508,559,224,783,42,825
公投第７案,臺北市,大安區,昌隆里,1243,1310,492,194,686,33,719
公投第７案,臺北市,大安區,誠安里,1244,1233,439,163,602,34,636
公投第７案,臺北市,大安區,誠安里,1245,1287,482,160,642,49,691
公投第７案,臺北市,大安區,誠安里,1246,1147,405,158,563,34,597
公投第７案,臺北市,大安區,光武里,1247,1260,476,166,642,33,675
公投第７案,臺北市,大安區,光武里,1248,1377,558,163,721,41,762
公投第７案,臺北市,大安區,光武里,1249,1284,485,167,652,62,714
公投第７案,臺北市,大安區,光武里,1250,1314,484,159,643,28,671
公投第７案,臺北市,大安區,光武里,1251,1273,487,160,647,32,679
公投第７案,臺北市,大安區,龍坡里,1252,1146,472,172,644,23,667
公投第７案,臺北市,大安區,龍坡里,1253,1285,541,186,727,29,756
公投第７案,臺北市,大安區,龍坡里,1254,1297,559,188,747,35,782
公投第７案,臺北市,大安區,龍坡里,1255,1101,525,131,656,30,686
公投第７案,臺北市,大安區,龍泉里,1256,1310,524,187,711,52,763
公投第７案,臺北市,大安區,龍泉里,1257,1365,571,216,787,58,845
公投第７案,臺北市,大安區,龍泉里,1258,1372,559,191,750,28,778
公投第７案,臺北市,大安區,古風里,1259,1189,508,169,677,26,703
公投第７案,臺北市,大安區,古風里,1260,1256,525,180,705,42,747
公投第７案,臺北市,大安區,古風里,1261,1151,493,170,663,35,698
公投第７案,臺北市,大安區,古莊里,1262,1501,705,193,898,37,935
公投第７案,臺北市,大安區,古莊里,1263,1520,666,196,862,45,907
公投第７案,臺北市,大安區,古莊里,1264,1529,652,246,898,55,953
公投第７案,臺北市,大安區,古莊里,1265,1579,675,234,909,50,959
公投第７案,臺北市,大安區,龍安里,1266,2619,476,168,644,35,679
公投第７案,臺北市,大安區,龍安里,1267,1290,557,185,742,21,763
公投第７案,臺北市,大安區,龍安里,1268,1307,563,210,773,31,804
公投第７案,臺北市,大安區,龍安里,1269,1489,648,182,830,33,863
公投第７案,臺北市,大安區,錦安里,1270,1097,511,139,650,35,685
公投第７案,臺北市,大安區,錦安里,1271,1328,559,179,738,39,777
公投第７案,臺北市,大安區,錦安里,1272,1189,490,174,664,20,684
公投第７案,臺北市,大安區,錦安里,1273,1270,524,190,714,27,741
公投第７案,臺北市,大安區,福住里,1274,1349,534,205,739,18,757
公投第７案,臺北市,大安區,福住里,1275,1292,516,171,687,31,718
公投第７案,臺北市,大安區,福住里,1276,1314,589,184,773,35,808
公投第７案,臺北市,大安區,福住里,1277,1200,500,180,680,49,729
公投第７案,臺北市,大安區,永康里,1278,1558,630,230,860,43,903
公投第７案,臺北市,大安區,永康里,1279,1561,630,228,858,40,898
公投第７案,臺北市,大安區,光明里,1280,1446,632,178,810,44,854
公投第７案,臺北市,大安區,光明里,1281,1499,640,211,851,34,885
公投第７案,臺北市,大安區,錦泰里,1282,1467,618,206,824,36,860
公投第７案,臺北市,大安區,錦泰里,1283,1511,605,187,792,50,842
公投第７案,臺北市,大安區,錦華里,1284,1600,685,221,906,56,962
公投第７案,臺北市,大安區,錦華里,1285,1573,636,253,889,43,932
公投第７案,臺北市,大安區,錦華里,1286,1467,653,193,846,50,896
公投第７案,臺北市,大安區,龍圖里,1287,1358,598,143,741,61,802
公投第７案,臺北市,大安區,龍圖里,1288,1568,636,204,840,61,901
公投第７案,臺北市,大安區,龍圖里,1289,1411,593,199,792,45,837
公投第７案,臺北市,大安區,龍圖里,1290,1554,626,195,821,29,850
公投第７案,臺北市,大安區,新龍里,1291,1345,620,110,730,33,763
公投第７案,臺北市,大安區,新龍里,1292,1435,659,146,805,27,832
公投第７案,臺北市,大安區,新龍里,1293,1481,710,188,898,27,925
公投第７案,臺北市,大安區,新龍里,1294,1451,727,160,887,34,921
公投第７案,臺北市,大安區,龍陣里,1295,1566,638,223,861,62,923
公投第７案,臺北市,大安區,龍陣里,1296,1525,638,214,852,38,890
公投第７案,臺北市,大安區,龍雲里,1297,1336,532,168,700,41,741
公投第７案,臺北市,大安區,龍雲里,1298,1483,604,206,810,57,867
公投第７案,臺北市,大安區,龍雲里,1299,1396,534,144,678,31,709
公投第７案,臺北市,大安區,龍生里,1300,1406,605,198,803,59,862
公投第７案,臺北市,大安區,龍生里,1301,1434,621,180,801,34,835
公投第７案,臺北市,大安區,龍生里,1302,1288,533,178,711,36,747
公投第７案,臺北市,大安區,龍生里,1303,1407,616,178,794,36,830
公投第７案,臺北市,大安區,住安里,1304,1514,585,190,775,38,813
公投第７案,臺北市,大安區,住安里,1305,1550,568,146,714,58,772
公投第７案,臺北市,大安區,住安里,1306,1490,634,87,721,50,771
公投第７案,臺北市,大安區,義安里,1307,1284,535,143,678,30,708
公投第７案,臺北市,大安區,義安里,1308,1129,505,131,636,42,678
公投第７案,臺北市,大安區,義安里,1309,1193,512,162,674,30,704
公投第７案,臺北市,大安區,義安里,1310,1057,413,147,560,39,599
公投第７案,臺北市,大安區,通化里,1311,1361,551,175,726,50,776
公投第７案,臺北市,大安區,通化里,1312,1412,582,150,732,61,793
公投第７案,臺北市,大安區,通化里,1313,1423,511,159,670,47,717
公投第７案,臺北市,大安區,通化里,1314,1257,517,148,665,70,735
公投第７案,臺北市,大安區,通安里,1315,1133,504,161,665,37,702
公投第７案,臺北市,大安區,通安里,1316,1077,432,142,574,29,603
公投第７案,臺北市,大安區,通安里,1317,1300,567,174,741,39,780
公投第７案,臺北市,大安區,通安里,1318,1319,597,169,766,55,821
公投第７案,臺北市,大安區,臨江里,1319,1265,555,135,690,71,761
公投第７案,臺北市,大安區,臨江里,1320,1265,499,155,654,27,681
公投第７案,臺北市,大安區,臨江里,1321,1103,504,115,619,34,653
公投第７案,臺北市,大安區,法治里,1322,1341,614,133,747,42,789
公投第７案,臺北市,大安區,法治里,1323,1357,631,144,775,49,824
公投第７案,臺北市,大安區,法治里,1324,1260,544,161,705,41,746
公投第７案,臺北市,大安區,全安里,1325,1295,566,162,728,42,770
公投第７案,臺北市,大安區,全安里,1326,1399,550,162,712,26,738
公投第７案,臺北市,大安區,全安里,1327,1150,486,145,631,36,667
公投第７案,臺北市,大安區,群賢里,1328,1351,541,140,681,34,715
公投第７案,臺北市,大安區,群賢里,1329,1341,570,171,741,50,791
公投第７案,臺北市,大安區,群賢里,1330,1129,560,47,607,21,628
公投第７案,臺北市,大安區,群賢里,1331,1328,584,143,727,31,758
公投第７案,臺北市,大安區,群英里,1332,1557,799,137,936,39,975
公投第７案,臺北市,大安區,群英里,1333,1461,711,165,876,46,922
公投第７案,臺北市,大安區,群英里,1334,1589,611,171,782,34,816
公投第７案,臺北市,大安區,群英里,1335,1473,652,135,787,44,831
公投第７案,臺北市,大安區,虎嘯里,1336,1479,609,188,797,42,839
公投第７案,臺北市,大安區,虎嘯里,1337,833,372,122,494,29,523
公投第７案,臺北市,大安區,虎嘯里,1338,999,436,101,537,27,564
公投第７案,臺北市,大安區,臥龍里,1339,1757,785,214,999,42,1041
公投第７案,臺北市,大安區,龍淵里,1340,1573,685,201,886,37,923
公投第７案,臺北市,大安區,龍淵里,1341,1587,707,229,936,44,980
公投第７案,臺北市,大安區,龍淵里,1342,1496,634,225,859,55,914
公投第７案,臺北市,大安區,龍淵里,1343,1440,598,203,801,44,845
公投第７案,臺北市,大安區,龍淵里,1344,1578,667,226,893,61,954
公投第７案,臺北市,大安區,龍門里,1345,1223,494,181,675,32,707
公投第７案,臺北市,大安區,龍門里,1346,1119,460,162,622,21,643
公投第７案,臺北市,大安區,龍門里,1347,1252,550,172,722,40,762
公投第７案,臺北市,大安區,大學里,1348,1576,644,232,876,46,922
公投第７案,臺北市,大安區,大學里,1349,1425,574,190,764,38,802
公投第７案,臺北市,大安區,大學里,1350,1450,548,197,745,29,774
公投第７案,臺北市,大安區,大學里,1351,1444,577,194,771,38,809
公投第７案,臺北市,大安區,大學里,1352,1337,594,198,792,33,825
公投第７案,臺北市,大安區,芳和里,1353,1417,580,157,737,31,768
公投第７案,臺北市,大安區,芳和里,1354,1250,529,153,682,45,727
公投第７案,臺北市,大安區,芳和里,1355,1176,490,139,629,51,680
公投第７案,臺北市,大安區,芳和里,1356,1257,578,157,735,48,783
公投第７案,臺北市,大安區,黎元里,1357,1257,539,158,697,50,747
公投第７案,臺北市,大安區,黎元里,1358,1148,486,147,633,27,660
公投第７案,臺北市,大安區,黎元里,1359,1418,587,174,761,59,820
公投第７案,臺北市,大安區,黎元里,1360,1028,430,117,547,26,573
公投第７案,臺北市,大安區,黎孝里,1361,1445,628,211,839,49,888
公投第７案,臺北市,大安區,黎孝里,1362,1361,599,163,762,49,811
公投第７案,臺北市,大安區,黎孝里,1363,1343,577,189,766,56,822
公投第７案,臺北市,大安區,黎孝里,1364,1267,547,156,703,50,753
公投第７案,臺北市,大安區,黎孝里,1365,1380,544,167,711,40,751
公投第７案,臺北市,大安區,黎和里,1366,1524,623,177,800,54,854
公投第７案,臺北市,大安區,黎和里,1367,1470,638,180,818,40,858
公投第７案,臺北市,大安區,黎和里,1368,1318,531,122,653,46,699
公投第７案,臺北市,大安區,建安里,1369,1430,560,163,723,42,765
公投第７案,臺北市,大安區,建安里,1370,1386,569,186,755,42,797
公投第７案,臺北市,大安區,建安里,1371,1438,560,181,741,29,770
公投第７案,臺北市,大安區,建倫里,1372,1270,479,150,629,24,653
公投第７案,臺北市,大安區,建倫里,1373,1395,559,157,716,60,776
公投第７案,臺北市,大安區,建倫里,1374,1292,537,156,693,45,738
公投第７案,臺北市,大安區,建倫里,1375,1310,507,180,687,46,733
公投第７案,臺北市,大安區,敦安里,1376,1319,511,185,696,42,738
公投第７案,臺北市,大安區,敦安里,1377,1355,561,202,763,22,785
公投第７案,臺北市,大安區,敦安里,1378,1312,511,144,655,29,684
公投第７案,臺北市,大安區,敦安里,1379,1335,566,149,715,29,744
公投第７案,臺北市,大安區,正聲里,1380,1489,555,197,752,31,783
公投第７案,臺北市,大安區,正聲里,1381,1307,561,158,719,26,745
公投第７案,臺北市,大安區,正聲里,1382,1328,495,184,679,19,698
公投第７案,臺北市,大安區,敦煌里,1383,1277,499,157,656,11,667
公投第７案,臺北市,大安區,敦煌里,1384,1314,543,166,709,40,749
公投第７案,臺北市,大安區,敦煌里,1385,1270,509,206,715,50,765
公投第７案,臺北市,大安區,敦煌里,1386,1308,518,182,700,58,758
公投第７案,臺北市,大安區,華聲里,1387,1138,497,151,648,26,674
公投第７案,臺北市,大安區,華聲里,1388,1333,565,142,707,31,738
公投第７案,臺北市,大安區,華聲里,1389,1176,481,164,645,42,687
公投第７案,臺北市,大安區,車層里,1390,1311,532,174,706,49,755
公投第７案,臺北市,大安區,車層里,1391,1295,521,173,694,28,722
公投第７案,臺北市,大安區,車層里,1392,1421,605,175,780,48,828
公投第７案,臺北市,大安區,車層里,1393,1409,564,179,743,39,782
公投第７案,臺北市,大安區,光信里,1394,1434,622,179,801,34,835
公投第７案,臺北市,大安區,光信里,1395,1449,552,178,730,52,782
公投第７案,臺北市,大安區,光信里,1396,1284,540,164,704,53,757
公投第７案,臺北市,大安區,光信里,1397,1248,546,143,689,33,722
公投第７案,臺北市,大安區,光信里,1398,1119,532,178,710,29,739
公投第７案,臺北市,大安區,學府里,1399,883,404,97,501,35,536
公投第７案,臺北市,大安區,學府里,1400,630,250,70,320,40,360
公投第７案,臺北市,大安區,學府里,1401,814,327,125,452,32,484
公投第７案,臺北市,文山區,景行里,1402,1539,612,218,830,33,863
公投第７案,臺北市,文山區,景行里,1403,1548,623,153,776,42,818
公投第７案,臺北市,文山區,景行里,1404,1493,621,212,833,68,901
公投第７案,臺北市,文山區,景行里,1405,1648,726,212,938,54,992
公投第７案,臺北市,文山區,景東里,1406,1544,667,175,842,55,897
公投第７案,臺北市,文山區,景東里,1407,1557,698,154,852,57,909
公投第７案,臺北市,文山區,景東里,1408,1514,657,145,802,46,848
公投第７案,臺北市,文山區,景東里,1409,1540,742,180,922,64,986
公投第７案,臺北市,文山區,景美里,1410,1466,681,179,860,48,908
公投第７案,臺北市,文山區,景美里,1411,1444,677,177,854,38,892
公投第７案,臺北市,文山區,景美里,1412,1455,636,189,825,57,882
公投第７案,臺北市,文山區,景慶里,1413,1440,558,191,749,57,806
公投第７案,臺北市,文山區,景慶里,1414,1398,636,169,805,55,860
公投第７案,臺北市,文山區,景慶里,1415,1412,583,154,737,28,765
公投第７案,臺北市,文山區,景慶里,1416,1426,615,164,779,44,823
公投第７案,臺北市,文山區,景仁里,1417,1437,617,186,803,50,853
公投第７案,臺北市,文山區,景仁里,1418,1340,617,150,767,43,810
公投第７案,臺北市,文山區,景仁里,1419,1568,670,183,853,30,883
公投第７案,臺北市,文山區,景華里,1420,1372,592,158,750,27,777
公投第７案,臺北市,文山區,景華里,1421,1046,442,124,566,31,597
公投第７案,臺北市,文山區,景華里,1422,1274,536,154,690,45,735
公投第７案,臺北市,文山區,景華里,1423,1324,569,156,725,36,761
公投第７案,臺北市,文山區,萬有里,1424,1722,715,223,938,50,988
公投第７案,臺北市,文山區,萬有里,1425,1737,781,206,987,58,1045
公投第７案,臺北市,文山區,萬有里,1426,1370,676,150,826,23,849
公投第７案,臺北市,文山區,萬祥里,1427,1495,630,200,830,51,881
公投第７案,臺北市,文山區,萬祥里,1428,1328,588,164,752,49,801
公投第７案,臺北市,文山區,萬祥里,1429,1138,506,145,651,57,708
公投第７案,臺北市,文山區,萬隆里,1430,1471,671,165,836,40,876
公投第７案,臺北市,文山區,萬隆里,1431,1144,529,149,678,35,713
公投第７案,臺北市,文山區,萬隆里,1432,1176,547,160,707,49,756
公投第７案,臺北市,文山區,萬隆里,1433,1212,539,172,711,49,760
公投第７案,臺北市,文山區,萬隆里,1434,1214,570,149,719,31,750
公投第７案,臺北市,文山區,萬年里,1435,1170,465,172,637,38,675
公投第７案,臺北市,文山區,萬年里,1436,1308,551,201,752,46,798
公投第７案,臺北市,文山區,萬年里,1437,1190,522,150,672,53,725
公投第７案,臺北市,文山區,萬年里,1438,1110,487,131,618,48,666
公投第７案,臺北市,文山區,萬和里,1439,1512,653,181,834,57,891
公投第７案,臺北市,文山區,萬和里,1440,1387,684,117,801,59,860
公投第７案,臺北市,文山區,萬盛里,1441,1355,605,155,760,51,811
公投第７案,臺北市,文山區,萬盛里,1442,1370,575,197,772,53,825
公投第７案,臺北市,文山區,萬盛里,1443,1484,636,157,793,64,857
公投第７案,臺北市,文山區,興豐里,1444,1786,772,213,985,58,1043
公投第７案,臺北市,文山區,興豐里,1445,1260,595,125,720,45,765
公投第７案,臺北市,文山區,興豐里,1446,1194,578,171,749,27,776
公投第７案,臺北市,文山區,興邦里,1447,1444,631,189,820,44,864
公投第７案,臺北市,文山區,興邦里,1448,1495,694,153,847,52,899
公投第７案,臺北市,文山區,興邦里,1449,1446,691,137,828,53,881
公投第７案,臺北市,文山區,興光里,1450,1450,625,154,779,78,857
公投第７案,臺北市,文山區,興光里,1451,1486,701,155,856,52,908
公投第７案,臺北市,文山區,興家里,1452,1259,582,151,733,39,772
公投第７案,臺北市,文山區,興家里,1453,1317,626,166,792,19,811
公投第７案,臺北市,文山區,興家里,1454,1321,627,161,788,42,830
公投第７案,臺北市,文山區,興家里,1455,1475,640,168,808,54,862
公投第７案,臺北市,文山區,興家里,1456,1271,546,140,686,48,734
公投第７案,臺北市,文山區,興得里,1457,1609,696,229,925,43,968
公投第７案,臺北市,文山區,興得里,1458,1501,655,145,800,29,829
公投第７案,臺北市,文山區,興得里,1459,997,403,109,512,39,551
公投第７案,臺北市,文山區,興得里,1460,1052,528,121,649,33,682
公投第７案,臺北市,文山區,興業里,1461,1247,594,134,728,36,764
公投第７案,臺北市,文山區,興業里,1462,1167,687,152,839,47,886
公投第７案,臺北市,文山區,興業里,1463,1280,569,170,739,36,775
公投第７案,臺北市,文山區,興業里,1464,1153,555,119,674,38,712
公投第７案,臺北市,文山區,興安里,1465,1557,737,71,808,47,855
公投第７案,臺北市,文山區,興安里,1466,1444,655,153,808,55,863
公投第７案,臺北市,文山區,興安里,1467,1459,734,151,885,51,936
公投第７案,臺北市,文山區,興安里,1468,1357,655,161,816,52,868
公投第７案,臺北市,文山區,興福里,1469,1194,596,157,753,41,794
公投第７案,臺北市,文山區,興福里,1470,1184,576,137,713,52,765
公投第７案,臺北市,文山區,興福里,1471,1119,517,147,664,51,715
公投第７案,臺北市,文山區,興福里,1472,1350,662,154,816,47,863
公投第７案,臺北市,文山區,興旺里,1473,1502,634,159,793,51,844
公投第７案,臺北市,文山區,興旺里,1474,1511,693,159,852,55,907
公投第７案,臺北市,文山區,興旺里,1475,1481,709,183,892,39,931
公投第７案,臺北市,文山區,興旺里,1476,1477,730,164,894,39,933
公投第７案,臺北市,文山區,興旺里,1477,1294,595,155,750,51,801
公投第７案,臺北市,文山區,興泰里,1478,1040,532,146,678,32,710
公投第７案,臺北市,文山區,興泰里,1479,1323,628,161,789,41,830
公投第７案,臺北市,文山區,興泰里,1480,1153,498,160,658,52,710
公投第７案,臺北市,文山區,興昌里,1481,1525,686,162,848,58,906
公投第７案,臺北市,文山區,興昌里,1482,1412,604,145,749,51,800
公投第７案,臺北市,文山區,興昌里,1483,1473,678,200,878,56,934
公投第７案,臺北市,文山區,興昌里,1484,1486,651,201,852,28,880
公投第７案,臺北市,文山區,試院里,1485,1616,793,168,961,53,1014
公投第７案,臺北市,文山區,試院里,1486,1489,708,181,889,57,946
公投第７案,臺北市,文山區,試院里,1487,1414,627,168,795,54,849
公投第７案,臺北市,文山區,試院里,1488,1494,734,177,911,56,967
公投第７案,臺北市,文山區,華興里,1489,1547,720,185,905,50,955
公投第７案,臺北市,文山區,華興里,1490,1587,689,218,907,60,967
公投第７案,臺北市,文山區,華興里,1491,1515,748,185,933,33,966
公投第７案,臺北市,文山區,華興里,1492,1573,725,203,928,57,985
公投第７案,臺北市,文山區,華興里,1493,1542,743,176,919,38,957
公投第７案,臺北市,文山區,明義里,1494,1465,603,147,750,62,812
公投第７案,臺北市,文山區,明義里,1495,699,228,85,313,29,342
公投第７案,臺北市,文山區,明義里,1496,1372,519,133,652,58,710
公投第７案,臺北市,文山區,明興里,1497,1448,563,128,691,59,750
公投第７案,臺北市,文山區,明興里,1498,1548,687,172,859,54,913
公投第７案,臺北市,文山區,明興里,1499,1501,687,171,858,38,896
公投第７案,臺北市,文山區,明興里,1500,1560,733,175,908,40,948
公投第７案,臺北市,文山區,木柵里,1501,1567,688,180,868,40,908
公投第７案,臺北市,文山區,木柵里,1502,1554,705,163,868,48,916
公投第７案,臺北市,文山區,木柵里,1503,1544,693,169,862,54,916
公投第７案,臺北市,文山區,木柵里,1504,1528,726,157,883,48,931
公投第７案,臺北市,文山區,木柵里,1505,1543,742,192,934,34,968
公投第７案,臺北市,文山區,木新里,1506,2754,695,210,905,59,964
公投第７案,臺北市,文山區,木新里,1507,1709,649,175,824,70,894
公投第７案,臺北市,文山區,木新里,1508,1515,630,168,798,72,870
公投第７案,臺北市,文山區,木新里,1509,1571,623,171,794,66,860
公投第７案,臺北市,文山區,木新里,1510,1578,667,175,842,65,907
公投第７案,臺北市,文山區,順興里,1511,1454,591,174,765,58,823
公投第７案,臺北市,文山區,順興里,1512,1436,625,168,793,61,854
公投第７案,臺北市,文山區,順興里,1513,1402,653,169,822,54,876
公投第７案,臺北市,文山區,順興里,1514,1117,517,141,658,42,700
公投第７案,臺北市,文山區,順興里,1515,1094,469,121,590,59,649
公投第７案,臺北市,文山區,忠順里,1516,1070,508,132,640,46,686
公投第７案,臺北市,文山區,忠順里,1517,1319,660,147,807,35,842
公投第７案,臺北市,文山區,忠順里,1518,1226,595,141,736,50,786
公投第７案,臺北市,文山區,樟林里,1519,1385,596,146,742,43,785
公投第７案,臺北市,文山區,樟林里,1520,1416,629,176,805,52,857
公投第７案,臺北市,文山區,樟林里,1521,1412,788,63,851,48,899
公投第７案,臺北市,文山區,樟林里,1522,1535,622,187,809,61,870
公投第７案,臺北市,文山區,樟林里,1523,1654,802,198,1000,49,1049
公投第７案,臺北市,文山區,樟新里,1524,1156,552,126,678,39,717
公投第７案,臺北市,文山區,樟新里,1525,1231,594,134,728,45,773
公投第７案,臺北市,文山區,樟新里,1526,1218,548,132,680,47,727
公投第７案,臺北市,文山區,樟新里,1527,1176,593,132,725,31,756
公投第７案,臺北市,文山區,樟文里,1528,1392,636,181,817,29,846
公投第７案,臺北市,文山區,樟文里,1529,1323,553,148,701,93,794
公投第７案,臺北市,文山區,樟文里,1530,1297,524,166,690,53,743
公投第７案,臺北市,文山區,樟文里,1531,1296,615,138,753,65,818
公投第７案,臺北市,文山區,樟腳里,1532,1613,674,195,869,62,931
公投第７案,臺北市,文山區,樟腳里,1533,1697,749,215,964,63,1027
公投第７案,臺北市,文山區,樟腳里,1534,1579,710,156,866,70,936
公投第７案,臺北市,文山區,樟樹里,1535,1320,629,161,790,46,836
公投第７案,臺北市,文山區,樟樹里,1536,1438,646,145,791,31,822
公投第７案,臺北市,文山區,樟樹里,1537,1465,615,149,764,29,793
公投第７案,臺北市,文山區,萬芳里,1538,1646,690,232,922,65,987
公投第７案,臺北市,文山區,萬芳里,1539,1286,579,157,736,44,780
公投第７案,臺北市,文山區,萬芳里,1540,1219,558,151,709,40,749
公投第７案,臺北市,文山區,萬芳里,1541,1292,586,171,757,46,803
公投第７案,臺北市,文山區,萬芳里,1542,1489,626,163,789,58,847
公投第７案,臺北市,文山區,萬美里,1543,1611,713,206,919,64,983
公投第７案,臺北市,文山區,萬美里,1544,1549,584,76,660,51,711
公投第７案,臺北市,文山區,萬美里,1545,1678,705,170,875,63,938
公投第７案,臺北市,文山區,萬美里,1546,1660,688,190,878,67,945
公投第７案,臺北市,文山區,博嘉里,1547,1816,682,177,859,32,891
公投第７案,臺北市,文山區,博嘉里,1548,985,405,124,529,36,565
公投第７案,臺北市,文山區,博嘉里,1549,1314,662,131,793,26,819
公投第７案,臺北市,文山區,博嘉里,1550,1018,495,134,629,36,665
公投第７案,臺北市,文山區,萬興里,1551,1578,685,202,887,45,932
公投第７案,臺北市,文山區,萬興里,1552,1457,650,183,833,26,859
公投第７案,臺北市,文山區,萬興里,1553,1326,616,150,766,52,818
公投第７案,臺北市,文山區,萬興里,1554,1393,636,164,800,54,854
公投第７案,臺北市,文山區,萬興里,1555,1377,569,158,727,61,788
公投第７案,臺北市,文山區,政大里,1556,1448,646,184,830,39,869
公投第７案,臺北市,文山區,政大里,1557,1447,688,178,866,47,913
公投第７案,臺北市,文山區,政大里,1558,1739,837,233,1070,60,1130
公投第７案,臺北市,文山區,政大里,1559,1457,682,156,838,37,875
公投第７案,臺北市,文山區,指南里,1560,1288,588,159,747,45,792
公投第７案,臺北市,文山區,指南里,1561,1301,504,141,645,69,714
公投第７案,臺北市,文山區,指南里,1562,865,315,106,421,52,473
公投第７案,臺北市,文山區,老泉里,1563,789,297,104,401,38,439
公投第７案,高雄市,桃源區,梅山里,1,264,60,16,76,0,76
公投第７案,高雄市,桃源區,拉芙蘭里,2,233,122,33,155,16,171
公投第７案,高雄市,桃源區,復興里,3,279,143,24,167,7,174
公投第７案,高雄市,桃源區,勤和里,4,223,73,33,106,3,109
公投第７案,高雄市,桃源區,桃源里,5,783,243,55,298,12,310
公投第７案,高雄市,桃源區,高中里,6,632,197,35,232,8,240
公投第７案,高雄市,桃源區,建山里,7,612,319,64,383,32,415
公投第７案,高雄市,桃源區,寶山里,8,472,182,45,227,21,248
公投第７案,高雄市,那瑪夏區,達卡努瓦里,9,741,249,65,314,14,328
公投第７案,高雄市,那瑪夏區,達卡努瓦里,10,585,273,84,357,64,421
公投第７案,高雄市,那瑪夏區,瑪雅里,11,609,339,65,404,60,464
公投第７案,高雄市,那瑪夏區,南沙魯里,12,489,118,40,158,6,164
公投第７案,高雄市,甲仙區,東安里,13,472,124,30,154,7,161
公投第７案,高雄市,甲仙區,西安里,14,882,411,93,504,50,554
公投第７案,高雄市,甲仙區,和安里,15,668,259,57,316,38,354
公投第７案,高雄市,甲仙區,大田里,16,1581,537,146,683,111,794
公投第７案,高雄市,甲仙區,寶隆里,17,673,169,36,205,8,213
公投第７案,高雄市,甲仙區,關山里,18,607,203,41,244,34,278
公投第７案,高雄市,甲仙區,小林里,19,534,190,41,231,12,243
公投第７案,高雄市,六龜區,新威里,20,760,250,93,343,28,371
公投第７案,高雄市,六龜區,新興里,21,666,203,73,276,31,307
公投第７案,高雄市,六龜區,新寮里,22,704,279,78,357,42,399
公投第７案,高雄市,六龜區,新發里,23,1003,354,104,458,51,509
公投第７案,高雄市,六龜區,荖濃里,24,1382,447,109,556,97,653
公投第７案,高雄市,六龜區,六龜里,25,986,277,77,354,68,422
公投第７案,高雄市,六龜區,義寶里,26,1046,371,109,480,45,525
公投第７案,高雄市,六龜區,興龍里,27,812,248,81,329,53,382
公投第７案,高雄市,六龜區,中興里,28,1431,465,130,595,70,665
公投第７案,高雄市,六龜區,寶來里,29,912,342,66,408,69,477
公投第７案,高雄市,六龜區,文武里,30,1472,364,127,491,44,535
公投第７案,高雄市,六龜區,大津里,31,327,92,28,120,23,143
公投第７案,高雄市,杉林區,杉林里,32,640,211,61,272,44,316
公投第７案,高雄市,杉林區,木梓里,33,696,215,55,270,24,294
公投第７案,高雄市,杉林區,集來里,34,1284,302,107,409,38,447
公投第７案,高雄市,杉林區,新庄里,35,1027,289,90,379,57,436
公投第７案,高雄市,杉林區,新庄里,36,482,168,37,205,25,230
公投第７案,高雄市,杉林區,上平里,37,1627,602,186,788,113,901
公投第７案,高雄市,杉林區,月眉里,38,1630,543,135,678,32,710
公投第７案,高雄市,杉林區,大愛里,39,973,242,85,327,20,347
公投第７案,高雄市,杉林區,大愛里,40,987,284,81,365,24,389
公投第７案,高雄市,杉林區,月美里,41,1261,445,144,589,74,663
公投第７案,高雄市,內門區,溝坪里,42,969,303,82,385,55,440
公投第７案,高雄市,內門區,金竹里,43,652,187,43,230,17,247
公投第７案,高雄市,內門區,永富里,44,961,314,115,429,83,512
公投第７案,高雄市,內門區,永吉里,45,426,138,18,156,6,162
公投第７案,高雄市,內門區,永興里,46,398,135,29,164,16,180
公投第７案,高雄市,內門區,石坑里,47,508,165,38,203,16,219
公投第７案,高雄市,內門區,內門里,48,980,399,95,494,78,572
公投第７案,高雄市,內門區,內豊里,49,1225,371,117,488,45,533
公投第７案,高雄市,內門區,觀亭里,50,1722,608,198,806,140,946
公投第７案,高雄市,內門區,中埔里,51,560,172,73,245,30,275
公投第７案,高雄市,內門區,內東里,52,801,227,62,289,21,310
公投第７案,高雄市,內門區,內南里,53,423,149,47,196,19,215
公投第７案,高雄市,內門區,東埔里,54,497,151,52,203,33,236
公投第７案,高雄市,內門區,三平里,55,677,211,73,284,32,316
公投第７案,高雄市,內門區,木柵里,56,593,150,36,186,10,196
公投第７案,高雄市,內門區,內興里,57,597,151,52,203,45,248
公投第７案,高雄市,內門區,瑞山里,58,343,106,23,129,9,138
公投第７案,高雄市,內門區,光興里,59,670,244,80,324,42,366
公投第７案,高雄市,旗山區,太平里,60,1060,487,94,581,52,633
公投第７案,高雄市,旗山區,太平里,61,1125,434,108,542,48,590
公投第７案,高雄市,旗山區,大德里,62,1100,507,112,619,26,645
公投第７案,高雄市,旗山區,大德里,63,1238,552,137,689,23,712
公投第７案,高雄市,旗山區,湄洲里,64,933,413,86,499,23,522
公投第７案,高雄市,旗山區,湄洲里,65,727,261,67,328,16,344
公投第７案,高雄市,旗山區,圓富里,66,1071,439,105,544,51,595
公投第７案,高雄市,旗山區,圓富里,67,744,284,68,352,30,382
公投第７案,高雄市,旗山區,中正里,68,1100,375,110,485,29,514
公投第７案,高雄市,旗山區,中正里,69,369,140,38,178,15,193
公投第７案,高雄市,旗山區,大林里,70,888,278,85,363,10,373
公投第７案,高雄市,旗山區,大林里,71,510,145,50,195,7,202
公投第７案,高雄市,旗山區,上洲里,72,1042,422,139,561,84,645
公投第７案,高雄市,旗山區,新光里,73,791,307,82,389,45,434
公投第７案,高雄市,旗山區,南勝里,74,939,381,109,490,73,563
公投第７案,高雄市,旗山區,南勝里,75,1218,433,129,562,35,597
公投第７案,高雄市,旗山區,中寮里,76,178,51,22,73,22,95
公投第７案,高雄市,旗山區,東平里,77,946,416,116,532,56,588
公投第７案,高雄市,旗山區,東平里,78,1025,372,132,504,32,536
公投第７案,高雄市,旗山區,東昌里,79,1040,453,99,552,74,626
公投第７案,高雄市,旗山區,竹峰里,80,900,400,124,524,50,574
公投第７案,高雄市,旗山區,竹峰里,81,663,245,66,311,20,331
公投第７案,高雄市,旗山區,瑞吉里,82,954,382,90,472,58,530
公投第７案,高雄市,旗山區,瑞吉里,83,1060,409,105,514,35,549
公投第７案,高雄市,旗山區,永和里,84,1110,480,129,609,53,662
公投第７案,高雄市,旗山區,永和里,85,1062,455,129,584,45,629
公投第７案,高雄市,旗山區,永和里,86,1151,473,113,586,36,622
公投第７案,高雄市,旗山區,三協里,87,266,102,35,137,27,164
公投第７案,高雄市,旗山區,三協里,88,633,265,91,356,34,390
公投第７案,高雄市,旗山區,三協里,89,1307,454,139,593,30,623
公投第７案,高雄市,旗山區,鯤洲里,90,754,257,105,362,63,425
公投第７案,高雄市,旗山區,大山里,91,1296,588,50,638,99,737
公投第７案,高雄市,旗山區,中洲里,92,839,270,77,347,19,366
公投第７案,高雄市,旗山區,南洲里,93,1329,535,163,698,51,749
公投第７案,高雄市,旗山區,廣福里,94,628,272,69,341,29,370
公投第７案,高雄市,美濃區,福安里,95,1175,485,134,619,69,688
公投第７案,高雄市,美濃區,福安里,96,1438,519,146,665,26,691
公投第７案,高雄市,美濃區,合和里,97,989,285,78,363,43,406
公投第７案,高雄市,美濃區,合和里,98,1427,595,161,756,66,822
公投第７案,高雄市,美濃區,祿興里,99,1309,547,131,678,61,739
公投第７案,高雄市,美濃區,祿興里,100,1263,534,138,672,93,765
公投第７案,高雄市,美濃區,中壇里,101,997,450,98,548,53,601
公投第７案,高雄市,美濃區,中壇里,102,1064,470,101,571,46,617
公投第７案,高雄市,美濃區,德興里,103,1498,598,142,740,70,810
公投第７案,高雄市,美濃區,龍山里,104,1119,484,105,589,67,656
公投第７案,高雄市,美濃區,龍山里,105,1031,436,105,541,61,602
公投第７案,高雄市,美濃區,獅山里,106,1437,555,146,701,73,774
公投第７案,高雄市,美濃區,獅山里,107,1071,438,117,555,53,608
公投第７案,高雄市,美濃區,龍肚里,108,687,283,63,346,35,381
公投第７案,高雄市,美濃區,龍肚里,109,775,241,63,304,17,321
公投第７案,高雄市,美濃區,廣德里,110,1353,471,157,628,66,694
公投第７案,高雄市,美濃區,興隆里,111,1191,423,110,533,50,583
公投第７案,高雄市,美濃區,中圳里,112,906,311,84,395,33,428
公投第７案,高雄市,美濃區,中圳里,113,1178,534,122,656,35,691
公投第７案,高雄市,美濃區,東門里,114,1252,455,104,559,27,586
公投第７案,高雄市,美濃區,泰安里,115,1549,656,163,819,52,871
公投第７案,高雄市,美濃區,瀰濃里,116,1088,419,86,505,44,549
公投第７案,高雄市,美濃區,瀰濃里,117,1116,463,128,591,44,635
公投第７案,高雄市,美濃區,清水里,118,977,382,115,497,30,527
公投第７案,高雄市,美濃區,清水里,119,816,350,100,450,60,510
公投第７案,高雄市,美濃區,吉洋里,120,955,341,61,402,28,430
公投第７案,高雄市,美濃區,吉洋里,121,943,394,99,493,56,549
公投第７案,高雄市,美濃區,吉和里,122,1371,519,142,661,39,700
公投第７案,高雄市,美濃區,吉東里,123,919,331,119,450,62,512
公投第７案,高雄市,美濃區,吉東里,124,915,390,126,516,46,562
公投第７案,高雄市,美濃區,廣林里,125,828,316,82,398,58,456
公投第７案,高雄市,美濃區,廣林里,126,674,201,62,263,54,317
公投第７案,高雄市,茂林區,多納里,127,507,265,59,324,32,356
公投第７案,高雄市,茂林區,萬山里,128,382,200,39,239,19,258
公投第７案,高雄市,茂林區,茂林里,129,726,344,68,412,28,440
公投第７案,高雄市,茄萣區,福德里,130,976,310,91,401,22,423
公投第７案,高雄市,茄萣區,萬福里,131,887,311,114,425,59,484
公投第７案,高雄市,茄萣區,白雲里,132,1710,625,184,809,30,839
公投第７案,高雄市,茄萣區,嘉賜里,133,1280,398,119,517,44,561
公投第７案,高雄市,茄萣區,嘉賜里,134,1314,513,171,684,30,714
公投第７案,高雄市,茄萣區,嘉賜里,135,1157,506,150,656,17,673
公投第７案,高雄市,茄萣區,嘉安里,136,1785,652,211,863,118,981
公投第７案,高雄市,茄萣區,嘉樂里,137,838,282,109,391,92,483
公投第７案,高雄市,茄萣區,嘉樂里,138,1249,536,173,709,84,793
公投第７案,高雄市,茄萣區,嘉泰里,139,1116,394,116,510,98,608
公投第７案,高雄市,茄萣區,嘉福里,140,978,327,94,421,51,472
公投第７案,高雄市,茄萣區,和協里,141,1125,335,113,448,46,494
公投第７案,高雄市,茄萣區,嘉定里,142,1139,384,153,537,82,619
公投第７案,高雄市,茄萣區,保定里,143,1363,508,149,657,107,764
公投第７案,高雄市,茄萣區,保定里,144,1598,607,216,823,103,926
公投第７案,高雄市,茄萣區,大定里,145,1111,407,124,531,68,599
公投第７案,高雄市,茄萣區,光定里,146,925,272,93,365,49,414
公投第７案,高雄市,茄萣區,吉定里,147,1148,417,133,550,65,615
公投第７案,高雄市,茄萣區,崎漏里,148,1353,453,156,609,49,658
公投第７案,高雄市,茄萣區,崎漏里,149,1331,495,160,655,64,719
公投第７案,高雄市,茄萣區,崎漏里,150,1829,629,190,819,66,885
公投第７案,高雄市,湖內區,海山里,151,1112,388,122,510,38,548
公投第７案,高雄市,湖內區,劉家里,152,1017,392,103,495,82,577
公投第７案,高雄市,湖內區,太爺里,153,796,285,90,375,29,404
公投第７案,高雄市,湖內區,公舘里,154,1079,484,129,613,32,645
公投第７案,高雄市,湖內區,公舘里,155,1115,441,145,586,26,612
公投第７案,高雄市,湖內區,葉厝里,156,1311,507,134,641,39,680
公投第７案,高雄市,湖內區,葉厝里,157,1319,508,133,641,34,675
公投第７案,高雄市,湖內區,大湖里,158,1244,559,155,714,70,784
公投第７案,高雄市,湖內區,大湖里,159,1227,553,162,715,50,765
公投第７案,高雄市,湖內區,大湖里,160,1163,527,118,645,64,709
公投第７案,高雄市,湖內區,田尾里,161,981,432,125,557,32,589
公投第７案,高雄市,湖內區,湖內里,162,780,304,72,376,16,392
公投第７案,高雄市,湖內區,湖內里,163,832,339,83,422,52,474
公投第７案,高雄市,湖內區,湖內里,164,1017,460,139,599,36,635
公投第７案,高雄市,湖內區,湖內里,165,1051,457,114,571,21,592
公投第７案,高雄市,湖內區,海埔里,166,941,354,100,454,31,485
公投第７案,高雄市,湖內區,海埔里,167,863,322,101,423,53,476
公投第７案,高雄市,湖內區,文賢里,168,1160,455,121,576,52,628
公投第７案,高雄市,湖內區,中賢里,169,1090,337,94,431,23,454
公投第７案,高雄市,湖內區,中賢里,170,1122,436,152,588,56,644
公投第７案,高雄市,湖內區,逸賢里,171,1123,390,83,473,28,501
公投第７案,高雄市,湖內區,忠興里,172,684,261,69,330,27,357
公投第７案,高雄市,湖內區,湖東里,173,1249,458,120,578,27,605
公投第７案,高雄市,湖內區,湖東里,174,1453,461,127,588,49,637
公投第７案,高雄市,路竹區,竹滬里,175,1026,393,96,489,29,518
公投第７案,高雄市,路竹區,竹滬里,176,1069,431,126,557,70,627
公投第７案,高雄市,路竹區,竹滬里,177,1127,472,148,620,69,689
公投第７案,高雄市,路竹區,頂寮里,178,1179,465,124,589,75,664
公投第７案,高雄市,路竹區,新達里,179,1237,464,150,614,88,702
公投第７案,高雄市,路竹區,後鄉里,180,1096,461,130,591,65,656
公投第７案,高雄市,路竹區,北嶺里,181,1272,570,155,725,72,797
公投第７案,高雄市,路竹區,社西里,182,1182,494,143,637,57,694
公投第７案,高雄市,路竹區,社西里,183,1127,489,116,605,48,653
公投第７案,高雄市,路竹區,甲北里,184,956,409,118,527,44,571
公投第７案,高雄市,路竹區,甲北里,185,1132,469,144,613,50,663
公投第７案,高雄市,路竹區,甲南里,186,1025,476,104,580,75,655
公投第７案,高雄市,路竹區,甲南里,187,1007,398,96,494,28,522
公投第７案,高雄市,路竹區,甲南里,188,1301,513,119,632,61,693
公投第７案,高雄市,路竹區,下坑里,189,885,381,90,471,34,505
公投第７案,高雄市,路竹區,下坑里,190,837,272,101,373,18,391
公投第７案,高雄市,路竹區,下坑里,191,930,400,105,505,60,565
公投第７案,高雄市,路竹區,竹園里,192,781,280,75,355,47,402
公投第７案,高雄市,路竹區,竹園里,193,1023,412,132,544,63,607
公投第７案,高雄市,路竹區,竹東里,194,1763,770,185,955,78,1033
公投第７案,高雄市,路竹區,竹東里,195,1637,626,222,848,56,904
公投第７案,高雄市,路竹區,竹西里,196,1070,414,136,550,37,587
公投第７案,高雄市,路竹區,竹西里,197,1177,502,134,636,72,708
公投第７案,高雄市,路竹區,文北里,198,1007,389,165,554,38,592
公投第７案,高雄市,路竹區,文北里,199,1026,432,124,556,30,586
公投第７案,高雄市,路竹區,文北里,200,1017,427,118,545,35,580
公投第７案,高雄市,路竹區,文南里,201,1264,529,151,680,53,733
公投第７案,高雄市,路竹區,文南里,202,1089,496,121,617,44,661
公投第７案,高雄市,路竹區,三爺里,203,851,340,110,450,41,491
公投第７案,高雄市,路竹區,鴨寮里,204,1011,441,138,579,43,622
公投第７案,高雄市,路竹區,鴨寮里,205,937,437,138,575,29,604
公投第７案,高雄市,路竹區,社東里,206,820,276,88,364,14,378
公投第７案,高雄市,路竹區,社東里,207,910,439,114,553,27,580
公投第７案,高雄市,路竹區,社中里,208,867,334,111,445,48,493
公投第７案,高雄市,路竹區,竹南里,209,937,386,108,494,33,527
公投第７案,高雄市,路竹區,竹南里,210,900,385,104,489,23,512
公投第７案,高雄市,路竹區,竹南里,211,900,388,108,496,56,552
公投第７案,高雄市,路竹區,社南里,212,918,430,81,511,35,546
公投第７案,高雄市,路竹區,社南里,213,870,403,114,517,41,558
公投第７案,高雄市,路竹區,社南里,214,1150,525,148,673,48,721
公投第７案,高雄市,路竹區,社南里,215,1537,743,175,918,63,981
公投第７案,高雄市,阿蓮區,石安里,216,1299,406,150,556,41,597
公投第７案,高雄市,阿蓮區,中路里,217,1107,420,117,537,41,578
公投第７案,高雄市,阿蓮區,中路里,218,898,312,94,406,31,437
公投第７案,高雄市,阿蓮區,峯山里,219,1259,452,142,594,80,674
公投第７案,高雄市,阿蓮區,港後里,220,1579,608,148,756,47,803
公投第７案,高雄市,阿蓮區,港後里,221,564,242,68,310,5,315
公投第７案,高雄市,阿蓮區,崗山里,222,768,354,97,451,45,496
公投第７案,高雄市,阿蓮區,阿蓮里,223,1092,477,115,592,43,635
公投第７案,高雄市,阿蓮區,阿蓮里,224,1099,429,139,568,55,623
公投第７案,高雄市,阿蓮區,阿蓮里,225,1134,488,107,595,24,619
公投第７案,高雄市,阿蓮區,阿蓮里,226,1561,575,170,745,28,773
公投第７案,高雄市,阿蓮區,清蓮里,227,1533,603,214,817,82,899
公投第７案,高雄市,阿蓮區,清蓮里,228,1116,410,117,527,26,553
公投第７案,高雄市,阿蓮區,和蓮里,229,1054,397,113,510,38,548
公投第７案,高雄市,阿蓮區,和蓮里,230,1260,492,131,623,58,681
公投第７案,高雄市,阿蓮區,青旗里,231,1504,583,137,720,72,792
公投第７案,高雄市,阿蓮區,復安里,232,848,299,79,378,16,394
公投第７案,高雄市,阿蓮區,復安里,233,823,327,76,403,21,424
公投第７案,高雄市,阿蓮區,玉庫里,234,1021,424,99,523,30,553
公投第７案,高雄市,阿蓮區,南蓮里,235,1715,643,152,795,39,834
公投第７案,高雄市,阿蓮區,南蓮里,236,1300,485,149,634,49,683
公投第７案,高雄市,田寮區,鹿埔里,237,369,111,25,136,5,141
公投第７案,高雄市,田寮區,南安里,238,656,193,55,248,21,269
公投第７案,高雄市,田寮區,南安里,239,406,89,17,106,10,116
公投第７案,高雄市,田寮區,大同里,240,380,125,46,171,17,188
公投第７案,高雄市,田寮區,田寮里,241,379,136,37,173,19,192
公投第７案,高雄市,田寮區,七星里,242,625,224,69,293,56,349
公投第７案,高雄市,田寮區,崇德里,243,946,335,77,412,20,432
公投第７案,高雄市,田寮區,西德里,244,794,250,74,324,50,374
公投第７案,高雄市,田寮區,三和里,245,382,111,35,146,22,168
公投第７案,高雄市,田寮區,古亭里,246,513,110,49,159,40,199
公投第７案,高雄市,田寮區,新興里,247,601,200,70,270,21,291
公投第７案,高雄市,田寮區,新興里,248,620,235,67,302,59,361
公投第７案,高雄市,永安區,永安里,249,756,370,90,460,38,498
公投第７案,高雄市,永安區,永安里,250,818,330,111,441,71,512
公投第７案,高雄市,永安區,永華里,251,866,424,126,550,45,595
公投第７案,高雄市,永安區,永華里,252,951,414,135,549,64,613
公投第７案,高雄市,永安區,新港里,253,992,421,137,558,64,622
公投第７案,高雄市,永安區,新港里,254,682,218,70,288,19,307
公投第７案,高雄市,永安區,新港里,255,665,281,76,357,23,380
公投第７案,高雄市,永安區,鹽田里,256,371,141,46,187,16,203
公投第７案,高雄市,永安區,保寧里,257,1114,509,151,660,68,728
公投第７案,高雄市,永安區,保寧里,258,1418,651,186,837,39,876
公投第７案,高雄市,永安區,維新里,259,1477,687,202,889,76,965
公投第７案,高雄市,永安區,維新里,260,1891,869,235,1104,83,1187
公投第７案,高雄市,岡山區,岡山里,261,1345,671,158,829,44,873
公投第７案,高雄市,岡山區,岡山里,262,1045,334,109,443,21,464
公投第７案,高雄市,岡山區,岡山里,263,1051,494,99,593,46,639
公投第７案,高雄市,岡山區,岡山里,264,917,426,96,522,19,541
公投第７案,高雄市,岡山區,壽天里,265,934,435,133,568,34,602
公投第７案,高雄市,岡山區,壽天里,266,1097,501,134,635,53,688
公投第７案,高雄市,岡山區,壽天里,267,1208,617,144,761,41,802
公投第７案,高雄市,岡山區,平安里,268,1159,521,168,689,75,764
公投第７案,高雄市,岡山區,維仁里,269,1018,436,133,569,54,623
公投第７案,高雄市,岡山區,大遼里,270,1316,480,132,612,39,651
公投第７案,高雄市,岡山區,程香里,271,1345,607,138,745,32,777
公投第７案,高雄市,岡山區,程香里,272,1295,588,169,757,49,806
公投第７案,高雄市,岡山區,程香里,273,1425,624,160,784,57,841
公投第７案,高雄市,岡山區,後紅里,274,1328,551,116,667,41,708
公投第７案,高雄市,岡山區,後紅里,275,1382,619,155,774,25,799
公投第７案,高雄市,岡山區,後紅里,276,1381,673,132,805,23,828
公投第７案,高雄市,岡山區,碧紅里,277,1282,546,145,691,72,763
公投第７案,高雄市,岡山區,碧紅里,278,1240,511,156,667,22,689
公投第７案,高雄市,岡山區,碧紅里,279,1327,617,117,734,60,794
公投第７案,高雄市,岡山區,竹圍里,280,1736,751,157,908,55,963
公投第７案,高雄市,岡山區,竹圍里,281,1566,680,201,881,69,950
公投第７案,高雄市,岡山區,竹圍里,282,1779,776,156,932,29,961
公投第７案,高雄市,岡山區,竹圍里,283,1593,737,189,926,64,990
公投第７案,高雄市,岡山區,台上里,284,1480,680,176,856,61,917
公投第７案,高雄市,岡山區,台上里,285,1364,611,164,775,35,810
公投第７案,高雄市,岡山區,台上里,286,1410,641,175,816,47,863
公投第７案,高雄市,岡山區,台上里,287,1148,560,167,727,61,788
公投第７案,高雄市,岡山區,為隨里,288,625,273,85,358,47,405
公投第７案,高雄市,岡山區,灣裡里,289,969,454,102,556,39,595
公投第７案,高雄市,岡山區,灣裡里,290,861,393,117,510,17,527
公投第７案,高雄市,岡山區,本洲里,291,823,330,83,413,17,430
公投第７案,高雄市,岡山區,本洲里,292,889,407,130,537,58,595
公投第７案,高雄市,岡山區,前峰里,293,1283,565,155,720,56,776
公投第７案,高雄市,岡山區,前峰里,294,1512,638,143,781,44,825
公投第７案,高雄市,岡山區,壽峰里,295,983,477,137,614,58,672
公投第７案,高雄市,岡山區,壽峰里,296,1262,567,134,701,49,750
公投第７案,高雄市,岡山區,仁壽里,297,1096,481,137,618,60,678
公投第７案,高雄市,岡山區,仁壽里,298,1066,477,127,604,43,647
公投第７案,高雄市,岡山區,仁壽里,299,1188,516,111,627,38,665
公投第７案,高雄市,岡山區,後協里,300,1360,622,160,782,59,841
公投第７案,高雄市,岡山區,後協里,301,1363,632,162,794,33,827
公投第７案,高雄市,岡山區,後協里,302,1352,656,163,819,56,875
公投第７案,高雄市,岡山區,後協里,303,1460,649,160,809,60,869
公投第７案,高雄市,岡山區,協和里,304,1272,582,145,727,50,777
公投第７案,高雄市,岡山區,協和里,305,1080,520,130,650,49,699
公投第７案,高雄市,岡山區,協和里,306,1255,553,152,705,74,779
公投第７案,高雄市,岡山區,協榮里,307,938,456,124,580,49,629
公投第７案,高雄市,岡山區,協榮里,308,1237,613,134,747,47,794
公投第７案,高雄市,岡山區,劉厝里,309,1413,516,156,672,33,705
公投第７案,高雄市,岡山區,白米里,310,765,321,96,417,18,435
公投第７案,高雄市,岡山區,白米里,311,1043,501,142,643,34,677
公投第７案,高雄市,岡山區,石潭里,312,844,329,68,397,30,427
公投第７案,高雄市,岡山區,石潭里,313,993,532,163,695,33,728
公投第７案,高雄市,岡山區,福興里,314,1038,471,129,600,70,670
公投第７案,高雄市,岡山區,嘉興里,315,1070,446,143,589,69,658
公投第７案,高雄市,岡山區,嘉興里,316,1023,571,40,611,70,681
公投第７案,高雄市,岡山區,嘉興里,317,1349,571,164,735,30,765
公投第７案,高雄市,岡山區,嘉峰里,318,1452,591,155,746,41,787
公投第７案,高雄市,岡山區,嘉峰里,319,301,142,48,190,14,204
公投第７案,高雄市,岡山區,潭底里,320,756,330,102,432,80,512
公投第７案,高雄市,岡山區,華崗里,321,733,255,78,333,14,347
公投第７案,高雄市,岡山區,華崗里,322,854,409,110,519,72,591
公投第７案,高雄市,岡山區,三和里,323,866,289,69,358,19,377
公投第７案,高雄市,岡山區,大莊里,324,978,396,109,505,59,564
公投第７案,高雄市,岡山區,忠孝里,325,1336,679,104,783,36,819
公投第７案,高雄市,岡山區,忠孝里,326,1218,672,71,743,19,762
公投第７案,高雄市,岡山區,忠孝里,327,341,187,54,241,17,258
公投第７案,高雄市,岡山區,仁義里,328,955,635,53,688,26,714
公投第７案,高雄市,岡山區,仁義里,329,940,573,58,631,18,649
公投第７案,高雄市,岡山區,信義里,330,851,421,111,532,43,575
公投第７案,高雄市,岡山區,信義里,331,762,446,65,511,23,534
公投第７案,高雄市,岡山區,和平里,332,318,177,51,228,13,241
公投第７案,高雄市,燕巢區,尖山里,333,1152,465,115,580,76,656
公投第７案,高雄市,燕巢區,瓊林里,334,1120,478,133,611,22,633
公投第７案,高雄市,燕巢區,瓊林里,335,974,448,136,584,56,640
公投第７案,高雄市,燕巢區,安招里,336,1019,398,115,513,20,533
公投第７案,高雄市,燕巢區,安招里,337,1058,393,131,524,72,596
公投第７案,高雄市,燕巢區,安招里,338,1017,312,83,395,35,430
公投第７案,高雄市,燕巢區,安招里,339,259,35,5,40,1,41
公投第７案,高雄市,燕巢區,角宿里,340,926,456,96,552,62,614
公投第７案,高雄市,燕巢區,角宿里,341,624,236,54,290,19,309
公投第７案,高雄市,燕巢區,角宿里,342,1102,518,140,658,59,717
公投第７案,高雄市,燕巢區,鳳雄里,343,1072,426,107,533,45,578
公投第７案,高雄市,燕巢區,鳳雄里,344,1361,552,162,714,59,773
公投第７案,高雄市,燕巢區,金山里,345,472,212,43,255,32,287
公投第７案,高雄市,燕巢區,東燕里,346,1197,445,130,575,53,628
公投第７案,高雄市,燕巢區,東燕里,347,1134,522,136,658,81,739
公投第７案,高雄市,燕巢區,南燕里,348,1148,439,124,563,42,605
公投第７案,高雄市,燕巢區,南燕里,349,1207,495,95,590,65,655
公投第７案,高雄市,燕巢區,南燕里,350,1402,667,165,832,42,874
公投第７案,高雄市,燕巢區,西燕里,351,1000,422,114,536,71,607
公投第７案,高雄市,燕巢區,西燕里,352,1110,487,125,612,69,681
公投第７案,高雄市,燕巢區,西燕里,353,1291,560,122,682,60,742
公投第７案,高雄市,燕巢區,橫山里,354,797,318,92,410,76,486
公投第７案,高雄市,燕巢區,橫山里,355,1098,394,116,510,56,566
公投第７案,高雄市,燕巢區,深水里,356,1393,538,146,684,67,751
公投第７案,高雄市,燕巢區,深水里,357,1079,367,74,441,19,460
公投第７案,高雄市,彌陀區,光和里,358,1246,504,166,670,78,748
公投第７案,高雄市,彌陀區,彌靖里,359,885,366,121,487,60,547
公投第７案,高雄市,彌陀區,彌靖里,360,955,440,142,582,64,646
公投第７案,高雄市,彌陀區,彌仁里,361,534,199,71,270,44,314
公投第７案,高雄市,彌陀區,彌壽里,362,738,320,95,415,30,445
公投第７案,高雄市,彌陀區,彌陀里,363,855,425,108,533,42,575
公投第７案,高雄市,彌陀區,彌陀里,364,877,400,53,453,104,557
公投第７案,高雄市,彌陀區,舊港里,365,781,339,92,431,72,503
公投第７案,高雄市,彌陀區,舊港里,366,808,328,102,430,33,463
公投第７案,高雄市,彌陀區,文安里,367,904,326,93,419,35,454
公投第７案,高雄市,彌陀區,文安里,368,825,344,98,442,57,499
公投第７案,高雄市,彌陀區,過港里,369,941,334,111,445,73,518
公投第７案,高雄市,彌陀區,鹽埕里,370,1013,414,119,533,36,569
公投第７案,高雄市,彌陀區,鹽埕里,371,1024,464,114,578,64,642
公投第７案,高雄市,彌陀區,海尾里,372,861,348,65,413,22,435
公投第７案,高雄市,彌陀區,漯底里,373,1163,503,150,653,72,725
公投第７案,高雄市,彌陀區,南寮里,374,1216,552,147,699,91,790
公投第７案,高雄市,彌陀區,南寮里,375,861,421,118,539,83,622
公投第７案,高雄市,梓官區,梓信里,376,1061,402,204,606,68,674
公投第７案,高雄市,梓官區,梓信里,377,1063,438,127,565,71,636
公投第７案,高雄市,梓官區,梓義里,378,969,389,120,509,33,542
公投第７案,高雄市,梓官區,梓義里,379,1078,390,127,517,21,538
公投第７案,高雄市,梓官區,梓和里,380,838,341,117,458,62,520
公投第７案,高雄市,梓官區,梓和里,381,611,270,86,356,23,379
公投第７案,高雄市,梓官區,梓和里,382,782,322,82,404,32,436
公投第７案,高雄市,梓官區,梓平里,383,1451,671,186,857,86,943
公投第７案,高雄市,梓官區,中崙里,384,1144,426,149,575,27,602
公投第７案,高雄市,梓官區,同安里,385,975,353,108,461,14,475
公投第７案,高雄市,梓官區,大舍里,386,1317,538,148,686,48,734
公投第７案,高雄市,梓官區,大舍里,387,1218,522,154,676,77,753
公投第７案,高雄市,梓官區,大舍里,388,1073,459,125,584,35,619
公投第７案,高雄市,梓官區,赤崁里,389,1112,403,87,490,82,572
公投第７案,高雄市,梓官區,赤崁里,390,715,269,93,362,37,399
公投第７案,高雄市,梓官區,赤東里,391,1311,602,38,640,54,694
公投第７案,高雄市,梓官區,赤東里,392,939,363,111,474,32,506
公投第７案,高雄市,梓官區,赤西里,393,824,377,101,478,37,515
公投第７案,高雄市,梓官區,禮蚵里,394,1052,538,53,591,104,695
公投第７案,高雄市,梓官區,禮蚵里,395,1020,433,112,545,101,646
公投第７案,高雄市,梓官區,智蚵里,396,1260,471,137,608,37,645
公投第７案,高雄市,梓官區,智蚵里,397,1595,635,171,806,46,852
公投第７案,高雄市,梓官區,信蚵里,398,829,364,96,460,35,495
公投第７案,高雄市,梓官區,信蚵里,399,1532,616,149,765,30,795
公投第７案,高雄市,梓官區,茄苳里,400,1195,527,158,685,74,759
公投第７案,高雄市,梓官區,茄苳里,401,1143,491,137,628,79,707
公投第７案,高雄市,梓官區,典寶里,402,1186,523,150,673,61,734
公投第７案,高雄市,梓官區,典寶里,403,1732,627,134,761,42,803
公投第７案,高雄市,橋頭區,橋頭里,404,1005,458,141,599,69,668
公投第７案,高雄市,橋頭區,橋頭里,405,1073,478,149,627,51,678
公投第７案,高雄市,橋頭區,橋南里,406,1129,479,129,608,37,645
公投第７案,高雄市,橋頭區,仕隆里,407,1244,536,167,703,78,781
公投第７案,高雄市,橋頭區,仕隆里,408,1091,457,125,582,37,619
公投第７案,高雄市,橋頭區,仕豐里,409,1329,647,160,807,52,859
公投第７案,高雄市,橋頭區,仕豐里,410,1140,499,166,665,42,707
公投第７案,高雄市,橋頭區,芋寮里,411,1220,503,180,683,72,755
公投第７案,高雄市,橋頭區,東林里,412,1047,493,158,651,59,710
公投第７案,高雄市,橋頭區,東林里,413,1315,520,168,688,96,784
公投第７案,高雄市,橋頭區,西林里,414,691,261,91,352,34,386
公投第７案,高雄市,橋頭區,西林里,415,720,310,102,412,65,477
公投第７案,高雄市,橋頭區,白樹里,416,1192,521,157,678,67,745
公投第７案,高雄市,橋頭區,白樹里,417,1318,599,184,783,53,836
公投第７案,高雄市,橋頭區,白樹里,418,761,359,85,444,47,491
公投第７案,高雄市,橋頭區,筆秀里,419,973,421,111,532,24,556
公投第７案,高雄市,橋頭區,筆秀里,420,587,262,70,332,30,362
公投第７案,高雄市,橋頭區,新莊里,421,812,364,120,484,43,527
公投第７案,高雄市,橋頭區,新莊里,422,343,150,51,201,13,214
公投第７案,高雄市,橋頭區,新莊里,423,1266,640,141,781,30,811
公投第７案,高雄市,橋頭區,甲北里,424,1128,515,138,653,86,739
公投第７案,高雄市,橋頭區,甲北里,425,884,401,101,502,61,563
公投第７案,高雄市,橋頭區,甲南里,426,1187,498,122,620,70,690
公投第７案,高雄市,橋頭區,甲南里,427,1259,549,155,704,74,778
公投第７案,高雄市,橋頭區,頂鹽里,428,1361,524,153,677,74,751
公投第７案,高雄市,橋頭區,中崎里,429,671,249,74,323,29,352
公投第７案,高雄市,橋頭區,仕和里,430,1215,549,158,707,69,776
公投第７案,高雄市,橋頭區,仕和里,431,1255,511,192,703,102,805
公投第７案,高雄市,橋頭區,仕和里,432,1219,574,158,732,58,790
公投第７案,高雄市,橋頭區,德松里,433,1372,562,150,712,36,748
公投第７案,高雄市,橋頭區,三德里,434,758,223,67,290,11,301
公投第７案,高雄市,楠梓區,清豐里,435,1309,616,157,773,48,821
公投第７案,高雄市,楠梓區,清豐里,436,1408,611,178,789,34,823
公投第７案,高雄市,楠梓區,清豐里,437,1851,808,227,1035,60,1095
公投第７案,高雄市,楠梓區,清豐里,438,1578,687,224,911,67,978
公投第７案,高雄市,楠梓區,清豐里,439,1715,745,189,934,38,972
公投第７案,高雄市,楠梓區,清豐里,440,1611,680,172,852,35,887
公投第７案,高雄市,楠梓區,清豐里,441,2024,856,180,1036,73,1109
公投第７案,高雄市,楠梓區,清豐里,442,1890,761,199,960,43,1003
公投第７案,高雄市,楠梓區,清豐里,443,1762,671,183,854,31,885
公投第７案,高雄市,楠梓區,清豐里,444,1888,757,212,969,69,1038
公投第７案,高雄市,楠梓區,清豐里,445,1822,760,196,956,79,1035
公投第７案,高雄市,楠梓區,清豐里,446,1846,748,223,971,70,1041
公投第７案,高雄市,楠梓區,東寧里,447,1268,570,142,712,75,787
公投第７案,高雄市,楠梓區,東寧里,448,1240,592,158,750,54,804
公投第７案,高雄市,楠梓區,東寧里,449,1432,649,199,848,33,881
公投第７案,高雄市,楠梓區,五常里,450,1490,656,142,798,61,859
公投第７案,高雄市,楠梓區,五常里,451,1464,700,160,860,61,921
公投第７案,高雄市,楠梓區,五常里,452,1435,558,181,739,79,818
公投第７案,高雄市,楠梓區,五常里,453,1602,641,173,814,82,896
公投第７案,高雄市,楠梓區,享平里,454,1500,613,171,784,52,836
公投第７案,高雄市,楠梓區,享平里,455,1591,631,192,823,107,930
公投第７案,高雄市,楠梓區,惠楠里,456,1669,440,159,599,59,658
公投第７案,高雄市,楠梓區,惠楠里,457,1469,643,194,837,61,898
公投第７案,高雄市,楠梓區,中陽里,458,1559,631,169,800,88,888
公投第７案,高雄市,楠梓區,中陽里,459,1638,638,202,840,91,931
公投第７案,高雄市,楠梓區,惠民里,460,1960,842,228,1070,82,1152
公投第７案,高雄市,楠梓區,惠民里,461,1912,787,232,1019,128,1147
公投第７案,高雄市,楠梓區,惠豐里,462,1559,678,158,836,63,899
公投第７案,高雄市,楠梓區,惠豐里,463,1423,610,143,753,51,804
公投第７案,高雄市,楠梓區,惠豐里,464,1696,754,197,951,13,964
公投第７案,高雄市,楠梓區,錦屏里,465,1493,528,198,726,160,886
公投第７案,高雄市,楠梓區,錦屏里,466,1527,624,206,830,90,920
公投第７案,高雄市,楠梓區,玉屏里,467,1020,403,159,562,86,648
公投第７案,高雄市,楠梓區,玉屏里,468,1197,469,155,624,80,704
公投第７案,高雄市,楠梓區,金田里,469,1528,519,224,743,89,832
公投第７案,高雄市,楠梓區,金田里,470,1918,647,228,875,110,985
公投第７案,高雄市,楠梓區,稔田里,471,1458,551,172,723,100,823
公投第７案,高雄市,楠梓區,瑞屏里,472,1790,763,232,995,106,1101
公投第７案,高雄市,楠梓區,瑞屏里,473,1845,834,220,1054,85,1139
公投第７案,高雄市,楠梓區,翠屏里,474,2037,922,196,1118,77,1195
公投第７案,高雄市,楠梓區,翠屏里,475,1964,868,180,1048,60,1108
公投第７案,高雄市,楠梓區,翠屏里,476,2006,874,201,1075,35,1110
公投第７案,高雄市,楠梓區,翠屏里,477,1951,835,207,1042,64,1106
公投第７案,高雄市,楠梓區,翠屏里,478,1951,819,193,1012,71,1083
公投第７案,高雄市,楠梓區,翠屏里,479,2008,921,198,1119,74,1193
公投第７案,高雄市,楠梓區,翠屏里,480,1923,884,196,1080,85,1165
公投第７案,高雄市,楠梓區,翠屏里,481,1921,895,197,1092,53,1145
公投第７案,高雄市,楠梓區,宏南里,482,832,414,131,545,40,585
公投第７案,高雄市,楠梓區,宏毅里,483,1156,451,187,638,53,691
公投第７案,高雄市,楠梓區,宏毅里,484,1125,441,179,620,63,683
公投第７案,高雄市,楠梓區,宏榮里,485,1060,456,159,615,60,675
公投第７案,高雄市,楠梓區,宏榮里,486,1502,676,171,847,71,918
公投第７案,高雄市,楠梓區,廣昌里,487,1404,568,197,765,93,858
公投第７案,高雄市,楠梓區,廣昌里,488,1552,588,169,757,70,827
公投第７案,高雄市,楠梓區,久昌里,489,1460,529,182,711,71,782
公投第７案,高雄市,楠梓區,久昌里,490,1315,533,127,660,61,721
公投第７案,高雄市,楠梓區,大昌里,491,1062,464,136,600,69,669
公投第７案,高雄市,楠梓區,大昌里,492,1078,483,110,593,67,660
公投第７案,高雄市,楠梓區,福昌里,493,914,407,118,525,87,612
公投第７案,高雄市,楠梓區,福昌里,494,1064,478,137,615,94,709
公投第７案,高雄市,楠梓區,盛昌里,495,1705,728,222,950,91,1041
公投第７案,高雄市,楠梓區,盛昌里,496,1728,819,160,979,68,1047
公投第７案,高雄市,楠梓區,盛昌里,497,1917,904,181,1085,73,1158
公投第７案,高雄市,楠梓區,泰昌里,498,1439,568,149,717,99,816
公投第７案,高雄市,楠梓區,興昌里,499,1287,594,117,711,77,788
公投第７案,高雄市,楠梓區,興昌里,500,1504,705,167,872,77,949
公投第７案,高雄市,楠梓區,興昌里,501,1405,695,152,847,76,923
公投第７案,高雄市,楠梓區,建昌里,502,1287,641,65,706,80,786
公投第７案,高雄市,楠梓區,建昌里,503,1295,585,167,752,57,809
公投第７案,高雄市,楠梓區,宏昌里,504,1483,676,199,875,58,933
公投第７案,高雄市,楠梓區,宏昌里,505,1649,818,201,1019,74,1093
公投第７案,高雄市,楠梓區,和昌里,506,998,469,103,572,78,650
公投第７案,高雄市,楠梓區,和昌里,507,1025,476,124,600,69,669
公投第７案,高雄市,楠梓區,慶昌里,508,1671,810,208,1018,80,1098
公投第７案,高雄市,楠梓區,慶昌里,509,1453,653,201,854,102,956
公投第７案,高雄市,楠梓區,隆昌里,510,1673,721,187,908,92,1000
公投第７案,高雄市,楠梓區,隆昌里,511,1653,724,167,891,58,949
公投第７案,高雄市,楠梓區,秀昌里,512,1034,456,131,587,54,641
公投第７案,高雄市,楠梓區,秀昌里,513,1127,583,136,719,58,777
公投第７案,高雄市,楠梓區,裕昌里,514,1575,641,177,818,95,913
公投第７案,高雄市,楠梓區,裕昌里,515,1559,725,175,900,68,968
公投第７案,高雄市,楠梓區,裕昌里,516,1378,594,150,744,61,805
公投第７案,高雄市,楠梓區,國昌里,517,1714,746,217,963,82,1045
公投第７案,高雄市,楠梓區,國昌里,518,1721,762,198,960,88,1048
公投第７案,高雄市,楠梓區,加昌里,519,1628,708,201,909,67,976
公投第７案,高雄市,楠梓區,加昌里,520,1590,804,188,992,89,1081
公投第７案,高雄市,楠梓區,加昌里,521,1628,743,181,924,72,996
公投第７案,高雄市,楠梓區,加昌里,522,1739,881,193,1074,53,1127
公投第７案,高雄市,楠梓區,加昌里,523,1642,807,183,990,73,1063
公投第７案,高雄市,楠梓區,仁昌里,524,1766,737,162,899,89,988
公投第７案,高雄市,楠梓區,仁昌里,525,1482,643,143,786,74,860
公投第７案,高雄市,楠梓區,仁昌里,526,1749,750,127,877,38,915
公投第７案,高雄市,楠梓區,藍田里,527,1591,710,201,911,53,964
公投第７案,高雄市,楠梓區,藍田里,528,1545,767,182,949,45,994
公投第７案,高雄市,楠梓區,藍田里,529,1651,834,193,1027,43,1070
公投第７案,高雄市,楠梓區,藍田里,530,1646,816,163,979,64,1043
公投第７案,高雄市,楠梓區,中興里,531,1496,657,189,846,82,928
公投第７案,高雄市,楠梓區,中和里,532,1403,547,161,708,92,800
公投第７案,高雄市,楠梓區,中和里,533,1624,700,176,876,59,935
公投第７案,高雄市,左營區,進學里,534,2604,639,179,818,58,876
公投第７案,高雄市,左營區,尾西里,535,1037,427,140,567,81,648
公投第７案,高雄市,左營區,頂北里,536,542,240,66,306,47,353
公投第７案,高雄市,左營區,中北里,537,635,257,79,336,53,389
公投第７案,高雄市,左營區,中南里,538,518,181,41,222,20,242
公投第７案,高雄市,左營區,廟東里,539,813,284,94,378,62,440
公投第７案,高雄市,左營區,廟北里,540,889,329,132,461,82,543
公投第７案,高雄市,左營區,尾南里,541,731,300,97,397,74,471
公投第７案,高雄市,左營區,尾北里,542,1592,563,177,740,48,788
公投第７案,高雄市,左營區,尾北里,543,1709,727,228,955,56,1011
公投第７案,高雄市,左營區,屏山里,544,1588,758,123,881,62,943
公投第７案,高雄市,左營區,祥和里,545,358,176,14,190,6,196
公投第７案,高雄市,左營區,永清里,546,666,403,40,443,13,456
公投第７案,高雄市,左營區,莒光里,547,1748,754,161,915,72,987
公投第７案,高雄市,左營區,光輝里,548,1196,556,186,742,25,767
公投第７案,高雄市,左營區,光輝里,549,1240,565,148,713,66,779
公投第７案,高雄市,左營區,合群里,550,1402,726,92,818,46,864
公投第７案,高雄市,左營區,合群里,551,1173,643,78,721,28,749
公投第７案,高雄市,左營區,明建里,552,641,373,65,438,21,459
公投第７案,高雄市,左營區,頂西里,553,951,336,140,476,45,521
公投第７案,高雄市,左營區,聖后里,554,732,284,88,372,46,418
公投第７案,高雄市,左營區,聖西里,555,339,125,42,167,12,179
公投第７案,高雄市,左營區,聖南里,556,519,221,55,276,16,292
公投第７案,高雄市,左營區,城南里,557,514,206,76,282,60,342
公投第７案,高雄市,左營區,路東里,558,720,316,81,397,61,458
公投第７案,高雄市,左營區,廍北里,559,411,163,57,220,49,269
公投第７案,高雄市,左營區,廍南里,560,603,258,96,354,43,397
公投第７案,高雄市,左營區,埤西里,561,904,353,125,478,79,557
公投第７案,高雄市,左營區,埤北里,562,1318,484,130,614,44,658
公投第７案,高雄市,左營區,埤東里,563,966,347,116,463,25,488
公投第７案,高雄市,左營區,海勝里,564,1440,686,120,806,40,846
公投第７案,高雄市,左營區,海勝里,565,1990,913,136,1049,44,1093
公投第７案,高雄市,左營區,海勝里,566,1090,567,70,637,32,669
公投第７案,高雄市,左營區,海勝里,567,1272,623,98,721,72,793
公投第７案,高雄市,左營區,崇實里,568,1558,776,170,946,29,975
公投第７案,高雄市,左營區,崇實里,569,1501,745,181,926,38,964
公投第７案,高雄市,左營區,自助里,570,360,199,40,239,8,247
公投第７案,高雄市,左營區,果貿里,571,1335,700,73,773,35,808
公投第７案,高雄市,左營區,果貿里,572,1359,664,106,770,22,792
公投第７案,高雄市,左營區,果惠里,573,1487,703,152,855,58,913
公投第７案,高雄市,左營區,果峰里,574,1637,731,139,870,57,927
公投第７案,高雄市,左營區,新下里,575,1553,763,154,917,44,961
公投第７案,高雄市,左營區,新下里,576,1564,726,196,922,72,994
公投第７案,高雄市,左營區,新下里,577,1788,864,231,1095,58,1153
公投第７案,高雄市,左營區,新下里,578,2028,936,219,1155,101,1256
公投第７案,高雄市,左營區,新下里,579,2037,901,239,1140,96,1236
公投第７案,高雄市,左營區,新下里,580,2101,990,244,1234,58,1292
公投第７案,高雄市,左營區,新下里,581,2018,1034,127,1161,64,1225
公投第７案,高雄市,左營區,新上里,582,1925,851,293,1144,96,1240
公投第７案,高雄市,左營區,新上里,583,1989,834,257,1091,37,1128
公投第７案,高雄市,左營區,新上里,584,1780,703,177,880,42,922
公投第７案,高雄市,左營區,新上里,585,1778,807,237,1044,35,1079
公投第７案,高雄市,左營區,新上里,586,1496,698,181,879,33,912
公投第７案,高雄市,左營區,新上里,587,1538,707,200,907,55,962
公投第７案,高雄市,左營區,新上里,588,2058,933,250,1183,70,1253
公投第７案,高雄市,左營區,新上里,589,1992,889,251,1140,34,1174
公投第７案,高雄市,左營區,新上里,590,2058,942,250,1192,75,1267
公投第７案,高雄市,左營區,新上里,591,2090,969,244,1213,53,1266
公投第７案,高雄市,左營區,新上里,592,2157,899,283,1182,43,1225
公投第７案,高雄市,左營區,新上里,593,2096,1000,263,1263,47,1310
公投第７案,高雄市,左營區,新上里,594,2101,954,290,1244,88,1332
公投第７案,高雄市,左營區,新中里,595,1649,735,186,921,73,994
公投第７案,高雄市,左營區,新中里,596,1516,619,185,804,91,895
公投第７案,高雄市,左營區,新中里,597,1678,733,209,942,97,1039
公投第７案,高雄市,左營區,新光里,598,1898,831,243,1074,76,1150
公投第７案,高雄市,左營區,新光里,599,1837,789,211,1000,58,1058
公投第７案,高雄市,左營區,新光里,600,1922,891,135,1026,24,1050
公投第７案,高雄市,左營區,新光里,601,1785,858,206,1064,58,1122
公投第７案,高雄市,左營區,新光里,602,1886,839,194,1033,31,1064
公投第７案,高雄市,左營區,新光里,603,1895,892,214,1106,49,1155
公投第７案,高雄市,左營區,新光里,604,1831,871,206,1077,36,1113
公投第７案,高雄市,左營區,菜公里,605,2050,921,214,1135,41,1176
公投第７案,高雄市,左營區,菜公里,606,2251,1145,288,1433,48,1481
公投第７案,高雄市,左營區,菜公里,607,2126,1011,268,1279,38,1317
公投第７案,高雄市,左營區,菜公里,608,1928,820,198,1018,34,1052
公投第７案,高雄市,左營區,菜公里,609,2166,917,251,1168,60,1228
公投第７案,高雄市,左營區,菜公里,610,2031,938,220,1158,60,1218
公投第７案,高雄市,左營區,菜公里,611,1987,946,225,1171,66,1237
公投第７案,高雄市,左營區,菜公里,612,2166,1032,248,1280,41,1321
公投第７案,高雄市,左營區,菜公里,613,1856,817,261,1078,59,1137
公投第７案,高雄市,左營區,菜公里,614,2289,997,354,1351,49,1400
公投第７案,高雄市,左營區,菜公里,615,1973,924,192,1116,48,1164
公投第７案,高雄市,左營區,菜公里,616,1818,827,210,1037,90,1127
公投第７案,高雄市,左營區,菜公里,617,1565,676,185,861,32,893
公投第７案,高雄市,左營區,菜公里,618,1608,817,191,1008,40,1048
公投第７案,高雄市,左營區,福山里,619,1812,904,214,1118,58,1176
公投第７案,高雄市,左營區,福山里,620,1821,795,181,976,21,997
公投第７案,高雄市,左營區,福山里,621,1907,892,243,1135,60,1195
公投第７案,高雄市,左營區,福山里,622,1812,866,157,1023,50,1073
公投第７案,高雄市,左營區,福山里,623,1833,886,227,1113,40,1153
公投第７案,高雄市,左營區,福山里,624,1850,861,221,1082,62,1144
公投第７案,高雄市,左營區,福山里,625,1738,788,174,962,63,1025
公投第７案,高雄市,左營區,福山里,626,1864,949,200,1149,59,1208
公投第７案,高雄市,左營區,福山里,627,1887,900,237,1137,51,1188
公投第７案,高雄市,左營區,福山里,628,1870,833,175,1008,31,1039
公投第７案,高雄市,左營區,福山里,629,1866,878,172,1050,33,1083
公投第７案,高雄市,左營區,福山里,630,1862,838,207,1045,16,1061
公投第７案,高雄市,左營區,福山里,631,1816,876,185,1061,34,1095
公投第７案,高雄市,左營區,福山里,632,1833,844,205,1049,47,1096
公投第７案,高雄市,左營區,福山里,633,1676,770,226,996,56,1052
公投第７案,高雄市,左營區,福山里,634,1843,867,202,1069,61,1130
公投第７案,高雄市,左營區,福山里,635,1872,889,223,1112,41,1153
公投第７案,高雄市,左營區,福山里,636,2259,1047,243,1290,47,1337
公投第７案,高雄市,大社區,嘉誠里,637,950,353,106,459,73,532
公投第７案,高雄市,大社區,保社里,638,1306,484,128,612,45,657
公投第７案,高雄市,大社區,保社里,639,1856,648,140,788,35,823
公投第７案,高雄市,大社區,大社里,640,986,148,423,571,63,634
公投第７案,高雄市,大社區,大社里,641,1116,401,114,515,58,573
公投第７案,高雄市,大社區,大社里,642,1253,543,191,734,72,806
公投第７案,高雄市,大社區,大社里,643,1613,479,201,680,48,728
公投第７案,高雄市,大社區,保安里,644,1455,551,174,725,48,773
公投第７案,高雄市,大社區,保安里,645,1674,688,242,930,47,977
公投第７案,高雄市,大社區,三奶里,646,1004,444,97,541,66,607
公投第７案,高雄市,大社區,三奶里,647,879,360,105,465,34,499
公投第７案,高雄市,大社區,三奶里,648,778,268,124,392,14,406
公投第７案,高雄市,大社區,觀音里,649,1110,475,138,613,62,675
公投第７案,高雄市,大社區,觀音里,650,1432,577,166,743,53,796
公投第７案,高雄市,大社區,觀音里,651,1466,632,168,800,49,849
公投第７案,高雄市,大社區,觀音里,652,1383,599,222,821,89,910
公投第７案,高雄市,大社區,神農里,653,1645,726,177,903,78,981
公投第７案,高雄市,大社區,神農里,654,1555,556,182,738,45,783
公投第７案,高雄市,大社區,神農里,655,1750,712,218,930,82,1012
公投第７案,高雄市,大社區,中里里,656,1111,467,129,596,55,651
公投第７案,高雄市,大社區,中里里,657,1133,492,136,628,69,697
公投第７案,高雄市,大社區,中里里,658,912,401,100,501,36,537
公投第７案,高雄市,大社區,翠屏里,659,745,246,73,319,17,336
公投第７案,高雄市,大社區,翠屏里,660,934,394,113,507,33,540
公投第７案,高雄市,仁武區,大灣里,661,1777,832,218,1050,51,1101
公投第７案,高雄市,仁武區,大灣里,662,2273,1036,270,1306,69,1375
公投第７案,高雄市,仁武區,灣內里,663,1384,662,172,834,80,914
公投第７案,高雄市,仁武區,灣內里,664,1170,494,137,631,58,689
公投第７案,高雄市,仁武區,灣內里,665,1216,585,170,755,60,815
公投第７案,高雄市,仁武區,灣內里,666,1598,700,164,864,22,886
公投第７案,高雄市,仁武區,灣內里,667,2143,1066,219,1285,42,1327
公投第７案,高雄市,仁武區,考潭里,668,1300,545,145,690,58,748
公投第７案,高雄市,仁武區,考潭里,669,1338,573,164,737,74,811
公投第７案,高雄市,仁武區,烏林里,670,1217,464,149,613,21,634
公投第７案,高雄市,仁武區,烏林里,671,1202,424,121,545,71,616
公投第７案,高雄市,仁武區,烏林里,672,1404,537,136,673,42,715
公投第７案,高雄市,仁武區,仁福里,673,830,328,102,430,50,480
公投第７案,高雄市,仁武區,仁武里,674,1802,566,168,734,39,773
公投第７案,高雄市,仁武區,仁武里,675,1877,768,151,919,67,986
公投第７案,高雄市,仁武區,仁武里,676,1738,628,157,785,41,826
公投第７案,高雄市,仁武區,文武里,677,1549,640,163,803,53,856
公投第７案,高雄市,仁武區,文武里,678,1579,685,189,874,52,926
公投第７案,高雄市,仁武區,文武里,679,1406,584,127,711,32,743
公投第７案,高雄市,仁武區,文武里,680,1461,661,130,791,30,821
公投第７案,高雄市,仁武區,文武里,681,1311,588,180,768,52,820
公投第７案,高雄市,仁武區,文武里,682,1373,587,132,719,30,749
公投第７案,高雄市,仁武區,竹後里,683,1035,333,134,467,20,487
公投第７案,高雄市,仁武區,竹後里,684,1181,436,154,590,39,629
公投第７案,高雄市,仁武區,八卦里,685,1670,685,165,850,45,895
公投第７案,高雄市,仁武區,八卦里,686,1576,634,186,820,31,851
公投第７案,高雄市,仁武區,八卦里,687,1576,739,171,910,66,976
公投第７案,高雄市,仁武區,八卦里,688,1915,904,218,1122,46,1168
公投第７案,高雄市,仁武區,八卦里,689,1758,761,157,918,25,943
公投第７案,高雄市,仁武區,八卦里,690,1892,929,202,1131,62,1193
公投第７案,高雄市,仁武區,八卦里,691,2025,934,221,1155,69,1224
公投第７案,高雄市,仁武區,八卦里,692,2014,975,204,1179,60,1239
公投第７案,高雄市,仁武區,八卦里,693,1473,750,189,939,59,998
公投第７案,高雄市,仁武區,高楠里,694,979,378,98,476,36,512
公投第７案,高雄市,仁武區,高楠里,695,944,406,97,503,23,526
公投第７案,高雄市,仁武區,後安里,696,1153,490,128,618,82,700
公投第７案,高雄市,仁武區,後安里,697,1328,528,133,661,41,702
公投第７案,高雄市,仁武區,中華里,698,1657,688,229,917,73,990
公投第７案,高雄市,仁武區,五和里,699,1545,605,140,745,72,817
公投第７案,高雄市,仁武區,五和里,700,1417,635,180,815,56,871
公投第７案,高雄市,仁武區,五和里,701,1602,776,206,982,43,1025
公投第７案,高雄市,仁武區,仁和里,702,1823,861,231,1092,76,1168
公投第７案,高雄市,仁武區,仁和里,703,1914,805,232,1037,35,1072
公投第７案,高雄市,仁武區,赤山里,704,1992,875,203,1078,52,1130
公投第７案,高雄市,仁武區,赤山里,705,2045,818,201,1019,49,1068
公投第７案,高雄市,仁武區,赤山里,706,1982,912,234,1146,63,1209
公投第７案,高雄市,仁武區,仁慈里,707,2167,855,250,1105,58,1163
公投第７案,高雄市,鳥松區,鳥松里,708,1678,694,235,929,63,992
公投第７案,高雄市,鳥松區,鳥松里,709,1682,663,186,849,65,914
公投第７案,高雄市,鳥松區,鳥松里,710,1225,533,161,694,49,743
公投第７案,高雄市,鳥松區,鳥松里,711,1322,516,153,669,62,731
公投第７案,高雄市,鳥松區,鳥松里,712,1215,534,145,679,58,737
公投第７案,高雄市,鳥松區,鳥松里,713,1779,687,217,904,48,952
公投第７案,高雄市,鳥松區,鳥松里,714,1129,525,188,713,17,730
公投第７案,高雄市,鳥松區,夢裡里,715,1374,624,170,794,62,856
公投第７案,高雄市,鳥松區,夢裡里,716,1089,411,179,590,33,623
公投第７案,高雄市,鳥松區,夢裡里,717,2219,971,315,1286,71,1357
公投第７案,高雄市,鳥松區,大華里,718,1634,679,214,893,33,926
公投第７案,高雄市,鳥松區,大華里,719,1553,746,175,921,65,986
公投第７案,高雄市,鳥松區,大華里,720,1572,725,222,947,48,995
公投第７案,高雄市,鳥松區,大華里,721,1688,772,242,1014,45,1059
公投第７案,高雄市,鳥松區,大華里,722,1626,690,257,947,38,985
公投第７案,高雄市,鳥松區,大華里,723,1744,817,222,1039,72,1111
公投第７案,高雄市,鳥松區,坔埔里,724,1230,492,135,627,57,684
公投第７案,高雄市,鳥松區,坔埔里,725,1201,538,141,679,95,774
公投第７案,高雄市,鳥松區,坔埔里,726,1117,524,143,667,48,715
公投第７案,高雄市,鳥松區,仁美里,727,1255,516,138,654,61,715
公投第７案,高雄市,鳥松區,仁美里,728,1432,545,149,694,41,735
公投第７案,高雄市,鳥松區,仁美里,729,1370,521,154,675,29,704
公投第７案,高雄市,鳥松區,仁美里,730,1364,653,146,799,54,853
公投第７案,高雄市,鳥松區,仁美里,731,1041,464,128,592,57,649
公投第７案,高雄市,鳥松區,大竹里,732,702,366,103,469,38,507
公投第７案,高雄市,鳥松區,華美里,733,1212,499,159,658,73,731
公投第７案,高雄市,鳥松區,華美里,734,1289,572,128,700,52,752
公投第７案,高雄市,鳥松區,華美里,735,1449,703,191,894,33,927
公投第７案,高雄市,大樹區,竹寮里,736,1386,551,169,720,23,743
公投第７案,高雄市,大樹區,竹寮里,737,1315,664,152,816,21,837
公投第７案,高雄市,大樹區,九曲里,738,2461,993,251,1244,72,1316
公投第７案,高雄市,大樹區,九曲里,739,1274,511,125,636,32,668
公投第７案,高雄市,大樹區,九曲里,740,1265,533,120,653,61,714
公投第７案,高雄市,大樹區,久堂里,741,1504,610,156,766,67,833
公投第７案,高雄市,大樹區,久堂里,742,1049,372,121,493,20,513
公投第７案,高雄市,大樹區,久堂里,743,1573,620,140,760,69,829
公投第７案,高雄市,大樹區,水安里,744,1121,412,79,491,31,522
公投第７案,高雄市,大樹區,水安里,745,1207,504,145,649,51,700
公投第７案,高雄市,大樹區,水寮里,746,1134,444,124,568,23,591
公投第７案,高雄市,大樹區,水寮里,747,1124,461,151,612,41,653
公投第７案,高雄市,大樹區,檨腳里,748,1259,496,131,627,90,717
公投第７案,高雄市,大樹區,檨腳里,749,1105,502,131,633,68,701
公投第７案,高雄市,大樹區,檨腳里,750,1128,457,128,585,59,644
公投第７案,高雄市,大樹區,興山里,751,1079,394,113,507,89,596
公投第７案,高雄市,大樹區,和山里,752,1025,376,93,469,38,507
公投第７案,高雄市,大樹區,姑山里,753,950,379,96,475,55,530
公投第７案,高雄市,大樹區,大坑里,754,1433,542,177,719,93,812
公投第７案,高雄市,大樹區,井腳里,755,794,284,71,355,21,376
公投第７案,高雄市,大樹區,井腳里,756,781,206,73,279,12,291
公投第７案,高雄市,大樹區,小坪里,757,1318,442,139,581,21,602
公投第７案,高雄市,大樹區,龍目里,758,736,290,72,362,42,404
公投第７案,高雄市,大樹區,龍目里,759,1047,341,114,455,23,478
公投第７案,高雄市,大樹區,大樹里,760,1271,520,153,673,75,748
公投第７案,高雄市,大樹區,大樹里,761,1186,404,123,527,30,557
公投第７案,高雄市,大樹區,三和里,762,1007,415,112,527,46,573
公投第７案,高雄市,大樹區,溪埔里,763,859,363,92,455,57,512
公投第７案,高雄市,大樹區,溪埔里,764,735,271,46,317,16,333
公投第７案,高雄市,大樹區,興田里,765,1046,451,115,566,72,638
公投第７案,高雄市,大樹區,興田里,766,880,553,56,609,42,651
公投第７案,高雄市,大樹區,統嶺里,767,720,273,66,339,20,359
公投第７案,高雄市,鼓山區,鼓峰里,768,959,379,90,469,21,490
公投第７案,高雄市,鼓山區,鼓峰里,769,1000,494,115,609,46,655
公投第７案,高雄市,鼓山區,雄峰里,770,910,391,99,490,13,503
公投第７案,高雄市,鼓山區,雄峰里,771,1085,551,106,657,54,711
公投第７案,高雄市,鼓山區,前峰里,772,1484,517,146,663,46,709
公投第７案,高雄市,鼓山區,前峰里,773,1393,646,138,784,27,811
公投第７案,高雄市,鼓山區,前峰里,774,1270,655,132,787,62,849
公投第７案,高雄市,鼓山區,光榮里,775,1055,416,111,527,49,576
公投第７案,高雄市,鼓山區,光榮里,776,1172,462,163,625,30,655
公投第７案,高雄市,鼓山區,光榮里,777,1175,511,174,685,48,733
公投第７案,高雄市,鼓山區,民族里,778,1274,527,166,693,46,739
公投第７案,高雄市,鼓山區,內惟里,779,1085,394,109,503,52,555
公投第７案,高雄市,鼓山區,建國里,780,1470,643,142,785,69,854
公投第７案,高雄市,鼓山區,建國里,781,974,421,162,583,51,634
公投第７案,高雄市,鼓山區,忠正里,782,1275,541,176,717,88,805
公投第７案,高雄市,鼓山區,忠正里,783,1206,479,154,633,56,689
公投第７案,高雄市,鼓山區,忠正里,784,1238,512,156,668,30,698
公投第７案,高雄市,鼓山區,自強里,785,721,440,40,480,16,496
公投第７案,高雄市,鼓山區,龍井里,786,1220,483,132,615,28,643
公投第７案,高雄市,鼓山區,正德里,787,1966,679,187,866,49,915
公投第７案,高雄市,鼓山區,平和里,788,1722,615,220,835,69,904
公投第７案,高雄市,鼓山區,平和里,789,1720,675,168,843,26,869
公投第７案,高雄市,鼓山區,民強里,790,1287,545,151,696,105,801
公投第７案,高雄市,鼓山區,民強里,791,1369,447,132,579,46,625
公投第７案,高雄市,鼓山區,厚生里,792,1222,580,135,715,27,742
公投第７案,高雄市,鼓山區,厚生里,793,1770,712,175,887,53,940
公投第７案,高雄市,鼓山區,龍子里,794,1860,798,231,1029,36,1065
公投第７案,高雄市,鼓山區,龍子里,795,1857,667,319,986,52,1038
公投第７案,高雄市,鼓山區,龍子里,796,1841,791,232,1023,47,1070
公投第７案,高雄市,鼓山區,龍子里,797,1830,846,212,1058,67,1125
公投第７案,高雄市,鼓山區,龍子里,798,1809,790,217,1007,65,1072
公投第７案,高雄市,鼓山區,龍子里,799,1894,873,225,1098,37,1135
公投第７案,高雄市,鼓山區,龍子里,800,1882,875,246,1121,30,1151
公投第７案,高雄市,鼓山區,龍子里,801,1894,874,282,1156,59,1215
公投第７案,高雄市,鼓山區,龍水里,802,1745,781,185,966,40,1006
公投第７案,高雄市,鼓山區,龍水里,803,1887,815,205,1020,19,1039
公投第７案,高雄市,鼓山區,龍水里,804,1891,911,260,1171,59,1230
公投第７案,高雄市,鼓山區,龍水里,805,1903,868,241,1109,55,1164
公投第７案,高雄市,鼓山區,龍水里,806,1998,864,295,1159,50,1209
公投第７案,高雄市,鼓山區,龍水里,807,1912,919,205,1124,48,1172
公投第７案,高雄市,鼓山區,龍水里,808,1923,890,243,1133,67,1200
公投第７案,高雄市,鼓山區,龍水里,809,1888,886,252,1138,29,1167
公投第７案,高雄市,鼓山區,龍水里,810,1873,898,224,1122,20,1142
公投第７案,高雄市,鼓山區,龍水里,811,1959,975,280,1255,50,1305
公投第７案,高雄市,鼓山區,龍水里,812,1897,959,228,1187,48,1235
公投第７案,高雄市,鼓山區,明誠里,813,2362,1119,273,1392,43,1435
公投第７案,高雄市,鼓山區,明誠里,814,1850,859,235,1094,71,1165
公投第７案,高雄市,鼓山區,明誠里,815,1928,902,242,1144,34,1178
公投第７案,高雄市,鼓山區,明誠里,816,1937,873,192,1065,32,1097
公投第７案,高雄市,鼓山區,明誠里,817,2123,966,222,1188,74,1262
公投第７案,高雄市,鼓山區,明誠里,818,1861,813,232,1045,40,1085
公投第７案,高雄市,鼓山區,明誠里,819,1892,882,183,1065,27,1092
公投第７案,高雄市,鼓山區,明誠里,820,2147,989,259,1248,55,1303
公投第７案,高雄市,鼓山區,華豐里,821,1897,898,211,1109,51,1160
公投第７案,高雄市,鼓山區,華豐里,822,2041,886,238,1124,32,1156
公投第７案,高雄市,鼓山區,裕興里,823,1309,589,131,720,56,776
公投第７案,高雄市,鼓山區,裕興里,824,1867,824,226,1050,59,1109
公投第７案,高雄市,鼓山區,裕豐里,825,1152,598,145,743,39,782
公投第７案,高雄市,鼓山區,裕豐里,826,1404,673,178,851,50,901
公投第７案,高雄市,鼓山區,鼓岩里,827,1210,327,97,424,24,448
公投第７案,高雄市,鼓山區,樹德里,828,1135,423,153,576,51,627
公投第７案,高雄市,鼓山區,寶樹里,829,1831,441,135,576,86,662
公投第７案,高雄市,鼓山區,興宗里,830,1288,535,150,685,72,757
公投第７案,高雄市,鼓山區,光化里,831,1241,493,123,616,34,650
公投第７案,高雄市,鼓山區,山下里,832,1342,597,150,747,78,825
公投第７案,高雄市,鼓山區,河邊里,833,1422,599,172,771,96,867
公投第７案,高雄市,鼓山區,綠川里,834,1453,648,169,817,100,917
公投第７案,高雄市,鼓山區,登山里,835,616,265,90,355,43,398
公投第７案,高雄市,鼓山區,峰南里,836,834,304,119,423,80,503
公投第７案,高雄市,鼓山區,麗興里,837,969,382,117,499,115,614
公投第７案,高雄市,鼓山區,新民里,838,978,367,117,484,87,571
公投第７案,高雄市,鼓山區,延平里,839,760,294,113,407,79,486
公投第７案,高雄市,鼓山區,維生里,840,1248,536,139,675,70,745
公投第７案,高雄市,鼓山區,惠安里,841,1143,386,148,534,33,567
公投第７案,高雄市,鼓山區,壽山里,842,1358,441,149,590,80,670
公投第７案,高雄市,鼓山區,哨船頭里,843,1036,398,91,489,18,507
公投第７案,高雄市,鼓山區,桃源里,844,580,209,71,280,20,300
公投第７案,高雄市,鹽埕區,藍橋里,845,1304,548,212,760,48,808
公投第７案,高雄市,鹽埕區,慈愛里,846,357,154,40,194,23,217
公投第７案,高雄市,鹽埕區,博愛里,847,651,254,95,349,26,375
公投第７案,高雄市,鹽埕區,壽星里,848,1322,460,152,612,26,638
公投第７案,高雄市,鹽埕區,中山里,849,1056,445,128,573,20,593
公投第７案,高雄市,鹽埕區,教仁里,850,904,363,128,491,21,512
公投第７案,高雄市,鹽埕區,教仁里,851,1130,442,132,574,30,604
公投第７案,高雄市,鹽埕區,新樂里,852,840,401,81,482,19,501
公投第７案,高雄市,鹽埕區,中原里,853,616,297,106,403,32,435
公投第７案,高雄市,鹽埕區,光明里,854,1397,491,179,670,45,715
公投第７案,高雄市,鹽埕區,育仁里,855,766,279,124,403,16,419
公投第７案,高雄市,鹽埕區,河濱里,856,839,354,110,464,44,508
公投第７案,高雄市,鹽埕區,河濱里,857,805,340,118,458,15,473
公投第７案,高雄市,鹽埕區,沙地里,858,750,288,83,371,23,394
公投第７案,高雄市,鹽埕區,南端里,859,986,366,131,497,35,532
公投第７案,高雄市,鹽埕區,港都里,860,1068,372,107,479,16,495
公投第７案,高雄市,鹽埕區,江西里,861,1060,424,153,577,55,632
公投第７案,高雄市,鹽埕區,新豐里,862,805,302,102,404,37,441
公投第７案,高雄市,鹽埕區,府北里,863,1073,382,116,498,19,517
公投第７案,高雄市,鹽埕區,府北里,864,921,329,106,435,30,465
公投第７案,高雄市,鹽埕區,陸橋里,865,1171,455,143,598,22,620
公投第７案,高雄市,鹽埕區,瀨南里,866,594,231,88,319,18,337
公投第７案,高雄市,鹽埕區,新化里,867,592,252,78,330,17,347
公投第７案,高雄市,鹽埕區,江南里,868,610,208,85,293,15,308
公投第７案,高雄市,旗津區,旗下里,869,1177,440,172,612,118,730
公投第７案,高雄市,旗津區,永安里,870,1109,388,104,492,50,542
公投第７案,高雄市,旗津區,振興里,871,1642,508,173,681,29,710
公投第７案,高雄市,旗津區,慈愛里,872,1209,445,109,554,106,660
公投第７案,高雄市,旗津區,慈愛里,873,1112,353,115,468,54,522
公投第７案,高雄市,旗津區,復興里,874,1483,546,202,748,101,849
公投第７案,高雄市,旗津區,復興里,875,1460,487,96,583,31,614
公投第７案,高雄市,旗津區,中華里,876,1572,601,223,824,159,983
公投第７案,高雄市,旗津區,實踐里,877,1384,476,117,593,30,623
公投第７案,高雄市,旗津區,北汕里,878,1390,459,133,592,41,633
公投第７案,高雄市,旗津區,北汕里,879,1239,403,136,539,62,601
公投第７案,高雄市,旗津區,南汕里,880,2045,663,245,908,130,1038
公投第７案,高雄市,旗津區,上竹里,881,893,290,102,392,23,415
公投第７案,高雄市,旗津區,上竹里,882,1866,603,236,839,137,976
公投第７案,高雄市,旗津區,中洲里,883,1874,504,182,686,34,720
公投第７案,高雄市,旗津區,安順里,884,893,300,88,388,67,455
公投第７案,高雄市,旗津區,中興里,885,1215,420,166,586,41,627
公投第７案,高雄市,旗津區,中興里,886,1297,446,107,553,48,601
公投第７案,高雄市,三民區,鼎金里,887,1893,772,220,992,93,1085
公投第７案,高雄市,三民區,鼎金里,888,1982,755,212,967,101,1068
公投第７案,高雄市,三民區,鼎盛里,889,1661,723,165,888,82,970
公投第７案,高雄市,三民區,鼎盛里,890,1894,785,192,977,27,1004
公投第７案,高雄市,三民區,鼎盛里,891,1839,784,195,979,65,1044
公投第７案,高雄市,三民區,鼎盛里,892,2014,850,234,1084,71,1155
公投第７案,高雄市,三民區,鼎強里,893,1897,788,205,993,123,1116
公投第７案,高雄市,三民區,鼎強里,894,2016,747,237,984,53,1037
公投第７案,高雄市,三民區,鼎力里,895,1924,771,213,984,52,1036
公投第７案,高雄市,三民區,鼎力里,896,1749,764,205,969,63,1032
公投第７案,高雄市,三民區,鼎西里,897,1845,865,224,1089,79,1168
公投第７案,高雄市,三民區,鼎西里,898,1724,676,179,855,44,899
公投第７案,高雄市,三民區,鼎西里,899,1889,818,201,1019,51,1070
公投第７案,高雄市,三民區,鼎西里,900,1622,685,192,877,72,949
公投第７案,高雄市,三民區,鼎中里,901,1870,774,245,1019,41,1060
公投第７案,高雄市,三民區,鼎中里,902,1523,656,228,884,74,958
公投第７案,高雄市,三民區,鼎泰里,903,2006,724,224,948,75,1023
公投第７案,高雄市,三民區,鼎泰里,904,2076,949,277,1226,76,1302
公投第７案,高雄市,三民區,鼎泰里,905,2073,802,340,1142,33,1175
公投第７案,高雄市,三民區,鼎泰里,906,2045,919,211,1130,68,1198
公投第７案,高雄市,三民區,鼎泰里,907,2070,756,205,961,77,1038
公投第７案,高雄市,三民區,鼎泰里,908,2035,795,261,1056,71,1127
公投第７案,高雄市,三民區,鼎泰里,909,2075,948,274,1222,61,1283
公投第７案,高雄市,三民區,鼎泰里,910,2053,946,212,1158,39,1197
公投第７案,高雄市,三民區,鼎泰里,911,2063,989,237,1226,78,1304
公投第７案,高雄市,三民區,鼎泰里,912,2143,1031,260,1291,62,1353
公投第７案,高雄市,三民區,本館里,913,1746,733,262,995,87,1082
公投第７案,高雄市,三民區,本館里,914,1735,642,194,836,29,865
公投第７案,高雄市,三民區,本館里,915,1655,668,178,846,69,915
公投第７案,高雄市,三民區,本館里,916,1583,712,171,883,61,944
公投第７案,高雄市,三民區,本館里,917,1800,785,181,966,52,1018
公投第７案,高雄市,三民區,本和里,918,1730,763,212,975,40,1015
公投第７案,高雄市,三民區,本和里,919,1715,715,208,923,30,953
公投第７案,高雄市,三民區,本和里,920,1691,711,237,948,59,1007
公投第７案,高雄市,三民區,本和里,921,1865,844,201,1045,58,1103
公投第７案,高雄市,三民區,本文里,922,1073,512,142,654,37,691
公投第７案,高雄市,三民區,本文里,923,917,436,138,574,63,637
公投第７案,高雄市,三民區,本武里,924,1647,785,133,918,58,976
公投第７案,高雄市,三民區,本元里,925,1654,720,217,937,70,1007
公投第７案,高雄市,三民區,本元里,926,1639,752,209,961,49,1010
公投第７案,高雄市,三民區,本元里,927,1833,827,213,1040,63,1103
公投第７案,高雄市,三民區,本安里,928,1362,651,191,842,42,884
公投第７案,高雄市,三民區,本安里,929,1557,721,203,924,63,987
公投第７案,高雄市,三民區,本安里,930,1482,674,198,872,27,899
公投第７案,高雄市,三民區,本上里,931,1563,707,217,924,44,968
公投第７案,高雄市,三民區,本上里,932,1497,658,208,866,34,900
公投第７案,高雄市,三民區,本上里,933,1523,705,209,914,42,956
公投第７案,高雄市,三民區,本揚里,934,1293,622,189,811,56,867
公投第７案,高雄市,三民區,本揚里,935,1662,780,210,990,59,1049
公投第７案,高雄市,三民區,本揚里,936,1441,607,193,800,62,862
公投第７案,高雄市,三民區,本揚里,937,1326,647,200,847,49,896
公投第７案,高雄市,三民區,本揚里,938,1476,693,223,916,33,949
公投第７案,高雄市,三民區,寶獅里,939,1968,756,203,959,32,991
公投第７案,高雄市,三民區,寶獅里,940,1618,616,175,791,28,819
公投第７案,高雄市,三民區,寶德里,941,1873,814,218,1032,56,1088
公投第７案,高雄市,三民區,寶德里,942,1487,674,151,825,71,896
公投第７案,高雄市,三民區,寶德里,943,1640,639,223,862,25,887
公投第７案,高雄市,三民區,寶泰里,944,1889,775,192,967,35,1002
公投第７案,高雄市,三民區,寶泰里,945,1969,802,197,999,45,1044
公投第７案,高雄市,三民區,寶興里,946,1466,593,193,786,95,881
公投第７案,高雄市,三民區,寶興里,947,1697,763,215,978,65,1043
公投第７案,高雄市,三民區,寶興里,948,1663,767,190,957,71,1028
公投第７案,高雄市,三民區,寶興里,949,1649,711,197,908,49,957
公投第７案,高雄市,三民區,寶中里,950,1486,609,177,786,45,831
公投第７案,高雄市,三民區,寶中里,951,1495,587,182,769,30,799
公投第７案,高雄市,三民區,寶華里,952,1548,748,190,938,28,966
公投第７案,高雄市,三民區,寶華里,953,1493,622,182,804,29,833
公投第７案,高雄市,三民區,寶國里,954,1445,688,175,863,30,893
公投第７案,高雄市,三民區,寶國里,955,1529,670,148,818,43,861
公投第７案,高雄市,三民區,寶國里,956,1506,644,155,799,31,830
公投第７案,高雄市,三民區,寶國里,957,1549,731,177,908,60,968
公投第７案,高雄市,三民區,寶國里,958,1620,772,93,865,72,937
公投第７案,高雄市,三民區,寶民里,959,1550,715,208,923,61,984
公投第７案,高雄市,三民區,寶民里,960,1488,683,201,884,56,940
公投第７案,高雄市,三民區,寶慶里,961,1335,614,160,774,57,831
公投第７案,高雄市,三民區,寶慶里,962,1332,603,155,758,58,816
公投第７案,高雄市,三民區,寶業里,963,1764,761,227,988,94,1082
公投第７案,高雄市,三民區,寶業里,964,1811,766,229,995,47,1042
公投第７案,高雄市,三民區,寶業里,965,1693,768,233,1001,73,1074
公投第７案,高雄市,三民區,寶盛里,966,1684,789,247,1036,84,1120
公投第７案,高雄市,三民區,寶盛里,967,1464,621,153,774,68,842
公投第７案,高雄市,三民區,寶盛里,968,1719,844,222,1066,40,1106
公投第７案,高雄市,三民區,寶安里,969,1749,736,223,959,39,998
公投第７案,高雄市,三民區,寶安里,970,1908,808,187,995,44,1039
公投第７案,高雄市,三民區,寶安里,971,1573,735,170,905,62,967
公投第７案,高雄市,三民區,寶安里,972,1628,680,199,879,50,929
公投第７案,高雄市,三民區,寶龍里,973,1377,488,164,652,53,705
公投第７案,高雄市,三民區,寶龍里,974,1530,718,193,911,57,968
公投第７案,高雄市,三民區,寶龍里,975,1188,485,129,614,52,666
公投第７案,高雄市,三民區,寶珠里,976,2791,601,184,785,39,824
公投第７案,高雄市,三民區,寶珠里,977,1840,814,207,1021,62,1083
公投第７案,高雄市,三民區,寶珠里,978,1671,740,221,961,98,1059
公投第７案,高雄市,三民區,寶玉里,979,1624,693,223,916,64,980
公投第７案,高雄市,三民區,寶玉里,980,1555,770,218,988,70,1058
公投第７案,高雄市,三民區,寶玉里,981,1489,726,209,935,48,983
公投第７案,高雄市,三民區,寶玉里,982,1662,777,194,971,67,1038
公投第７案,高雄市,三民區,寶玉里,983,1639,708,187,895,24,919
公投第７案,高雄市,三民區,灣子里,984,1872,764,237,1001,86,1087
公投第７案,高雄市,三民區,灣子里,985,1968,832,209,1041,92,1133
公投第７案,高雄市,三民區,灣愛里,986,1471,538,135,673,113,786
公投第７案,高雄市,三民區,灣愛里,987,1534,630,181,811,68,879
公投第７案,高雄市,三民區,灣中里,988,1659,636,182,818,88,906
公投第７案,高雄市,三民區,灣中里,989,1815,675,171,846,46,892
公投第７案,高雄市,三民區,灣中里,990,1808,728,189,917,58,975
公投第７案,高雄市,三民區,灣華里,991,1224,463,138,601,36,637
公投第７案,高雄市,三民區,灣華里,992,1406,561,168,729,39,768
公投第７案,高雄市,三民區,灣勝里,993,945,380,106,486,32,518
公投第７案,高雄市,三民區,灣勝里,994,944,409,146,555,42,597
公投第７案,高雄市,三民區,灣利里,995,1669,660,230,890,80,970
公投第７案,高雄市,三民區,灣利里,996,1473,588,240,828,84,912
公投第７案,高雄市,三民區,灣復里,997,1876,692,197,889,68,957
公投第７案,高雄市,三民區,灣復里,998,1682,449,143,592,63,655
公投第７案,高雄市,三民區,正興里,999,1791,703,209,912,48,960
公投第７案,高雄市,三民區,正興里,1000,1808,781,244,1025,66,1091
公投第７案,高雄市,三民區,正興里,1001,1798,729,200,929,61,990
公投第７案,高雄市,三民區,正興里,1002,2030,907,272,1179,75,1254
公投第７案,高雄市,三民區,正興里,1003,2034,892,220,1112,30,1142
公投第７案,高雄市,三民區,正興里,1004,1998,882,222,1104,37,1141
公投第７案,高雄市,三民區,正順里,1005,1914,730,219,949,39,988
公投第７案,高雄市,三民區,正順里,1006,1965,794,214,1008,52,1060
公投第７案,高雄市,三民區,灣興里,1007,1885,746,250,996,97,1093
公投第７案,高雄市,三民區,灣成里,1008,1220,575,139,714,12,726
公投第７案,高雄市,三民區,灣成里,1009,1057,410,149,559,75,634
公投第７案,高雄市,三民區,安康里,1010,1434,470,149,619,29,648
公投第７案,高雄市,三民區,安康里,1011,1350,478,118,596,49,645
公投第７案,高雄市,三民區,安寧里,1012,872,294,83,377,25,402
公投第７案,高雄市,三民區,安寧里,1013,954,361,107,468,20,488
公投第７案,高雄市,三民區,安吉里,1014,1689,758,175,933,25,958
公投第７案,高雄市,三民區,安吉里,1015,1390,582,159,741,24,765
公投第７案,高雄市,三民區,安吉里,1016,1336,542,184,726,79,805
公投第７案,高雄市,三民區,安發里,1017,1437,670,224,894,58,952
公投第７案,高雄市,三民區,安發里,1018,1452,630,176,806,31,837
公投第７案,高雄市,三民區,安發里,1019,1513,644,207,851,83,934
公投第７案,高雄市,三民區,安東里,1020,1467,628,220,848,105,953
公投第７案,高雄市,三民區,安東里,1021,1381,616,238,854,82,936
公投第７案,高雄市,三民區,安和里,1022,1117,435,163,598,56,654
公投第７案,高雄市,三民區,安和里,1023,1327,594,178,772,37,809
公投第７案,高雄市,三民區,達德里,1024,1304,558,176,734,38,772
公投第７案,高雄市,三民區,達明里,1025,1483,528,203,731,38,769
公投第７案,高雄市,三民區,達仁里,1026,1473,609,241,850,52,902
公投第７案,高雄市,三民區,達勇里,1027,980,435,128,563,37,600
公投第７案,高雄市,三民區,同德里,1028,1409,616,187,803,68,871
公投第７案,高雄市,三民區,同德里,1029,1230,508,191,699,51,750
公投第７案,高雄市,三民區,德智里,1030,1024,455,163,618,65,683
公投第７案,高雄市,三民區,德智里,1031,1130,489,174,663,54,717
公投第７案,高雄市,三民區,德仁里,1032,1889,696,237,933,38,971
公投第７案,高雄市,三民區,安生里,1033,1427,572,210,782,36,818
公投第７案,高雄市,三民區,德東里,1034,791,356,93,449,20,469
公投第７案,高雄市,三民區,德行里,1035,1079,504,167,671,88,759
公投第７案,高雄市,三民區,精華里,1036,1492,576,237,813,80,893
公投第７案,高雄市,三民區,民享里,1037,1020,432,159,591,68,659
公投第７案,高雄市,三民區,民享里,1038,1001,422,140,562,13,575
公投第７案,高雄市,三民區,安宜里,1039,1581,656,202,858,52,910
公投第７案,高雄市,三民區,安宜里,1040,1471,562,211,773,50,823
公投第７案,高雄市,三民區,安泰里,1041,1151,488,143,631,26,657
公投第７案,高雄市,三民區,安泰里,1042,1334,582,202,784,66,850
公投第７案,高雄市,三民區,安泰里,1043,1275,557,161,718,53,771
公投第７案,高雄市,三民區,安邦里,1044,1688,536,174,710,50,760
公投第７案,高雄市,三民區,安邦里,1045,1214,485,171,656,39,695
公投第７案,高雄市,三民區,安邦里,1046,1149,541,152,693,30,723
公投第７案,高雄市,三民區,十全里,1047,1667,695,232,927,99,1026
公投第７案,高雄市,三民區,十美里,1048,1786,645,220,865,45,910
公投第７案,高雄市,三民區,德北里,1049,896,376,139,515,23,538
公投第７案,高雄市,三民區,德北里,1050,925,426,101,527,54,581
公投第７案,高雄市,三民區,立誠里,1051,684,312,100,412,52,464
公投第７案,高雄市,三民區,立業里,1052,981,444,156,600,57,657
公投第７案,高雄市,三民區,港東里,1053,1383,492,169,661,95,756
公投第７案,高雄市,三民區,港新里,1054,1382,543,192,735,58,793
公投第７案,高雄市,三民區,港西里,1055,808,340,85,425,27,452
公投第７案,高雄市,三民區,博愛里,1056,1197,502,170,672,32,704
公投第７案,高雄市,三民區,博惠里,1057,1344,541,162,703,56,759
公投第７案,高雄市,三民區,博惠里,1058,1344,533,216,749,65,814
公投第７案,高雄市,三民區,博惠里,1059,1359,596,175,771,20,791
公投第７案,高雄市,三民區,長明里,1060,1073,486,143,629,53,682
公投第７案,高雄市,三民區,建東里,1061,1186,477,138,615,55,670
公投第７案,高雄市,三民區,興德里,1062,1749,709,241,950,85,1035
公投第７案,高雄市,三民區,鳳南里,1063,877,332,99,431,18,449
公投第７案,高雄市,三民區,鳳北里,1064,1402,600,206,806,105,911
公投第７案,高雄市,三民區,德西里,1065,769,364,103,467,23,490
公投第７案,高雄市,三民區,豐裕里,1066,1207,534,145,679,67,746
公投第７案,高雄市,三民區,豐裕里,1067,1270,459,135,594,52,646
公投第７案,高雄市,三民區,川東里,1068,1248,518,146,664,60,724
公投第７案,高雄市,三民區,裕民里,1069,1263,553,146,699,86,785
公投第７案,高雄市,三民區,力行里,1070,1101,465,139,604,37,641
公投第７案,高雄市,三民區,千歲里,1071,1116,490,130,620,32,652
公投第７案,高雄市,三民區,立德里,1072,1152,483,148,631,33,664
公投第７案,高雄市,三民區,千北里,1073,1057,455,131,586,77,663
公投第７案,高雄市,三民區,千秋里,1074,971,359,107,466,52,518
公投第７案,高雄市,三民區,千秋里,1075,1062,411,138,549,25,574
公投第７案,高雄市,前金區,三川里,1076,673,256,76,332,18,350
公投第７案,高雄市,前金區,草江里,1077,1022,483,112,595,25,620
公投第７案,高雄市,前金區,長城里,1078,1324,541,132,673,41,714
公投第７案,高雄市,前金區,北金里,1079,839,353,105,458,50,508
公投第７案,高雄市,前金區,東金里,1080,975,373,144,517,74,591
公投第７案,高雄市,前金區,新生里,1081,1806,805,190,995,70,1065
公投第７案,高雄市,前金區,新生里,1082,1781,753,225,978,43,1021
公投第７案,高雄市,前金區,後金里,1083,717,317,96,413,37,450
公投第７案,高雄市,前金區,長興里,1084,1097,464,137,601,12,613
公投第７案,高雄市,前金區,青山里,1085,1633,670,214,884,33,917
公投第７案,高雄市,前金區,民生里,1086,759,360,117,477,37,514
公投第７案,高雄市,前金區,復元里,1087,948,417,149,566,56,622
公投第７案,高雄市,前金區,林投里,1088,1009,345,141,486,77,563
公投第７案,高雄市,前金區,國民里,1089,945,420,117,537,32,569
公投第７案,高雄市,前金區,社東里,1090,772,331,99,430,26,456
公投第７案,高雄市,前金區,社東里,1091,757,352,111,463,26,489
公投第７案,高雄市,前金區,社西里,1092,1047,475,130,605,41,646
公投第７案,高雄市,前金區,博孝里,1093,985,421,154,575,48,623
公投第７案,高雄市,前金區,長生里,1094,1674,557,318,875,26,901
公投第７案,高雄市,前金區,榮復里,1095,1088,448,136,584,31,615
公投第７案,高雄市,前金區,文西里,1096,893,416,130,546,55,601
公投第７案,高雄市,前金區,文東里,1097,1184,465,148,613,42,655
公投第７案,高雄市,新興區,浩然里,1098,828,342,111,453,35,488
公投第７案,高雄市,新興區,浩然里,1099,963,441,130,571,63,634
公投第７案,高雄市,新興區,振成里,1100,1075,426,123,549,29,578
公投第７案,高雄市,新興區,德生里,1101,1488,634,191,825,29,854
公投第７案,高雄市,新興區,德生里,1102,1438,632,166,798,42,840
公投第７案,高雄市,新興區,振華里,1103,1049,467,142,609,31,640
公投第７案,高雄市,新興區,正氣里,1104,1378,596,226,822,97,919
公投第７案,高雄市,新興區,德政里,1105,666,308,91,399,37,436
公投第７案,高雄市,新興區,仁聲里,1106,981,403,147,550,27,577
公投第７案,高雄市,新興區,德望里,1107,933,425,150,575,33,608
公投第７案,高雄市,新興區,德望里,1108,987,429,112,541,29,570
公投第７案,高雄市,新興區,華聲里,1109,988,463,109,572,42,614
公投第７案,高雄市,新興區,蕉園里,1110,735,343,94,437,45,482
公投第７案,高雄市,新興區,永寧里,1111,1317,554,192,746,33,779
公投第７案,高雄市,新興區,玉衡里,1112,800,315,78,393,17,410
公投第７案,高雄市,新興區,順昌里,1113,968,432,129,561,43,604
公投第７案,高雄市,新興區,順昌里,1114,913,416,115,531,27,558
公投第７案,高雄市,新興區,文昌里,1115,1389,604,226,830,27,857
公投第７案,高雄市,新興區,文昌里,1116,1228,593,182,775,51,826
公投第７案,高雄市,新興區,光耀里,1117,1211,535,151,686,80,766
公投第７案,高雄市,新興區,光耀里,1118,1101,504,128,632,16,648
公投第７案,高雄市,新興區,興昌里,1119,752,358,91,449,19,468
公投第７案,高雄市,新興區,興昌里,1120,873,424,136,560,57,617
公投第７案,高雄市,新興區,開平里,1121,1609,669,258,927,43,970
公投第７案,高雄市,新興區,開平里,1122,1736,785,242,1027,61,1088
公投第７案,高雄市,新興區,成功里,1123,1258,538,138,676,28,704
公投第７案,高雄市,新興區,新江里,1124,1105,475,153,628,58,686
公投第７案,高雄市,新興區,黎明里,1125,851,364,115,479,53,532
公投第７案,高雄市,新興區,愛平里,1126,1011,447,146,593,41,634
公投第７案,高雄市,新興區,南港里,1127,888,395,153,548,69,617
公投第７案,高雄市,新興區,南港里,1128,1005,430,117,547,32,579
公投第７案,高雄市,新興區,中東里,1129,1375,442,137,579,19,598
公投第７案,高雄市,新興區,中東里,1130,1388,605,191,796,57,853
公投第７案,高雄市,新興區,明莊里,1131,719,303,75,378,50,428
公投第７案,高雄市,新興區,大明里,1132,1077,427,144,571,77,648
公投第７案,高雄市,新興區,秋山里,1133,875,311,96,407,17,424
公投第７案,高雄市,新興區,長驛里,1134,936,367,112,479,23,502
公投第７案,高雄市,新興區,建興里,1135,944,382,109,491,62,553
公投第７案,高雄市,新興區,建華里,1136,833,312,94,406,32,438
公投第７案,高雄市,新興區,漢民里,1137,708,296,99,395,13,408
公投第７案,高雄市,新興區,榮治里,1138,741,338,67,405,18,423
公投第７案,高雄市,新興區,東坡里,1139,1235,426,170,596,36,632
公投第７案,高雄市,苓雅區,博仁里,1140,718,315,104,419,30,449
公投第７案,高雄市,苓雅區,苓洲里,1141,1492,655,145,800,46,846
公投第７案,高雄市,苓雅區,苓昇里,1142,1210,539,144,683,47,730
公投第７案,高雄市,苓雅區,苓中里,1143,1617,603,159,762,30,792
公投第７案,高雄市,苓雅區,苓雅里,1144,1428,636,162,798,80,878
公投第７案,高雄市,苓雅區,苓東里,1145,1444,514,173,687,51,738
公投第７案,高雄市,苓雅區,城北里,1146,1452,599,193,792,77,869
公投第７案,高雄市,苓雅區,城西里,1147,554,237,79,316,39,355
公投第７案,高雄市,苓雅區,城東里,1148,950,369,133,502,19,521
公投第７案,高雄市,苓雅區,城東里,1149,978,369,131,500,18,518
公投第７案,高雄市,苓雅區,意誠里,1150,1673,608,196,804,36,840
公投第７案,高雄市,苓雅區,意誠里,1151,2045,770,244,1014,59,1073
公投第７案,高雄市,苓雅區,鼓中里,1152,939,378,143,521,69,590
公投第７案,高雄市,苓雅區,田西里,1153,1284,515,140,655,37,692
公投第７案,高雄市,苓雅區,人和里,1154,908,405,111,516,27,543
公投第７案,高雄市,苓雅區,人和里,1155,838,348,96,444,16,460
公投第７案,高雄市,苓雅區,仁政里,1156,1267,552,180,732,39,771
公投第７案,高雄市,苓雅區,廣澤里,1157,994,65,147,212,51,263
公投第７案,高雄市,苓雅區,廣澤里,1158,774,266,114,380,21,401
公投第７案,高雄市,苓雅區,美田里,1159,1121,494,137,631,27,658
公投第７案,高雄市,苓雅區,華堂里,1160,1474,589,212,801,65,866
公投第７案,高雄市,苓雅區,華堂里,1161,1525,655,216,871,71,942
公投第７案,高雄市,苓雅區,日中里,1162,1147,594,30,624,32,656
公投第７案,高雄市,苓雅區,日中里,1163,1014,455,144,599,36,635
公投第７案,高雄市,苓雅區,普照里,1164,1496,615,232,847,59,906
公投第７案,高雄市,苓雅區,普照里,1165,1499,670,202,872,69,941
公投第７案,高雄市,苓雅區,和煦里,1166,1138,521,142,663,31,694
公投第７案,高雄市,苓雅區,和煦里,1167,839,419,119,538,41,579
公投第７案,高雄市,苓雅區,晴朗里,1168,2088,529,142,671,43,714
公投第７案,高雄市,苓雅區,普天里,1169,1648,704,223,927,39,966
公投第７案,高雄市,苓雅區,普天里,1170,1623,676,208,884,68,952
公投第７案,高雄市,苓雅區,林富里,1171,1932,805,364,1169,58,1227
公投第７案,高雄市,苓雅區,林圍里,1172,1127,587,150,737,24,761
公投第７案,高雄市,苓雅區,林圍里,1173,1156,585,164,749,25,774
公投第７案,高雄市,苓雅區,林安里,1174,1465,671,196,867,36,903
公投第７案,高雄市,苓雅區,光華里,1175,690,268,64,332,29,361
公投第７案,高雄市,苓雅區,林興里,1176,1283,492,146,638,93,731
公投第７案,高雄市,苓雅區,林華里,1177,1432,600,185,785,75,860
公投第７案,高雄市,苓雅區,林華里,1178,1313,579,156,735,48,783
公投第７案,高雄市,苓雅區,林西里,1179,1579,606,201,807,24,831
公投第７案,高雄市,苓雅區,林中里,1180,1385,570,197,767,67,834
公投第７案,高雄市,苓雅區,林中里,1181,1449,654,169,823,63,886
公投第７案,高雄市,苓雅區,林泉里,1182,1834,860,235,1095,48,1143
公投第７案,高雄市,苓雅區,林南里,1183,1436,641,199,840,58,898
公投第７案,高雄市,苓雅區,林南里,1184,1431,673,188,861,55,916
公投第７案,高雄市,苓雅區,中正里,1185,1248,588,185,773,16,789
公投第７案,高雄市,苓雅區,中正里,1186,1470,707,186,893,39,932
公投第７案,高雄市,苓雅區,尚義里,1187,1540,743,193,936,82,1018
公投第７案,高雄市,苓雅區,同慶里,1188,1374,637,192,829,30,859
公投第７案,高雄市,苓雅區,同慶里,1189,839,409,121,530,24,554
公投第７案,高雄市,苓雅區,凱旋里,1190,1022,519,134,653,36,689
公投第７案,高雄市,苓雅區,凱旋里,1191,1062,532,132,664,15,679
公投第７案,高雄市,苓雅區,安祥里,1192,1078,483,143,626,21,647
公投第７案,高雄市,苓雅區,安祥里,1193,1117,519,174,693,25,718
公投第７案,高雄市,苓雅區,奏捷里,1194,1516,690,203,893,43,936
公投第７案,高雄市,苓雅區,福壽里,1195,1440,559,215,774,114,888
公投第７案,高雄市,苓雅區,福南里,1196,839,358,117,475,37,512
公投第７案,高雄市,苓雅區,福南里,1197,888,359,100,459,27,486
公投第７案,高雄市,苓雅區,五權里,1198,1101,501,159,660,31,691
公投第７案,高雄市,苓雅區,五權里,1199,1004,485,166,651,63,714
公投第７案,高雄市,苓雅區,民主里,1200,1427,624,185,809,64,873
公投第７案,高雄市,苓雅區,民主里,1201,1168,502,157,659,31,690
公投第７案,高雄市,苓雅區,民主里,1202,1184,557,179,736,59,795
公投第７案,高雄市,苓雅區,林德里,1203,974,442,137,579,35,614
公投第７案,高雄市,苓雅區,林德里,1204,849,331,95,426,14,440
公投第７案,高雄市,苓雅區,林貴里,1205,1821,822,222,1044,52,1096
公投第７案,高雄市,苓雅區,林榮里,1206,1306,587,178,765,54,819
公投第７案,高雄市,苓雅區,林榮里,1207,1185,540,163,703,26,729
公投第７案,高雄市,苓雅區,林榮里,1208,1415,583,196,779,50,829
公投第７案,高雄市,苓雅區,英明里,1209,962,455,137,592,40,632
公投第７案,高雄市,苓雅區,英明里,1210,964,394,125,519,70,589
公投第７案,高雄市,苓雅區,林靖里,1211,1524,659,204,863,35,898
公投第７案,高雄市,苓雅區,朝陽里,1212,1455,611,236,847,30,877
公投第７案,高雄市,苓雅區,福隆里,1213,1272,478,154,632,41,673
公投第７案,高雄市,苓雅區,福隆里,1214,1256,500,144,644,30,674
公投第７案,高雄市,苓雅區,福祥里,1215,1203,508,130,638,34,672
公投第７案,高雄市,苓雅區,福海里,1216,1062,500,119,619,20,639
公投第７案,高雄市,苓雅區,福康里,1217,850,379,125,504,64,568
公投第７案,高雄市,苓雅區,福康里,1218,1010,445,146,591,87,678
公投第７案,高雄市,苓雅區,福人里,1219,1118,483,117,600,31,631
公投第７案,高雄市,苓雅區,福人里,1220,937,421,115,536,56,592
公投第７案,高雄市,苓雅區,福地里,1221,1493,551,156,707,30,737
公投第７案,高雄市,苓雅區,福地里,1222,1183,540,138,678,30,708
公投第７案,高雄市,苓雅區,福居里,1223,1318,508,117,625,33,658
公投第７案,高雄市,苓雅區,福居里,1224,1362,553,188,741,52,793
公投第７案,高雄市,苓雅區,福東里,1225,1102,434,143,577,88,665
公投第７案,高雄市,苓雅區,福東里,1226,1481,625,178,803,69,872
公投第７案,高雄市,苓雅區,福西里,1227,878,399,125,524,58,582
公投第７案,高雄市,苓雅區,福西里,1228,908,331,111,442,21,463
公投第７案,高雄市,苓雅區,永康里,1229,1056,502,136,638,50,688
公投第７案,高雄市,苓雅區,永康里,1230,1091,418,122,540,39,579
公投第７案,高雄市,苓雅區,正文里,1231,976,440,143,583,25,608
公投第７案,高雄市,苓雅區,正文里,1232,1063,490,171,661,45,706
公投第７案,高雄市,苓雅區,正言里,1233,1484,680,187,867,70,937
公投第７案,高雄市,苓雅區,正言里,1234,1290,523,222,745,33,778
公投第７案,高雄市,苓雅區,正大里,1235,1740,779,220,999,63,1062
公投第７案,高雄市,苓雅區,正大里,1236,1594,777,197,974,68,1042
公投第７案,高雄市,苓雅區,正大里,1237,1648,729,168,897,25,922
公投第７案,高雄市,苓雅區,五福里,1238,1236,588,150,738,62,800
公投第７案,高雄市,苓雅區,五福里,1239,1211,534,164,698,45,743
公投第７案,高雄市,苓雅區,五福里,1240,1283,527,164,691,31,722
公投第７案,高雄市,苓雅區,正心里,1241,1804,797,244,1041,86,1127
公投第７案,高雄市,苓雅區,正心里,1242,1718,783,242,1025,63,1088
公投第７案,高雄市,苓雅區,正道里,1243,1297,596,163,759,56,815
公投第７案,高雄市,苓雅區,正道里,1244,1449,613,194,807,84,891
公投第７案,高雄市,苓雅區,正道里,1245,1307,577,178,755,30,785
公投第７案,高雄市,苓雅區,正義里,1246,1184,551,149,700,51,751
公投第７案,高雄市,苓雅區,正義里,1247,1250,579,185,764,80,844
公投第７案,高雄市,苓雅區,正仁里,1248,1248,507,170,677,36,713
公投第７案,高雄市,苓雅區,正仁里,1249,1283,574,155,729,26,755
公投第７案,高雄市,苓雅區,文昌里,1250,1121,513,124,637,30,667
公投第７案,高雄市,苓雅區,文昌里,1251,1258,540,171,711,26,737
公投第７案,高雄市,苓雅區,文昌里,1252,1339,588,144,732,33,765
公投第７案,高雄市,苓雅區,建軍里,1253,1986,770,268,1038,60,1098
公投第７案,高雄市,苓雅區,衛武里,1254,1028,451,112,563,34,597
公投第７案,高雄市,苓雅區,衛武里,1255,948,432,119,551,18,569
公投第７案,高雄市,鳳山區,鳳崗里,1256,1080,505,152,657,52,709
公投第７案,高雄市,鳳山區,縣衙里,1257,819,384,94,478,37,515
公投第７案,高雄市,鳳山區,曹公里,1258,851,380,84,464,67,531
公投第７案,高雄市,鳳山區,曹公里,1259,1075,482,150,632,39,671
公投第７案,高雄市,鳳山區,鎮西里,1260,1223,579,140,719,33,752
公投第７案,高雄市,鳳山區,鎮西里,1261,1207,551,154,705,40,745
公投第７案,高雄市,鳳山區,鎮西里,1262,1339,522,173,695,38,733
公投第７案,高雄市,鳳山區,鎮西里,1263,1188,473,101,574,39,613
公投第７案,高雄市,鳳山區,北門里,1264,1055,490,95,585,55,640
公投第７案,高雄市,鳳山區,北門里,1265,1109,467,102,569,68,637
公投第７案,高雄市,鳳山區,北門里,1266,756,382,97,479,39,518
公投第７案,高雄市,鳳山區,北門里,1267,1182,491,117,608,36,644
公投第７案,高雄市,鳳山區,鎮北里,1268,1496,654,156,810,78,888
公投第７案,高雄市,鳳山區,鎮北里,1269,2094,785,194,979,65,1044
公投第７案,高雄市,鳳山區,鎮北里,1270,1672,704,176,880,27,907
公投第７案,高雄市,鳳山區,鎮北里,1271,1761,752,172,924,29,953
公投第７案,高雄市,鳳山區,鎮北里,1272,1450,637,162,799,61,860
公投第７案,高雄市,鳳山區,武松里,1273,1455,566,148,714,38,752
公投第７案,高雄市,鳳山區,武松里,1274,1234,523,148,671,61,732
公投第７案,高雄市,鳳山區,忠誠里,1275,1713,797,307,1104,66,1170
公投第７案,高雄市,鳳山區,忠誠里,1276,1698,708,139,847,29,876
公投第７案,高雄市,鳳山區,文英里,1277,1247,540,164,704,68,772
公投第７案,高雄市,鳳山區,文英里,1278,1087,474,137,611,47,658
公投第７案,高雄市,鳳山區,文英里,1279,1199,555,130,685,20,705
公投第７案,高雄市,鳳山區,文華里,1280,1559,752,94,846,53,899
公投第７案,高雄市,鳳山區,文華里,1281,1233,561,126,687,41,728
公投第７案,高雄市,鳳山區,文華里,1282,1277,563,147,710,48,758
公投第７案,高雄市,鳳山區,文華里,1283,1481,672,119,791,20,811
公投第７案,高雄市,鳳山區,文華里,1284,1154,566,154,720,16,736
公投第７案,高雄市,鳳山區,文華里,1285,1475,676,191,867,31,898
公投第７案,高雄市,鳳山區,文山里,1286,1247,499,114,613,33,646
公投第７案,高雄市,鳳山區,文山里,1287,1538,607,166,773,76,849
公投第７案,高雄市,鳳山區,文山里,1288,1097,436,142,578,36,614
公投第７案,高雄市,鳳山區,文山里,1289,1221,451,145,596,25,621
公投第７案,高雄市,鳳山區,文山里,1290,1075,533,146,679,54,733
公投第７案,高雄市,鳳山區,文德里,1291,1751,805,210,1015,42,1057
公投第７案,高雄市,鳳山區,文德里,1292,1758,795,208,1003,44,1047
公投第７案,高雄市,鳳山區,文德里,1293,1749,754,199,953,82,1035
公投第７案,高雄市,鳳山區,文德里,1294,1746,771,163,934,21,955
公投第７案,高雄市,鳳山區,文德里,1295,1712,747,167,914,49,963
公投第７案,高雄市,鳳山區,文衡里,1296,1247,588,128,716,37,753
公投第７案,高雄市,鳳山區,文衡里,1297,1409,613,190,803,54,857
公投第７案,高雄市,鳳山區,文衡里,1298,1347,595,159,754,52,806
公投第７案,高雄市,鳳山區,文福里,1299,1771,759,195,954,27,981
公投第７案,高雄市,鳳山區,文福里,1300,1537,698,157,855,16,871
公投第７案,高雄市,鳳山區,文福里,1301,1605,746,173,919,27,946
公投第７案,高雄市,鳳山區,文福里,1302,1375,627,144,771,52,823
公投第７案,高雄市,鳳山區,文福里,1303,1393,640,167,807,65,872
公投第７案,高雄市,鳳山區,文福里,1304,1584,654,176,830,27,857
公投第７案,高雄市,鳳山區,成功里,1305,618,241,93,334,20,354
公投第７案,高雄市,鳳山區,縣口里,1306,423,203,36,239,11,250
公投第７案,高雄市,鳳山區,光明里,1307,1312,544,162,706,59,765
公投第７案,高雄市,鳳山區,和德里,1308,769,329,95,424,30,454
公投第７案,高雄市,鳳山區,和德里,1309,1213,591,136,727,21,748
公投第７案,高雄市,鳳山區,和興里,1310,1107,548,136,684,34,718
公投第７案,高雄市,鳳山區,和興里,1311,1188,511,168,679,30,709
公投第７案,高雄市,鳳山區,和興里,1312,1183,528,162,690,41,731
公投第７案,高雄市,鳳山區,和興里,1313,1264,546,179,725,55,780
公投第７案,高雄市,鳳山區,南興里,1314,882,363,124,487,30,517
公投第７案,高雄市,鳳山區,三民里,1315,1007,506,151,657,46,703
公投第７案,高雄市,鳳山區,新興里,1316,853,358,100,458,75,533
公投第７案,高雄市,鳳山區,新興里,1317,1660,322,97,419,54,473
公投第７案,高雄市,鳳山區,興仁里,1318,1124,514,138,652,37,689
公投第７案,高雄市,鳳山區,興仁里,1319,1112,465,167,632,60,692
公投第７案,高雄市,鳳山區,興仁里,1320,1182,486,130,616,40,656
公投第７案,高雄市,鳳山區,興中里,1321,875,464,118,582,45,627
公投第７案,高雄市,鳳山區,協和里,1322,1040,441,154,595,44,639
公投第７案,高雄市,鳳山區,協和里,1323,1094,514,157,671,26,697
公投第７案,高雄市,鳳山區,協和里,1324,1217,525,173,698,61,759
公投第７案,高雄市,鳳山區,忠義里,1325,974,491,137,628,38,666
公投第７案,高雄市,鳳山區,忠義里,1326,987,469,92,561,39,600
公投第７案,高雄市,鳳山區,忠義里,1327,1210,612,143,755,21,776
公投第７案,高雄市,鳳山區,忠義里,1328,1391,578,186,764,65,829
公投第７案,高雄市,鳳山區,忠孝里,1329,1241,458,136,594,22,616
公投第７案,高雄市,鳳山區,忠孝里,1330,1000,483,113,596,48,644
公投第７案,高雄市,鳳山區,忠孝里,1331,1092,511,109,620,44,664
公投第７案,高雄市,鳳山區,忠孝里,1332,1308,612,150,762,48,810
公投第７案,高雄市,鳳山區,忠孝里,1333,1031,481,112,593,55,648
公投第７案,高雄市,鳳山區,中和里,1334,1159,514,172,686,59,745
公投第７案,高雄市,鳳山區,中和里,1335,1127,491,119,610,63,673
公投第７案,高雄市,鳳山區,中和里,1336,1109,565,183,748,45,793
公投第７案,高雄市,鳳山區,誠義里,1337,1879,895,233,1128,64,1192
公投第７案,高雄市,鳳山區,誠義里,1338,1803,941,208,1149,49,1198
公投第７案,高雄市,鳳山區,生明里,1339,2045,842,174,1016,88,1104
公投第７案,高雄市,鳳山區,鎮東里,1340,1432,596,164,760,58,818
公投第７案,高雄市,鳳山區,鎮東里,1341,1033,423,95,518,20,538
公投第７案,高雄市,鳳山區,瑞竹里,1342,1253,551,169,720,82,802
公投第７案,高雄市,鳳山區,瑞竹里,1343,1217,546,156,702,24,726
公投第７案,高雄市,鳳山區,瑞竹里,1344,1267,620,139,759,48,807
公投第７案,高雄市,鳳山區,瑞竹里,1345,1251,510,137,647,42,689
公投第７案,高雄市,鳳山區,瑞興里,1346,1563,706,157,863,75,938
公投第７案,高雄市,鳳山區,瑞興里,1347,1888,910,189,1099,62,1161
公投第７案,高雄市,鳳山區,瑞興里,1348,1368,597,176,773,63,836
公投第７案,高雄市,鳳山區,東門里,1349,1588,659,158,817,42,859
公投第７案,高雄市,鳳山區,東門里,1350,1255,646,104,750,51,801
公投第７案,高雄市,鳳山區,東門里,1351,1264,551,146,697,67,764
公投第７案,高雄市,鳳山區,東門里,1352,1291,585,142,727,72,799
公投第７案,高雄市,鳳山區,誠德里,1353,1224,555,108,663,39,702
公投第７案,高雄市,鳳山區,誠德里,1354,1296,590,129,719,40,759
公投第７案,高雄市,鳳山區,誠信里,1355,826,406,99,505,51,556
公投第７案,高雄市,鳳山區,誠信里,1356,1229,567,138,705,44,749
公投第７案,高雄市,鳳山區,誠智里,1357,1467,726,130,856,47,903
公投第７案,高雄市,鳳山區,誠智里,1358,1218,550,134,684,61,745
公投第７案,高雄市,鳳山區,鳳東里,1359,2173,898,240,1138,75,1213
公投第７案,高雄市,鳳山區,鳳東里,1360,2255,1001,250,1251,68,1319
公投第７案,高雄市,鳳山區,鳳東里,1361,1556,718,165,883,41,924
公投第７案,高雄市,鳳山區,埤頂里,1362,1521,630,164,794,53,847
公投第７案,高雄市,鳳山區,埤頂里,1363,1407,571,124,695,40,735
公投第７案,高雄市,鳳山區,埤頂里,1364,1542,720,155,875,63,938
公投第７案,高雄市,鳳山區,埤頂里,1365,1502,640,125,765,22,787
公投第７案,高雄市,鳳山區,中正里,1366,1320,629,144,773,52,825
公投第７案,高雄市,鳳山區,中正里,1367,1507,711,93,804,31,835
公投第７案,高雄市,鳳山區,中正里,1368,1284,687,103,790,84,874
公投第７案,高雄市,鳳山區,海光里,1369,1441,610,140,750,40,790
公投第７案,高雄市,鳳山區,海光里,1370,1485,705,126,831,82,913
公投第７案,高雄市,鳳山區,國泰里,1371,1205,457,175,632,68,700
公投第７案,高雄市,鳳山區,國泰里,1372,1284,528,146,674,21,695
公投第７案,高雄市,鳳山區,國泰里,1373,1326,563,193,756,69,825
公投第７案,高雄市,鳳山區,國光里,1374,1096,469,148,617,24,641
公投第７案,高雄市,鳳山區,國光里,1375,1182,512,170,682,74,756
公投第７案,高雄市,鳳山區,國光里,1376,1017,502,137,639,55,694
公投第７案,高雄市,鳳山區,國隆里,1377,1198,463,165,628,81,709
公投第７案,高雄市,鳳山區,國隆里,1378,1281,470,148,618,33,651
公投第７案,高雄市,鳳山區,國富里,1379,1358,627,187,814,43,857
公投第７案,高雄市,鳳山區,國富里,1380,1226,617,151,768,40,808
公投第７案,高雄市,鳳山區,武慶里,1381,1098,524,125,649,62,711
公投第７案,高雄市,鳳山區,武慶里,1382,1200,536,146,682,38,720
公投第７案,高雄市,鳳山區,武漢里,1383,942,404,104,508,44,552
公投第７案,高雄市,鳳山區,武漢里,1384,1206,501,120,621,34,655
公投第７案,高雄市,鳳山區,武漢里,1385,1159,565,148,713,35,748
公投第７案,高雄市,鳳山區,武漢里,1386,1401,659,167,826,55,881
公投第７案,高雄市,鳳山區,新甲里,1387,1525,618,171,789,23,812
公投第７案,高雄市,鳳山區,新甲里,1388,1345,557,170,727,41,768
公投第７案,高雄市,鳳山區,新武里,1389,1180,544,149,693,39,732
公投第７案,高雄市,鳳山區,新武里,1390,1106,439,117,556,26,582
公投第７案,高雄市,鳳山區,新泰里,1391,1442,679,181,860,60,920
公投第７案,高雄市,鳳山區,新泰里,1392,1376,633,177,810,46,856
公投第７案,高雄市,鳳山區,新泰里,1393,1243,539,157,696,29,725
公投第７案,高雄市,鳳山區,新樂里,1394,1361,627,124,751,23,774
公投第７案,高雄市,鳳山區,新樂里,1395,1416,615,194,809,73,882
公投第７案,高雄市,鳳山區,新樂里,1396,1536,735,204,939,75,1014
公投第７案,高雄市,鳳山區,新強里,1397,1388,544,155,699,24,723
公投第７案,高雄市,鳳山區,新強里,1398,1241,545,153,698,73,771
公投第７案,高雄市,鳳山區,新強里,1399,1394,667,162,829,51,880
公投第７案,高雄市,鳳山區,新強里,1400,1188,599,146,745,28,773
公投第７案,高雄市,鳳山區,海洋里,1401,1112,474,150,624,39,663
公投第７案,高雄市,鳳山區,海洋里,1402,1198,540,185,725,56,781
公投第７案,高雄市,鳳山區,海洋里,1403,1475,619,182,801,44,845
公投第７案,高雄市,鳳山區,新富里,1404,1216,493,120,613,30,643
公投第７案,高雄市,鳳山區,新富里,1405,1318,475,144,619,35,654
公投第７案,高雄市,鳳山區,新富里,1406,1465,635,157,792,23,815
公投第７案,高雄市,鳳山區,老爺里,1407,1314,506,143,649,37,686
公投第７案,高雄市,鳳山區,老爺里,1408,1649,639,151,790,24,814
公投第７案,高雄市,鳳山區,老爺里,1409,1601,625,175,800,93,893
公投第７案,高雄市,鳳山區,老爺里,1410,1155,473,130,603,25,628
公投第７案,高雄市,鳳山區,老爺里,1411,1050,457,121,578,62,640
公投第７案,高雄市,鳳山區,中民里,1412,1417,553,134,687,24,711
公投第７案,高雄市,鳳山區,中民里,1413,1525,656,164,820,63,883
公投第７案,高雄市,鳳山區,中民里,1414,1514,681,181,862,63,925
公投第７案,高雄市,鳳山區,中崙里,1415,1190,547,107,654,49,703
公投第７案,高雄市,鳳山區,中崙里,1416,1325,567,122,689,23,712
公投第７案,高雄市,鳳山區,中榮里,1417,1049,472,122,594,60,654
公投第７案,高雄市,鳳山區,中榮里,1418,1026,477,86,563,34,597
公投第７案,高雄市,鳳山區,中榮里,1419,1152,498,168,666,54,720
公投第７案,高雄市,鳳山區,中榮里,1420,1254,493,127,620,23,643
公投第７案,高雄市,鳳山區,過埤里,1421,1688,597,171,768,106,874
公投第７案,高雄市,鳳山區,過埤里,1422,1657,707,146,853,67,920
公投第７案,高雄市,鳳山區,過埤里,1423,1729,811,54,865,43,908
公投第７案,高雄市,鳳山區,過埤里,1424,1628,741,185,926,52,978
公投第７案,高雄市,鳳山區,過埤里,1425,1891,732,177,909,19,928
公投第７案,高雄市,鳳山區,過埤里,1426,1594,863,167,1030,55,1085
公投第７案,高雄市,鳳山區,過埤里,1427,1342,674,144,818,19,837
公投第７案,高雄市,鳳山區,過埤里,1428,1448,716,189,905,42,947
公投第７案,高雄市,鳳山區,正義里,1429,1405,632,167,799,69,868
公投第７案,高雄市,鳳山區,正義里,1430,1097,484,153,637,77,714
公投第７案,高雄市,鳳山區,正義里,1431,1248,531,199,730,87,817
公投第７案,高雄市,鳳山區,正義里,1432,1225,519,173,692,70,762
公投第７案,高雄市,鳳山區,正義里,1433,1214,487,149,636,37,673
公投第７案,高雄市,鳳山區,保安里,1434,2032,1052,134,1186,88,1274
公投第７案,高雄市,鳳山區,保安里,1435,1927,861,204,1065,80,1145
公投第７案,高雄市,鳳山區,保安里,1436,2097,991,234,1225,72,1297
公投第７案,高雄市,鳳山區,一甲里,1437,968,384,128,512,54,566
公投第７案,高雄市,鳳山區,一甲里,1438,1200,488,120,608,68,676
公投第７案,高雄市,鳳山區,一甲里,1439,1101,459,143,602,68,670
公投第７案,高雄市,鳳山區,二甲里,1440,1369,535,166,701,42,743
公投第７案,高雄市,鳳山區,二甲里,1441,1542,643,189,832,76,908
公投第７案,高雄市,鳳山區,二甲里,1442,1536,707,185,892,58,950
公投第７案,高雄市,鳳山區,龍成里,1443,1382,521,167,688,30,718
公投第７案,高雄市,鳳山區,龍成里,1444,1452,585,194,779,97,876
公投第７案,高雄市,鳳山區,鎮南里,1445,1058,468,107,575,52,627
公投第７案,高雄市,鳳山區,鎮南里,1446,976,477,106,583,52,635
公投第７案,高雄市,鳳山區,鎮南里,1447,1545,598,159,757,39,796
公投第７案,高雄市,鳳山區,鎮南里,1448,1143,465,155,620,53,673
公投第７案,高雄市,鳳山區,富甲里,1449,1301,254,64,318,15,333
公投第７案,高雄市,鳳山區,富甲里,1450,1250,426,135,561,27,588
公投第７案,高雄市,鳳山區,善美里,1451,1208,524,127,651,56,707
公投第７案,高雄市,鳳山區,善美里,1452,1202,523,126,649,91,740
公投第７案,高雄市,鳳山區,善美里,1453,1499,632,153,785,73,858
公投第７案,高雄市,鳳山區,善美里,1454,1522,633,164,797,51,848
公投第７案,高雄市,鳳山區,富榮里,1455,1125,520,141,661,56,717
公投第７案,高雄市,鳳山區,富榮里,1456,1307,581,141,722,40,762
公投第７案,高雄市,鳳山區,南和里,1457,1405,564,195,759,71,830
公投第７案,高雄市,鳳山區,南和里,1458,1252,541,147,688,72,760
公投第７案,高雄市,鳳山區,南成里,1459,1291,613,142,755,31,786
公投第７案,高雄市,鳳山區,南成里,1460,938,419,104,523,69,592
公投第７案,高雄市,鳳山區,南成里,1461,1783,753,231,984,52,1036
公投第７案,高雄市,鳳山區,南成里,1462,1105,519,105,624,37,661
公投第７案,高雄市,鳳山區,南成里,1463,1392,545,171,716,89,805
公投第７案,高雄市,鳳山區,南成里,1464,1244,624,165,789,41,830
公投第７案,高雄市,鳳山區,天興里,1465,1154,448,142,590,56,646
公投第７案,高雄市,鳳山區,天興里,1466,1153,490,147,637,62,699
公投第７案,高雄市,鳳山區,天興里,1467,1148,419,110,529,21,550
公投第７案,高雄市,鳳山區,大德里,1468,1432,555,150,705,121,826
公投第７案,高雄市,鳳山區,大德里,1469,1429,419,143,562,25,587
公投第７案,高雄市,鳳山區,大德里,1470,1479,627,155,782,27,809
公投第７案,高雄市,鳳山區,五福里,1471,1026,454,131,585,54,639
公投第７案,高雄市,鳳山區,五福里,1472,993,429,156,585,90,675
公投第７案,高雄市,鳳山區,五福里,1473,947,433,108,541,70,611
公投第７案,高雄市,鳳山區,福興里,1474,1042,447,86,533,66,599
公投第７案,高雄市,鳳山區,福興里,1475,1098,471,129,600,61,661
公投第７案,高雄市,鳳山區,福興里,1476,1284,488,138,626,23,649
公投第７案,高雄市,鳳山區,福興里,1477,1242,471,148,619,48,667
公投第７案,高雄市,鳳山區,福興里,1478,1093,482,130,612,77,689
公投第７案,高雄市,鳳山區,福祥里,1479,1353,521,179,700,48,748
公投第７案,高雄市,鳳山區,福祥里,1480,1353,525,144,669,26,695
公投第７案,高雄市,鳳山區,福誠里,1481,1309,572,163,735,65,800
公投第７案,高雄市,鳳山區,福誠里,1482,1627,707,178,885,55,940
公投第７案,高雄市,鳳山區,福誠里,1483,1372,589,158,747,88,835
公投第７案,高雄市,前鎮區,草衙里,1484,1809,554,222,776,130,906
公投第７案,高雄市,前鎮區,草衙里,1485,1835,698,232,930,91,1021
公投第７案,高雄市,前鎮區,草衙里,1486,1890,592,173,765,78,843
公投第７案,高雄市,前鎮區,草衙里,1487,2013,706,206,912,66,978
公投第７案,高雄市,前鎮區,草衙里,1488,1776,654,219,873,75,948
公投第７案,高雄市,前鎮區,明孝里,1489,1705,549,186,735,96,831
公投第７案,高雄市,前鎮區,明孝里,1490,672,271,75,346,76,422
公投第７案,高雄市,前鎮區,明正里,1491,1726,577,176,753,92,845
公投第７案,高雄市,前鎮區,明正里,1492,1597,663,182,845,35,880
公投第７案,高雄市,前鎮區,明正里,1493,1690,698,220,918,82,1000
公投第７案,高雄市,前鎮區,明義里,1494,1080,480,133,613,73,686
公投第７案,高雄市,前鎮區,明義里,1495,1159,530,169,699,66,765
公投第７案,高雄市,前鎮區,仁愛里,1496,1314,501,138,639,74,713
公投第７案,高雄市,前鎮區,德昌里,1497,896,405,90,495,65,560
公投第７案,高雄市,前鎮區,德昌里,1498,1002,428,127,555,39,594
公投第７案,高雄市,前鎮區,平等里,1499,2765,731,223,954,112,1066
公投第７案,高雄市,前鎮區,平昌里,1500,600,260,49,309,69,378
公投第７案,高雄市,前鎮區,明禮里,1501,1466,353,116,469,48,517
公投第７案,高雄市,前鎮區,信義里,1502,1449,551,160,711,46,757
公投第７案,高雄市,前鎮區,信德里,1503,991,381,107,488,57,545
公投第７案,高雄市,前鎮區,信德里,1504,1248,533,142,675,79,754
公投第７案,高雄市,前鎮區,明道里,1505,1066,456,123,579,100,679
公投第７案,高雄市,前鎮區,興化里,1506,706,233,64,297,33,330
公投第７案,高雄市,前鎮區,興仁里,1507,713,255,77,332,37,369
公投第７案,高雄市,前鎮區,前鎮里,1508,1344,470,167,637,43,680
公投第７案,高雄市,前鎮區,鎮東里,1509,856,344,119,463,54,517
公投第７案,高雄市,前鎮區,鎮東里,1510,873,286,113,399,42,441
公投第７案,高雄市,前鎮區,鎮榮里,1511,1114,409,110,519,49,568
公投第７案,高雄市,前鎮區,鎮榮里,1512,1112,362,120,482,21,503
公投第７案,高雄市,前鎮區,鎮昌里,1513,1044,396,125,521,64,585
公投第７案,高雄市,前鎮區,鎮昌里,1514,940,349,113,462,54,516
公投第７案,高雄市,前鎮區,鎮海里,1515,1342,492,136,628,74,702
公投第７案,高雄市,前鎮區,鎮海里,1516,1402,673,192,865,62,927
公投第７案,高雄市,前鎮區,鎮海里,1517,1320,577,179,756,42,798
公投第７案,高雄市,前鎮區,鎮陽里,1518,958,384,118,502,70,572
公投第７案,高雄市,前鎮區,興邦里,1519,1276,658,166,824,44,868
公投第７案,高雄市,前鎮區,興邦里,1520,1459,657,157,814,97,911
公投第７案,高雄市,前鎮區,鎮中里,1521,761,239,101,340,20,360
公投第７案,高雄市,前鎮區,鎮北里,1522,1093,404,134,538,23,561
公投第７案,高雄市,前鎮區,忠純里,1523,1521,783,136,919,42,961
公投第７案,高雄市,前鎮區,忠純里,1524,1557,767,146,913,45,958
公投第７案,高雄市,前鎮區,忠純里,1525,1821,766,143,909,78,987
公投第７案,高雄市,前鎮區,忠誠里,1526,1066,583,115,698,39,737
公投第７案,高雄市,前鎮區,忠誠里,1527,1046,577,84,661,21,682
公投第７案,高雄市,前鎮區,西山里,1528,1709,686,251,937,55,992
公投第７案,高雄市,前鎮區,西山里,1529,1723,737,239,976,88,1064
公投第７案,高雄市,前鎮區,民權里,1530,1202,556,178,734,53,787
公投第７案,高雄市,前鎮區,民權里,1531,1279,577,219,796,42,838
公投第７案,高雄市,前鎮區,民權里,1532,1513,730,199,929,49,978
公投第７案,高雄市,前鎮區,建隆里,1533,1260,578,112,690,18,708
公投第７案,高雄市,前鎮區,振興里,1534,1139,506,158,664,84,748
公投第７案,高雄市,前鎮區,振興里,1535,1140,547,164,711,49,760
公投第７案,高雄市,前鎮區,良和里,1536,1462,642,204,846,73,919
公投第７案,高雄市,前鎮區,良和里,1537,1359,611,178,789,53,842
公投第７案,高雄市,前鎮區,西甲里,1538,2037,701,262,963,97,1060
公投第７案,高雄市,前鎮區,盛興里,1539,1410,591,145,736,28,764
公投第７案,高雄市,前鎮區,盛興里,1540,1307,524,183,707,23,730
公投第７案,高雄市,前鎮區,盛豐里,1541,1512,593,211,804,87,891
公投第７案,高雄市,前鎮區,盛豐里,1542,1491,613,222,835,81,916
公投第７案,高雄市,前鎮區,興中里,1543,1621,672,188,860,91,951
公投第７案,高雄市,前鎮區,興中里,1544,1522,588,147,735,72,807
公投第７案,高雄市,前鎮區,興東里,1545,1593,659,223,882,65,947
公投第７案,高雄市,前鎮區,興東里,1546,1885,816,235,1051,92,1143
公投第７案,高雄市,前鎮區,興東里,1547,1870,827,254,1081,90,1171
公投第７案,高雄市,前鎮區,忠孝里,1548,1388,576,195,771,31,802
公投第７案,高雄市,前鎮區,忠孝里,1549,1348,577,165,742,68,810
公投第７案,高雄市,前鎮區,復國里,1550,1341,529,136,665,111,776
公投第７案,高雄市,前鎮區,復國里,1551,1364,609,213,822,41,863
公投第７案,高雄市,前鎮區,竹內里,1552,1367,567,183,750,79,829
公投第７案,高雄市,前鎮區,竹內里,1553,1326,513,181,694,85,779
公投第７案,高雄市,前鎮區,竹東里,1554,1059,456,113,569,44,613
公投第７案,高雄市,前鎮區,竹東里,1555,1119,519,118,637,26,663
公投第７案,高雄市,前鎮區,竹南里,1556,1565,598,184,782,42,824
公投第７案,高雄市,前鎮區,竹南里,1557,1549,721,105,826,77,903
公投第７案,高雄市,前鎮區,竹南里,1558,1691,823,230,1053,43,1096
公投第７案,高雄市,前鎮區,竹南里,1559,1837,845,214,1059,46,1105
公投第７案,高雄市,前鎮區,竹北里,1560,1092,512,132,644,24,668
公投第７案,高雄市,前鎮區,竹北里,1561,1126,498,149,647,58,705
公投第７案,高雄市,前鎮區,竹西里,1562,1215,489,134,623,83,706
公投第７案,高雄市,前鎮區,竹西里,1563,1443,618,204,822,31,853
公投第７案,高雄市,前鎮區,竹西里,1564,1448,713,221,934,28,962
公投第７案,高雄市,前鎮區,竹中里,1565,1648,732,184,916,93,1009
公投第７案,高雄市,前鎮區,竹中里,1566,1603,616,189,805,88,893
公投第７案,高雄市,前鎮區,瑞竹里,1567,1596,600,144,744,34,778
公投第７案,高雄市,前鎮區,瑞南里,1568,1450,534,134,668,41,709
公投第７案,高雄市,前鎮區,瑞南里,1569,1510,599,144,743,94,837
公投第７案,高雄市,前鎮區,瑞南里,1570,1647,708,231,939,94,1033
公投第７案,高雄市,前鎮區,瑞豐里,1571,1342,565,133,698,72,770
公投第７案,高雄市,前鎮區,瑞豐里,1572,1384,548,137,685,51,736
公投第７案,高雄市,前鎮區,瑞祥里,1573,1479,623,140,763,75,838
公投第７案,高雄市,前鎮區,瑞祥里,1574,1546,663,172,835,39,874
公投第７案,高雄市,前鎮區,瑞祥里,1575,1595,700,196,896,72,968
公投第７案,高雄市,前鎮區,瑞東里,1576,1201,549,123,672,69,741
公投第７案,高雄市,前鎮區,瑞東里,1577,1082,432,119,551,25,576
公投第７案,高雄市,前鎮區,瑞和里,1578,996,397,101,498,43,541
公投第７案,高雄市,前鎮區,瑞和里,1579,932,381,112,493,84,577
公投第７案,高雄市,前鎮區,瑞平里,1580,1146,479,158,637,51,688
公投第７案,高雄市,前鎮區,瑞平里,1581,1096,482,133,615,33,648
公投第７案,高雄市,前鎮區,瑞平里,1582,1332,651,141,792,21,813
公投第７案,高雄市,前鎮區,瑞隆里,1583,1175,479,152,631,40,671
公投第７案,高雄市,前鎮區,瑞隆里,1584,986,426,111,537,62,599
公投第７案,高雄市,前鎮區,瑞隆里,1585,1316,588,156,744,79,823
公投第７案,高雄市,前鎮區,瑞北里,1586,1559,569,177,746,65,811
公投第７案,高雄市,前鎮區,瑞北里,1587,1622,698,210,908,79,987
公投第７案,高雄市,前鎮區,瑞西里,1588,1310,553,126,679,37,716
公投第７案,高雄市,前鎮區,瑞西里,1589,1299,525,169,694,104,798
公投第７案,高雄市,前鎮區,瑞崗里,1590,1191,567,153,720,73,793
公投第７案,高雄市,前鎮區,瑞崗里,1591,1375,560,124,684,29,713
公投第７案,高雄市,前鎮區,瑞興里,1592,1338,574,149,723,36,759
公投第７案,高雄市,前鎮區,瑞興里,1593,1175,464,143,607,26,633
公投第７案,高雄市,前鎮區,瑞誠里,1594,1357,580,139,719,27,746
公投第７案,高雄市,前鎮區,瑞誠里,1595,1187,528,183,711,61,772
公投第７案,高雄市,前鎮區,瑞文里,1596,1164,480,131,611,49,660
公投第７案,高雄市,前鎮區,瑞文里,1597,1219,549,150,699,65,764
公投第７案,高雄市,前鎮區,瑞華里,1598,1428,565,186,751,25,776
公投第７案,高雄市,前鎮區,瑞華里,1599,1495,579,194,773,108,881
公投第７案,高雄市,前鎮區,瑞華里,1600,1531,707,160,867,41,908
公投第７案,高雄市,前鎮區,瑞昌里,1601,1509,648,163,811,86,897
公投第７案,高雄市,前鎮區,瑞昌里,1602,1591,633,187,820,75,895
公投第７案,高雄市,小港區,小港里,1603,1108,520,128,648,48,696
公投第７案,高雄市,小港區,小港里,1604,1171,523,145,668,60,728
公投第７案,高雄市,小港區,港口里,1605,1557,690,249,939,26,965
公投第７案,高雄市,小港區,港口里,1606,1668,679,160,839,21,860
公投第７案,高雄市,小港區,港正里,1607,1183,661,34,695,24,719
公投第７案,高雄市,小港區,港正里,1608,1372,590,161,751,27,778
公投第７案,高雄市,小港區,港墘里,1609,1737,776,214,990,53,1043
公投第７案,高雄市,小港區,港明里,1610,1586,592,238,830,69,899
公投第７案,高雄市,小港區,港明里,1611,1558,614,147,761,75,836
公投第７案,高雄市,小港區,港后里,1612,1284,595,182,777,69,846
公投第７案,高雄市,小港區,港后里,1613,1249,576,164,740,57,797
公投第７案,高雄市,小港區,港南里,1614,2400,797,211,1008,118,1126
公投第７案,高雄市,小港區,港興里,1615,1181,493,167,660,45,705
公投第７案,高雄市,小港區,港興里,1616,1079,457,121,578,31,609
公投第７案,高雄市,小港區,鳳宮里,1617,1335,577,168,745,38,783
公投第７案,高雄市,小港區,鳳宮里,1618,1241,568,139,707,59,766
公投第７案,高雄市,小港區,店鎮里,1619,1513,627,182,809,63,872
公投第７案,高雄市,小港區,店鎮里,1620,1349,606,158,764,67,831
公投第７案,高雄市,小港區,店鎮里,1621,1483,600,178,778,46,824
公投第７案,高雄市,小港區,店鎮里,1622,1451,649,154,803,30,833
公投第７案,高雄市,小港區,大苓里,1623,1241,495,135,630,25,655
公投第７案,高雄市,小港區,大苓里,1624,1262,571,204,775,68,843
公投第７案,高雄市,小港區,二苓里,1625,1813,780,226,1006,94,1100
公投第７案,高雄市,小港區,二苓里,1626,1877,704,162,866,39,905
公投第７案,高雄市,小港區,三苓里,1627,1391,570,173,743,29,772
公投第７案,高雄市,小港區,三苓里,1628,1453,637,187,824,32,856
公投第７案,高雄市,小港區,正苓里,1629,1374,586,192,778,42,820
公投第７案,高雄市,小港區,正苓里,1630,1348,564,163,727,60,787
公投第７案,高雄市,小港區,正苓里,1631,1334,622,152,774,63,837
公投第７案,高雄市,小港區,順苓里,1632,1433,585,173,758,37,795
公投第７案,高雄市,小港區,順苓里,1633,1448,548,157,705,19,724
公投第７案,高雄市,小港區,順苓里,1634,1488,773,108,881,76,957
公投第７案,高雄市,小港區,六苓里,1635,1278,578,147,725,63,788
公投第７案,高雄市,小港區,六苓里,1636,1306,663,177,840,57,897
公投第７案,高雄市,小港區,宏亮里,1637,1625,704,194,898,75,973
公投第７案,高雄市,小港區,宏亮里,1638,1640,754,206,960,83,1043
公投第７案,高雄市,小港區,山東里,1639,1506,657,167,824,52,876
公投第７案,高雄市,小港區,山東里,1640,1438,576,161,737,58,795
公投第７案,高雄市,小港區,青島里,1641,1105,566,137,703,34,737
公投第７案,高雄市,小港區,青島里,1642,1167,513,116,629,18,647
公投第７案,高雄市,小港區,濟南里,1643,1420,672,151,823,31,854
公投第７案,高雄市,小港區,濟南里,1644,1380,682,159,841,67,908
公投第７案,高雄市,小港區,濟南里,1645,1239,568,107,675,28,703
公投第７案,高雄市,小港區,泰山里,1646,1563,705,195,900,60,960
公投第７案,高雄市,小港區,泰山里,1647,1644,721,188,909,71,980
公投第７案,高雄市,小港區,山明里,1648,1895,799,208,1007,76,1083
公投第７案,高雄市,小港區,山明里,1649,1748,707,187,894,93,987
公投第７案,高雄市,小港區,山明里,1650,1579,618,254,872,99,971
公投第７案,高雄市,小港區,山明里,1651,2135,884,251,1135,55,1190
公投第７案,高雄市,小港區,山明里,1652,1728,719,206,925,83,1008
公投第７案,高雄市,小港區,山明里,1653,2022,833,179,1012,47,1059
公投第７案,高雄市,小港區,高松里,1654,1329,482,104,586,23,609
公投第７案,高雄市,小港區,高松里,1655,1320,537,144,681,43,724
公投第７案,高雄市,小港區,高松里,1656,1267,539,149,688,88,776
公投第７案,高雄市,小港區,松金里,1657,1298,577,178,755,71,826
公投第７案,高雄市,小港區,松金里,1658,1289,598,157,755,32,787
公投第７案,高雄市,小港區,松山里,1659,1534,688,175,863,44,907
公投第７案,高雄市,小港區,松山里,1660,1494,655,182,837,39,876
公投第７案,高雄市,小港區,大坪里,1661,1377,562,192,754,74,828
公投第７案,高雄市,小港區,大坪里,1662,1344,669,123,792,70,862
公投第７案,高雄市,小港區,坪頂里,1663,1508,629,161,790,71,861
公投第７案,高雄市,小港區,坪頂里,1664,1400,536,202,738,29,767
公投第７案,高雄市,小港區,坪頂里,1665,1457,673,144,817,65,882
公投第７案,高雄市,小港區,坪頂里,1666,1392,582,161,743,31,774
公投第７案,高雄市,小港區,孔宅里,1667,1983,790,227,1017,68,1085
公投第７案,高雄市,小港區,孔宅里,1668,1204,528,105,633,28,661
公投第７案,高雄市,小港區,孔宅里,1669,1300,567,140,707,53,760
公投第７案,高雄市,小港區,廈莊里,1670,1857,805,257,1062,92,1154
公投第７案,高雄市,小港區,廈莊里,1671,1566,688,160,848,34,882
公投第７案,高雄市,小港區,合作里,1672,1343,635,164,799,85,884
公投第７案,高雄市,小港區,合作里,1673,1236,568,149,717,87,804
公投第７案,高雄市,小港區,桂林里,1674,1564,691,193,884,94,978
公投第７案,高雄市,小港區,桂林里,1675,1484,607,226,833,13,846
公投第７案,高雄市,小港區,桂林里,1676,1477,603,184,787,40,827
公投第７案,高雄市,小港區,桂林里,1677,1482,686,195,881,37,918
公投第７案,高雄市,小港區,桂林里,1678,1708,686,194,880,39,919
公投第７案,高雄市,小港區,中厝里,1679,1867,752,248,1000,67,1067
公投第７案,高雄市,小港區,中厝里,1680,1709,658,156,814,25,839
公投第７案,高雄市,小港區,鳳鳴里,1681,1425,546,171,717,64,781
公投第７案,高雄市,小港區,鳳鳴里,1682,1696,593,156,749,50,799
公投第７案,高雄市,小港區,龍鳳里,1683,1522,530,152,682,77,759
公投第７案,高雄市,小港區,龍鳳里,1684,1531,638,178,816,88,904
公投第７案,高雄市,小港區,鳳森里,1685,2215,809,271,1080,142,1222
公投第７案,高雄市,小港區,鳳林里,1686,1515,589,166,755,31,786
公投第７案,高雄市,小港區,鳳林里,1687,1535,516,171,687,41,728
公投第７案,高雄市,小港區,鳳興里,1688,1276,512,145,657,32,689
公投第７案,高雄市,小港區,鳳興里,1689,1217,432,126,558,36,594
公投第７案,高雄市,小港區,鳳源里,1690,1707,600,167,767,78,845
公投第７案,高雄市,小港區,鳳源里,1691,1920,674,232,906,115,1021
公投第７案,高雄市,大寮區,拷潭里,1692,727,248,73,321,30,351
公投第７案,高雄市,大寮區,拷潭里,1693,718,237,78,315,18,333
公投第７案,高雄市,大寮區,內坑里,1694,1340,496,119,615,43,658
公投第７案,高雄市,大寮區,內坑里,1695,1575,538,155,693,46,739
公投第７案,高雄市,大寮區,內坑里,1696,444,187,49,236,26,262
公投第７案,高雄市,大寮區,內坑里,1697,2374,819,187,1006,50,1056
公投第７案,高雄市,大寮區,大寮里,1698,1291,515,135,650,72,722
公投第７案,高雄市,大寮區,大寮里,1699,1400,579,157,736,70,806
公投第７案,高雄市,大寮區,大寮里,1700,1390,552,155,707,31,738
公投第７案,高雄市,大寮區,大寮里,1701,1401,539,168,707,74,781
公投第７案,高雄市,大寮區,大寮里,1702,1199,453,126,579,30,609
公投第７案,高雄市,大寮區,上寮里,1703,1210,422,130,552,29,581
公投第７案,高雄市,大寮區,上寮里,1704,1195,479,142,621,43,664
公投第７案,高雄市,大寮區,三隆里,1705,1166,452,105,557,23,580
公投第７案,高雄市,大寮區,三隆里,1706,1353,539,160,699,44,743
公投第７案,高雄市,大寮區,三隆里,1707,1052,450,127,577,67,644
公投第７案,高雄市,大寮區,三隆里,1708,1024,333,97,430,24,454
公投第７案,高雄市,大寮區,琉球里,1709,1189,472,151,623,31,654
公投第７案,高雄市,大寮區,琉球里,1710,1512,665,166,831,85,916
公投第７案,高雄市,大寮區,琉球里,1711,1633,633,172,805,69,874
公投第７案,高雄市,大寮區,翁園里,1712,1214,533,146,679,39,718
公投第７案,高雄市,大寮區,翁園里,1713,1258,573,148,721,81,802
公投第７案,高雄市,大寮區,翁園里,1714,1323,545,178,723,25,748
公投第７案,高雄市,大寮區,前庄里,1715,1253,595,112,707,49,756
公投第７案,高雄市,大寮區,前庄里,1716,1035,479,110,589,54,643
公投第７案,高雄市,大寮區,中庄里,1717,1106,447,126,573,29,602
公投第７案,高雄市,大寮區,中庄里,1718,1195,506,138,644,40,684
公投第７案,高雄市,大寮區,中庄里,1719,1051,440,113,553,35,588
公投第７案,高雄市,大寮區,中庄里,1720,1425,611,157,768,83,851
公投第７案,高雄市,大寮區,中庄里,1721,1635,655,196,851,58,909
公投第７案,高雄市,大寮區,中庄里,1722,1359,564,184,748,58,806
公投第７案,高雄市,大寮區,中庄里,1723,1361,614,134,748,56,804
公投第７案,高雄市,大寮區,中庄里,1724,1629,699,176,875,42,917
公投第７案,高雄市,大寮區,後庄里,1725,1518,661,169,830,49,879
公投第７案,高雄市,大寮區,後庄里,1726,1620,654,163,817,74,891
公投第７案,高雄市,大寮區,後庄里,1727,1648,658,174,832,27,859
公投第７案,高雄市,大寮區,後庄里,1728,1385,595,139,734,55,789
公投第７案,高雄市,大寮區,後庄里,1729,1435,569,159,728,27,755
公投第７案,高雄市,大寮區,義仁里,1730,1046,405,138,543,22,565
公投第７案,高雄市,大寮區,義仁里,1731,789,280,104,384,33,417
公投第７案,高雄市,大寮區,新厝里,1732,909,361,101,462,30,492
公投第７案,高雄市,大寮區,新厝里,1733,733,304,101,405,28,433
公投第７案,高雄市,大寮區,過溪里,1734,1553,595,169,764,73,837
公投第７案,高雄市,大寮區,過溪里,1735,922,382,87,469,29,498
公投第７案,高雄市,大寮區,潮寮里,1736,1012,398,116,514,72,586
公投第７案,高雄市,大寮區,潮寮里,1737,968,373,104,477,65,542
公投第７案,高雄市,大寮區,潮寮里,1738,1021,390,114,504,47,551
公投第７案,高雄市,大寮區,會結里,1739,1554,532,139,671,76,747
公投第７案,高雄市,大寮區,會社里,1740,1120,487,148,635,52,687
公投第７案,高雄市,大寮區,會社里,1741,1225,661,43,704,61,765
公投第７案,高雄市,大寮區,會社里,1742,1320,381,104,485,27,512
公投第７案,高雄市,大寮區,會社里,1743,1317,548,142,690,51,741
公投第７案,高雄市,大寮區,會社里,1744,1119,452,121,573,24,597
公投第７案,高雄市,大寮區,山頂里,1745,1190,539,134,673,48,721
公投第７案,高雄市,大寮區,山頂里,1746,1229,559,145,704,51,755
公投第７案,高雄市,大寮區,山頂里,1747,1178,572,135,707,47,754
公投第７案,高雄市,大寮區,山頂里,1748,1272,614,150,764,28,792
公投第７案,高雄市,大寮區,山頂里,1749,1413,599,149,748,20,768
公投第７案,高雄市,大寮區,山頂里,1750,1185,555,135,690,49,739
公投第７案,高雄市,大寮區,忠義里,1751,553,248,46,294,6,300
公投第７案,高雄市,大寮區,永芳里,1752,1121,432,117,549,75,624
公投第７案,高雄市,大寮區,永芳里,1753,1227,529,129,658,26,684
公投第７案,高雄市,大寮區,永芳里,1754,1058,508,139,647,70,717
公投第７案,高雄市,大寮區,永芳里,1755,1209,511,149,660,35,695
公投第７案,高雄市,大寮區,永芳里,1756,1100,487,120,607,23,630
公投第７案,高雄市,大寮區,永芳里,1757,1122,440,119,559,27,586
公投第７案,高雄市,大寮區,義和里,1758,983,432,136,568,75,643
公投第７案,高雄市,大寮區,義和里,1759,1192,449,128,577,23,600
公投第７案,高雄市,大寮區,溪寮里,1760,719,281,70,351,35,386
公投第７案,高雄市,大寮區,溪寮里,1761,829,352,91,443,42,485
公投第７案,高雄市,大寮區,江山里,1762,771,365,94,459,74,533
公投第７案,高雄市,大寮區,江山里,1763,1075,446,142,588,94,682
公投第７案,高雄市,大寮區,昭明里,1764,1280,542,155,697,83,780
公投第７案,高雄市,大寮區,昭明里,1765,1179,471,148,619,73,692
公投第７案,高雄市,大寮區,昭明里,1766,1210,472,129,601,27,628
公投第７案,高雄市,大寮區,光武里,1767,189,91,17,108,8,116
公投第７案,高雄市,大寮區,中興里,1768,1228,551,138,689,63,752
公投第７案,高雄市,大寮區,中興里,1769,1170,528,109,637,41,678
公投第７案,高雄市,大寮區,中興里,1770,1416,680,137,817,56,873
公投第７案,高雄市,大寮區,中興里,1771,1482,810,51,861,100,961
公投第７案,高雄市,大寮區,中興里,1772,1478,641,121,762,58,820
公投第７案,高雄市,林園區,東林里,1773,1262,532,141,673,87,760
公投第７案,高雄市,林園區,東林里,1774,1562,568,183,751,68,819
公投第７案,高雄市,林園區,林園里,1775,1078,460,106,566,30,596
公投第７案,高雄市,林園區,林園里,1776,979,438,129,567,59,626
公投第７案,高雄市,林園區,林園里,1777,1195,492,134,626,50,676
公投第７案,高雄市,林園區,溪州里,1778,1380,529,160,689,65,754
公投第７案,高雄市,林園區,溪州里,1779,1280,495,156,651,74,725
公投第７案,高雄市,林園區,溪州里,1780,1269,480,150,630,24,654
公投第７案,高雄市,林園區,潭頭里,1781,1568,510,137,647,19,666
公投第７案,高雄市,林園區,潭頭里,1782,1226,537,78,615,68,683
公投第７案,高雄市,林園區,中厝里,1783,1480,601,131,732,58,790
公投第７案,高雄市,林園區,中厝里,1784,1459,635,168,803,54,857
公投第７案,高雄市,林園區,中門里,1785,1593,608,159,767,43,810
公投第７案,高雄市,林園區,中門里,1786,895,360,100,460,74,534
公投第７案,高雄市,林園區,頂厝里,1787,1110,421,121,542,34,576
公投第７案,高雄市,林園區,頂厝里,1788,1348,510,150,660,65,725
公投第７案,高雄市,林園區,頂厝里,1789,912,380,115,495,55,550
公投第７案,高雄市,林園區,頂厝里,1790,1085,488,145,633,69,702
公投第７案,高雄市,林園區,港埔里,1791,955,385,91,476,30,506
公投第７案,高雄市,林園區,港埔里,1792,879,396,92,488,55,543
公投第７案,高雄市,林園區,西溪里,1793,1103,459,114,573,66,639
公投第７案,高雄市,林園區,西溪里,1794,1054,489,127,616,73,689
公投第７案,高雄市,林園區,西溪里,1795,1292,443,122,565,24,589
公投第７案,高雄市,林園區,港嘴里,1796,1683,586,135,721,25,746
公投第７案,高雄市,林園區,北汕里,1797,607,260,54,314,36,350
公投第７案,高雄市,林園區,北汕里,1798,1012,394,129,523,69,592
公投第７案,高雄市,林園區,林內里,1799,1046,460,105,565,51,616
公投第７案,高雄市,林園區,林內里,1800,914,329,70,399,18,417
公投第７案,高雄市,林園區,王公里,1801,1405,599,148,747,69,816
公投第７案,高雄市,林園區,王公里,1802,1299,560,161,721,67,788
公投第７案,高雄市,林園區,王公里,1803,1170,513,77,590,31,621
公投第７案,高雄市,林園區,林家里,1804,1299,422,136,558,36,594
公投第７案,高雄市,林園區,龔厝里,1805,1031,411,127,538,43,581
公投第７案,高雄市,林園區,龔厝里,1806,849,316,100,416,15,431
公投第７案,高雄市,林園區,鳳芸里,1807,838,278,111,389,64,453
公投第７案,高雄市,林園區,鳳芸里,1808,938,395,93,488,28,516
公投第７案,高雄市,林園區,中芸里,1809,1051,388,75,463,43,506
公投第７案,高雄市,林園區,中芸里,1810,786,328,97,425,53,478
公投第７案,高雄市,林園區,東汕里,1811,894,384,100,484,74,558
公投第７案,高雄市,林園區,西汕里,1812,749,220,42,262,15,277
公投第７案,高雄市,林園區,仁愛里,1813,1485,650,171,821,41,862
公投第７案,高雄市,林園區,仁愛里,1814,1478,615,212,827,89,916
公投第７案,高雄市,林園區,文賢里,1815,1345,615,150,765,90,855
公投第７案,高雄市,林園區,文賢里,1816,1038,384,129,513,62,575
公投第７案,高雄市,林園區,廣應里,1817,1203,503,158,661,33,694
公投第７案,高雄市,林園區,廣應里,1818,1138,459,133,592,24,616
公投第７案,高雄市,林園區,廣應里,1819,1025,398,87,485,19,504
公投第７案,高雄市,林園區,五福里,1820,1341,568,141,709,77,786
公投第７案,高雄市,林園區,五福里,1821,1218,417,103,520,24,544
公投第７案,高雄市,林園區,中汕里,1822,1147,357,96,453,22,475
公投第７案,高雄市,林園區,中汕里,1823,1176,369,100,469,18,487
公投第７案,新北市,石門區,德茂里,1,1121,402,126,528,51,579
公投第７案,新北市,石門區,富基里,2,1389,471,130,601,70,671
公投第７案,新北市,石門區,老梅里,3,933,353,83,436,55,491
公投第７案,新北市,石門區,老梅里,4,1244,450,107,557,61,618
公投第７案,新北市,石門區,山溪里,5,883,342,86,428,56,484
公投第７案,新北市,石門區,石門里,6,1564,612,155,767,56,823
公投第７案,新北市,石門區,尖鹿里,7,1500,574,157,731,64,795
公投第７案,新北市,石門區,乾華里,8,328,115,22,137,14,151
公投第７案,新北市,石門區,茂林里,9,651,289,70,359,44,403
公投第７案,新北市,石門區,草里里,10,915,291,82,373,38,411
公投第７案,新北市,三芝區,八賢里,11,312,109,29,138,10,148
公投第７案,新北市,三芝區,埔頭里,12,1421,525,111,636,37,673
公投第７案,新北市,三芝區,埔頭里,13,1557,587,156,743,58,801
公投第７案,新北市,三芝區,埔頭里,14,1828,694,169,863,59,922
公投第７案,新北市,三芝區,古庄里,15,1060,383,113,496,44,540
公投第７案,新北市,三芝區,新庄里,16,819,252,69,321,35,356
公投第７案,新北市,三芝區,埔坪里,17,1701,535,144,679,37,716
公投第７案,新北市,三芝區,埔坪里,18,1740,596,165,761,76,837
公投第７案,新北市,三芝區,埔坪里,19,1451,480,141,621,49,670
公投第７案,新北市,三芝區,埔坪里,20,1248,411,111,522,53,575
公投第７案,新北市,三芝區,茂長里,21,629,232,71,303,13,316
公投第７案,新北市,三芝區,橫山里,22,504,177,35,212,21,233
公投第７案,新北市,三芝區,錫板里,23,698,225,66,291,17,308
公投第７案,新北市,三芝區,後厝里,24,2069,726,176,902,51,953
公投第７案,新北市,三芝區,福德里,25,784,297,83,380,34,414
公投第７案,新北市,三芝區,圓山里,26,522,170,70,240,23,263
公投第７案,新北市,三芝區,店子里,27,587,192,66,258,47,305
公投第７案,新北市,三芝區,興華里,28,1189,408,152,560,40,600
公投第７案,新北市,淡水區,中和里,29,544,191,69,260,27,287
公投第７案,新北市,淡水區,屯山里,30,1044,416,110,526,53,579
公投第７案,新北市,淡水區,賢孝里,31,1462,553,132,685,38,723
公投第７案,新北市,淡水區,興仁里,32,1525,554,180,734,62,796
公投第７案,新北市,淡水區,蕃薯里,33,986,338,88,426,41,467
公投第７案,新北市,淡水區,忠山里,34,806,306,105,411,32,443
公投第７案,新北市,淡水區,義山里,35,1173,454,134,588,69,657
公投第７案,新北市,淡水區,義山里,36,1343,464,120,584,41,625
公投第７案,新北市,淡水區,水源里,37,1153,350,103,453,34,487
公投第７案,新北市,淡水區,水源里,38,874,260,119,379,38,417
公投第７案,新北市,淡水區,忠寮里,39,1063,377,130,507,79,586
公投第７案,新北市,淡水區,樹興里,40,1309,449,129,578,39,617
公投第７案,新北市,淡水區,坪頂里,41,1290,490,156,646,47,693
公投第７案,新北市,淡水區,福德里,42,1675,720,189,909,39,948
公投第７案,新北市,淡水區,福德里,43,1589,641,190,831,48,879
公投第７案,新北市,淡水區,福德里,44,1624,720,185,905,43,948
公投第７案,新北市,淡水區,福德里,45,1241,481,137,618,41,659
公投第７案,新北市,淡水區,竹圍里,46,1317,503,160,663,47,710
公投第７案,新北市,淡水區,竹圍里,47,1225,510,46,556,36,592
公投第７案,新北市,淡水區,竹圍里,48,1426,585,147,732,39,771
公投第７案,新北市,淡水區,竹圍里,49,1610,682,201,883,53,936
公投第７案,新北市,淡水區,民權里,50,1982,808,219,1027,40,1067
公投第７案,新北市,淡水區,民權里,51,1924,661,184,845,49,894
公投第７案,新北市,淡水區,民生里,52,1822,663,201,864,51,915
公投第７案,新北市,淡水區,民生里,53,1232,507,150,657,77,734
公投第７案,新北市,淡水區,民生里,54,1588,655,184,839,63,902
公投第７案,新北市,淡水區,民生里,55,1784,694,160,854,50,904
公投第７案,新北市,淡水區,八勢里,56,1762,619,228,847,80,927
公投第７案,新北市,淡水區,八勢里,57,1546,620,152,772,45,817
公投第７案,新北市,淡水區,八勢里,58,1897,731,230,961,53,1014
公投第７案,新北市,淡水區,竿蓁里,59,1489,606,148,754,44,798
公投第７案,新北市,淡水區,竿蓁里,60,1679,636,172,808,51,859
公投第７案,新北市,淡水區,竿蓁里,61,1693,617,185,802,41,843
公投第７案,新北市,淡水區,竿蓁里,62,1674,616,157,773,21,794
公投第７案,新北市,淡水區,竿蓁里,63,1330,543,156,699,27,726
公投第７案,新北市,淡水區,竿蓁里,64,1467,625,120,745,21,766
公投第７案,新北市,淡水區,崁頂里,65,1837,770,164,934,44,978
公投第７案,新北市,淡水區,崁頂里,66,1924,506,121,627,25,652
公投第７案,新北市,淡水區,崁頂里,67,2340,898,222,1120,35,1155
公投第７案,新北市,淡水區,崁頂里,68,1704,609,137,746,47,793
公投第７案,新北市,淡水區,崁頂里,69,1363,528,152,680,39,719
公投第７案,新北市,淡水區,崁頂里,70,3068,1006,346,1352,47,1399
公投第７案,新北市,淡水區,埤島里,71,1528,583,126,709,31,740
公投第７案,新北市,淡水區,水碓里,72,1600,573,173,746,59,805
公投第７案,新北市,淡水區,水碓里,73,1874,782,197,979,66,1045
公投第７案,新北市,淡水區,水碓里,74,1567,611,154,765,68,833
公投第７案,新北市,淡水區,北新里,75,1245,496,163,659,39,698
公投第７案,新北市,淡水區,北新里,76,1211,469,131,600,30,630
公投第７案,新北市,淡水區,正德里,77,1992,819,206,1025,48,1073
公投第７案,新北市,淡水區,正德里,78,2028,828,194,1022,41,1063
公投第７案,新北市,淡水區,新興里,79,1373,562,146,708,72,780
公投第７案,新北市,淡水區,新興里,80,1732,724,157,881,33,914
公投第７案,新北市,淡水區,新興里,81,1519,541,171,712,48,760
公投第７案,新北市,淡水區,新興里,82,1727,625,167,792,23,815
公投第７案,新北市,淡水區,新義里,83,1297,530,141,671,35,706
公投第７案,新北市,淡水區,新義里,84,1066,415,95,510,61,571
公投第７案,新北市,淡水區,新義里,85,1387,567,146,713,52,765
公投第７案,新北市,淡水區,新春里,86,1909,761,222,983,54,1037
公投第７案,新北市,淡水區,新春里,87,1770,704,181,885,62,947
公投第７案,新北市,淡水區,新春里,88,2049,762,194,956,70,1026
公投第７案,新北市,淡水區,新春里,89,1680,676,194,870,34,904
公投第７案,新北市,淡水區,新民里,90,1433,575,203,778,65,843
公投第７案,新北市,淡水區,新民里,91,1365,544,141,685,42,727
公投第７案,新北市,淡水區,新民里,92,1452,605,159,764,54,818
公投第７案,新北市,淡水區,北投里,93,1804,756,150,906,58,964
公投第７案,新北市,淡水區,北投里,94,1322,514,138,652,47,699
公投第７案,新北市,淡水區,北投里,95,2019,818,179,997,32,1029
公投第７案,新北市,淡水區,北投里,96,1696,752,176,928,47,975
公投第７案,新北市,淡水區,北投里,97,1576,634,209,843,36,879
公投第７案,新北市,淡水區,鄧公里,98,1781,760,195,955,48,1003
公投第７案,新北市,淡水區,鄧公里,99,1665,686,231,917,54,971
公投第７案,新北市,淡水區,鄧公里,100,2013,886,126,1012,60,1072
公投第７案,新北市,淡水區,幸福里,101,1108,423,137,560,33,593
公投第７案,新北市,淡水區,幸福里,102,1305,507,152,659,53,712
公投第７案,新北市,淡水區,幸福里,103,1199,456,150,606,22,628
公投第７案,新北市,淡水區,學府里,104,2017,795,202,997,63,1060
公投第７案,新北市,淡水區,學府里,105,2125,665,299,964,67,1031
公投第７案,新北市,淡水區,中興里,106,1289,430,132,562,24,586
公投第７案,新北市,淡水區,中興里,107,1319,580,158,738,45,783
公投第７案,新北市,淡水區,中興里,108,1051,436,106,542,22,564
公投第７案,新北市,淡水區,長庚里,109,1348,542,135,677,39,716
公投第７案,新北市,淡水區,清文里,110,1106,411,118,529,35,564
公投第７案,新北市,淡水區,草東里,111,717,295,95,390,31,421
公投第７案,新北市,淡水區,協元里,112,1385,518,169,687,28,715
公投第７案,新北市,淡水區,永吉里,113,841,351,121,472,32,504
公投第７案,新北市,淡水區,民安里,114,665,277,70,347,31,378
公投第７案,新北市,淡水區,新生里,115,419,181,49,230,20,250
公投第７案,新北市,淡水區,文化里,116,1599,667,183,850,32,882
公投第７案,新北市,淡水區,油車里,117,1670,638,182,820,57,877
公投第７案,新北市,淡水區,油車里,118,1683,703,194,897,58,955
公投第７案,新北市,淡水區,油車里,119,1577,580,162,742,54,796
公投第７案,新北市,淡水區,沙崙里,120,1618,604,158,762,52,814
公投第７案,新北市,淡水區,沙崙里,121,2214,788,195,983,41,1024
公投第７案,新北市,淡水區,大庄里,122,1832,698,191,889,64,953
公投第７案,新北市,淡水區,大庄里,123,2123,818,222,1040,66,1106
公投第７案,新北市,淡水區,大庄里,124,2998,1077,176,1253,33,1286
公投第７案,新北市,八里區,龍源里,125,1498,530,150,680,63,743
公投第７案,新北市,八里區,龍源里,126,1939,683,170,853,38,891
公投第７案,新北市,八里區,龍源里,127,1516,564,174,738,70,808
公投第７案,新北市,八里區,龍源里,128,1642,694,186,880,65,945
公投第７案,新北市,八里區,米倉里,129,1927,667,186,853,87,940
公投第７案,新北市,八里區,米倉里,130,1276,519,124,643,48,691
公投第７案,新北市,八里區,大崁里,131,1349,585,156,741,44,785
公投第７案,新北市,八里區,大崁里,132,1403,576,146,722,64,786
公投第７案,新北市,八里區,埤頭里,133,1644,638,190,828,59,887
公投第７案,新北市,八里區,埤頭里,134,1853,725,193,918,63,981
公投第７案,新北市,八里區,頂罟里,135,1793,763,194,957,88,1045
公投第７案,新北市,八里區,舊城里,136,1644,638,197,835,49,884
公投第７案,新北市,八里區,舊城里,137,1846,716,184,900,64,964
公投第７案,新北市,八里區,舊城里,138,1346,511,148,659,58,717
公投第７案,新北市,八里區,舊城里,139,1621,626,192,818,54,872
公投第７案,新北市,八里區,訊塘里,140,2110,693,180,873,68,941
公投第７案,新北市,八里區,訊塘里,141,1967,713,198,911,89,1000
公投第７案,新北市,八里區,荖阡里,142,1626,664,184,848,49,897
公投第７案,新北市,八里區,長坑里,143,1514,601,169,770,61,831
公投第７案,新北市,八里區,下罟里,144,1456,578,172,750,82,832
公投第７案,新北市,林口區,東林里,145,1268,455,148,603,73,676
公投第７案,新北市,林口區,東林里,146,1171,413,144,557,50,607
公投第７案,新北市,林口區,東林里,147,1218,490,152,642,58,700
公投第７案,新北市,林口區,林口里,148,1788,672,190,862,54,916
公投第７案,新北市,林口區,林口里,149,1625,602,165,767,61,828
公投第７案,新北市,林口區,林口里,150,1448,544,148,692,63,755
公投第７案,新北市,林口區,西林里,151,1328,454,147,601,83,684
公投第７案,新北市,林口區,西林里,152,1523,505,130,635,70,705
公投第７案,新北市,林口區,西林里,153,1245,519,114,633,50,683
公投第７案,新北市,林口區,西林里,154,1329,647,135,782,43,825
公投第７案,新北市,林口區,西林里,155,1465,657,165,822,34,856
公投第７案,新北市,林口區,西林里,156,1369,615,155,770,35,805
公投第７案,新北市,林口區,菁湖里,157,1346,560,174,734,52,786
公投第７案,新北市,林口區,菁湖里,158,1181,440,148,588,61,649
公投第７案,新北市,林口區,菁湖里,159,1291,568,201,769,28,797
公投第７案,新北市,林口區,中湖里,160,1213,479,150,629,45,674
公投第７案,新北市,林口區,中湖里,161,1256,561,132,693,39,732
公投第７案,新北市,林口區,中湖里,162,1185,448,151,599,44,643
公投第７案,新北市,林口區,湖北里,163,1361,549,147,696,41,737
公投第７案,新北市,林口區,湖南里,164,1756,765,110,875,22,897
公投第７案,新北市,林口區,湖南里,165,1676,670,158,828,32,860
公投第７案,新北市,林口區,湖南里,166,1540,689,160,849,22,871
公投第７案,新北市,林口區,湖南里,167,1569,681,129,810,41,851
公投第７案,新北市,林口區,湖南里,168,1514,658,146,804,32,836
公投第７案,新北市,林口區,湖南里,169,1193,561,109,670,24,694
公投第７案,新北市,林口區,湖南里,170,1610,711,171,882,30,912
公投第７案,新北市,林口區,湖南里,171,1338,609,136,745,30,775
公投第７案,新北市,林口區,湖南里,172,1141,488,129,617,37,654
公投第７案,新北市,林口區,湖南里,173,1307,560,140,700,38,738
公投第７案,新北市,林口區,湖南里,174,1327,584,149,733,28,761
公投第７案,新北市,林口區,湖南里,175,1285,562,144,706,37,743
公投第７案,新北市,林口區,南勢里,176,1481,608,182,790,45,835
公投第７案,新北市,林口區,南勢里,177,1510,660,169,829,29,858
公投第７案,新北市,林口區,南勢里,178,1785,720,187,907,47,954
公投第７案,新北市,林口區,南勢里,179,1792,747,190,937,34,971
公投第７案,新北市,林口區,南勢里,180,1517,678,149,827,29,856
公投第７案,新北市,林口區,南勢里,181,1564,715,152,867,32,899
公投第７案,新北市,林口區,南勢里,182,1560,721,130,851,44,895
公投第７案,新北市,林口區,南勢里,183,1544,640,167,807,33,840
公投第７案,新北市,林口區,南勢里,184,1593,676,143,819,39,858
公投第７案,新北市,林口區,南勢里,185,1431,648,124,772,31,803
公投第７案,新北市,林口區,仁愛里,186,1571,628,166,794,40,834
公投第７案,新北市,林口區,仁愛里,187,1439,631,155,786,37,823
公投第７案,新北市,林口區,仁愛里,188,1451,614,180,794,49,843
公投第７案,新北市,林口區,仁愛里,189,1391,623,168,791,49,840
公投第７案,新北市,林口區,麗林里,190,1461,627,155,782,30,812
公投第７案,新北市,林口區,麗林里,191,1691,705,176,881,32,913
公投第７案,新北市,林口區,麗林里,192,1524,602,197,799,50,849
公投第７案,新北市,林口區,麗林里,193,1343,659,146,805,33,838
公投第７案,新北市,林口區,麗林里,194,1398,654,146,800,37,837
公投第７案,新北市,林口區,東勢里,195,1380,606,158,764,48,812
公投第７案,新北市,林口區,東勢里,196,1367,543,169,712,55,767
公投第７案,新北市,林口區,東勢里,197,1350,532,198,730,35,765
公投第７案,新北市,林口區,東勢里,198,1194,529,131,660,39,699
公投第７案,新北市,林口區,麗園里,199,1344,513,166,679,58,737
公投第７案,新北市,林口區,麗園里,200,1154,492,128,620,33,653
公投第７案,新北市,林口區,麗園里,201,1119,517,137,654,40,694
公投第７案,新北市,林口區,頂福里,202,1026,338,119,457,44,501
公投第７案,新北市,林口區,下福里,203,1210,459,164,623,49,672
公投第７案,新北市,林口區,嘉寶里,204,912,349,110,459,54,513
公投第７案,新北市,林口區,瑞平里,205,824,316,128,444,36,480
公投第７案,新北市,林口區,太平里,206,1411,576,167,743,88,831
公投第７案,新北市,五股區,興珍里,207,1456,512,184,696,95,791
公投第７案,新北市,五股區,興珍里,208,1482,540,172,712,71,783
公投第７案,新北市,五股區,興珍里,209,1287,486,182,668,54,722
公投第７案,新北市,五股區,更寮里,210,1106,345,169,514,39,553
公投第７案,新北市,五股區,觀音里,211,1283,405,154,559,77,636
公投第７案,新北市,五股區,集福里,212,1833,657,200,857,54,911
公投第７案,新北市,五股區,集福里,213,1141,481,123,604,51,655
公投第７案,新北市,五股區,集福里,214,463,187,64,251,32,283
公投第７案,新北市,五股區,集賢里,215,1786,687,201,888,55,943
公投第７案,新北市,五股區,集賢里,216,1660,559,246,805,39,844
公投第７案,新北市,五股區,成德里,217,1534,554,202,756,87,843
公投第７案,新北市,五股區,成德里,218,1285,501,140,641,82,723
公投第７案,新北市,五股區,成州里,219,1832,656,199,855,109,964
公投第７案,新北市,五股區,成州里,220,1542,593,160,753,42,795
公投第７案,新北市,五股區,成州里,221,1897,621,188,809,48,857
公投第７案,新北市,五股區,成功里,222,1964,669,187,856,101,957
公投第７案,新北市,五股區,成功里,223,1779,618,186,804,81,885
公投第７案,新北市,五股區,成功里,224,1735,643,169,812,82,894
公投第７案,新北市,五股區,成泰里,225,2299,832,240,1072,52,1124
公投第７案,新北市,五股區,成泰里,226,1755,623,161,784,60,844
公投第７案,新北市,五股區,成泰里,227,1674,657,180,837,69,906
公投第７案,新北市,五股區,成泰里,228,1661,644,191,835,82,917
公投第７案,新北市,五股區,五龍里,229,1281,410,144,554,41,595
公投第７案,新北市,五股區,五福里,230,1566,578,182,760,83,843
公投第７案,新北市,五股區,五福里,231,1560,520,139,659,39,698
公投第７案,新北市,五股區,六福里,232,1622,643,170,813,42,855
公投第７案,新北市,五股區,六福里,233,1779,702,196,898,51,949
公投第７案,新北市,五股區,民義里,234,1487,543,149,692,75,767
公投第７案,新北市,五股區,民義里,235,1567,642,164,806,51,857
公投第７案,新北市,五股區,五股里,236,1333,376,105,481,35,516
公投第７案,新北市,五股區,五股里,237,1263,537,160,697,60,757
公投第７案,新北市,五股區,五股里,238,1314,524,160,684,78,762
公投第７案,新北市,五股區,德音里,239,1513,564,149,713,41,754
公投第７案,新北市,五股區,德音里,240,1517,604,176,780,34,814
公投第７案,新北市,五股區,德音里,241,1613,608,190,798,73,871
公投第７案,新北市,五股區,水碓里,242,1616,625,174,799,70,869
公投第７案,新北市,五股區,水碓里,243,1616,601,191,792,73,865
公投第７案,新北市,五股區,水碓里,244,1689,647,195,842,76,918
公投第７案,新北市,五股區,水碓里,245,1894,726,192,918,26,944
公投第７案,新北市,五股區,福德里,246,1210,530,166,696,66,762
公投第７案,新北市,五股區,福德里,247,1643,612,177,789,57,846
公投第７案,新北市,五股區,德泰里,248,1441,566,144,710,31,741
公投第７案,新北市,五股區,德泰里,249,1305,572,128,700,51,751
公投第７案,新北市,五股區,德泰里,250,1170,534,127,661,59,720
公投第７案,新北市,五股區,貿商里,251,1397,661,137,798,53,851
公投第７案,新北市,五股區,貿商里,252,1312,626,114,740,56,796
公投第７案,新北市,五股區,陸一里,253,1127,465,79,544,30,574
公投第７案,新北市,五股區,陸一里,254,1154,493,65,558,43,601
公投第７案,新北市,泰山區,大科里,255,643,221,72,293,34,327
公投第７案,新北市,泰山區,大科里,256,186,91,18,109,5,114
公投第７案,新北市,泰山區,黎明里,257,1457,535,148,683,45,728
公投第７案,新北市,泰山區,黎明里,258,1594,666,160,826,62,888
公投第７案,新北市,泰山區,山腳里,259,1598,632,116,748,53,801
公投第７案,新北市,泰山區,山腳里,260,1503,569,135,704,46,750
公投第７案,新北市,泰山區,山腳里,261,1436,552,141,693,55,748
公投第７案,新北市,泰山區,山腳里,262,1384,536,175,711,51,762
公投第７案,新北市,泰山區,福泰里,263,1231,490,146,636,51,687
公投第７案,新北市,泰山區,福泰里,264,1295,481,149,630,25,655
公投第７案,新北市,泰山區,福興里,265,1563,657,171,828,69,897
公投第７案,新北市,泰山區,福興里,266,1610,716,154,870,67,937
公投第７案,新北市,泰山區,楓樹里,267,1253,485,155,640,33,673
公投第７案,新北市,泰山區,楓樹里,268,1294,491,132,623,41,664
公投第７案,新北市,泰山區,楓樹里,269,1354,577,165,742,47,789
公投第７案,新北市,泰山區,同榮里,270,1259,521,120,641,36,677
公投第７案,新北市,泰山區,同榮里,271,1252,516,154,670,27,697
公投第７案,新北市,泰山區,同榮里,272,1094,432,105,537,26,563
公投第７案,新北市,泰山區,同興里,273,1590,626,207,833,57,890
公投第７案,新北市,泰山區,同興里,274,1634,730,96,826,82,908
公投第７案,新北市,泰山區,全興里,275,1536,521,163,684,45,729
公投第７案,新北市,泰山區,全興里,276,1534,650,177,827,58,885
公投第７案,新北市,泰山區,全興里,277,1545,724,161,885,62,947
公投第７案,新北市,泰山區,全興里,278,1399,608,130,738,44,782
公投第７案,新北市,泰山區,全興里,279,1315,532,136,668,28,696
公投第７案,新北市,泰山區,義學里,280,1201,546,134,680,54,734
公投第７案,新北市,泰山區,義學里,281,1182,468,134,602,55,657
公投第７案,新北市,泰山區,義學里,282,1665,656,157,813,58,871
公投第７案,新北市,泰山區,義仁里,283,1855,719,219,938,71,1009
公投第７案,新北市,泰山區,義仁里,284,1866,710,224,934,93,1027
公投第７案,新北市,泰山區,義仁里,285,1935,771,203,974,56,1030
公投第７案,新北市,泰山區,義仁里,286,1589,613,158,771,48,819
公投第７案,新北市,泰山區,明志里,287,1152,452,103,555,36,591
公投第７案,新北市,泰山區,明志里,288,1114,430,147,577,48,625
公投第７案,新北市,泰山區,明志里,289,1040,477,123,600,47,647
公投第７案,新北市,泰山區,泰友里,290,1003,448,108,556,41,597
公投第７案,新北市,泰山區,泰友里,291,975,399,142,541,25,566
公投第７案,新北市,泰山區,新明里,292,1440,558,183,741,44,785
公投第７案,新北市,泰山區,新明里,293,1480,580,154,734,23,757
公投第７案,新北市,泰山區,貴子里,294,1211,497,142,639,41,680
公投第７案,新北市,泰山區,貴子里,295,1237,486,145,631,35,666
公投第７案,新北市,泰山區,貴子里,296,1069,424,113,537,41,578
公投第７案,新北市,泰山區,貴賢里,297,1680,761,168,929,63,992
公投第７案,新北市,泰山區,貴賢里,298,1651,676,200,876,40,916
公投第７案,新北市,泰山區,貴和里,299,1420,546,150,696,30,726
公投第７案,新北市,泰山區,貴和里,300,1337,559,162,721,33,754
公投第７案,新北市,泰山區,貴和里,301,1591,685,192,877,42,919
公投第７案,新北市,新莊區,海山里,302,1123,428,173,601,59,660
公投第７案,新北市,新莊區,海山里,303,1278,508,187,695,67,762
公投第７案,新北市,新莊區,海山里,304,1163,534,145,679,59,738
公投第７案,新北市,新莊區,海山里,305,1228,516,181,697,56,753
公投第７案,新北市,新莊區,全安里,306,1211,474,177,651,59,710
公投第７案,新北市,新莊區,全安里,307,1176,458,183,641,57,698
公投第７案,新北市,新莊區,全安里,308,1536,677,207,884,57,941
公投第７案,新北市,新莊區,全泰里,309,1486,691,176,867,66,933
公投第７案,新北市,新莊區,全泰里,310,1513,695,213,908,73,981
公投第７案,新北市,新莊區,全泰里,311,1395,588,221,809,80,889
公投第７案,新北市,新莊區,忠孝里,312,1353,545,144,689,81,770
公投第７案,新北市,新莊區,忠孝里,313,1409,605,194,799,72,871
公投第７案,新北市,新莊區,忠孝里,314,1478,616,146,762,36,798
公投第７案,新北市,新莊區,文衡里,315,921,380,136,516,59,575
公投第７案,新北市,新莊區,文衡里,316,971,406,157,563,48,611
公投第７案,新北市,新莊區,文聖里,317,1534,718,174,892,70,962
公投第７案,新北市,新莊區,文聖里,318,1516,595,180,775,50,825
公投第７案,新北市,新莊區,興漢里,319,697,280,95,375,35,410
公投第７案,新北市,新莊區,興漢里,320,1235,543,119,662,40,702
公投第７案,新北市,新莊區,興漢里,321,1138,452,143,595,43,638
公投第７案,新北市,新莊區,榮和里,322,1063,405,120,525,28,553
公投第７案,新北市,新莊區,榮和里,323,3399,575,201,776,65,841
公投第７案,新北市,新莊區,文德里,324,1575,676,181,857,78,935
公投第７案,新北市,新莊區,文明里,325,1615,702,229,931,76,1007
公投第７案,新北市,新莊區,化成里,326,1612,590,194,784,67,851
公投第７案,新北市,新莊區,化成里,327,1514,576,186,762,78,840
公投第７案,新北市,新莊區,頭前里,328,1382,501,153,654,30,684
公投第７案,新北市,新莊區,頭前里,329,1475,599,177,776,54,830
公投第７案,新北市,新莊區,頭前里,330,1462,626,174,800,26,826
公投第７案,新北市,新莊區,頭前里,331,1426,585,165,750,38,788
公投第７案,新北市,新莊區,頭前里,332,1421,539,190,729,61,790
公投第７案,新北市,新莊區,福基里,333,1536,636,171,807,49,856
公投第７案,新北市,新莊區,福基里,334,1587,684,187,871,50,921
公投第７案,新北市,新莊區,福基里,335,749,292,81,373,17,390
公投第７案,新北市,新莊區,福興里,336,1276,579,141,720,46,766
公投第７案,新北市,新莊區,福興里,337,1303,517,154,671,37,708
公投第７案,新北市,新莊區,福興里,338,1259,560,152,712,59,771
公投第７案,新北市,新莊區,福興里,339,1291,585,141,726,51,777
公投第７案,新北市,新莊區,昌平里,340,1493,661,155,816,31,847
公投第７案,新北市,新莊區,昌平里,341,1507,621,201,822,53,875
公投第７案,新北市,新莊區,昌平里,342,1456,623,154,777,23,800
公投第７案,新北市,新莊區,昌平里,343,1396,594,156,750,31,781
公投第７案,新北市,新莊區,和平里,344,1351,469,150,619,61,680
公投第７案,新北市,新莊區,和平里,345,1403,571,157,728,67,795
公投第７案,新北市,新莊區,和平里,346,1497,576,186,762,70,832
公投第７案,新北市,新莊區,幸福里,347,1272,538,157,695,79,774
公投第７案,新北市,新莊區,幸福里,348,1269,460,121,581,39,620
公投第７案,新北市,新莊區,幸福里,349,1335,540,167,707,50,757
公投第７案,新北市,新莊區,昌隆里,350,1300,596,162,758,35,793
公投第７案,新北市,新莊區,昌隆里,351,1286,606,130,736,44,780
公投第７案,新北市,新莊區,昌隆里,352,1255,615,157,772,52,824
公投第７案,新北市,新莊區,信義里,353,1558,624,176,800,92,892
公投第７案,新北市,新莊區,信義里,354,1567,617,176,793,72,865
公投第７案,新北市,新莊區,信義里,355,1603,675,190,865,72,937
公投第７案,新北市,新莊區,昌信里,356,1538,630,182,812,40,852
公投第７案,新北市,新莊區,昌信里,357,1671,659,231,890,59,949
公投第７案,新北市,新莊區,昌明里,358,1698,616,203,819,49,868
公投第７案,新北市,新莊區,昌明里,359,1545,683,203,886,51,937
公投第７案,新北市,新莊區,仁義里,360,1696,710,203,913,117,1030
公投第７案,新北市,新莊區,仁義里,361,1626,604,190,794,104,898
公投第７案,新北市,新莊區,仁愛里,362,1170,439,124,563,62,625
公投第７案,新北市,新莊區,仁愛里,363,1236,473,146,619,99,718
公投第７案,新北市,新莊區,自信里,364,1071,415,114,529,66,595
公投第７案,新北市,新莊區,自信里,365,1129,437,154,591,53,644
公投第７案,新北市,新莊區,自立里,366,1586,661,203,864,50,914
公投第７案,新北市,新莊區,自立里,367,1597,584,181,765,64,829
公投第７案,新北市,新莊區,自立里,368,1573,529,174,703,110,813
公投第７案,新北市,新莊區,自強里,369,1225,452,130,582,51,633
公投第７案,新北市,新莊區,自強里,370,1217,463,113,576,37,613
公投第７案,新北市,新莊區,思源里,371,1571,617,188,805,85,890
公投第７案,新北市,新莊區,思源里,372,1594,623,165,788,73,861
公投第７案,新北市,新莊區,思源里,373,1583,606,192,798,62,860
公投第７案,新北市,新莊區,思賢里,374,1245,563,141,704,54,758
公投第７案,新北市,新莊區,思賢里,375,1203,467,162,629,52,681
公投第７案,新北市,新莊區,思賢里,376,1265,592,156,748,51,799
公投第７案,新北市,新莊區,中華里,377,1255,527,157,684,66,750
公投第７案,新北市,新莊區,中華里,378,1287,532,173,705,48,753
公投第７案,新北市,新莊區,中美里,379,1167,496,183,679,53,732
公投第７案,新北市,新莊區,中美里,380,1299,505,140,645,68,713
公投第７案,新北市,新莊區,中美里,381,1207,499,147,646,52,698
公投第７案,新北市,新莊區,中美里,382,1415,606,166,772,53,825
公投第７案,新北市,新莊區,恆安里,383,1342,517,194,711,72,783
公投第７案,新北市,新莊區,恆安里,384,1341,494,176,670,91,761
公投第７案,新北市,新莊區,恆安里,385,1247,504,139,643,72,715
公投第７案,新北市,新莊區,立人里,386,984,521,99,620,30,650
公投第７案,新北市,新莊區,立人里,387,1043,477,119,596,47,643
公投第７案,新北市,新莊區,立德里,388,1135,532,179,711,43,754
公投第７案,新北市,新莊區,立德里,389,1185,501,140,641,45,686
公投第７案,新北市,新莊區,中和里,390,1346,560,164,724,52,776
公投第７案,新北市,新莊區,中和里,391,1372,560,174,734,84,818
公投第７案,新北市,新莊區,中和里,392,1350,586,173,759,68,827
公投第７案,新北市,新莊區,中泰里,393,1307,472,171,643,82,725
公投第７案,新北市,新莊區,中泰里,394,1353,529,155,684,92,776
公投第７案,新北市,新莊區,中泰里,395,1287,521,164,685,83,768
公投第７案,新北市,新莊區,中宏里,396,1567,523,132,655,36,691
公投第７案,新北市,新莊區,中宏里,397,1709,715,214,929,90,1019
公投第７案,新北市,新莊區,中全里,398,1616,614,138,752,37,789
公投第７案,新北市,新莊區,中全里,399,1628,571,170,741,70,811
公投第７案,新北市,新莊區,立志里,400,1148,499,142,641,65,706
公投第７案,新北市,新莊區,立志里,401,1201,495,160,655,12,667
公投第７案,新北市,新莊區,立志里,402,1135,515,158,673,55,728
公投第７案,新北市,新莊區,立廷里,403,1495,646,220,866,56,922
公投第７案,新北市,新莊區,立廷里,404,1486,643,198,841,67,908
公投第７案,新北市,新莊區,立廷里,405,1483,700,172,872,49,921
公投第７案,新北市,新莊區,立廷里,406,1553,660,150,810,51,861
公投第７案,新北市,新莊區,立廷里,407,1625,764,203,967,37,1004
公投第７案,新北市,新莊區,立廷里,408,1671,710,176,886,36,922
公投第７案,新北市,新莊區,立基里,409,1389,606,186,792,74,866
公投第７案,新北市,新莊區,立基里,410,1272,531,162,693,36,729
公投第７案,新北市,新莊區,立基里,411,1409,668,160,828,50,878
公投第７案,新北市,新莊區,立基里,412,1372,578,200,778,38,816
公投第７案,新北市,新莊區,中誠里,413,955,384,120,504,56,560
公投第７案,新北市,新莊區,中誠里,414,952,359,112,471,68,539
公投第７案,新北市,新莊區,中港里,415,1412,573,174,747,39,786
公投第７案,新北市,新莊區,中港里,416,1415,550,208,758,64,822
公投第７案,新北市,新莊區,中港里,417,1421,598,191,789,65,854
公投第７案,新北市,新莊區,中港里,418,1293,571,174,745,63,808
公投第７案,新北市,新莊區,中信里,419,1475,565,157,722,22,744
公投第７案,新北市,新莊區,中信里,420,1429,587,157,744,74,818
公投第７案,新北市,新莊區,中信里,421,1481,623,158,781,62,843
公投第７案,新北市,新莊區,中信里,422,1472,634,164,798,90,888
公投第７案,新北市,新莊區,中信里,423,1474,640,184,824,41,865
公投第７案,新北市,新莊區,中平里,424,1462,633,183,816,26,842
公投第７案,新北市,新莊區,中平里,425,1484,649,192,841,42,883
公投第７案,新北市,新莊區,中平里,426,1461,629,157,786,51,837
公投第７案,新北市,新莊區,中平里,427,1444,639,161,800,34,834
公投第７案,新北市,新莊區,中平里,428,1437,654,159,813,29,842
公投第７案,新北市,新莊區,中原里,429,1641,618,178,796,37,833
公投第７案,新北市,新莊區,中原里,430,1633,608,197,805,37,842
公投第７案,新北市,新莊區,中原里,431,1531,653,177,830,24,854
公投第７案,新北市,新莊區,中原里,432,1517,675,167,842,62,904
公投第７案,新北市,新莊區,中原里,433,1487,595,174,769,55,824
公投第７案,新北市,新莊區,中原里,434,1560,672,159,831,53,884
公投第７案,新北市,新莊區,中隆里,435,1584,623,202,825,68,893
公投第７案,新北市,新莊區,中隆里,436,1602,654,179,833,34,867
公投第７案,新北市,新莊區,中隆里,437,818,311,122,433,51,484
公投第７案,新北市,新莊區,立功里,438,1633,552,165,717,62,779
公投第７案,新北市,新莊區,立功里,439,1652,608,207,815,73,888
公投第７案,新北市,新莊區,立泰里,440,1498,575,180,755,70,825
公投第７案,新北市,新莊區,立泰里,441,1379,533,159,692,51,743
公投第７案,新北市,新莊區,立泰里,442,1381,594,166,760,49,809
公投第７案,新北市,新莊區,立言里,443,1535,650,183,833,72,905
公投第７案,新北市,新莊區,立言里,444,1492,665,207,872,69,941
公投第７案,新北市,新莊區,立言里,445,1450,652,176,828,82,910
公投第７案,新北市,新莊區,豐年里,446,1107,472,134,606,51,657
公投第７案,新北市,新莊區,豐年里,447,1063,471,132,603,57,660
公投第７案,新北市,新莊區,豐年里,448,1143,446,162,608,63,671
公投第７案,新北市,新莊區,國泰里,449,1341,509,150,659,96,755
公投第７案,新北市,新莊區,泰豐里,450,1063,455,125,580,45,625
公投第７案,新北市,新莊區,泰豐里,451,1096,450,156,606,52,658
公投第７案,新北市,新莊區,瓊林里,452,1309,548,155,703,44,747
公投第７案,新北市,新莊區,瓊林里,453,1216,510,179,689,45,734
公投第７案,新北市,新莊區,瓊林里,454,1278,503,138,641,43,684
公投第７案,新北市,新莊區,瓊林里,455,1352,514,186,700,72,772
公投第７案,新北市,新莊區,福營里,456,1298,464,157,621,57,678
公投第７案,新北市,新莊區,福營里,457,1042,437,125,562,50,612
公投第７案,新北市,新莊區,營盤里,458,881,335,103,438,25,463
公投第７案,新北市,新莊區,營盤里,459,1109,498,170,668,52,720
公投第７案,新北市,新莊區,丹鳳里,460,1291,515,149,664,53,717
公投第７案,新北市,新莊區,丹鳳里,461,1293,515,144,659,25,684
公投第７案,新北市,新莊區,丹鳳里,462,1336,535,185,720,66,786
公投第７案,新北市,新莊區,丹鳳里,463,1384,562,135,697,48,745
公投第７案,新北市,新莊區,丹鳳里,464,1231,498,89,587,22,609
公投第７案,新北市,新莊區,丹鳳里,465,940,420,93,513,32,545
公投第７案,新北市,新莊區,合鳳里,466,1369,502,167,669,96,765
公投第７案,新北市,新莊區,合鳳里,467,1384,557,158,715,65,780
公投第７案,新北市,新莊區,合鳳里,468,1272,493,173,666,72,738
公投第７案,新北市,新莊區,祥鳳里,469,1073,483,112,595,42,637
公投第７案,新北市,新莊區,祥鳳里,470,1058,432,135,567,33,600
公投第７案,新北市,新莊區,雙鳳里,471,1528,629,169,798,24,822
公投第７案,新北市,新莊區,雙鳳里,472,1244,529,110,639,40,679
公投第７案,新北市,新莊區,雙鳳里,473,1356,543,131,674,51,725
公投第７案,新北市,新莊區,雙鳳里,474,1164,484,97,581,29,610
公投第７案,新北市,新莊區,雙鳳里,475,1423,636,139,775,65,840
公投第７案,新北市,新莊區,雙鳳里,476,1250,578,161,739,35,774
公投第７案,新北市,新莊區,雙鳳里,477,1252,512,144,656,34,690
公投第７案,新北市,新莊區,龍福里,478,1022,414,113,527,27,554
公投第７案,新北市,新莊區,龍福里,479,959,389,135,524,39,563
公投第７案,新北市,新莊區,龍鳳里,480,1646,215,685,900,53,953
公投第７案,新北市,新莊區,龍鳳里,481,1551,638,166,804,64,868
公投第７案,新北市,新莊區,龍鳳里,482,1526,664,187,851,53,904
公投第７案,新北市,新莊區,龍鳳里,483,1518,634,186,820,30,850
公投第７案,新北市,新莊區,龍鳳里,484,1547,686,171,857,46,903
公投第７案,新北市,新莊區,裕民里,485,1505,575,169,744,81,825
公投第７案,新北市,新莊區,裕民里,486,1527,551,190,741,82,823
公投第７案,新北市,新莊區,裕民里,487,1482,556,167,723,58,781
公投第７案,新北市,新莊區,裕民里,488,1586,606,146,752,67,819
公投第７案,新北市,新莊區,龍安里,489,1065,416,135,551,68,619
公投第７案,新北市,新莊區,龍安里,490,1040,491,134,625,46,671
公投第７案,新北市,新莊區,富國里,491,1090,431,135,566,45,611
公投第７案,新北市,新莊區,富國里,492,1071,439,128,567,54,621
公投第７案,新北市,新莊區,富民里,493,1704,625,193,818,33,851
公投第７案,新北市,新莊區,富民里,494,1698,625,157,782,37,819
公投第７案,新北市,新莊區,後德里,495,1362,636,157,793,56,849
公投第７案,新北市,新莊區,後德里,496,1350,574,167,741,40,781
公投第７案,新北市,新莊區,萬安里,497,1689,705,201,906,65,971
公投第７案,新北市,新莊區,萬安里,498,1612,691,171,862,70,932
公投第７案,新北市,新莊區,建福里,499,1130,488,135,623,61,684
公投第７案,新北市,新莊區,建福里,500,1111,478,148,626,68,694
公投第７案,新北市,新莊區,後港里,501,1539,610,175,785,44,829
公投第７案,新北市,新莊區,後港里,502,1586,631,211,842,37,879
公投第７案,新北市,新莊區,後港里,503,1631,657,199,856,77,933
公投第７案,新北市,新莊區,後港里,504,1540,627,176,803,57,860
公投第７案,新北市,新莊區,四維里,505,1388,469,181,650,48,698
公投第７案,新北市,新莊區,四維里,506,1388,479,159,638,74,712
公投第７案,新北市,新莊區,四維里,507,1387,479,148,627,64,691
公投第７案,新北市,新莊區,南港里,508,1181,473,123,596,36,632
公投第７案,新北市,新莊區,南港里,509,1135,443,170,613,59,672
公投第７案,新北市,新莊區,南港里,510,1173,453,162,615,56,671
公投第７案,新北市,新莊區,南港里,511,1215,518,152,670,35,705
公投第７案,新北市,新莊區,建安里,512,1488,632,186,818,48,866
公投第７案,新北市,新莊區,建安里,513,1444,594,175,769,61,830
公投第７案,新北市,新莊區,建安里,514,1499,604,177,781,48,829
公投第７案,新北市,新莊區,建安里,515,1449,585,188,773,29,802
公投第７案,新北市,新莊區,民全里,516,1640,666,180,846,77,923
公投第７案,新北市,新莊區,民全里,517,1648,625,199,824,79,903
公投第７案,新北市,新莊區,八德里,518,1371,515,156,671,51,722
公投第７案,新北市,新莊區,八德里,519,1400,521,181,702,69,771
公投第７案,新北市,新莊區,成德里,520,1457,587,152,739,71,810
公投第７案,新北市,新莊區,成德里,521,1502,564,169,733,16,749
公投第７案,新北市,新莊區,成德里,522,1412,561,152,713,70,783
公投第７案,新北市,新莊區,民安里,523,1318,528,140,668,63,731
公投第７案,新北市,新莊區,民安里,524,1411,593,177,770,61,831
公投第７案,新北市,新莊區,民安里,525,1262,548,147,695,28,723
公投第７案,新北市,新莊區,民安里,526,1228,594,113,707,36,743
公投第７案,新北市,新莊區,民有里,527,1748,754,190,944,78,1022
公投第７案,新北市,新莊區,民有里,528,1761,767,191,958,70,1028
公投第７案,新北市,新莊區,民本里,529,1326,488,152,640,64,704
公投第７案,新北市,新莊區,民本里,530,1344,460,146,606,64,670
公投第７案,新北市,新莊區,光明里,531,1355,590,130,720,47,767
公投第７案,新北市,新莊區,光明里,532,1306,546,148,694,66,760
公投第７案,新北市,新莊區,光明里,533,1349,600,161,761,38,799
公投第７案,新北市,新莊區,光正里,534,1265,539,127,666,42,708
公投第７案,新北市,新莊區,光正里,535,1282,562,143,705,64,769
公投第７案,新北市,新莊區,光正里,536,1237,575,118,693,54,747
公投第７案,新北市,新莊區,光榮里,537,1301,559,132,691,23,714
公投第７案,新北市,新莊區,光榮里,538,1262,529,137,666,57,723
公投第７案,新北市,新莊區,光榮里,539,1270,538,136,674,49,723
公投第７案,新北市,新莊區,光和里,540,1245,479,171,650,72,722
公投第７案,新北市,新莊區,光和里,541,1220,440,175,615,72,687
公投第７案,新北市,新莊區,光華里,542,1245,509,120,629,41,670
公投第７案,新北市,新莊區,光華里,543,1212,466,123,589,48,637
公投第７案,新北市,新莊區,光華里,544,1253,493,135,628,55,683
公投第７案,新北市,新莊區,光華里,545,1272,479,140,619,56,675
公投第７案,新北市,新莊區,光華里,546,1227,567,126,693,31,724
公投第７案,新北市,新莊區,西盛里,547,1126,503,130,633,41,674
公投第７案,新北市,新莊區,西盛里,548,1240,522,155,677,43,720
公投第７案,新北市,新莊區,西盛里,549,1460,620,162,782,47,829
公投第７案,新北市,新莊區,西盛里,550,1072,421,141,562,39,601
公投第７案,新北市,新莊區,西盛里,551,1127,414,121,535,46,581
公投第７案,新北市,新莊區,西盛里,552,1332,592,149,741,32,773
公投第７案,新北市,新莊區,西盛里,553,1341,513,153,666,18,684
公投第７案,新北市,新莊區,西盛里,554,1140,354,104,458,24,482
公投第７案,新北市,蘆洲區,光華里,555,1600,620,201,821,96,917
公投第７案,新北市,蘆洲區,光華里,556,1549,593,199,792,67,859
公投第７案,新北市,蘆洲區,光華里,557,1516,617,173,790,98,888
公投第７案,新北市,蘆洲區,光明里,558,1404,533,159,692,82,774
公投第７案,新北市,蘆洲區,光明里,559,1381,507,156,663,88,751
公投第７案,新北市,蘆洲區,光明里,560,1485,647,142,789,49,838
公投第７案,新北市,蘆洲區,中路里,561,1779,513,133,646,44,690
公投第７案,新北市,蘆洲區,中路里,562,1797,570,334,904,58,962
公投第７案,新北市,蘆洲區,永安里,563,1364,559,164,723,69,792
公投第７案,新北市,蘆洲區,永安里,564,1635,649,189,838,73,911
公投第７案,新北市,蘆洲區,永安里,565,1567,539,157,696,47,743
公投第７案,新北市,蘆洲區,九芎里,566,1524,590,169,759,54,813
公投第７案,新北市,蘆洲區,九芎里,567,1612,585,172,757,70,827
公投第７案,新北市,蘆洲區,九芎里,568,1674,635,180,815,62,877
公投第７案,新北市,蘆洲區,延平里,569,1838,644,194,838,62,900
公投第７案,新北市,蘆洲區,延平里,570,1814,588,187,775,47,822
公投第７案,新北市,蘆洲區,中華里,571,1473,514,208,722,49,771
公投第７案,新北市,蘆洲區,中華里,572,1465,609,137,746,56,802
公投第７案,新北市,蘆洲區,中原里,573,1652,668,192,860,87,947
公投第７案,新北市,蘆洲區,中原里,574,1650,624,191,815,90,905
公投第７案,新北市,蘆洲區,中原里,575,1656,704,166,870,44,914
公投第７案,新北市,蘆洲區,長安里,576,1571,568,194,762,58,820
公投第７案,新北市,蘆洲區,長安里,577,1523,527,213,740,79,819
公投第７案,新北市,蘆洲區,長安里,578,1475,577,167,744,46,790
公投第７案,新北市,蘆洲區,忠義里,579,1367,529,124,653,69,722
公投第７案,新北市,蘆洲區,忠義里,580,1514,609,190,799,54,853
公投第７案,新北市,蘆洲區,正義里,581,1791,760,237,997,57,1054
公投第７案,新北市,蘆洲區,正義里,582,1714,707,276,983,55,1038
公投第７案,新北市,蘆洲區,正義里,583,1780,781,187,968,41,1009
公投第７案,新北市,蘆洲區,正義里,584,1713,694,220,914,50,964
公投第７案,新北市,蘆洲區,正義里,585,1720,723,216,939,49,988
公投第７案,新北市,蘆洲區,正義里,586,1766,747,173,920,50,970
公投第７案,新北市,蘆洲區,南港里,587,1623,630,184,814,69,883
公投第７案,新北市,蘆洲區,南港里,588,1740,688,209,897,51,948
公投第７案,新北市,蘆洲區,南港里,589,1759,743,207,950,68,1018
公投第７案,新北市,蘆洲區,永樂里,590,1775,722,221,943,81,1024
公投第７案,新北市,蘆洲區,永樂里,591,1909,790,223,1013,76,1089
公投第７案,新北市,蘆洲區,永樂里,592,1805,732,224,956,96,1052
公投第７案,新北市,蘆洲區,成功里,593,1642,629,190,819,49,868
公投第７案,新北市,蘆洲區,成功里,594,1713,651,205,856,59,915
公投第７案,新北市,蘆洲區,成功里,595,1746,619,214,833,64,897
公投第７案,新北市,蘆洲區,成功里,596,1596,621,189,810,65,875
公投第７案,新北市,蘆洲區,永康里,597,1434,554,143,697,58,755
公投第７案,新北市,蘆洲區,永康里,598,1450,541,182,723,71,794
公投第７案,新北市,蘆洲區,永康里,599,1543,572,161,733,26,759
公投第７案,新北市,蘆洲區,永康里,600,1525,617,154,771,49,820
公投第７案,新北市,蘆洲區,永德里,601,1419,513,140,653,79,732
公投第７案,新北市,蘆洲區,永德里,602,1298,518,166,684,56,740
公投第７案,新北市,蘆洲區,永德里,603,1304,492,146,638,68,706
公投第７案,新北市,蘆洲區,樓厝里,604,1806,675,221,896,72,968
公投第７案,新北市,蘆洲區,樓厝里,605,1910,703,211,914,79,993
公投第７案,新北市,蘆洲區,樓厝里,606,1873,595,185,780,67,847
公投第７案,新北市,蘆洲區,信義里,607,1785,596,189,785,57,842
公投第７案,新北市,蘆洲區,信義里,608,1760,604,197,801,66,867
公投第７案,新北市,蘆洲區,玉清里,609,1841,766,182,948,73,1021
公投第７案,新北市,蘆洲區,玉清里,610,1855,662,174,836,40,876
公投第７案,新北市,蘆洲區,玉清里,611,1450,506,147,653,77,730
公投第７案,新北市,蘆洲區,復興里,612,1585,569,184,753,76,829
公投第７案,新北市,蘆洲區,復興里,613,1541,544,147,691,96,787
公投第７案,新北市,蘆洲區,福安里,614,1626,630,160,790,68,858
公投第７案,新北市,蘆洲區,福安里,615,1241,498,155,653,63,716
公投第７案,新北市,蘆洲區,鷺江里,616,1634,626,183,809,70,879
公投第７案,新北市,蘆洲區,鷺江里,617,1573,609,191,800,69,869
公投第７案,新北市,蘆洲區,鷺江里,618,1619,640,222,862,49,911
公投第７案,新北市,蘆洲區,恆德里,619,1878,728,207,935,95,1030
公投第７案,新北市,蘆洲區,恆德里,620,1797,677,200,877,90,967
公投第７案,新北市,蘆洲區,恆德里,621,1816,733,235,968,42,1010
公投第７案,新北市,蘆洲區,溪墘里,622,1344,525,186,711,84,795
公投第７案,新北市,蘆洲區,溪墘里,623,1492,591,237,828,57,885
公投第７案,新北市,蘆洲區,仁復里,624,1959,723,215,938,113,1051
公投第７案,新北市,蘆洲區,仁德里,625,1611,576,209,785,97,882
公投第７案,新北市,蘆洲區,仁德里,626,1574,609,208,817,85,902
公投第７案,新北市,蘆洲區,仁德里,627,1653,672,182,854,72,926
公投第７案,新北市,蘆洲區,仁義里,628,3085,764,225,989,64,1053
公投第７案,新北市,蘆洲區,仁義里,629,1812,663,230,893,76,969
公投第７案,新北市,蘆洲區,得勝里,630,1332,498,174,672,64,736
公投第７案,新北市,蘆洲區,得勝里,631,1648,527,164,691,86,777
公投第７案,新北市,蘆洲區,得仁里,632,1355,520,141,661,29,690
公投第７案,新北市,蘆洲區,得仁里,633,1371,519,143,662,44,706
公投第７案,新北市,蘆洲區,保和里,634,1111,412,158,570,69,639
公投第７案,新北市,蘆洲區,保和里,635,1176,465,158,623,76,699
公投第７案,新北市,蘆洲區,樹德里,636,1602,635,192,827,64,891
公投第７案,新北市,蘆洲區,樹德里,637,1361,456,178,634,60,694
公投第７案,新北市,蘆洲區,民和里,638,1530,602,159,761,67,828
公投第７案,新北市,蘆洲區,民和里,639,925,356,105,461,67,528
公投第７案,新北市,蘆洲區,水湳里,640,1851,698,214,912,83,995
公投第７案,新北市,蘆洲區,水湳里,641,1791,619,194,813,63,876
公投第７案,新北市,蘆洲區,水湳里,642,1853,664,181,845,72,917
公投第７案,新北市,蘆洲區,水湳里,643,1758,628,181,809,52,861
公投第７案,新北市,蘆洲區,水湳里,644,1798,688,196,884,84,968
公投第７案,新北市,蘆洲區,水河里,645,1645,646,192,838,59,897
公投第７案,新北市,蘆洲區,水河里,646,1612,573,162,735,57,792
公投第７案,新北市,蘆洲區,水河里,647,1784,599,177,776,82,858
公投第７案,新北市,蘆洲區,水河里,648,1701,562,163,725,63,788
公投第７案,新北市,蘆洲區,水河里,649,1581,604,161,765,45,810
公投第７案,新北市,蘆洲區,仁愛里,650,1534,584,200,784,60,844
公投第７案,新北市,蘆洲區,仁愛里,651,1620,641,211,852,69,921
公投第７案,新北市,蘆洲區,仁愛里,652,1494,640,173,813,73,886
公投第７案,新北市,蘆洲區,忠孝里,653,1183,470,134,604,53,657
公投第７案,新北市,蘆洲區,忠孝里,654,985,374,145,519,53,572
公投第７案,新北市,蘆洲區,保佑里,655,1673,589,194,783,84,867
公投第７案,新北市,蘆洲區,保佑里,656,1688,646,193,839,103,942
公投第７案,新北市,蘆洲區,保新里,657,1249,392,140,532,52,584
公投第７案,新北市,蘆洲區,保新里,658,1476,535,170,705,73,778
公投第７案,新北市,三重區,大有里,659,1509,577,159,736,71,807
公投第７案,新北市,三重區,大有里,660,1591,655,198,853,67,920
公投第７案,新北市,三重區,大有里,661,1653,677,204,881,71,952
公投第７案,新北市,三重區,博愛里,662,1392,552,194,746,79,825
公投第７案,新北市,三重區,博愛里,663,1451,618,165,783,97,880
公投第７案,新北市,三重區,博愛里,664,1329,505,170,675,86,761
公投第７案,新北市,三重區,二重里,665,1459,621,162,783,49,832
公投第７案,新北市,三重區,頂崁里,666,1024,417,135,552,62,614
公投第７案,新北市,三重區,頂崁里,667,1066,435,144,579,62,641
公投第７案,新北市,三重區,谷王里,668,856,395,107,502,64,566
公投第７案,新北市,三重區,五谷里,669,764,296,101,397,42,439
公投第７案,新北市,三重區,五谷里,670,821,337,121,458,48,506
公投第７案,新北市,三重區,中興里,671,1887,670,241,911,70,981
公投第７案,新北市,三重區,中興里,672,1646,607,201,808,57,865
公投第７案,新北市,三重區,德厚里,673,358,154,39,193,17,210
公投第７案,新北市,三重區,成功里,674,1039,458,119,577,44,621
公投第７案,新北市,三重區,成功里,675,1114,444,170,614,42,656
公投第７案,新北市,三重區,成功里,676,1588,662,215,877,57,934
公投第７案,新北市,三重區,成功里,677,1702,649,198,847,62,909
公投第７案,新北市,三重區,福祉里,678,1288,539,191,730,63,793
公投第７案,新北市,三重區,福祉里,679,1629,673,249,922,65,987
公投第７案,新北市,三重區,福祉里,680,1861,762,209,971,73,1044
公投第７案,新北市,三重區,福德里,681,1727,634,204,838,53,891
公投第７案,新北市,三重區,福德里,682,1813,732,215,947,56,1003
公投第７案,新北市,三重區,福民里,683,1595,651,178,829,78,907
公投第７案,新北市,三重區,福民里,684,1513,601,199,800,71,871
公投第７案,新北市,三重區,過田里,685,4433,554,216,770,53,823
公投第７案,新北市,三重區,過田里,686,1283,529,167,696,49,745
公投第７案,新北市,三重區,過田里,687,1430,621,193,814,57,871
公投第７案,新北市,三重區,過田里,688,1357,597,199,796,34,830
公投第７案,新北市,三重區,錦田里,689,963,403,121,524,46,570
公投第７案,新北市,三重區,錦田里,690,883,355,107,462,53,515
公投第７案,新北市,三重區,重明里,691,1494,584,168,752,102,854
公投第７案,新北市,三重區,重明里,692,1616,664,200,864,91,955
公投第７案,新北市,三重區,光田里,693,1329,532,155,687,76,763
公投第７案,新北市,三重區,光田里,694,1289,553,194,747,58,805
公投第７案,新北市,三重區,光田里,695,1380,514,199,713,87,800
公投第７案,新北市,三重區,光陽里,696,1668,713,176,889,54,943
公投第７案,新北市,三重區,光陽里,697,1226,536,162,698,78,776
公投第７案,新北市,三重區,光陽里,698,1421,585,180,765,69,834
公投第７案,新北市,三重區,光陽里,699,1364,582,157,739,61,800
公投第７案,新北市,三重區,田心里,700,1232,521,166,687,46,733
公投第７案,新北市,三重區,田心里,701,1248,547,171,718,60,778
公投第７案,新北市,三重區,田心里,702,1256,490,197,687,68,755
公投第７案,新北市,三重區,福田里,703,1506,635,222,857,75,932
公投第７案,新北市,三重區,福田里,704,1669,706,224,930,62,992
公投第７案,新北市,三重區,田中里,705,1308,519,150,669,97,766
公投第７案,新北市,三重區,田中里,706,1263,616,159,775,53,828
公投第７案,新北市,三重區,田中里,707,1471,572,183,755,183,938
公投第７案,新北市,三重區,田中里,708,1447,556,204,760,112,872
公投第７案,新北市,三重區,田安里,709,1693,572,189,761,71,832
公投第７案,新北市,三重區,田安里,710,2015,779,230,1009,73,1082
公投第７案,新北市,三重區,田安里,711,1812,655,196,851,97,948
公投第７案,新北市,三重區,三民里,712,1509,533,171,704,53,757
公投第７案,新北市,三重區,三民里,713,1439,594,173,767,65,832
公投第７案,新北市,三重區,光明里,714,1437,578,174,752,67,819
公投第７案,新北市,三重區,光明里,715,1697,642,216,858,62,920
公投第７案,新北市,三重區,光明里,716,1793,693,172,865,50,915
公投第７案,新北市,三重區,光明里,717,1603,688,211,899,60,959
公投第７案,新北市,三重區,光正里,718,1166,455,138,593,41,634
公投第７案,新北市,三重區,光正里,719,1126,486,133,619,45,664
公投第７案,新北市,三重區,同安里,720,1291,451,134,585,63,648
公投第７案,新北市,三重區,同慶里,721,1597,595,202,797,100,897
公投第７案,新北市,三重區,菜寮里,722,1081,459,131,590,72,662
公投第７案,新北市,三重區,菜寮里,723,911,385,141,526,62,588
公投第７案,新北市,三重區,永春里,724,1719,609,174,783,56,839
公投第７案,新北市,三重區,中正里,725,1289,482,159,641,83,724
公投第７案,新北市,三重區,吉利里,726,1318,519,187,706,97,803
公投第７案,新北市,三重區,大同里,727,1822,641,223,864,80,944
公投第７案,新北市,三重區,中民里,728,1185,424,166,590,100,690
公投第７案,新北市,三重區,平和里,729,1369,502,133,635,87,722
公投第７案,新北市,三重區,大安里,730,1507,636,186,822,69,891
公投第７案,新北市,三重區,仁德里,731,926,374,115,489,63,552
公投第７案,新北市,三重區,仁德里,732,950,342,100,442,21,463
公投第７案,新北市,三重區,忠孝里,733,1678,612,200,812,79,891
公投第７案,新北市,三重區,仁義里,734,1117,435,124,559,79,638
公投第７案,新北市,三重區,光榮里,735,1318,490,143,633,63,696
公投第７案,新北市,三重區,光輝里,736,1388,537,170,707,46,753
公投第７案,新北市,三重區,福星里,737,1026,395,126,521,77,598
公投第７案,新北市,三重區,福利里,738,1096,473,149,622,49,671
公投第７案,新北市,三重區,福利里,739,967,412,126,538,35,573
公投第７案,新北市,三重區,清和里,740,1871,668,239,907,75,982
公投第７案,新北市,三重區,清和里,741,1663,669,179,848,85,933
公投第７案,新北市,三重區,永興里,742,1208,474,129,603,32,635
公投第７案,新北市,三重區,中山里,743,1398,480,183,663,57,720
公投第７案,新北市,三重區,中山里,744,1078,407,129,536,33,569
公投第７案,新北市,三重區,大園里,745,1102,397,123,520,66,586
公投第７案,新北市,三重區,大園里,746,1393,506,176,682,85,767
公投第７案,新北市,三重區,國隆里,747,1251,526,143,669,74,743
公投第７案,新北市,三重區,國隆里,748,1234,554,165,719,66,785
公投第７案,新北市,三重區,重陽里,749,1661,655,222,877,82,959
公投第７案,新北市,三重區,重陽里,750,1590,632,195,827,80,907
公投第７案,新北市,三重區,民生里,751,1182,463,162,625,76,701
公投第７案,新北市,三重區,民生里,752,1369,541,200,741,77,818
公投第７案,新北市,三重區,民生里,753,1222,524,178,702,56,758
公投第７案,新北市,三重區,重新里,754,1304,464,172,636,104,740
公投第７案,新北市,三重區,正德里,755,1054,395,119,514,52,566
公投第７案,新北市,三重區,正義里,756,1635,605,230,835,80,915
公投第７案,新北市,三重區,正安里,757,1779,667,188,855,79,934
公投第７案,新北市,三重區,自強里,758,1633,666,182,848,86,934
公投第７案,新北市,三重區,文化里,759,1107,452,133,585,54,639
公投第７案,新北市,三重區,文化里,760,1021,450,135,585,48,633
公投第７案,新北市,三重區,中央里,761,1649,560,194,754,101,855
公投第７案,新北市,三重區,雙園里,762,874,348,109,457,39,496
公投第７案,新北市,三重區,錦通里,763,1402,538,173,711,112,823
公投第７案,新北市,三重區,錦安里,764,1713,574,198,772,93,865
公投第７案,新北市,三重區,長安里,765,973,330,105,435,54,489
公投第７案,新北市,三重區,長安里,766,1038,409,147,556,59,615
公投第７案,新北市,三重區,光華里,767,1833,650,195,845,96,941
公投第７案,新北市,三重區,長生里,768,817,311,102,413,45,458
公投第７案,新北市,三重區,開元里,769,1387,567,180,747,80,827
公投第７案,新北市,三重區,大德里,770,784,346,91,437,32,469
公投第７案,新北市,三重區,長元里,771,1096,398,131,529,31,560
公投第７案,新北市,三重區,長元里,772,1163,492,139,631,62,693
公投第７案,新北市,三重區,長江里,773,1868,724,193,917,62,979
公投第７案,新北市,三重區,長泰里,774,1117,411,133,544,71,615
公投第７案,新北市,三重區,長泰里,775,934,343,102,445,54,499
公投第７案,新北市,三重區,長福里,776,1412,492,173,665,76,741
公投第７案,新北市,三重區,介壽里,777,1062,500,120,620,50,670
公投第７案,新北市,三重區,萬壽里,778,891,354,82,436,76,512
公投第７案,新北市,三重區,萬壽里,779,936,428,123,551,88,639
公投第７案,新北市,三重區,錦江里,780,1085,392,134,526,72,598
公投第７案,新北市,三重區,錦江里,781,1065,354,132,486,22,508
公投第７案,新北市,三重區,龍濱里,782,1398,555,184,739,66,805
公投第７案,新北市,三重區,龍濱里,783,1550,627,198,825,58,883
公投第７案,新北市,三重區,龍門里,784,1674,608,199,807,98,905
公投第７案,新北市,三重區,秀江里,785,1215,496,142,638,73,711
公投第７案,新北市,三重區,奕壽里,786,1606,589,220,809,75,884
公投第７案,新北市,三重區,三安里,787,1182,493,111,604,56,660
公投第７案,新北市,三重區,三安里,788,1238,498,142,640,88,728
公投第７案,新北市,三重區,福安里,789,1342,560,175,735,63,798
公投第７案,新北市,三重區,福安里,790,1408,580,180,760,59,819
公投第７案,新北市,三重區,信安里,791,1770,696,188,884,103,987
公投第７案,新北市,三重區,安慶里,792,940,367,121,488,61,549
公投第７案,新北市,三重區,安慶里,793,975,366,118,484,24,508
公投第７案,新北市,三重區,幸福里,794,1507,577,170,747,54,801
公投第７案,新北市,三重區,幸福里,795,1419,553,184,737,76,813
公投第７案,新北市,三重區,幸福里,796,1257,523,136,659,57,716
公投第７案,新北市,三重區,六合里,797,1619,601,230,831,90,921
公投第７案,新北市,三重區,六合里,798,1745,673,191,864,88,952
公投第７案,新北市,三重區,六福里,799,1519,579,207,786,72,858
公投第７案,新北市,三重區,六福里,800,1682,621,186,807,82,889
公投第７案,新北市,三重區,六福里,801,1697,703,219,922,68,990
公投第７案,新北市,三重區,順德里,802,1073,405,95,500,78,578
公投第７案,新北市,三重區,順德里,803,924,347,107,454,56,510
公投第７案,新北市,三重區,承德里,804,1613,541,160,701,56,757
公投第７案,新北市,三重區,瑞德里,805,1034,398,97,495,58,553
公投第７案,新北市,三重區,瑞德里,806,1118,429,145,574,70,644
公投第７案,新北市,三重區,崇德里,807,1269,463,166,629,82,711
公投第７案,新北市,三重區,崇德里,808,990,351,130,481,69,550
公投第７案,新北市,三重區,崇德里,809,1336,510,160,670,85,755
公投第７案,新北市,三重區,厚德里,810,1601,649,184,833,63,896
公投第７案,新北市,三重區,厚德里,811,1581,611,258,869,82,951
公投第７案,新北市,三重區,維德里,812,1345,554,162,716,65,781
公投第７案,新北市,三重區,維德里,813,1226,499,198,697,56,753
公投第７案,新北市,三重區,尚德里,814,1650,628,146,774,93,867
公投第７案,新北市,三重區,尚德里,815,1140,469,120,589,67,656
公投第７案,新北市,三重區,培德里,816,1639,633,169,802,41,843
公投第７案,新北市,三重區,培德里,817,1699,670,194,864,84,948
公投第７案,新北市,三重區,立德里,818,1501,700,202,902,92,994
公投第７案,新北市,三重區,立德里,819,1538,611,189,800,70,870
公投第７案,新北市,三重區,永德里,820,1540,590,160,750,93,843
公投第７案,新北市,三重區,永德里,821,1276,518,142,660,61,721
公投第７案,新北市,三重區,永德里,822,1539,559,207,766,70,836
公投第７案,新北市,三重區,永煇里,823,1170,496,155,651,52,703
公投第７案,新北市,三重區,永煇里,824,1120,427,169,596,42,638
公投第７案,新北市,三重區,永發里,825,1789,715,200,915,94,1009
公投第７案,新北市,三重區,永發里,826,1520,539,198,737,71,808
公投第７案,新北市,三重區,永發里,827,1821,696,239,935,82,1017
公投第７案,新北市,三重區,永盛里,828,1407,551,162,713,83,796
公投第７案,新北市,三重區,永盛里,829,1491,594,174,768,67,835
公投第７案,新北市,三重區,永吉里,830,1381,574,175,749,76,825
公投第７案,新北市,三重區,永吉里,831,1222,478,147,625,89,714
公投第７案,新北市,三重區,永安里,832,1938,743,207,950,65,1015
公投第７案,新北市,三重區,永安里,833,1639,740,78,818,50,868
公投第７案,新北市,三重區,永豐里,834,1614,665,151,816,89,905
公投第７案,新北市,三重區,永豐里,835,1709,677,188,865,76,941
公投第７案,新北市,三重區,永豐里,836,1753,646,182,828,79,907
公投第７案,新北市,三重區,永福里,837,1398,528,210,738,81,819
公投第７案,新北市,三重區,永福里,838,1706,623,206,829,92,921
公投第７案,新北市,三重區,永福里,839,1614,646,208,854,71,925
公投第７案,新北市,三重區,永清里,840,1591,620,206,826,68,894
公投第７案,新北市,三重區,永清里,841,1627,617,190,807,64,871
公投第７案,新北市,三重區,永清里,842,1505,580,194,774,92,866
公投第７案,新北市,三重區,永順里,843,1331,554,150,704,50,754
公投第７案,新北市,三重區,永順里,844,1678,603,153,756,54,810
公投第７案,新北市,三重區,永順里,845,1498,604,177,781,65,846
公投第７案,新北市,三重區,溪美里,846,1800,744,238,982,78,1060
公投第７案,新北市,三重區,溪美里,847,1703,602,183,785,53,838
公投第７案,新北市,三重區,溪美里,848,1975,728,199,927,57,984
公投第７案,新北市,三重區,溪美里,849,1894,679,235,914,70,984
公投第７案,新北市,三重區,福隆里,850,1405,585,181,766,58,824
公投第７案,新北市,三重區,福隆里,851,1293,529,168,697,46,743
公投第７案,新北市,三重區,福隆里,852,1259,500,165,665,62,727
公投第７案,新北市,三重區,五常里,853,1144,477,149,626,82,708
公投第７案,新北市,三重區,五常里,854,1254,525,162,687,80,767
公投第７案,新北市,三重區,五常里,855,1313,533,143,676,68,744
公投第７案,新北市,三重區,五福里,856,1594,587,197,784,85,869
公投第７案,新北市,三重區,五福里,857,1775,697,207,904,76,980
公投第７案,新北市,三重區,仁忠里,858,1516,569,178,747,101,848
公投第７案,新北市,三重區,仁忠里,859,1315,552,167,719,102,821
公投第７案,新北市,三重區,慈福里,860,843,338,114,452,67,519
公投第７案,新北市,三重區,慈福里,861,1160,433,110,543,64,607
公投第７案,新北市,三重區,慈生里,862,1052,435,121,556,60,616
公投第７案,新北市,三重區,慈生里,863,1054,454,153,607,64,671
公投第７案,新北市,三重區,慈惠里,864,997,389,138,527,62,589
公投第７案,新北市,三重區,慈惠里,865,936,334,122,456,43,499
公投第７案,新北市,三重區,慈愛里,866,1658,619,191,810,99,909
公投第７案,新北市,三重區,慈愛里,867,1496,541,188,729,82,811
公投第７案,新北市,三重區,慈化里,868,1064,466,132,598,62,660
公投第７案,新北市,三重區,慈化里,869,1152,501,141,642,62,704
公投第７案,新北市,三重區,慈祐里,870,1532,583,152,735,48,783
公投第７案,新北市,三重區,慈祐里,871,1338,476,121,597,39,636
公投第７案,新北市,三重區,慈祐里,872,1303,525,163,688,77,765
公投第７案,新北市,三重區,富華里,873,1369,588,145,733,86,819
公投第７案,新北市,三重區,富華里,874,1491,594,158,752,84,836
公投第７案,新北市,三重區,富貴里,875,1821,637,196,833,115,948
公投第７案,新北市,三重區,富貴里,876,1906,699,198,897,69,966
公投第７案,新北市,三重區,富貴里,877,1842,690,273,963,78,1041
公投第７案,新北市,三重區,富福里,878,878,336,90,426,46,472
公投第７案,新北市,三重區,富福里,879,963,425,136,561,62,623
公投第７案,新北市,三重區,五華里,880,1381,470,154,624,31,655
公投第７案,新北市,三重區,五華里,881,1681,600,159,759,74,833
公投第７案,新北市,三重區,五華里,882,1548,565,177,742,48,790
公投第７案,新北市,三重區,碧華里,883,1542,613,205,818,76,894
公投第７案,新北市,三重區,碧華里,884,1557,611,186,797,73,870
公投第７案,新北市,三重區,碧華里,885,1661,685,166,851,46,897
公投第７案,新北市,三重區,碧華里,886,2024,800,215,1015,39,1054
公投第７案,新北市,三重區,福樂里,887,1588,618,107,725,66,791
公投第７案,新北市,三重區,福樂里,888,1706,616,200,816,122,938
公投第７案,新北市,三重區,仁華里,889,1341,549,177,726,57,783
公投第７案,新北市,三重區,仁華里,890,1025,381,107,488,49,537
公投第７案,新北市,三重區,仁華里,891,1339,540,147,687,77,764
公投第７案,新北市,三重區,五順里,892,1725,636,214,850,108,958
公投第７案,新北市,三重區,五順里,893,1826,772,190,962,80,1042
公投第７案,新北市,板橋區,留侯里,894,1388,514,183,697,72,769
公投第７案,新北市,板橋區,流芳里,895,1294,517,195,712,49,761
公投第７案,新北市,板橋區,赤松里,896,667,291,88,379,18,397
公投第７案,新北市,板橋區,黃石里,897,898,321,112,433,41,474
公投第７案,新北市,板橋區,挹秀里,898,829,363,107,470,34,504
公投第７案,新北市,板橋區,挹秀里,899,739,345,75,420,40,460
公投第７案,新北市,板橋區,湳興里,900,1035,431,143,574,55,629
公投第７案,新北市,板橋區,湳興里,901,1713,570,158,728,34,762
公投第７案,新北市,板橋區,湳興里,902,658,246,63,309,18,327
公投第７案,新北市,板橋區,湳興里,903,1312,497,144,641,93,734
公投第７案,新北市,板橋區,新興里,904,1492,535,164,699,64,763
公投第７案,新北市,板橋區,新興里,905,1393,496,179,675,65,740
公投第７案,新北市,板橋區,社後里,906,4742,602,216,818,61,879
公投第７案,新北市,板橋區,社後里,907,1439,565,152,717,36,753
公投第７案,新北市,板橋區,社後里,908,1187,494,150,644,71,715
公投第７案,新北市,板橋區,社後里,909,1122,455,123,578,33,611
公投第７案,新北市,板橋區,香社里,910,1363,567,157,724,59,783
公投第７案,新北市,板橋區,香社里,911,1093,454,142,596,52,648
公投第７案,新北市,板橋區,香社里,912,1331,541,175,716,51,767
公投第７案,新北市,板橋區,香雅里,913,1026,455,132,587,54,641
公投第７案,新北市,板橋區,香雅里,914,1244,518,137,655,70,725
公投第７案,新北市,板橋區,中正里,915,1268,469,141,610,80,690
公投第７案,新北市,板橋區,中正里,916,1313,463,145,608,40,648
公投第７案,新北市,板橋區,中正里,917,1196,533,145,678,52,730
公投第７案,新北市,板橋區,自強里,918,1137,563,162,725,49,774
公投第７案,新北市,板橋區,自強里,919,1269,568,180,748,57,805
公投第７案,新北市,板橋區,自強里,920,1117,506,134,640,27,667
公投第７案,新北市,板橋區,自強里,921,1042,488,114,602,57,659
公投第７案,新北市,板橋區,自立里,922,1257,520,162,682,77,759
公投第７案,新北市,板橋區,自立里,923,1216,505,139,644,79,723
公投第７案,新北市,板橋區,光華里,924,1126,473,124,597,60,657
公投第７案,新北市,板橋區,光華里,925,1290,604,176,780,64,844
公投第７案,新北市,板橋區,光榮里,926,1215,455,128,583,13,596
公投第７案,新北市,板橋區,光榮里,927,1099,411,129,540,27,567
公投第７案,新北市,板橋區,國光里,928,1329,700,126,826,44,870
公投第７案,新北市,板橋區,國光里,929,996,479,94,573,34,607
公投第７案,新北市,板橋區,國光里,930,1047,456,123,579,41,620
公投第７案,新北市,板橋區,港尾里,931,1272,547,156,703,62,765
公投第７案,新北市,板橋區,港尾里,932,1252,540,150,690,55,745
公投第７案,新北市,板橋區,新生里,933,1238,502,161,663,68,731
公投第７案,新北市,板橋區,新生里,934,1389,637,168,805,78,883
公投第７案,新北市,板橋區,新生里,935,1194,499,172,671,72,743
公投第７案,新北市,板橋區,金華里,936,1093,412,111,523,59,582
公投第７案,新北市,板橋區,金華里,937,1148,447,136,583,74,657
公投第７案,新北市,板橋區,金華里,938,1268,536,154,690,44,734
公投第７案,新北市,板橋區,港德里,939,1230,494,153,647,71,718
公投第７案,新北市,板橋區,港德里,940,1012,408,115,523,53,576
公投第７案,新北市,板橋區,港德里,941,811,343,96,439,47,486
公投第７案,新北市,板橋區,港德里,942,1197,519,156,675,77,752
公投第７案,新北市,板橋區,民權里,943,1142,459,121,580,29,609
公投第７案,新北市,板橋區,民權里,944,1222,486,150,636,57,693
公投第７案,新北市,板橋區,民安里,945,796,361,101,462,44,506
公投第７案,新北市,板橋區,民安里,946,997,465,106,571,76,647
公投第７案,新北市,板橋區,建國里,947,1011,388,169,557,30,587
公投第７案,新北市,板橋區,建國里,948,1157,460,143,603,64,667
公投第７案,新北市,板橋區,建國里,949,1040,450,125,575,60,635
公投第７案,新北市,板橋區,漢生里,950,1173,530,136,666,42,708
公投第７案,新北市,板橋區,漢生里,951,1193,476,140,616,28,644
公投第７案,新北市,板橋區,漢生里,952,1255,533,156,689,40,729
公投第７案,新北市,板橋區,公舘里,953,1306,513,179,692,60,752
公投第７案,新北市,板橋區,公舘里,954,1050,441,123,564,15,579
公投第７案,新北市,板橋區,公舘里,955,942,379,129,508,33,541
公投第７案,新北市,板橋區,新民里,956,1133,492,161,653,58,711
公投第７案,新北市,板橋區,新民里,957,1251,527,148,675,52,727
公投第７案,新北市,板橋區,新民里,958,1293,575,153,728,39,767
公投第７案,新北市,板橋區,幸福里,959,1208,433,152,585,67,652
公投第７案,新北市,板橋區,幸福里,960,1223,484,151,635,75,710
公投第７案,新北市,板橋區,幸福里,961,1061,422,127,549,55,604
公投第７案,新北市,板橋區,文德里,962,1515,643,164,807,46,853
公投第７案,新北市,板橋區,文德里,963,1225,530,158,688,67,755
公投第７案,新北市,板橋區,忠誠里,964,1120,563,116,679,30,709
公投第７案,新北市,板橋區,忠誠里,965,1091,523,124,647,40,687
公投第７案,新北市,板橋區,忠誠里,966,1385,695,114,809,43,852
公投第７案,新北市,板橋區,陽明里,967,1283,535,188,723,70,793
公投第７案,新北市,板橋區,陽明里,968,1204,479,146,625,93,718
公投第７案,新北市,板橋區,百壽里,969,1191,559,139,698,59,757
公投第７案,新北市,板橋區,百壽里,970,1078,474,148,622,64,686
公投第７案,新北市,板橋區,介壽里,971,1351,540,178,718,78,796
公投第７案,新北市,板橋區,介壽里,972,1322,549,161,710,68,778
公投第７案,新北市,板橋區,新埔里,973,868,351,116,467,61,528
公投第７案,新北市,板橋區,新埔里,974,1029,450,165,615,76,691
公投第７案,新北市,板橋區,華江里,975,1602,691,204,895,40,935
公投第７案,新北市,板橋區,華江里,976,1362,568,182,750,69,819
公投第７案,新北市,板橋區,華江里,977,1698,663,208,871,91,962
公投第７案,新北市,板橋區,華江里,978,1495,646,154,800,48,848
公投第７案,新北市,板橋區,江翠里,979,1522,531,229,760,85,845
公投第７案,新北市,板橋區,江翠里,980,1279,544,138,682,72,754
公投第７案,新北市,板橋區,江翠里,981,1559,511,151,662,64,726
公投第７案,新北市,板橋區,純翠里,982,1537,538,187,725,104,829
公投第７案,新北市,板橋區,純翠里,983,1531,520,175,695,92,787
公投第７案,新北市,板橋區,純翠里,984,1720,648,208,856,38,894
公投第７案,新北市,板橋區,溪頭里,985,1165,431,125,556,43,599
公投第７案,新北市,板橋區,溪頭里,986,1857,793,203,996,64,1060
公投第７案,新北市,板橋區,溪頭里,987,1078,427,133,560,71,631
公投第７案,新北市,板橋區,溪頭里,988,1177,431,152,583,26,609
公投第７案,新北市,板橋區,聯翠里,989,1798,734,222,956,62,1018
公投第７案,新北市,板橋區,聯翠里,990,1455,603,167,770,110,880
公投第７案,新北市,板橋區,文化里,991,1245,519,177,696,68,764
公投第７案,新北市,板橋區,文化里,992,1704,601,234,835,96,931
公投第７案,新北市,板橋區,宏翠里,993,1600,692,185,877,44,921
公投第７案,新北市,板橋區,宏翠里,994,1409,509,160,669,40,709
公投第７案,新北市,板橋區,宏翠里,995,1286,476,170,646,60,706
公投第７案,新北市,板橋區,仁翠里,996,1359,394,150,544,124,668
公投第７案,新北市,板橋區,仁翠里,997,1188,430,146,576,54,630
公投第７案,新北市,板橋區,新翠里,998,1627,600,177,777,59,836
公投第７案,新北市,板橋區,新翠里,999,1633,552,163,715,37,752
公投第７案,新北市,板橋區,新翠里,1000,1814,761,224,985,107,1092
公投第７案,新北市,板橋區,新翠里,1001,1810,719,224,943,87,1030
公投第７案,新北市,板橋區,朝陽里,1002,1133,444,131,575,83,658
公投第７案,新北市,板橋區,朝陽里,1003,841,331,100,431,42,473
公投第７案,新北市,板橋區,朝陽里,1004,1050,459,138,597,61,658
公投第７案,新北市,板橋區,吉翠里,1005,1130,419,137,556,79,635
公投第７案,新北市,板橋區,吉翠里,1006,1056,452,136,588,72,660
公投第７案,新北市,板橋區,吉翠里,1007,1129,421,126,547,32,579
公投第７案,新北市,板橋區,德翠里,1008,1713,671,215,886,88,974
公投第７案,新北市,板橋區,德翠里,1009,1622,665,202,867,76,943
公投第７案,新北市,板橋區,德翠里,1010,1427,659,168,827,64,891
公投第７案,新北市,板橋區,德翠里,1011,1471,696,171,867,29,896
公投第７案,新北市,板橋區,新海里,1012,1076,425,58,483,25,508
公投第７案,新北市,板橋區,新海里,1013,979,343,97,440,16,456
公投第７案,新北市,板橋區,新海里,1014,1079,509,123,632,34,666
公投第７案,新北市,板橋區,滿翠里,1015,828,306,102,408,63,471
公投第７案,新北市,板橋區,滿翠里,1016,820,315,131,446,67,513
公投第７案,新北市,板橋區,滿翠里,1017,989,402,125,527,42,569
公投第７案,新北市,板橋區,明翠里,1018,1023,386,146,532,68,600
公投第７案,新北市,板橋區,明翠里,1019,1044,391,135,526,35,561
公投第７案,新北市,板橋區,明翠里,1020,968,381,120,501,70,571
公投第７案,新北市,板橋區,明翠里,1021,1222,494,164,658,35,693
公投第７案,新北市,板橋區,松翠里,1022,1385,548,155,703,48,751
公投第７案,新北市,板橋區,松翠里,1023,1585,591,193,784,70,854
公投第７案,新北市,板橋區,柏翠里,1024,1840,688,225,913,91,1004
公投第７案,新北市,板橋區,柏翠里,1025,1806,736,266,1002,104,1106
公投第７案,新北市,板橋區,龍翠里,1026,1506,581,191,772,86,858
公投第７案,新北市,板橋區,龍翠里,1027,1476,578,167,745,96,841
公投第７案,新北市,板橋區,龍翠里,1028,1500,623,168,791,83,874
公投第７案,新北市,板橋區,松柏里,1029,1096,489,140,629,65,694
公投第７案,新北市,板橋區,松柏里,1030,963,389,135,524,79,603
公投第７案,新北市,板橋區,華翠里,1031,1601,607,194,801,41,842
公投第７案,新北市,板橋區,華翠里,1032,1507,640,204,844,81,925
公投第７案,新北市,板橋區,莒光里,1033,1315,543,200,743,78,821
公投第７案,新北市,板橋區,莒光里,1034,1178,438,157,595,34,629
公投第７案,新北市,板橋區,忠翠里,1035,1822,783,215,998,89,1087
公投第７案,新北市,板橋區,忠翠里,1036,1605,677,231,908,91,999
公投第７案,新北市,板橋區,忠翠里,1037,1549,669,207,876,20,896
公投第７案,新北市,板橋區,忠翠里,1038,1948,859,243,1102,53,1155
公投第７案,新北市,板橋區,忠翠里,1039,1935,783,210,993,33,1026
公投第７案,新北市,板橋區,嵐翠里,1040,1097,401,126,527,47,574
公投第７案,新北市,板橋區,嵐翠里,1041,1095,407,137,544,52,596
公投第７案,新北市,板橋區,文聖里,1042,1678,606,220,826,99,925
公投第７案,新北市,板橋區,文聖里,1043,1750,667,198,865,100,965
公投第７案,新北市,板橋區,文翠里,1044,1187,460,147,607,58,665
公投第７案,新北市,板橋區,文翠里,1045,1154,475,162,637,31,668
公投第７案,新北市,板橋區,文翠里,1046,1262,512,154,666,41,707
公投第７案,新北市,板橋區,青翠里,1047,1271,487,142,629,90,719
公投第７案,新北市,板橋區,青翠里,1048,1410,532,175,707,98,805
公投第７案,新北市,板橋區,懷翠里,1049,1745,643,176,819,90,909
公投第７案,新北市,板橋區,懷翠里,1050,1867,678,248,926,135,1061
公投第７案,新北市,板橋區,懷翠里,1051,1753,739,205,944,101,1045
公投第７案,新北市,板橋區,福翠里,1052,1204,503,153,656,68,724
公投第７案,新北市,板橋區,港嘴里,1053,1614,593,200,793,71,864
公投第７案,新北市,板橋區,港嘴里,1054,1237,516,170,686,54,740
公投第７案,新北市,板橋區,港嘴里,1055,1361,541,186,727,76,803
公投第７案,新北市,板橋區,港嘴里,1056,1243,468,173,641,40,681
公投第７案,新北市,板橋區,振興里,1057,1515,544,177,721,34,755
公投第７案,新北市,板橋區,振興里,1058,1515,621,204,825,82,907
公投第７案,新北市,板橋區,振興里,1059,949,395,123,518,64,582
公投第７案,新北市,板橋區,振義里,1060,1629,633,195,828,73,901
公投第７案,新北市,板橋區,振義里,1061,1238,407,224,631,51,682
公投第７案,新北市,板橋區,振義里,1062,901,280,63,343,38,381
公投第７案,新北市,板橋區,光復里,1063,1475,613,159,772,84,856
公投第７案,新北市,板橋區,光復里,1064,1481,546,195,741,85,826
公投第７案,新北市,板橋區,埔墘里,1065,1800,657,189,846,76,922
公投第７案,新北市,板橋區,埔墘里,1066,1630,664,222,886,71,957
公投第７案,新北市,板橋區,埔墘里,1067,1298,566,152,718,56,774
公投第７案,新北市,板橋區,埔墘里,1068,874,368,109,477,44,521
公投第７案,新北市,板橋區,富貴里,1069,992,384,114,498,20,518
公投第７案,新北市,板橋區,富貴里,1070,1034,472,142,614,20,634
公投第７案,新北市,板橋區,長壽里,1071,1451,551,220,771,86,857
公投第７案,新北市,板橋區,長壽里,1072,1130,475,151,626,50,676
公投第７案,新北市,板橋區,福壽里,1073,1440,611,182,793,54,847
公投第７案,新北市,板橋區,福壽里,1074,1531,601,218,819,89,908
公投第７案,新北市,板橋區,居仁里,1075,1349,589,196,785,69,854
公投第７案,新北市,板橋區,居仁里,1076,1593,534,186,720,44,764
公投第７案,新北市,板橋區,海山里,1077,1174,508,124,632,37,669
公投第７案,新北市,板橋區,海山里,1078,1228,485,152,637,58,695
公投第７案,新北市,板橋區,海山里,1079,1187,462,165,627,42,669
公投第７案,新北市,板橋區,海山里,1080,870,362,113,475,61,536
公投第７案,新北市,板橋區,海山里,1081,2033,964,214,1178,42,1220
公投第７案,新北市,板橋區,九如里,1082,1418,522,195,717,53,770
公投第７案,新北市,板橋區,九如里,1083,1075,411,159,570,49,619
公投第７案,新北市,板橋區,正泰里,1084,1515,595,151,746,46,792
公投第７案,新北市,板橋區,正泰里,1085,1182,530,157,687,47,734
公投第７案,新北市,板橋區,玉光里,1086,1893,740,218,958,90,1048
公投第７案,新北市,板橋區,玉光里,1087,1302,479,180,659,64,723
公投第７案,新北市,板橋區,玉光里,1088,1366,512,153,665,47,712
公投第７案,新北市,板橋區,光仁里,1089,1318,569,167,736,90,826
公投第７案,新北市,板橋區,光仁里,1090,1200,468,152,620,43,663
公投第７案,新北市,板橋區,埤墘里,1091,2028,800,282,1082,53,1135
公投第７案,新北市,板橋區,埤墘里,1092,1746,679,232,911,113,1024
公投第７案,新北市,板橋區,莊敬里,1093,1954,745,192,937,33,970
公投第７案,新北市,板橋區,莊敬里,1094,1474,576,184,760,67,827
公投第７案,新北市,板橋區,永安里,1095,1418,541,173,714,66,780
公投第７案,新北市,板橋區,永安里,1096,1563,655,226,881,79,960
公投第７案,新北市,板橋區,雙玉里,1097,1780,664,216,880,103,983
公投第７案,新北市,板橋區,雙玉里,1098,1707,671,201,872,51,923
公投第７案,新北市,板橋區,廣新里,1099,906,250,53,303,12,315
公投第７案,新北市,板橋區,廣新里,1100,1030,391,131,522,66,588
公投第７案,新北市,板橋區,廣新里,1101,1115,457,144,601,46,647
公投第７案,新北市,板橋區,深丘里,1102,1836,737,184,921,33,954
公投第７案,新北市,板橋區,深丘里,1103,1881,736,206,942,99,1041
公投第７案,新北市,板橋區,深丘里,1104,1688,661,209,870,50,920
公投第７案,新北市,板橋區,深丘里,1105,1760,768,222,990,46,1036
公投第７案,新北市,板橋區,香丘里,1106,1044,459,145,604,50,654
公投第７案,新北市,板橋區,香丘里,1107,1043,441,160,601,45,646
公投第７案,新北市,板橋區,香丘里,1108,1099,498,138,636,49,685
公投第７案,新北市,板橋區,西安里,1109,1260,490,181,671,54,725
公投第７案,新北市,板橋區,西安里,1110,1131,465,144,609,48,657
公投第７案,新北市,板橋區,東丘里,1111,1225,494,164,658,60,718
公投第７案,新北市,板橋區,東丘里,1112,1455,661,183,844,56,900
公投第７案,新北市,板橋區,東丘里,1113,1267,463,184,647,66,713
公投第７案,新北市,板橋區,民生里,1114,972,369,154,523,61,584
公投第７案,新北市,板橋區,民生里,1115,994,411,139,550,40,590
公投第７案,新北市,板橋區,長安里,1116,1111,479,130,609,21,630
公投第７案,新北市,板橋區,長安里,1117,1177,554,159,713,74,787
公投第７案,新北市,板橋區,長安里,1118,1544,631,162,793,67,860
公投第７案,新北市,板橋區,東安里,1119,1021,408,107,515,80,595
公投第７案,新北市,板橋區,東安里,1120,1040,416,123,539,53,592
公投第７案,新北市,板橋區,福丘里,1121,1504,596,190,786,29,815
公投第７案,新北市,板橋區,福丘里,1122,1373,541,157,698,45,743
公投第７案,新北市,板橋區,福丘里,1123,1210,526,143,669,31,700
公投第７案,新北市,板橋區,福祿里,1124,1809,684,190,874,86,960
公投第７案,新北市,板橋區,福祿里,1125,1551,658,182,840,78,918
公投第７案,新北市,板橋區,民族里,1126,1408,614,157,771,37,808
公投第７案,新北市,板橋區,民族里,1127,1285,577,137,714,28,742
公投第７案,新北市,板橋區,民族里,1128,1102,499,142,641,44,685
公投第７案,新北市,板橋區,國泰里,1129,1399,520,155,675,32,707
公投第７案,新北市,板橋區,國泰里,1130,1692,670,183,853,105,958
公投第７案,新北市,板橋區,後埔里,1131,1625,711,214,925,38,963
公投第７案,新北市,板橋區,後埔里,1132,1712,706,220,926,113,1039
公投第７案,新北市,板橋區,福德里,1133,1246,522,148,670,34,704
公投第７案,新北市,板橋區,福德里,1134,1471,602,184,786,36,822
公投第７案,新北市,板橋區,福德里,1135,1761,756,171,927,65,992
公投第７案,新北市,板橋區,景星里,1136,1499,588,200,788,78,866
公投第７案,新北市,板橋區,景星里,1137,1528,555,186,741,60,801
公投第７案,新北市,板橋區,福星里,1138,1536,618,194,812,65,877
公投第７案,新北市,板橋區,福星里,1139,1550,627,201,828,58,886
公投第７案,新北市,板橋區,鄉雲里,1140,2050,820,281,1101,94,1195
公投第７案,新北市,板橋區,鄉雲里,1141,1300,561,156,717,54,771
公投第７案,新北市,板橋區,廣德里,1142,1537,634,192,826,54,880
公投第７案,新北市,板橋區,廣德里,1143,1341,476,155,631,25,656
公投第７案,新北市,板橋區,廣德里,1144,1606,669,201,870,29,899
公投第７案,新北市,板橋區,廣德里,1145,1433,526,160,686,41,727
公投第７案,新北市,板橋區,大豐里,1146,1685,617,173,790,43,833
公投第７案,新北市,板橋區,大豐里,1147,1248,534,166,700,65,765
公投第７案,新北市,板橋區,大豐里,1148,1172,486,110,596,51,647
公投第７案,新北市,板橋區,重慶里,1149,1640,545,169,714,31,745
公投第７案,新北市,板橋區,重慶里,1150,1428,573,143,716,45,761
公投第７案,新北市,板橋區,重慶里,1151,1527,616,185,801,74,875
公投第７案,新北市,板橋區,重慶里,1152,1350,582,169,751,39,790
公投第７案,新北市,板橋區,重慶里,1153,1582,667,171,838,59,897
公投第７案,新北市,板橋區,仁愛里,1154,919,435,118,553,52,605
公投第７案,新北市,板橋區,仁愛里,1155,930,400,95,495,21,516
公投第７案,新北市,板橋區,仁愛里,1156,974,465,104,569,32,601
公投第７案,新北市,板橋區,和平里,1157,1732,800,153,953,52,1005
公投第７案,新北市,板橋區,和平里,1158,1438,596,159,755,54,809
公投第７案,新北市,板橋區,廣福里,1159,1777,644,219,863,101,964
公投第７案,新北市,板橋區,廣福里,1160,1764,629,190,819,58,877
公投第７案,新北市,板橋區,五權里,1161,1289,507,154,661,26,687
公投第７案,新北市,板橋區,五權里,1162,1182,501,130,631,40,671
公投第７案,新北市,板橋區,五權里,1163,1174,478,161,639,67,706
公投第７案,新北市,板橋區,華興里,1164,1870,683,214,897,111,1008
公投第７案,新北市,板橋區,華興里,1165,1842,780,221,1001,62,1063
公投第７案,新北市,板橋區,華貴里,1166,1094,465,106,571,62,633
公投第７案,新北市,板橋區,華貴里,1167,1228,485,139,624,51,675
公投第７案,新北市,板橋區,華福里,1168,998,348,145,493,49,542
公投第７案,新北市,板橋區,華福里,1169,862,305,129,434,41,475
公投第７案,新北市,板橋區,華德里,1170,1622,581,209,790,54,844
公投第７案,新北市,板橋區,華德里,1171,1205,523,138,661,68,729
公投第７案,新北市,板橋區,華德里,1172,1787,657,200,857,47,904
公投第７案,新北市,板橋區,華德里,1173,1610,692,177,869,47,916
公投第７案,新北市,板橋區,華東里,1174,2216,943,286,1229,51,1280
公投第７案,新北市,板橋區,華東里,1175,2294,943,271,1214,61,1275
公投第７案,新北市,板橋區,華東里,1176,2090,783,220,1003,91,1094
公投第７案,新北市,板橋區,信義里,1177,1356,511,118,629,36,665
公投第７案,新北市,板橋區,信義里,1178,1067,486,122,608,35,643
公投第７案,新北市,板橋區,信義里,1179,1319,422,202,624,54,678
公投第７案,新北市,板橋區,浮洲里,1180,1316,480,142,622,56,678
公投第７案,新北市,板橋區,浮洲里,1181,1195,431,146,577,71,648
公投第７案,新北市,板橋區,浮洲里,1182,857,339,104,443,32,475
公投第７案,新北市,板橋區,華中里,1183,1417,516,169,685,80,765
公投第７案,新北市,板橋區,華中里,1184,1560,608,210,818,82,900
公投第７案,新北市,板橋區,華中里,1185,1747,727,178,905,81,986
公投第７案,新北市,板橋區,僑中里,1186,1176,514,194,708,52,760
公投第７案,新北市,板橋區,僑中里,1187,1101,455,156,611,30,641
公投第７案,新北市,板橋區,僑中里,1188,1458,590,188,778,29,807
公投第７案,新北市,板橋區,大觀里,1189,1630,564,179,743,52,795
公投第７案,新北市,板橋區,大觀里,1190,1611,565,228,793,99,892
公投第７案,新北市,板橋區,歡園里,1191,1139,419,140,559,32,591
公投第７案,新北市,板橋區,中山里,1192,1120,487,104,591,32,623
公投第７案,新北市,板橋區,中山里,1193,1022,443,125,568,85,653
公投第７案,新北市,板橋區,中山里,1194,1049,439,130,569,69,638
公投第７案,新北市,板橋區,中山里,1195,1007,440,115,555,28,583
公投第７案,新北市,板橋區,中山里,1196,1393,604,137,741,35,776
公投第７案,新北市,板橋區,復興里,1197,474,122,48,170,30,200
公投第７案,新北市,板橋區,復興里,1198,500,206,63,269,29,298
公投第７案,新北市,板橋區,大安里,1199,1177,457,143,600,43,643
公投第７案,新北市,板橋區,大安里,1200,1186,463,130,593,36,629
公投第７案,新北市,板橋區,大安里,1201,1139,480,154,634,63,697
公投第７案,新北市,板橋區,福安里,1202,1750,687,205,892,71,963
公投第７案,新北市,板橋區,福安里,1203,3451,879,248,1127,37,1164
公投第７案,新北市,板橋區,聚安里,1204,1620,600,179,779,78,857
公投第７案,新北市,板橋區,聚安里,1205,903,323,86,409,24,433
公投第７案,新北市,板橋區,聚安里,1206,1232,499,166,665,55,720
公投第７案,新北市,板橋區,聚安里,1207,975,317,103,420,28,448
公投第７案,新北市,板橋區,龍安里,1208,1224,478,134,612,33,645
公投第７案,新北市,板橋區,龍安里,1209,1291,537,131,668,40,708
公投第７案,新北市,板橋區,崑崙里,1210,1828,632,201,833,44,877
公投第７案,新北市,板橋區,崑崙里,1211,1725,630,165,795,57,852
公投第７案,新北市,板橋區,崑崙里,1212,1085,387,109,496,25,521
公投第７案,新北市,板橋區,崑崙里,1213,2357,891,250,1141,80,1221
公投第７案,新北市,板橋區,崑崙里,1214,1560,623,167,790,37,827
公投第７案,新北市,板橋區,成和里,1215,2201,757,156,913,32,945
公投第７案,新北市,板橋區,成和里,1216,1626,619,175,794,63,857
公投第７案,新北市,板橋區,成和里,1217,1786,621,154,775,51,826
公投第７案,新北市,板橋區,溪洲里,1218,1763,669,198,867,56,923
公投第７案,新北市,板橋區,溪洲里,1219,1744,635,168,803,34,837
公投第７案,新北市,板橋區,溪洲里,1220,1645,625,164,789,61,850
公投第７案,新北市,板橋區,溪福里,1221,1861,716,148,864,37,901
公投第７案,新北市,板橋區,溪福里,1222,1596,571,176,747,30,777
公投第７案,新北市,板橋區,溪福里,1223,1871,723,227,950,65,1015
公投第７案,新北市,板橋區,溪福里,1224,1938,807,191,998,65,1063
公投第７案,新北市,板橋區,溪福里,1225,1827,762,199,961,51,1012
公投第７案,新北市,板橋區,溪福里,1226,1359,545,127,672,37,709
公投第７案,新北市,板橋區,溪福里,1227,1613,678,137,815,67,882
公投第７案,新北市,板橋區,溪北里,1228,1566,615,189,804,79,883
公投第７案,新北市,板橋區,溪北里,1229,1552,681,192,873,45,918
公投第７案,新北市,板橋區,堂春里,1230,1885,706,215,921,41,962
公投第７案,新北市,板橋區,堂春里,1231,1893,684,227,911,72,983
公投第７案,新北市,中和區,中原里,1232,1630,585,190,775,69,844
公投第７案,新北市,中和區,中原里,1233,1775,741,195,936,54,990
公投第７案,新北市,中和區,中原里,1234,1844,690,184,874,41,915
公投第７案,新北市,中和區,連和里,1235,1019,484,132,616,28,644
公投第７案,新北市,中和區,連和里,1236,1138,533,120,653,37,690
公投第７案,新北市,中和區,連城里,1237,1878,739,171,910,44,954
公投第７案,新北市,中和區,連城里,1238,1980,888,191,1079,53,1132
公投第７案,新北市,中和區,連城里,1239,1844,751,205,956,76,1032
公投第７案,新北市,中和區,力行里,1240,2085,893,214,1107,44,1151
公投第７案,新北市,中和區,力行里,1241,1498,616,165,781,52,833
公投第７案,新北市,中和區,力行里,1242,1761,706,205,911,42,953
公投第７案,新北市,中和區,正行里,1243,1254,512,123,635,38,673
公投第７案,新北市,中和區,正行里,1244,1343,605,135,740,47,787
公投第７案,新北市,中和區,德行里,1245,1789,738,197,935,34,969
公投第７案,新北市,中和區,德行里,1246,2000,834,210,1044,45,1089
公投第７案,新北市,中和區,德行里,1247,1953,683,221,904,45,949
公投第７案,新北市,中和區,枋寮里,1248,1712,669,207,876,70,946
公投第７案,新北市,中和區,枋寮里,1249,1582,699,150,849,54,903
公投第７案,新北市,中和區,漳和里,1250,1742,708,184,892,59,951
公投第７案,新北市,中和區,漳和里,1251,1493,689,180,869,47,916
公投第７案,新北市,中和區,廟美里,1252,1352,515,135,650,52,702
公投第７案,新北市,中和區,廟美里,1253,1244,554,136,690,47,737
公投第７案,新北市,中和區,廟美里,1254,1394,589,168,757,61,818
公投第７案,新北市,中和區,福真里,1255,1917,634,180,814,26,840
公投第７案,新北市,中和區,福真里,1256,1830,667,203,870,92,962
公投第７案,新北市,中和區,福善里,1257,1124,465,139,604,57,661
公投第７案,新北市,中和區,福善里,1258,1412,509,142,651,40,691
公投第７案,新北市,中和區,福善里,1259,1356,528,161,689,52,741
公投第７案,新北市,中和區,福美里,1260,1425,537,159,696,48,744
公投第７案,新北市,中和區,福美里,1261,1259,534,148,682,75,757
公投第７案,新北市,中和區,福美里,1262,1256,512,150,662,66,728
公投第７案,新北市,中和區,福祥里,1263,1423,589,161,750,41,791
公投第７案,新北市,中和區,福祥里,1264,1221,537,118,655,57,712
公投第７案,新北市,中和區,福祥里,1265,1858,671,202,873,67,940
公投第７案,新北市,中和區,瓦磘里,1266,1804,708,173,881,51,932
公投第７案,新北市,中和區,瓦磘里,1267,1669,691,209,900,44,944
公投第７案,新北市,中和區,瓦磘里,1268,1485,629,159,788,48,836
公投第７案,新北市,中和區,福和里,1269,1005,428,124,552,53,605
公投第７案,新北市,中和區,福和里,1270,1175,524,157,681,67,748
公投第７案,新北市,中和區,福和里,1271,1171,520,119,639,50,689
公投第７案,新北市,中和區,佳和里,1272,1746,655,172,827,30,857
公投第７案,新北市,中和區,佳和里,1273,1555,575,163,738,41,779
公投第７案,新北市,中和區,佳和里,1274,1112,472,116,588,43,631
公投第７案,新北市,中和區,新南里,1275,1780,816,191,1007,44,1051
公投第７案,新北市,中和區,新南里,1276,1918,803,185,988,46,1034
公投第７案,新北市,中和區,新南里,1277,1689,577,160,737,30,767
公投第７案,新北市,中和區,新南里,1278,1781,768,202,970,30,1000
公投第７案,新北市,中和區,南山里,1279,1419,583,162,745,49,794
公投第７案,新北市,中和區,南山里,1280,1344,542,142,684,39,723
公投第７案,新北市,中和區,南山里,1281,1804,825,231,1056,64,1120
公投第７案,新北市,中和區,平河里,1282,1788,673,205,878,79,957
公投第７案,新北市,中和區,平河里,1283,1793,745,192,937,62,999
公投第７案,新北市,中和區,平河里,1284,1352,578,144,722,65,787
公投第７案,新北市,中和區,平河里,1285,1813,806,158,964,56,1020
公投第７案,新北市,中和區,平河里,1286,1288,621,140,761,42,803
公投第７案,新北市,中和區,信和里,1287,1186,481,138,619,41,660
公投第７案,新北市,中和區,信和里,1288,1237,462,148,610,10,620
公投第７案,新北市,中和區,信和里,1289,1406,572,144,716,49,765
公投第７案,新北市,中和區,仁和里,1290,1442,595,140,735,73,808
公投第７案,新北市,中和區,仁和里,1291,1040,455,125,580,56,636
公投第７案,新北市,中和區,仁和里,1292,1292,569,171,740,46,786
公投第７案,新北市,中和區,中正里,1293,1811,702,217,919,64,983
公投第７案,新北市,中和區,中正里,1294,1789,728,173,901,111,1012
公投第７案,新北市,中和區,建和里,1295,859,446,84,530,35,565
公投第７案,新北市,中和區,建和里,1296,972,516,78,594,32,626
公投第７案,新北市,中和區,建和里,1297,1346,556,156,712,53,765
公投第７案,新北市,中和區,中山里,1298,1034,433,130,563,37,600
公投第７案,新北市,中和區,中山里,1299,1387,605,140,745,51,796
公投第７案,新北市,中和區,碧河里,1300,2067,854,218,1072,100,1172
公投第７案,新北市,中和區,碧河里,1301,1670,571,173,744,62,806
公投第７案,新北市,中和區,正南里,1302,1166,484,117,601,57,658
公投第７案,新北市,中和區,正南里,1303,963,437,98,535,40,575
公投第７案,新北市,中和區,正南里,1304,1070,409,116,525,35,560
公投第７案,新北市,中和區,頂南里,1305,1319,542,152,694,45,739
公投第７案,新北市,中和區,頂南里,1306,1438,667,156,823,64,887
公投第７案,新北市,中和區,華新里,1307,1808,721,154,875,34,909
公投第７案,新北市,中和區,華新里,1308,1191,498,88,586,23,609
公投第７案,新北市,中和區,華新里,1309,1632,669,170,839,65,904
公投第７案,新北市,中和區,華新里,1310,1765,715,146,861,46,907
公投第７案,新北市,中和區,東南里,1311,1168,573,94,667,33,700
公投第７案,新北市,中和區,東南里,1312,1176,503,110,613,24,637
公投第７案,新北市,中和區,東南里,1313,1565,782,153,935,54,989
公投第７案,新北市,中和區,華南里,1314,1578,620,139,759,48,807
公投第７案,新北市,中和區,華南里,1315,2029,859,166,1025,38,1063
公投第７案,新北市,中和區,華南里,1316,905,403,85,488,34,522
公投第７案,新北市,中和區,忠孝里,1317,839,327,76,403,41,444
公投第７案,新北市,中和區,忠孝里,1318,762,318,88,406,32,438
公投第７案,新北市,中和區,忠孝里,1319,1420,485,149,634,69,703
公投第７案,新北市,中和區,忠孝里,1320,1272,510,125,635,60,695
公投第７案,新北市,中和區,崇南里,1321,1976,784,201,985,76,1061
公投第７案,新北市,中和區,崇南里,1322,1779,749,152,901,52,953
公投第７案,新北市,中和區,興南里,1323,1454,524,123,647,58,705
公投第７案,新北市,中和區,興南里,1324,1374,559,116,675,31,706
公投第７案,新北市,中和區,景南里,1325,1369,542,105,647,48,695
公投第７案,新北市,中和區,景南里,1326,1501,619,147,766,56,822
公投第７案,新北市,中和區,景本里,1327,920,424,115,539,59,598
公投第７案,新北市,中和區,景本里,1328,1050,472,119,591,62,653
公投第７案,新北市,中和區,橫路里,1329,321,134,44,178,20,198
公投第７案,新北市,中和區,內南里,1330,1474,414,138,552,62,614
公投第７案,新北市,中和區,內南里,1331,1461,630,135,765,71,836
公投第７案,新北市,中和區,內南里,1332,1621,651,156,807,52,859
公投第７案,新北市,中和區,壽南里,1333,1327,559,194,753,68,821
公投第７案,新北市,中和區,壽南里,1334,775,323,89,412,35,447
公投第７案,新北市,中和區,福南里,1335,1916,734,184,918,42,960
公投第７案,新北市,中和區,福南里,1336,1901,727,182,909,69,978
公投第７案,新北市,中和區,外南里,1337,4411,558,156,714,38,752
公投第７案,新北市,中和區,外南里,1338,1212,504,140,644,21,665
公投第７案,新北市,中和區,外南里,1339,1126,476,132,608,42,650
公投第７案,新北市,中和區,中興里,1340,1507,601,146,747,26,773
公投第７案,新北市,中和區,中興里,1341,1519,640,153,793,28,821
公投第７案,新北市,中和區,中興里,1342,1467,638,154,792,49,841
公投第７案,新北市,中和區,中興里,1343,1453,648,160,808,74,882
公投第７案,新北市,中和區,吉興里,1344,1364,605,168,773,50,823
公投第７案,新北市,中和區,吉興里,1345,1302,556,119,675,54,729
公投第７案,新北市,中和區,復興里,1346,1627,574,127,701,42,743
公投第７案,新北市,中和區,復興里,1347,1503,567,151,718,45,763
公投第７案,新北市,中和區,復興里,1348,1392,539,140,679,33,712
公投第７案,新北市,中和區,和興里,1349,1067,495,102,597,39,636
公投第７案,新北市,中和區,和興里,1350,1623,626,179,805,57,862
公投第７案,新北市,中和區,和興里,1351,1208,537,133,670,35,705
公投第７案,新北市,中和區,景平里,1352,1991,672,173,845,48,893
公投第７案,新北市,中和區,景平里,1353,1932,714,130,844,58,902
公投第７案,新北市,中和區,景平里,1354,947,470,110,580,43,623
公投第７案,新北市,中和區,景新里,1355,1660,692,195,887,76,963
公投第７案,新北市,中和區,景新里,1356,1574,577,147,724,62,786
公投第７案,新北市,中和區,景福里,1357,2136,802,211,1013,66,1079
公投第７案,新北市,中和區,景福里,1358,1462,522,179,701,80,781
公投第７案,新北市,中和區,景福里,1359,1548,592,133,725,83,808
公投第７案,新北市,中和區,景安里,1360,692,355,79,434,23,457
公投第７案,新北市,中和區,景安里,1361,1221,592,115,707,63,770
公投第７案,新北市,中和區,景安里,1362,1331,557,173,730,56,786
公投第７案,新北市,中和區,景安里,1363,984,450,105,555,48,603
公投第７案,新北市,中和區,景文里,1364,1871,693,192,885,59,944
公投第７案,新北市,中和區,景文里,1365,1279,507,125,632,44,676
公投第７案,新北市,中和區,錦和里,1366,1629,684,189,873,55,928
公投第７案,新北市,中和區,錦和里,1367,1482,649,155,804,37,841
公投第７案,新北市,中和區,錦和里,1368,1715,748,191,939,59,998
公投第７案,新北市,中和區,錦昌里,1369,1952,805,217,1022,66,1088
公投第７案,新北市,中和區,灰磘里,1370,686,299,67,366,38,404
公投第７案,新北市,中和區,積穗里,1371,1577,532,190,722,33,755
公投第７案,新北市,中和區,積穗里,1372,1158,522,116,638,10,648
公投第７案,新北市,中和區,積穗里,1373,1195,584,132,716,24,740
公投第７案,新北市,中和區,積穗里,1374,1054,513,130,643,32,675
公投第７案,新北市,中和區,積穗里,1375,612,285,76,361,30,391
公投第７案,新北市,中和區,積穗里,1376,1668,724,169,893,36,929
公投第７案,新北市,中和區,民享里,1377,1071,478,143,621,64,685
公投第７案,新北市,中和區,民享里,1378,1169,576,168,744,54,798
公投第７案,新北市,中和區,員山里,1379,1370,542,147,689,49,738
公投第７案,新北市,中和區,員山里,1380,1574,687,187,874,76,950
公投第７案,新北市,中和區,員山里,1381,2614,931,193,1124,34,1158
公投第７案,新北市,中和區,嘉穗里,1382,1477,627,192,819,44,863
公投第７案,新北市,中和區,嘉穗里,1383,1041,431,115,546,65,611
公投第７案,新北市,中和區,文元里,1384,1538,582,128,710,51,761
公投第７案,新北市,中和區,文元里,1385,1599,605,191,796,55,851
公投第７案,新北市,中和區,文元里,1386,1586,657,205,862,77,939
公投第７案,新北市,中和區,嘉新里,1387,1726,725,222,947,90,1037
公投第７案,新北市,中和區,嘉新里,1388,1854,807,240,1047,88,1135
公投第７案,新北市,中和區,民安里,1389,1472,662,172,834,60,894
公投第７案,新北市,中和區,民安里,1390,1430,635,162,797,69,866
公投第７案,新北市,中和區,民安里,1391,1488,677,159,836,55,891
公投第７案,新北市,中和區,安穗里,1392,1251,497,153,650,29,679
公投第７案,新北市,中和區,安穗里,1393,1487,667,153,820,44,864
公投第７案,新北市,中和區,安穗里,1394,1328,494,156,650,94,744
公投第７案,新北市,中和區,瑞穗里,1395,1128,539,110,649,47,696
公投第７案,新北市,中和區,瑞穗里,1396,1008,505,119,624,32,656
公投第７案,新北市,中和區,明穗里,1397,1786,760,214,974,38,1012
公投第７案,新北市,中和區,明穗里,1398,2219,889,226,1115,82,1197
公投第７案,新北市,中和區,清穗里,1399,1322,480,149,629,37,666
公投第７案,新北市,中和區,清穗里,1400,1495,592,152,744,29,773
公投第７案,新北市,中和區,自強里,1401,1414,531,175,706,49,755
公投第７案,新北市,中和區,自強里,1402,1681,705,192,897,71,968
公投第７案,新北市,中和區,自強里,1403,1361,559,143,702,50,752
公投第７案,新北市,中和區,德穗里,1404,1442,561,174,735,67,802
公投第７案,新北市,中和區,德穗里,1405,1383,519,164,683,27,710
公投第７案,新北市,中和區,德穗里,1406,1264,566,169,735,36,771
公投第７案,新北市,中和區,民生里,1407,1810,740,222,962,116,1078
公投第７案,新北市,中和區,民生里,1408,1951,701,196,897,47,944
公投第７案,新北市,中和區,國光里,1409,1582,597,124,721,47,768
公投第７案,新北市,中和區,國光里,1410,1945,937,124,1061,91,1152
公投第７案,新北市,中和區,壽德里,1411,1390,609,140,749,53,802
公投第７案,新北市,中和區,壽德里,1412,1161,496,135,631,18,649
公投第７案,新北市,中和區,壽德里,1413,1399,672,77,749,39,788
公投第７案,新北市,中和區,明德里,1414,1070,432,117,549,27,576
公投第７案,新北市,中和區,明德里,1415,1169,461,131,592,25,617
公投第７案,新北市,中和區,明德里,1416,1214,550,141,691,74,765
公投第７案,新北市,中和區,錦中里,1417,1398,614,140,754,68,822
公投第７案,新北市,中和區,錦中里,1418,1049,450,120,570,33,603
公投第７案,新北市,中和區,錦中里,1419,1324,599,159,758,49,807
公投第７案,新北市,中和區,錦盛里,1420,1765,608,168,776,36,812
公投第７案,新北市,中和區,錦盛里,1421,1709,656,177,833,46,879
公投第７案,新北市,中和區,民有里,1422,1186,494,141,635,61,696
公投第７案,新北市,中和區,民有里,1423,1318,550,164,714,56,770
公投第７案,新北市,中和區,員富里,1424,1430,598,178,776,41,817
公投第７案,新北市,中和區,員富里,1425,1637,542,138,680,54,734
公投第７案,新北市,中和區,嘉慶里,1426,1283,511,140,651,58,709
公投第７案,新北市,中和區,嘉慶里,1427,1310,531,160,691,48,739
公投第７案,新北市,中和區,嘉慶里,1428,1301,561,141,702,55,757
公投第７案,新北市,中和區,冠穗里,1429,1681,699,204,903,63,966
公投第７案,新北市,中和區,冠穗里,1430,1384,581,159,740,41,781
公投第７案,新北市,中和區,國華里,1431,1187,493,134,627,59,686
公投第７案,新北市,中和區,國華里,1432,1779,605,175,780,3,783
公投第７案,新北市,中和區,宜安里,1433,1712,756,161,917,52,969
公投第７案,新北市,中和區,安樂里,1434,1462,591,155,746,51,797
公投第７案,新北市,中和區,安樂里,1435,1824,734,192,926,41,967
公投第７案,新北市,中和區,安和里,1436,1389,544,165,709,69,778
公投第７案,新北市,中和區,安和里,1437,1434,630,164,794,43,837
公投第７案,新北市,中和區,安順里,1438,1953,808,165,973,63,1036
公投第７案,新北市,中和區,安順里,1439,2002,799,226,1025,75,1100
公投第７案,新北市,中和區,安平里,1440,1858,751,160,911,45,956
公投第７案,新北市,中和區,安平里,1441,1801,740,165,905,23,928
公投第７案,新北市,中和區,安平里,1442,1691,723,180,903,65,968
公投第７案,新北市,中和區,中安里,1443,1363,595,161,756,50,806
公投第７案,新北市,中和區,中安里,1444,1220,599,123,722,30,752
公投第７案,新北市,中和區,中安里,1445,1365,665,142,807,32,839
公投第７案,新北市,中和區,泰安里,1446,1178,515,115,630,33,663
公投第７案,新北市,中和區,泰安里,1447,830,375,93,468,36,504
公投第７案,新北市,中和區,泰安里,1448,1197,464,122,586,53,639
公投第７案,新北市,中和區,秀山里,1449,1369,573,169,742,54,796
公投第７案,新北市,中和區,秀山里,1450,1336,599,145,744,51,795
公投第７案,新北市,中和區,秀山里,1451,1377,654,149,803,57,860
公投第７案,新北市,中和區,秀成里,1452,1499,637,178,815,67,882
公投第７案,新北市,中和區,秀成里,1453,1689,749,173,922,48,970
公投第７案,新北市,中和區,秀義里,1454,1323,574,170,744,56,800
公投第７案,新北市,中和區,秀義里,1455,1079,489,145,634,42,676
公投第７案,新北市,中和區,秀福里,1456,1545,647,185,832,67,899
公投第７案,新北市,中和區,秀福里,1457,1326,512,162,674,65,739
公投第７案,新北市,中和區,秀福里,1458,1443,576,161,737,42,779
公投第７案,新北市,中和區,秀景里,1459,1712,749,157,906,32,938
公投第７案,新北市,中和區,秀景里,1460,1916,803,182,985,58,1043
公投第７案,新北市,中和區,秀景里,1461,863,402,103,505,36,541
公投第７案,新北市,中和區,秀景里,1462,1203,585,148,733,13,746
公投第７案,新北市,中和區,秀明里,1463,1483,645,134,779,17,796
公投第７案,新北市,中和區,秀明里,1464,1575,666,140,806,31,837
公投第７案,新北市,中和區,秀明里,1465,1432,515,142,657,64,721
公投第７案,新北市,中和區,秀峰里,1466,1441,614,134,748,59,807
公投第７案,新北市,中和區,秀峰里,1467,1269,551,149,700,55,755
公投第７案,新北市,中和區,秀峰里,1468,1363,630,137,767,39,806
公投第７案,新北市,中和區,秀士里,1469,1089,506,84,590,34,624
公投第７案,新北市,中和區,秀士里,1470,1171,433,139,572,31,603
公投第７案,新北市,中和區,秀水里,1471,1150,515,93,608,35,643
公投第７案,新北市,中和區,秀水里,1472,1154,572,132,704,23,727
公投第７案,新北市,中和區,秀水里,1473,1067,517,104,621,37,658
公投第７案,新北市,中和區,秀仁里,1474,1526,631,148,779,44,823
公投第７案,新北市,中和區,秀仁里,1475,1447,643,147,790,52,842
公投第７案,新北市,永和區,光復里,1476,1554,656,186,842,79,921
公投第７案,新北市,永和區,網溪里,1477,1065,473,98,571,22,593
公投第７案,新北市,永和區,復興里,1478,854,417,83,500,42,542
公投第７案,新北市,永和區,復興里,1479,1253,571,129,700,60,760
公投第７案,新北市,永和區,竹林里,1480,1733,718,202,920,43,963
公投第７案,新北市,永和區,竹林里,1481,1581,651,182,833,60,893
公投第７案,新北市,永和區,桂林里,1482,1735,725,171,896,56,952
公投第７案,新北市,永和區,桂林里,1483,1563,684,123,807,24,831
公投第７案,新北市,永和區,上林里,1484,1650,715,201,916,63,979
公投第７案,新北市,永和區,上林里,1485,1454,649,126,775,47,822
公投第７案,新北市,永和區,福林里,1486,1568,600,162,762,60,822
公投第７案,新北市,永和區,福林里,1487,1444,605,147,752,44,796
公投第７案,新北市,永和區,勵行里,1488,1140,451,125,576,48,624
公投第７案,新北市,永和區,中興里,1489,1188,544,132,676,55,731
公投第７案,新北市,永和區,中興里,1490,1516,623,169,792,62,854
公投第７案,新北市,永和區,永興里,1491,1397,594,124,718,62,780
公投第７案,新北市,永和區,永興里,1492,1438,618,140,758,42,800
公投第７案,新北市,永和區,正興里,1493,1084,502,108,610,39,649
公投第７案,新北市,永和區,正興里,1494,941,501,14,515,28,543
公投第７案,新北市,永和區,豫溪里,1495,1598,678,138,816,49,865
公投第７案,新北市,永和區,豫溪里,1496,2842,609,176,785,32,817
公投第７案,新北市,永和區,光明里,1497,1261,564,176,740,47,787
公投第７案,新北市,永和區,光明里,1498,1449,695,184,879,47,926
公投第７案,新北市,永和區,福和里,1499,1511,654,182,836,48,884
公投第７案,新北市,永和區,福和里,1500,1470,716,152,868,59,927
公投第７案,新北市,永和區,福和里,1501,1580,689,172,861,47,908
公投第７案,新北市,永和區,得和里,1502,1438,693,162,855,45,900
公投第７案,新北市,永和區,得和里,1503,1305,636,138,774,32,806
公投第７案,新北市,永和區,得和里,1504,1046,494,108,602,30,632
公投第７案,新北市,永和區,永貞里,1505,1566,680,170,850,27,877
公投第７案,新北市,永和區,永貞里,1506,1468,646,178,824,36,860
公投第７案,新北市,永和區,永福里,1507,1305,653,155,808,44,852
公投第７案,新北市,永和區,永福里,1508,1181,533,138,671,34,705
公投第７案,新北市,永和區,河濱里,1509,1720,780,100,880,55,935
公投第７案,新北市,永和區,河濱里,1510,1103,504,154,658,25,683
公投第７案,新北市,永和區,秀和里,1511,1649,735,158,893,79,972
公投第７案,新北市,永和區,秀和里,1512,1206,547,170,717,37,754
公投第７案,新北市,永和區,秀和里,1513,1506,676,176,852,50,902
公投第７案,新北市,永和區,永元里,1514,1488,630,159,789,67,856
公投第７案,新北市,永和區,永元里,1515,1288,582,148,730,64,794
公投第７案,新北市,永和區,永元里,1516,1413,542,155,697,38,735
公投第７案,新北市,永和區,民權里,1517,1329,572,141,713,59,772
公投第７案,新北市,永和區,民權里,1518,1436,687,154,841,42,883
公投第７案,新北市,永和區,民權里,1519,1112,484,131,615,49,664
公投第７案,新北市,永和區,民族里,1520,1100,584,119,703,39,742
公投第７案,新北市,永和區,民族里,1521,1545,732,178,910,51,961
公投第７案,新北市,永和區,民族里,1522,1436,640,129,769,34,803
公投第７案,新北市,永和區,秀朗里,1523,1731,843,177,1020,62,1082
公投第７案,新北市,永和區,秀朗里,1524,1762,787,227,1014,80,1094
公投第７案,新北市,永和區,秀成里,1525,1320,552,148,700,44,744
公投第７案,新北市,永和區,秀成里,1526,1297,480,129,609,13,622
公投第７案,新北市,永和區,秀林里,1527,1798,735,200,935,89,1024
公投第７案,新北市,永和區,秀林里,1528,1491,643,195,838,66,904
公投第７案,新北市,永和區,秀得里,1529,1223,582,114,696,23,719
公投第７案,新北市,永和區,秀得里,1530,1108,477,137,614,52,666
公投第７案,新北市,永和區,秀元里,1531,1408,612,187,799,61,860
公投第７案,新北市,永和區,秀元里,1532,1265,562,157,719,54,773
公投第７案,新北市,永和區,民生里,1533,1115,465,110,575,28,603
公投第７案,新北市,永和區,民生里,1534,1133,528,137,665,63,728
公投第７案,新北市,永和區,民生里,1535,1217,515,151,666,58,724
公投第７案,新北市,永和區,民本里,1536,1713,695,200,895,57,952
公投第７案,新北市,永和區,民本里,1537,1721,722,158,880,61,941
公投第７案,新北市,永和區,民富里,1538,1327,540,144,684,65,749
公投第７案,新北市,永和區,民富里,1539,1257,600,144,744,34,778
公投第７案,新北市,永和區,民樂里,1540,1348,652,145,797,53,850
公投第７案,新北市,永和區,民樂里,1541,1461,733,150,883,48,931
公投第７案,新北市,永和區,民樂里,1542,1368,612,144,756,58,814
公投第７案,新北市,永和區,民治里,1543,1234,541,115,656,57,713
公投第７案,新北市,永和區,民治里,1544,1303,569,136,705,59,764
公投第７案,新北市,永和區,智光里,1545,1516,657,135,792,23,815
公投第７案,新北市,永和區,智光里,1546,1422,641,176,817,72,889
公投第７案,新北市,永和區,潭安里,1547,991,470,117,587,31,618
公投第７案,新北市,永和區,潭安里,1548,1016,479,115,594,40,634
公投第７案,新北市,永和區,潭安里,1549,1146,532,122,654,38,692
公投第７案,新北市,永和區,潭安里,1550,1043,477,117,594,26,620
公投第７案,新北市,永和區,潭墘里,1551,1210,558,134,692,28,720
公投第７案,新北市,永和區,潭墘里,1552,1630,717,175,892,34,926
公投第７案,新北市,永和區,潭墘里,1553,1092,512,115,627,27,654
公投第７案,新北市,永和區,店街里,1554,1872,836,211,1047,58,1105
公投第７案,新北市,永和區,店街里,1555,1781,764,188,952,40,992
公投第７案,新北市,永和區,大新里,1556,1049,475,123,598,46,644
公投第７案,新北市,永和區,大新里,1557,1285,694,65,759,38,797
公投第７案,新北市,永和區,永安里,1558,1209,555,150,705,32,737
公投第７案,新北市,永和區,永安里,1559,1132,519,154,673,31,704
公投第７案,新北市,永和區,永安里,1560,1287,584,181,765,51,816
公投第７案,新北市,永和區,永樂里,1561,1068,510,115,625,45,670
公投第７案,新北市,永和區,永樂里,1562,1098,519,130,649,47,696
公投第７案,新北市,永和區,水源里,1563,1222,557,148,705,54,759
公投第７案,新北市,永和區,水源里,1564,1157,516,138,654,59,713
公投第７案,新北市,永和區,水源里,1565,1168,557,153,710,57,767
公投第７案,新北市,永和區,協和里,1566,1283,535,159,694,56,750
公投第７案,新北市,永和區,協和里,1567,1372,585,163,748,48,796
公投第７案,新北市,永和區,雙和里,1568,1876,878,185,1063,46,1109
公投第７案,新北市,永和區,雙和里,1569,1576,756,175,931,68,999
公投第７案,新北市,永和區,安和里,1570,1661,749,197,946,51,997
公投第７案,新北市,永和區,安和里,1571,1808,792,183,975,31,1006
公投第７案,新北市,永和區,前溪里,1572,1898,802,201,1003,47,1050
公投第７案,新北市,永和區,和平里,1573,1508,680,194,874,53,927
公投第７案,新北市,永和區,和平里,1574,1341,616,143,759,69,828
公投第７案,新北市,永和區,和平里,1575,1422,623,159,782,52,834
公投第７案,新北市,永和區,保平里,1576,1177,537,115,652,29,681
公投第７案,新北市,永和區,保平里,1577,1557,682,170,852,71,923
公投第７案,新北市,永和區,保平里,1578,1491,592,186,778,46,824
公投第７案,新北市,永和區,中溪里,1579,1586,671,176,847,54,901
公投第７案,新北市,永和區,中溪里,1580,1313,534,145,679,22,701
公投第７案,新北市,永和區,中溪里,1581,1636,679,191,870,65,935
公投第７案,新北市,永和區,保安里,1582,1598,662,191,853,62,915
公投第７案,新北市,永和區,保安里,1583,1609,743,183,926,49,975
公投第７案,新北市,永和區,保安里,1584,1375,629,180,809,43,852
公投第７案,新北市,永和區,保安里,1585,1648,807,174,981,56,1037
公投第７案,新北市,永和區,保順里,1586,1077,485,124,609,39,648
公投第７案,新北市,永和區,保順里,1587,1157,520,148,668,35,703
公投第７案,新北市,永和區,保順里,1588,1339,635,180,815,38,853
公投第７案,新北市,永和區,保順里,1589,1306,638,138,776,18,794
公投第７案,新北市,永和區,保順里,1590,1236,630,131,761,25,786
公投第７案,新北市,永和區,保順里,1591,1133,555,122,677,24,701
公投第７案,新北市,永和區,保順里,1592,1425,685,132,817,46,863
公投第７案,新北市,永和區,下溪里,1593,1938,813,209,1022,81,1103
公投第７案,新北市,永和區,下溪里,1594,1607,697,195,892,64,956
公投第７案,新北市,永和區,大同里,1595,853,402,87,489,38,527
公投第７案,新北市,永和區,新生里,1596,768,313,64,377,49,426
公投第７案,新北市,永和區,永成里,1597,893,324,57,381,29,410
公投第７案,新北市,永和區,忠義里,1598,743,340,52,392,44,436
公投第７案,新北市,永和區,仁愛里,1599,1155,528,139,667,46,713
公投第７案,新北市,永和區,仁愛里,1600,1263,596,139,735,47,782
公投第７案,新北市,永和區,文化里,1601,1189,581,117,698,29,727
公投第７案,新北市,永和區,文化里,1602,1346,572,120,692,44,736
公投第７案,新北市,永和區,信義里,1603,1368,580,147,727,46,773
公投第７案,新北市,永和區,信義里,1604,1043,470,125,595,18,613
公投第７案,新北市,永和區,後溪里,1605,1709,754,223,977,44,1021
公投第７案,新北市,永和區,上溪里,1606,879,369,89,458,18,476
公投第７案,新北市,永和區,上溪里,1607,904,397,111,508,33,541
公投第７案,新北市,永和區,頂溪里,1608,1221,587,135,722,48,770
公投第７案,新北市,永和區,頂溪里,1609,1018,458,124,582,50,632
公投第７案,新北市,永和區,河堤里,1610,1551,671,158,829,34,863
公投第７案,新北市,永和區,河堤里,1611,1428,646,156,802,54,856
公投第７案,新北市,永和區,新廍里,1612,1044,468,126,594,56,650
公投第７案,新北市,永和區,新廍里,1613,967,456,106,562,40,602
公投第７案,新北市,樹林區,三興里,1614,1408,506,175,681,60,741
公投第７案,新北市,樹林區,三興里,1615,1310,481,166,647,32,679
公投第７案,新北市,樹林區,三興里,1616,1534,534,155,689,65,754
公投第７案,新北市,樹林區,三福里,1617,1211,474,138,612,59,671
公投第７案,新北市,樹林區,三福里,1618,1125,471,143,614,41,655
公投第７案,新北市,樹林區,三福里,1619,1134,478,153,631,48,679
公投第７案,新北市,樹林區,三多里,1620,1897,625,188,813,86,899
公投第７案,新北市,樹林區,三多里,1621,1716,656,189,845,65,910
公投第７案,新北市,樹林區,三龍里,1622,736,321,95,416,42,458
公投第７案,新北市,樹林區,三龍里,1623,1137,509,145,654,35,689
公投第７案,新北市,樹林區,獇寮里,1624,1542,567,179,746,52,798
公投第７案,新北市,樹林區,獇寮里,1625,1470,564,179,743,62,805
公投第７案,新北市,樹林區,獇寮里,1626,1456,507,147,654,26,680
公投第７案,新北市,樹林區,光興里,1627,1124,458,128,586,28,614
公投第７案,新北市,樹林區,光興里,1628,1235,481,146,627,30,657
公投第７案,新北市,樹林區,光興里,1629,1212,470,171,641,30,671
公投第７案,新北市,樹林區,金寮里,1630,1223,465,115,580,45,625
公投第７案,新北市,樹林區,金寮里,1631,1335,468,188,656,80,736
公投第７案,新北市,樹林區,金寮里,1632,1206,474,153,627,35,662
公投第７案,新北市,樹林區,潭底里,1633,1927,472,159,631,77,708
公投第７案,新北市,樹林區,潭底里,1634,914,360,122,482,38,520
公投第７案,新北市,樹林區,潭底里,1635,1456,601,181,782,55,837
公投第７案,新北市,樹林區,文林里,1636,1409,545,145,690,48,738
公投第７案,新北市,樹林區,文林里,1637,1500,621,213,834,64,898
公投第７案,新北市,樹林區,文林里,1638,1545,694,114,808,59,867
公投第７案,新北市,樹林區,保安里,1639,1483,558,184,742,28,770
公投第７案,新北市,樹林區,保安里,1640,1524,595,163,758,37,795
公投第７案,新北市,樹林區,保安里,1641,1431,592,166,758,37,795
公投第７案,新北市,樹林區,保安里,1642,1181,455,137,592,64,656
公投第７案,新北市,樹林區,圳安里,1643,1116,449,141,590,61,651
公投第７案,新北市,樹林區,圳安里,1644,1077,398,131,529,36,565
公投第７案,新北市,樹林區,圳安里,1645,1103,402,111,513,20,533
公投第７案,新北市,樹林區,圳福里,1646,1385,576,139,715,60,775
公投第７案,新北市,樹林區,圳福里,1647,1266,470,141,611,52,663
公投第７案,新北市,樹林區,圳福里,1648,1195,460,138,598,50,648
公投第７案,新北市,樹林區,圳民里,1649,1254,487,138,625,52,677
公投第７案,新北市,樹林區,圳民里,1650,1263,527,149,676,47,723
公投第７案,新北市,樹林區,圳生里,1651,1473,659,178,837,75,912
公投第７案,新北市,樹林區,樹德里,1652,870,369,100,469,27,496
公投第７案,新北市,樹林區,樹德里,1653,1338,553,198,751,66,817
公投第７案,新北市,樹林區,樹德里,1654,1010,393,107,500,30,530
公投第７案,新北市,樹林區,樹福里,1655,1658,708,192,900,74,974
公投第７案,新北市,樹林區,樹福里,1656,1538,673,238,911,56,967
公投第７案,新北市,樹林區,樹西里,1657,1405,649,146,795,87,882
公投第７案,新北市,樹林區,樹西里,1658,1587,607,225,832,56,888
公投第７案,新北市,樹林區,樹西里,1659,1566,615,204,819,53,872
公投第７案,新北市,樹林區,樹興里,1660,997,406,91,497,12,509
公投第７案,新北市,樹林區,樹興里,1661,1187,478,144,622,51,673
公投第７案,新北市,樹林區,樹興里,1662,1061,411,117,528,51,579
公投第７案,新北市,樹林區,樹人里,1663,1701,731,176,907,46,953
公投第７案,新北市,樹林區,樹人里,1664,1278,539,120,659,64,723
公投第７案,新北市,樹林區,育英里,1665,1433,620,176,796,66,862
公投第７案,新北市,樹林區,育英里,1666,1306,559,165,724,53,777
公投第７案,新北市,樹林區,樹南里,1667,1268,547,166,713,62,775
公投第７案,新北市,樹林區,樹南里,1668,1281,536,164,700,35,735
公投第７案,新北市,樹林區,樹南里,1669,1200,523,142,665,50,715
公投第７案,新北市,樹林區,坡內里,1670,1491,562,177,739,29,768
公投第７案,新北市,樹林區,樹東里,1671,1066,416,112,528,26,554
公投第７案,新北市,樹林區,樹北里,1672,877,397,101,498,6,504
公投第７案,新北市,樹林區,彭福里,1673,1616,639,171,810,65,875
公投第７案,新北市,樹林區,彭福里,1674,1589,533,149,682,60,742
公投第７案,新北市,樹林區,彭福里,1675,1367,529,208,737,57,794
公投第７案,新北市,樹林區,和平里,1676,1144,501,145,646,42,688
公投第７案,新北市,樹林區,和平里,1677,1059,426,103,529,31,560
公投第７案,新北市,樹林區,和平里,1678,1224,468,155,623,53,676
公投第７案,新北市,樹林區,彭興里,1679,1141,412,127,539,40,579
公投第７案,新北市,樹林區,彭興里,1680,1396,456,112,568,25,593
公投第７案,新北市,樹林區,彭興里,1681,1157,447,148,595,39,634
公投第７案,新北市,樹林區,彭興里,1682,1498,517,183,700,74,774
公投第７案,新北市,樹林區,彭厝里,1683,1514,584,173,757,73,830
公投第７案,新北市,樹林區,彭厝里,1684,1546,576,149,725,57,782
公投第７案,新北市,樹林區,彭厝里,1685,1392,561,173,734,51,785
公投第７案,新北市,樹林區,大同里,1686,1566,696,133,829,44,873
公投第７案,新北市,樹林區,大同里,1687,1566,650,163,813,28,841
公投第７案,新北市,樹林區,中華里,1688,1517,608,165,773,50,823
公投第７案,新北市,樹林區,中華里,1689,1481,612,161,773,38,811
公投第７案,新北市,樹林區,太順里,1690,1261,491,153,644,38,682
公投第７案,新北市,樹林區,太順里,1691,1163,465,115,580,26,606
公投第７案,新北市,樹林區,東昇里,1692,1661,713,213,926,78,1004
公投第７案,新北市,樹林區,東昇里,1693,1585,629,214,843,53,896
公投第７案,新北市,樹林區,東昇里,1694,1018,457,123,580,36,616
公投第７案,新北市,樹林區,東陽里,1695,1247,505,129,634,65,699
公投第７案,新北市,樹林區,東陽里,1696,1390,569,114,683,70,753
公投第７案,新北市,樹林區,東陽里,1697,1293,545,157,702,39,741
公投第７案,新北市,樹林區,東陽里,1698,1301,468,164,632,41,673
公投第７案,新北市,樹林區,東山里,1699,1606,586,203,789,64,853
公投第７案,新北市,樹林區,東山里,1700,1277,481,193,674,68,742
公投第７案,新北市,樹林區,山佳里,1701,1219,483,151,634,69,703
公投第７案,新北市,樹林區,山佳里,1702,1454,562,136,698,36,734
公投第７案,新北市,樹林區,山佳里,1703,1314,528,134,662,38,700
公投第７案,新北市,樹林區,山佳里,1704,1008,485,123,608,32,640
公投第７案,新北市,樹林區,中山里,1705,1574,635,139,774,72,846
公投第７案,新北市,樹林區,中山里,1706,1364,576,158,734,33,767
公投第７案,新北市,樹林區,中山里,1707,1677,573,203,776,74,850
公投第７案,新北市,樹林區,樂山里,1708,1683,536,151,687,34,721
公投第７案,新北市,樹林區,柑園里,1709,1452,623,163,786,49,835
公投第７案,新北市,樹林區,柑園里,1710,1592,724,160,884,36,920
公投第７案,新北市,樹林區,柑園里,1711,1619,731,152,883,48,931
公投第７案,新北市,樹林區,柑園里,1712,1642,878,94,972,42,1014
公投第７案,新北市,樹林區,柑園里,1713,1357,587,144,731,26,757
公投第７案,新北市,樹林區,西園里,1714,1638,644,225,869,107,976
公投第７案,新北市,樹林區,南園里,1715,1592,617,181,798,55,853
公投第７案,新北市,樹林區,南園里,1716,1521,683,146,829,55,884
公投第７案,新北市,樹林區,南園里,1717,1707,765,206,971,57,1028
公投第７案,新北市,樹林區,南園里,1718,1741,762,194,956,64,1020
公投第７案,新北市,樹林區,南園里,1719,1655,715,161,876,32,908
公投第７案,新北市,樹林區,南園里,1720,1775,678,178,856,60,916
公投第７案,新北市,樹林區,南園里,1721,1781,757,164,921,69,990
公投第７案,新北市,樹林區,東園里,1722,1565,522,138,660,51,711
公投第７案,新北市,樹林區,北園里,1723,936,347,117,464,40,504
公投第７案,新北市,樹林區,北園里,1724,1030,410,128,538,17,555
公投第７案,新北市,鶯歌區,建德里,1725,515,198,80,278,16,294
公投第７案,新北市,鶯歌區,東鶯里,1726,965,405,130,535,44,579
公投第７案,新北市,鶯歌區,北鶯里,1727,1931,766,201,967,94,1061
公投第７案,新北市,鶯歌區,北鶯里,1728,1797,646,182,828,57,885
公投第７案,新北市,鶯歌區,西鶯里,1729,1057,435,125,560,32,592
公投第７案,新北市,鶯歌區,西鶯里,1730,962,361,105,466,13,479
公投第７案,新北市,鶯歌區,中鶯里,1731,934,421,125,546,34,580
公投第７案,新北市,鶯歌區,南鶯里,1732,1742,656,325,981,75,1056
公投第７案,新北市,鶯歌區,南鶯里,1733,1634,621,181,802,58,860
公投第７案,新北市,鶯歌區,南鶯里,1734,1676,624,163,787,36,823
公投第７案,新北市,鶯歌區,建國里,1735,2052,792,249,1041,87,1128
公投第７案,新北市,鶯歌區,建國里,1736,1977,667,198,865,35,900
公投第７案,新北市,鶯歌區,建國里,1737,1957,758,225,983,35,1018
公投第７案,新北市,鶯歌區,二甲里,1738,850,260,98,358,23,381
公投第７案,新北市,鶯歌區,二橋里,1739,1782,680,180,860,53,913
公投第７案,新北市,鶯歌區,二橋里,1740,1496,615,128,743,48,791
公投第７案,新北市,鶯歌區,二橋里,1741,2071,708,239,947,41,988
公投第７案,新北市,鶯歌區,二橋里,1742,1753,569,170,739,51,790
公投第７案,新北市,鶯歌區,尖山里,1743,1737,672,157,829,42,871
公投第７案,新北市,鶯歌區,尖山里,1744,1669,633,140,773,64,837
公投第７案,新北市,鶯歌區,尖山里,1745,1842,610,167,777,45,822
公投第７案,新北市,鶯歌區,尖山里,1746,1454,525,165,690,48,738
公投第７案,新北市,鶯歌區,南靖里,1747,942,358,104,462,38,500
公投第７案,新北市,鶯歌區,南靖里,1748,1317,477,167,644,60,704
公投第７案,新北市,鶯歌區,南靖里,1749,949,320,87,407,19,426
公投第７案,新北市,鶯歌區,同慶里,1750,1440,602,177,779,65,844
公投第７案,新北市,鶯歌區,永昌里,1751,1809,691,221,912,79,991
公投第７案,新北市,鶯歌區,永昌里,1752,1758,717,206,923,63,986
公投第７案,新北市,鶯歌區,永昌里,1753,1589,637,167,804,58,862
公投第７案,新北市,鶯歌區,永昌里,1754,1067,458,136,594,36,630
公投第７案,新北市,鶯歌區,永昌里,1755,1092,467,141,608,34,642
公投第７案,新北市,鶯歌區,永吉里,1756,1730,746,166,912,40,952
公投第７案,新北市,鶯歌區,永吉里,1757,1281,546,116,662,51,713
公投第７案,新北市,鶯歌區,永吉里,1758,1238,567,155,722,43,765
公投第７案,新北市,鶯歌區,鳳祥里,1759,1568,630,162,792,77,869
公投第７案,新北市,鶯歌區,鳳祥里,1760,1271,508,126,634,50,684
公投第７案,新北市,鶯歌區,鳳祥里,1761,1183,367,98,465,25,490
公投第７案,新北市,鶯歌區,鳳鳴里,1762,1026,386,74,460,22,482
公投第７案,新北市,鶯歌區,鳳鳴里,1763,1721,635,168,803,38,841
公投第７案,新北市,鶯歌區,鳳鳴里,1764,1317,478,149,627,62,689
公投第７案,新北市,鶯歌區,鳳福里,1765,1046,442,136,578,48,626
公投第７案,新北市,鶯歌區,鳳福里,1766,1144,487,156,643,44,687
公投第７案,新北市,鶯歌區,鳳福里,1767,1336,385,237,622,60,682
公投第７案,新北市,鶯歌區,大湖里,1768,1479,528,127,655,22,677
公投第７案,新北市,鶯歌區,大湖里,1769,1736,618,217,835,57,892
公投第７案,新北市,鶯歌區,大湖里,1770,1389,586,163,749,61,810
公投第７案,新北市,鶯歌區,中湖里,1771,1956,758,198,956,78,1034
公投第７案,新北市,鶯歌區,中湖里,1772,1371,513,181,694,45,739
公投第７案,新北市,鶯歌區,中湖里,1773,1810,561,137,698,35,733
公投第７案,新北市,鶯歌區,東湖里,1774,227,77,19,96,3,99
公投第７案,新北市,土城區,祖田里,1775,1505,569,165,734,69,803
公投第７案,新北市,土城區,頂新里,1776,1242,580,124,704,37,741
公投第７案,新北市,土城區,頂新里,1777,1206,537,148,685,28,713
公投第７案,新北市,土城區,頂福里,1778,1474,548,181,729,76,805
公投第７案,新北市,土城區,頂福里,1779,1489,525,164,689,62,751
公投第７案,新北市,土城區,頂福里,1780,1675,614,189,803,56,859
公投第７案,新北市,土城區,頂埔里,1781,1499,597,166,763,57,820
公投第７案,新北市,土城區,頂埔里,1782,1495,610,116,726,43,769
公投第７案,新北市,土城區,頂埔里,1783,1411,512,171,683,77,760
公投第７案,新北市,土城區,沛陂里,1784,1378,505,139,644,57,701
公投第７案,新北市,土城區,沛陂里,1785,1256,488,131,619,48,667
公投第７案,新北市,土城區,沛陂里,1786,1379,554,170,724,65,789
公投第７案,新北市,土城區,永寧里,1787,1424,548,155,703,59,762
公投第７案,新北市,土城區,永寧里,1788,1455,563,163,726,59,785
公投第７案,新北市,土城區,永寧里,1789,1419,525,169,694,42,736
公投第７案,新北市,土城區,永寧里,1790,1357,629,145,774,38,812
公投第７案,新北市,土城區,永寧里,1791,1501,596,159,755,46,801
公投第７案,新北市,土城區,大安里,1792,1206,488,140,628,65,693
公投第７案,新北市,土城區,大安里,1793,1255,521,162,683,46,729
公投第７案,新北市,土城區,大安里,1794,1869,685,204,889,80,969
公投第７案,新北市,土城區,員仁里,1795,1292,505,152,657,39,696
公投第７案,新北市,土城區,員仁里,1796,1324,483,125,608,31,639
公投第７案,新北市,土城區,員仁里,1797,1155,436,129,565,47,612
公投第７案,新北市,土城區,員仁里,1798,1183,475,122,597,54,651
公投第７案,新北市,土城區,埤塘里,1799,2518,380,96,476,46,522
公投第７案,新北市,土城區,埤塘里,1800,1218,465,120,585,47,632
公投第７案,新北市,土城區,埤塘里,1801,1133,481,96,577,70,647
公投第７案,新北市,土城區,土城里,1802,894,349,108,457,37,494
公投第７案,新北市,土城區,土城里,1803,931,379,110,489,58,547
公投第７案,新北市,土城區,長風里,1804,1820,943,157,1100,52,1152
公投第７案,新北市,土城區,員信里,1805,1320,541,118,659,29,688
公投第７案,新北市,土城區,員信里,1806,1241,452,155,607,48,655
公投第７案,新北市,土城區,員信里,1807,1414,545,147,692,64,756
公投第７案,新北市,土城區,員林里,1808,1378,586,145,731,54,785
公投第７案,新北市,土城區,員林里,1809,1421,598,165,763,62,825
公投第７案,新北市,土城區,員林里,1810,1340,554,124,678,45,723
公投第７案,新北市,土城區,員林里,1811,1144,500,138,638,40,678
公投第７案,新北市,土城區,員福里,1812,1268,513,154,667,57,724
公投第７案,新北市,土城區,員福里,1813,1196,496,131,627,65,692
公投第７案,新北市,土城區,員福里,1814,1308,571,159,730,48,778
公投第７案,新北市,土城區,員福里,1815,1175,520,117,637,34,671
公投第７案,新北市,土城區,日和里,1816,1230,502,141,643,61,704
公投第７案,新北市,土城區,日和里,1817,1342,509,175,684,79,763
公投第７案,新北市,土城區,日和里,1818,1268,540,152,692,52,744
公投第７案,新北市,土城區,日和里,1819,1227,533,173,706,65,771
公投第７案,新北市,土城區,日新里,1820,1356,532,168,700,79,779
公投第７案,新北市,土城區,日新里,1821,1496,606,167,773,65,838
公投第７案,新北市,土城區,日新里,1822,1309,520,145,665,80,745
公投第７案,新北市,土城區,裕生里,1823,1175,459,169,628,64,692
公投第７案,新北市,土城區,裕生里,1824,1237,460,159,619,75,694
公投第７案,新北市,土城區,裕生里,1825,1256,529,132,661,59,720
公投第７案,新北市,土城區,裕生里,1826,1228,502,128,630,35,665
公投第７案,新北市,土城區,貨饒里,1827,1182,456,138,594,71,665
公投第７案,新北市,土城區,貨饒里,1828,1558,635,150,785,49,834
公投第７案,新北市,土城區,貨饒里,1829,1160,489,117,606,56,662
公投第７案,新北市,土城區,瑞興里,1830,1357,525,165,690,72,762
公投第７案,新北市,土城區,瑞興里,1831,1464,532,173,705,92,797
公投第７案,新北市,土城區,復興里,1832,1335,468,148,616,78,694
公投第７案,新北市,土城區,復興里,1833,1346,501,145,646,79,725
公投第７案,新北市,土城區,復興里,1834,1435,602,209,811,51,862
公投第７案,新北市,土城區,廣福里,1835,1639,674,172,846,57,903
公投第７案,新北市,土城區,廣福里,1836,1728,705,219,924,55,979
公投第７案,新北市,土城區,廣福里,1837,1665,565,155,720,35,755
公投第７案,新北市,土城區,學成里,1838,1333,565,159,724,82,806
公投第７案,新北市,土城區,學成里,1839,1567,670,185,855,48,903
公投第７案,新北市,土城區,埤林里,1840,1576,594,190,784,82,866
公投第７案,新北市,土城區,埤林里,1841,1458,620,149,769,63,832
公投第７案,新北市,土城區,埤林里,1842,1517,608,186,794,76,870
公投第７案,新北市,土城區,埤林里,1843,1489,630,169,799,45,844
公投第７案,新北市,土城區,埤林里,1844,1463,616,177,793,48,841
公投第７案,新北市,土城區,廣興里,1845,1584,661,161,822,26,848
公投第７案,新北市,土城區,廣興里,1846,1464,599,157,756,48,804
公投第７案,新北市,土城區,樂利里,1847,1598,640,198,838,61,899
公投第７案,新北市,土城區,樂利里,1848,1500,557,167,724,81,805
公投第７案,新北市,土城區,樂利里,1849,1542,638,155,793,48,841
公投第７案,新北市,土城區,學府里,1850,1619,698,197,895,63,958
公投第７案,新北市,土城區,學府里,1851,1521,571,144,715,34,749
公投第７案,新北市,土城區,明德里,1852,1691,674,190,864,41,905
公投第７案,新北市,土城區,明德里,1853,1657,656,172,828,52,880
公投第７案,新北市,土城區,明德里,1854,1772,746,233,979,44,1023
公投第７案,新北市,土城區,學士里,1855,1423,597,160,757,21,778
公投第７案,新北市,土城區,學士里,1856,1321,565,203,768,43,811
公投第７案,新北市,土城區,學士里,1857,1429,524,283,807,56,863
公投第７案,新北市,土城區,柑林里,1858,1445,555,167,722,52,774
公投第７案,新北市,土城區,柑林里,1859,1520,659,166,825,55,880
公投第７案,新北市,土城區,中正里,1860,1484,511,130,641,33,674
公投第７案,新北市,土城區,中正里,1861,1362,545,150,695,32,727
公投第７案,新北市,土城區,青雲里,1862,1262,513,124,637,37,674
公投第７案,新北市,土城區,青雲里,1863,1343,557,169,726,45,771
公投第７案,新北市,土城區,清和里,1864,1337,439,164,603,52,655
公投第７案,新北市,土城區,清和里,1865,1325,423,117,540,50,590
公投第７案,新北市,土城區,清和里,1866,1390,511,156,667,42,709
公投第７案,新北市,土城區,清和里,1867,1534,612,150,762,68,830
公投第７案,新北市,土城區,清化里,1868,1484,550,165,715,73,788
公投第７案,新北市,土城區,清溪里,1869,1532,569,153,722,76,798
公投第７案,新北市,土城區,清溪里,1870,1507,610,160,770,75,845
公投第７案,新北市,土城區,清溪里,1871,1550,648,161,809,57,866
公投第７案,新北市,土城區,清溪里,1872,1567,639,166,805,54,859
公投第７案,新北市,土城區,青山里,1873,1367,584,169,753,30,783
公投第７案,新北市,土城區,青山里,1874,1293,513,122,635,58,693
公投第７案,新北市,土城區,清水里,1875,1402,543,173,716,69,785
公投第７案,新北市,土城區,清水里,1876,1379,546,158,704,52,756
公投第７案,新北市,土城區,清水里,1877,1471,552,158,710,47,757
公投第７案,新北市,土城區,清水里,1878,1410,550,147,697,50,747
公投第７案,新北市,土城區,清水里,1879,1542,585,187,772,56,828
公投第７案,新北市,土城區,永豐里,1880,1238,480,150,630,53,683
公投第７案,新北市,土城區,永豐里,1881,1301,502,133,635,42,677
公投第７案,新北市,土城區,永豐里,1882,1311,641,161,802,40,842
公投第７案,新北市,土城區,永富里,1883,1511,557,147,704,32,736
公投第７案,新北市,土城區,永富里,1884,1531,577,172,749,67,816
公投第７案,新北市,土城區,永富里,1885,1638,622,164,786,67,853
公投第７案,新北市,土城區,廷寮里,1886,1335,79,170,249,40,289
公投第７案,新北市,土城區,廷寮里,1887,1459,606,154,760,43,803
公投第７案,新北市,土城區,廷寮里,1888,1489,609,169,778,31,809
公投第７案,新北市,土城區,金城里,1889,1774,730,182,912,12,924
公投第７案,新北市,土城區,金城里,1890,1792,758,165,923,54,977
公投第７案,新北市,土城區,金城里,1891,1798,764,181,945,70,1015
公投第７案,新北市,土城區,峯廷里,1892,1312,504,148,652,53,705
公投第７案,新北市,土城區,峯廷里,1893,1301,493,124,617,59,676
公投第７案,新北市,土城區,峯廷里,1894,1254,474,135,609,57,666
公投第７案,新北市,土城區,峯廷里,1895,1215,462,122,584,37,621
公投第７案,新北市,土城區,峯廷里,1896,1448,595,140,735,59,794
公投第７案,新北市,土城區,延吉里,1897,1321,497,147,644,67,711
公投第７案,新北市,土城區,延吉里,1898,1150,393,137,530,73,603
公投第７案,新北市,土城區,延吉里,1899,1425,477,168,645,54,699
公投第７案,新北市,土城區,延壽里,1900,1366,556,191,747,64,811
公投第７案,新北市,土城區,延壽里,1901,1292,550,131,681,50,731
公投第７案,新北市,土城區,延壽里,1902,1317,529,119,648,71,719
公投第７案,新北市,土城區,延祿里,1903,1324,544,147,691,62,753
公投第７案,新北市,土城區,延祿里,1904,1189,468,120,588,3,591
公投第７案,新北市,土城區,延祿里,1905,1223,496,141,637,74,711
公投第７案,新北市,土城區,平和里,1906,1550,621,142,763,51,814
公投第７案,新北市,土城區,平和里,1907,1606,656,179,835,75,910
公投第７案,新北市,土城區,平和里,1908,1509,597,177,774,53,827
公投第７案,新北市,土城區,平和里,1909,1529,609,154,763,64,827
公投第７案,新北市,土城區,安和里,1910,1458,540,140,680,85,765
公投第７案,新北市,土城區,安和里,1911,1468,577,187,764,77,841
公投第７案,新北市,土城區,安和里,1912,1495,585,168,753,50,803
公投第７案,新北市,土城區,延和里,1913,1303,505,170,675,65,740
公投第７案,新北市,土城區,延和里,1914,1365,569,142,711,57,768
公投第７案,新北市,土城區,延和里,1915,1476,580,157,737,83,820
公投第７案,新北市,土城區,延和里,1916,1519,669,130,799,42,841
公投第７案,新北市,三峽區,三峽里,1917,274,130,36,166,22,188
公投第７案,新北市,三峽區,秀川里,1918,583,227,54,281,41,322
公投第７案,新北市,三峽區,八張里,1919,1765,542,191,733,30,763
公投第７案,新北市,三峽區,八張里,1920,1714,638,210,848,56,904
公投第７案,新北市,三峽區,中埔里,1921,1355,523,130,653,27,680
公投第７案,新北市,三峽區,中埔里,1922,1329,579,125,704,41,745
公投第７案,新北市,三峽區,弘道里,1923,1059,398,117,515,39,554
公投第７案,新北市,三峽區,永舘里,1924,1364,547,173,720,60,780
公投第７案,新北市,三峽區,永舘里,1925,1098,441,149,590,56,646
公投第７案,新北市,三峽區,永舘里,1926,1296,507,145,652,58,710
公投第７案,新北市,三峽區,永舘里,1927,1240,459,152,611,52,663
公投第７案,新北市,三峽區,永舘里,1928,1531,598,164,762,47,809
公投第７案,新北市,三峽區,鳶山里,1929,1444,540,121,661,35,696
公投第７案,新北市,三峽區,鳶山里,1930,1347,511,143,654,72,726
公投第７案,新北市,三峽區,鳶山里,1931,1455,598,129,727,52,779
公投第７案,新北市,三峽區,鳶山里,1932,1556,534,137,671,39,710
公投第７案,新北市,三峽區,鳶山里,1933,1390,441,113,554,38,592
公投第７案,新北市,三峽區,鳶山里,1934,1532,619,150,769,50,819
公投第７案,新北市,三峽區,龍埔里,1935,1377,489,120,609,61,670
公投第７案,新北市,三峽區,龍埔里,1936,1731,659,180,839,54,893
公投第７案,新北市,三峽區,龍埔里,1937,1705,621,195,816,33,849
公投第７案,新北市,三峽區,龍埔里,1938,1590,677,155,832,35,867
公投第７案,新北市,三峽區,龍埔里,1939,1650,707,186,893,29,922
公投第７案,新北市,三峽區,龍恩里,1940,1441,602,149,751,35,786
公投第７案,新北市,三峽區,龍恩里,1941,1404,657,131,788,25,813
公投第７案,新北市,三峽區,龍恩里,1942,1295,602,134,736,34,770
公投第７案,新北市,三峽區,龍恩里,1943,1348,478,139,617,31,648
公投第７案,新北市,三峽區,龍學里,1944,1579,664,167,831,21,852
公投第７案,新北市,三峽區,龍學里,1945,1435,589,143,732,29,761
公投第７案,新北市,三峽區,龍學里,1946,1659,764,162,926,33,959
公投第７案,新北市,三峽區,龍學里,1947,1512,712,159,871,45,916
公投第７案,新北市,三峽區,龍學里,1948,1463,632,160,792,52,844
公投第７案,新北市,三峽區,龍學里,1949,1465,663,149,812,23,835
公投第７案,新北市,三峽區,龍學里,1950,1463,124,686,810,28,838
公投第７案,新北市,三峽區,龍學里,1951,1443,639,139,778,43,821
公投第７案,新北市,三峽區,礁溪里,1952,1634,609,161,770,53,823
公投第７案,新北市,三峽區,礁溪里,1953,1716,661,198,859,54,913
公投第７案,新北市,三峽區,礁溪里,1954,1675,636,162,798,67,865
公投第７案,新北市,三峽區,安溪里,1955,1649,534,129,663,57,720
公投第７案,新北市,三峽區,安溪里,1956,1489,567,149,716,70,786
公投第７案,新北市,三峽區,安溪里,1957,1771,648,166,814,49,863
公投第７案,新北市,三峽區,安溪里,1958,1726,716,160,876,60,936
公投第７案,新北市,三峽區,介壽里,1959,1363,526,141,667,60,727
公投第７案,新北市,三峽區,介壽里,1960,1624,650,149,799,40,839
公投第７案,新北市,三峽區,介壽里,1961,1352,537,162,699,49,748
公投第７案,新北市,三峽區,介壽里,1962,1608,454,127,581,26,607
公投第７案,新北市,三峽區,中正里,1963,1458,561,161,722,55,777
公投第７案,新北市,三峽區,中正里,1964,1641,587,150,737,42,779
公投第７案,新北市,三峽區,中正里,1965,1530,525,176,701,103,804
公投第７案,新北市,三峽區,大埔里,1966,1389,449,124,573,57,630
公投第７案,新北市,三峽區,大埔里,1967,1315,473,126,599,67,666
公投第７案,新北市,三峽區,大埔里,1968,934,442,87,529,39,568
公投第７案,新北市,三峽區,嘉添里,1969,1270,437,120,557,35,592
公投第７案,新北市,三峽區,嘉添里,1970,929,311,106,417,40,457
公投第７案,新北市,三峽區,添福里,1971,1035,376,108,484,17,501
公投第７案,新北市,三峽區,金圳里,1972,502,170,39,209,17,226
公投第７案,新北市,三峽區,五寮里,1973,836,274,79,353,54,407
公投第７案,新北市,三峽區,插角里,1974,669,208,64,272,54,326
公投第７案,新北市,三峽區,有木里,1975,733,292,74,366,64,430
公投第７案,新北市,三峽區,二鬮里,1976,1560,702,177,879,58,937
公投第７案,新北市,三峽區,二鬮里,1977,1638,615,175,790,50,840
公投第７案,新北市,三峽區,溪南里,1978,1394,490,123,613,48,661
公投第７案,新北市,三峽區,溪北里,1979,771,313,84,397,48,445
公投第７案,新北市,三峽區,溪北里,1980,1367,461,164,625,35,660
公投第７案,新北市,三峽區,溪東里,1981,1241,453,123,576,69,645
公投第７案,新北市,三峽區,溪東里,1982,1520,553,136,689,24,713
公投第７案,新北市,三峽區,成福里,1983,873,388,115,503,53,556
公投第７案,新北市,三峽區,竹崙里,1984,768,240,86,326,48,374
公投第７案,新北市,三峽區,竹崙里,1985,1097,378,97,475,35,510
公投第７案,新北市,三峽區,安坑里,1986,1322,392,108,500,67,567
公投第７案,新北市,新店區,新店里,1987,1603,668,149,817,59,876
公投第７案,新北市,新店區,張南里,1988,1921,829,203,1032,48,1080
公投第７案,新北市,新店區,國校里,1989,1082,446,113,559,23,582
公投第７案,新北市,新店區,國校里,1990,1235,513,153,666,51,717
公投第７案,新北市,新店區,文中里,1991,1568,733,145,878,35,913
公投第７案,新北市,新店區,廣明里,1992,771,319,104,423,32,455
公投第７案,新北市,新店區,文明里,1993,1256,490,163,653,43,696
公投第７案,新北市,新店區,文明里,1994,1008,439,112,551,50,601
公投第７案,新北市,新店區,中興里,1995,1515,704,134,838,48,886
公投第７案,新北市,新店區,中興里,1996,1637,787,174,961,53,1014
公投第７案,新北市,新店區,中興里,1997,1549,662,187,849,50,899
公投第７案,新北市,新店區,新生里,1998,2011,987,199,1186,66,1252
公投第７案,新北市,新店區,新生里,1999,1554,642,169,811,88,899
公投第７案,新北市,新店區,新生里,2000,1770,747,172,919,64,983
公投第７案,新北市,新店區,新德里,2001,1316,603,132,735,47,782
公投第７案,新北市,新店區,新德里,2002,1126,472,126,598,43,641
公投第７案,新北市,新店區,張北里,2003,1460,581,154,735,58,793
公投第７案,新北市,新店區,張北里,2004,1584,693,184,877,58,935
公投第７案,新北市,新店區,張北里,2005,1449,625,155,780,48,828
公投第７案,新北市,新店區,張北里,2006,1520,747,151,898,53,951
公投第７案,新北市,新店區,張北里,2007,1821,852,184,1036,36,1072
公投第７案,新北市,新店區,五峯里,2008,1956,827,216,1043,51,1094
公投第７案,新北市,新店區,五峯里,2009,1665,730,191,921,58,979
公投第７案,新北市,新店區,五峯里,2010,1588,740,175,915,49,964
公投第７案,新北市,新店區,五峯里,2011,1519,643,179,822,23,845
公投第７案,新北市,新店區,長春里,2012,1185,561,148,709,39,748
公投第７案,新北市,新店區,長春里,2013,1095,533,135,668,23,691
公投第７案,新北市,新店區,新安里,2014,1106,508,127,635,55,690
公投第７案,新北市,新店區,新安里,2015,2700,306,82,388,20,408
公投第７案,新北市,新店區,新安里,2016,995,458,103,561,26,587
公投第７案,新北市,新店區,新安里,2017,1168,517,116,633,40,673
公投第７案,新北市,新店區,忠誠里,2018,1123,588,114,702,58,760
公投第７案,新北市,新店區,忠誠里,2019,1085,510,147,657,46,703
公投第７案,新北市,新店區,中正里,2020,1412,665,165,830,52,882
公投第７案,新北市,新店區,中正里,2021,1659,770,154,924,61,985
公投第７案,新北市,新店區,中正里,2022,1198,597,116,713,53,766
公投第７案,新北市,新店區,中正里,2023,1376,586,128,714,29,743
公投第７案,新北市,新店區,中華里,2024,1300,548,128,676,34,710
公投第７案,新北市,新店區,中華里,2025,1238,555,126,681,44,725
公投第７案,新北市,新店區,中華里,2026,1388,565,134,699,28,727
公投第７案,新北市,新店區,仁愛里,2027,933,440,105,545,41,586
公投第７案,新北市,新店區,仁愛里,2028,908,437,112,549,32,581
公投第７案,新北市,新店區,建國里,2029,1582,681,163,844,67,911
公投第７案,新北市,新店區,建國里,2030,1247,601,131,732,45,777
公投第７案,新北市,新店區,百忍里,2031,971,449,98,547,53,600
公投第７案,新北市,新店區,百忍里,2032,1145,552,98,650,48,698
公投第７案,新北市,新店區,百忍里,2033,1392,655,130,785,52,837
公投第７案,新北市,新店區,百和里,2034,1452,706,156,862,52,914
公投第７案,新北市,新店區,百和里,2035,1440,616,163,779,55,834
公投第７案,新北市,新店區,福德里,2036,1786,754,180,934,88,1022
公投第７案,新北市,新店區,福德里,2037,1825,837,169,1006,56,1062
公投第７案,新北市,新店區,百福里,2038,1477,710,143,853,28,881
公投第７案,新北市,新店區,百福里,2039,1750,786,192,978,50,1028
公投第７案,新北市,新店區,福民里,2040,1792,795,162,957,68,1025
公投第７案,新北市,新店區,福民里,2041,1979,897,154,1051,66,1117
公投第７案,新北市,新店區,中山里,2042,826,393,83,476,24,500
公投第７案,新北市,新店區,中山里,2043,1924,923,176,1099,43,1142
公投第７案,新北市,新店區,中山里,2044,1383,667,147,814,28,842
公投第７案,新北市,新店區,和平里,2045,830,310,80,390,38,428
公投第７案,新北市,新店區,中央里,2046,1759,842,182,1024,37,1061
公投第７案,新北市,新店區,中央里,2047,1957,923,244,1167,53,1220
公投第７案,新北市,新店區,中央里,2048,1481,717,154,871,23,894
公投第７案,新北市,新店區,國豐里,2049,1552,696,155,851,68,919
公投第７案,新北市,新店區,國豐里,2050,1467,705,73,778,66,844
公投第７案,新北市,新店區,明德里,2051,1371,622,136,758,39,797
公投第７案,新北市,新店區,明德里,2052,991,459,98,557,41,598
公投第７案,新北市,新店區,明德里,2053,1231,565,128,693,53,746
公投第７案,新北市,新店區,大豐里,2054,1701,755,186,941,56,997
公投第７案,新北市,新店區,大豐里,2055,1707,727,207,934,44,978
公投第７案,新北市,新店區,大同里,2056,1773,798,167,965,34,999
公投第７案,新北市,新店區,大同里,2057,1866,756,193,949,39,988
公投第７案,新北市,新店區,江陵里,2058,1735,813,177,990,40,1030
公投第７案,新北市,新店區,江陵里,2059,1632,781,207,988,50,1038
公投第７案,新北市,新店區,江陵里,2060,1591,744,144,888,54,942
公投第７案,新北市,新店區,復興里,2061,1495,626,119,745,70,815
公投第７案,新北市,新店區,復興里,2062,1511,604,118,722,29,751
公投第７案,新北市,新店區,寶興里,2063,1260,537,142,679,57,736
公投第７案,新北市,新店區,寶興里,2064,1948,916,205,1121,46,1167
公投第７案,新北市,新店區,寶興里,2065,1582,740,185,925,49,974
公投第７案,新北市,新店區,寶福里,2066,1315,560,144,704,58,762
公投第７案,新北市,新店區,寶福里,2067,1562,742,58,800,46,846
公投第７案,新北市,新店區,寶福里,2068,1982,953,185,1138,28,1166
公投第７案,新北市,新店區,寶福里,2069,1518,677,170,847,52,899
公投第７案,新北市,新店區,寶安里,2070,1735,778,157,935,35,970
公投第７案,新北市,新店區,寶安里,2071,1716,760,149,909,54,963
公投第７案,新北市,新店區,寶安里,2072,1580,703,165,868,55,923
公投第７案,新北市,新店區,信義里,2073,1358,633,166,799,45,844
公投第７案,新北市,新店區,信義里,2074,1610,703,211,914,88,1002
公投第７案,新北市,新店區,信義里,2075,1383,556,174,730,43,773
公投第７案,新北市,新店區,信義里,2076,1596,706,162,868,36,904
公投第７案,新北市,新店區,忠孝里,2077,1360,573,113,686,38,724
公投第７案,新北市,新店區,忠孝里,2078,1160,503,71,574,19,593
公投第７案,新北市,新店區,大鵬里,2079,1236,639,92,731,35,766
公投第７案,新北市,新店區,大鵬里,2080,1234,654,114,768,26,794
公投第７案,新北市,新店區,太平里,2081,1579,684,174,858,59,917
公投第７案,新北市,新店區,太平里,2082,1241,571,93,664,45,709
公投第７案,新北市,新店區,美城里,2083,1275,537,138,675,29,704
公投第７案,新北市,新店區,美城里,2084,1214,492,106,598,48,646
公投第７案,新北市,新店區,頂城里,2085,1578,578,151,729,60,789
公投第７案,新北市,新店區,下城里,2086,1442,584,162,746,48,794
公投第７案,新北市,新店區,下城里,2087,1475,541,147,688,76,764
公投第７案,新北市,新店區,柴埕里,2088,1580,698,178,876,48,924
公投第７案,新北市,新店區,柴埕里,2089,1585,636,158,794,38,832
公投第７案,新北市,新店區,柴埕里,2090,1586,664,164,828,60,888
公投第７案,新北市,新店區,柴埕里,2091,1931,803,200,1003,70,1073
公投第７案,新北市,新店區,柴埕里,2092,1239,533,116,649,34,683
公投第７案,新北市,新店區,安和里,2093,1892,798,190,988,60,1048
公投第７案,新北市,新店區,安和里,2094,1529,595,147,742,50,792
公投第７案,新北市,新店區,安和里,2095,1358,621,118,739,49,788
公投第７案,新北市,新店區,安和里,2096,1905,734,194,928,44,972
公投第７案,新北市,新店區,永安里,2097,1885,773,177,950,40,990
公投第７案,新北市,新店區,永安里,2098,1345,556,121,677,56,733
公投第７案,新北市,新店區,永安里,2099,1387,591,135,726,66,792
公投第７案,新北市,新店區,新和里,2100,1960,849,165,1014,65,1079
公投第７案,新北市,新店區,新和里,2101,1837,779,172,951,76,1027
公投第７案,新北市,新店區,永平里,2102,1662,705,193,898,48,946
公投第７案,新北市,新店區,永平里,2103,1617,771,169,940,55,995
公投第７案,新北市,新店區,永平里,2104,1704,735,186,921,35,956
公投第７案,新北市,新店區,公崙里,2105,1835,735,181,916,71,987
公投第７案,新北市,新店區,公崙里,2106,2009,805,201,1006,78,1084
公投第７案,新北市,新店區,公崙里,2107,1450,594,166,760,52,812
公投第７案,新北市,新店區,公崙里,2108,1726,763,149,912,46,958
公投第７案,新北市,新店區,公崙里,2109,1797,727,184,911,60,971
公投第７案,新北市,新店區,公崙里,2110,1739,743,172,915,40,955
公投第７案,新北市,新店區,安昌里,2111,1523,682,127,809,36,845
公投第７案,新北市,新店區,安昌里,2112,1642,724,125,849,26,875
公投第７案,新北市,新店區,安昌里,2113,1644,725,165,890,19,909
公投第７案,新北市,新店區,德安里,2114,1662,638,158,796,39,835
公投第７案,新北市,新店區,德安里,2115,2067,908,211,1119,60,1179
公投第７案,新北市,新店區,德安里,2116,1870,628,169,797,37,834
公投第７案,新北市,新店區,達觀里,2117,1982,843,158,1001,59,1060
公投第７案,新北市,新店區,達觀里,2118,1546,700,135,835,38,873
公投第７案,新北市,新店區,明城里,2119,1712,801,197,998,33,1031
公投第７案,新北市,新店區,明城里,2120,1423,701,157,858,26,884
公投第７案,新北市,新店區,小城里,2121,1666,757,181,938,71,1009
公投第７案,新北市,新店區,小城里,2122,1769,843,193,1036,60,1096
公投第７案,新北市,新店區,雙城里,2123,1079,377,125,502,39,541
公投第７案,新北市,新店區,雙城里,2124,1140,445,107,552,33,585
公投第７案,新北市,新店區,雙城里,2125,1825,757,183,940,59,999
公投第７案,新北市,新店區,雙城里,2126,1178,537,141,678,34,712
公投第７案,新北市,新店區,香坡里,2127,1463,623,132,755,38,793
公投第７案,新北市,新店區,香坡里,2128,1152,514,110,624,33,657
公投第７案,新北市,新店區,香坡里,2129,2008,749,141,890,29,919
公投第７案,新北市,新店區,香坡里,2130,2120,800,133,933,40,973
公投第７案,新北市,新店區,香坡里,2131,1153,556,101,657,18,675
公投第７案,新北市,新店區,香坡里,2132,1573,642,150,792,43,835
公投第７案,新北市,新店區,日興里,2133,1992,691,196,887,75,962
公投第７案,新北市,新店區,日興里,2134,1668,605,165,770,47,817
公投第７案,新北市,新店區,日興里,2135,1617,584,157,741,54,795
公投第７案,新北市,新店區,玫瑰里,2136,2013,808,190,998,81,1079
公投第７案,新北市,新店區,玫瑰里,2137,1791,849,80,929,57,986
公投第７案,新北市,新店區,玫瑰里,2138,1624,701,167,868,50,918
公投第７案,新北市,新店區,吉祥里,2139,1178,576,104,680,33,713
公投第７案,新北市,新店區,吉祥里,2140,1277,617,103,720,27,747
公投第７案,新北市,新店區,吉祥里,2141,1879,838,168,1006,57,1063
公投第７案,新北市,新店區,塗潭里,2142,939,303,104,407,30,437
公投第７案,新北市,新店區,華城里,2143,960,397,112,509,38,547
公投第７案,新北市,新店區,華城里,2144,1434,673,168,841,32,873
公投第７案,新北市,新店區,青潭里,2145,1838,702,196,898,59,957
公投第７案,新北市,新店區,青潭里,2146,1453,626,135,761,54,815
公投第７案,新北市,新店區,青潭里,2147,1549,631,150,781,49,830
公投第７案,新北市,新店區,美潭里,2148,1860,844,181,1025,51,1076
公投第７案,新北市,新店區,美潭里,2149,1743,672,167,839,38,877
公投第７案,新北市,新店區,美潭里,2150,1122,572,132,704,31,735
公投第７案,新北市,新店區,員潭里,2151,1468,649,130,779,32,811
公投第７案,新北市,新店區,員潭里,2152,1763,803,113,916,43,959
公投第７案,新北市,新店區,員潭里,2153,1344,536,141,677,35,712
公投第７案,新北市,新店區,雙坑里,2154,753,298,60,358,48,406
公投第７案,新北市,新店區,粗坑里,2155,602,215,70,285,9,294
公投第７案,新北市,新店區,粗坑里,2156,2237,829,265,1094,72,1166
公投第７案,新北市,新店區,屈尺里,2157,1096,420,134,554,32,586
公投第７案,新北市,新店區,屈尺里,2158,1143,384,108,492,46,538
公投第７案,新北市,新店區,龜山里,2159,1569,566,182,748,77,825
公投第７案,新北市,新店區,廣興里,2160,1284,475,150,625,65,690
公投第７案,新北市,新店區,直潭里,2161,439,93,31,124,10,134
公投第７案,新北市,新店區,直潭里,2162,750,274,121,395,38,433
公投第７案,新北市,深坑區,萬順里,2163,1142,435,120,555,30,585
公投第７案,新北市,深坑區,萬順里,2164,1139,463,153,616,52,668
公投第７案,新北市,深坑區,萬福里,2165,1065,385,128,513,60,573
公投第７案,新北市,深坑區,萬福里,2166,1400,530,126,656,50,706
公投第７案,新北市,深坑區,土庫里,2167,1330,509,135,644,33,677
公投第７案,新北市,深坑區,土庫里,2168,1380,513,122,635,38,673
公投第７案,新北市,深坑區,深坑里,2169,1496,506,128,634,29,663
公投第７案,新北市,深坑區,深坑里,2170,1508,631,162,793,68,861
公投第７案,新北市,深坑區,埔新里,2171,1624,679,185,864,59,923
公投第７案,新北市,深坑區,埔新里,2172,2165,872,228,1100,63,1163
公投第７案,新北市,深坑區,埔新里,2173,1790,701,212,913,65,978
公投第７案,新北市,深坑區,昇高里,2174,782,288,70,358,23,381
公投第７案,新北市,深坑區,昇高里,2175,1164,518,126,644,21,665
公投第７案,新北市,深坑區,賴仲里,2176,1344,579,156,735,65,800
公投第７案,新北市,深坑區,賴仲里,2177,739,340,88,428,27,455
公投第７案,新北市,深坑區,阿柔里,2178,556,244,62,306,33,339
公投第７案,新北市,石碇區,石碇里,2179,391,158,60,218,23,241
公投第７案,新北市,石碇區,潭邊里,2180,789,272,85,357,41,398
公投第７案,新北市,石碇區,烏塗里,2181,662,191,60,251,25,276
公投第７案,新北市,石碇區,彭山里,2182,310,107,35,142,12,154
公投第７案,新北市,石碇區,豐田里,2183,280,106,29,135,13,148
公投第７案,新北市,石碇區,豐田里,2184,93,25,8,33,5,38
公投第７案,新北市,石碇區,隆盛里,2185,683,205,56,261,48,309
公投第７案,新北市,石碇區,豐林里,2186,323,158,33,191,11,202
公投第７案,新北市,石碇區,中民里,2187,726,191,58,249,7,256
公投第７案,新北市,石碇區,永定里,2188,591,203,77,280,35,315
公投第７案,新北市,石碇區,光明里,2189,282,128,39,167,22,189
公投第７案,新北市,石碇區,永安里,2190,788,237,62,299,12,311
公投第７案,新北市,石碇區,格頭里,2191,943,377,117,494,55,549
公投第７案,新北市,坪林區,坪林里,2192,1248,482,108,590,43,633
公投第７案,新北市,坪林區,水德里,2193,612,200,50,250,41,291
公投第７案,新北市,坪林區,大林里,2194,1141,434,120,554,96,650
公投第７案,新北市,坪林區,石𥕢里,2195,417,116,33,149,9,158
公投第７案,新北市,坪林區,粗窟里,2196,595,222,65,287,43,330
公投第７案,新北市,坪林區,粗窟里,2197,248,108,27,135,17,152
公投第７案,新北市,坪林區,上德里,2198,338,120,34,154,8,162
公投第７案,新北市,坪林區,上德里,2199,478,160,30,190,16,206
公投第７案,新北市,坪林區,漁光里,2200,390,101,34,135,12,147
公投第７案,新北市,坪林區,漁光里,2201,424,132,34,166,26,192
公投第７案,新北市,烏來區,忠治里,2202,1568,701,168,869,57,926
公投第７案,新北市,烏來區,烏來里,2203,1198,452,108,560,21,581
公投第７案,新北市,烏來區,烏來里,2204,1169,429,92,521,25,546
公投第７案,新北市,烏來區,孝義里,2205,228,90,22,112,2,114
公投第７案,新北市,烏來區,信賢里,2206,486,189,40,229,34,263
公投第７案,新北市,烏來區,福山里,2207,615,211,40,251,22,273
公投第７案,新北市,平溪區,薯榔里,2208,384,133,45,178,9,187
公投第７案,新北市,平溪區,菁桐里,2209,232,77,16,93,3,96
公投第７案,新北市,平溪區,白石里,2210,249,96,31,127,13,140
公投第７案,新北市,平溪區,石底里,2211,458,171,52,223,30,253
公投第７案,新北市,平溪區,平溪里,2212,232,83,30,113,16,129
公投第７案,新北市,平溪區,嶺腳里,2213,635,193,50,243,16,259
公投第７案,新北市,平溪區,東勢里,2214,427,165,47,212,25,237
公投第７案,新北市,平溪區,十分里,2215,862,241,64,305,37,342
公投第７案,新北市,平溪區,望古里,2216,147,53,16,69,4,73
公投第７案,新北市,平溪區,南山里,2217,365,98,24,122,13,135
公投第７案,新北市,平溪區,新寮里,2218,153,47,15,62,8,70
公投第７案,新北市,平溪區,平湖里,2219,177,71,22,93,16,109
公投第７案,新北市,瑞芳區,龍潭里,2220,725,306,80,386,34,420
公投第７案,新北市,瑞芳區,龍興里,2221,1074,445,102,547,53,600
公投第７案,新北市,瑞芳區,龍興里,2222,825,326,72,398,23,421
公投第７案,新北市,瑞芳區,龍鎮里,2223,1242,490,137,627,37,664
公投第７案,新北市,瑞芳區,龍安里,2224,598,241,59,300,26,326
公投第７案,新北市,瑞芳區,龍川里,2225,872,331,92,423,43,466
公投第７案,新北市,瑞芳區,龍川里,2226,760,262,68,330,36,366
公投第７案,新北市,瑞芳區,龍山里,2227,1330,458,126,584,34,618
公投第７案,新北市,瑞芳區,爪峯里,2228,1683,554,161,715,60,775
公投第７案,新北市,瑞芳區,爪峯里,2229,980,378,100,478,40,518
公投第７案,新北市,瑞芳區,爪峯里,2230,946,359,101,460,42,502
公投第７案,新北市,瑞芳區,新峰里,2231,1375,470,109,579,21,600
公投第７案,新北市,瑞芳區,新峰里,2232,1671,632,154,786,34,820
公投第７案,新北市,瑞芳區,東和里,2233,978,324,71,395,22,417
公投第７案,新北市,瑞芳區,東和里,2234,645,206,80,286,29,315
公投第７案,新北市,瑞芳區,柑坪里,2235,1089,383,123,506,52,558
公投第７案,新北市,瑞芳區,弓橋里,2236,286,88,22,110,11,121
公投第７案,新北市,瑞芳區,猴硐里,2237,461,160,44,204,27,231
公投第７案,新北市,瑞芳區,光復里,2238,274,95,26,121,16,137
公投第７案,新北市,瑞芳區,碩仁里,2239,155,64,18,82,11,93
公投第７案,新北市,瑞芳區,吉慶里,2240,817,325,86,411,38,449
公投第７案,新北市,瑞芳區,吉慶里,2241,884,322,103,425,39,464
公投第７案,新北市,瑞芳區,吉安里,2242,1333,456,110,566,52,618
公投第７案,新北市,瑞芳區,吉安里,2243,607,189,38,227,5,232
公投第７案,新北市,瑞芳區,吉安里,2244,1045,408,101,509,33,542
公投第７案,新北市,瑞芳區,上天里,2245,673,269,54,323,40,363
公投第７案,新北市,瑞芳區,上天里,2246,618,176,43,219,12,231
公投第７案,新北市,瑞芳區,傑魚里,2247,1063,377,87,464,27,491
公投第７案,新北市,瑞芳區,傑魚里,2248,860,339,87,426,39,465
公投第７案,新北市,瑞芳區,基山里,2249,432,101,27,128,3,131
公投第７案,新北市,瑞芳區,永慶里,2250,445,121,38,159,9,168
公投第７案,新北市,瑞芳區,崇文里,2251,318,110,16,126,7,133
公投第７案,新北市,瑞芳區,福住里,2252,159,59,9,68,9,77
公投第７案,新北市,瑞芳區,頌德里,2253,337,95,33,128,17,145
公投第７案,新北市,瑞芳區,瓜山里,2254,180,69,23,92,6,98
公投第７案,新北市,瑞芳區,銅山里,2255,187,57,11,68,13,81
公投第７案,新北市,瑞芳區,新山里,2256,369,131,41,172,19,191
公投第７案,新北市,瑞芳區,石山里,2257,335,121,50,171,15,186
公投第７案,新北市,瑞芳區,濓洞里,2258,470,151,32,183,16,199
公投第７案,新北市,瑞芳區,濓新里,2259,297,83,27,110,5,115
公投第７案,新北市,瑞芳區,南雅里,2260,267,138,22,160,4,164
公投第７案,新北市,瑞芳區,鼻頭里,2261,876,165,46,211,9,220
公投第７案,新北市,瑞芳區,海濱里,2262,1241,317,102,419,29,448
公投第７案,新北市,瑞芳區,瑞濱里,2263,998,343,133,476,58,534
公投第７案,新北市,瑞芳區,瑞濱里,2264,948,335,110,445,54,499
公投第７案,新北市,瑞芳區,深澳里,2265,1308,382,103,485,27,512
公投第７案,新北市,雙溪區,雙溪里,2266,455,162,30,192,22,214
公投第７案,新北市,雙溪區,新基里,2267,286,113,23,136,12,148
公投第７案,新北市,雙溪區,新基里,2268,496,204,48,252,24,276
公投第７案,新北市,雙溪區,三港里,2269,383,121,28,149,11,160
公投第７案,新北市,雙溪區,牡丹里,2270,887,255,82,337,40,377
公投第７案,新北市,雙溪區,牡丹里,2271,652,193,48,241,35,276
公投第７案,新北市,雙溪區,三貂里,2272,333,124,30,154,13,167
公投第７案,新北市,雙溪區,平林里,2273,642,227,62,289,27,316
公投第７案,新北市,雙溪區,平林里,2274,282,90,34,124,11,135
公投第７案,新北市,雙溪區,上林里,2275,621,182,65,247,21,268
公投第７案,新北市,雙溪區,外柑里,2276,422,128,28,156,10,166
公投第７案,新北市,雙溪區,長源里,2277,369,82,32,114,20,134
公投第７案,新北市,雙溪區,共和里,2278,120,48,8,56,9,65
公投第７案,新北市,雙溪區,共和里,2279,271,100,20,120,14,134
公投第７案,新北市,雙溪區,魚行里,2280,362,147,40,187,25,212
公投第７案,新北市,雙溪區,魚行里,2281,371,130,35,165,28,193
公投第７案,新北市,雙溪區,泰平里,2282,1047,433,124,557,51,608
公投第７案,新北市,貢寮區,貢寮里,2283,876,310,82,392,43,435
公投第７案,新北市,貢寮區,龍崗里,2284,433,147,48,195,22,217
公投第７案,新北市,貢寮區,吉林里,2285,516,147,36,183,15,198
公投第７案,新北市,貢寮區,雙玉里,2286,373,100,29,129,20,149
公投第７案,新北市,貢寮區,雙玉里,2287,313,93,38,131,18,149
公投第７案,新北市,貢寮區,福連里,2288,485,179,44,223,11,234
公投第７案,新北市,貢寮區,福連里,2289,415,119,60,179,32,211
公投第７案,新北市,貢寮區,福隆里,2290,812,240,68,308,14,322
公投第７案,新北市,貢寮區,福隆里,2291,861,277,102,379,33,412
公投第７案,新北市,貢寮區,龍門里,2292,676,173,58,231,31,262
公投第７案,新北市,貢寮區,真理里,2293,1091,265,93,358,29,387
公投第７案,新北市,貢寮區,真理里,2294,955,247,91,338,49,387
公投第７案,新北市,貢寮區,仁里里,2295,769,219,50,269,11,280
公投第７案,新北市,貢寮區,仁里里,2296,962,305,118,423,41,464
公投第７案,新北市,貢寮區,美豐里,2297,390,143,39,182,12,194
公投第７案,新北市,貢寮區,美豐里,2298,349,110,36,146,2,148
公投第７案,新北市,貢寮區,和美里,2299,508,125,45,170,27,197
公投第７案,新北市,貢寮區,和美里,2300,495,110,38,148,13,161
公投第７案,新北市,金山區,和平里,2301,481,194,39,233,29,262
公投第７案,新北市,金山區,大同里,2302,715,267,81,348,31,379
公投第７案,新北市,金山區,豐漁里,2303,481,147,42,189,25,214
公投第７案,新北市,金山區,磺港里,2304,1792,601,138,739,87,826
公投第７案,新北市,金山區,美田里,2305,1781,627,210,837,72,909
公投第７案,新北市,金山區,美田里,2306,2010,817,194,1011,55,1066
公投第７案,新北市,金山區,金美里,2307,1572,563,145,708,55,763
公投第７案,新北市,金山區,金美里,2308,1777,673,163,836,71,907
公投第７案,新北市,金山區,金美里,2309,1631,570,137,707,67,774
公投第７案,新北市,金山區,五湖里,2310,828,318,82,400,35,435
公投第７案,新北市,金山區,五湖里,2311,888,327,93,420,29,449
公投第７案,新北市,金山區,重和里,2312,1211,405,133,538,69,607
公投第７案,新北市,金山區,兩湖里,2313,416,173,50,223,16,239
公投第７案,新北市,金山區,六股里,2314,682,277,78,355,43,398
公投第７案,新北市,金山區,三界里,2315,644,238,62,300,48,348
公投第７案,新北市,金山區,清泉里,2316,830,289,78,367,42,409
公投第７案,新北市,金山區,西湖里,2317,188,65,23,88,11,99
公投第７案,新北市,金山區,萬壽里,2318,469,159,70,229,30,259
公投第７案,新北市,金山區,永興里,2319,582,143,42,185,28,213
公投第７案,新北市,萬里區,萬里里,2320,1286,528,121,649,46,695
公投第７案,新北市,萬里區,萬里里,2321,1576,618,177,795,64,859
公投第７案,新北市,萬里區,萬里里,2322,1447,520,127,647,46,693
公投第７案,新北市,萬里區,北基里,2323,1466,474,121,595,74,669
公投第７案,新北市,萬里區,北基里,2324,1369,406,120,526,60,586
公投第７案,新北市,萬里區,龜吼里,2325,1215,342,78,420,55,475
公投第７案,新北市,萬里區,龜吼里,2326,1317,503,129,632,57,689
公投第７案,新北市,萬里區,野柳里,2327,1676,528,122,650,69,719
公投第７案,新北市,萬里區,野柳里,2328,1550,525,135,660,79,739
公投第７案,新北市,萬里區,大鵬里,2329,945,422,111,533,51,584
公投第７案,新北市,萬里區,大鵬里,2330,1760,697,186,883,75,958
公投第７案,新北市,萬里區,磺潭里,2331,570,221,47,268,20,288
公投第７案,新北市,萬里區,雙興里,2332,952,307,110,417,27,444
公投第７案,新北市,萬里區,溪底里,2333,674,263,80,343,52,395
公投第７案,新北市,萬里區,崁脚里,2334,405,151,34,185,23,208
公投第７案,新北市,萬里區,中幅里,2335,1089,378,113,491,56,547
公投第７案,新北市,汐止區,仁德里,2336,1595,615,164,779,77,856
公投第７案,新北市,汐止區,義民里,2337,1262,521,141,662,43,705
公投第７案,新北市,汐止區,禮門里,2338,917,379,103,482,59,541
公投第７案,新北市,汐止區,智慧里,2339,1929,780,225,1005,61,1066
公投第７案,新北市,汐止區,智慧里,2340,2227,887,223,1110,68,1178
公投第７案,新北市,汐止區,大同里,2341,1143,429,157,586,60,646
公投第７案,新北市,汐止區,大同里,2342,1367,565,153,718,41,759
公投第７案,新北市,汐止區,信望里,2343,322,113,40,153,20,173
公投第７案,新北市,汐止區,新昌里,2344,1460,612,169,781,9,790
公投第７案,新北市,汐止區,新昌里,2345,1719,609,198,807,68,875
公投第７案,新北市,汐止區,新昌里,2346,1661,611,160,771,58,829
公投第７案,新北市,汐止區,福安里,2347,1590,667,168,835,67,902
公投第７案,新北市,汐止區,福安里,2348,1599,664,155,819,52,871
公投第７案,新北市,汐止區,福安里,2349,1749,742,178,920,48,968
公投第７案,新北市,汐止區,秀峰里,2350,1809,246,86,332,24,356
公投第７案,新北市,汐止區,秀峰里,2351,1601,440,258,698,33,731
公投第７案,新北市,汐止區,秀峰里,2352,1387,545,128,673,65,738
公投第７案,新北市,汐止區,秀山里,2353,1779,707,208,915,83,998
公投第７案,新北市,汐止區,秀山里,2354,2074,876,207,1083,72,1155
公投第７案,新北市,汐止區,復興里,2355,2072,843,220,1063,47,1110
公投第７案,新北市,汐止區,復興里,2356,2120,902,268,1170,57,1227
公投第７案,新北市,汐止區,復興里,2357,1952,791,209,1000,40,1040
公投第７案,新北市,汐止區,自強里,2358,1654,632,177,809,67,876
公投第７案,新北市,汐止區,自強里,2359,1444,556,140,696,62,758
公投第７案,新北市,汐止區,自強里,2360,1627,717,205,922,40,962
公投第７案,新北市,汐止區,文化里,2361,1751,654,175,829,75,904
公投第７案,新北市,汐止區,文化里,2362,2066,823,213,1036,48,1084
公投第７案,新北市,汐止區,白雲里,2363,1941,645,173,818,49,867
公投第７案,新北市,汐止區,白雲里,2364,1906,677,218,895,45,940
公投第７案,新北市,汐止區,茄苳里,2365,1363,517,137,654,64,718
公投第７案,新北市,汐止區,茄苳里,2366,1368,496,149,645,50,695
公投第７案,新北市,汐止區,茄苳里,2367,1233,423,137,560,51,611
公投第７案,新北市,汐止區,崇德里,2368,1554,597,141,738,23,761
公投第７案,新北市,汐止區,崇德里,2369,1700,617,190,807,31,838
公投第７案,新北市,汐止區,崇德里,2370,1124,491,110,601,27,628
公投第７案,新北市,汐止區,城中里,2371,1900,806,198,1004,80,1084
公投第７案,新北市,汐止區,城中里,2372,2050,852,181,1033,58,1091
公投第７案,新北市,汐止區,橋東里,2373,1244,469,142,611,53,664
公投第７案,新北市,汐止區,橋東里,2374,1320,493,130,623,38,661
公投第７案,新北市,汐止區,建成里,2375,1473,611,174,785,45,830
公投第７案,新北市,汐止區,建成里,2376,1802,732,191,923,69,992
公投第７案,新北市,汐止區,建成里,2377,1266,591,114,705,37,742
公投第７案,新北市,汐止區,長安里,2378,1481,532,142,674,62,736
公投第７案,新北市,汐止區,保安里,2379,1497,554,154,708,61,769
公投第７案,新北市,汐止區,東山里,2380,556,231,52,283,20,303
公投第７案,新北市,汐止區,保長里,2381,1913,713,188,901,55,956
公投第７案,新北市,汐止區,保長里,2382,2027,791,180,971,42,1013
公投第７案,新北市,汐止區,保新里,2383,1927,750,160,910,33,943
公投第７案,新北市,汐止區,保新里,2384,696,253,92,345,44,389
公投第７案,新北市,汐止區,鄉長里,2385,2127,775,217,992,60,1052
公投第７案,新北市,汐止區,江北里,2386,1642,577,145,722,50,772
公投第７案,新北市,汐止區,江北里,2387,1912,699,216,915,80,995
公投第７案,新北市,汐止區,江北里,2388,1893,634,184,818,58,876
公投第７案,新北市,汐止區,拱北里,2389,1466,516,137,653,60,713
公投第７案,新北市,汐止區,拱北里,2390,1538,566,136,702,82,784
公投第７案,新北市,汐止區,拱北里,2391,1550,602,137,739,43,782
公投第７案,新北市,汐止區,烘內里,2392,1456,523,159,682,52,734
公投第７案,新北市,汐止區,八連里,2393,947,405,117,522,49,571
公投第７案,新北市,汐止區,長青里,2394,923,348,135,483,26,509
公投第７案,新北市,汐止區,北峰里,2395,2043,719,209,928,99,1027
公投第７案,新北市,汐止區,北峰里,2396,2012,658,209,867,89,956
公投第７案,新北市,汐止區,金龍里,2397,1471,506,131,637,35,672
公投第７案,新北市,汐止區,金龍里,2398,1603,623,139,762,52,814
公投第７案,新北市,汐止區,金龍里,2399,1530,605,162,767,57,824
公投第７案,新北市,汐止區,樟樹里,2400,1988,646,183,829,28,857
公投第７案,新北市,汐止區,忠孝里,2401,2198,819,210,1029,59,1088
公投第７案,新北市,汐止區,忠孝里,2402,1712,638,168,806,64,870
公投第７案,新北市,汐止區,忠孝里,2403,1806,751,188,939,66,1005
公投第７案,新北市,汐止區,忠孝里,2404,1576,613,142,755,77,832
公投第７案,新北市,汐止區,厚德里,2405,1511,597,150,747,27,774
公投第７案,新北市,汐止區,厚德里,2406,1691,607,158,765,35,800
公投第７案,新北市,汐止區,厚德里,2407,1636,660,169,829,44,873
公投第７案,新北市,汐止區,厚德里,2408,1676,633,157,790,76,866
公投第７案,新北市,汐止區,山光里,2409,1264,501,116,617,37,654
公投第７案,新北市,汐止區,山光里,2410,1165,467,101,568,30,598
公投第７案,新北市,汐止區,中興里,2411,1765,661,176,837,55,892
公投第７案,新北市,汐止區,中興里,2412,1815,596,161,757,33,790
公投第７案,新北市,汐止區,中興里,2413,1778,633,189,822,62,884
公投第７案,新北市,汐止區,中興里,2414,1580,637,158,795,78,873
公投第７案,新北市,汐止區,福德里,2415,1516,586,172,758,50,808
公投第７案,新北市,汐止區,福德里,2416,1425,514,139,653,47,700
公投第７案,新北市,汐止區,興福里,2417,1388,575,146,721,36,757
公投第７案,新北市,汐止區,興福里,2418,1436,561,162,723,53,776
公投第７案,新北市,汐止區,康福里,2419,1591,645,157,802,36,838
公投第７案,新北市,汐止區,康福里,2420,1639,619,148,767,46,813
公投第７案,新北市,汐止區,康福里,2421,1394,532,131,663,18,681
公投第７案,新北市,汐止區,湖光里,2422,2035,728,209,937,49,986
公投第７案,新北市,汐止區,湖光里,2423,1895,744,165,909,56,965
公投第７案,新北市,汐止區,湖光里,2424,1374,644,111,755,20,775
公投第７案,新北市,汐止區,湖蓮里,2425,1061,490,107,597,29,626
公投第７案,新北市,汐止區,湖蓮里,2426,1312,672,129,801,27,828
公投第７案,新北市,汐止區,湖興里,2427,1548,640,166,806,43,849
公投第７案,新北市,汐止區,湖興里,2428,1350,582,159,741,31,772
公投第７案,新北市,汐止區,湖興里,2429,1499,608,174,782,32,814
公投第７案,新北市,汐止區,湖興里,2430,1366,586,142,728,59,787
公投第７案,新北市,汐止區,北山里,2431,1335,551,154,705,61,766
公投第７案,新北市,汐止區,北山里,2432,1324,608,143,751,55,806
公投第７案,新北市,汐止區,北山里,2433,1286,562,148,710,70,780
公投第７案,新北市,汐止區,北山里,2434,1155,456,135,591,46,637
公投第７案,新北市,汐止區,忠山里,2435,1682,767,218,985,50,1035
公投第７案,新北市,汐止區,忠山里,2436,1494,699,169,868,56,924
公投第７案,新北市,汐止區,環河里,2437,1166,460,171,631,66,697
公投第７案,新北市,汐止區,橫科里,2438,2184,858,246,1104,114,1218
公投第７案,新北市,汐止區,橫科里,2439,2031,794,232,1026,82,1108
公投第７案,新北市,汐止區,福山里,2440,1759,716,193,909,69,978
公投第７案,新北市,汐止區,福山里,2441,1577,644,194,838,55,893
公投第７案,新北市,汐止區,宜興里,2442,1364,560,130,690,19,709
公投第７案,新北市,汐止區,宜興里,2443,1401,581,166,747,36,783
公投第７案,新北市,汐止區,東勢里,2444,1173,479,156,635,58,693
公投第７案,新北市,汐止區,東勢里,2445,993,469,86,555,23,578
公投第７案,新北市,汐止區,東勢里,2446,1587,635,167,802,29,831
公投第７案,臺中市,大甲區,朝陽里,1,1356,584,152,736,70,806
公投第７案,臺中市,大甲區,大甲里,2,1059,494,115,609,50,659
公投第７案,臺中市,大甲區,順天里,3,694,307,106,413,27,440
公投第７案,臺中市,大甲區,順天里,4,874,368,126,494,23,517
公投第７案,臺中市,大甲區,孔門里,5,763,318,81,399,30,429
公投第７案,臺中市,大甲區,平安里,6,856,424,88,512,35,547
公投第７案,臺中市,大甲區,平安里,7,1249,536,163,699,36,735
公投第７案,臺中市,大甲區,庄美里,8,922,382,82,464,32,496
公投第７案,臺中市,大甲區,庄美里,9,1189,533,125,658,35,693
公投第７案,臺中市,大甲區,新美里,10,1065,530,103,633,49,682
公投第７案,臺中市,大甲區,新美里,11,1252,580,151,731,73,804
公投第７案,臺中市,大甲區,新美里,12,1057,436,135,571,33,604
公投第７案,臺中市,大甲區,岷山里,13,1031,453,110,563,31,594
公投第７案,臺中市,大甲區,岷山里,14,1060,481,150,631,40,671
公投第７案,臺中市,大甲區,中山里,15,1311,572,142,714,51,765
公投第７案,臺中市,大甲區,中山里,16,1424,648,126,774,44,818
公投第７案,臺中市,大甲區,中山里,17,1670,750,73,823,58,881
公投第７案,臺中市,大甲區,南陽里,18,812,362,70,432,44,476
公投第７案,臺中市,大甲區,薰風里,19,863,399,87,486,21,507
公投第７案,臺中市,大甲區,義和里,20,1598,735,171,906,42,948
公投第７案,臺中市,大甲區,義和里,21,1588,720,155,875,36,911
公投第７案,臺中市,大甲區,武陵里,22,1197,503,136,639,52,691
公投第７案,臺中市,大甲區,文曲里,23,1106,425,114,539,76,615
公投第７案,臺中市,大甲區,武曲里,24,903,422,101,523,48,571
公投第７案,臺中市,大甲區,武曲里,25,869,392,123,515,29,544
公投第７案,臺中市,大甲區,文武里,26,1350,588,165,753,24,777
公投第７案,臺中市,大甲區,文武里,27,1144,498,124,622,65,687
公投第７案,臺中市,大甲區,文武里,28,1208,552,133,685,48,733
公投第７案,臺中市,大甲區,文武里,29,1567,698,179,877,33,910
公投第７案,臺中市,大甲區,奉化里,30,1246,628,130,758,30,788
公投第７案,臺中市,大甲區,奉化里,31,767,342,92,434,38,472
公投第７案,臺中市,大甲區,德化里,32,790,361,77,438,41,479
公投第７案,臺中市,大甲區,德化里,33,972,458,93,551,28,579
公投第７案,臺中市,大甲區,江南里,34,1388,591,125,716,51,767
公投第７案,臺中市,大甲區,頂店里,35,1331,541,131,672,34,706
公投第７案,臺中市,大甲區,頂店里,36,1167,552,131,683,40,723
公投第７案,臺中市,大甲區,頂店里,37,1934,867,171,1038,62,1100
公投第７案,臺中市,大甲區,太白里,38,1263,489,124,613,46,659
公投第７案,臺中市,大甲區,孟春里,39,1390,621,158,779,50,829
公投第７案,臺中市,大甲區,孟春里,40,1186,427,107,534,27,561
公投第７案,臺中市,大甲區,孟春里,41,1397,612,136,748,27,775
公投第７案,臺中市,大甲區,幸福里,42,1173,408,74,482,15,497
公投第７案,臺中市,大甲區,幸福里,43,1398,568,139,707,66,773
公投第７案,臺中市,大甲區,日南里,44,1228,443,144,587,53,640
公投第７案,臺中市,大甲區,日南里,45,1258,506,134,640,41,681
公投第７案,臺中市,大甲區,日南里,46,1435,613,138,751,35,786
公投第７案,臺中市,大甲區,日南里,47,1532,615,178,793,47,840
公投第７案,臺中市,大甲區,龍泉里,48,652,284,62,346,30,376
公投第７案,臺中市,大甲區,龍泉里,49,870,315,81,396,26,422
公投第７案,臺中市,大甲區,西岐里,50,891,333,99,432,28,460
公投第７案,臺中市,大甲區,西岐里,51,784,349,72,421,30,451
公投第７案,臺中市,大甲區,銅安里,52,1368,534,136,670,75,745
公投第７案,臺中市,大甲區,福德里,53,1126,437,116,553,48,601
公投第７案,臺中市,大甲區,建興里,54,1486,538,124,662,68,730
公投第７案,臺中市,大安區,南埔里,55,1068,446,73,519,53,572
公投第７案,臺中市,大安區,南庄里,56,1050,453,102,555,58,613
公投第７案,臺中市,大安區,中庄里,57,1246,547,143,690,60,750
公投第７案,臺中市,大安區,中庄里,58,1397,584,151,735,49,784
公投第７案,臺中市,大安區,東安里,59,1227,577,135,712,53,765
公投第７案,臺中市,大安區,福興里,60,1170,518,110,628,65,693
公投第７案,臺中市,大安區,龜壳里,61,914,453,107,560,35,595
公投第７案,臺中市,大安區,龜壳里,62,667,259,50,309,36,345
公投第７案,臺中市,大安區,頂安里,63,890,366,82,448,38,486
公投第７案,臺中市,大安區,永安里,64,1289,525,144,669,60,729
公投第７案,臺中市,大安區,永安里,65,455,171,45,216,25,241
公投第７案,臺中市,大安區,福住里,66,1028,445,112,557,31,588
公投第７案,臺中市,大安區,海墘里,67,1446,659,135,794,67,861
公投第７案,臺中市,大安區,西安里,68,688,350,72,422,26,448
公投第７案,臺中市,大安區,西安里,69,1062,491,109,600,49,649
公投第７案,臺中市,大安區,松雅里,70,923,444,121,565,29,594
公投第７案,臺中市,外埔區,永豐里,71,1059,446,119,565,37,602
公投第７案,臺中市,外埔區,六分里,72,1013,462,103,565,23,588
公投第７案,臺中市,外埔區,六分里,73,1150,555,113,668,45,713
公投第７案,臺中市,外埔區,大同里,74,1855,942,170,1112,62,1174
公投第７案,臺中市,外埔區,大同里,75,1327,622,141,763,31,794
公投第７案,臺中市,外埔區,大同里,76,1453,710,128,838,42,880
公投第７案,臺中市,外埔區,大東里,77,1653,715,143,858,67,925
公投第７案,臺中市,外埔區,大東里,78,1615,692,142,834,39,873
公投第７案,臺中市,外埔區,大東里,79,1470,593,152,745,31,776
公投第７案,臺中市,外埔區,大東里,80,1559,689,178,867,46,913
公投第７案,臺中市,外埔區,三崁里,81,1902,804,186,990,80,1070
公投第７案,臺中市,外埔區,水美里,82,1138,557,134,691,39,730
公投第７案,臺中市,外埔區,水美里,83,1065,506,107,613,65,678
公投第７案,臺中市,外埔區,水美里,84,1243,615,129,744,32,776
公投第７案,臺中市,外埔區,鐵山里,85,962,398,88,486,44,530
公投第７案,臺中市,外埔區,鐵山里,86,1169,512,103,615,37,652
公投第７案,臺中市,外埔區,中山里,87,1216,599,131,730,52,782
公投第７案,臺中市,外埔區,馬鳴里,88,1391,605,132,737,41,778
公投第７案,臺中市,外埔區,土城里,89,1616,652,185,837,69,906
公投第７案,臺中市,外埔區,廍子里,90,1203,442,83,525,30,555
公投第７案,臺中市,清水區,鰲峰里,91,1076,447,114,561,19,580
公投第７案,臺中市,清水區,靈泉里,92,953,472,106,578,47,625
公投第７案,臺中市,清水區,清水里,93,914,418,117,535,38,573
公投第７案,臺中市,清水區,清水里,94,1143,561,135,696,37,733
公投第７案,臺中市,清水區,文昌里,95,680,307,98,405,20,425
公投第７案,臺中市,清水區,南寧里,96,904,425,95,520,38,558
公投第７案,臺中市,清水區,南寧里,97,893,436,107,543,32,575
公投第７案,臺中市,清水區,西寧里,98,1577,712,172,884,34,918
公投第７案,臺中市,清水區,北寧里,99,690,316,67,383,26,409
公投第７案,臺中市,清水區,中興里,100,403,181,53,234,13,247
公投第７案,臺中市,清水區,西社里,101,1413,644,148,792,52,844
公投第７案,臺中市,清水區,西社里,102,777,338,92,430,35,465
公投第７案,臺中市,清水區,南社里,103,1313,613,151,764,27,791
公投第７案,臺中市,清水區,南社里,104,1439,693,161,854,45,899
公投第７案,臺中市,清水區,南社里,105,1265,533,123,656,23,679
公投第７案,臺中市,清水區,南社里,106,1277,626,139,765,29,794
公投第７案,臺中市,清水區,南社里,107,1276,628,105,733,37,770
公投第７案,臺中市,清水區,南社里,108,1376,734,104,838,27,865
公投第７案,臺中市,清水區,南社里,109,1291,649,132,781,25,806
公投第７案,臺中市,清水區,裕嘉里,110,1510,697,163,860,57,917
公投第７案,臺中市,清水區,臨江里,111,1524,720,147,867,63,930
公投第７案,臺中市,清水區,秀水里,112,1474,611,131,742,40,782
公投第７案,臺中市,清水區,秀水里,113,1507,679,139,818,42,860
公投第７案,臺中市,清水區,秀水里,114,1321,636,159,795,66,861
公投第７案,臺中市,清水區,武鹿里,115,1157,474,110,584,19,603
公投第７案,臺中市,清水區,武鹿里,116,1255,591,129,720,30,750
公投第７案,臺中市,清水區,武鹿里,117,881,382,94,476,22,498
公投第７案,臺中市,清水區,海濱里,118,1083,532,91,623,44,667
公投第７案,臺中市,清水區,海濱里,119,951,481,78,559,22,581
公投第７案,臺中市,清水區,槺榔里,120,1424,611,129,740,42,782
公投第７案,臺中市,清水區,槺榔里,121,1233,488,132,620,55,675
公投第７案,臺中市,清水區,槺榔里,122,1288,467,111,578,52,630
公投第７案,臺中市,清水區,槺榔里,123,1200,556,117,673,46,719
公投第７案,臺中市,清水區,中社里,124,1609,811,108,919,40,959
公投第７案,臺中市,清水區,中社里,125,1136,579,113,692,19,711
公投第７案,臺中市,清水區,高西里,126,1302,573,103,676,50,726
公投第７案,臺中市,清水區,高南里,127,1373,588,106,694,80,774
公投第７案,臺中市,清水區,高東里,128,1257,462,130,592,64,656
公投第７案,臺中市,清水區,高北里,129,1184,468,97,565,47,612
公投第７案,臺中市,清水區,高美里,130,1322,578,116,694,54,748
公投第７案,臺中市,清水區,國姓里,131,1193,474,110,584,38,622
公投第７案,臺中市,清水區,國姓里,132,927,391,115,506,37,543
公投第７案,臺中市,清水區,菁埔里,133,1073,509,121,630,40,670
公投第７案,臺中市,清水區,菁埔里,134,1163,517,138,655,64,719
公投第７案,臺中市,清水區,頂湳里,135,855,355,59,414,63,477
公投第７案,臺中市,清水區,頂湳里,136,902,352,98,450,56,506
公投第７案,臺中市,清水區,田寮里,137,1415,622,139,761,52,813
公投第７案,臺中市,清水區,田寮里,138,1066,431,122,553,26,579
公投第７案,臺中市,清水區,橋頭里,139,1391,605,135,740,52,792
公投第７案,臺中市,清水區,橋頭里,140,1449,598,136,734,31,765
公投第７案,臺中市,清水區,橋頭里,141,1377,628,151,779,50,829
公投第７案,臺中市,清水區,橋頭里,142,1423,651,143,794,49,843
公投第７案,臺中市,清水區,橋頭里,143,1624,729,168,897,40,937
公投第７案,臺中市,清水區,下湳里,144,1358,582,109,691,60,751
公投第７案,臺中市,清水區,下湳里,145,1464,640,137,777,72,849
公投第７案,臺中市,清水區,東山里,146,1211,548,141,689,58,747
公投第７案,臺中市,清水區,吳厝里,147,1456,621,117,738,25,763
公投第７案,臺中市,清水區,楊厝里,148,1162,558,102,660,62,722
公投第７案,臺中市,清水區,海風里,149,1368,678,137,815,56,871
公投第７案,臺中市,梧棲區,頂寮里,150,1541,655,164,819,50,869
公投第７案,臺中市,梧棲區,頂寮里,151,1581,691,148,839,42,881
公投第７案,臺中市,梧棲區,下寮里,152,1083,471,127,598,39,637
公投第７案,臺中市,梧棲區,下寮里,153,876,407,95,502,27,529
公投第７案,臺中市,梧棲區,中正里,154,1043,441,123,564,55,619
公投第７案,臺中市,梧棲區,中正里,155,1502,585,157,742,38,780
公投第７案,臺中市,梧棲區,中正里,156,1384,626,126,752,33,785
公投第７案,臺中市,梧棲區,中和里,157,517,262,72,334,24,358
公投第７案,臺中市,梧棲區,文化里,158,1169,575,121,696,50,746
公投第７案,臺中市,梧棲區,安仁里,159,863,371,122,493,31,524
公投第７案,臺中市,梧棲區,草湳里,160,1277,502,101,603,38,641
公投第７案,臺中市,梧棲區,草湳里,161,1742,693,203,896,41,937
公投第７案,臺中市,梧棲區,草湳里,162,1342,556,184,740,52,792
公投第７案,臺中市,梧棲區,草湳里,163,1767,736,210,946,74,1020
公投第７案,臺中市,梧棲區,南簡里,164,1542,578,153,731,53,784
公投第７案,臺中市,梧棲區,南簡里,165,1636,707,142,849,48,897
公投第７案,臺中市,梧棲區,南簡里,166,1796,732,147,879,58,937
公投第７案,臺中市,梧棲區,福德里,167,1450,594,130,724,73,797
公投第７案,臺中市,梧棲區,福德里,168,1548,608,141,749,102,851
公投第７案,臺中市,梧棲區,福德里,169,1366,643,122,765,37,802
公投第７案,臺中市,梧棲區,大庄里,170,955,493,94,587,26,613
公投第７案,臺中市,梧棲區,大庄里,171,1305,532,131,663,54,717
公投第７案,臺中市,梧棲區,大庄里,172,1239,581,123,704,29,733
公投第７案,臺中市,梧棲區,大庄里,173,1079,509,103,612,55,667
公投第７案,臺中市,梧棲區,大庄里,174,1220,545,111,656,24,680
公投第７案,臺中市,梧棲區,大庄里,175,1544,696,179,875,64,939
公投第７案,臺中市,梧棲區,大村里,176,1460,672,163,835,46,881
公投第７案,臺中市,梧棲區,大村里,177,1292,616,130,746,38,784
公投第７案,臺中市,梧棲區,大村里,178,1300,559,118,677,62,739
公投第７案,臺中市,梧棲區,大村里,179,1555,623,165,788,47,835
公投第７案,臺中市,梧棲區,興農里,180,1031,417,115,532,39,571
公投第７案,臺中市,梧棲區,興農里,181,1277,588,134,722,50,772
公投第７案,臺中市,梧棲區,永寧里,182,1037,411,123,534,39,573
公投第７案,臺中市,梧棲區,永寧里,183,1187,536,127,663,44,707
公投第７案,臺中市,梧棲區,永安里,184,1399,592,124,716,39,755
公投第７案,臺中市,梧棲區,永安里,185,1135,500,103,603,38,641
公投第７案,臺中市,沙鹿區,居仁里,186,1380,593,108,701,38,739
公投第７案,臺中市,沙鹿區,洛泉里,187,852,389,96,485,35,520
公投第７案,臺中市,沙鹿區,洛泉里,188,1176,562,132,694,32,726
公投第７案,臺中市,沙鹿區,沙鹿里,189,958,441,137,578,67,645
公投第７案,臺中市,沙鹿區,美仁里,190,488,249,70,319,17,336
公投第７案,臺中市,沙鹿區,興仁里,191,1177,510,148,658,32,690
公投第７案,臺中市,沙鹿區,興仁里,192,1285,552,136,688,48,736
公投第７案,臺中市,沙鹿區,興安里,193,1736,687,184,871,67,938
公投第７案,臺中市,沙鹿區,興安里,194,1628,735,196,931,57,988
公投第７案,臺中市,沙鹿區,斗抵里,195,1469,613,151,764,26,790
公投第７案,臺中市,沙鹿區,斗抵里,196,1423,665,162,827,45,872
公投第７案,臺中市,沙鹿區,斗抵里,197,1444,647,157,804,59,863
公投第７案,臺中市,沙鹿區,鹿峰里,198,1469,627,155,782,78,860
公投第７案,臺中市,沙鹿區,鹿峰里,199,1902,845,193,1038,80,1118
公投第７案,臺中市,沙鹿區,鹿峰里,200,1675,748,192,940,43,983
公投第７案,臺中市,沙鹿區,鹿寮里,201,1098,474,113,587,48,635
公投第７案,臺中市,沙鹿區,鹿寮里,202,1539,598,277,875,58,933
公投第７案,臺中市,沙鹿區,鹿寮里,203,1329,601,153,754,32,786
公投第７案,臺中市,沙鹿區,鹿寮里,204,1255,503,149,652,45,697
公投第７案,臺中市,沙鹿區,鹿寮里,205,1507,658,179,837,49,886
公投第７案,臺中市,沙鹿區,竹林里,206,1463,644,153,797,71,868
公投第７案,臺中市,沙鹿區,竹林里,207,1279,542,113,655,52,707
公投第７案,臺中市,沙鹿區,竹林里,208,1024,437,66,503,30,533
公投第７案,臺中市,沙鹿區,竹林里,209,1388,575,112,687,67,754
公投第７案,臺中市,沙鹿區,竹林里,210,1074,498,119,617,35,652
公投第７案,臺中市,沙鹿區,竹林里,211,1072,510,114,624,31,655
公投第７案,臺中市,沙鹿區,犁分里,212,1107,505,123,628,61,689
公投第７案,臺中市,沙鹿區,福興里,213,1947,784,157,941,47,988
公投第７案,臺中市,沙鹿區,福興里,214,1682,683,157,840,57,897
公投第７案,臺中市,沙鹿區,北勢里,215,1633,786,116,902,48,950
公投第７案,臺中市,沙鹿區,北勢里,216,1533,614,144,758,47,805
公投第７案,臺中市,沙鹿區,北勢里,217,1605,584,137,721,34,755
公投第７案,臺中市,沙鹿區,晉江里,218,1694,712,129,841,26,867
公投第７案,臺中市,沙鹿區,六路里,219,1628,672,159,831,43,874
公投第７案,臺中市,沙鹿區,六路里,220,1665,749,178,927,24,951
公投第７案,臺中市,沙鹿區,六路里,221,1651,714,148,862,47,909
公投第７案,臺中市,沙鹿區,南勢里,222,1108,560,98,658,30,688
公投第７案,臺中市,沙鹿區,南勢里,223,1142,548,116,664,36,700
公投第７案,臺中市,沙鹿區,南勢里,224,1039,473,97,570,28,598
公投第７案,臺中市,沙鹿區,埔子里,225,1840,774,169,943,70,1013
公投第７案,臺中市,沙鹿區,埔子里,226,1872,830,176,1006,30,1036
公投第７案,臺中市,沙鹿區,埔子里,227,1558,644,149,793,50,843
公投第７案,臺中市,沙鹿區,三鹿里,228,1739,722,133,855,43,898
公投第７案,臺中市,沙鹿區,三鹿里,229,1672,658,151,809,32,841
公投第７案,臺中市,沙鹿區,三鹿里,230,1634,728,152,880,28,908
公投第７案,臺中市,沙鹿區,三鹿里,231,1616,643,142,785,44,829
公投第７案,臺中市,沙鹿區,公明里,232,1593,683,175,858,47,905
公投第７案,臺中市,沙鹿區,公明里,233,981,432,69,501,25,526
公投第７案,臺中市,沙鹿區,公明里,234,1740,822,165,987,45,1032
公投第７案,臺中市,沙鹿區,清泉里,235,1247,582,123,705,59,764
公投第７案,臺中市,沙鹿區,清泉里,236,1047,506,81,587,13,600
公投第７案,臺中市,沙鹿區,西勢里,237,1119,488,120,608,58,666
公投第７案,臺中市,沙鹿區,西勢里,238,1025,435,96,531,15,546
公投第７案,臺中市,龍井區,竹坑里,239,1758,785,191,976,74,1050
公投第７案,臺中市,龍井區,竹坑里,240,1275,558,138,696,34,730
公投第７案,臺中市,龍井區,龍東里,241,1379,512,129,641,27,668
公投第７案,臺中市,龍井區,龍東里,242,1403,555,133,688,60,748
公投第７案,臺中市,龍井區,龍西里,243,974,408,110,518,45,563
公投第７案,臺中市,龍井區,龍西里,244,901,17,484,501,38,539
公投第７案,臺中市,龍井區,田中里,245,1779,763,166,929,58,987
公投第７案,臺中市,龍井區,田中里,246,1609,740,171,911,45,956
公投第７案,臺中市,龍井區,福田里,247,1038,415,101,516,19,535
公投第７案,臺中市,龍井區,麗水里,248,1328,615,139,754,51,805
公投第７案,臺中市,龍井區,麗水里,249,921,422,106,528,34,562
公投第７案,臺中市,龍井區,龍津里,250,1609,637,160,797,47,844
公投第７案,臺中市,龍井區,龍津里,251,1227,453,104,557,16,573
公投第７案,臺中市,龍井區,龍津里,252,1278,548,121,669,55,724
公投第７案,臺中市,龍井區,龍津里,253,914,298,99,397,17,414
公投第７案,臺中市,龍井區,三德里,254,1678,626,129,755,40,795
公投第７案,臺中市,龍井區,三德里,255,1233,464,128,592,32,624
公投第７案,臺中市,龍井區,忠和里,256,1520,639,155,794,65,859
公投第７案,臺中市,龍井區,忠和里,257,1905,778,164,942,27,969
公投第７案,臺中市,龍井區,忠和里,258,1520,646,200,846,54,900
公投第７案,臺中市,龍井區,山腳里,259,1385,561,124,685,63,748
公投第７案,臺中市,龍井區,山腳里,260,1212,471,124,595,37,632
公投第７案,臺中市,龍井區,山腳里,261,1432,639,151,790,21,811
公投第７案,臺中市,龍井區,山腳里,262,1663,671,163,834,32,866
公投第７案,臺中市,龍井區,龍泉里,263,1422,579,137,716,34,750
公投第７案,臺中市,龍井區,龍泉里,264,1616,594,162,756,57,813
公投第７案,臺中市,龍井區,龍泉里,265,1422,670,132,802,45,847
公投第７案,臺中市,龍井區,龍泉里,266,1165,546,129,675,15,690
公投第７案,臺中市,龍井區,龍泉里,267,1624,694,187,881,19,900
公投第７案,臺中市,龍井區,龍崗里,268,1613,690,166,856,43,899
公投第７案,臺中市,龍井區,龍崗里,269,943,439,110,549,37,586
公投第７案,臺中市,龍井區,新庄里,270,1595,638,144,782,69,851
公投第７案,臺中市,龍井區,新庄里,271,1508,662,166,828,60,888
公投第７案,臺中市,龍井區,新庄里,272,1479,592,154,746,38,784
公投第７案,臺中市,龍井區,新庄里,273,1509,669,164,833,41,874
公投第７案,臺中市,龍井區,南寮里,274,1582,714,173,887,55,942
公投第７案,臺中市,龍井區,東海里,275,1725,779,154,933,42,975
公投第７案,臺中市,龍井區,東海里,276,1616,760,124,884,31,915
公投第７案,臺中市,龍井區,東海里,277,1657,773,156,929,43,972
公投第７案,臺中市,龍井區,東海里,278,1774,802,179,981,54,1035
公投第７案,臺中市,龍井區,東海里,279,1701,762,221,983,54,1037
公投第７案,臺中市,龍井區,新東里,280,1121,512,116,628,34,662
公投第７案,臺中市,龍井區,新東里,281,987,462,119,581,39,620
公投第７案,臺中市,龍井區,新東里,282,1206,517,148,665,48,713
公投第７案,臺中市,龍井區,新東里,283,1378,672,140,812,35,847
公投第７案,臺中市,大肚區,王田里,284,1415,623,138,761,28,789
公投第７案,臺中市,大肚區,王田里,285,1392,563,138,701,45,746
公投第７案,臺中市,大肚區,王田里,286,1520,712,159,871,50,921
公投第７案,臺中市,大肚區,中和里,287,862,421,113,534,49,583
公投第７案,臺中市,大肚區,福山里,288,1256,589,140,729,48,777
公投第７案,臺中市,大肚區,福山里,289,1292,560,139,699,48,747
公投第７案,臺中市,大肚區,福山里,290,1010,473,111,584,32,616
公投第７案,臺中市,大肚區,營埔里,291,1485,676,168,844,74,918
公投第７案,臺中市,大肚區,社腳里,292,1190,587,114,701,57,758
公投第７案,臺中市,大肚區,社腳里,293,1250,569,123,692,52,744
公投第７案,臺中市,大肚區,新興里,294,1310,560,178,738,42,780
公投第７案,臺中市,大肚區,新興里,295,1294,569,127,696,40,736
公投第７案,臺中市,大肚區,大東里,296,1734,838,194,1032,50,1082
公投第７案,臺中市,大肚區,大東里,297,1316,572,127,699,49,748
公投第７案,臺中市,大肚區,大肚里,298,854,383,96,479,32,511
公投第７案,臺中市,大肚區,大肚里,299,1273,628,145,773,24,797
公投第７案,臺中市,大肚區,永和里,300,851,431,83,514,17,531
公投第７案,臺中市,大肚區,磺溪里,301,1629,746,127,873,35,908
公投第７案,臺中市,大肚區,永順里,302,1709,735,141,876,95,971
公投第７案,臺中市,大肚區,成功里,303,953,402,72,474,36,510
公投第７案,臺中市,大肚區,山陽里,304,1336,620,154,774,38,812
公投第７案,臺中市,大肚區,頂街里,305,2113,828,251,1079,63,1142
公投第７案,臺中市,大肚區,頂街里,306,1730,775,161,936,81,1017
公投第７案,臺中市,大肚區,頂街里,307,1692,744,177,921,25,946
公投第７案,臺中市,大肚區,頂街里,308,1747,802,142,944,41,985
公投第７案,臺中市,大肚區,瑞井里,309,1672,780,121,901,57,958
公投第７案,臺中市,大肚區,瑞井里,310,1675,678,164,842,40,882
公投第７案,臺中市,大肚區,瑞井里,311,1673,727,161,888,51,939
公投第７案,臺中市,大肚區,蔗廍里,312,1636,740,173,913,39,952
公投第７案,臺中市,大肚區,蔗廍里,313,1753,666,190,856,86,942
公投第７案,臺中市,大肚區,蔗廍里,314,1343,531,119,650,28,678
公投第７案,臺中市,大肚區,自強里,315,1822,758,162,920,51,971
公投第７案,臺中市,大肚區,自強里,316,1670,804,168,972,60,1032
公投第７案,臺中市,烏日區,烏日里,317,1480,674,179,853,54,907
公投第７案,臺中市,烏日區,烏日里,318,1841,860,196,1056,68,1124
公投第７案,臺中市,烏日區,烏日里,319,1751,753,188,941,58,999
公投第７案,臺中市,烏日區,烏日里,320,1547,727,168,895,64,959
公投第７案,臺中市,烏日區,烏日里,321,1836,831,182,1013,44,1057
公投第７案,臺中市,烏日區,湖日里,322,1239,589,156,745,85,830
公投第７案,臺中市,烏日區,湖日里,323,1295,540,137,677,65,742
公投第７案,臺中市,烏日區,三和里,324,1263,545,129,674,37,711
公投第７案,臺中市,烏日區,三和里,325,1622,721,155,876,30,906
公投第７案,臺中市,烏日區,三和里,326,1822,784,176,960,76,1036
公投第７案,臺中市,烏日區,榮泉里,327,1966,881,175,1056,52,1108
公投第７案,臺中市,烏日區,榮泉里,328,1615,746,156,902,47,949
公投第７案,臺中市,烏日區,榮泉里,329,1232,585,134,719,30,749
公投第７案,臺中市,烏日區,學田里,330,1347,613,114,727,26,753
公投第７案,臺中市,烏日區,學田里,331,1165,492,93,585,35,620
公投第７案,臺中市,烏日區,九德里,332,1664,781,167,948,37,985
公投第７案,臺中市,烏日區,九德里,333,1230,585,137,722,52,774
公投第７案,臺中市,烏日區,九德里,334,1574,715,202,917,72,989
公投第７案,臺中市,烏日區,九德里,335,1452,685,195,880,39,919
公投第７案,臺中市,烏日區,九德里,336,1879,767,161,928,50,978
公投第７案,臺中市,烏日區,九德里,337,1601,689,171,860,37,897
公投第７案,臺中市,烏日區,九德里,338,1546,725,183,908,43,951
公投第７案,臺中市,烏日區,九德里,339,1866,722,180,902,32,934
公投第７案,臺中市,烏日區,仁德里,340,1938,849,236,1085,67,1152
公投第７案,臺中市,烏日區,仁德里,341,1759,792,195,987,55,1042
公投第７案,臺中市,烏日區,仁德里,342,2061,859,235,1094,54,1148
公投第７案,臺中市,烏日區,仁德里,343,1691,775,180,955,44,999
公投第７案,臺中市,烏日區,前竹里,344,1039,484,158,642,37,679
公投第７案,臺中市,烏日區,前竹里,345,1221,548,153,701,27,728
公投第７案,臺中市,烏日區,五光里,346,1650,752,74,826,73,899
公投第７案,臺中市,烏日區,光明里,347,937,436,113,549,33,582
公投第７案,臺中市,烏日區,光明里,348,1220,566,114,680,49,729
公投第７案,臺中市,烏日區,東園里,349,2139,844,202,1046,104,1150
公投第７案,臺中市,烏日區,溪埧里,350,1371,657,157,814,60,874
公投第７案,臺中市,烏日區,溪埧里,351,1277,581,130,711,44,755
公投第７案,臺中市,烏日區,溪埧里,352,1708,703,184,887,52,939
公投第７案,臺中市,烏日區,螺潭里,353,2048,895,182,1077,63,1140
公投第７案,臺中市,烏日區,北里里,354,1632,667,166,833,79,912
公投第７案,臺中市,烏日區,南里里,355,1327,607,144,751,54,805
公投第７案,臺中市,烏日區,溪尾里,356,854,354,86,440,59,499
公投第７案,臺中市,后里區,廣福里,357,852,441,69,510,34,544
公投第７案,臺中市,后里區,廣福里,358,1135,486,107,593,55,648
公投第７案,臺中市,后里區,仁里里,359,1079,428,113,541,37,578
公投第７案,臺中市,后里區,義里里,360,1539,731,141,872,46,918
公投第７案,臺中市,后里區,義里里,361,1591,720,134,854,70,924
公投第７案,臺中市,后里區,義德里,362,1376,549,115,664,45,709
公投第７案,臺中市,后里區,義德里,363,1298,572,122,694,22,716
公投第７案,臺中市,后里區,后里里,364,1428,624,158,782,72,854
公投第７案,臺中市,后里區,后里里,365,1178,598,141,739,43,782
公投第７案,臺中市,后里區,后里里,366,1095,501,104,605,53,658
公投第７案,臺中市,后里區,厚里里,367,963,419,90,509,23,532
公投第７案,臺中市,后里區,厚里里,368,1163,506,112,618,40,658
公投第７案,臺中市,后里區,墩東里,369,1018,490,102,592,28,620
公投第７案,臺中市,后里區,墩東里,370,854,439,75,514,38,552
公投第７案,臺中市,后里區,墩東里,371,1485,630,137,767,47,814
公投第７案,臺中市,后里區,墩東里,372,1355,683,132,815,41,856
公投第７案,臺中市,后里區,墩西里,373,840,348,75,423,40,463
公投第７案,臺中市,后里區,墩西里,374,1146,506,136,642,47,689
公投第７案,臺中市,后里區,墩南里,375,1669,802,160,962,58,1020
公投第７案,臺中市,后里區,墩南里,376,1673,786,173,959,86,1045
公投第７案,臺中市,后里區,墩北里,377,1493,676,152,828,37,865
公投第７案,臺中市,后里區,墩北里,378,1052,477,121,598,52,650
公投第７案,臺中市,后里區,墩北里,379,909,373,87,460,17,477
公投第７案,臺中市,后里區,中和里,380,1091,499,108,607,63,670
公投第７案,臺中市,后里區,中和里,381,1342,642,146,788,42,830
公投第７案,臺中市,后里區,舊社里,382,1138,460,133,593,55,648
公投第７案,臺中市,后里區,舊社里,383,977,456,96,552,41,593
公投第７案,臺中市,后里區,聯合里,384,1584,581,140,721,27,748
公投第７案,臺中市,后里區,太平里,385,915,405,94,499,25,524
公投第７案,臺中市,后里區,太平里,386,1225,559,118,677,59,736
公投第７案,臺中市,后里區,眉山里,387,1552,680,133,813,37,850
公投第７案,臺中市,后里區,眉山里,388,1600,692,155,847,20,867
公投第７案,臺中市,后里區,月眉里,389,942,416,86,502,33,535
公投第７案,臺中市,后里區,月眉里,390,943,394,108,502,24,526
公投第７案,臺中市,后里區,公館里,391,1055,451,77,528,32,560
公投第７案,臺中市,后里區,公館里,392,1067,469,111,580,51,631
公投第７案,臺中市,后里區,泰安里,393,1340,533,135,668,47,715
公投第７案,臺中市,豐原區,豐原里,394,983,400,121,521,39,560
公投第７案,臺中市,豐原區,豐原里,395,1309,572,153,725,58,783
公投第７案,臺中市,豐原區,豐榮里,396,1116,485,156,641,57,698
公投第７案,臺中市,豐原區,頂街里,397,945,457,114,571,37,608
公投第７案,臺中市,豐原區,中山里,398,850,359,135,494,57,551
公投第７案,臺中市,豐原區,下街里,399,760,367,88,455,34,489
公投第７案,臺中市,豐原區,中陽里,400,1617,719,176,895,12,907
公投第７案,臺中市,豐原區,中陽里,401,1677,704,144,848,46,894
公投第７案,臺中市,豐原區,中陽里,402,1771,883,197,1080,37,1117
公投第７案,臺中市,豐原區,大湳里,403,1145,462,128,590,72,662
公投第７案,臺中市,豐原區,大湳里,404,1362,618,126,744,26,770
公投第７案,臺中市,豐原區,北湳里,405,1389,661,133,794,41,835
公投第７案,臺中市,豐原區,北湳里,406,1530,703,177,880,60,940
公投第７案,臺中市,豐原區,東湳里,407,1471,646,161,807,76,883
公投第７案,臺中市,豐原區,東湳里,408,1410,616,165,781,74,855
公投第７案,臺中市,豐原區,東湳里,409,1162,490,131,621,47,668
公投第７案,臺中市,豐原區,西湳里,410,1656,740,169,909,34,943
公投第７案,臺中市,豐原區,西湳里,411,1838,799,194,993,51,1044
公投第７案,臺中市,豐原區,西湳里,412,1666,717,171,888,56,944
公投第７案,臺中市,豐原區,西湳里,413,1821,825,193,1018,80,1098
公投第７案,臺中市,豐原區,西湳里,414,1821,927,220,1147,64,1211
公投第７案,臺中市,豐原區,豐西里,415,1647,696,188,884,30,914
公投第７案,臺中市,豐原區,圳寮里,416,1256,595,177,772,66,838
公投第７案,臺中市,豐原區,豐圳里,417,1552,777,172,949,49,998
公投第７案,臺中市,豐原區,豐圳里,418,1793,810,188,998,44,1042
公投第７案,臺中市,豐原區,富春里,419,759,401,107,508,37,545
公投第７案,臺中市,豐原區,葫蘆里,420,642,283,103,386,37,423
公投第７案,臺中市,豐原區,西安里,421,1528,702,166,868,28,896
公投第７案,臺中市,豐原區,西安里,422,1788,871,208,1079,62,1141
公投第７案,臺中市,豐原區,西安里,423,1663,814,198,1012,70,1082
公投第７案,臺中市,豐原區,西勢里,424,1260,640,177,817,54,871
公投第７案,臺中市,豐原區,西勢里,425,902,415,76,491,31,522
公投第７案,臺中市,豐原區,中興里,426,1357,587,112,699,30,729
公投第７案,臺中市,豐原區,中興里,427,1592,777,151,928,36,964
公投第７案,臺中市,豐原區,社皮里,428,1873,882,153,1035,69,1104
公投第７案,臺中市,豐原區,社皮里,429,1867,850,156,1006,54,1060
公投第７案,臺中市,豐原區,社皮里,430,1823,791,198,989,71,1060
公投第７案,臺中市,豐原區,社皮里,431,1962,792,174,966,63,1029
公投第７案,臺中市,豐原區,社皮里,432,2313,1074,275,1349,74,1423
公投第７案,臺中市,豐原區,三村里,433,1510,711,180,891,50,941
公投第７案,臺中市,豐原區,三村里,434,1824,833,204,1037,67,1104
公投第７案,臺中市,豐原區,三村里,435,1363,595,200,795,30,825
公投第７案,臺中市,豐原區,三村里,436,1535,161,755,916,0,916
公投第７案,臺中市,豐原區,東勢里,437,1457,661,196,857,53,910
公投第７案,臺中市,豐原區,民生里,438,1184,545,150,695,35,730
公投第７案,臺中市,豐原區,田心里,439,2299,885,166,1051,63,1114
公投第７案,臺中市,豐原區,田心里,440,1940,888,195,1083,70,1153
公投第７案,臺中市,豐原區,田心里,441,2067,901,188,1089,56,1145
公投第７案,臺中市,豐原區,豐田里,442,2038,891,183,1074,80,1154
公投第７案,臺中市,豐原區,豐田里,443,1835,778,215,993,53,1046
公投第７案,臺中市,豐原區,豐田里,444,1979,821,242,1063,74,1137
公投第７案,臺中市,豐原區,豐田里,445,2014,882,178,1060,67,1127
公投第７案,臺中市,豐原區,豐田里,446,2257,980,242,1222,100,1322
公投第７案,臺中市,豐原區,鎌村里,447,1406,663,152,815,73,888
公投第７案,臺中市,豐原區,鎌村里,448,1418,649,159,808,44,852
公投第７案,臺中市,豐原區,鎌村里,449,1772,903,166,1069,69,1138
公投第７案,臺中市,豐原區,陽明里,450,1202,574,144,718,42,760
公投第７案,臺中市,豐原區,陽明里,451,1447,680,173,853,38,891
公投第７案,臺中市,豐原區,南陽里,452,1758,809,206,1015,69,1084
公投第７案,臺中市,豐原區,南陽里,453,1546,741,188,929,56,985
公投第７案,臺中市,豐原區,南陽里,454,1815,914,160,1074,50,1124
公投第７案,臺中市,豐原區,南陽里,455,1932,883,237,1120,51,1171
公投第７案,臺中市,豐原區,南陽里,456,1770,872,202,1074,58,1132
公投第７案,臺中市,豐原區,南陽里,457,1560,710,131,841,36,877
公投第７案,臺中市,豐原區,北陽里,458,1810,824,191,1015,33,1048
公投第７案,臺中市,豐原區,北陽里,459,1653,796,181,977,50,1027
公投第７案,臺中市,豐原區,北陽里,460,1444,673,135,808,57,865
公投第７案,臺中市,豐原區,北陽里,461,1318,639,136,775,51,826
公投第７案,臺中市,豐原區,北陽里,462,1566,682,187,869,79,948
公投第７案,臺中市,豐原區,北陽里,463,1748,788,166,954,67,1021
公投第７案,臺中市,豐原區,北陽里,464,1772,732,162,894,76,970
公投第７案,臺中市,豐原區,北陽里,465,1721,744,190,934,74,1008
公投第７案,臺中市,豐原區,東陽里,466,1578,720,185,905,48,953
公投第７案,臺中市,豐原區,南村里,467,1859,784,224,1008,76,1084
公投第７案,臺中市,豐原區,南村里,468,1479,647,172,819,46,865
公投第７案,臺中市,豐原區,南村里,469,1889,850,205,1055,42,1097
公投第７案,臺中市,豐原區,南田里,470,1803,841,154,995,37,1032
公投第７案,臺中市,豐原區,南田里,471,1421,591,173,764,57,821
公投第７案,臺中市,豐原區,南嵩里,472,1585,710,228,938,63,1001
公投第７案,臺中市,豐原區,南嵩里,473,1774,871,183,1054,66,1120
公投第７案,臺中市,豐原區,翁明里,474,2132,969,222,1191,70,1261
公投第７案,臺中市,豐原區,翁子里,475,1515,674,164,838,66,904
公投第７案,臺中市,豐原區,翁子里,476,1359,560,124,684,19,703
公投第７案,臺中市,豐原區,翁社里,477,948,437,104,541,54,595
公投第７案,臺中市,豐原區,翁社里,478,1134,508,158,666,45,711
公投第７案,臺中市,豐原區,朴子里,479,1114,554,145,699,50,749
公投第７案,臺中市,豐原區,朴子里,480,1050,464,130,594,44,638
公投第７案,臺中市,豐原區,朴子里,481,1182,588,143,731,43,774
公投第７案,臺中市,神岡區,神岡里,482,1684,783,165,948,57,1005
公投第７案,臺中市,神岡區,神岡里,483,1559,720,153,873,52,925
公投第７案,臺中市,神岡區,庄前里,484,1095,463,128,591,24,615
公投第７案,臺中市,神岡區,庄前里,485,1044,538,116,654,55,709
公投第７案,臺中市,神岡區,北庄里,486,1310,626,162,788,65,853
公投第７案,臺中市,神岡區,北庄里,487,1294,602,147,749,77,826
公投第７案,臺中市,神岡區,庄後里,488,1143,507,132,639,45,684
公投第７案,臺中市,神岡區,庄後里,489,1022,455,132,587,45,632
公投第７案,臺中市,神岡區,圳前里,490,1269,524,126,650,43,693
公投第７案,臺中市,神岡區,圳前里,491,1085,415,69,484,27,511
公投第７案,臺中市,神岡區,圳堵里,492,942,410,123,533,61,594
公投第７案,臺中市,神岡區,圳堵里,493,1154,478,137,615,25,640
公投第７案,臺中市,神岡區,新庄里,494,1390,558,169,727,41,768
公投第７案,臺中市,神岡區,新庄里,495,1372,642,151,793,75,868
公投第７案,臺中市,神岡區,新庄里,496,1328,507,127,634,46,680
公投第７案,臺中市,神岡區,山皮里,497,1038,417,119,536,27,563
公投第７案,臺中市,神岡區,社口里,498,1452,628,129,757,30,787
公投第７案,臺中市,神岡區,社口里,499,1551,736,161,897,65,962
公投第７案,臺中市,神岡區,社口里,500,1567,672,143,815,46,861
公投第７案,臺中市,神岡區,社口里,501,1449,634,161,795,42,837
公投第７案,臺中市,神岡區,社口里,502,1246,504,121,625,19,644
公投第７案,臺中市,神岡區,社南里,503,1431,654,154,808,46,854
公投第７案,臺中市,神岡區,社南里,504,1163,539,147,686,49,735
公投第７案,臺中市,神岡區,社南里,505,1402,691,157,848,53,901
公投第７案,臺中市,神岡區,社南里,506,1271,589,127,716,36,752
公投第７案,臺中市,神岡區,三角里,507,1198,546,137,683,43,726
公投第７案,臺中市,神岡區,三角里,508,1312,616,130,746,57,803
公投第７案,臺中市,神岡區,大社里,509,1590,685,153,838,64,902
公投第７案,臺中市,神岡區,大社里,510,1324,563,123,686,38,724
公投第７案,臺中市,神岡區,大社里,511,1415,679,43,722,42,764
公投第７案,臺中市,神岡區,岸裡里,512,1483,722,174,896,42,938
公投第７案,臺中市,神岡區,岸裡里,513,1402,553,147,700,27,727
公投第７案,臺中市,神岡區,豐洲里,514,1275,549,127,676,35,711
公投第７案,臺中市,神岡區,豐洲里,515,1288,490,143,633,74,707
公投第７案,臺中市,神岡區,豐洲里,516,1080,451,126,577,42,619
公投第７案,臺中市,神岡區,豐洲里,517,1344,568,126,694,27,721
公投第７案,臺中市,神岡區,豐洲里,518,1061,482,130,612,51,663
公投第７案,臺中市,神岡區,豐洲里,519,1176,564,139,703,42,745
公投第７案,臺中市,神岡區,神洲里,520,1244,570,156,726,51,777
公投第７案,臺中市,神岡區,神洲里,521,1318,638,164,802,48,850
公投第７案,臺中市,神岡區,溪洲里,522,1471,614,137,751,46,797
公投第７案,臺中市,神岡區,溪洲里,523,1323,641,163,804,70,874
公投第７案,臺中市,大雅區,上雅里,524,2027,919,175,1094,68,1162
公投第７案,臺中市,大雅區,上雅里,525,1967,777,188,965,27,992
公投第７案,臺中市,大雅區,上雅里,526,1912,818,172,990,36,1026
公投第７案,臺中市,大雅區,大雅里,527,1537,723,173,896,47,943
公投第７案,臺中市,大雅區,大雅里,528,1439,667,185,852,49,901
公投第７案,臺中市,大雅區,大雅里,529,1402,648,139,787,50,837
公投第７案,臺中市,大雅區,文雅里,530,2013,862,202,1064,31,1095
公投第７案,臺中市,大雅區,文雅里,531,1917,858,197,1055,64,1119
公投第７案,臺中市,大雅區,文雅里,532,2011,879,183,1062,34,1096
公投第７案,臺中市,大雅區,三和里,533,1887,264,185,449,46,495
公投第７案,臺中市,大雅區,三和里,534,1480,662,189,851,51,902
公投第７案,臺中市,大雅區,三和里,535,1816,816,172,988,47,1035
公投第７案,臺中市,大雅區,二和里,536,1898,741,181,922,63,985
公投第７案,臺中市,大雅區,二和里,537,2008,915,167,1082,68,1150
公投第７案,臺中市,大雅區,二和里,538,1976,926,168,1094,52,1146
公投第７案,臺中市,大雅區,四德里,539,1673,786,150,936,41,977
公投第７案,臺中市,大雅區,四德里,540,1409,672,163,835,32,867
公投第７案,臺中市,大雅區,四德里,541,1382,645,141,786,18,804
公投第７案,臺中市,大雅區,西寶里,542,1635,725,140,865,63,928
公投第７案,臺中市,大雅區,西寶里,543,1565,729,154,883,40,923
公投第７案,臺中市,大雅區,西寶里,544,1528,644,154,798,40,838
公投第７案,臺中市,大雅區,上楓里,545,1963,816,167,983,45,1028
公投第７案,臺中市,大雅區,上楓里,546,2073,835,189,1024,36,1060
公投第７案,臺中市,大雅區,上楓里,547,1984,861,190,1051,44,1095
公投第７案,臺中市,大雅區,大楓里,548,1688,743,143,886,52,938
公投第７案,臺中市,大雅區,大楓里,549,1387,604,150,754,48,802
公投第７案,臺中市,大雅區,大楓里,550,1701,776,186,962,72,1034
公投第７案,臺中市,大雅區,雅楓里,551,1721,728,154,882,89,971
公投第７案,臺中市,大雅區,雅楓里,552,1879,690,134,824,39,863
公投第７案,臺中市,大雅區,員林里,553,1568,768,166,934,48,982
公投第７案,臺中市,大雅區,員林里,554,1761,745,209,954,56,1010
公投第７案,臺中市,大雅區,員林里,555,1752,808,197,1005,59,1064
公投第７案,臺中市,大雅區,員林里,556,1264,587,135,722,37,759
公投第７案,臺中市,大雅區,員林里,557,1302,644,127,771,38,809
公投第７案,臺中市,大雅區,員林里,558,1449,633,141,774,54,828
公投第７案,臺中市,大雅區,六寶里,559,1621,783,138,921,70,991
公投第７案,臺中市,大雅區,六寶里,560,1647,705,146,851,75,926
公投第７案,臺中市,大雅區,六寶里,561,1441,636,126,762,25,787
公投第７案,臺中市,大雅區,六寶里,562,1460,650,122,772,21,793
公投第７案,臺中市,大雅區,秀山里,563,1832,893,234,1127,65,1192
公投第７案,臺中市,大雅區,秀山里,564,1371,670,148,818,52,870
公投第７案,臺中市,大雅區,橫山里,565,1418,539,146,685,13,698
公投第７案,臺中市,大雅區,橫山里,566,1473,694,134,828,32,860
公投第７案,臺中市,大雅區,橫山里,567,1335,612,133,745,47,792
公投第７案,臺中市,大雅區,忠義里,568,1733,777,149,926,52,978
公投第７案,臺中市,大雅區,忠義里,569,1884,735,127,862,100,962
公投第７案,臺中市,潭子區,潭秀里,570,1306,586,161,747,39,786
公投第７案,臺中市,潭子區,潭北里,571,1128,520,126,646,41,687
公投第７案,臺中市,潭子區,潭北里,572,1159,567,135,702,46,748
公投第７案,臺中市,潭子區,潭陽里,573,1630,785,156,941,60,1001
公投第７案,臺中市,潭子區,潭陽里,574,1532,705,145,850,27,877
公投第７案,臺中市,潭子區,潭陽里,575,1677,672,158,830,36,866
公投第７案,臺中市,潭子區,潭陽里,576,1744,704,169,873,53,926
公投第７案,臺中市,潭子區,潭陽里,577,1795,766,210,976,57,1033
公投第７案,臺中市,潭子區,潭陽里,578,1171,536,112,648,26,674
公投第７案,臺中市,潭子區,潭陽里,579,1427,642,141,783,33,816
公投第７案,臺中市,潭子區,福仁里,580,1709,754,168,922,65,987
公投第７案,臺中市,潭子區,福仁里,581,1723,777,171,948,35,983
公投第７案,臺中市,潭子區,福仁里,582,1782,783,160,943,43,986
公投第７案,臺中市,潭子區,福仁里,583,1407,601,127,728,39,767
公投第７案,臺中市,潭子區,福仁里,584,1771,786,179,965,39,1004
公投第７案,臺中市,潭子區,福仁里,585,1795,832,185,1017,67,1084
公投第７案,臺中市,潭子區,頭家里,586,1612,790,173,963,47,1010
公投第７案,臺中市,潭子區,頭家里,587,1894,822,174,996,37,1033
公投第７案,臺中市,潭子區,頭家里,588,1689,734,179,913,39,952
公投第７案,臺中市,潭子區,頭家東里,589,1525,604,145,749,47,796
公投第７案,臺中市,潭子區,頭家東里,590,1622,684,174,858,36,894
公投第７案,臺中市,潭子區,頭家東里,591,1200,539,124,663,62,725
公投第７案,臺中市,潭子區,家興里,592,1355,591,117,708,12,720
公投第７案,臺中市,潭子區,家興里,593,1777,782,154,936,29,965
公投第７案,臺中市,潭子區,家興里,594,1923,873,179,1052,27,1079
公投第７案,臺中市,潭子區,家興里,595,1674,717,143,860,65,925
公投第７案,臺中市,潭子區,家福里,596,1451,708,158,866,45,911
公投第７案,臺中市,潭子區,家福里,597,1486,646,170,816,59,875
公投第７案,臺中市,潭子區,家福里,598,1511,692,163,855,60,915
公投第７案,臺中市,潭子區,甘蔗里,599,1666,811,139,950,42,992
公投第７案,臺中市,潭子區,甘蔗里,600,1750,770,147,917,69,986
公投第７案,臺中市,潭子區,甘蔗里,601,1437,637,126,763,46,809
公投第７案,臺中市,潭子區,甘蔗里,602,1735,776,166,942,32,974
公投第７案,臺中市,潭子區,甘蔗里,603,1612,695,156,851,57,908
公投第７案,臺中市,潭子區,甘蔗里,604,1143,578,104,682,24,706
公投第７案,臺中市,潭子區,東寶里,605,2096,899,189,1088,34,1122
公投第７案,臺中市,潭子區,東寶里,606,1549,693,183,876,60,936
公投第７案,臺中市,潭子區,東寶里,607,1573,704,154,858,33,891
公投第７案,臺中市,潭子區,東寶里,608,1585,687,131,818,29,847
公投第７案,臺中市,潭子區,東寶里,609,1572,697,148,845,38,883
公投第７案,臺中市,潭子區,東寶里,610,1738,827,156,983,46,1029
公投第７案,臺中市,潭子區,東寶里,611,1883,809,163,972,68,1040
公投第７案,臺中市,潭子區,大富里,612,1401,614,160,774,26,800
公投第７案,臺中市,潭子區,大富里,613,1352,655,144,799,43,842
公投第７案,臺中市,潭子區,大豐里,614,2085,979,195,1174,67,1241
公投第７案,臺中市,潭子區,大豐里,615,2047,957,215,1172,69,1241
公投第７案,臺中市,潭子區,大豐里,616,1673,662,195,857,17,874
公投第７案,臺中市,潭子區,栗林里,617,1874,850,190,1040,77,1117
公投第７案,臺中市,潭子區,栗林里,618,1051,454,134,588,47,635
公投第７案,臺中市,潭子區,栗林里,619,1674,655,180,835,49,884
公投第７案,臺中市,潭子區,嘉仁里,620,1831,839,179,1018,61,1079
公投第７案,臺中市,潭子區,嘉仁里,621,2003,823,203,1026,58,1084
公投第７案,臺中市,潭子區,新田里,622,1535,674,152,826,36,862
公投第７案,臺中市,潭子區,聚興里,623,2286,881,199,1080,91,1171
公投第７案,臺中市,潭子區,聚興里,624,1861,745,189,934,63,997
公投第７案,臺中市,西屯區,西安里,625,1638,761,201,962,50,1012
公投第７案,臺中市,西屯區,西安里,626,1335,570,136,706,27,733
公投第７案,臺中市,西屯區,西安里,627,1776,833,172,1005,50,1055
公投第７案,臺中市,西屯區,至善里,628,1351,601,156,757,17,774
公投第７案,臺中市,西屯區,至善里,629,1338,603,175,778,41,819
公投第７案,臺中市,西屯區,至善里,630,1582,696,161,857,32,889
公投第７案,臺中市,西屯區,西平里,631,1710,730,137,867,25,892
公投第７案,臺中市,西屯區,西平里,632,1595,632,176,808,46,854
公投第７案,臺中市,西屯區,西平里,633,1585,772,117,889,50,939
公投第７案,臺中市,西屯區,西墩里,634,1749,705,216,921,58,979
公投第７案,臺中市,西屯區,西墩里,635,1877,875,163,1038,48,1086
公投第７案,臺中市,西屯區,西墩里,636,1697,718,179,897,29,926
公投第７案,臺中市,西屯區,潮洋里,637,1480,700,158,858,44,902
公投第７案,臺中市,西屯區,潮洋里,638,1483,740,185,925,48,973
公投第７案,臺中市,西屯區,潮洋里,639,2484,683,173,856,40,896
公投第７案,臺中市,西屯區,龍潭里,640,781,378,99,477,46,523
公投第７案,臺中市,西屯區,惠來里,641,1477,678,154,832,57,889
公投第７案,臺中市,西屯區,惠來里,642,1784,809,156,965,36,1001
公投第７案,臺中市,西屯區,惠來里,643,1686,801,143,944,22,966
公投第７案,臺中市,西屯區,惠來里,644,1692,760,171,931,31,962
公投第７案,臺中市,西屯區,惠來里,645,1659,745,129,874,21,895
公投第７案,臺中市,西屯區,惠來里,646,1648,780,137,917,32,949
公投第７案,臺中市,西屯區,惠來里,647,1536,747,165,912,28,940
公投第７案,臺中市,西屯區,惠來里,648,1666,784,174,958,41,999
公投第７案,臺中市,西屯區,上石里,649,1428,661,146,807,45,852
公投第７案,臺中市,西屯區,上石里,650,1810,797,153,950,37,987
公投第７案,臺中市,西屯區,上石里,651,1574,741,123,864,33,897
公投第７案,臺中市,西屯區,上安里,652,1650,746,167,913,22,935
公投第７案,臺中市,西屯區,上安里,653,1681,750,162,912,59,971
公投第７案,臺中市,西屯區,上安里,654,1656,711,176,887,47,934
公投第７案,臺中市,西屯區,上德里,655,1243,591,119,710,51,761
公投第７案,臺中市,西屯區,上德里,656,1471,721,161,882,54,936
公投第７案,臺中市,西屯區,上德里,657,1431,734,138,872,29,901
公投第７案,臺中市,西屯區,逢甲里,658,1714,758,189,947,30,977
公投第７案,臺中市,西屯區,逢甲里,659,1424,645,145,790,52,842
公投第７案,臺中市,西屯區,逢甲里,660,1176,542,122,664,34,698
公投第７案,臺中市,西屯區,逢福里,661,1456,672,151,823,60,883
公投第７案,臺中市,西屯區,逢福里,662,1451,745,143,888,45,933
公投第７案,臺中市,西屯區,逢福里,663,1063,574,100,674,24,698
公投第７案,臺中市,西屯區,逢福里,664,1357,619,134,753,42,795
公投第７案,臺中市,西屯區,鵬程里,665,1355,704,97,801,51,852
公投第７案,臺中市,西屯區,鵬程里,666,1384,711,120,831,19,850
公投第７案,臺中市,西屯區,何厝里,667,1613,746,174,920,46,966
公投第７案,臺中市,西屯區,何厝里,668,1562,681,180,861,49,910
公投第７案,臺中市,西屯區,何明里,669,1219,563,172,735,59,794
公投第７案,臺中市,西屯區,何明里,670,1235,521,156,677,40,717
公投第７案,臺中市,西屯區,何明里,671,1131,494,139,633,50,683
公投第７案,臺中市,西屯區,何南里,672,1494,718,167,885,47,932
公投第７案,臺中市,西屯區,何南里,673,1325,623,130,753,17,770
公投第７案,臺中市,西屯區,何南里,674,1386,647,157,804,22,826
公投第７案,臺中市,西屯區,何成里,675,1816,792,218,1010,63,1073
公投第７案,臺中市,西屯區,何成里,676,1734,738,154,892,42,934
公投第７案,臺中市,西屯區,何成里,677,1777,825,188,1013,53,1066
公投第７案,臺中市,西屯區,何成里,678,1818,760,188,948,56,1004
公投第７案,臺中市,西屯區,何安里,679,1699,734,156,890,74,964
公投第７案,臺中市,西屯區,何安里,680,1715,680,162,842,43,885
公投第７案,臺中市,西屯區,何安里,681,1654,712,139,851,41,892
公投第７案,臺中市,西屯區,何仁里,682,1636,702,160,862,23,885
公投第７案,臺中市,西屯區,何仁里,683,1298,550,149,699,22,721
公投第７案,臺中市,西屯區,何仁里,684,1391,636,162,798,41,839
公投第７案,臺中市,西屯區,何仁里,685,1853,858,188,1046,47,1093
公投第７案,臺中市,西屯區,何德里,686,1820,787,164,951,56,1007
公投第７案,臺中市,西屯區,何德里,687,1809,823,175,998,43,1041
公投第７案,臺中市,西屯區,何福里,688,1352,659,139,798,44,842
公投第７案,臺中市,西屯區,何福里,689,1521,663,158,821,58,879
公投第７案,臺中市,西屯區,何福里,690,1486,685,172,857,46,903
公投第７案,臺中市,西屯區,何源里,691,1674,750,191,941,42,983
公投第７案,臺中市,西屯區,何源里,692,1610,761,193,954,54,1008
公投第７案,臺中市,西屯區,何源里,693,1695,771,169,940,42,982
公投第７案,臺中市,西屯區,何源里,694,1684,737,155,892,53,945
公投第７案,臺中市,西屯區,大河里,695,1221,575,144,719,24,743
公投第７案,臺中市,西屯區,大河里,696,1252,656,150,806,43,849
公投第７案,臺中市,西屯區,大河里,697,1301,611,148,759,49,808
公投第７案,臺中市,西屯區,大石里,698,1049,564,71,635,31,666
公投第７案,臺中市,西屯區,大石里,699,1113,548,84,632,43,675
公投第７案,臺中市,西屯區,大福里,700,1557,680,119,799,48,847
公投第７案,臺中市,西屯區,大福里,701,1640,702,164,866,42,908
公投第７案,臺中市,西屯區,大鵬里,702,1402,690,177,867,66,933
公投第７案,臺中市,西屯區,大鵬里,703,1717,686,151,837,69,906
公投第７案,臺中市,西屯區,大鵬里,704,1688,755,152,907,58,965
公投第７案,臺中市,西屯區,港尾里,705,1168,525,135,660,59,719
公投第７案,臺中市,西屯區,港尾里,706,1729,750,148,898,44,942
公投第７案,臺中市,西屯區,港尾里,707,2007,834,183,1017,42,1059
公投第７案,臺中市,西屯區,廣福里,708,1296,587,136,723,74,797
公投第７案,臺中市,西屯區,廣福里,709,1068,417,102,519,17,536
公投第７案,臺中市,西屯區,林厝里,710,1707,715,131,846,61,907
公投第７案,臺中市,西屯區,林厝里,711,1636,761,160,921,43,964
公投第７案,臺中市,西屯區,永安里,712,1761,662,144,806,39,845
公投第７案,臺中市,西屯區,永安里,713,1314,590,135,725,40,765
公投第７案,臺中市,西屯區,永安里,714,1233,615,135,750,36,786
公投第７案,臺中市,西屯區,永安里,715,1549,655,148,803,48,851
公投第７案,臺中市,西屯區,永安里,716,1639,726,122,848,29,877
公投第７案,臺中市,西屯區,永安里,717,1486,632,136,768,45,813
公投第７案,臺中市,西屯區,永安里,718,1806,803,168,971,18,989
公投第７案,臺中市,西屯區,永安里,719,1451,636,134,770,22,792
公投第７案,臺中市,西屯區,福安里,720,1302,626,110,736,30,766
公投第７案,臺中市,西屯區,福安里,721,1353,644,156,800,42,842
公投第７案,臺中市,西屯區,福雅里,722,2162,1001,203,1204,51,1255
公投第７案,臺中市,西屯區,福雅里,723,1520,668,143,811,54,865
公投第７案,臺中市,西屯區,福雅里,724,1935,862,151,1013,30,1043
公投第７案,臺中市,西屯區,福林里,725,1847,809,190,999,46,1045
公投第７案,臺中市,西屯區,福林里,726,1738,795,187,982,27,1009
公投第７案,臺中市,西屯區,福林里,727,1640,791,171,962,43,1005
公投第７案,臺中市,西屯區,福林里,728,1908,841,221,1062,35,1097
公投第７案,臺中市,西屯區,福瑞里,729,1402,649,136,785,27,812
公投第７案,臺中市,西屯區,福瑞里,730,1515,626,154,780,25,805
公投第７案,臺中市,西屯區,福聯里,731,1541,612,120,732,42,774
公投第７案,臺中市,西屯區,福聯里,732,1502,652,146,798,38,836
公投第７案,臺中市,西屯區,福和里,733,1526,676,186,862,45,907
公投第７案,臺中市,西屯區,福和里,734,1425,668,137,805,59,864
公投第７案,臺中市,西屯區,福和里,735,1334,646,150,796,37,833
公投第７案,臺中市,西屯區,福中里,736,1649,780,184,964,26,990
公投第７案,臺中市,西屯區,福中里,737,1566,668,152,820,27,847
公投第７案,臺中市,西屯區,福恩里,738,1629,794,161,955,38,993
公投第７案,臺中市,西屯區,福恩里,739,1628,722,204,926,32,958
公投第７案,臺中市,西屯區,福恩里,740,1442,719,136,855,32,887
公投第７案,臺中市,西屯區,協和里,741,1206,506,121,627,44,671
公投第７案,臺中市,西屯區,協和里,742,1086,489,147,636,45,681
公投第７案,臺中市,西屯區,協和里,743,1088,533,119,652,29,681
公投第７案,臺中市,西屯區,協和里,744,1140,534,116,650,28,678
公投第７案,臺中市,南屯區,南屯里,745,1321,586,165,751,56,807
公投第７案,臺中市,南屯區,南屯里,746,1346,620,170,790,55,845
公投第７案,臺中市,南屯區,南屯里,747,1428,634,177,811,47,858
公投第７案,臺中市,南屯區,南屯里,748,1442,663,136,799,37,836
公投第７案,臺中市,南屯區,南屯里,749,1408,746,138,884,22,906
公投第７案,臺中市,南屯區,南屯里,750,1404,705,129,834,25,859
公投第７案,臺中市,南屯區,豐樂里,751,1354,676,134,810,51,861
公投第７案,臺中市,南屯區,豐樂里,752,1332,620,170,790,46,836
公投第７案,臺中市,南屯區,豐樂里,753,1463,725,165,890,36,926
公投第７案,臺中市,南屯區,豐樂里,754,1413,654,156,810,46,856
公投第７案,臺中市,南屯區,豐樂里,755,1218,606,129,735,39,774
公投第７案,臺中市,南屯區,豐樂里,756,1308,598,140,738,25,763
公投第７案,臺中市,南屯區,豐樂里,757,1527,745,174,919,42,961
公投第７案,臺中市,南屯區,豐樂里,758,1294,613,157,770,31,801
公投第７案,臺中市,南屯區,楓樹里,759,1516,616,155,771,44,815
公投第７案,臺中市,南屯區,楓樹里,760,1529,711,157,868,78,946
公投第７案,臺中市,南屯區,楓樹里,761,1397,630,168,798,60,858
公投第７案,臺中市,南屯區,楓樹里,762,1406,619,140,759,30,789
公投第７案,臺中市,南屯區,中和里,763,1497,627,149,776,49,825
公投第７案,臺中市,南屯區,中和里,764,1424,606,142,748,69,817
公投第７案,臺中市,南屯區,中和里,765,1488,561,134,695,33,728
公投第７案,臺中市,南屯區,鎮平里,766,608,293,78,371,37,408
公投第７案,臺中市,南屯區,鎮平里,767,813,365,111,476,52,528
公投第７案,臺中市,南屯區,春社里,768,1190,444,137,581,55,636
公投第７案,臺中市,南屯區,春社里,769,1174,527,108,635,29,664
公投第７案,臺中市,南屯區,春社里,770,1224,586,115,701,23,724
公投第７案,臺中市,南屯區,春社里,771,1466,550,114,664,36,700
公投第７案,臺中市,南屯區,春社里,772,1333,457,95,552,21,573
公投第７案,臺中市,南屯區,春安里,773,814,379,90,469,51,520
公投第７案,臺中市,南屯區,文山里,774,1436,586,144,730,55,785
公投第７案,臺中市,南屯區,文山里,775,1515,692,163,855,52,907
公投第７案,臺中市,南屯區,文山里,776,1545,649,118,767,37,804
公投第７案,臺中市,南屯區,文山里,777,1383,646,133,779,35,814
公投第７案,臺中市,南屯區,文山里,778,1433,697,123,820,37,857
公投第７案,臺中市,南屯區,文山里,779,1134,468,123,591,34,625
公投第７案,臺中市,南屯區,文山里,780,1216,634,94,728,34,762
公投第７案,臺中市,南屯區,寶山里,781,1271,542,129,671,64,735
公投第７案,臺中市,南屯區,寶山里,782,1203,521,116,637,28,665
公投第７案,臺中市,南屯區,寶山里,783,1268,577,142,719,23,742
公投第７案,臺中市,南屯區,寶山里,784,1390,628,154,782,52,834
公投第７案,臺中市,南屯區,新生里,785,1397,629,150,779,38,817
公投第７案,臺中市,南屯區,永定里,786,1607,672,188,860,62,922
公投第７案,臺中市,南屯區,永定里,787,1582,750,158,908,34,942
公投第７案,臺中市,南屯區,永定里,788,1611,760,165,925,42,967
公投第７案,臺中市,南屯區,三厝里,789,1322,622,184,806,36,842
公投第７案,臺中市,南屯區,三厝里,790,1321,684,143,827,32,859
公投第７案,臺中市,南屯區,三厝里,791,1360,650,120,770,41,811
公投第７案,臺中市,南屯區,三厝里,792,1361,665,136,801,13,814
公投第７案,臺中市,南屯區,三厝里,793,1257,616,143,759,33,792
公投第７案,臺中市,南屯區,三義里,794,1207,623,133,756,26,782
公投第７案,臺中市,南屯區,三義里,795,1282,667,126,793,23,816
公投第７案,臺中市,南屯區,三義里,796,1248,654,137,791,27,818
公投第７案,臺中市,南屯區,三義里,797,1304,675,140,815,37,852
公投第７案,臺中市,南屯區,三義里,798,1214,590,121,711,33,744
公投第７案,臺中市,南屯區,三和里,799,1102,555,114,669,39,708
公投第７案,臺中市,南屯區,三和里,800,1630,850,169,1019,32,1051
公投第７案,臺中市,南屯區,三和里,801,1333,677,124,801,32,833
公投第７案,臺中市,南屯區,三和里,802,1292,651,144,795,29,824
公投第７案,臺中市,南屯區,三和里,803,1272,617,129,746,37,783
公投第７案,臺中市,南屯區,三和里,804,1345,670,110,780,39,819
公投第７案,臺中市,南屯區,黎明里,805,981,524,135,659,28,687
公投第７案,臺中市,南屯區,黎明里,806,1097,530,130,660,44,704
公投第７案,臺中市,南屯區,黎明里,807,991,510,114,624,25,649
公投第７案,臺中市,南屯區,黎明里,808,1170,552,131,683,27,710
公投第７案,臺中市,南屯區,溝墘里,809,1171,585,125,710,41,751
公投第７案,臺中市,南屯區,溝墘里,810,1349,587,162,749,57,806
公投第７案,臺中市,南屯區,溝墘里,811,1368,685,155,840,34,874
公投第７案,臺中市,南屯區,溝墘里,812,1263,635,150,785,33,818
公投第７案,臺中市,南屯區,大業里,813,1547,746,183,929,39,968
公投第７案,臺中市,南屯區,大業里,814,1649,772,175,947,42,989
公投第７案,臺中市,南屯區,大業里,815,1629,720,165,885,33,918
公投第７案,臺中市,南屯區,大業里,816,1580,642,176,818,41,859
公投第７案,臺中市,南屯區,惠中里,817,1444,752,169,921,26,947
公投第７案,臺中市,南屯區,惠中里,818,1413,659,143,802,23,825
公投第７案,臺中市,南屯區,惠中里,819,1377,649,127,776,29,805
公投第７案,臺中市,南屯區,惠中里,820,1527,682,206,888,45,933
公投第７案,臺中市,南屯區,惠中里,821,1335,659,145,804,33,837
公投第７案,臺中市,南屯區,田心里,822,1544,831,172,1003,31,1034
公投第７案,臺中市,南屯區,田心里,823,1482,715,215,930,43,973
公投第７案,臺中市,南屯區,田心里,824,1488,689,182,871,57,928
公投第７案,臺中市,南屯區,田心里,825,1538,608,174,782,33,815
公投第７案,臺中市,南屯區,向心里,826,1674,803,185,988,69,1057
公投第７案,臺中市,南屯區,向心里,827,1996,655,166,821,42,863
公投第７案,臺中市,南屯區,向心里,828,1514,721,145,866,55,921
公投第７案,臺中市,南屯區,文心里,829,1217,607,130,737,46,783
公投第７案,臺中市,南屯區,文心里,830,1347,604,143,747,55,802
公投第７案,臺中市,南屯區,文心里,831,1109,521,125,646,34,680
公投第７案,臺中市,南屯區,同心里,832,1546,703,143,846,51,897
公投第７案,臺中市,南屯區,同心里,833,1408,689,176,865,40,905
公投第７案,臺中市,南屯區,同心里,834,1057,466,102,568,18,586
公投第７案,臺中市,南屯區,同心里,835,1133,518,128,646,47,693
公投第７案,臺中市,南屯區,大同里,836,1278,618,129,747,26,773
公投第７案,臺中市,南屯區,大同里,837,1144,582,138,720,34,754
公投第７案,臺中市,南屯區,大同里,838,1140,508,153,661,37,698
公投第７案,臺中市,南屯區,大同里,839,1171,575,135,710,31,741
公投第７案,臺中市,南屯區,大興里,840,1303,645,156,801,37,838
公投第７案,臺中市,南屯區,大興里,841,1402,588,145,733,40,773
公投第７案,臺中市,南屯區,大興里,842,1571,706,164,870,41,911
公投第７案,臺中市,南屯區,大誠里,843,1139,542,150,692,40,732
公投第７案,臺中市,南屯區,大誠里,844,1216,607,133,740,40,780
公投第７案,臺中市,南屯區,大誠里,845,1162,583,118,701,38,739
公投第７案,臺中市,北屯區,北屯里,846,1670,788,178,966,60,1026
公投第７案,臺中市,北屯區,北屯里,847,1706,715,155,870,61,931
公投第７案,臺中市,北屯區,北京里,848,1507,646,169,815,69,884
公投第７案,臺中市,北屯區,北京里,849,1652,735,200,935,47,982
公投第７案,臺中市,北屯區,北興里,850,1107,458,91,549,25,574
公投第７案,臺中市,北屯區,北興里,851,2151,881,197,1078,78,1156
公投第７案,臺中市,北屯區,三光里,852,1612,780,148,928,25,953
公投第７案,臺中市,北屯區,三光里,853,1743,774,161,935,44,979
公投第７案,臺中市,北屯區,三光里,854,2099,863,198,1061,42,1103
公投第７案,臺中市,北屯區,三光里,855,1595,753,139,892,0,892
公投第７案,臺中市,北屯區,三和里,856,1923,791,168,959,55,1014
公投第７案,臺中市,北屯區,三和里,857,1641,713,146,859,54,913
公投第７案,臺中市,北屯區,三和里,858,1157,582,124,706,25,731
公投第７案,臺中市,北屯區,三和里,859,1041,538,89,627,37,664
公投第７案,臺中市,北屯區,東光里,860,1563,640,163,803,46,849
公投第７案,臺中市,北屯區,東光里,861,1559,640,140,780,60,840
公投第７案,臺中市,北屯區,東光里,862,1411,587,97,684,17,701
公投第７案,臺中市,北屯區,水景里,863,1761,829,175,1004,34,1038
公投第７案,臺中市,北屯區,水景里,864,1361,646,159,805,50,855
公投第７案,臺中市,北屯區,水景里,865,1852,802,194,996,60,1056
公投第７案,臺中市,北屯區,水景里,866,1928,888,180,1068,39,1107
公投第７案,臺中市,北屯區,水景里,867,1492,749,179,928,29,957
公投第７案,臺中市,北屯區,水景里,868,1998,860,182,1042,56,1098
公投第７案,臺中市,北屯區,水景里,869,1272,622,165,787,38,825
公投第７案,臺中市,北屯區,水景里,870,1317,633,139,772,40,812
公投第７案,臺中市,北屯區,軍功里,871,1327,515,140,655,64,719
公投第７案,臺中市,北屯區,軍功里,872,1280,519,131,650,26,676
公投第７案,臺中市,北屯區,軍功里,873,1865,762,164,926,54,980
公投第７案,臺中市,北屯區,軍功里,874,1230,613,119,732,51,783
公投第７案,臺中市,北屯區,軍功里,875,1356,571,113,684,43,727
公投第７案,臺中市,北屯區,軍功里,876,1732,791,147,938,53,991
公投第７案,臺中市,北屯區,軍功里,877,1586,760,147,907,37,944
公投第７案,臺中市,北屯區,軍功里,878,1441,647,130,777,35,812
公投第７案,臺中市,北屯區,和平里,879,2045,865,193,1058,54,1112
公投第７案,臺中市,北屯區,和平里,880,1914,741,198,939,68,1007
公投第７案,臺中市,北屯區,和平里,881,1918,859,170,1029,58,1087
公投第７案,臺中市,北屯區,和平里,882,2079,906,145,1051,33,1084
公投第７案,臺中市,北屯區,和平里,883,2040,902,208,1110,63,1173
公投第７案,臺中市,北屯區,廍子里,884,2027,812,145,957,52,1009
公投第７案,臺中市,北屯區,廍子里,885,1402,614,130,744,45,789
公投第７案,臺中市,北屯區,廍子里,886,1826,842,176,1018,45,1063
公投第７案,臺中市,北屯區,廍子里,887,2162,902,158,1060,26,1086
公投第７案,臺中市,北屯區,廍子里,888,2332,886,204,1090,22,1112
公投第７案,臺中市,北屯區,民政里,889,985,450,93,543,37,580
公投第７案,臺中市,北屯區,東山里,890,2037,675,220,895,28,923
公投第７案,臺中市,北屯區,大坑里,891,1032,489,101,590,42,632
公投第７案,臺中市,北屯區,大坑里,892,1062,499,95,594,30,624
公投第７案,臺中市,北屯區,民德里,893,909,381,91,472,49,521
公投第７案,臺中市,北屯區,舊社里,894,1445,702,127,829,43,872
公投第７案,臺中市,北屯區,舊社里,895,1842,769,173,942,39,981
公投第７案,臺中市,北屯區,舊社里,896,1187,572,117,689,28,717
公投第７案,臺中市,北屯區,舊社里,897,1456,655,153,808,30,838
公投第７案,臺中市,北屯區,松茂里,898,1866,809,198,1007,65,1072
公投第７案,臺中市,北屯區,松茂里,899,1667,702,148,850,47,897
公投第７案,臺中市,北屯區,松茂里,900,1683,768,164,932,21,953
公投第７案,臺中市,北屯區,松強里,901,1642,713,166,879,22,901
公投第７案,臺中市,北屯區,松強里,902,1475,681,144,825,17,842
公投第７案,臺中市,北屯區,松強里,903,1644,739,116,855,29,884
公投第７案,臺中市,北屯區,松強里,904,1603,791,137,928,25,953
公投第７案,臺中市,北屯區,松勇里,905,1949,899,200,1099,58,1157
公投第７案,臺中市,北屯區,松勇里,906,1790,896,186,1082,37,1119
公投第７案,臺中市,北屯區,松勇里,907,1440,667,147,814,36,850
公投第７案,臺中市,北屯區,松安里,908,1601,742,187,929,44,973
公投第７案,臺中市,北屯區,松安里,909,1527,643,162,805,53,858
公投第７案,臺中市,北屯區,松安里,910,1675,668,176,844,47,891
公投第７案,臺中市,北屯區,松和里,911,1579,611,138,749,41,790
公投第７案,臺中市,北屯區,松和里,912,1524,681,128,809,75,884
公投第７案,臺中市,北屯區,松和里,913,1677,713,148,861,55,916
公投第７案,臺中市,北屯區,松和里,914,1599,707,149,856,49,905
公投第７案,臺中市,北屯區,松竹里,915,1458,661,170,831,55,886
公投第７案,臺中市,北屯區,松竹里,916,1571,741,155,896,50,946
公投第７案,臺中市,北屯區,松竹里,917,1579,691,184,875,62,937
公投第７案,臺中市,北屯區,松竹里,918,1849,828,208,1036,50,1086
公投第７案,臺中市,北屯區,松竹里,919,1682,753,169,922,42,964
公投第７案,臺中市,北屯區,平興里,920,1760,788,148,936,31,967
公投第７案,臺中市,北屯區,平興里,921,1699,758,168,926,64,990
公投第７案,臺中市,北屯區,平興里,922,1626,780,174,954,48,1002
公投第７案,臺中市,北屯區,平興里,923,1491,675,206,881,10,891
公投第７案,臺中市,北屯區,平田里,924,1640,679,179,858,31,889
公投第７案,臺中市,北屯區,平田里,925,2052,885,195,1080,55,1135
公投第７案,臺中市,北屯區,平田里,926,1875,836,192,1028,44,1072
公投第７案,臺中市,北屯區,平昌里,927,1559,687,151,838,21,859
公投第７案,臺中市,北屯區,平昌里,928,1480,659,155,814,69,883
公投第７案,臺中市,北屯區,平昌里,929,1397,617,172,789,52,841
公投第７案,臺中市,北屯區,平安里,930,1889,850,206,1056,41,1097
公投第７案,臺中市,北屯區,平安里,931,1728,709,205,914,57,971
公投第７案,臺中市,北屯區,平安里,932,1592,666,162,828,63,891
公投第７案,臺中市,北屯區,平順里,933,1656,706,146,852,67,919
公投第７案,臺中市,北屯區,平順里,934,1524,631,138,769,55,824
公投第７案,臺中市,北屯區,平心里,935,1502,664,175,839,42,881
公投第７案,臺中市,北屯區,平心里,936,1772,780,175,955,35,990
公投第７案,臺中市,北屯區,平心里,937,1461,701,89,790,36,826
公投第７案,臺中市,北屯區,平福里,938,1769,732,141,873,22,895
公投第７案,臺中市,北屯區,平福里,939,1894,840,220,1060,68,1128
公投第７案,臺中市,北屯區,平德里,940,2033,796,213,1009,58,1067
公投第７案,臺中市,北屯區,平德里,941,1947,824,200,1024,40,1064
公投第７案,臺中市,北屯區,平德里,942,2188,926,269,1195,60,1255
公投第７案,臺中市,北屯區,平和里,943,1661,785,178,963,37,1000
公投第７案,臺中市,北屯區,平和里,944,1667,762,166,928,46,974
公投第７案,臺中市,北屯區,平和里,945,1728,760,161,921,39,960
公投第７案,臺中市,北屯區,平陽里,946,1688,726,145,871,38,909
公投第７案,臺中市,北屯區,平陽里,947,1475,686,142,828,24,852
公投第７案,臺中市,北屯區,平陽里,948,1681,823,180,1003,32,1035
公投第７案,臺中市,北屯區,仁和里,949,2078,970,198,1168,46,1214
公投第７案,臺中市,北屯區,仁和里,950,2059,910,206,1116,45,1161
公投第７案,臺中市,北屯區,仁和里,951,1792,829,176,1005,38,1043
公投第７案,臺中市,北屯區,仁和里,952,2974,819,193,1012,32,1044
公投第７案,臺中市,北屯區,仁愛里,953,1072,466,115,581,46,627
公投第７案,臺中市,北屯區,仁美里,954,2099,835,418,1253,51,1304
公投第７案,臺中市,北屯區,仁美里,955,1823,901,220,1121,44,1165
公投第７案,臺中市,北屯區,仁美里,956,2022,973,193,1166,69,1235
公投第７案,臺中市,北屯區,仁美里,957,1992,904,194,1098,31,1129
公投第７案,臺中市,北屯區,四民里,958,1585,742,181,923,56,979
公投第７案,臺中市,北屯區,同榮里,959,1565,737,178,915,46,961
公投第７案,臺中市,北屯區,同榮里,960,1780,709,141,850,45,895
公投第７案,臺中市,北屯區,同榮里,961,1874,894,208,1102,51,1153
公投第７案,臺中市,北屯區,后庄里,962,1755,858,149,1007,42,1049
公投第７案,臺中市,北屯區,后庄里,963,1497,810,159,969,37,1006
公投第７案,臺中市,北屯區,后庄里,964,1567,772,162,934,52,986
公投第７案,臺中市,北屯區,后庄里,965,1624,737,126,863,42,905
公投第７案,臺中市,北屯區,后庄里,966,1614,773,169,942,43,985
公投第７案,臺中市,北屯區,后庄里,967,1595,747,143,890,22,912
公投第７案,臺中市,北屯區,新平里,968,1782,764,121,885,64,949
公投第７案,臺中市,北屯區,新平里,969,1357,550,113,663,24,687
公投第７案,臺中市,北屯區,新平里,970,1071,469,96,565,58,623
公投第７案,臺中市,北屯區,陳平里,971,1372,591,127,718,42,760
公投第７案,臺中市,北屯區,陳平里,972,1415,655,139,794,54,848
公投第７案,臺中市,北屯區,陳平里,973,1789,858,184,1042,62,1104
公投第７案,臺中市,北屯區,忠平里,974,1907,933,188,1121,72,1193
公投第７案,臺中市,北屯區,忠平里,975,2008,947,186,1133,53,1186
公投第７案,臺中市,北屯區,大德里,976,1541,689,142,831,47,878
公投第７案,臺中市,北屯區,大德里,977,1669,769,172,941,54,995
公投第７案,臺中市,北屯區,大德里,978,1685,775,156,931,25,956
公投第７案,臺中市,北屯區,水湳里,979,1785,805,202,1007,54,1061
公投第７案,臺中市,北屯區,水湳里,980,1596,751,173,924,55,979
公投第７案,臺中市,北屯區,水湳里,981,1731,803,189,992,54,1046
公投第７案,臺中市,北屯區,水湳里,982,1496,641,151,792,59,851
公投第７案,臺中市,北區,中正里,983,1437,571,158,729,27,756
公投第７案,臺中市,北區,六合里,984,1708,647,218,865,65,930
公投第７案,臺中市,北區,光大里,985,1051,419,91,510,32,542
公投第７案,臺中市,北區,光大里,986,996,448,107,555,30,585
公投第７案,臺中市,北區,文莊里,987,1504,724,119,843,20,863
公投第７案,臺中市,北區,文莊里,988,975,441,111,552,53,605
公投第７案,臺中市,北區,文莊里,989,886,401,98,499,24,523
公投第７案,臺中市,北區,大湖里,990,1276,423,106,529,41,570
公投第７案,臺中市,北區,大湖里,991,938,358,96,454,30,484
公投第７案,臺中市,北區,五常里,992,1404,577,129,706,64,770
公投第７案,臺中市,北區,錦平里,993,996,430,109,539,20,559
公投第７案,臺中市,北區,錦平里,994,869,337,111,448,44,492
公投第７案,臺中市,北區,新北里,995,704,323,88,411,17,428
公投第７案,臺中市,北區,新北里,996,979,447,78,525,20,545
公投第７案,臺中市,北區,新興里,997,773,325,66,391,13,404
公投第７案,臺中市,北區,新興里,998,759,369,63,432,18,450
公投第７案,臺中市,北區,樂英里,999,1438,697,110,807,37,844
公投第７案,臺中市,北區,樂英里,1000,1212,529,84,613,14,627
公投第７案,臺中市,北區,錦村里,1001,1731,756,174,930,41,971
公投第７案,臺中市,北區,錦村里,1002,1445,705,155,860,29,889
公投第７案,臺中市,北區,建成里,1003,1855,791,193,984,39,1023
公投第７案,臺中市,北區,建成里,1004,1728,698,120,818,53,871
公投第７案,臺中市,北區,建成里,1005,1878,745,175,920,45,965
公投第７案,臺中市,北區,建德里,1006,1793,695,179,874,63,937
公投第７案,臺中市,北區,建德里,1007,1555,790,53,843,54,897
公投第７案,臺中市,北區,錦洲里,1008,1761,674,150,824,28,852
公投第７案,臺中市,北區,錦洲里,1009,1579,695,136,831,27,858
公投第７案,臺中市,北區,錦祥里,1010,2192,931,193,1124,65,1189
公投第７案,臺中市,北區,錦祥里,1011,1560,721,160,881,50,931
公投第７案,臺中市,北區,金華里,1012,1476,632,178,810,44,854
公投第７案,臺中市,北區,金華里,1013,1006,485,106,591,31,622
公投第７案,臺中市,北區,金龍里,1014,1403,624,150,774,36,810
公投第７案,臺中市,北區,金龍里,1015,1446,549,151,700,23,723
公投第７案,臺中市,北區,金龍里,1016,1460,611,162,773,42,815
公投第７案,臺中市,北區,邱厝里,1017,1233,546,120,666,21,687
公投第７案,臺中市,北區,邱厝里,1018,1027,531,123,654,20,674
公投第７案,臺中市,北區,建興里,1019,1207,538,131,669,22,691
公投第７案,臺中市,北區,建興里,1020,1167,549,132,681,30,711
公投第７案,臺中市,北區,建興里,1021,1150,493,126,619,23,642
公投第７案,臺中市,北區,建興里,1022,1061,476,121,597,30,627
公投第７案,臺中市,北區,建興里,1023,1005,441,129,570,20,590
公投第７案,臺中市,北區,頂厝里,1024,1250,546,133,679,22,701
公投第７案,臺中市,北區,頂厝里,1025,1448,645,159,804,51,855
公投第７案,臺中市,北區,頂厝里,1026,1379,649,130,779,60,839
公投第７案,臺中市,北區,崇德里,1027,1652,707,192,899,59,958
公投第７案,臺中市,北區,崇德里,1028,1867,795,175,970,40,1010
公投第７案,臺中市,北區,賴厝里,1029,2078,423,103,526,20,546
公投第７案,臺中市,北區,賴厝里,1030,1562,739,154,893,46,939
公投第７案,臺中市,北區,賴厝里,1031,1430,646,126,772,35,807
公投第７案,臺中市,北區,賴福里,1032,2018,885,236,1121,38,1159
公投第７案,臺中市,北區,賴福里,1033,1710,666,156,822,31,853
公投第７案,臺中市,北區,賴興里,1034,1432,629,126,755,33,788
公投第７案,臺中市,北區,賴興里,1035,1157,540,132,672,26,698
公投第７案,臺中市,北區,賴興里,1036,1188,551,109,660,23,683
公投第７案,臺中市,北區,賴旺里,1037,1419,631,143,774,25,799
公投第７案,臺中市,北區,賴旺里,1038,1653,686,160,846,26,872
公投第７案,臺中市,北區,賴旺里,1039,1233,549,144,693,36,729
公投第７案,臺中市,北區,賴明里,1040,1243,669,28,697,16,713
公投第７案,臺中市,北區,賴明里,1041,1219,543,72,615,22,637
公投第７案,臺中市,北區,賴明里,1042,1272,546,161,707,49,756
公投第７案,臺中市,北區,梅川里,1043,1285,582,137,719,20,739
公投第７案,臺中市,北區,梅川里,1044,1780,777,207,984,44,1028
公投第７案,臺中市,北區,賴村里,1045,1461,579,136,715,27,742
公投第７案,臺中市,北區,賴村里,1046,1310,639,134,773,56,829
公投第７案,臺中市,北區,賴村里,1047,1669,708,160,868,29,897
公投第７案,臺中市,北區,育德里,1048,1932,870,189,1059,52,1111
公投第７案,臺中市,北區,育德里,1049,1682,714,185,899,36,935
公投第７案,臺中市,北區,淡溝里,1050,1891,736,219,955,43,998
公投第７案,臺中市,北區,淡溝里,1051,1882,783,210,993,70,1063
公投第７案,臺中市,北區,淡溝里,1052,1159,504,118,622,30,652
公投第７案,臺中市,北區,健行里,1053,1553,643,170,813,50,863
公投第７案,臺中市,北區,健行里,1054,1607,669,162,831,51,882
公投第７案,臺中市,北區,健行里,1055,1773,732,216,948,39,987
公投第７案,臺中市,北區,健行里,1056,1524,655,170,825,52,877
公投第７案,臺中市,北區,明德里,1057,1613,747,196,943,58,1001
公投第７案,臺中市,北區,明德里,1058,1877,885,182,1067,50,1117
公投第７案,臺中市,北區,明德里,1059,1792,793,187,980,52,1032
公投第７案,臺中市,北區,明新里,1060,1392,626,152,778,45,823
公投第７案,臺中市,北區,明新里,1061,1297,565,125,690,34,724
公投第７案,臺中市,北區,長青里,1062,1556,700,202,902,30,932
公投第７案,臺中市,北區,長青里,1063,1497,628,171,799,28,827
公投第７案,臺中市,北區,長青里,1064,1550,677,141,818,45,863
公投第７案,臺中市,北區,長青里,1065,1434,599,159,758,33,791
公投第７案,臺中市,北區,立人里,1066,1793,795,193,988,48,1036
公投第７案,臺中市,北區,立人里,1067,1866,808,195,1003,33,1036
公投第７案,臺中市,北區,中達里,1068,1346,604,128,732,67,799
公投第７案,臺中市,北區,中達里,1069,1267,546,129,675,54,729
公投第７案,臺中市,中區,綠川里,1070,1652,756,191,947,79,1026
公投第７案,臺中市,中區,繼光里,1071,1531,614,199,813,40,853
公投第７案,臺中市,中區,公園里,1072,1431,602,162,764,24,788
公投第７案,臺中市,中區,光復里,1073,1060,469,108,577,36,613
公投第７案,臺中市,中區,光復里,1074,982,411,93,504,45,549
公投第７案,臺中市,中區,大墩里,1075,1191,495,145,640,47,687
公投第７案,臺中市,中區,大墩里,1076,855,363,108,471,24,495
公投第７案,臺中市,中區,柳川里,1077,1135,410,93,503,28,531
公投第７案,臺中市,中區,柳川里,1078,705,334,52,386,13,399
公投第７案,臺中市,中區,大誠里,1079,1009,459,110,569,31,600
公投第７案,臺中市,中區,大誠里,1080,1304,510,139,649,74,723
公投第７案,臺中市,中區,中華里,1081,1841,709,141,850,27,877
公投第７案,臺中市,西區,三民里,1082,1400,397,87,484,28,512
公投第７案,臺中市,西區,三民里,1083,861,413,111,524,19,543
公投第７案,臺中市,西區,利民里,1084,1416,636,167,803,45,848
公投第７案,臺中市,西區,民生里,1085,1020,466,131,597,38,635
公投第７案,臺中市,西區,民生里,1086,778,381,113,494,18,512
公投第７案,臺中市,西區,廣民里,1087,1465,614,145,759,43,802
公投第７案,臺中市,西區,平和里,1088,1017,449,120,569,14,583
公投第７案,臺中市,西區,平和里,1089,868,395,113,508,22,530
公投第７案,臺中市,西區,東昇里,1090,1251,617,149,766,37,803
公投第７案,臺中市,西區,東昇里,1091,1044,506,136,642,41,683
公投第７案,臺中市,西區,公民里,1092,1487,663,167,830,24,854
公投第７案,臺中市,西區,公民里,1093,1573,690,171,861,45,906
公投第７案,臺中市,西區,公民里,1094,1731,793,193,986,61,1047
公投第７案,臺中市,西區,藍興里,1095,1209,559,143,702,19,721
公投第７案,臺中市,西區,藍興里,1096,1564,696,159,855,33,888
公投第７案,臺中市,西區,藍興里,1097,1175,557,140,697,34,731
公投第７案,臺中市,西區,公舘里,1098,1505,670,154,824,18,842
公投第７案,臺中市,西區,公舘里,1099,1418,640,181,821,27,848
公投第７案,臺中市,西區,公舘里,1100,1497,528,131,659,15,674
公投第７案,臺中市,西區,公舘里,1101,1260,536,177,713,41,754
公投第７案,臺中市,西區,安龍里,1102,1399,608,197,805,46,851
公投第７案,臺中市,西區,安龍里,1103,1447,628,165,793,35,828
公投第７案,臺中市,西區,吉龍里,1104,1683,726,203,929,53,982
公投第７案,臺中市,西區,吉龍里,1105,1585,715,192,907,48,955
公投第７案,臺中市,西區,吉龍里,1106,1557,748,147,895,35,930
公投第７案,臺中市,西區,吉龍里,1107,1663,693,162,855,51,906
公投第７案,臺中市,西區,土庫里,1108,1921,826,240,1066,54,1120
公投第７案,臺中市,西區,土庫里,1109,1952,762,213,975,32,1007
公投第７案,臺中市,西區,土庫里,1110,1708,727,186,913,39,952
公投第７案,臺中市,西區,大忠里,1111,1131,584,113,697,17,714
公投第７案,臺中市,西區,大忠里,1112,1916,923,68,991,42,1033
公投第７案,臺中市,西區,大忠里,1113,1275,600,151,751,22,773
公投第７案,臺中市,西區,民龍里,1114,1822,732,172,904,57,961
公投第７案,臺中市,西區,民龍里,1115,1374,613,154,767,40,807
公投第７案,臺中市,西區,和龍里,1116,1129,473,125,598,60,658
公投第７案,臺中市,西區,和龍里,1117,1201,477,157,634,30,664
公投第７案,臺中市,西區,後龍里,1118,1639,683,182,865,61,926
公投第７案,臺中市,西區,後龍里,1119,1863,808,215,1023,66,1089
公投第７案,臺中市,西區,双龍里,1120,1287,636,148,784,40,824
公投第７案,臺中市,西區,双龍里,1121,1504,686,186,872,43,915
公投第７案,臺中市,西區,昇平里,1122,1308,558,149,707,55,762
公投第７案,臺中市,西區,昇平里,1123,1433,649,146,795,52,847
公投第７案,臺中市,西區,昇平里,1124,1450,611,175,786,30,816
公投第７案,臺中市,西區,昇平里,1125,1465,715,168,883,40,923
公投第７案,臺中市,西區,中興里,1126,1818,704,235,939,60,999
公投第７案,臺中市,西區,中興里,1127,1782,729,265,994,52,1046
公投第７案,臺中市,西區,公益里,1128,1428,627,191,818,40,858
公投第７案,臺中市,西區,公益里,1129,1366,547,141,688,40,728
公投第７案,臺中市,西區,公德里,1130,1498,654,156,810,37,847
公投第７案,臺中市,西區,公德里,1131,1350,652,129,781,34,815
公投第７案,臺中市,西區,公德里,1132,1339,647,132,779,27,806
公投第７案,臺中市,西區,公正里,1133,1613,768,159,927,40,967
公投第７案,臺中市,西區,公正里,1134,1454,648,158,806,44,850
公投第７案,臺中市,西區,公正里,1135,1597,731,190,921,36,957
公投第７案,臺中市,西區,公正里,1136,1411,683,174,857,36,893
公投第７案,臺中市,西區,公平里,1137,1493,658,171,829,60,889
公投第７案,臺中市,西區,公平里,1138,1600,769,161,930,48,978
公投第７案,臺中市,西區,公平里,1139,1710,715,200,915,51,966
公投第７案,臺中市,西區,忠明里,1140,1139,514,136,650,26,676
公投第７案,臺中市,西區,忠明里,1141,1105,522,128,650,32,682
公投第７案,臺中市,西區,忠明里,1142,1498,649,172,821,43,864
公投第７案,臺中市,西區,忠明里,1143,1921,705,203,908,35,943
公投第７案,臺中市,西區,忠誠里,1144,1340,569,161,730,50,780
公投第７案,臺中市,西區,忠誠里,1145,1536,711,197,908,19,927
公投第７案,臺中市,西區,忠誠里,1146,1361,563,176,739,66,805
公投第７案,臺中市,西區,忠誠里,1147,1430,703,159,862,30,892
公投第７案,臺中市,東區,新庄里,1148,1138,330,89,419,19,438
公投第７案,臺中市,東區,新庄里,1149,984,432,109,541,21,562
公投第７案,臺中市,東區,新庄里,1150,877,398,93,491,29,520
公投第７案,臺中市,東區,振興里,1151,1070,485,157,642,41,683
公投第７案,臺中市,東區,振興里,1152,1106,490,144,634,45,679
公投第７案,臺中市,東區,振興里,1153,953,411,123,534,43,577
公投第７案,臺中市,東區,東橋里,1154,1195,547,131,678,18,696
公投第７案,臺中市,東區,東橋里,1155,1251,549,123,672,33,705
公投第７案,臺中市,東區,東橋里,1156,1190,454,167,621,44,665
公投第７案,臺中市,東區,東興里,1157,1394,574,165,739,49,788
公投第７案,臺中市,東區,東興里,1158,1443,625,204,829,51,880
公投第７案,臺中市,東區,泉源里,1159,762,313,86,399,36,435
公投第７案,臺中市,東區,泉源里,1160,1140,537,138,675,47,722
公投第７案,臺中市,東區,干城里,1161,1211,594,102,696,62,758
公投第７案,臺中市,東區,干城里,1162,755,397,66,463,21,484
公投第７案,臺中市,東區,旱溪里,1163,1491,609,171,780,57,837
公投第７案,臺中市,東區,旱溪里,1164,1000,392,114,506,29,535
公投第７案,臺中市,東區,樂成里,1165,1114,492,142,634,43,677
公投第７案,臺中市,東區,樂成里,1166,1101,465,120,585,35,620
公投第７案,臺中市,東區,東門里,1167,1169,556,143,699,57,756
公投第７案,臺中市,東區,東門里,1168,1283,606,133,739,66,805
公投第７案,臺中市,東區,東門里,1169,1168,560,146,706,32,738
公投第７案,臺中市,東區,東門里,1170,1386,548,165,713,32,745
公投第７案,臺中市,東區,東門里,1171,1557,688,185,873,51,924
公投第７案,臺中市,東區,十甲里,1172,1380,577,179,756,60,816
公投第７案,臺中市,東區,十甲里,1173,1674,754,172,926,43,969
公投第７案,臺中市,東區,十甲里,1174,1604,766,189,955,39,994
公投第７案,臺中市,東區,東英里,1175,1815,814,222,1036,54,1090
公投第７案,臺中市,東區,東英里,1176,1700,713,182,895,46,941
公投第７案,臺中市,東區,東英里,1177,1592,698,159,857,55,912
公投第７案,臺中市,東區,東英里,1178,1850,799,183,982,51,1033
公投第７案,臺中市,東區,東南里,1179,1252,612,107,719,30,749
公投第７案,臺中市,東區,東南里,1180,1250,605,150,755,38,793
公投第７案,臺中市,東區,東南里,1181,1241,584,114,698,53,751
公投第７案,臺中市,東區,東勢里,1182,1318,510,149,659,47,706
公投第７案,臺中市,東區,東勢里,1183,1288,573,118,691,42,733
公投第７案,臺中市,東區,合作里,1184,1442,673,144,817,78,895
公投第７案,臺中市,東區,合作里,1185,1202,533,134,667,45,712
公投第７案,臺中市,東區,合作里,1186,1452,696,113,809,49,858
公投第７案,臺中市,東區,富仁里,1187,1480,657,150,807,29,836
公投第７案,臺中市,東區,富仁里,1188,1736,832,115,947,38,985
公投第７案,臺中市,東區,富仁里,1189,867,356,101,457,39,496
公投第７案,臺中市,東區,富台里,1190,1693,707,132,839,42,881
公投第７案,臺中市,東區,東信里,1191,1538,710,163,873,67,940
公投第７案,臺中市,東區,東信里,1192,1593,701,215,916,83,999
公投第７案,臺中市,東區,東信里,1193,1481,651,138,789,24,813
公投第７案,臺中市,東區,東信里,1194,1414,671,149,820,42,862
公投第７案,臺中市,東區,東信里,1195,1297,550,133,683,28,711
公投第７案,臺中市,東區,東信里,1196,1394,601,167,768,64,832
公投第７案,臺中市,南區,長春里,1197,937,425,109,534,39,573
公投第７案,臺中市,南區,長春里,1198,1001,476,140,616,40,656
公投第７案,臺中市,南區,長榮里,1199,1249,610,152,762,61,823
公投第７案,臺中市,南區,長榮里,1200,1202,605,165,770,49,819
公投第７案,臺中市,南區,城隍里,1201,1130,528,142,670,45,715
公投第７案,臺中市,南區,城隍里,1202,1239,568,168,736,47,783
公投第７案,臺中市,南區,城隍里,1203,1238,528,142,670,58,728
公投第７案,臺中市,南區,國光里,1204,1272,557,174,731,56,787
公投第７案,臺中市,南區,國光里,1205,1273,559,166,725,40,765
公投第７案,臺中市,南區,國光里,1206,1317,642,100,742,63,805
公投第７案,臺中市,南區,南門里,1207,1160,598,150,748,40,788
公投第７案,臺中市,南區,南門里,1208,1205,567,163,730,55,785
公投第７案,臺中市,南區,南門里,1209,1111,520,128,648,37,685
公投第７案,臺中市,南區,德義里,1210,1407,687,193,880,44,924
公投第７案,臺中市,南區,德義里,1211,1419,632,173,805,48,853
公投第７案,臺中市,南區,積善里,1212,1157,529,146,675,62,737
公投第７案,臺中市,南區,積善里,1213,1415,620,149,769,31,800
公投第７案,臺中市,南區,江川里,1214,1289,634,166,800,46,846
公投第７案,臺中市,南區,江川里,1215,1454,660,157,817,56,873
公投第７案,臺中市,南區,新榮里,1216,1491,692,117,809,55,864
公投第７案,臺中市,南區,新榮里,1217,1394,659,138,797,30,827
公投第７案,臺中市,南區,新榮里,1218,1430,635,173,808,49,857
公投第７案,臺中市,南區,福興里,1219,1342,616,155,771,66,837
公投第７案,臺中市,南區,福興里,1220,1304,622,180,802,82,884
公投第７案,臺中市,南區,福興里,1221,1190,578,138,716,30,746
公投第７案,臺中市,南區,福平里,1222,1273,587,113,700,56,756
公投第７案,臺中市,南區,福平里,1223,1387,690,154,844,62,906
公投第７案,臺中市,南區,福平里,1224,1356,621,156,777,35,812
公投第７案,臺中市,南區,福平里,1225,1304,624,144,768,47,815
公投第７案,臺中市,南區,福順里,1226,1256,614,153,767,24,791
公投第７案,臺中市,南區,福順里,1227,1364,659,179,838,25,863
公投第７案,臺中市,南區,福順里,1228,1361,591,184,775,71,846
公投第７案,臺中市,南區,福順里,1229,1407,704,142,846,22,868
公投第７案,臺中市,南區,和平里,1230,1308,595,150,745,53,798
公投第７案,臺中市,南區,和平里,1231,1250,574,125,699,34,733
公投第７案,臺中市,南區,和平里,1232,1284,549,155,704,36,740
公投第７案,臺中市,南區,平和里,1233,1175,547,155,702,51,753
公投第７案,臺中市,南區,平和里,1234,1158,576,162,738,31,769
公投第７案,臺中市,南區,平和里,1235,1168,532,136,668,45,713
公投第７案,臺中市,南區,南和里,1236,1626,830,161,991,45,1036
公投第７案,臺中市,南區,南和里,1237,2115,664,184,848,32,880
公投第７案,臺中市,南區,南和里,1238,1805,808,159,967,38,1005
公投第７案,臺中市,南區,南和里,1239,1695,762,156,918,28,946
公投第７案,臺中市,南區,永興里,1240,1643,817,175,992,47,1039
公投第７案,臺中市,南區,永興里,1241,1423,677,180,857,32,889
公投第７案,臺中市,南區,永興里,1242,1542,722,155,877,41,918
公投第７案,臺中市,南區,永興里,1243,1533,739,139,878,27,905
公投第７案,臺中市,南區,永興里,1244,1531,755,170,925,64,989
公投第７案,臺中市,南區,永和里,1245,1392,570,139,709,30,739
公投第７案,臺中市,南區,永和里,1246,1592,716,155,871,46,917
公投第７案,臺中市,南區,永和里,1247,1431,685,165,850,43,893
公投第７案,臺中市,南區,樹義里,1248,1799,748,192,940,43,983
公投第７案,臺中市,南區,樹義里,1249,1708,862,174,1036,48,1084
公投第７案,臺中市,南區,樹義里,1250,1700,766,171,937,45,982
公投第７案,臺中市,南區,樹義里,1251,1751,853,191,1044,42,1086
公投第７案,臺中市,南區,樹義里,1252,2109,980,219,1199,55,1254
公投第７案,臺中市,南區,樹義里,1253,1697,781,171,952,53,1005
公投第７案,臺中市,南區,工學里,1254,1456,674,141,815,46,861
公投第７案,臺中市,南區,工學里,1255,1726,888,208,1096,51,1147
公投第７案,臺中市,南區,工學里,1256,1723,858,171,1029,53,1082
公投第７案,臺中市,南區,工學里,1257,1569,749,170,919,54,973
公投第７案,臺中市,南區,樹德里,1258,1274,622,131,753,39,792
公投第７案,臺中市,南區,樹德里,1259,1390,718,167,885,33,918
公投第７案,臺中市,南區,樹德里,1260,1295,664,155,819,30,849
公投第７案,臺中市,南區,樹德里,1261,1312,624,135,759,46,805
公投第７案,臺中市,南區,樹德里,1262,1417,717,154,871,30,901
公投第７案,臺中市,南區,樹德里,1263,1230,681,136,817,35,852
公投第７案,臺中市,南區,西川里,1264,1308,583,143,726,55,781
公投第７案,臺中市,南區,西川里,1265,1467,634,171,805,70,875
公投第７案,臺中市,南區,西川里,1266,1399,695,123,818,36,854
公投第７案,臺中市,南區,崇倫里,1267,1207,537,146,683,50,733
公投第７案,臺中市,南區,崇倫里,1268,1317,613,124,737,34,771
公投第７案,臺中市,南區,崇倫里,1269,1563,687,191,878,37,915
公投第７案,臺中市,南區,崇倫里,1270,1221,629,111,740,30,770
公投第７案,臺中市,太平區,太平里,1271,1821,731,171,902,91,993
公投第７案,臺中市,太平區,太平里,1272,1680,663,141,804,35,839
公投第７案,臺中市,太平區,太平里,1273,1947,818,221,1039,90,1129
公投第７案,臺中市,太平區,長億里,1274,1910,822,217,1039,111,1150
公投第７案,臺中市,太平區,長億里,1275,1894,789,189,978,41,1019
公投第７案,臺中市,太平區,長億里,1276,1953,826,174,1000,52,1052
公投第７案,臺中市,太平區,永成里,1277,1846,778,212,990,72,1062
公投第７案,臺中市,太平區,永成里,1278,1493,693,145,838,39,877
公投第７案,臺中市,太平區,永成里,1279,1605,687,156,843,57,900
公投第７案,臺中市,太平區,永成里,1280,1619,770,150,920,28,948
公投第７案,臺中市,太平區,中平里,1281,2011,828,206,1034,69,1103
公投第７案,臺中市,太平區,中平里,1282,2056,851,165,1016,41,1057
公投第７案,臺中市,太平區,中政里,1283,1876,788,173,961,62,1023
公投第７案,臺中市,太平區,中政里,1284,1815,750,164,914,69,983
公投第７案,臺中市,太平區,平安里,1285,1281,516,156,672,41,713
公投第７案,臺中市,太平區,平安里,1286,1004,474,135,609,43,652
公投第７案,臺中市,太平區,中興里,1287,1886,849,213,1062,63,1125
公投第７案,臺中市,太平區,中興里,1288,1431,625,175,800,60,860
公投第７案,臺中市,太平區,永平里,1289,1930,771,213,984,67,1051
公投第７案,臺中市,太平區,永平里,1290,2164,827,216,1043,75,1118
公投第７案,臺中市,太平區,東平里,1291,2048,842,183,1025,92,1117
公投第７案,臺中市,太平區,東平里,1292,2035,830,187,1017,63,1080
公投第７案,臺中市,太平區,成功里,1293,1685,685,160,845,90,935
公投第７案,臺中市,太平區,成功里,1294,2185,922,91,1013,67,1080
公投第７案,臺中市,太平區,東和里,1295,1176,495,103,598,23,621
公投第７案,臺中市,太平區,東和里,1296,1597,667,160,827,46,873
公投第７案,臺中市,太平區,建國里,1297,1378,555,119,674,67,741
公投第７案,臺中市,太平區,建國里,1298,1546,623,144,767,41,808
公投第７案,臺中市,太平區,建興里,1299,1890,695,188,883,77,960
公投第７案,臺中市,太平區,建興里,1300,1053,452,89,541,53,594
公投第７案,臺中市,太平區,坪林里,1301,1582,758,123,881,74,955
公投第７案,臺中市,太平區,坪林里,1302,1699,772,177,949,57,1006
公投第７案,臺中市,太平區,大興里,1303,1493,629,139,768,50,818
公投第７案,臺中市,太平區,大興里,1304,1063,435,107,542,33,575
公投第７案,臺中市,太平區,勤益里,1305,1117,550,99,649,42,691
公投第７案,臺中市,太平區,勤益里,1306,1084,533,89,622,36,658
公投第７案,臺中市,太平區,光華里,1307,1776,710,155,865,28,893
公投第７案,臺中市,太平區,光華里,1308,1729,723,169,892,40,932
公投第７案,臺中市,太平區,光華里,1309,1658,626,132,758,47,805
公投第７案,臺中市,太平區,光明里,1310,2010,883,141,1024,50,1074
公投第７案,臺中市,太平區,光明里,1311,1752,745,129,874,63,937
公投第７案,臺中市,太平區,中山里,1312,1654,747,179,926,71,997
公投第７案,臺中市,太平區,中山里,1313,1951,618,127,745,32,777
公投第７案,臺中市,太平區,豐年里,1314,2170,1036,247,1283,81,1364
公投第７案,臺中市,太平區,豐年里,1315,2231,1013,256,1269,41,1310
公投第７案,臺中市,太平區,宜欣里,1316,1623,731,144,875,36,911
公投第７案,臺中市,太平區,宜欣里,1317,1548,575,140,715,46,761
公投第７案,臺中市,太平區,宜欣里,1318,1442,579,157,736,55,791
公投第７案,臺中市,太平區,宜欣里,1319,1501,559,130,689,32,721
公投第７案,臺中市,太平區,宜佳里,1320,2025,769,173,942,26,968
公投第７案,臺中市,太平區,宜佳里,1321,1885,772,179,951,58,1009
公投第７案,臺中市,太平區,宜佳里,1322,2155,795,194,989,72,1061
公投第７案,臺中市,太平區,宜昌里,1323,1775,666,160,826,43,869
公投第７案,臺中市,太平區,宜昌里,1324,2021,709,147,856,75,931
公投第７案,臺中市,太平區,新坪里,1325,2075,928,189,1117,72,1189
公投第７案,臺中市,太平區,新坪里,1326,1723,708,156,864,39,903
公投第７案,臺中市,太平區,新坪里,1327,2049,894,166,1060,51,1111
公投第７案,臺中市,太平區,新坪里,1328,1415,623,126,749,31,780
公投第７案,臺中市,太平區,新吉里,1329,1778,765,179,944,41,985
公投第７案,臺中市,太平區,新吉里,1330,1706,679,177,856,51,907
公投第７案,臺中市,太平區,新吉里,1331,2090,895,200,1095,52,1147
公投第７案,臺中市,太平區,新城里,1332,2093,827,163,990,49,1039
公投第７案,臺中市,太平區,新城里,1333,1688,638,115,753,38,791
公投第７案,臺中市,太平區,新城里,1334,1488,623,93,716,39,755
公投第７案,臺中市,太平區,新光里,1335,1667,747,171,918,54,972
公投第７案,臺中市,太平區,新光里,1336,1793,751,190,941,75,1016
公投第７案,臺中市,太平區,新光里,1337,1903,889,144,1033,34,1067
公投第７案,臺中市,太平區,新光里,1338,1834,787,177,964,59,1023
公投第７案,臺中市,太平區,新興里,1339,1526,668,116,784,26,810
公投第７案,臺中市,太平區,新興里,1340,1483,755,138,893,24,917
公投第７案,臺中市,太平區,新興里,1341,1694,777,146,923,27,950
公投第７案,臺中市,太平區,新高里,1342,1952,758,168,926,7,933
公投第７案,臺中市,太平區,新高里,1343,1995,841,199,1040,32,1072
公投第７案,臺中市,太平區,新高里,1344,1311,617,120,737,25,762
公投第７案,臺中市,太平區,新高里,1345,1537,835,144,979,37,1016
公投第７案,臺中市,太平區,新福里,1346,1974,756,160,916,47,963
公投第７案,臺中市,太平區,新福里,1347,1828,811,159,970,48,1018
公投第７案,臺中市,太平區,新福里,1348,2191,857,185,1042,31,1073
公投第７案,臺中市,太平區,頭汴里,1349,1825,716,176,892,79,971
公投第７案,臺中市,太平區,聖和里,1350,1559,592,147,739,18,757
公投第７案,臺中市,太平區,東汴里,1351,1225,518,104,622,66,688
公投第７案,臺中市,太平區,興隆里,1352,1678,725,154,879,58,937
公投第７案,臺中市,太平區,興隆里,1353,1501,578,163,741,62,803
公投第７案,臺中市,太平區,福隆里,1354,1450,672,184,856,73,929
公投第７案,臺中市,太平區,福隆里,1355,2126,840,189,1029,73,1102
公投第７案,臺中市,太平區,黃竹里,1356,699,338,71,409,36,445
公投第７案,臺中市,太平區,光隆里,1357,1428,501,139,640,29,669
公投第７案,臺中市,太平區,光隆里,1358,1666,742,153,895,67,962
公投第７案,臺中市,太平區,永隆里,1359,1241,494,152,646,45,691
公投第７案,臺中市,太平區,永隆里,1360,1266,570,137,707,52,759
公投第７案,臺中市,太平區,德隆里,1361,1166,514,120,634,34,668
公投第７案,臺中市,太平區,德隆里,1362,1790,797,182,979,65,1044
公投第７案,臺中市,太平區,德隆里,1363,1754,600,164,764,43,807
公投第７案,臺中市,大里區,東湖里,1364,1614,633,159,792,44,836
公投第７案,臺中市,大里區,東湖里,1365,1599,638,134,772,28,800
公投第７案,臺中市,大里區,東湖里,1366,1715,667,161,828,41,869
公投第７案,臺中市,大里區,東湖里,1367,1264,559,132,691,23,714
公投第７案,臺中市,大里區,東湖里,1368,1416,584,122,706,34,740
公投第７案,臺中市,大里區,東湖里,1369,1188,515,102,617,25,642
公投第７案,臺中市,大里區,東湖里,1370,1359,537,136,673,49,722
公投第７案,臺中市,大里區,西湖里,1371,1457,634,144,778,60,838
公投第７案,臺中市,大里區,西湖里,1372,1403,640,145,785,43,828
公投第７案,臺中市,大里區,大里里,1373,1697,701,174,875,47,922
公投第７案,臺中市,大里區,大里里,1374,1811,795,215,1010,75,1085
公投第７案,臺中市,大里區,新里里,1375,1830,740,183,923,57,980
公投第７案,臺中市,大里區,新里里,1376,2228,725,173,898,67,965
公投第７案,臺中市,大里區,新里里,1377,1997,885,180,1065,75,1140
公投第７案,臺中市,大里區,新里里,1378,2033,1044,211,1255,42,1297
公投第７案,臺中市,大里區,新里里,1379,1835,777,240,1017,33,1050
公投第７案,臺中市,大里區,國光里,1380,1268,569,127,696,23,719
公投第７案,臺中市,大里區,國光里,1381,1645,711,169,880,47,927
公投第７案,臺中市,大里區,國光里,1382,1561,724,155,879,22,901
公投第７案,臺中市,大里區,國光里,1383,1301,706,120,826,30,856
公投第７案,臺中市,大里區,樹王里,1384,1621,725,105,830,60,890
公投第７案,臺中市,大里區,樹王里,1385,1797,696,198,894,68,962
公投第７案,臺中市,大里區,祥興里,1386,1230,503,118,621,24,645
公投第７案,臺中市,大里區,祥興里,1387,1488,627,142,769,52,821
公投第７案,臺中市,大里區,祥興里,1388,1459,568,164,732,62,794
公投第７案,臺中市,大里區,祥興里,1389,1647,711,168,879,54,933
公投第７案,臺中市,大里區,祥興里,1390,1100,503,122,625,61,686
公投第７案,臺中市,大里區,內新里,1391,1410,641,120,761,46,807
公投第７案,臺中市,大里區,內新里,1392,1807,734,162,896,61,957
公投第７案,臺中市,大里區,內新里,1393,1331,568,140,708,50,758
公投第７案,臺中市,大里區,內新里,1394,1801,739,181,920,49,969
公投第７案,臺中市,大里區,內新里,1395,1909,777,146,923,43,966
公投第７案,臺中市,大里區,中新里,1396,1699,640,151,791,71,862
公投第７案,臺中市,大里區,中新里,1397,1627,728,156,884,57,941
公投第７案,臺中市,大里區,中新里,1398,1912,815,162,977,60,1037
公投第７案,臺中市,大里區,東昇里,1399,1753,717,161,878,62,940
公投第７案,臺中市,大里區,東昇里,1400,1602,672,159,831,46,877
公投第７案,臺中市,大里區,大元里,1401,1144,490,121,611,49,660
公投第７案,臺中市,大里區,大元里,1402,1655,692,219,911,51,962
公投第７案,臺中市,大里區,大元里,1403,1438,603,168,771,37,808
公投第７案,臺中市,大里區,夏田里,1404,1000,439,106,545,46,591
公投第７案,臺中市,大里區,仁化里,1405,1711,748,147,895,68,963
公投第７案,臺中市,大里區,仁化里,1406,1698,750,120,870,10,880
公投第７案,臺中市,大里區,仁化里,1407,1914,831,170,1001,71,1072
公投第７案,臺中市,大里區,仁化里,1408,1465,648,149,797,28,825
公投第７案,臺中市,大里區,仁化里,1409,1581,676,162,838,64,902
公投第７案,臺中市,大里區,仁德里,1410,1509,670,164,834,60,894
公投第７案,臺中市,大里區,仁德里,1411,1570,664,122,786,34,820
公投第７案,臺中市,大里區,仁德里,1412,1425,631,155,786,40,826
公投第７案,臺中市,大里區,仁德里,1413,1384,612,146,758,63,821
公投第７案,臺中市,大里區,健民里,1414,1204,431,118,549,36,585
公投第７案,臺中市,大里區,健民里,1415,1761,662,155,817,31,848
公投第７案,臺中市,大里區,健民里,1416,1473,565,110,675,26,701
公投第７案,臺中市,大里區,塗城里,1417,1675,738,159,897,50,947
公投第７案,臺中市,大里區,塗城里,1418,1755,798,136,934,54,988
公投第７案,臺中市,大里區,塗城里,1419,1593,596,166,762,77,839
公投第７案,臺中市,大里區,塗城里,1420,1799,739,198,937,61,998
公投第７案,臺中市,大里區,塗城里,1421,1606,664,167,831,80,911
公投第７案,臺中市,大里區,東興里,1422,1875,746,193,939,44,983
公投第７案,臺中市,大里區,東興里,1423,1670,725,179,904,50,954
公投第７案,臺中市,大里區,東興里,1424,1898,770,192,962,44,1006
公投第７案,臺中市,大里區,東興里,1425,1679,659,182,841,28,869
公投第７案,臺中市,大里區,大明里,1426,1373,559,138,697,54,751
公投第７案,臺中市,大里區,大明里,1427,1299,574,123,697,55,752
公投第７案,臺中市,大里區,大明里,1428,1430,635,139,774,39,813
公投第７案,臺中市,大里區,永隆里,1429,1805,885,209,1094,43,1137
公投第７案,臺中市,大里區,永隆里,1430,1806,922,210,1132,25,1157
公投第７案,臺中市,大里區,永隆里,1431,1826,965,180,1145,45,1190
公投第７案,臺中市,大里區,永隆里,1432,1805,948,189,1137,40,1177
公投第７案,臺中市,大里區,永隆里,1433,1907,922,184,1106,43,1149
公投第７案,臺中市,大里區,日新里,1434,1103,551,110,661,42,703
公投第７案,臺中市,大里區,日新里,1435,1419,612,130,742,51,793
公投第７案,臺中市,大里區,日新里,1436,1434,581,140,721,72,793
公投第７案,臺中市,大里區,西榮里,1437,1875,698,152,850,34,884
公投第７案,臺中市,大里區,西榮里,1438,1862,774,231,1005,49,1054
公投第７案,臺中市,大里區,西榮里,1439,1850,777,170,947,28,975
公投第７案,臺中市,大里區,長榮里,1440,1622,693,179,872,63,935
公投第７案,臺中市,大里區,長榮里,1441,1638,788,175,963,55,1018
公投第７案,臺中市,大里區,長榮里,1442,1633,754,188,942,73,1015
公投第７案,臺中市,大里區,長榮里,1443,1662,725,182,907,35,942
公投第７案,臺中市,大里區,長榮里,1444,1917,924,164,1088,41,1129
公投第７案,臺中市,大里區,金城里,1445,1701,637,188,825,75,900
公投第７案,臺中市,大里區,金城里,1446,1549,625,152,777,55,832
公投第７案,臺中市,大里區,金城里,1447,1567,724,155,879,58,937
公投第７案,臺中市,大里區,金城里,1448,1614,712,151,863,45,908
公投第７案,臺中市,大里區,金城里,1449,1811,777,189,966,78,1044
公投第７案,臺中市,大里區,金城里,1450,1336,566,146,712,38,750
公投第７案,臺中市,大里區,立仁里,1451,1759,725,169,894,40,934
公投第７案,臺中市,大里區,立仁里,1452,1783,688,178,866,71,937
公投第７案,臺中市,大里區,立仁里,1453,1736,650,171,821,64,885
公投第７案,臺中市,大里區,立德里,1454,1874,799,185,984,61,1045
公投第７案,臺中市,大里區,立德里,1455,1889,833,198,1031,38,1069
公投第７案,臺中市,大里區,立德里,1456,1947,797,189,986,55,1041
公投第７案,臺中市,大里區,立德里,1457,1938,880,202,1082,48,1130
公投第７案,臺中市,大里區,新仁里,1458,1836,780,183,963,61,1024
公投第７案,臺中市,大里區,新仁里,1459,1913,786,193,979,68,1047
公投第７案,臺中市,大里區,新仁里,1460,1913,745,197,942,75,1017
公投第７案,臺中市,大里區,新仁里,1461,1937,792,169,961,52,1013
公投第７案,臺中市,大里區,瑞城里,1462,1508,642,142,784,35,819
公投第７案,臺中市,大里區,瑞城里,1463,1340,618,144,762,19,781
公投第７案,臺中市,大里區,瑞城里,1464,1656,760,158,918,47,965
公投第７案,臺中市,大里區,瑞城里,1465,1290,557,130,687,42,729
公投第７案,臺中市,大里區,瑞城里,1466,1655,737,152,889,35,924
公投第７案,臺中市,大里區,瑞城里,1467,1260,490,105,595,18,613
公投第７案,臺中市,大里區,瑞城里,1468,1247,579,129,708,36,744
公投第７案,臺中市,大里區,瑞城里,1469,1548,640,179,819,47,866
公投第７案,臺中市,霧峰區,桐林里,1470,1205,568,135,703,37,740
公投第７案,臺中市,霧峰區,吉峰里,1471,1620,688,192,880,43,923
公投第７案,臺中市,霧峰區,吉峰里,1472,1559,761,143,904,50,954
公投第７案,臺中市,霧峰區,吉峰里,1473,1660,743,154,897,56,953
公投第７案,臺中市,霧峰區,吉峰里,1474,1602,779,161,940,45,985
公投第７案,臺中市,霧峰區,吉峰里,1475,1325,554,128,682,47,729
公投第７案,臺中市,霧峰區,吉峰里,1476,1515,692,141,833,52,885
公投第７案,臺中市,霧峰區,甲寅里,1477,1561,641,167,808,61,869
公投第７案,臺中市,霧峰區,甲寅里,1478,1691,686,171,857,52,909
公投第７案,臺中市,霧峰區,甲寅里,1479,1486,652,184,836,44,880
公投第７案,臺中市,霧峰區,本鄉里,1480,975,446,115,561,51,612
公投第７案,臺中市,霧峰區,本鄉里,1481,1358,670,124,794,65,859
公投第７案,臺中市,霧峰區,中正里,1482,1141,589,134,723,33,756
公投第７案,臺中市,霧峰區,中正里,1483,855,409,95,504,58,562
公投第７案,臺中市,霧峰區,錦榮里,1484,1202,526,129,655,64,719
公投第７案,臺中市,霧峰區,萊園里,1485,1078,467,90,557,44,601
公投第７案,臺中市,霧峰區,本堂里,1486,1456,605,178,783,61,844
公投第７案,臺中市,霧峰區,本堂里,1487,1573,759,156,915,47,962
公投第７案,臺中市,霧峰區,本堂里,1488,1591,745,149,894,49,943
公投第７案,臺中市,霧峰區,本堂里,1489,1214,607,117,724,55,779
公投第７案,臺中市,霧峰區,北柳里,1490,1267,538,130,668,55,723
公投第７案,臺中市,霧峰區,北柳里,1491,1277,607,97,704,56,760
公投第７案,臺中市,霧峰區,北柳里,1492,1366,583,144,727,51,778
公投第７案,臺中市,霧峰區,南柳里,1493,994,518,128,646,42,688
公投第７案,臺中市,霧峰區,南柳里,1494,863,398,102,500,41,541
公投第７案,臺中市,霧峰區,四德里,1495,1274,562,132,694,41,735
公投第７案,臺中市,霧峰區,四德里,1496,1162,492,128,620,60,680
公投第７案,臺中市,霧峰區,五福里,1497,1252,590,123,713,62,775
公投第７案,臺中市,霧峰區,五福里,1498,1322,579,158,737,53,790
公投第７案,臺中市,霧峰區,丁台里,1499,1116,533,120,653,56,709
公投第７案,臺中市,霧峰區,丁台里,1500,1156,538,125,663,69,732
公投第７案,臺中市,霧峰區,北勢里,1501,1147,581,109,690,52,742
公投第７案,臺中市,霧峰區,北勢里,1502,928,486,99,585,43,628
公投第７案,臺中市,霧峰區,南勢里,1503,1296,553,128,681,47,728
公投第７案,臺中市,霧峰區,萬豐里,1504,1314,526,128,654,64,718
公投第７案,臺中市,霧峰區,萬豐里,1505,1328,613,138,751,57,808
公投第７案,臺中市,霧峰區,舊正里,1506,989,437,101,538,54,592
公投第７案,臺中市,霧峰區,舊正里,1507,1088,509,118,627,52,679
公投第７案,臺中市,霧峰區,坑口里,1508,1363,696,101,797,60,857
公投第７案,臺中市,霧峰區,坑口里,1509,1573,746,160,906,60,966
公投第７案,臺中市,霧峰區,峰谷里,1510,1117,480,105,585,65,650
公投第７案,臺中市,霧峰區,六股里,1511,1342,637,167,804,58,862
公投第７案,臺中市,霧峰區,六股里,1512,1024,488,131,619,64,683
公投第７案,臺中市,東勢區,慶福里,1513,1299,552,125,677,48,725
公投第７案,臺中市,東勢區,慶東里,1514,1007,410,110,520,44,564
公投第７案,臺中市,東勢區,慶東里,1515,859,343,74,417,63,480
公投第７案,臺中市,東勢區,上城里,1516,991,473,123,596,61,657
公投第７案,臺中市,東勢區,下城里,1517,863,322,90,412,23,435
公投第７案,臺中市,東勢區,詒福里,1518,1628,653,165,818,105,923
公投第７案,臺中市,東勢區,新盛里,1519,1335,513,137,650,49,699
公投第７案,臺中市,東勢區,新盛里,1520,1092,530,118,648,50,698
公投第７案,臺中市,東勢區,新盛里,1521,1050,494,129,623,46,669
公投第７案,臺中市,東勢區,新盛里,1522,1431,646,134,780,45,825
公投第７案,臺中市,東勢區,福隆里,1523,1372,638,135,773,52,825
公投第７案,臺中市,東勢區,福隆里,1524,1412,647,139,786,48,834
公投第７案,臺中市,東勢區,福隆里,1525,878,386,80,466,52,518
公投第７案,臺中市,東勢區,隆興里,1526,1475,541,142,683,70,753
公投第７案,臺中市,東勢區,中嵙里,1527,872,380,63,443,22,465
公投第７案,臺中市,東勢區,中嵙里,1528,1006,420,97,517,52,569
公投第７案,臺中市,東勢區,泰昌里,1529,1222,537,121,658,18,676
公投第７案,臺中市,東勢區,泰昌里,1530,1228,608,150,758,55,813
公投第７案,臺中市,東勢區,泰昌里,1531,1036,477,113,590,28,618
公投第７案,臺中市,東勢區,上新里,1532,977,454,109,563,27,590
公投第７案,臺中市,東勢區,廣興里,1533,1395,616,111,727,34,761
公投第７案,臺中市,東勢區,延平里,1534,1169,525,137,662,77,739
公投第７案,臺中市,東勢區,延平里,1535,1027,477,114,591,50,641
公投第７案,臺中市,東勢區,南平里,1536,984,470,82,552,27,579
公投第７案,臺中市,東勢區,南平里,1537,866,486,80,566,35,601
公投第７案,臺中市,東勢區,東安里,1538,1031,483,101,584,54,638
公投第７案,臺中市,東勢區,中寧里,1539,865,451,78,529,47,576
公投第７案,臺中市,東勢區,北興里,1540,1357,666,113,779,70,849
公投第７案,臺中市,東勢區,粵寧里,1541,736,360,64,424,24,448
公投第７案,臺中市,東勢區,粵寧里,1542,1314,596,124,720,50,770
公投第７案,臺中市,東勢區,下新里,1543,1677,655,157,812,97,909
公投第７案,臺中市,東勢區,東新里,1544,950,448,94,542,33,575
公投第７案,臺中市,東勢區,東新里,1545,1007,476,105,581,48,629
公投第７案,臺中市,東勢區,興隆里,1546,1214,416,159,575,45,620
公投第７案,臺中市,東勢區,茂興里,1547,907,397,94,491,29,520
公投第７案,臺中市,東勢區,茂興里,1548,902,363,103,466,34,500
公投第７案,臺中市,東勢區,泰興里,1549,720,249,61,310,9,319
公投第７案,臺中市,東勢區,埤頭里,1550,666,231,64,295,10,305
公投第７案,臺中市,東勢區,明正里,1551,1361,569,116,685,52,737
公投第７案,臺中市,石岡區,石岡里,1552,1244,548,140,688,42,730
公投第７案,臺中市,石岡區,萬安里,1553,1539,665,160,825,5,830
公投第７案,臺中市,石岡區,九房里,1554,1202,517,153,670,40,710
公投第７案,臺中市,石岡區,金星里,1555,1272,519,114,633,64,697
公投第７案,臺中市,石岡區,龍興里,1556,652,298,63,361,30,391
公投第７案,臺中市,石岡區,萬興里,1557,1457,717,169,886,71,957
公投第７案,臺中市,石岡區,梅子里,1558,1836,785,189,974,62,1036
公投第７案,臺中市,石岡區,土牛里,1559,1001,431,101,532,48,580
公投第７案,臺中市,石岡區,德興里,1560,1448,681,154,835,62,897
公投第７案,臺中市,石岡區,和盛里,1561,1229,574,136,710,53,763
公投第７案,臺中市,新社區,新社里,1562,1011,420,112,532,22,554
公投第７案,臺中市,新社區,新社里,1563,1195,504,129,633,39,672
公投第７案,臺中市,新社區,新社里,1564,1053,503,108,611,20,631
公投第７案,臺中市,新社區,復盛里,1565,961,304,84,388,15,403
公投第７案,臺中市,新社區,復盛里,1566,919,362,91,453,17,470
公投第７案,臺中市,新社區,中正里,1567,1367,642,142,784,55,839
公投第７案,臺中市,新社區,月湖里,1568,1010,402,102,504,22,526
公投第７案,臺中市,新社區,崑山里,1569,1169,415,101,516,42,558
公投第７案,臺中市,新社區,大南里,1570,989,393,121,514,48,562
公投第７案,臺中市,新社區,大南里,1571,894,384,70,454,13,467
公投第７案,臺中市,新社區,永源里,1572,1033,387,76,463,16,479
公投第７案,臺中市,新社區,永源里,1573,1058,342,75,417,23,440
公投第７案,臺中市,新社區,永源里,1574,845,290,80,370,21,391
公投第７案,臺中市,新社區,中興里,1575,576,296,69,365,24,389
公投第７案,臺中市,新社區,協成里,1576,1229,458,109,567,59,626
公投第７案,臺中市,新社區,協成里,1577,890,304,71,375,26,401
公投第７案,臺中市,新社區,協成里,1578,781,301,69,370,28,398
公投第７案,臺中市,新社區,東興里,1579,1244,526,86,612,67,679
公投第７案,臺中市,新社區,慶西里,1580,213,64,7,71,8,79
公投第７案,臺中市,新社區,慶西里,1581,676,234,51,285,23,308
公投第７案,臺中市,新社區,中和里,1582,585,214,42,256,22,278
公投第７案,臺中市,新社區,福興里,1583,938,414,74,488,38,526
公投第７案,臺中市,新社區,福興里,1584,224,87,20,107,3,110
公投第７案,臺中市,和平區,南勢里,1585,956,460,121,581,32,613
公投第７案,臺中市,和平區,南勢里,1586,963,480,100,580,47,627
公投第７案,臺中市,和平區,天輪里,1587,456,205,39,244,14,258
公投第７案,臺中市,和平區,博愛里,1588,1011,517,89,606,31,637
公投第７案,臺中市,和平區,博愛里,1589,636,303,58,361,13,374
公投第７案,臺中市,和平區,自由里,1590,270,105,16,121,6,127
公投第７案,臺中市,和平區,自由里,1591,460,306,30,336,21,357
公投第７案,臺中市,和平區,自由里,1592,321,197,34,231,11,242
公投第７案,臺中市,和平區,達觀里,1593,783,388,83,471,25,496
公投第７案,臺中市,和平區,達觀里,1594,336,150,32,182,18,200
公投第７案,臺中市,和平區,中坑里,1595,451,250,46,296,13,309
公投第７案,臺中市,和平區,梨山里,1596,366,144,34,178,13,191
公投第７案,臺中市,和平區,梨山里,1597,771,282,43,325,8,333
公投第７案,臺中市,和平區,梨山里,1598,574,250,42,292,26,318
公投第７案,臺中市,和平區,梨山里,1599,274,122,35,157,12,169
公投第７案,臺中市,和平區,平等里,1600,157,69,15,84,2,86
公投第７案,臺中市,和平區,平等里,1601,713,277,47,324,17,341
公投第７案,臺南市,後壁區,後壁里,1,743,288,73,361,65,426
公投第７案,臺南市,後壁區,後壁里,2,898,330,73,403,21,424
公投第７案,臺南市,後壁區,侯伯里,3,786,234,79,313,51,364
公投第７案,臺南市,後壁區,侯伯里,4,534,163,50,213,58,271
公投第７案,臺南市,後壁區,嘉苳里,5,1034,354,104,458,70,528
公投第７案,臺南市,後壁區,嘉苳里,6,232,55,32,87,19,106
公投第７案,臺南市,後壁區,土溝里,7,479,150,42,192,41,233
公投第７案,臺南市,後壁區,土溝里,8,837,267,75,342,25,367
公投第７案,臺南市,後壁區,上茄苳里,9,1085,287,95,382,33,415
公投第７案,臺南市,後壁區,上茄苳里,10,1157,300,61,361,23,384
公投第７案,臺南市,後壁區,菁豐里,11,755,269,55,324,60,384
公投第７案,臺南市,後壁區,菁豐里,12,458,160,54,214,32,246
公投第７案,臺南市,後壁區,菁寮里,13,371,116,27,143,29,172
公投第７案,臺南市,後壁區,菁寮里,14,676,205,70,275,49,324
公投第７案,臺南市,後壁區,菁寮里,15,428,128,35,163,27,190
公投第７案,臺南市,後壁區,新嘉里,16,547,138,43,181,12,193
公投第７案,臺南市,後壁區,新嘉里,17,455,123,57,180,51,231
公投第７案,臺南市,後壁區,長短樹里,18,984,245,85,330,70,400
公投第７案,臺南市,後壁區,長短樹里,19,483,143,39,182,31,213
公投第７案,臺南市,後壁區,長短樹里,20,536,165,26,191,32,223
公投第７案,臺南市,後壁區,竹新里,21,958,234,55,289,13,302
公投第７案,臺南市,後壁區,竹新里,22,441,178,42,220,33,253
公投第７案,臺南市,後壁區,新東里,23,677,226,69,295,63,358
公投第７案,臺南市,後壁區,新東里,24,996,354,87,441,78,519
公投第７案,臺南市,後壁區,頂安里,25,1255,374,117,491,31,522
公投第７案,臺南市,後壁區,長安里,26,678,213,55,268,15,283
公投第７案,臺南市,後壁區,長安里,27,553,145,40,185,9,194
公投第７案,臺南市,後壁區,福安里,28,616,148,41,189,14,203
公投第７案,臺南市,後壁區,福安里,29,1189,392,108,500,28,528
公投第７案,臺南市,白河區,白河里,30,1176,414,122,536,86,622
公投第７案,臺南市,白河區,白河里,31,546,199,49,248,18,266
公投第７案,臺南市,白河區,永安里,32,859,321,105,426,34,460
公投第７案,臺南市,白河區,永安里,33,946,371,104,475,38,513
公投第７案,臺南市,白河區,永安里,34,1116,379,123,502,38,540
公投第７案,臺南市,白河區,外角里,35,1397,367,96,463,33,496
公投第７案,臺南市,白河區,庄內里,36,756,202,57,259,17,276
公投第７案,臺南市,白河區,庄內里,37,871,298,79,377,44,421
公投第７案,臺南市,白河區,秀祐里,38,897,304,97,401,38,439
公投第７案,臺南市,白河區,河東里,39,784,171,53,224,35,259
公投第７案,臺南市,白河區,河東里,40,572,168,49,217,15,232
公投第７案,臺南市,白河區,虎山里,41,457,100,26,126,9,135
公投第７案,臺南市,白河區,大林里,42,600,146,36,182,15,197
公投第７案,臺南市,白河區,崁頭里,43,375,87,13,100,7,107
公投第７案,臺南市,白河區,六溪里,44,508,88,24,112,10,122
公投第７案,臺南市,白河區,關嶺里,45,631,114,49,163,13,176
公投第７案,臺南市,白河區,關嶺里,46,391,75,22,97,13,110
公投第７案,臺南市,白河區,仙草里,47,799,167,57,224,14,238
公投第７案,臺南市,白河區,仙草里,48,506,104,31,135,18,153
公投第７案,臺南市,白河區,詔豐里,49,832,225,74,299,29,328
公投第７案,臺南市,白河區,詔豐里,50,1179,369,117,486,31,517
公投第７案,臺南市,白河區,大竹里,51,744,171,53,224,11,235
公投第７案,臺南市,白河區,大竹里,52,699,175,60,235,15,250
公投第７案,臺南市,白河區,廣蓮里,53,633,149,51,200,14,214
公投第７案,臺南市,白河區,廣蓮里,54,859,305,100,405,53,458
公投第７案,臺南市,白河區,竹門里,55,884,253,79,332,47,379
公投第７案,臺南市,白河區,崎內里,56,740,151,33,184,9,193
公投第７案,臺南市,白河區,昇安里,57,1334,377,113,490,54,544
公投第７案,臺南市,白河區,汴頭里,58,723,219,76,295,57,352
公投第７案,臺南市,白河區,內角里,59,682,226,83,309,64,373
公投第７案,臺南市,白河區,馬稠後里,60,855,278,113,391,47,438
公投第７案,臺南市,白河區,馬稠後里,61,543,142,50,192,19,211
公投第７案,臺南市,東山區,東山里,62,1401,436,123,559,62,621
公投第７案,臺南市,東山區,東中里,63,1185,354,79,433,29,462
公投第７案,臺南市,東山區,東中里,64,1303,342,121,463,63,526
公投第７案,臺南市,東山區,東正里,65,732,199,59,258,32,290
公投第７案,臺南市,東山區,東正里,66,721,185,52,237,34,271
公投第７案,臺南市,東山區,大客里,67,1104,256,92,348,46,394
公投第７案,臺南市,東山區,三榮里,68,943,265,74,339,23,362
公投第７案,臺南市,東山區,科里里,69,653,115,20,135,4,139
公投第７案,臺南市,東山區,科里里,70,596,178,43,221,69,290
公投第７案,臺南市,東山區,東河里,71,878,241,85,326,65,391
公投第７案,臺南市,東山區,聖賢里,72,771,191,70,261,58,319
公投第７案,臺南市,東山區,聖賢里,73,483,145,38,183,26,209
公投第７案,臺南市,東山區,聖賢里,74,640,207,48,255,38,293
公投第７案,臺南市,東山區,南溪里,75,425,72,21,93,2,95
公投第７案,臺南市,東山區,水雲里,76,394,105,22,127,17,144
公投第７案,臺南市,東山區,林安里,77,373,123,36,159,26,185
公投第７案,臺南市,東山區,東原里,78,1257,281,75,356,33,389
公投第７案,臺南市,東山區,東原里,79,887,149,40,189,7,196
公投第７案,臺南市,東山區,嶺南里,80,658,119,28,147,12,159
公投第７案,臺南市,東山區,南勢里,81,1101,212,69,281,26,307
公投第７案,臺南市,東山區,青山里,82,1057,182,59,241,18,259
公投第７案,臺南市,東山區,高原里,83,639,204,56,260,43,303
公投第７案,臺南市,東山區,高原里,84,270,78,29,107,10,117
公投第７案,臺南市,鹽水區,水秀里,85,1037,375,111,486,65,551
公投第７案,臺南市,鹽水區,水秀里,86,480,180,58,238,19,257
公投第７案,臺南市,鹽水區,津城里,87,636,270,77,347,30,377
公投第７案,臺南市,鹽水區,津城里,88,321,93,44,137,9,146
公投第７案,臺南市,鹽水區,津城里,89,497,202,58,260,34,294
公投第７案,臺南市,鹽水區,月港里,90,759,312,88,400,15,415
公投第７案,臺南市,鹽水區,月港里,91,341,125,19,144,18,162
公投第７案,臺南市,鹽水區,月港里,92,507,186,58,244,28,272
公投第７案,臺南市,鹽水區,橋南里,93,863,255,77,332,23,355
公投第７案,臺南市,鹽水區,橋南里,94,1373,463,125,588,21,609
公投第７案,臺南市,鹽水區,橋南里,95,1507,557,131,688,60,748
公投第７案,臺南市,鹽水區,岸內里,96,1374,490,161,651,74,725
公投第７案,臺南市,鹽水區,岸內里,97,1244,402,112,514,48,562
公投第７案,臺南市,鹽水區,岸內里,98,1022,365,109,474,61,535
公投第７案,臺南市,鹽水區,汫水里,99,921,220,62,282,41,323
公投第７案,臺南市,鹽水區,義中里,100,847,289,128,417,40,457
公投第７案,臺南市,鹽水區,義中里,101,736,166,47,213,4,217
公投第７案,臺南市,鹽水區,三明里,102,761,240,80,320,14,334
公投第７案,臺南市,鹽水區,三明里,103,285,97,29,126,11,137
公投第７案,臺南市,鹽水區,三明里,104,493,141,51,192,34,226
公投第７案,臺南市,鹽水區,文昌里,105,621,158,37,195,23,218
公投第７案,臺南市,鹽水區,文昌里,106,392,92,21,113,11,124
公投第７案,臺南市,鹽水區,歡雅里,107,925,305,74,379,29,408
公投第７案,臺南市,鹽水區,歡雅里,108,728,214,66,280,28,308
公投第７案,臺南市,鹽水區,三和里,109,214,49,13,62,18,80
公投第７案,臺南市,鹽水區,三和里,110,387,143,24,167,7,174
公投第７案,臺南市,鹽水區,三和里,111,301,96,35,131,19,150
公投第７案,臺南市,鹽水區,竹林里,112,755,192,67,259,26,285
公投第７案,臺南市,鹽水區,竹林里,113,365,92,35,127,17,144
公投第７案,臺南市,鹽水區,坔頭港里,114,935,280,80,360,30,390
公投第７案,臺南市,鹽水區,坔頭港里,115,494,148,38,186,27,213
公投第７案,臺南市,新營區,忠政里,116,1693,584,147,731,55,786
公投第７案,臺南市,新營區,忠政里,117,1561,652,162,814,54,868
公投第７案,臺南市,新營區,忠政里,118,1487,567,178,745,56,801
公投第７案,臺南市,新營區,民權里,119,1232,464,118,582,31,613
公投第７案,臺南市,新營區,民權里,120,1067,392,104,496,31,527
公投第７案,臺南市,新營區,三仙里,121,1419,452,133,585,37,622
公投第７案,臺南市,新營區,三仙里,122,1466,606,133,739,23,762
公投第７案,臺南市,新營區,永平里,123,932,393,128,521,45,566
公投第７案,臺南市,新營區,永平里,124,1099,339,112,451,29,480
公投第７案,臺南市,新營區,永平里,125,757,253,65,318,27,345
公投第７案,臺南市,新營區,大宏里,126,888,368,96,464,33,497
公投第７案,臺南市,新營區,大宏里,127,1115,398,129,527,14,541
公投第７案,臺南市,新營區,大宏里,128,937,313,92,405,23,428
公投第７案,臺南市,新營區,王公里,129,1387,486,153,639,36,675
公投第７案,臺南市,新營區,王公里,130,1526,562,148,710,43,753
公投第７案,臺南市,新營區,王公里,131,1301,539,148,687,37,724
公投第７案,臺南市,新營區,新東里,132,1538,644,157,801,64,865
公投第７案,臺南市,新營區,新東里,133,1584,657,152,809,42,851
公投第７案,臺南市,新營區,新東里,134,1583,619,239,858,37,895
公投第７案,臺南市,新營區,新東里,135,1530,628,159,787,39,826
公投第７案,臺南市,新營區,中營里,136,1193,487,148,635,47,682
公投第７案,臺南市,新營區,土庫里,137,1439,401,94,495,13,508
公投第７案,臺南市,新營區,興業里,138,1438,608,144,752,52,804
公投第７案,臺南市,新營區,興業里,139,359,137,51,188,21,209
公投第７案,臺南市,新營區,南興里,140,1233,342,116,458,31,489
公投第７案,臺南市,新營區,南興里,141,1227,394,79,473,18,491
公投第７案,臺南市,新營區,民生里,142,1320,443,91,534,29,563
公投第７案,臺南市,新營區,民生里,143,1930,564,169,733,27,760
公投第７案,臺南市,新營區,新北里,144,1501,586,146,732,55,787
公投第７案,臺南市,新營區,新北里,145,1475,555,117,672,42,714
公投第７案,臺南市,新營區,新北里,146,1753,718,157,875,54,929
公投第７案,臺南市,新營區,新南里,147,1748,646,158,804,40,844
公投第７案,臺南市,新營區,新南里,148,1741,664,169,833,45,878
公投第７案,臺南市,新營區,新南里,149,1433,531,117,648,26,674
公投第７案,臺南市,新營區,民榮里,150,1595,603,160,763,64,827
公投第７案,臺南市,新營區,民榮里,151,959,309,78,387,17,404
公投第７案,臺南市,新營區,民榮里,152,1865,644,164,808,76,884
公投第７案,臺南市,新營區,埤寮里,153,1678,552,144,696,85,781
公投第７案,臺南市,新營區,護鎮里,154,1373,450,111,561,53,614
公投第７案,臺南市,新營區,太南里,155,1431,361,130,491,23,514
公投第７案,臺南市,新營區,太南里,156,291,74,17,91,3,94
公投第７案,臺南市,新營區,太北里,157,1749,620,180,800,38,838
公投第７案,臺南市,新營區,南紙里,158,1862,616,157,773,48,821
公投第７案,臺南市,新營區,南紙里,159,1821,715,169,884,93,977
公投第７案,臺南市,新營區,嘉芳里,160,1845,616,172,788,59,847
公投第７案,臺南市,新營區,姑爺里,161,542,140,38,178,10,188
公投第７案,臺南市,新營區,姑爺里,162,402,96,30,126,8,134
公投第７案,臺南市,新營區,五興里,163,703,260,91,351,59,410
公投第７案,臺南市,新營區,五興里,164,941,286,93,379,39,418
公投第７案,臺南市,柳營區,士林里,165,1166,400,114,514,45,559
公投第７案,臺南市,柳營區,士林里,166,625,229,87,316,14,330
公投第７案,臺南市,柳營區,光福里,167,738,225,57,282,24,306
公投第７案,臺南市,柳營區,光福里,168,834,334,79,413,18,431
公投第７案,臺南市,柳營區,中埕里,169,1104,332,124,456,39,495
公投第７案,臺南市,柳營區,東昇里,170,1015,311,83,394,21,415
公投第７案,臺南市,柳營區,東昇里,171,1720,655,160,815,119,934
公投第７案,臺南市,柳營區,八翁里,172,1391,476,115,591,64,655
公投第７案,臺南市,柳營區,人和里,173,425,145,32,177,8,185
公投第７案,臺南市,柳營區,人和里,174,318,87,17,104,19,123
公投第７案,臺南市,柳營區,太康里,175,753,254,78,332,40,372
公投第７案,臺南市,柳營區,太康里,176,730,252,59,311,33,344
公投第７案,臺南市,柳營區,重溪里,177,725,247,66,313,36,349
公投第７案,臺南市,柳營區,重溪里,178,787,303,74,377,39,416
公投第７案,臺南市,柳營區,重溪里,179,297,104,36,140,30,170
公投第７案,臺南市,柳營區,篤農里,180,673,273,56,329,39,368
公投第７案,臺南市,柳營區,篤農里,181,640,244,58,302,56,358
公投第７案,臺南市,柳營區,大農里,182,660,192,63,255,26,281
公投第７案,臺南市,柳營區,神農里,183,1212,376,89,465,42,507
公投第７案,臺南市,柳營區,神農里,184,202,70,16,86,4,90
公投第７案,臺南市,柳營區,果毅里,185,1049,340,88,428,75,503
公投第７案,臺南市,柳營區,果毅里,186,158,55,12,67,2,69
公投第７案,臺南市,柳營區,旭山里,187,921,307,93,400,64,464
公投第７案,臺南市,柳營區,旭山里,188,504,155,33,188,19,207
公投第７案,臺南市,柳營區,旭山里,189,157,50,11,61,4,65
公投第７案,臺南市,北門區,永隆里,190,484,123,61,184,14,198
公投第７案,臺南市,北門區,永隆里,191,401,123,25,148,15,163
公投第７案,臺南市,北門區,北門里,192,456,119,26,145,6,151
公投第７案,臺南市,北門區,北門里,193,382,152,33,185,15,200
公投第７案,臺南市,北門區,玉港里,194,356,124,31,155,20,175
公投第７案,臺南市,北門區,玉港里,195,389,99,29,128,6,134
公投第７案,臺南市,北門區,保吉里,196,742,227,55,282,5,287
公投第７案,臺南市,北門區,保吉里,197,599,179,39,218,11,229
公投第７案,臺南市,北門區,蚵寮里,198,594,174,46,220,23,243
公投第７案,臺南市,北門區,蚵寮里,199,572,173,46,219,25,244
公投第７案,臺南市,北門區,蚵寮里,200,318,68,22,90,4,94
公投第７案,臺南市,北門區,雙春里,201,473,128,34,162,13,175
公投第７案,臺南市,北門區,錦湖里,202,954,213,50,263,17,280
公投第７案,臺南市,北門區,慈安里,203,737,294,56,350,38,388
公投第７案,臺南市,北門區,三光里,204,679,157,44,201,16,217
公投第７案,臺南市,北門區,三光里,205,521,126,42,168,28,196
公投第７案,臺南市,北門區,文山里,206,632,150,41,191,16,207
公投第７案,臺南市,北門區,文山里,207,636,162,34,196,14,210
公投第７案,臺南市,學甲區,秀昌里,208,862,299,121,420,59,479
公投第７案,臺南市,學甲區,秀昌里,209,611,237,87,324,10,334
公投第７案,臺南市,學甲區,秀昌里,210,936,334,109,443,29,472
公投第７案,臺南市,學甲區,明宜里,211,1066,350,120,470,31,501
公投第７案,臺南市,學甲區,明宜里,212,869,337,110,447,31,478
公投第７案,臺南市,學甲區,慈福里,213,635,232,58,290,35,325
公投第７案,臺南市,學甲區,慈福里,214,822,288,57,345,21,366
公投第７案,臺南市,學甲區,慈福里,215,443,134,33,167,18,185
公投第７案,臺南市,學甲區,仁得里,216,1370,517,133,650,36,686
公投第７案,臺南市,學甲區,仁得里,217,1117,402,146,548,54,602
公投第７案,臺南市,學甲區,仁得里,218,1365,476,126,602,78,680
公投第７案,臺南市,學甲區,新達里,219,1489,514,128,642,72,714
公投第７案,臺南市,學甲區,新達里,220,627,156,54,210,42,252
公投第７案,臺南市,學甲區,新榮里,221,1052,367,86,453,47,500
公投第７案,臺南市,學甲區,新榮里,222,1183,423,104,527,21,548
公投第７案,臺南市,學甲區,大灣里,223,979,285,79,364,27,391
公投第７案,臺南市,學甲區,豐和里,224,1241,364,123,487,66,553
公投第７案,臺南市,學甲區,中洲里,225,843,242,48,290,23,313
公投第７案,臺南市,學甲區,中洲里,226,580,189,55,244,35,279
公投第７案,臺南市,學甲區,光華里,227,832,227,44,271,19,290
公投第７案,臺南市,學甲區,光華里,228,406,89,48,137,5,142
公投第７案,臺南市,學甲區,宅港里,229,818,301,81,382,42,424
公投第７案,臺南市,學甲區,平和里,230,1052,281,81,362,17,379
公投第７案,臺南市,學甲區,三慶里,231,578,161,55,216,11,227
公投第７案,臺南市,學甲區,三慶里,232,430,105,39,144,23,167
公投第７案,臺南市,學甲區,三慶里,233,361,134,20,154,10,164
公投第７案,臺南市,將軍區,長榮里,234,1110,420,130,550,70,620
公投第７案,臺南市,將軍區,西甲里,235,1418,481,117,598,25,623
公投第７案,臺南市,將軍區,西甲里,236,969,326,80,406,19,425
公投第７案,臺南市,將軍區,忠嘉里,237,519,205,58,263,36,299
公投第７案,臺南市,將軍區,忠嘉里,238,1106,358,127,485,16,501
公投第７案,臺南市,將軍區,忠嘉里,239,542,170,55,225,42,267
公投第７案,臺南市,將軍區,忠嘉里,240,315,81,24,105,11,116
公投第７案,臺南市,將軍區,苓仔寮里,241,584,79,38,117,20,137
公投第７案,臺南市,將軍區,苓仔寮里,242,398,136,31,167,7,174
公投第７案,臺南市,將軍區,苓仔寮里,243,608,168,41,209,13,222
公投第７案,臺南市,將軍區,苓仔寮里,244,442,150,49,199,15,214
公投第７案,臺南市,將軍區,巷埔里,245,650,155,49,204,11,215
公投第７案,臺南市,將軍區,巷埔里,246,573,132,35,167,14,181
公投第７案,臺南市,將軍區,將軍里,247,617,155,40,195,9,204
公投第７案,臺南市,將軍區,將軍里,248,573,181,47,228,29,257
公投第７案,臺南市,將軍區,將軍里,249,434,150,38,188,24,212
公投第７案,臺南市,將軍區,玉山里,250,849,228,58,286,14,300
公投第７案,臺南市,將軍區,廣山里,251,645,179,46,225,28,253
公投第７案,臺南市,將軍區,長沙里,252,690,172,44,216,27,243
公投第７案,臺南市,將軍區,長沙里,253,663,145,32,177,7,184
公投第７案,臺南市,將軍區,平沙里,254,1175,300,73,373,29,402
公投第７案,臺南市,將軍區,鯤鯓里,255,837,201,44,245,28,273
公投第７案,臺南市,將軍區,鯤鯓里,256,1061,339,102,441,115,556
公投第７案,臺南市,將軍區,鯤溟里,257,976,233,48,281,22,303
公投第７案,臺南市,七股區,後港里,258,534,166,42,208,15,223
公投第７案,臺南市,七股區,後港里,259,508,178,60,238,14,252
公投第７案,臺南市,七股區,大潭里,260,665,161,34,195,5,200
公投第７案,臺南市,七股區,篤加里,261,834,256,55,311,21,332
公投第７案,臺南市,七股區,頂山里,262,810,226,54,280,16,296
公投第７案,臺南市,七股區,西寮里,263,480,114,29,143,7,150
公投第７案,臺南市,七股區,塩埕里,264,445,122,26,148,4,152
公投第７案,臺南市,七股區,中寮里,265,680,130,38,168,10,178
公投第７案,臺南市,七股區,龍山里,266,838,192,44,236,9,245
公投第７案,臺南市,七股區,龍山里,267,780,183,45,228,18,246
公投第７案,臺南市,七股區,溪南里,268,350,133,32,165,17,182
公投第７案,臺南市,七股區,七股里,269,907,349,106,455,62,517
公投第７案,臺南市,七股區,玉成里,270,780,239,57,296,16,312
公投第７案,臺南市,七股區,大埕里,271,1658,518,116,634,40,674
公投第７案,臺南市,七股區,大埕里,272,913,280,67,347,32,379
公投第７案,臺南市,七股區,樹林里,273,1202,428,107,535,54,589
公投第７案,臺南市,七股區,樹林里,274,696,194,36,230,6,236
公投第７案,臺南市,七股區,竹橋里,275,647,210,61,271,32,303
公投第７案,臺南市,七股區,竹橋里,276,622,269,68,337,48,385
公投第７案,臺南市,七股區,義合里,277,1175,459,122,581,86,667
公投第７案,臺南市,七股區,義合里,278,698,215,64,279,21,300
公投第７案,臺南市,七股區,永吉里,279,983,340,102,442,66,508
公投第７案,臺南市,七股區,三股里,280,1366,323,116,439,38,477
公投第７案,臺南市,七股區,十份里,281,1379,403,120,523,78,601
公投第７案,臺南市,佳里區,東寧里,282,1391,532,171,703,67,770
公投第７案,臺南市,佳里區,東寧里,283,829,351,99,450,32,482
公投第７案,臺南市,佳里區,忠仁里,284,1401,465,125,590,20,610
公投第７案,臺南市,佳里區,忠仁里,285,1452,471,108,579,19,598
公投第７案,臺南市,佳里區,鎮山里,286,1382,527,148,675,58,733
公投第７案,臺南市,佳里區,鎮山里,287,1463,560,133,693,73,766
公投第７案,臺南市,佳里區,鎮山里,288,1280,460,110,570,41,611
公投第７案,臺南市,佳里區,鎮山里,289,1486,574,162,736,68,804
公投第７案,臺南市,佳里區,安西里,290,1378,531,153,684,70,754
公投第７案,臺南市,佳里區,安西里,291,1505,578,161,739,60,799
公投第７案,臺南市,佳里區,安西里,292,1860,717,160,877,88,965
公投第７案,臺南市,佳里區,安西里,293,1134,451,112,563,70,633
公投第７案,臺南市,佳里區,文新里,294,1426,545,151,696,64,760
公投第７案,臺南市,佳里區,文新里,295,1779,706,160,866,59,925
公投第７案,臺南市,佳里區,文新里,296,1906,796,181,977,59,1036
公投第７案,臺南市,佳里區,建南里,297,1425,517,139,656,48,704
公投第７案,臺南市,佳里區,建南里,298,1255,488,121,609,46,655
公投第７案,臺南市,佳里區,建南里,299,1524,532,136,668,73,741
公投第７案,臺南市,佳里區,南勢里,300,1631,612,156,768,45,813
公投第７案,臺南市,佳里區,南勢里,301,1546,685,148,833,29,862
公投第７案,臺南市,佳里區,南勢里,302,1187,534,126,660,42,702
公投第７案,臺南市,佳里區,六安里,303,1381,532,133,665,41,706
公投第７案,臺南市,佳里區,六安里,304,1364,507,129,636,16,652
公投第７案,臺南市,佳里區,六安里,305,1314,496,153,649,27,676
公投第７案,臺南市,佳里區,佳化里,306,1164,441,137,578,55,633
公投第７案,臺南市,佳里區,佳化里,307,961,352,110,462,50,512
公投第７案,臺南市,佳里區,佳興里,308,1218,520,18,538,47,585
公投第７案,臺南市,佳里區,佳興里,309,919,338,112,450,19,469
公投第７案,臺南市,佳里區,營溪里,310,689,254,65,319,25,344
公投第７案,臺南市,佳里區,營溪里,311,383,110,48,158,10,168
公投第７案,臺南市,佳里區,海澄里,312,1507,502,160,662,51,713
公投第７案,臺南市,佳里區,海澄里,313,702,244,63,307,37,344
公投第７案,臺南市,佳里區,下營里,314,907,355,98,453,42,495
公投第７案,臺南市,佳里區,下營里,315,937,380,125,505,45,550
公投第７案,臺南市,佳里區,塭內里,316,1030,401,135,536,10,546
公投第７案,臺南市,佳里區,塭內里,317,981,358,100,458,45,503
公投第７案,臺南市,佳里區,塭內里,318,787,267,59,326,22,348
公投第７案,臺南市,佳里區,民安里,319,1513,566,120,686,73,759
公投第７案,臺南市,佳里區,子龍里,320,714,216,54,270,19,289
公投第７案,臺南市,佳里區,子龍里,321,745,253,75,328,40,368
公投第７案,臺南市,佳里區,子龍里,322,951,283,106,389,28,417
公投第７案,臺南市,西港區,西港里,323,933,342,81,423,18,441
公投第７案,臺南市,西港區,西港里,324,901,321,115,436,22,458
公投第７案,臺南市,西港區,西港里,325,1314,448,114,562,23,585
公投第７案,臺南市,西港區,慶安里,326,1349,486,133,619,71,690
公投第７案,臺南市,西港區,慶安里,327,1014,398,116,514,45,559
公投第７案,臺南市,西港區,慶安里,328,1900,538,126,664,36,700
公投第７案,臺南市,西港區,南海里,329,1663,537,132,669,53,722
公投第７案,臺南市,西港區,南海里,330,738,203,78,281,13,294
公投第７案,臺南市,西港區,港東里,331,1211,483,110,593,52,645
公投第７案,臺南市,西港區,港東里,332,382,114,40,154,25,179
公投第７案,臺南市,西港區,檨林里,333,786,246,66,312,14,326
公投第７案,臺南市,西港區,檨林里,334,838,274,71,345,15,360
公投第７案,臺南市,西港區,後營里,335,1449,409,116,525,41,566
公投第７案,臺南市,西港區,營西里,336,1479,429,106,535,24,559
公投第７案,臺南市,西港區,金砂里,337,763,287,65,352,68,420
公投第７案,臺南市,西港區,劉厝里,338,1297,386,110,496,24,520
公投第７案,臺南市,西港區,竹林里,339,1393,433,130,563,34,597
公投第７案,臺南市,西港區,永樂里,340,958,257,77,334,16,350
公投第７案,臺南市,西港區,永樂里,341,391,147,34,181,19,200
公投第７案,臺南市,西港區,新復里,342,805,291,78,369,52,421
公投第７案,臺南市,下營區,下營里,343,1558,452,119,571,46,617
公投第７案,臺南市,下營區,仁里里,344,1112,298,96,394,27,421
公投第７案,臺南市,下營區,仁里里,345,893,288,76,364,58,422
公投第７案,臺南市,下營區,宅內里,346,1623,464,125,589,49,638
公投第７案,臺南市,下營區,後街里,347,1568,529,147,676,86,762
公投第７案,臺南市,下營區,新興里,348,985,356,99,455,50,505
公投第７案,臺南市,下營區,新興里,349,953,318,59,377,18,395
公投第７案,臺南市,下營區,營前里,350,1031,335,92,427,29,456
公投第７案,臺南市,下營區,營前里,351,1077,404,124,528,67,595
公投第７案,臺南市,下營區,大吉里,352,703,182,63,245,35,280
公投第７案,臺南市,下營區,大吉里,353,854,252,66,318,21,339
公投第７案,臺南市,下營區,茅營里,354,1164,398,111,509,45,554
公投第７案,臺南市,下營區,茅營里,355,1091,339,88,427,20,447
公投第７案,臺南市,下營區,開化里,356,959,346,82,428,61,489
公投第７案,臺南市,下營區,開化里,357,935,321,74,395,30,425
公投第７案,臺南市,下營區,西連里,358,893,319,85,404,43,447
公投第７案,臺南市,下營區,賀建里,359,1293,476,114,590,77,667
公投第７案,臺南市,下營區,紅甲里,360,1185,385,139,524,102,626
公投第７案,臺南市,下營區,紅甲里,361,1070,272,68,340,18,358
公投第７案,臺南市,六甲區,六甲里,362,819,309,102,411,53,464
公投第７案,臺南市,六甲區,六甲里,363,645,227,66,293,21,314
公投第７案,臺南市,六甲區,六甲里,364,1444,476,118,594,47,641
公投第７案,臺南市,六甲區,甲東里,365,1554,441,128,569,59,628
公投第７案,臺南市,六甲區,甲東里,366,1171,345,91,436,45,481
公投第７案,臺南市,六甲區,甲南里,367,1351,437,144,581,66,647
公投第７案,臺南市,六甲區,七甲里,368,1010,290,107,397,68,465
公投第７案,臺南市,六甲區,七甲里,369,919,297,75,372,60,432
公投第７案,臺南市,六甲區,二甲里,370,1369,443,139,582,68,650
公投第７案,臺南市,六甲區,二甲里,371,976,347,96,443,57,500
公投第７案,臺南市,六甲區,二甲里,372,1015,373,126,499,57,556
公投第７案,臺南市,六甲區,水林里,373,1176,365,117,482,30,512
公投第７案,臺南市,六甲區,水林里,374,939,317,109,426,54,480
公投第７案,臺南市,六甲區,中社里,375,712,236,88,324,45,369
公投第７案,臺南市,六甲區,中社里,376,881,324,91,415,42,457
公投第７案,臺南市,六甲區,龜港里,377,1184,486,146,632,58,690
公投第７案,臺南市,六甲區,菁埔里,378,599,237,91,328,34,362
公投第７案,臺南市,六甲區,王爺里,379,759,164,45,209,11,220
公投第７案,臺南市,六甲區,大丘里,380,621,160,55,215,29,244
公投第７案,臺南市,麻豆區,新興里,381,1205,419,130,549,47,596
公投第７案,臺南市,麻豆區,新興里,382,660,246,85,331,37,368
公投第７案,臺南市,麻豆區,巷口里,383,523,174,83,257,15,272
公投第７案,臺南市,麻豆區,巷口里,384,1597,564,173,737,37,774
公投第７案,臺南市,麻豆區,東角里,385,1262,490,158,648,53,701
公投第７案,臺南市,麻豆區,東角里,386,1325,526,171,697,43,740
公投第７案,臺南市,麻豆區,晋江里,387,1384,483,141,624,31,655
公投第７案,臺南市,麻豆區,晋江里,388,1121,395,139,534,21,555
公投第７案,臺南市,麻豆區,中興里,389,1021,328,125,453,15,468
公投第７案,臺南市,麻豆區,中興里,390,954,314,111,425,36,461
公投第７案,臺南市,麻豆區,興農里,391,1513,442,158,600,32,632
公投第７案,臺南市,麻豆區,油車里,392,1726,536,156,692,41,733
公投第７案,臺南市,麻豆區,油車里,393,1804,664,162,826,60,886
公投第７案,臺南市,麻豆區,北勢里,394,1106,338,130,468,26,494
公投第７案,臺南市,麻豆區,大埕里,395,1503,520,163,683,44,727
公投第７案,臺南市,麻豆區,大埕里,396,1302,468,140,608,49,657
公投第７案,臺南市,麻豆區,清水里,397,645,223,62,285,14,299
公投第７案,臺南市,麻豆區,清水里,398,777,311,103,414,23,437
公投第７案,臺南市,麻豆區,南勢里,399,1612,519,157,676,39,715
公投第７案,臺南市,麻豆區,南勢里,400,718,222,57,279,15,294
公投第７案,臺南市,麻豆區,寮廍里,401,1656,496,143,639,22,661
公投第７案,臺南市,麻豆區,埤頭里,402,1355,458,135,593,69,662
公投第７案,臺南市,麻豆區,埤頭里,403,977,274,61,335,28,363
公投第７案,臺南市,麻豆區,海埔里,404,1012,305,97,402,33,435
公投第７案,臺南市,麻豆區,海埔里,405,626,230,73,303,21,324
公投第７案,臺南市,麻豆區,海埔里,406,467,100,28,128,4,132
公投第７案,臺南市,麻豆區,港尾里,407,1260,394,126,520,19,539
公投第７案,臺南市,麻豆區,麻口里,408,1111,396,118,514,41,555
公投第７案,臺南市,麻豆區,安業里,409,550,207,62,269,16,285
公投第７案,臺南市,麻豆區,安業里,410,798,267,98,365,38,403
公投第７案,臺南市,麻豆區,謝厝寮里,411,852,343,89,432,75,507
公投第７案,臺南市,麻豆區,謝厝寮里,412,830,240,65,305,11,316
公投第７案,臺南市,麻豆區,安正里,413,941,286,78,364,13,377
公投第７案,臺南市,麻豆區,井東里,414,1158,400,125,525,33,558
公投第７案,臺南市,麻豆區,井東里,415,612,190,60,250,9,259
公投第７案,臺南市,官田區,官田里,416,1104,345,108,453,13,466
公投第７案,臺南市,官田區,官田里,417,965,328,101,429,45,474
公投第７案,臺南市,官田區,二鎮里,418,1402,498,138,636,41,677
公投第７案,臺南市,官田區,二鎮里,419,1653,607,207,814,90,904
公投第７案,臺南市,官田區,烏山頭里,420,966,281,104,385,51,436
公投第７案,臺南市,官田區,烏山頭里,421,284,77,31,108,14,122
公投第７案,臺南市,官田區,大崎里,422,402,84,20,104,5,109
公投第７案,臺南市,官田區,隆田里,423,982,344,109,453,8,461
公投第７案,臺南市,官田區,隆田里,424,975,285,91,376,27,403
公投第７案,臺南市,官田區,隆本里,425,802,272,87,359,39,398
公投第７案,臺南市,官田區,隆本里,426,1118,424,119,543,51,594
公投第７案,臺南市,官田區,隆本里,427,1455,510,146,656,30,686
公投第７案,臺南市,官田區,南廍里,428,1208,425,131,556,30,586
公投第７案,臺南市,官田區,東西庄里,429,1293,382,135,517,59,576
公投第７案,臺南市,官田區,東西庄里,430,607,169,51,220,19,239
公投第７案,臺南市,官田區,渡拔里,431,501,156,49,205,34,239
公投第７案,臺南市,官田區,渡拔里,432,728,262,80,342,54,396
公投第７案,臺南市,官田區,渡拔里,433,842,258,102,360,16,376
公投第７案,臺南市,官田區,渡拔里,434,515,170,67,237,38,275
公投第７案,臺南市,官田區,社子里,435,873,250,59,309,17,326
公投第７案,臺南市,大內區,石湖里,436,759,208,64,272,52,324
公投第７案,臺南市,大內區,石湖里,437,262,66,15,81,2,83
公投第７案,臺南市,大內區,石林里,438,646,163,33,196,14,210
公投第７案,臺南市,大內區,石城里,439,1473,412,101,513,70,583
公投第７案,臺南市,大內區,內江里,440,915,352,71,423,68,491
公投第７案,臺南市,大內區,大內里,441,779,302,90,392,36,428
公投第７案,臺南市,大內區,內郭里,442,637,258,77,335,53,388
公投第７案,臺南市,大內區,頭社里,443,993,289,93,382,35,417
公投第７案,臺南市,大內區,環湖里,444,766,307,64,371,38,409
公投第７案,臺南市,大內區,二溪里,445,841,318,55,373,37,410
公投第７案,臺南市,大內區,曲溪里,446,583,193,45,238,45,283
公投第７案,臺南市,楠西區,楠西里,447,978,335,94,429,47,476
公投第７案,臺南市,楠西區,楠西里,448,870,334,95,429,44,473
公投第７案,臺南市,楠西區,灣丘里,449,1160,244,79,323,11,334
公投第７案,臺南市,楠西區,密枝里,450,699,207,53,260,23,283
公投第７案,臺南市,楠西區,照興里,451,990,266,55,321,14,335
公投第７案,臺南市,楠西區,鹿田里,452,928,297,72,369,25,394
公投第７案,臺南市,楠西區,龜丹里,453,660,219,44,263,47,310
公投第７案,臺南市,楠西區,東勢里,454,1187,388,115,503,72,575
公投第７案,臺南市,楠西區,東勢里,455,1056,357,89,446,29,475
公投第７案,臺南市,南化區,南化里,456,690,252,72,324,42,366
公投第７案,臺南市,南化區,南化里,457,695,252,76,328,53,381
公投第７案,臺南市,南化區,小崙里,458,806,248,71,319,39,358
公投第７案,臺南市,南化區,東和里,459,654,191,38,229,40,269
公投第７案,臺南市,南化區,西埔里,460,783,198,53,251,31,282
公投第７案,臺南市,南化區,中坑里,461,425,135,48,183,22,205
公投第７案,臺南市,南化區,北平里,462,559,196,48,244,30,274
公投第７案,臺南市,南化區,北寮里,463,1189,359,84,443,25,468
公投第７案,臺南市,南化區,玉山里,464,1044,381,112,493,34,527
公投第７案,臺南市,南化區,關山里,465,941,369,92,461,27,488
公投第７案,臺南市,玉井區,玉井里,466,1242,444,104,548,28,576
公投第７案,臺南市,玉井區,玉田里,467,1141,447,99,546,42,588
公投第７案,臺南市,玉井區,玉田里,468,698,234,66,300,21,321
公投第７案,臺南市,玉井區,玉田里,469,849,298,84,382,22,404
公投第７案,臺南市,玉井區,玉田里,470,949,391,67,458,48,506
公投第７案,臺南市,玉井區,中正里,471,618,229,54,283,18,301
公投第７案,臺南市,玉井區,中正里,472,594,184,41,225,4,229
公投第７案,臺南市,玉井區,竹圍里,473,927,291,73,364,9,373
公投第７案,臺南市,玉井區,竹圍里,474,512,188,36,224,47,271
公投第７案,臺南市,玉井區,沙田里,475,509,167,44,211,31,242
公投第７案,臺南市,玉井區,三埔里,476,496,187,53,240,20,260
公投第７案,臺南市,玉井區,三和里,477,759,242,68,310,9,319
公投第７案,臺南市,玉井區,望明里,478,669,180,48,228,11,239
公投第７案,臺南市,玉井區,望明里,479,787,255,60,315,68,383
公投第７案,臺南市,玉井區,層林里,480,620,179,62,241,40,281
公投第７案,臺南市,玉井區,豐里里,481,987,362,87,449,52,501
公投第７案,臺南市,左鎮區,光和里,482,392,133,31,164,23,187
公投第７案,臺南市,左鎮區,榮和里,483,644,250,43,293,42,335
公投第７案,臺南市,左鎮區,左鎮里,484,468,128,36,164,18,182
公投第７案,臺南市,左鎮區,中正里,485,753,198,66,264,48,312
公投第７案,臺南市,左鎮區,睦光里,486,345,102,27,129,28,157
公投第７案,臺南市,左鎮區,內庄里,487,393,120,30,150,15,165
公投第７案,臺南市,左鎮區,岡林里,488,420,126,32,158,14,172
公投第７案,臺南市,左鎮區,草山里,489,313,82,25,107,8,115
公投第７案,臺南市,左鎮區,二寮里,490,186,48,11,59,5,64
公投第７案,臺南市,左鎮區,澄山里,491,504,128,47,175,45,220
公投第７案,臺南市,善化區,東關里,492,1132,355,106,461,31,492
公投第７案,臺南市,善化區,坐駕里,493,1845,642,199,841,66,907
公投第７案,臺南市,善化區,坐駕里,494,2090,746,207,953,95,1048
公投第７案,臺南市,善化區,光文里,495,1582,645,146,791,80,871
公投第７案,臺南市,善化區,光文里,496,1901,734,229,963,78,1041
公投第７案,臺南市,善化區,光文里,497,1818,657,193,850,61,911
公投第７案,臺南市,善化區,文昌里,498,1639,604,183,787,71,858
公投第７案,臺南市,善化區,文昌里,499,1061,422,130,552,42,594
公投第７案,臺南市,善化區,南關里,500,1786,685,190,875,105,980
公投第７案,臺南市,善化區,頂街里,501,1147,425,121,546,34,580
公投第７案,臺南市,善化區,文正里,502,1581,541,174,715,72,787
公投第７案,臺南市,善化區,胡家里,503,1240,405,154,559,94,653
公投第７案,臺南市,善化區,胡厝里,504,1743,458,166,624,26,650
公投第７案,臺南市,善化區,什乃里,505,1246,479,163,642,51,693
公投第７案,臺南市,善化區,溪美里,506,961,314,117,431,27,458
公投第７案,臺南市,善化區,溪美里,507,938,312,97,409,13,422
公投第７案,臺南市,善化區,六分里,508,722,246,80,326,17,343
公投第７案,臺南市,善化區,六德里,509,1062,339,89,428,21,449
公投第７案,臺南市,善化區,田寮里,510,1715,608,162,770,91,861
公投第７案,臺南市,善化區,昌隆里,511,1120,368,115,483,54,537
公投第７案,臺南市,善化區,昌隆里,512,865,283,105,388,41,429
公投第７案,臺南市,善化區,牛庄里,513,1574,559,194,753,63,816
公投第７案,臺南市,善化區,嘉北里,514,1535,487,135,622,70,692
公投第７案,臺南市,善化區,嘉南里,515,1106,378,139,517,61,578
公投第７案,臺南市,善化區,小新里,516,1402,457,151,608,40,648
公投第７案,臺南市,善化區,小新里,517,1458,587,198,785,83,868
公投第７案,臺南市,善化區,小新里,518,1380,462,129,591,45,636
公投第７案,臺南市,善化區,蓮潭里,519,1232,488,145,633,9,642
公投第７案,臺南市,善化區,蓮潭里,520,1069,448,115,563,12,575
公投第７案,臺南市,安定區,蘇林里,521,1251,527,155,682,84,766
公投第７案,臺南市,安定區,蘇林里,522,899,332,102,434,39,473
公投第７案,臺南市,安定區,蘇厝里,523,1106,398,122,520,82,602
公投第７案,臺南市,安定區,蘇厝里,524,948,352,118,470,55,525
公投第７案,臺南市,安定區,安定里,525,1442,479,156,635,31,666
公投第７案,臺南市,安定區,安加里,526,1385,449,149,598,44,642
公投第７案,臺南市,安定區,安加里,527,801,325,83,408,51,459
公投第７案,臺南市,安定區,港尾里,528,736,234,68,302,32,334
公投第７案,臺南市,安定區,港尾里,529,781,287,76,363,38,401
公投第７案,臺南市,安定區,中榮里,530,795,302,92,394,20,414
公投第７案,臺南市,安定區,中榮里,531,862,371,93,464,40,504
公投第７案,臺南市,安定區,港口里,532,1487,531,132,663,31,694
公投第７案,臺南市,安定區,港口里,533,1385,519,128,647,26,673
公投第７案,臺南市,安定區,港南里,534,1518,473,166,639,33,672
公投第７案,臺南市,安定區,港南里,535,1094,450,124,574,62,636
公投第７案,臺南市,安定區,嘉同里,536,1590,562,203,765,117,882
公投第７案,臺南市,安定區,嘉同里,537,754,302,82,384,35,419
公投第７案,臺南市,安定區,中沙里,538,716,275,83,358,44,402
公投第７案,臺南市,安定區,新吉里,539,1492,580,170,750,63,813
公投第７案,臺南市,安定區,新吉里,540,943,373,93,466,49,515
公投第７案,臺南市,安定區,海寮里,541,1157,438,104,542,32,574
公投第７案,臺南市,安定區,海寮里,542,1384,508,148,656,111,767
公投第７案,臺南市,安定區,文科里,543,967,364,107,471,50,521
公投第７案,臺南市,安定區,文科里,544,611,244,47,291,30,321
公投第７案,臺南市,新市區,新市里,545,960,344,84,428,22,450
公投第７案,臺南市,新市區,新市里,546,1118,460,146,606,45,651
公投第７案,臺南市,新市區,新市里,547,850,308,83,391,23,414
公投第７案,臺南市,新市區,新和里,548,1241,484,113,597,64,661
公投第７案,臺南市,新市區,新和里,549,1297,505,155,660,40,700
公投第７案,臺南市,新市區,新和里,550,962,418,80,498,43,541
公投第７案,臺南市,新市區,新和里,551,1237,392,248,640,57,697
公投第７案,臺南市,新市區,新和里,552,1326,512,149,661,49,710
公投第７案,臺南市,新市區,社內里,553,1211,476,154,630,64,694
公投第７案,臺南市,新市區,社內里,554,1305,450,159,609,46,655
公投第７案,臺南市,新市區,大洲里,555,688,239,76,315,61,376
公投第７案,臺南市,新市區,豐華里,556,911,356,121,477,35,512
公投第７案,臺南市,新市區,三舍里,557,1525,515,157,672,45,717
公投第７案,臺南市,新市區,大營里,558,1091,336,76,412,3,415
公投第７案,臺南市,新市區,大營里,559,1122,429,113,542,21,563
公投第７案,臺南市,新市區,大營里,560,1049,372,104,476,26,502
公投第７案,臺南市,新市區,大社里,561,1564,479,145,624,27,651
公投第７案,臺南市,新市區,大社里,562,1515,597,155,752,56,808
公投第７案,臺南市,新市區,大社里,563,1378,492,142,634,32,666
公投第７案,臺南市,新市區,潭頂里,564,827,364,91,455,59,514
公投第７案,臺南市,新市區,潭頂里,565,960,401,121,522,87,609
公投第７案,臺南市,新市區,港墘里,566,951,340,102,442,56,498
公投第７案,臺南市,新市區,港墘里,567,1264,369,258,627,69,696
公投第７案,臺南市,新市區,港墘里,568,1173,440,130,570,26,596
公投第７案,臺南市,新市區,永就里,569,684,269,93,362,21,383
公投第７案,臺南市,新市區,永就里,570,1055,452,121,573,74,647
公投第７案,臺南市,新市區,永就里,571,1122,497,135,632,52,684
公投第７案,臺南市,山上區,明和里,572,855,240,58,298,60,358
公投第７案,臺南市,山上區,明和里,573,836,221,57,278,37,315
公投第７案,臺南市,山上區,南洲里,574,753,239,87,326,39,365
公投第７案,臺南市,山上區,南洲里,575,788,257,73,330,43,373
公投第７案,臺南市,山上區,山上里,576,984,364,84,448,42,490
公投第７案,臺南市,山上區,新莊里,577,972,283,93,376,10,386
公投第７案,臺南市,山上區,玉峯里,578,553,124,28,152,5,157
公投第７案,臺南市,山上區,平陽里,579,378,111,25,136,5,141
公投第７案,臺南市,山上區,豐德里,580,392,121,37,158,23,181
公投第７案,臺南市,新化區,武安里,581,746,340,74,414,38,452
公投第７案,臺南市,新化區,武安里,582,1102,458,149,607,43,650
公投第７案,臺南市,新化區,武安里,583,370,154,37,191,23,214
公投第７案,臺南市,新化區,武安里,584,947,381,111,492,75,567
公投第７案,臺南市,新化區,東榮里,585,1154,436,110,546,64,610
公投第７案,臺南市,新化區,東榮里,586,1082,424,120,544,63,607
公投第７案,臺南市,新化區,東榮里,587,1075,432,116,548,63,611
公投第７案,臺南市,新化區,東榮里,588,640,248,63,311,26,337
公投第７案,臺南市,新化區,護國里,589,410,138,42,180,19,199
公投第７案,臺南市,新化區,護國里,590,533,196,46,242,28,270
公投第７案,臺南市,新化區,護國里,591,836,310,91,401,26,427
公投第７案,臺南市,新化區,護國里,592,978,303,83,386,32,418
公投第７案,臺南市,新化區,太平里,593,1348,497,157,654,50,704
公投第７案,臺南市,新化區,太平里,594,1015,388,98,486,49,535
公投第７案,臺南市,新化區,太平里,595,1228,425,106,531,35,566
公投第７案,臺南市,新化區,太平里,596,789,311,93,404,48,452
公投第７案,臺南市,新化區,協興里,597,1022,365,114,479,24,503
公投第７案,臺南市,新化區,協興里,598,1021,365,85,450,27,477
公投第７案,臺南市,新化區,協興里,599,1229,499,142,641,65,706
公投第７案,臺南市,新化區,唪口里,600,1153,435,118,553,22,575
公投第７案,臺南市,新化區,唪口里,601,1012,295,81,376,22,398
公投第７案,臺南市,新化區,北勢里,602,1458,576,141,717,76,793
公投第７案,臺南市,新化區,豐榮里,603,1645,657,183,840,68,908
公投第７案,臺南市,新化區,豐榮里,604,1016,415,109,524,62,586
公投第７案,臺南市,新化區,豐榮里,605,559,204,52,256,11,267
公投第７案,臺南市,新化區,全興里,606,1222,503,136,639,37,676
公投第７案,臺南市,新化區,全興里,607,1562,679,173,852,65,917
公投第７案,臺南市,新化區,崙頂里,608,994,327,83,410,38,448
公投第７案,臺南市,新化區,崙頂里,609,1013,362,107,469,92,561
公投第７案,臺南市,新化區,知義里,610,1197,446,150,596,75,671
公投第７案,臺南市,新化區,知義里,611,1021,336,121,457,51,508
公投第７案,臺南市,新化區,山脚里,612,1428,457,108,565,81,646
公投第７案,臺南市,新化區,大坑里,613,456,138,44,182,33,215
公投第７案,臺南市,新化區,𦰡拔里,614,1037,399,118,517,59,576
公投第７案,臺南市,新化區,𦰡拔里,615,1097,417,117,534,78,612
公投第７案,臺南市,新化區,羊林里,616,902,330,109,439,58,497
公投第７案,臺南市,新化區,礁坑里,617,999,322,93,415,93,508
公投第７案,臺南市,安南區,東和里,618,2549,983,270,1253,47,1300
公投第７案,臺南市,安南區,󻕯南里,619,2321,826,239,1065,73,1138
公投第７案,臺南市,安南區,󻕯南里,620,2156,878,239,1117,73,1190
公投第７案,臺南市,安南區,州南里,621,1662,680,208,888,81,969
公投第７案,臺南市,安南區,州南里,622,1512,603,164,767,106,873
公投第７案,臺南市,安南區,州南里,623,1625,575,174,749,72,821
公投第７案,臺南市,安南區,安順里,624,2143,698,196,894,50,944
公投第７案,臺南市,安南區,安順里,625,2457,977,255,1232,94,1326
公投第７案,臺南市,安南區,州北里,626,2148,838,251,1089,109,1198
公投第７案,臺南市,安南區,州北里,627,2364,875,255,1130,95,1225
公投第７案,臺南市,安南區,新順里,628,1868,640,181,821,44,865
公投第７案,臺南市,安南區,新順里,629,1797,768,196,964,79,1043
公投第７案,臺南市,安南區,新順里,630,2268,916,245,1161,63,1224
公投第７案,臺南市,安南區,頂安里,631,2291,728,200,928,82,1010
公投第７案,臺南市,安南區,頂安里,632,2255,848,217,1065,79,1144
公投第７案,臺南市,安南區,安慶里,633,1940,640,212,852,81,933
公投第７案,臺南市,安南區,安慶里,634,2013,767,228,995,44,1039
公投第７案,臺南市,安南區,安慶里,635,2024,772,190,962,77,1039
公投第７案,臺南市,安南區,溪北里,636,1613,670,218,888,92,980
公投第７案,臺南市,安南區,溪北里,637,1178,426,121,547,41,588
公投第７案,臺南市,安南區,安和里,638,2143,802,232,1034,80,1114
公投第７案,臺南市,安南區,安西里,639,1721,635,236,871,93,964
公投第７案,臺南市,安南區,安西里,640,1773,729,203,932,74,1006
公投第７案,臺南市,安南區,溪頂里,641,1428,538,159,697,25,722
公投第７案,臺南市,安南區,溪頂里,642,1626,635,189,824,67,891
公投第７案,臺南市,安南區,溪頂里,643,1358,509,163,672,59,731
公投第７案,臺南市,安南區,安東里,644,1447,628,155,783,58,841
公投第７案,臺南市,安南區,安東里,645,1358,537,148,685,86,771
公投第７案,臺南市,安南區,鳳凰里,646,2116,714,227,941,60,1001
公投第７案,臺南市,安南區,鳳凰里,647,2321,794,223,1017,47,1064
公投第７案,臺南市,安南區,梅花里,648,2117,773,193,966,49,1015
公投第７案,臺南市,安南區,梅花里,649,1927,649,229,878,73,951
公投第７案,臺南市,安南區,理想里,650,2242,765,235,1000,142,1142
公投第７案,臺南市,安南區,理想里,651,2334,813,228,1041,53,1094
公投第７案,臺南市,安南區,大安里,652,1822,698,224,922,68,990
公投第７案,臺南市,安南區,大安里,653,1813,668,236,904,103,1007
公投第７案,臺南市,安南區,原佃里,654,2188,827,220,1047,114,1161
公投第７案,臺南市,安南區,長安里,655,2399,845,219,1064,107,1171
公投第７案,臺南市,安南區,長安里,656,2247,732,220,952,75,1027
公投第７案,臺南市,安南區,公親里,657,1165,493,153,646,74,720
公投第７案,臺南市,安南區,布袋里,658,1539,551,154,705,60,765
公投第７案,臺南市,安南區,總頭里,659,1835,686,221,907,111,1018
公投第７案,臺南市,安南區,南興里,660,1797,642,221,863,105,968
公投第７案,臺南市,安南區,學東里,661,2223,737,238,975,105,1080
公投第７案,臺南市,安南區,公󻕯里,662,977,417,138,555,65,620
公投第７案,臺南市,安南區,佃東里,663,1642,563,149,712,41,753
公投第７案,臺南市,安南區,佃東里,664,1697,677,186,863,75,938
公投第７案,臺南市,安南區,佃西里,665,1966,676,174,850,58,908
公投第７案,臺南市,安南區,淵西里,666,1319,476,151,627,70,697
公投第７案,臺南市,安南區,淵西里,667,1909,638,213,851,79,930
公投第７案,臺南市,安南區,海西里,668,1763,698,177,875,67,942
公投第７案,臺南市,安南區,海西里,669,965,355,103,458,55,513
公投第７案,臺南市,安南區,海東里,670,1547,491,110,601,94,695
公投第７案,臺南市,安南區,海東里,671,1784,623,204,827,71,898
公投第７案,臺南市,安南區,海東里,672,2145,732,219,951,66,1017
公投第７案,臺南市,安南區,溪心里,673,2443,986,240,1226,72,1298
公投第７案,臺南市,安南區,溪心里,674,2565,810,244,1054,67,1121
公投第７案,臺南市,安南區,溪心里,675,2480,914,274,1188,97,1285
公投第７案,臺南市,安南區,淵東里,676,2349,747,204,951,104,1055
公投第７案,臺南市,安南區,淵東里,677,2168,805,254,1059,89,1148
公投第７案,臺南市,安南區,淵中里,678,1630,607,154,761,62,823
公投第７案,臺南市,安南區,淵中里,679,1675,526,145,671,51,722
公投第７案,臺南市,安南區,溪墘里,680,1627,713,179,892,117,1009
公投第７案,臺南市,安南區,溪墘里,681,1493,538,184,722,61,783
公投第７案,臺南市,安南區,海佃里,682,1397,515,185,700,84,784
公投第７案,臺南市,安南區,海佃里,683,1416,528,141,669,61,730
公投第７案,臺南市,安南區,海佃里,684,1460,550,161,711,28,739
公投第７案,臺南市,安南區,國安里,685,2222,699,210,909,51,960
公投第７案,臺南市,安南區,溪東里,686,2070,778,210,988,107,1095
公投第７案,臺南市,安南區,溪東里,687,1739,678,205,883,70,953
公投第７案,臺南市,安南區,安富里,688,1830,657,178,835,102,937
公投第７案,臺南市,安南區,安富里,689,1803,743,230,973,81,1054
公投第７案,臺南市,安南區,安富里,690,1800,702,237,939,74,1013
公投第７案,臺南市,安南區,幸福里,691,1815,578,196,774,75,849
公投第７案,臺南市,安南區,幸福里,692,1846,648,168,816,42,858
公投第７案,臺南市,安南區,海南里,693,905,366,129,495,57,552
公投第７案,臺南市,安南區,海南里,694,1073,457,115,572,89,661
公投第７案,臺南市,安南區,城東里,695,1579,658,175,833,76,909
公投第７案,臺南市,安南區,城南里,696,1876,647,199,846,119,965
公投第７案,臺南市,安南區,城南里,697,1194,422,122,544,56,600
公投第７案,臺南市,安南區,青草里,698,1475,410,103,513,30,543
公投第７案,臺南市,安南區,城西里,699,1380,491,122,613,27,640
公投第７案,臺南市,安南區,城北里,700,1462,456,144,600,39,639
公投第７案,臺南市,安南區,城中里,701,1044,423,106,529,67,596
公投第７案,臺南市,安南區,砂崙里,702,603,260,80,340,55,395
公投第７案,臺南市,安南區,砂崙里,703,690,277,94,371,27,398
公投第７案,臺南市,安南區,顯宮里,704,1447,490,158,648,68,716
公投第７案,臺南市,安南區,鹿耳里,705,910,431,118,549,48,597
公投第７案,臺南市,安南區,四草里,706,1850,632,164,796,95,891
公投第７案,臺南市,安南區,塩田里,707,1501,648,168,816,56,872
公投第７案,臺南市,永康區,五王里,708,1398,560,142,702,62,764
公投第７案,臺南市,永康區,五王里,709,1478,450,148,598,31,629
公投第７案,臺南市,永康區,五王里,710,1442,532,146,678,39,717
公投第７案,臺南市,永康區,五王里,711,1353,487,132,619,45,664
公投第７案,臺南市,永康區,三合里,712,1160,417,116,533,28,561
公投第７案,臺南市,永康區,三合里,713,1122,451,115,566,29,595
公投第７案,臺南市,永康區,三合里,714,1165,418,129,547,13,560
公投第７案,臺南市,永康區,六合里,715,1317,484,133,617,40,657
公投第７案,臺南市,永康區,六合里,716,1376,535,124,659,45,704
公投第７案,臺南市,永康區,六合里,717,1361,542,146,688,38,726
公投第７案,臺南市,永康區,六合里,718,1374,575,180,755,43,798
公投第７案,臺南市,永康區,網寮里,719,1709,579,193,772,60,832
公投第７案,臺南市,永康區,網寮里,720,1717,615,162,777,56,833
公投第７案,臺南市,永康區,網寮里,721,1759,602,192,794,45,839
公投第７案,臺南市,永康區,網寮里,722,1636,619,166,785,53,838
公投第７案,臺南市,永康區,二王里,723,1442,547,138,685,70,755
公投第７案,臺南市,永康區,二王里,724,1545,584,149,733,45,778
公投第７案,臺南市,永康區,二王里,725,1565,605,138,743,43,786
公投第７案,臺南市,永康區,二王里,726,1684,588,177,765,47,812
公投第７案,臺南市,永康區,二王里,727,1548,556,134,690,28,718
公投第７案,臺南市,永康區,永康里,728,1389,551,149,700,41,741
公投第７案,臺南市,永康區,永康里,729,1369,525,137,662,55,717
公投第７案,臺南市,永康區,永康里,730,1415,529,150,679,86,765
公投第７案,臺南市,永康區,永康里,731,1386,448,128,576,16,592
公投第７案,臺南市,永康區,永康里,732,1747,323,56,379,7,386
公投第７案,臺南市,永康區,永康里,733,1485,552,152,704,55,759
公投第７案,臺南市,永康區,埔園里,734,1747,644,169,813,73,886
公投第７案,臺南市,永康區,埔園里,735,1744,546,154,700,45,745
公投第７案,臺南市,永康區,埔園里,736,1797,643,143,786,36,822
公投第７案,臺南市,永康區,埔園里,737,1800,724,177,901,61,962
公投第７案,臺南市,永康區,龍埔里,738,1720,642,144,786,22,808
公投第７案,臺南市,永康區,龍埔里,739,1708,685,188,873,44,917
公投第７案,臺南市,永康區,正強里,740,1519,612,168,780,30,810
公投第７案,臺南市,永康區,正強里,741,1497,573,178,751,87,838
公投第７案,臺南市,永康區,正強里,742,1509,568,132,700,21,721
公投第７案,臺南市,永康區,正強里,743,1542,653,173,826,73,899
公投第７案,臺南市,永康區,正強里,744,1536,667,147,814,23,837
公投第７案,臺南市,永康區,大橋里,745,1531,591,177,768,55,823
公投第７案,臺南市,永康區,大橋里,746,1327,552,158,710,49,759
公投第７案,臺南市,永康區,大橋里,747,1456,555,160,715,23,738
公投第７案,臺南市,永康區,大橋里,748,1396,571,156,727,47,774
公投第７案,臺南市,永康區,東橋里,749,1636,591,183,774,68,842
公投第７案,臺南市,永康區,東橋里,750,1592,631,172,803,53,856
公投第７案,臺南市,永康區,東橋里,751,2017,728,194,922,34,956
公投第７案,臺南市,永康區,東橋里,752,672,262,78,340,11,351
公投第７案,臺南市,永康區,西橋里,753,1611,541,157,698,29,727
公投第７案,臺南市,永康區,西橋里,754,1502,580,158,738,50,788
公投第７案,臺南市,永康區,安康里,755,1660,566,140,706,20,726
公投第７案,臺南市,永康區,安康里,756,1561,510,142,652,30,682
公投第７案,臺南市,永康區,安康里,757,1590,544,169,713,26,739
公投第７案,臺南市,永康區,蔦松里,758,924,343,104,447,12,459
公投第７案,臺南市,永康區,蔦松里,759,938,407,98,505,28,533
公投第７案,臺南市,永康區,三民里,760,957,415,90,505,33,538
公投第７案,臺南市,永康區,三民里,761,496,183,56,239,36,275
公投第７案,臺南市,永康區,塩行里,762,1717,638,202,840,64,904
公投第７案,臺南市,永康區,塩行里,763,1615,534,174,708,34,742
公投第７案,臺南市,永康區,塩行里,764,1554,554,161,715,28,743
公投第７案,臺南市,永康區,塩興里,765,1196,416,113,529,27,556
公投第７案,臺南市,永康區,塩興里,766,1274,490,136,626,39,665
公投第７案,臺南市,永康區,塩興里,767,1215,481,133,614,39,653
公投第７案,臺南市,永康區,塩洲里,768,1457,547,161,708,24,732
公投第７案,臺南市,永康區,塩洲里,769,1451,578,143,721,18,739
公投第７案,臺南市,永康區,塩洲里,770,1423,447,162,609,74,683
公投第７案,臺南市,永康區,塩洲里,771,1394,550,157,707,35,742
公投第７案,臺南市,永康區,甲頂里,772,890,370,106,476,40,516
公投第７案,臺南市,永康區,甲頂里,773,1018,416,139,555,55,610
公投第７案,臺南市,永康區,甲頂里,774,368,142,49,191,23,214
公投第７案,臺南市,永康區,尚頂里,775,1208,501,160,661,50,711
公投第７案,臺南市,永康區,尚頂里,776,1187,380,143,523,38,561
公投第７案,臺南市,永康區,尚頂里,777,1381,525,142,667,34,701
公投第７案,臺南市,永康區,龍潭里,778,1405,517,145,662,68,730
公投第７案,臺南市,永康區,龍潭里,779,1445,516,140,656,66,722
公投第７案,臺南市,永康區,龍潭里,780,1687,621,165,786,63,849
公投第７案,臺南市,永康區,龍潭里,781,1535,499,153,652,28,680
公投第７案,臺南市,永康區,永明里,782,1542,631,152,783,53,836
公投第７案,臺南市,永康區,永明里,783,1618,616,160,776,36,812
公投第７案,臺南市,永康區,永明里,784,1338,586,124,710,34,744
公投第７案,臺南市,永康區,王行里,785,1285,503,167,670,68,738
公投第７案,臺南市,永康區,王行里,786,1240,433,124,557,25,582
公投第７案,臺南市,永康區,烏竹里,787,1343,478,125,603,66,669
公投第７案,臺南市,永康區,烏竹里,788,1327,555,158,713,48,761
公投第７案,臺南市,永康區,西勢里,789,1565,594,166,760,51,811
公投第７案,臺南市,永康區,西勢里,790,1476,593,145,738,82,820
公投第７案,臺南市,永康區,西勢里,791,1476,556,160,716,45,761
公投第７案,臺南市,永康區,西勢里,792,1463,590,194,784,49,833
公投第７案,臺南市,永康區,新樹里,793,983,381,120,501,73,574
公投第７案,臺南市,永康區,新樹里,794,1116,445,121,566,80,646
公投第７案,臺南市,永康區,大灣里,795,1117,407,106,513,74,587
公投第７案,臺南市,永康區,大灣里,796,1069,349,124,473,28,501
公投第７案,臺南市,永康區,大灣里,797,1180,524,134,658,39,697
公投第７案,臺南市,永康區,東灣里,798,1176,454,99,553,90,643
公投第７案,臺南市,永康區,東灣里,799,1158,411,139,550,58,608
公投第７案,臺南市,永康區,東灣里,800,1208,483,146,629,78,707
公投第７案,臺南市,永康區,西灣里,801,1501,543,170,713,88,801
公投第７案,臺南市,永康區,西灣里,802,1298,508,159,667,39,706
公投第７案,臺南市,永康區,西灣里,803,1542,582,147,729,35,764
公投第７案,臺南市,永康區,西灣里,804,1537,630,174,804,53,857
公投第７案,臺南市,永康區,西灣里,805,1359,594,153,747,71,818
公投第７案,臺南市,永康區,南灣里,806,1139,370,106,476,41,517
公投第７案,臺南市,永康區,南灣里,807,1158,398,129,527,47,574
公投第７案,臺南市,永康區,南灣里,808,1538,533,172,705,70,775
公投第７案,臺南市,永康區,崑山里,809,1166,420,101,521,20,541
公投第７案,臺南市,永康區,崑山里,810,1228,440,106,546,26,572
公投第７案,臺南市,永康區,崑山里,811,1200,482,144,626,54,680
公投第７案,臺南市,永康區,崑山里,812,1131,334,255,589,44,633
公投第７案,臺南市,永康區,崑山里,813,1147,434,114,548,30,578
公投第７案,臺南市,永康區,北灣里,814,1442,525,146,671,56,727
公投第７案,臺南市,永康區,北灣里,815,1325,448,119,567,26,593
公投第７案,臺南市,永康區,北灣里,816,1260,412,116,528,37,565
公投第７案,臺南市,永康區,北興里,817,1631,579,169,748,51,799
公投第７案,臺南市,永康區,北興里,818,1549,584,134,718,50,768
公投第７案,臺南市,永康區,北興里,819,1666,588,183,771,36,807
公投第７案,臺南市,永康區,復興里,820,1012,374,89,463,34,497
公投第７案,臺南市,永康區,復興里,821,976,327,71,398,22,420
公投第７案,臺南市,永康區,光復里,822,531,217,43,260,21,281
公投第７案,臺南市,永康區,建國里,823,859,350,78,428,45,473
公投第７案,臺南市,永康區,建國里,824,937,348,83,431,33,464
公投第７案,臺南市,永康區,復國里,825,1307,523,131,654,43,697
公投第７案,臺南市,永康區,復國里,826,1482,538,111,649,26,675
公投第７案,臺南市,永康區,復國里,827,1341,463,120,583,33,616
公投第７案,臺南市,永康區,復國里,828,1376,523,134,657,44,701
公投第７案,臺南市,永康區,復國里,829,1390,511,132,643,48,691
公投第７案,臺南市,永康區,復國里,830,1534,595,188,783,48,831
公投第７案,臺南市,永康區,復華里,831,1460,617,138,755,47,802
公投第７案,臺南市,永康區,復華里,832,1383,544,114,658,26,684
公投第７案,臺南市,永康區,復華里,833,1299,480,130,610,47,657
公投第７案,臺南市,永康區,復華里,834,1264,526,135,661,34,695
公投第７案,臺南市,永康區,復華里,835,1355,569,142,711,54,765
公投第７案,臺南市,永康區,復華里,836,1414,523,124,647,28,675
公投第７案,臺南市,永康區,復華里,837,1109,476,121,597,31,628
公投第７案,臺南市,永康區,神洲里,838,1151,433,110,543,44,587
公投第７案,臺南市,永康區,成功里,839,1026,500,112,612,48,660
公投第７案,臺南市,永康區,成功里,840,1071,381,95,476,24,500
公投第７案,臺南市,永康區,中華里,841,1387,633,188,821,48,869
公投第７案,臺南市,永康區,中華里,842,1377,574,186,760,44,804
公投第７案,臺南市,永康區,中興里,843,1687,629,201,830,65,895
公投第７案,臺南市,永康區,中興里,844,1700,609,189,798,44,842
公投第７案,臺南市,永康區,勝利里,845,1444,584,167,751,46,797
公投第７案,臺南市,永康區,勝利里,846,1485,575,136,711,44,755
公投第７案,臺南市,永康區,勝利里,847,1717,599,165,764,38,802
公投第７案,臺南市,永康區,勝利里,848,1701,588,158,746,51,797
公投第７案,臺南市,永康區,勝利里,849,1382,506,132,638,31,669
公投第７案,臺南市,北區,開元里,850,1793,654,176,830,79,909
公投第７案,臺南市,北區,開元里,851,1708,553,175,728,52,780
公投第７案,臺南市,北區,元寶里,852,997,391,97,488,22,510
公投第７案,臺南市,北區,元寶里,853,1452,480,137,617,33,650
公投第７案,臺南市,北區,元寶里,854,1351,493,149,642,18,660
公投第７案,臺南市,北區,合興里,855,1323,572,185,757,68,825
公投第７案,臺南市,北區,合興里,856,1073,408,142,550,33,583
公投第７案,臺南市,北區,合興里,857,1138,441,133,574,36,610
公投第７案,臺南市,北區,力行里,858,1189,454,125,579,35,614
公投第７案,臺南市,北區,力行里,859,1262,561,146,707,35,742
公投第７案,臺南市,北區,重興里,860,1017,449,120,569,26,595
公投第７案,臺南市,北區,重興里,861,847,314,96,410,20,430
公投第７案,臺南市,北區,東興里,862,1076,472,112,584,41,625
公投第７案,臺南市,北區,東興里,863,954,393,139,532,34,566
公投第７案,臺南市,北區,長勝里,864,1300,509,118,627,62,689
公投第７案,臺南市,北區,長勝里,865,1390,555,120,675,54,729
公投第７案,臺南市,北區,長勝里,866,1318,547,149,696,44,740
公投第７案,臺南市,北區,振興里,867,974,369,110,479,16,495
公投第７案,臺南市,北區,振興里,868,990,387,109,496,19,515
公投第７案,臺南市,北區,仁愛里,869,1016,418,157,575,24,599
公投第７案,臺南市,北區,仁愛里,870,1053,381,157,538,47,585
公投第７案,臺南市,北區,中樓里,871,1466,508,183,691,70,761
公投第７案,臺南市,北區,永祥里,872,1535,589,186,775,70,845
公投第７案,臺南市,北區,永祥里,873,1544,557,180,737,65,802
公投第７案,臺南市,北區,北門里,874,1760,716,198,914,61,975
公投第７案,臺南市,北區,北門里,875,1372,427,157,584,36,620
公投第７案,臺南市,北區,北門里,876,1002,434,112,546,40,586
公投第７案,臺南市,北區,北門里,877,1171,488,146,634,44,678
公投第７案,臺南市,北區,大光里,878,1285,484,94,578,25,603
公投第７案,臺南市,北區,大光里,879,1036,426,81,507,35,542
公投第７案,臺南市,北區,大光里,880,1392,573,125,698,48,746
公投第７案,臺南市,北區,大光里,881,1147,437,142,579,55,634
公投第７案,臺南市,北區,大興里,882,1526,148,470,618,39,657
公投第７案,臺南市,北區,大興里,883,1559,549,185,734,41,775
公投第７案,臺南市,北區,公園里,884,892,335,116,451,63,514
公投第７案,臺南市,北區,公園里,885,937,336,97,433,46,479
公投第７案,臺南市,北區,北華里,886,1449,550,187,737,92,829
公投第７案,臺南市,北區,北華里,887,1160,417,130,547,24,571
公投第７案,臺南市,北區,北華里,888,1567,386,131,517,75,592
公投第７案,臺南市,北區,長興里,889,1346,473,173,646,61,707
公投第７案,臺南市,北區,長興里,890,1451,506,145,651,13,664
公投第７案,臺南市,北區,小北里,891,1522,533,156,689,44,733
公投第７案,臺南市,北區,小北里,892,1278,451,145,596,33,629
公投第７案,臺南市,北區,小北里,893,1164,391,138,529,62,591
公投第７案,臺南市,北區,正覺里,894,1091,364,117,481,20,501
公投第７案,臺南市,北區,正覺里,895,993,339,115,454,31,485
公投第７案,臺南市,北區,正覺里,896,1119,330,115,445,39,484
公投第７案,臺南市,北區,成功里,897,1685,635,201,836,86,922
公投第７案,臺南市,北區,成功里,898,1368,518,161,679,20,699
公投第７案,臺南市,北區,成功里,899,1389,534,150,684,58,742
公投第７案,臺南市,北區,華德里,900,1469,629,156,785,24,809
公投第７案,臺南市,北區,華德里,901,1655,687,191,878,70,948
公投第７案,臺南市,北區,福德里,902,1261,527,152,679,32,711
公投第７案,臺南市,北區,福德里,903,1490,563,152,715,26,741
公投第７案,臺南市,北區,福德里,904,1436,601,180,781,45,826
公投第７案,臺南市,北區,成德里,905,1340,548,165,713,69,782
公投第７案,臺南市,北區,成德里,906,1464,573,182,755,37,792
公投第７案,臺南市,北區,成德里,907,1513,645,185,830,31,861
公投第７案,臺南市,北區,和順里,908,1709,707,197,904,23,927
公投第７案,臺南市,北區,和順里,909,1517,678,188,866,43,909
公投第７案,臺南市,北區,和順里,910,1598,586,216,802,20,822
公投第７案,臺南市,北區,立人里,911,1399,515,169,684,52,736
公投第７案,臺南市,北區,立人里,912,1214,442,147,589,47,636
公投第７案,臺南市,北區,雙安里,913,1064,446,121,567,27,594
公投第７案,臺南市,北區,雙安里,914,1148,489,159,648,52,700
公投第７案,臺南市,北區,文成里,915,1391,547,175,722,36,758
公投第７案,臺南市,北區,文成里,916,1584,660,162,822,45,867
公投第７案,臺南市,北區,元美里,917,1595,675,175,850,38,888
公投第７案,臺南市,北區,元美里,918,1397,543,155,698,32,730
公投第７案,臺南市,北區,文元里,919,1662,640,184,824,60,884
公投第７案,臺南市,北區,文元里,920,1634,607,168,775,29,804
公投第７案,臺南市,北區,大和里,921,1793,716,209,925,90,1015
公投第７案,臺南市,北區,大和里,922,1872,723,223,946,48,994
公投第７案,臺南市,北區,大港里,923,1874,680,225,905,101,1006
公投第７案,臺南市,北區,大港里,924,1760,648,178,826,71,897
公投第７案,臺南市,北區,大港里,925,1753,643,189,832,56,888
公投第７案,臺南市,北區,大豐里,926,1502,463,136,599,34,633
公投第７案,臺南市,北區,大豐里,927,1470,552,178,730,49,779
公投第７案,臺南市,北區,大豐里,928,1319,451,162,613,91,704
公投第７案,臺南市,北區,賢北里,929,1876,760,203,963,69,1032
公投第７案,臺南市,北區,賢北里,930,1720,627,212,839,40,879
公投第７案,臺南市,中西區,赤嵌里,931,1332,493,184,677,57,734
公投第７案,臺南市,中西區,赤嵌里,932,1246,478,160,638,74,712
公投第７案,臺南市,中西區,赤嵌里,933,1276,446,167,613,56,669
公投第７案,臺南市,中西區,郡王里,934,1583,629,200,829,58,887
公投第７案,臺南市,中西區,郡王里,935,1464,583,198,781,54,835
公投第７案,臺南市,中西區,法華里,936,1234,467,137,604,24,628
公投第７案,臺南市,中西區,法華里,937,1368,533,205,738,47,785
公投第７案,臺南市,中西區,開山里,938,1322,428,138,566,32,598
公投第７案,臺南市,中西區,開山里,939,1216,408,174,582,59,641
公投第７案,臺南市,中西區,永華里,940,1289,429,195,624,41,665
公投第７案,臺南市,中西區,永華里,941,1237,491,153,644,49,693
公投第７案,臺南市,中西區,藥王里,942,1189,374,144,518,33,551
公投第７案,臺南市,中西區,藥王里,943,1201,439,167,606,67,673
公投第７案,臺南市,中西區,藥王里,944,1065,444,131,575,61,636
公投第７案,臺南市,中西區,光賢里,945,1055,425,126,551,45,596
公投第７案,臺南市,中西區,光賢里,946,1170,518,150,668,43,711
公投第７案,臺南市,中西區,光賢里,947,1280,555,162,717,40,757
公投第７案,臺南市,中西區,大涼里,948,1223,479,168,647,42,689
公投第７案,臺南市,中西區,大涼里,949,1292,538,151,689,65,754
公投第７案,臺南市,中西區,西湖里,950,993,412,139,551,17,568
公投第７案,臺南市,中西區,西湖里,951,1541,580,201,781,47,828
公投第７案,臺南市,中西區,西湖里,952,1652,694,216,910,76,986
公投第７案,臺南市,中西區,西湖里,953,1212,495,159,654,33,687
公投第７案,臺南市,中西區,西賢里,954,1621,651,205,856,67,923
公投第７案,臺南市,中西區,西賢里,955,1660,630,231,861,45,906
公投第７案,臺南市,中西區,西賢里,956,1595,603,200,803,60,863
公投第７案,臺南市,中西區,城隍里,957,1436,519,184,703,59,762
公投第７案,臺南市,中西區,城隍里,958,1265,487,173,660,62,722
公投第７案,臺南市,中西區,城隍里,959,856,371,105,476,50,526
公投第７案,臺南市,中西區,南美里,960,1168,392,170,562,53,615
公投第７案,臺南市,中西區,南美里,961,1134,456,159,615,43,658
公投第７案,臺南市,中西區,南美里,962,995,403,148,551,60,611
公投第７案,臺南市,中西區,南門里,963,1313,622,136,758,43,801
公投第７案,臺南市,中西區,南門里,964,1265,540,156,696,52,748
公投第７案,臺南市,中西區,小西門里,965,1215,455,146,601,50,651
公投第７案,臺南市,中西區,小西門里,966,1248,497,128,625,58,683
公投第７案,臺南市,中西區,小西門里,967,687,235,97,332,45,377
公投第７案,臺南市,中西區,五條港里,968,1139,423,141,564,70,634
公投第７案,臺南市,中西區,五條港里,969,971,400,122,522,44,566
公投第７案,臺南市,中西區,兌悅里,970,1254,364,120,484,59,543
公投第７案,臺南市,中西區,兌悅里,971,979,391,102,493,37,530
公投第７案,臺南市,中西區,兌悅里,972,1745,624,191,815,72,887
公投第７案,臺南市,中西區,淺草里,973,1074,374,154,528,51,579
公投第７案,臺南市,中西區,淺草里,974,1436,493,171,664,45,709
公投第７案,臺南市,中西區,府前里,975,865,314,120,434,55,489
公投第７案,臺南市,中西區,府前里,976,1164,453,132,585,51,636
公投第７案,臺南市,中西區,南廠里,977,1285,412,161,573,24,597
公投第７案,臺南市,中西區,南廠里,978,1078,400,139,539,52,591
公投第７案,臺南市,中西區,南廠里,979,1704,515,157,672,54,726
公投第７案,臺南市,中西區,西和里,980,1296,514,156,670,83,753
公投第７案,臺南市,中西區,西和里,981,1128,447,130,577,42,619
公投第７案,臺南市,中西區,西和里,982,1245,482,151,633,45,678
公投第７案,臺南市,安平區,文平里,983,1753,679,202,881,83,964
公投第７案,臺南市,安平區,文平里,984,1859,718,175,893,55,948
公投第７案,臺南市,安平區,文平里,985,1382,594,160,754,53,807
公投第７案,臺南市,安平區,建平里,986,2547,903,274,1177,75,1252
公投第７案,臺南市,安平區,建平里,987,2407,928,264,1192,58,1250
公投第７案,臺南市,安平區,怡平里,988,2070,695,188,883,49,932
公投第７案,臺南市,安平區,怡平里,989,2132,764,257,1021,41,1062
公投第７案,臺南市,安平區,華平里,990,1450,561,168,729,27,756
公投第７案,臺南市,安平區,華平里,991,1605,575,166,741,29,770
公投第７案,臺南市,安平區,華平里,992,1755,668,198,866,74,940
公投第７案,臺南市,安平區,平通里,993,1728,593,169,762,51,813
公投第７案,臺南市,安平區,平通里,994,1754,512,171,683,35,718
公投第７案,臺南市,安平區,平通里,995,1686,645,171,816,56,872
公投第７案,臺南市,安平區,平通里,996,1843,729,212,941,50,991
公投第７案,臺南市,安平區,億載里,997,1565,628,196,824,46,870
公投第７案,臺南市,安平區,億載里,998,1288,511,126,637,32,669
公投第７案,臺南市,安平區,育平里,999,1653,560,187,747,23,770
公投第７案,臺南市,安平區,育平里,1000,1697,628,144,772,26,798
公投第７案,臺南市,安平區,育平里,1001,2154,762,200,962,45,1007
公投第７案,臺南市,安平區,育平里,1002,2107,766,203,969,56,1025
公投第７案,臺南市,安平區,國平里,1003,1675,665,190,855,66,921
公投第７案,臺南市,安平區,國平里,1004,1979,704,250,954,58,1012
公投第７案,臺南市,安平區,國平里,1005,1602,573,184,757,35,792
公投第７案,臺南市,安平區,國平里,1006,1586,597,155,752,51,803
公投第７案,臺南市,安平區,漁光里,1007,438,125,42,167,11,178
公投第７案,臺南市,安平區,平安里,1008,1780,622,192,814,82,896
公投第７案,臺南市,安平區,平安里,1009,1623,533,185,718,33,751
公投第７案,臺南市,安平區,天妃里,1010,2157,707,246,953,104,1057
公投第７案,臺南市,安平區,天妃里,1011,1286,407,148,555,47,602
公投第７案,臺南市,安平區,王城里,1012,1492,520,182,702,80,782
公投第７案,臺南市,安平區,王城里,1013,1325,409,121,530,35,565
公投第７案,臺南市,安平區,金城里,1014,2001,706,196,902,83,985
公投第７案,臺南市,南區,大恩里,1015,1221,491,135,626,43,669
公投第７案,臺南市,南區,大恩里,1016,2171,708,215,923,81,1004
公投第７案,臺南市,南區,大林里,1017,1150,492,130,622,42,664
公投第７案,臺南市,南區,大林里,1018,1122,474,106,580,32,612
公投第７案,臺南市,南區,大忠里,1019,1444,490,145,635,49,684
公投第７案,臺南市,南區,大忠里,1020,1765,605,194,799,64,863
公投第７案,臺南市,南區,大忠里,1021,1298,499,179,678,55,733
公投第７案,臺南市,南區,新生里,1022,1458,622,141,763,37,800
公投第７案,臺南市,南區,新生里,1023,1940,741,143,884,34,918
公投第７案,臺南市,南區,竹溪里,1024,1637,586,194,780,70,850
公投第７案,臺南市,南區,明德里,1025,871,292,83,375,15,390
公投第７案,臺南市,南區,大成里,1026,589,239,76,315,19,334
公投第７案,臺南市,南區,大成里,1027,801,362,118,480,44,524
公投第７案,臺南市,南區,田寮里,1028,990,402,108,510,58,568
公投第７案,臺南市,南區,田寮里,1029,1222,527,156,683,54,737
公投第７案,臺南市,南區,田寮里,1030,997,402,120,522,77,599
公投第７案,臺南市,南區,新興里,1031,1204,391,160,551,38,589
公投第７案,臺南市,南區,新興里,1032,1570,491,177,668,31,699
公投第７案,臺南市,南區,再興里,1033,1222,452,167,619,51,670
公投第７案,臺南市,南區,再興里,1034,1076,351,112,463,29,492
公投第７案,臺南市,南區,廣州里,1035,1127,377,159,536,27,563
公投第７案,臺南市,南區,廣州里,1036,1135,422,144,566,53,619
公投第７案,臺南市,南區,新昌里,1037,1263,449,154,603,66,669
公投第７案,臺南市,南區,新昌里,1038,1014,342,113,455,33,488
公投第７案,臺南市,南區,文華里,1039,1491,547,208,755,76,831
公投第７案,臺南市,南區,文華里,1040,1815,672,195,867,43,910
公投第７案,臺南市,南區,文南里,1041,1398,498,148,646,26,672
公投第７案,臺南市,南區,文南里,1042,2107,650,195,845,50,895
公投第７案,臺南市,南區,文南里,1043,1587,650,210,860,70,930
公投第７案,臺南市,南區,金華里,1044,1626,575,205,780,89,869
公投第７案,臺南市,南區,金華里,1045,1761,561,212,773,42,815
公投第７案,臺南市,南區,金華里,1046,1630,591,185,776,90,866
公投第７案,臺南市,南區,國宅里,1047,1542,577,193,770,58,828
公投第７案,臺南市,南區,國宅里,1048,1464,515,163,678,92,770
公投第７案,臺南市,南區,鹽埕里,1049,1727,572,224,796,108,904
公投第７案,臺南市,南區,鹽埕里,1050,1085,443,145,588,58,646
公投第７案,臺南市,南區,鹽埕里,1051,939,336,98,434,20,454
公投第７案,臺南市,南區,光明里,1052,1419,459,132,591,83,674
公投第７案,臺南市,南區,光明里,1053,1333,466,135,601,65,666
公投第７案,臺南市,南區,光明里,1054,1465,522,143,665,62,727
公投第７案,臺南市,南區,明亮里,1055,1099,391,131,522,27,549
公投第７案,臺南市,南區,明亮里,1056,1133,412,102,514,22,536
公投第７案,臺南市,南區,明亮里,1057,1375,456,148,604,105,709
公投第７案,臺南市,南區,府南里,1058,1781,560,174,734,38,772
公投第７案,臺南市,南區,府南里,1059,1542,630,183,813,62,875
公投第７案,臺南市,南區,府南里,1060,1486,504,160,664,42,706
公投第７案,臺南市,南區,明興里,1061,1640,601,213,814,91,905
公投第７案,臺南市,南區,明興里,1062,1701,514,196,710,53,763
公投第７案,臺南市,南區,郡南里,1063,1541,499,141,640,107,747
公投第７案,臺南市,南區,郡南里,1064,2027,724,186,910,108,1018
公投第７案,臺南市,南區,建南里,1065,1774,724,219,943,90,1033
公投第７案,臺南市,南區,建南里,1066,1613,558,203,761,69,830
公投第７案,臺南市,南區,建南里,1067,1707,580,186,766,29,795
公投第７案,臺南市,南區,南都里,1068,1657,378,126,504,28,532
公投第７案,臺南市,南區,南都里,1069,1077,401,126,527,50,577
公投第７案,臺南市,南區,南華里,1070,1185,467,119,586,40,626
公投第７案,臺南市,南區,南華里,1071,1249,445,150,595,62,657
公投第７案,臺南市,南區,開南里,1072,1985,623,176,799,41,840
公投第７案,臺南市,南區,開南里,1073,2017,592,227,819,86,905
公投第７案,臺南市,南區,開南里,1074,1717,532,218,750,91,841
公投第７案,臺南市,南區,彰南里,1075,929,355,106,461,45,506
公投第７案,臺南市,南區,彰南里,1076,695,262,104,366,28,394
公投第７案,臺南市,南區,鯤鯓里,1077,997,311,82,393,30,423
公投第７案,臺南市,南區,鯤鯓里,1078,784,252,50,302,29,331
公投第７案,臺南市,南區,喜北里,1079,1119,454,126,580,67,647
公投第７案,臺南市,南區,喜北里,1080,1054,289,106,395,33,428
公投第７案,臺南市,南區,喜南里,1081,1245,409,125,534,105,639
公投第７案,臺南市,南區,喜東里,1082,2064,631,194,825,93,918
公投第７案,臺南市,南區,省躬里,1083,2056,557,177,734,32,766
公投第７案,臺南市,南區,省躬里,1084,1373,422,123,545,26,571
公投第７案,臺南市,南區,永寧里,1085,1002,270,101,371,37,408
公投第７案,臺南市,南區,永寧里,1086,760,273,101,374,67,441
公投第７案,臺南市,南區,松安里,1087,1031,362,125,487,75,562
公投第７案,臺南市,南區,松安里,1088,744,265,89,354,54,408
公投第７案,臺南市,南區,佛壇里,1089,1186,436,132,568,72,640
公投第７案,臺南市,南區,佛壇里,1090,1358,492,167,659,82,741
公投第７案,臺南市,南區,同安里,1091,897,257,99,356,34,390
公投第７案,臺南市,南區,同安里,1092,1265,444,145,589,70,659
公投第７案,臺南市,南區,興農里,1093,1093,331,110,441,41,482
公投第７案,臺南市,南區,興農里,1094,1016,395,107,502,28,530
公投第７案,臺南市,東區,崇信里,1095,2681,758,230,988,59,1047
公投第７案,臺南市,東區,崇信里,1096,1811,645,214,859,36,895
公投第７案,臺南市,東區,崇學里,1097,1491,626,219,845,87,932
公投第７案,臺南市,東區,崇學里,1098,1378,535,169,704,51,755
公投第７案,臺南市,東區,崇德里,1099,1552,624,184,808,65,873
公投第７案,臺南市,東區,崇德里,1100,1326,533,190,723,33,756
公投第７案,臺南市,東區,崇德里,1101,1594,638,189,827,71,898
公投第７案,臺南市,東區,崇善里,1102,1639,650,232,882,58,940
公投第７案,臺南市,東區,崇善里,1103,1724,661,203,864,59,923
公投第７案,臺南市,東區,崇善里,1104,1629,626,202,828,79,907
公投第７案,臺南市,東區,崇成里,1105,1399,572,146,718,34,752
公投第７案,臺南市,東區,崇成里,1106,1534,622,161,783,37,820
公投第７案,臺南市,東區,崇文里,1107,1656,685,194,879,58,937
公投第７案,臺南市,東區,崇文里,1108,1322,539,127,666,62,728
公投第７案,臺南市,東區,崇文里,1109,1620,648,186,834,37,871
公投第７案,臺南市,東區,崇文里,1110,1331,633,137,770,37,807
公投第７案,臺南市,東區,東智里,1111,1039,416,122,538,46,584
公投第７案,臺南市,東區,東智里,1112,1257,432,126,558,29,587
公投第７案,臺南市,東區,大智里,1113,2067,732,210,942,104,1046
公投第７案,臺南市,東區,大智里,1114,2153,902,190,1092,35,1127
公投第７案,臺南市,東區,大智里,1115,2363,936,221,1157,68,1225
公投第７案,臺南市,東區,德高里,1116,1427,582,156,738,45,783
公投第７案,臺南市,東區,德高里,1117,1555,627,186,813,34,847
公投第７案,臺南市,東區,仁和里,1118,2115,700,190,890,61,951
公投第７案,臺南市,東區,仁和里,1119,2340,837,233,1070,84,1154
公投第７案,臺南市,東區,和平里,1120,2474,958,316,1274,67,1341
公投第７案,臺南市,東區,和平里,1121,2391,915,248,1163,73,1236
公投第７案,臺南市,東區,虎尾里,1122,1673,637,236,873,58,931
公投第７案,臺南市,東區,虎尾里,1123,1594,584,189,773,43,816
公投第７案,臺南市,東區,虎尾里,1124,1607,664,199,863,57,920
公投第７案,臺南市,東區,裕聖里,1125,2087,928,225,1153,37,1190
公投第７案,臺南市,東區,裕聖里,1126,2369,1023,279,1302,46,1348
公投第７案,臺南市,東區,復興里,1127,1696,612,193,805,101,906
公投第７案,臺南市,東區,復興里,1128,1612,590,210,800,46,846
公投第７案,臺南市,東區,自強里,1129,1708,602,200,802,73,875
公投第７案,臺南市,東區,自強里,1130,1560,620,183,803,54,857
公投第７案,臺南市,東區,自強里,1131,1854,702,222,924,63,987
公投第７案,臺南市,東區,東聖里,1132,2278,773,261,1034,43,1077
公投第７案,臺南市,東區,關聖里,1133,2093,776,222,998,52,1050
公投第７案,臺南市,東區,關聖里,1134,2242,959,249,1208,70,1278
公投第７案,臺南市,東區,南聖里,1135,1152,509,135,644,46,690
公投第７案,臺南市,東區,南聖里,1136,1318,612,161,773,23,796
公投第７案,臺南市,東區,文聖里,1137,2200,886,242,1128,51,1179
公投第７案,臺南市,東區,文聖里,1138,1960,862,237,1099,44,1143
公投第７案,臺南市,東區,後甲里,1139,1489,559,178,737,42,779
公投第７案,臺南市,東區,後甲里,1140,1443,538,187,725,69,794
公投第７案,臺南市,東區,東光里,1141,1498,627,225,852,53,905
公投第７案,臺南市,東區,東光里,1142,1622,632,217,849,27,876
公投第７案,臺南市,東區,東光里,1143,1738,719,206,925,37,962
公投第７案,臺南市,東區,東明里,1144,1501,544,179,723,69,792
公投第７案,臺南市,東區,東明里,1145,1482,561,201,762,63,825
公投第７案,臺南市,東區,莊敬里,1146,1829,628,211,839,44,883
公投第７案,臺南市,東區,莊敬里,1147,1764,685,207,892,68,960
公投第７案,臺南市,東區,小東里,1148,1427,610,170,780,42,822
公投第７案,臺南市,東區,小東里,1149,1427,534,174,708,63,771
公投第７案,臺南市,東區,小東里,1150,1388,589,143,732,49,781
公投第７案,臺南市,東區,大學里,1151,1131,469,182,651,35,686
公投第７案,臺南市,東區,成大里,1152,1000,370,116,486,48,534
公投第７案,臺南市,東區,成大里,1153,996,392,118,510,40,550
公投第７案,臺南市,東區,東門里,1154,935,332,120,452,46,498
公投第７案,臺南市,東區,東門里,1155,947,313,152,465,80,545
公投第７案,臺南市,東區,圍下里,1156,1090,407,152,559,19,578
公投第７案,臺南市,東區,圍下里,1157,896,307,119,426,50,476
公投第７案,臺南市,東區,中西里,1158,1589,588,204,792,28,820
公投第７案,臺南市,東區,中西里,1159,1497,609,180,789,50,839
公投第７案,臺南市,東區,東安里,1160,1386,490,174,664,58,722
公投第７案,臺南市,東區,新東里,1161,1101,410,146,556,19,575
公投第７案,臺南市,東區,新東里,1162,1332,509,203,712,59,771
公投第７案,臺南市,東區,崇誨里,1163,1185,489,117,606,59,665
公投第７案,臺南市,東區,崇誨里,1164,1262,522,157,679,57,736
公投第７案,臺南市,東區,衛國里,1165,1517,551,165,716,41,757
公投第７案,臺南市,東區,裕農里,1166,1287,491,142,633,76,709
公投第７案,臺南市,東區,裕農里,1167,1657,655,194,849,68,917
公投第７案,臺南市,東區,富強里,1168,2238,849,268,1117,104,1221
公投第７案,臺南市,東區,富強里,1169,2246,796,292,1088,61,1149
公投第７案,臺南市,東區,富裕里,1170,2191,820,243,1063,60,1123
公投第７案,臺南市,東區,忠孝里,1171,2063,775,236,1011,66,1077
公投第７案,臺南市,東區,忠孝里,1172,2177,904,267,1171,84,1255
公投第７案,臺南市,東區,崇明里,1173,1863,776,207,983,91,1074
公投第７案,臺南市,東區,崇明里,1174,2185,903,237,1140,45,1185
公投第７案,臺南市,東區,大福里,1175,1721,583,177,760,52,812
公投第７案,臺南市,東區,大德里,1176,1556,586,185,771,93,864
公投第７案,臺南市,東區,路東里,1177,1602,683,188,871,49,920
公投第７案,臺南市,東區,大同里,1178,1523,573,144,717,84,801
公投第７案,臺南市,東區,大同里,1179,1382,462,167,629,57,686
公投第７案,臺南市,東區,泉南里,1180,1486,570,177,747,38,785
公投第７案,臺南市,東區,泉南里,1181,1560,551,247,798,71,869
公投第７案,臺南市,東區,泉南里,1182,1684,563,203,766,73,839
公投第７案,臺南市,東區,龍山里,1183,1653,614,246,860,50,910
公投第７案,臺南市,東區,龍山里,1184,1554,580,235,815,20,835
公投第７案,臺南市,東區,龍山里,1185,1408,568,182,750,34,784
公投第７案,臺南市,東區,德光里,1186,2084,873,275,1148,41,1189
公投第７案,臺南市,東區,德光里,1187,1896,726,226,952,79,1031
公投第７案,臺南市,仁德區,太子里,1188,1318,488,152,640,80,720
公投第７案,臺南市,仁德區,太子里,1189,1406,559,141,700,69,769
公投第７案,臺南市,仁德區,太子里,1190,1465,524,153,677,86,763
公投第７案,臺南市,仁德區,太子里,1191,1192,490,154,644,72,716
公投第７案,臺南市,仁德區,土庫里,1192,1429,597,158,755,67,822
公投第７案,臺南市,仁德區,土庫里,1193,1320,453,159,612,111,723
公投第７案,臺南市,仁德區,一甲里,1194,1373,598,131,729,92,821
公投第７案,臺南市,仁德區,一甲里,1195,1330,533,160,693,65,758
公投第７案,臺南市,仁德區,仁德里,1196,1687,704,188,892,26,918
公投第７案,臺南市,仁德區,仁德里,1197,1491,529,167,696,58,754
公投第７案,臺南市,仁德區,仁德里,1198,1151,395,109,504,34,538
公投第７案,臺南市,仁德區,仁德里,1199,1407,581,110,691,24,715
公投第７案,臺南市,仁德區,仁德里,1200,1465,608,170,778,48,826
公投第７案,臺南市,仁德區,仁義里,1201,1335,531,175,706,43,749
公投第７案,臺南市,仁德區,仁義里,1202,1490,544,176,720,63,783
公投第７案,臺南市,仁德區,仁義里,1203,1453,611,183,794,58,852
公投第７案,臺南市,仁德區,仁義里,1204,990,352,100,452,30,482
公投第７案,臺南市,仁德區,仁義里,1205,1573,631,172,803,78,881
公投第７案,臺南市,仁德區,仁義里,1206,1031,372,132,504,61,565
公投第７案,臺南市,仁德區,仁義里,1207,1194,456,133,589,31,620
公投第７案,臺南市,仁德區,新田里,1208,1268,470,125,595,53,648
公投第７案,臺南市,仁德區,新田里,1209,929,339,128,467,42,509
公投第７案,臺南市,仁德區,新田里,1210,1145,396,100,496,12,508
公投第７案,臺南市,仁德區,後壁里,1211,1413,499,141,640,66,706
公投第７案,臺南市,仁德區,後壁里,1212,1465,546,137,683,103,786
公投第７案,臺南市,仁德區,後壁里,1213,1390,569,176,745,51,796
公投第７案,臺南市,仁德區,後壁里,1214,1396,536,155,691,69,760
公投第７案,臺南市,仁德區,後壁里,1215,1906,738,204,942,50,992
公投第７案,臺南市,仁德區,後壁里,1216,1546,584,151,735,37,772
公投第７案,臺南市,仁德區,上崙里,1217,1546,502,138,640,28,668
公投第７案,臺南市,仁德區,上崙里,1218,1399,554,139,693,49,742
公投第７案,臺南市,仁德區,上崙里,1219,1748,643,174,817,107,924
公投第７案,臺南市,仁德區,上崙里,1220,1140,472,130,602,40,642
公投第７案,臺南市,仁德區,文賢里,1221,1277,461,112,573,27,600
公投第７案,臺南市,仁德區,文賢里,1222,1019,467,121,588,51,639
公投第７案,臺南市,仁德區,保安里,1223,1414,470,140,610,39,649
公投第７案,臺南市,仁德區,保安里,1224,1349,450,118,568,28,596
公投第７案,臺南市,仁德區,成功里,1225,1471,518,153,671,31,702
公投第７案,臺南市,仁德區,成功里,1226,1324,484,144,628,19,647
公投第７案,臺南市,仁德區,成功里,1227,1310,497,92,589,38,627
公投第７案,臺南市,仁德區,成功里,1228,554,223,62,285,26,311
公投第７案,臺南市,仁德區,仁和里,1229,1395,618,97,715,33,748
公投第７案,臺南市,仁德區,仁愛里,1230,1264,482,112,594,19,613
公投第７案,臺南市,仁德區,二行里,1231,1180,417,119,536,79,615
公投第７案,臺南市,仁德區,二行里,1232,928,277,94,371,38,409
公投第７案,臺南市,仁德區,大甲里,1233,965,200,198,398,21,419
公投第７案,臺南市,仁德區,大甲里,1234,1119,365,103,468,28,496
公投第７案,臺南市,仁德區,中洲里,1235,1206,442,130,572,75,647
公投第７案,臺南市,仁德區,中洲里,1236,1466,466,136,602,38,640
公投第７案,臺南市,歸仁區,南保里,1237,1560,563,154,717,79,796
公投第７案,臺南市,歸仁區,南保里,1238,1383,584,183,767,67,834
公投第７案,臺南市,歸仁區,南保里,1239,1491,552,173,725,42,767
公投第７案,臺南市,歸仁區,南保里,1240,1482,479,172,651,72,723
公投第７案,臺南市,歸仁區,南興里,1241,1330,494,149,643,33,676
公投第７案,臺南市,歸仁區,南興里,1242,1399,552,180,732,48,780
公投第７案,臺南市,歸仁區,南興里,1243,1416,506,149,655,26,681
公投第７案,臺南市,歸仁區,六甲里,1244,1336,406,122,528,33,561
公投第７案,臺南市,歸仁區,六甲里,1245,1183,391,122,513,73,586
公投第７案,臺南市,歸仁區,六甲里,1246,1237,419,117,536,22,558
公投第７案,臺南市,歸仁區,歸南里,1247,1133,442,119,561,72,633
公投第７案,臺南市,歸仁區,歸南里,1248,1149,414,123,537,34,571
公投第７案,臺南市,歸仁區,後市里,1249,1105,413,138,551,7,558
公投第７案,臺南市,歸仁區,後市里,1250,1099,407,132,539,62,601
公投第７案,臺南市,歸仁區,後市里,1251,1082,422,127,549,81,630
公投第７案,臺南市,歸仁區,文化里,1252,1519,582,150,732,55,787
公投第７案,臺南市,歸仁區,文化里,1253,1467,572,188,760,74,834
公投第７案,臺南市,歸仁區,辜厝里,1254,1090,391,128,519,51,570
公投第７案,臺南市,歸仁區,辜厝里,1255,1131,406,108,514,33,547
公投第７案,臺南市,歸仁區,辜厝里,1256,1080,395,91,486,32,518
公投第７案,臺南市,歸仁區,新厝里,1257,1121,350,109,459,26,485
公投第７案,臺南市,歸仁區,新厝里,1258,1336,481,153,634,85,719
公投第７案,臺南市,歸仁區,許厝里,1259,1128,402,139,541,74,615
公投第７案,臺南市,歸仁區,許厝里,1260,1055,382,117,499,27,526
公投第７案,臺南市,歸仁區,許厝里,1261,1102,416,128,544,32,576
公投第７案,臺南市,歸仁區,看西里,1262,1068,426,111,537,41,578
公投第７案,臺南市,歸仁區,看西里,1263,1033,391,128,519,73,592
公投第７案,臺南市,歸仁區,看東里,1264,1772,501,137,638,32,670
公投第７案,臺南市,歸仁區,崙頂里,1265,1399,526,169,695,71,766
公投第７案,臺南市,歸仁區,崙頂里,1266,1544,591,154,745,26,771
公投第７案,臺南市,歸仁區,沙崙里,1267,684,220,58,278,8,286
公投第７案,臺南市,歸仁區,大潭里,1268,839,329,115,444,40,484
公投第７案,臺南市,歸仁區,大潭里,1269,1014,389,134,523,60,583
公投第７案,臺南市,歸仁區,武東里,1270,1906,511,144,655,36,691
公投第７案,臺南市,歸仁區,歸仁里,1271,1245,483,157,640,69,709
公投第７案,臺南市,歸仁區,歸仁里,1272,1048,396,125,521,35,556
公投第７案,臺南市,歸仁區,八甲里,1273,1175,429,114,543,23,566
公投第７案,臺南市,歸仁區,八甲里,1274,1411,458,147,605,31,636
公投第７案,臺南市,歸仁區,七甲里,1275,1514,628,173,801,51,852
公投第７案,臺南市,歸仁區,七甲里,1276,1678,651,176,827,74,901
公投第７案,臺南市,歸仁區,媽廟里,1277,949,384,92,476,35,511
公投第７案,臺南市,歸仁區,媽廟里,1278,1009,399,133,532,62,594
公投第７案,臺南市,歸仁區,西埔里,1279,984,427,148,575,6,581
公投第７案,臺南市,歸仁區,西埔里,1280,756,320,83,403,42,445
公投第７案,臺南市,歸仁區,大廟里,1281,1478,634,174,808,66,874
公投第７案,臺南市,歸仁區,大廟里,1282,1467,617,170,787,70,857
公投第７案,臺南市,關廟區,關廟里,1283,982,342,113,455,30,485
公投第７案,臺南市,關廟區,關廟里,1284,1156,490,127,617,46,663
公投第７案,臺南市,關廟區,山西里,1285,1006,343,92,435,27,462
公投第７案,臺南市,關廟區,山西里,1286,1043,409,163,572,58,630
公投第７案,臺南市,關廟區,香洋里,1287,1012,390,109,499,82,581
公投第７案,臺南市,關廟區,香洋里,1288,1013,324,86,410,25,435
公投第７案,臺南市,關廟區,香洋里,1289,1294,496,115,611,31,642
公投第７案,臺南市,關廟區,北勢里,1290,1264,450,125,575,39,614
公投第７案,臺南市,關廟區,北勢里,1291,1166,433,116,549,43,592
公投第７案,臺南市,關廟區,新埔里,1292,1018,340,103,443,20,463
公投第７案,臺南市,關廟區,新光里,1293,733,235,66,301,40,341
公投第７案,臺南市,關廟區,五甲里,1294,1093,446,125,571,35,606
公投第７案,臺南市,關廟區,五甲里,1295,1081,449,92,541,26,567
公投第７案,臺南市,關廟區,五甲里,1296,978,398,128,526,44,570
公投第７案,臺南市,關廟區,東勢里,1297,1116,356,126,482,21,503
公投第７案,臺南市,關廟區,東勢里,1298,972,364,103,467,51,518
公投第７案,臺南市,關廟區,東勢里,1299,1045,389,128,517,86,603
公投第７案,臺南市,關廟區,松腳里,1300,872,339,87,426,32,458
公投第７案,臺南市,關廟區,松腳里,1301,1007,407,121,528,40,568
公投第７案,臺南市,關廟區,花園里,1302,763,294,102,396,60,456
公投第７案,臺南市,關廟區,花園里,1303,630,237,64,301,33,334
公投第７案,臺南市,關廟區,花園里,1304,959,364,131,495,58,553
公投第７案,臺南市,關廟區,花園里,1305,1123,432,100,532,27,559
公投第７案,臺南市,關廟區,深坑里,1306,804,294,93,387,70,457
公投第７案,臺南市,關廟區,深坑里,1307,720,248,71,319,18,337
公投第７案,臺南市,關廟區,布袋里,1308,843,277,56,333,17,350
公投第７案,臺南市,關廟區,布袋里,1309,358,123,34,157,10,167
公投第７案,臺南市,關廟區,南雄里,1310,797,288,77,365,61,426
公投第７案,臺南市,關廟區,南雄里,1311,709,225,57,282,14,296
公投第７案,臺南市,關廟區,埤頭里,1312,904,302,85,387,17,404
公投第７案,臺南市,關廟區,埤頭里,1313,963,350,89,439,22,461
公投第７案,臺南市,關廟區,下湖里,1314,489,182,54,236,7,243
公投第７案,臺南市,龍崎區,崎頂里,1315,1047,360,108,468,62,530
公投第７案,臺南市,龍崎區,土崎里,1316,630,198,52,250,23,273
公投第７案,臺南市,龍崎區,中坑里,1317,141,38,8,46,3,49
公投第７案,臺南市,龍崎區,楠坑里,1318,367,117,42,159,15,174
公投第７案,臺南市,龍崎區,牛埔里,1319,337,119,27,146,14,160
公投第７案,臺南市,龍崎區,大坪里,1320,318,88,27,115,8,123
公投第７案,臺南市,龍崎區,龍船里,1321,427,164,27,191,22,213
公投第７案,臺南市,龍崎區,石𥕢里,1322,446,117,39,156,17,173
公投第７案,桃園市,桃園區,大林里,1,1593,578,175,753,51,804
公投第７案,桃園市,桃園區,大林里,2,1934,621,197,818,33,851
公投第７案,桃園市,桃園區,大林里,3,1661,688,173,861,53,914
公投第７案,桃園市,桃園區,大林里,4,1448,533,140,673,21,694
公投第７案,桃園市,桃園區,大樹里,5,1974,722,186,908,39,947
公投第７案,桃園市,桃園區,大樹里,6,1882,618,174,792,76,868
公投第７案,桃園市,桃園區,大豐里,7,1800,636,191,827,53,880
公投第７案,桃園市,桃園區,大豐里,8,1598,650,175,825,46,871
公投第７案,桃園市,桃園區,大豐里,9,1626,546,163,709,61,770
公投第７案,桃園市,桃園區,建國里,10,1590,555,159,714,50,764
公投第７案,桃園市,桃園區,建國里,11,1637,586,183,769,62,831
公投第７案,桃園市,桃園區,建國里,12,1943,665,207,872,60,932
公投第７案,桃園市,桃園區,雲林里,13,1482,550,183,733,41,774
公投第７案,桃園市,桃園區,雲林里,14,1423,567,152,719,58,777
公投第７案,桃園市,桃園區,雲林里,15,1509,615,167,782,51,833
公投第７案,桃園市,桃園區,雲林里,16,1567,674,142,816,33,849
公投第７案,桃園市,桃園區,福安里,17,1305,536,127,663,45,708
公投第７案,桃園市,桃園區,福安里,18,1416,513,130,643,36,679
公投第７案,桃園市,桃園區,福安里,19,1439,607,168,775,36,811
公投第７案,桃園市,桃園區,福林里,20,1399,536,196,732,49,781
公投第７案,桃園市,桃園區,福林里,21,1540,637,178,815,45,860
公投第７案,桃園市,桃園區,福林里,22,1638,627,135,762,39,801
公投第７案,桃園市,桃園區,福林里,23,1228,473,127,600,39,639
公投第７案,桃園市,桃園區,豐林里,24,1649,621,149,770,57,827
公投第７案,桃園市,桃園區,豐林里,25,1601,617,179,796,37,833
公投第７案,桃園市,桃園區,豐林里,26,1477,529,149,678,67,745
公投第７案,桃園市,桃園區,豐林里,27,1503,589,156,745,35,780
公投第７案,桃園市,桃園區,中和里,28,1375,535,184,719,72,791
公投第７案,桃園市,桃園區,中興里,29,1743,666,222,888,50,938
公投第７案,桃園市,桃園區,中興里,30,1862,644,200,844,65,909
公投第７案,桃園市,桃園區,中興里,31,1728,666,183,849,53,902
公投第７案,桃園市,桃園區,文化里,32,690,269,77,346,15,361
公投第７案,桃園市,桃園區,文昌里,33,852,368,111,479,36,515
公投第７案,桃園市,桃園區,文明里,34,1353,548,175,723,54,777
公投第７案,桃園市,桃園區,北門里,35,1698,479,119,598,32,630
公投第７案,桃園市,桃園區,民生里,36,1452,516,165,681,59,740
公投第７案,桃園市,桃園區,永興里,37,1681,606,206,812,58,870
公投第７案,桃園市,桃園區,光興里,38,1669,590,203,793,61,854
公投第７案,桃園市,桃園區,光興里,39,1530,616,194,810,54,864
公投第７案,桃園市,桃園區,光興里,40,1582,611,194,805,48,853
公投第７案,桃園市,桃園區,西門里,41,1587,580,137,717,45,762
公投第７案,桃園市,桃園區,西湖里,42,1451,551,196,747,59,806
公投第７案,桃園市,桃園區,武陵里,43,1582,497,183,680,46,726
公投第７案,桃園市,桃園區,長美里,44,1028,389,151,540,44,584
公投第７案,桃園市,桃園區,南門里,45,1934,719,161,880,86,966
公投第７案,桃園市,桃園區,南門里,46,1016,301,204,505,46,551
公投第７案,桃園市,桃園區,南門里,47,1079,425,122,547,33,580
公投第７案,桃園市,桃園區,南門里,48,1837,664,173,837,33,870
公投第７案,桃園市,桃園區,南華里,49,1390,525,173,698,58,756
公投第７案,桃園市,桃園區,中山里,50,1489,515,238,753,38,791
公投第７案,桃園市,桃園區,中山里,51,1821,756,226,982,27,1009
公投第７案,桃園市,桃園區,中山里,52,1563,568,137,705,24,729
公投第７案,桃園市,桃園區,中山里,53,1697,715,169,884,31,915
公投第７案,桃園市,桃園區,中平里,54,1740,718,182,900,38,938
公投第７案,桃園市,桃園區,中平里,55,1626,639,167,806,42,848
公投第７案,桃園市,桃園區,中平里,56,1239,548,115,663,14,677
公投第７案,桃園市,桃園區,中正里,57,1766,720,177,897,42,939
公投第７案,桃園市,桃園區,中正里,58,1555,606,179,785,48,833
公投第７案,桃園市,桃園區,中正里,59,1831,709,207,916,41,957
公投第７案,桃園市,桃園區,中成里,60,1115,505,127,632,33,665
公投第７案,桃園市,桃園區,中成里,61,1562,594,226,820,39,859
公投第７案,桃園市,桃園區,中成里,62,1744,679,172,851,43,894
公投第７案,桃園市,桃園區,中信里,63,1838,614,194,808,49,857
公投第７案,桃園市,桃園區,中信里,64,1889,726,227,953,71,1024
公投第７案,桃園市,桃園區,中信里,65,1985,707,178,885,53,938
公投第７案,桃園市,桃園區,中原里,66,1524,663,171,834,41,875
公投第７案,桃園市,桃園區,中原里,67,1425,681,144,825,47,872
公投第７案,桃園市,桃園區,中原里,68,1606,705,181,886,38,924
公投第７案,桃園市,桃園區,中泰里,69,2056,892,212,1104,32,1136
公投第７案,桃園市,桃園區,中泰里,70,2010,876,203,1079,33,1112
公投第７案,桃園市,桃園區,中聖里,71,2245,870,186,1056,53,1109
公投第７案,桃園市,桃園區,中聖里,72,1590,628,176,804,37,841
公投第７案,桃園市,桃園區,中聖里,73,1536,701,180,881,30,911
公投第７案,桃園市,桃園區,中路里,74,1949,676,205,881,60,941
公投第７案,桃園市,桃園區,中路里,75,1965,742,180,922,49,971
公投第７案,桃園市,桃園區,中德里,76,2414,834,187,1021,63,1084
公投第７案,桃園市,桃園區,中德里,77,1942,751,181,932,58,990
公投第７案,桃園市,桃園區,中德里,78,2156,844,219,1063,48,1111
公投第７案,桃園市,桃園區,文中里,79,1404,549,189,738,49,787
公投第７案,桃園市,桃園區,文中里,80,1194,542,131,673,25,698
公投第７案,桃園市,桃園區,玉山里,81,1449,554,207,761,67,828
公投第７案,桃園市,桃園區,玉山里,82,1803,610,189,799,73,872
公投第７案,桃園市,桃園區,玉山里,83,1692,648,203,851,47,898
公投第７案,桃園市,桃園區,泰山里,84,1913,723,216,939,50,989
公投第７案,桃園市,桃園區,泰山里,85,1815,671,210,881,62,943
公投第７案,桃園市,桃園區,龍山里,86,1173,417,127,544,42,586
公投第７案,桃園市,桃園區,龍山里,87,1162,449,83,532,22,554
公投第７案,桃園市,桃園區,龍山里,88,1194,392,104,496,57,553
公投第７案,桃園市,桃園區,龍安里,89,1695,662,193,855,49,904
公投第７案,桃園市,桃園區,龍安里,90,1797,687,170,857,40,897
公投第７案,桃園市,桃園區,龍安里,91,1592,649,132,781,34,815
公投第７案,桃園市,桃園區,龍岡里,92,1780,663,168,831,67,898
公投第７案,桃園市,桃園區,龍岡里,93,1904,668,169,837,34,871
公投第７案,桃園市,桃園區,龍岡里,94,2021,763,186,949,26,975
公投第７案,桃園市,桃園區,龍祥里,95,1545,613,137,750,41,791
公投第７案,桃園市,桃園區,龍祥里,96,1617,624,128,752,31,783
公投第７案,桃園市,桃園區,龍祥里,97,1683,671,146,817,35,852
公投第７案,桃園市,桃園區,龍壽里,98,1834,765,184,949,51,1000
公投第７案,桃園市,桃園區,龍壽里,99,2055,730,188,918,38,956
公投第７案,桃園市,桃園區,龍壽里,100,1828,703,157,860,26,886
公投第７案,桃園市,桃園區,龍鳳里,101,1873,707,172,879,37,916
公投第７案,桃園市,桃園區,龍鳳里,102,3687,594,131,725,38,763
公投第７案,桃園市,桃園區,龍鳳里,103,1850,710,184,894,7,901
公投第７案,桃園市,桃園區,龍鳳里,104,1827,712,158,870,44,914
公投第７案,桃園市,桃園區,中埔里,105,1149,525,128,653,37,690
公投第７案,桃園市,桃園區,中埔里,106,1061,458,124,582,38,620
公投第７案,桃園市,桃園區,中寧里,107,1831,651,162,813,34,847
公投第７案,桃園市,桃園區,中寧里,108,2168,819,205,1024,58,1082
公投第７案,桃園市,桃園區,中寧里,109,1874,705,181,886,30,916
公投第７案,桃園市,桃園區,北埔里,110,1524,531,143,674,24,698
公投第７案,桃園市,桃園區,北埔里,111,1528,625,156,781,32,813
公投第７案,桃園市,桃園區,北埔里,112,1489,610,152,762,44,806
公投第７案,桃園市,桃園區,永安里,113,1308,481,137,618,62,680
公投第７案,桃園市,桃園區,永安里,114,1583,592,157,749,55,804
公投第７案,桃園市,桃園區,永安里,115,1618,620,206,826,54,880
公投第７案,桃園市,桃園區,同安里,116,2127,740,227,967,66,1033
公投第７案,桃園市,桃園區,同安里,117,2033,746,190,936,22,958
公投第７案,桃園市,桃園區,同安里,118,2098,819,202,1021,36,1057
公投第７案,桃園市,桃園區,同安里,119,2126,869,220,1089,74,1163
公投第７案,桃園市,桃園區,同德里,120,1917,734,170,904,43,947
公投第７案,桃園市,桃園區,同德里,121,1997,744,179,923,47,970
公投第７案,桃園市,桃園區,同德里,122,1929,875,96,971,41,1012
公投第７案,桃園市,桃園區,自強里,123,1691,640,177,817,41,858
公投第７案,桃園市,桃園區,自強里,124,1900,761,164,925,36,961
公投第７案,桃園市,桃園區,自強里,125,1761,709,164,873,60,933
公投第７案,桃園市,桃園區,自強里,126,1922,712,198,910,33,943
公投第７案,桃園市,桃園區,西埔里,127,1995,749,162,911,45,956
公投第７案,桃園市,桃園區,西埔里,128,1063,411,123,534,43,577
公投第７案,桃園市,桃園區,明德里,129,1412,556,126,682,48,730
公投第７案,桃園市,桃園區,明德里,130,1746,716,187,903,22,925
公投第７案,桃園市,桃園區,東埔里,131,1689,572,182,754,58,812
公投第７案,桃園市,桃園區,東埔里,132,1542,479,146,625,33,658
公投第７案,桃園市,桃園區,東埔里,133,1437,529,138,667,42,709
公投第７案,桃園市,桃園區,長安里,134,1679,617,167,784,38,822
公投第７案,桃園市,桃園區,長安里,135,1886,623,190,813,63,876
公投第７案,桃園市,桃園區,長德里,136,1657,661,165,826,65,891
公投第７案,桃園市,桃園區,長德里,137,1349,528,146,674,15,689
公投第７案,桃園市,桃園區,長德里,138,1805,818,78,896,38,934
公投第７案,桃園市,桃園區,信光里,139,1846,677,180,857,70,927
公投第７案,桃園市,桃園區,信光里,140,1644,568,158,726,46,772
公投第７案,桃園市,桃園區,信光里,141,1674,584,163,747,57,804
公投第７案,桃園市,桃園區,信光里,142,1737,635,202,837,47,884
公投第７案,桃園市,桃園區,南埔里,143,1566,594,186,780,54,834
公投第７案,桃園市,桃園區,南埔里,144,1517,623,163,786,41,827
公投第７案,桃園市,桃園區,南埔里,145,1619,566,146,712,34,746
公投第７案,桃園市,桃園區,莊敬里,146,1774,636,245,881,27,908
公投第７案,桃園市,桃園區,莊敬里,147,1666,687,148,835,35,870
公投第７案,桃園市,桃園區,莊敬里,148,1528,608,160,768,26,794
公投第７案,桃園市,桃園區,莊敬里,149,1709,644,198,842,43,885
公投第７案,桃園市,桃園區,莊敬里,150,1719,659,167,826,34,860
公投第７案,桃園市,桃園區,慈文里,151,1569,531,150,681,50,731
公投第７案,桃園市,桃園區,慈文里,152,1505,558,149,707,36,743
公投第７案,桃園市,桃園區,慈文里,153,1496,547,160,707,48,755
公投第７案,桃園市,桃園區,慈文里,154,1505,622,140,762,40,802
公投第７案,桃園市,桃園區,新埔里,155,1807,699,165,864,45,909
公投第７案,桃園市,桃園區,新埔里,156,1857,727,175,902,44,946
公投第７案,桃園市,桃園區,新埔里,157,1589,658,174,832,59,891
公投第７案,桃園市,桃園區,新埔里,158,2088,772,224,996,44,1040
公投第７案,桃園市,桃園區,新埔里,159,1893,738,173,911,37,948
公投第７案,桃園市,桃園區,瑞慶里,160,1303,437,118,555,37,592
公投第７案,桃園市,桃園區,瑞慶里,161,1416,547,169,716,38,754
公投第７案,桃園市,桃園區,瑞慶里,162,1351,499,130,629,33,662
公投第７案,桃園市,桃園區,瑞慶里,163,1659,628,143,771,38,809
公投第７案,桃園市,桃園區,寶安里,164,2103,790,171,961,49,1010
公投第７案,桃園市,桃園區,寶安里,165,1943,721,179,900,58,958
公投第７案,桃園市,桃園區,寶安里,166,1927,722,200,922,52,974
公投第７案,桃園市,桃園區,寶安里,167,1929,671,151,822,52,874
公投第７案,桃園市,桃園區,寶慶里,168,2204,930,247,1177,45,1222
公投第７案,桃園市,桃園區,寶慶里,169,2033,682,217,899,31,930
公投第７案,桃園市,桃園區,寶慶里,170,1656,670,151,821,20,841
公投第７案,桃園市,桃園區,三元里,171,1712,609,177,786,60,846
公投第７案,桃園市,桃園區,三元里,172,1738,656,172,828,48,876
公投第７案,桃園市,桃園區,三民里,173,1432,718,105,823,23,846
公投第７案,桃園市,桃園區,三民里,174,1421,637,137,774,47,821
公投第７案,桃園市,桃園區,三民里,175,1344,520,145,665,26,691
公投第７案,桃園市,桃園區,大有里,176,1942,686,173,859,41,900
公投第７案,桃園市,桃園區,大有里,177,2001,776,181,957,43,1000
公投第７案,桃園市,桃園區,大有里,178,1941,682,155,837,25,862
公投第７案,桃園市,桃園區,大業里,179,1702,671,180,851,50,901
公投第７案,桃園市,桃園區,大業里,180,1589,624,155,779,42,821
公投第７案,桃園市,桃園區,大業里,181,1544,612,136,748,35,783
公投第７案,桃園市,桃園區,大興里,182,1860,587,158,745,32,777
公投第７案,桃園市,桃園區,大興里,183,1726,639,170,809,58,867
公投第７案,桃園市,桃園區,大興里,184,1798,640,189,829,39,868
公投第７案,桃園市,桃園區,成功里,185,1925,718,206,924,37,961
公投第７案,桃園市,桃園區,成功里,186,1945,679,226,905,42,947
公投第７案,桃園市,桃園區,汴洲里,187,1764,587,191,778,48,826
公投第７案,桃園市,桃園區,汴洲里,188,1899,772,197,969,62,1031
公投第７案,桃園市,桃園區,汴洲里,189,1415,554,137,691,21,712
公投第７案,桃園市,桃園區,忠義里,190,1790,660,157,817,33,850
公投第７案,桃園市,桃園區,忠義里,191,1693,515,156,671,25,696
公投第７案,桃園市,桃園區,東山里,192,1916,684,188,872,55,927
公投第７案,桃園市,桃園區,東門里,193,1434,483,145,628,31,659
公投第７案,桃園市,桃園區,東門里,194,1494,616,188,804,44,848
公投第７案,桃園市,桃園區,青溪里,195,1311,510,155,665,54,719
公投第７案,桃園市,桃園區,青溪里,196,1476,542,187,729,42,771
公投第７案,桃園市,桃園區,青溪里,197,1484,593,188,781,47,828
公投第７案,桃園市,桃園區,春日里,198,1514,585,143,728,44,772
公投第７案,桃園市,桃園區,春日里,199,1446,568,126,694,60,754
公投第７案,桃園市,桃園區,春日里,200,1573,562,147,709,19,728
公投第７案,桃園市,桃園區,春日里,201,1564,552,132,684,39,723
公投第７案,桃園市,桃園區,朝陽里,202,1015,405,124,529,40,569
公投第７案,桃園市,桃園區,朝陽里,203,955,383,91,474,26,500
公投第７案,桃園市,桃園區,會稽里,204,1796,690,165,855,41,896
公投第７案,桃園市,桃園區,會稽里,205,1878,750,157,907,29,936
公投第７案,桃園市,桃園區,會稽里,206,1729,629,176,805,40,845
公投第７案,桃園市,桃園區,會稽里,207,1843,641,151,792,26,818
公投第７案,桃園市,桃園區,會稽里,208,1817,608,140,748,34,782
公投第７案,桃園市,桃園區,萬壽里,209,979,387,129,516,35,551
公投第７案,桃園市,桃園區,福元里,210,1363,552,137,689,30,719
公投第７案,桃園市,桃園區,福元里,211,1546,626,118,744,13,757
公投第７案,桃園市,桃園區,福元里,212,1308,514,111,625,32,657
公投第７案,桃園市,桃園區,寶山里,213,2164,807,200,1007,62,1069
公投第７案,桃園市,桃園區,寶山里,214,2020,705,216,921,48,969
公投第７案,桃園市,桃園區,寶山里,215,1924,661,146,807,46,853
公投第７案,桃園市,桃園區,寶山里,216,2088,701,159,860,44,904
公投第７案,桃園市,龜山區,精忠里,217,874,404,61,465,17,482
公投第７案,桃園市,龜山區,精忠里,218,2014,845,160,1005,66,1071
公投第７案,桃園市,龜山區,精忠里,219,2145,810,195,1005,28,1033
公投第７案,桃園市,龜山區,陸光里,220,1744,793,97,890,55,945
公投第７案,桃園市,龜山區,陸光里,221,1885,821,134,955,56,1011
公投第７案,桃園市,龜山區,中興里,222,1546,562,139,701,54,755
公投第７案,桃園市,龜山區,中興里,223,1684,595,174,769,55,824
公投第７案,桃園市,龜山區,中興里,224,1477,478,156,634,27,661
公投第７案,桃園市,龜山區,新興里,225,1528,669,128,797,56,853
公投第７案,桃園市,龜山區,新興里,226,1428,213,64,277,14,291
公投第７案,桃園市,龜山區,新路里,227,1525,625,154,779,57,836
公投第７案,桃園市,龜山區,新路里,228,1041,430,130,560,45,605
公投第７案,桃園市,龜山區,新路里,229,1404,484,160,644,40,684
公投第７案,桃園市,龜山區,新路里,230,1478,589,168,757,54,811
公投第７案,桃園市,龜山區,龜山里,231,2178,816,233,1049,62,1111
公投第７案,桃園市,龜山區,龜山里,232,1672,617,185,802,91,893
公投第７案,桃園市,龜山區,龜山里,233,1376,532,113,645,39,684
公投第７案,桃園市,龜山區,龜山里,234,1480,540,163,703,47,750
公投第７案,桃園市,龜山區,大同里,235,1258,521,133,654,35,689
公投第７案,桃園市,龜山區,大同里,236,1464,588,121,709,28,737
公投第７案,桃園市,龜山區,大同里,237,1844,663,189,852,84,936
公投第７案,桃園市,龜山區,大同里,238,1169,457,125,582,21,603
公投第７案,桃園市,龜山區,山頂里,239,1921,561,150,711,23,734
公投第７案,桃園市,龜山區,山頂里,240,1694,603,162,765,26,791
公投第７案,桃園市,龜山區,山頂里,241,1771,741,191,932,52,984
公投第７案,桃園市,龜山區,山德里,242,1665,570,161,731,51,782
公投第７案,桃園市,龜山區,山德里,243,1439,514,70,584,56,640
公投第７案,桃園市,龜山區,山德里,244,1728,560,163,723,67,790
公投第７案,桃園市,龜山區,山福里,245,1788,692,171,863,42,905
公投第７案,桃園市,龜山區,山福里,246,1465,507,143,650,48,698
公投第７案,桃園市,龜山區,幸福里,247,1659,517,124,641,46,687
公投第７案,桃園市,龜山區,幸福里,248,1693,551,150,701,34,735
公投第７案,桃園市,龜山區,幸福里,249,1818,517,132,649,19,668
公投第７案,桃園市,龜山區,龍壽里,250,1752,589,223,812,72,884
公投第７案,桃園市,龜山區,龍華里,251,1818,653,194,847,33,880
公投第７案,桃園市,龜山區,龍華里,252,1499,560,138,698,29,727
公投第７案,桃園市,龜山區,迴龍里,253,1916,704,196,900,56,956
公投第７案,桃園市,龜山區,迴龍里,254,1804,659,199,858,41,899
公投第７案,桃園市,龜山區,迴龍里,255,2127,725,226,951,42,993
公投第７案,桃園市,龜山區,嶺頂里,256,1005,356,121,477,60,537
公投第７案,桃園市,龜山區,嶺頂里,257,1449,592,135,727,33,760
公投第７案,桃園市,龜山區,嶺頂里,258,1498,501,157,658,61,719
公投第７案,桃園市,龜山區,新嶺里,259,2149,704,211,915,46,961
公投第７案,桃園市,龜山區,新嶺里,260,1771,518,119,637,18,655
公投第７案,桃園市,龜山區,兔坑里,261,841,316,89,405,22,427
公投第７案,桃園市,龜山區,兔坑里,262,2284,736,246,982,64,1046
公投第７案,桃園市,龜山區,兔坑里,263,1228,448,144,592,59,651
公投第７案,桃園市,龜山區,福源里,264,1979,681,155,836,43,879
公投第７案,桃園市,龜山區,舊路里,265,1378,482,114,596,28,624
公投第７案,桃園市,龜山區,舊路里,266,1061,373,115,488,44,532
公投第７案,桃園市,龜山區,大坑里,267,1917,680,172,852,47,899
公投第７案,桃園市,龜山區,楓福里,268,1540,708,164,872,30,902
公投第７案,桃園市,龜山區,楓福里,269,1433,613,133,746,20,766
公投第７案,桃園市,龜山區,楓樹里,270,1455,530,173,703,20,723
公投第７案,桃園市,龜山區,楓樹里,271,2280,905,247,1152,70,1222
公投第７案,桃園市,龜山區,樂善里,272,1668,606,196,802,35,837
公投第７案,桃園市,龜山區,樂善里,273,1885,652,205,857,38,895
公投第７案,桃園市,龜山區,長庚里,274,1849,666,202,868,35,903
公投第７案,桃園市,龜山區,長庚里,275,1704,635,268,903,37,940
公投第７案,桃園市,龜山區,公西里,276,1156,453,129,582,34,616
公投第７案,桃園市,龜山區,大崗里,277,2114,674,154,828,52,880
公投第７案,桃園市,龜山區,大崗里,278,1943,649,182,831,29,860
公投第７案,桃園市,龜山區,大湖里,279,1800,615,177,792,43,835
公投第７案,桃園市,龜山區,大湖里,280,2020,714,199,913,52,965
公投第７案,桃園市,龜山區,大湖里,281,1319,568,126,694,37,731
公投第７案,桃園市,龜山區,大華里,282,2229,876,247,1123,46,1169
公投第７案,桃園市,龜山區,大華里,283,1992,690,223,913,21,934
公投第７案,桃園市,龜山區,大華里,284,2237,786,210,996,53,1049
公投第７案,桃園市,龜山區,大華里,285,2133,809,181,990,33,1023
公投第７案,桃園市,龜山區,文化里,286,2187,822,224,1046,59,1105
公投第７案,桃園市,龜山區,文化里,287,1959,718,176,894,58,952
公投第７案,桃園市,龜山區,文化里,288,1910,606,220,826,40,866
公投第７案,桃園市,龜山區,南上里,289,1840,661,225,886,92,978
公投第７案,桃園市,龜山區,南美里,290,2266,855,225,1080,48,1128
公投第７案,桃園市,龜山區,文青里,291,2387,867,162,1029,28,1057
公投第７案,桃園市,龜山區,文青里,292,1692,613,150,763,22,785
公投第７案,桃園市,龜山區,文青里,293,904,355,89,444,16,460
公投第７案,桃園市,龜山區,文青里,294,1469,628,129,757,25,782
公投第７案,桃園市,八德區,興仁里,295,1761,610,146,756,90,846
公投第７案,桃園市,八德區,興仁里,296,1804,561,142,703,17,720
公投第７案,桃園市,八德區,興仁里,297,1813,378,102,480,32,512
公投第７案,桃園市,八德區,興仁里,298,1784,631,141,772,37,809
公投第７案,桃園市,八德區,福興里,299,2257,794,125,919,47,966
公投第７案,桃園市,八德區,福興里,300,1857,596,116,712,29,741
公投第７案,桃園市,八德區,福興里,301,2261,784,168,952,44,996
公投第７案,桃園市,八德區,福興里,302,1903,740,193,933,55,988
公投第７案,桃園市,八德區,瑞豐里,303,1955,750,161,911,66,977
公投第７案,桃園市,八德區,瑞豐里,304,1665,559,131,690,18,708
公投第７案,桃園市,八德區,瑞興里,305,1431,564,169,733,50,783
公投第７案,桃園市,八德區,瑞興里,306,1263,518,128,646,37,683
公投第７案,桃園市,八德區,瑞泰里,307,1583,662,164,826,62,888
公投第７案,桃園市,八德區,瑞泰里,308,1246,534,120,654,30,684
公投第７案,桃園市,八德區,瑞泰里,309,1356,553,146,699,31,730
公投第７案,桃園市,八德區,瑞發里,310,1630,670,161,831,73,904
公投第７案,桃園市,八德區,瑞發里,311,1586,595,114,709,31,740
公投第７案,桃園市,八德區,瑞德里,312,1649,625,169,794,61,855
公投第７案,桃園市,八德區,瑞德里,313,1910,657,146,803,91,894
公投第７案,桃園市,八德區,瑞祥里,314,1612,641,177,818,72,890
公投第７案,桃園市,八德區,瑞祥里,315,1640,687,127,814,40,854
公投第７案,桃園市,八德區,廣德里,316,1303,481,148,629,38,667
公投第７案,桃園市,八德區,廣德里,317,1413,615,141,756,51,807
公投第７案,桃園市,八德區,廣興里,318,1711,640,178,818,47,865
公投第７案,桃園市,八德區,廣興里,319,1562,635,131,766,66,832
公投第７案,桃園市,八德區,廣隆里,320,1735,682,142,824,59,883
公投第７案,桃園市,八德區,廣隆里,321,1658,650,156,806,38,844
公投第７案,桃園市,八德區,廣隆里,322,1022,439,132,571,38,609
公投第７案,桃園市,八德區,竹園里,323,1673,581,142,723,47,770
公投第７案,桃園市,八德區,竹園里,324,1741,628,150,778,34,812
公投第７案,桃園市,八德區,霄裡里,325,2110,798,223,1021,62,1083
公投第７案,桃園市,八德區,龍友里,326,1145,501,83,584,23,607
公投第７案,桃園市,八德區,龍友里,327,1010,279,89,368,30,398
公投第７案,桃園市,八德區,茄明里,328,1848,617,157,774,19,793
公投第７案,桃園市,八德區,茄明里,329,1334,534,143,677,43,720
公投第７案,桃園市,八德區,茄明里,330,1349,438,115,553,27,580
公投第７案,桃園市,八德區,茄苳里,331,1341,578,151,729,35,764
公投第７案,桃園市,八德區,茄苳里,332,1178,519,112,631,50,681
公投第７案,桃園市,八德區,永豐里,333,1374,544,158,702,37,739
公投第７案,桃園市,八德區,永豐里,334,1462,497,171,668,71,739
公投第７案,桃園市,八德區,高明里,335,1943,733,61,794,49,843
公投第７案,桃園市,八德區,高明里,336,1928,533,151,684,77,761
公投第７案,桃園市,八德區,高城里,337,1403,449,147,596,27,623
公投第７案,桃園市,八德區,高城里,338,1672,582,167,749,51,800
公投第７案,桃園市,八德區,白鷺里,339,1947,665,202,867,35,902
公投第７案,桃園市,八德區,白鷺里,340,1200,453,135,588,39,627
公投第７案,桃園市,八德區,大湳里,341,1895,641,182,823,71,894
公投第７案,桃園市,八德區,大湳里,342,1988,665,192,857,62,919
公投第７案,桃園市,八德區,大發里,343,2006,760,222,982,60,1042
公投第７案,桃園市,八德區,大仁里,344,2061,697,204,901,13,914
公投第７案,桃園市,八德區,大仁里,345,2108,659,238,897,65,962
公投第７案,桃園市,八德區,大明里,346,1862,673,164,837,54,891
公投第７案,桃園市,八德區,大明里,347,1681,626,161,787,32,819
公投第７案,桃園市,八德區,大安里,348,1317,503,147,650,63,713
公投第７案,桃園市,八德區,大安里,349,2093,886,215,1101,63,1164
公投第７案,桃園市,八德區,大竹里,350,1499,596,199,795,56,851
公投第７案,桃園市,八德區,大興里,351,1782,676,177,853,54,907
公投第７案,桃園市,八德區,大興里,352,1763,710,156,866,33,899
公投第７案,桃園市,八德區,大愛里,353,1226,493,122,615,53,668
公投第７案,桃園市,八德區,大愛里,354,1311,552,148,700,38,738
公投第７案,桃園市,八德區,大華里,355,1170,500,107,607,36,643
公投第７案,桃園市,八德區,大華里,356,1313,563,120,683,29,712
公投第７案,桃園市,八德區,大順里,357,1186,507,117,624,25,649
公投第７案,桃園市,八德區,大順里,358,1481,539,133,672,49,721
公投第７案,桃園市,八德區,大和里,359,1998,774,189,963,62,1025
公投第７案,桃園市,八德區,大和里,360,916,386,91,477,30,507
公投第７案,桃園市,八德區,大和里,361,1943,720,161,881,47,928
公投第７案,桃園市,八德區,大和里,362,2076,804,147,951,39,990
公投第７案,桃園市,八德區,大昌里,363,1363,528,138,666,64,730
公投第７案,桃園市,八德區,大昌里,364,1491,570,163,733,54,787
公投第７案,桃園市,八德區,大信里,365,1474,550,152,702,67,769
公投第７案,桃園市,八德區,大信里,366,718,136,26,162,13,175
公投第７案,桃園市,八德區,大信里,367,1386,528,156,684,8,692
公投第７案,桃園市,八德區,陸光里,368,1487,579,125,704,67,771
公投第７案,桃園市,八德區,陸光里,369,1552,628,114,742,68,810
公投第７案,桃園市,八德區,陸光里,370,1255,84,475,559,54,613
公投第７案,桃園市,八德區,大同里,371,1505,626,150,776,63,839
公投第７案,桃園市,八德區,大慶里,372,1436,488,149,637,64,701
公投第７案,桃園市,八德區,大成里,373,1618,605,205,810,67,877
公投第７案,桃園市,八德區,大成里,374,1685,667,128,795,69,864
公投第７案,桃園市,八德區,大義里,375,1835,648,140,788,52,840
公投第７案,桃園市,八德區,大義里,376,1881,724,157,881,56,937
公投第７案,桃園市,八德區,大忠里,377,1766,619,168,787,47,834
公投第７案,桃園市,八德區,大智里,378,1817,692,162,854,68,922
公投第７案,桃園市,八德區,大智里,379,2198,936,159,1095,34,1129
公投第７案,桃園市,八德區,大宏里,380,1732,691,166,857,49,906
公投第７案,桃園市,八德區,大宏里,381,2089,829,221,1050,33,1083
公投第７案,桃園市,八德區,大正里,382,1257,525,117,642,31,673
公投第７案,桃園市,八德區,大正里,383,1267,488,120,608,48,656
公投第７案,桃園市,八德區,大正里,384,1427,616,126,742,23,765
公投第７案,桃園市,八德區,大福里,385,1685,723,192,915,52,967
公投第７案,桃園市,八德區,大福里,386,1748,695,199,894,50,944
公投第７案,桃園市,八德區,大福里,387,1650,902,174,1076,49,1125
公投第７案,桃園市,八德區,大強里,388,1478,563,167,730,56,786
公投第７案,桃園市,八德區,大強里,389,1607,657,153,810,53,863
公投第７案,桃園市,八德區,大勇里,390,1841,744,203,947,68,1015
公投第７案,桃園市,八德區,大勇里,391,2082,799,195,994,64,1058
公投第７案,桃園市,八德區,大榮里,392,1959,696,155,851,49,900
公投第７案,桃園市,八德區,大千里,393,2209,900,196,1096,53,1149
公投第７案,桃園市,八德區,大漢里,394,1864,777,146,923,50,973
公投第７案,桃園市,八德區,大漢里,395,2000,735,204,939,59,998
公投第７案,桃園市,蘆竹區,新興里,396,1358,462,164,626,75,701
公投第７案,桃園市,蘆竹區,新興里,397,1538,493,192,685,85,770
公投第７案,桃園市,蘆竹區,中福里,398,2118,646,169,815,62,877
公投第７案,桃園市,蘆竹區,中福里,399,1673,688,180,868,61,929
公投第７案,桃園市,蘆竹區,上興里,400,1500,578,170,748,30,778
公投第７案,桃園市,蘆竹區,上興里,401,1699,669,190,859,47,906
公投第７案,桃園市,蘆竹區,中興里,402,2250,882,199,1081,59,1140
公投第７案,桃園市,蘆竹區,中興里,403,2354,805,206,1011,24,1035
公投第７案,桃園市,蘆竹區,新莊里,404,1446,491,131,622,24,646
公投第７案,桃園市,蘆竹區,新莊里,405,1623,548,151,699,54,753
公投第７案,桃園市,蘆竹區,新莊里,406,1747,642,141,783,35,818
公投第７案,桃園市,蘆竹區,上竹里,407,1988,744,208,952,69,1021
公投第７案,桃園市,蘆竹區,上竹里,408,1437,566,146,712,42,754
公投第７案,桃園市,蘆竹區,宏竹里,409,1532,609,176,785,68,853
公投第７案,桃園市,蘆竹區,宏竹里,410,1447,541,103,644,46,690
公投第７案,桃園市,蘆竹區,大竹里,411,2189,799,233,1032,59,1091
公投第７案,桃園市,蘆竹區,大竹里,412,2498,890,101,991,60,1051
公投第７案,桃園市,蘆竹區,富竹里,413,1322,499,160,659,28,687
公投第７案,桃園市,蘆竹區,蘆竹里,414,1991,576,183,759,86,845
公投第７案,桃園市,蘆竹區,蘆竹里,415,2097,691,218,909,77,986
公投第７案,桃園市,蘆竹區,南興里,416,1558,649,168,817,30,847
公投第７案,桃園市,蘆竹區,南興里,417,1891,748,199,947,51,998
公投第７案,桃園市,蘆竹區,南興里,418,1590,598,135,733,39,772
公投第７案,桃園市,蘆竹區,福昌里,419,2404,798,229,1027,46,1073
公投第７案,桃園市,蘆竹區,福昌里,420,2522,945,256,1201,49,1250
公投第７案,桃園市,蘆竹區,福興里,421,1633,648,160,808,34,842
公投第７案,桃園市,蘆竹區,福興里,422,1715,661,164,825,51,876
公投第７案,桃園市,蘆竹區,正興里,423,2215,738,206,944,34,978
公投第７案,桃園市,蘆竹區,正興里,424,2029,757,176,933,47,980
公投第７案,桃園市,蘆竹區,順興里,425,1731,642,153,795,41,836
公投第７案,桃園市,蘆竹區,順興里,426,1820,717,171,888,36,924
公投第７案,桃園市,蘆竹區,蘆興里,427,1633,656,147,803,72,875
公投第７案,桃園市,蘆竹區,南榮里,428,1668,523,164,687,20,707
公投第７案,桃園市,蘆竹區,南榮里,429,1493,653,142,795,31,826
公投第７案,桃園市,蘆竹區,南崁里,430,1864,692,200,892,69,961
公投第７案,桃園市,蘆竹區,南崁里,431,1703,576,178,754,25,779
公投第７案,桃園市,蘆竹區,錦興里,432,1893,682,196,878,33,911
公投第７案,桃園市,蘆竹區,錦興里,433,1922,765,226,991,68,1059
公投第７案,桃園市,蘆竹區,興榮里,434,1393,561,143,704,32,736
公投第７案,桃園市,蘆竹區,興榮里,435,1338,548,147,695,39,734
公投第７案,桃園市,蘆竹區,錦中里,436,1688,646,168,814,41,855
公投第７案,桃園市,蘆竹區,錦中里,437,1462,521,162,683,68,751
公投第７案,桃園市,蘆竹區,長興里,438,1232,440,146,586,27,613
公投第７案,桃園市,蘆竹區,長興里,439,1356,497,116,613,34,647
公投第７案,桃園市,蘆竹區,五福里,440,1181,542,123,665,48,713
公投第７案,桃園市,蘆竹區,五福里,441,1199,366,119,485,22,507
公投第７案,桃園市,蘆竹區,中山里,442,1710,729,157,886,34,920
公投第７案,桃園市,蘆竹區,中山里,443,1423,545,127,672,38,710
公投第７案,桃園市,蘆竹區,福祿里,444,1522,601,174,775,38,813
公投第７案,桃園市,蘆竹區,福祿里,445,1639,668,158,826,49,875
公投第７案,桃園市,蘆竹區,羊稠里,446,2055,782,204,986,40,1026
公投第７案,桃園市,蘆竹區,羊稠里,447,2178,826,225,1051,37,1088
公投第７案,桃園市,蘆竹區,吉祥里,448,1709,719,164,883,34,917
公投第７案,桃園市,蘆竹區,長壽里,449,1667,699,171,870,43,913
公投第７案,桃園市,蘆竹區,長壽里,450,1745,729,184,913,34,947
公投第７案,桃園市,蘆竹區,長壽里,451,1967,806,210,1016,53,1069
公投第７案,桃園市,蘆竹區,吉祥里,452,1802,766,191,957,35,992
公投第７案,桃園市,蘆竹區,營盤里,453,2727,992,258,1250,52,1302
公投第７案,桃園市,蘆竹區,營盤里,454,1868,660,169,829,34,863
公投第７案,桃園市,蘆竹區,營福里,455,1537,573,159,732,42,774
公投第７案,桃園市,蘆竹區,營福里,456,1616,611,190,801,41,842
公投第７案,桃園市,蘆竹區,瓦窯里,457,1483,609,189,798,56,854
公投第７案,桃園市,蘆竹區,瓦窯里,458,1689,651,142,793,54,847
公投第７案,桃園市,蘆竹區,內厝里,459,1318,394,112,506,55,561
公投第７案,桃園市,蘆竹區,內厝里,460,1203,501,159,660,98,758
公投第７案,桃園市,蘆竹區,山鼻里,461,1771,600,169,769,30,799
公投第７案,桃園市,蘆竹區,山腳里,462,1832,567,202,769,90,859
公投第７案,桃園市,蘆竹區,山腳里,463,1763,593,198,791,98,889
公投第７案,桃園市,蘆竹區,外社里,464,1497,421,152,573,21,594
公投第７案,桃園市,蘆竹區,坑子里,465,1671,666,205,871,118,989
公投第７案,桃園市,蘆竹區,坑口里,466,929,363,98,461,72,533
公投第７案,桃園市,蘆竹區,坑口里,467,1559,561,193,754,115,869
公投第７案,桃園市,蘆竹區,海湖里,468,1497,585,128,713,34,747
公投第７案,桃園市,蘆竹區,海湖里,469,1441,641,184,825,88,913
公投第７案,桃園市,蘆竹區,濱海里,470,1465,535,153,688,49,737
公投第７案,桃園市,蘆竹區,濱海里,471,1029,360,124,484,45,529
公投第７案,桃園市,大園區,大園里,472,1538,507,147,654,50,704
公投第７案,桃園市,大園區,大園里,473,1616,464,134,598,29,627
公投第７案,桃園市,大園區,大園里,474,1437,584,188,772,49,821
公投第７案,桃園市,大園區,大園里,475,1554,626,171,797,41,838
公投第７案,桃園市,大園區,田心里,476,1237,470,132,602,37,639
公投第７案,桃園市,大園區,田心里,477,1347,511,118,629,65,694
公投第７案,桃園市,大園區,田心里,478,1261,456,126,582,27,609
公投第７案,桃園市,大園區,田心里,479,1256,479,114,593,43,636
公投第７案,桃園市,大園區,田心里,480,1370,464,122,586,32,618
公投第７案,桃園市,大園區,溪海里,481,1610,541,159,700,44,744
公投第７案,桃園市,大園區,溪海里,482,1419,511,151,662,48,710
公投第７案,桃園市,大園區,溪海里,483,1588,476,125,601,20,621
公投第７案,桃園市,大園區,和平里,484,1612,608,160,768,38,806
公投第７案,桃園市,大園區,橫峰里,485,1440,521,148,669,42,711
公投第７案,桃園市,大園區,橫峰里,486,1326,480,133,613,33,646
公投第７案,桃園市,大園區,橫峰里,487,1455,628,141,769,51,820
公投第７案,桃園市,大園區,橫峰里,488,1562,607,169,776,61,837
公投第７案,桃園市,大園區,橫峰里,489,1284,543,140,683,30,713
公投第７案,桃園市,大園區,橫峰里,490,1454,522,141,663,23,686
公投第７案,桃園市,大園區,橫峰里,491,1490,586,149,735,23,758
公投第７案,桃園市,大園區,五權里,492,1617,511,154,665,46,711
公投第７案,桃園市,大園區,五權里,493,1594,553,157,710,90,800
公投第７案,桃園市,大園區,五權里,494,1650,606,173,779,61,840
公投第７案,桃園市,大園區,埔心里,495,1467,502,142,644,20,664
公投第７案,桃園市,大園區,埔心里,496,1494,546,160,706,35,741
公投第７案,桃園市,大園區,埔心里,497,1538,574,142,716,57,773
公投第７案,桃園市,大園區,埔心里,498,1397,511,134,645,22,667
公投第７案,桃園市,大園區,大海里,499,1637,586,149,735,16,751
公投第７案,桃園市,大園區,三石里,500,1452,519,128,647,55,702
公投第７案,桃園市,大園區,三石里,501,1414,588,156,744,46,790
公投第７案,桃園市,大園區,菓林里,502,1670,583,179,762,44,806
公投第７案,桃園市,大園區,菓林里,503,1701,573,153,726,17,743
公投第７案,桃園市,大園區,菓林里,504,1813,528,166,694,40,734
公投第７案,桃園市,大園區,菓林里,505,1687,568,150,718,48,766
公投第７案,桃園市,大園區,竹圍里,506,1650,749,56,805,11,816
公投第７案,桃園市,大園區,竹圍里,507,1556,651,175,826,48,874
公投第７案,桃園市,大園區,海口里,508,1844,620,157,777,38,815
公投第７案,桃園市,大園區,沙崙里,509,1336,475,116,591,62,653
公投第７案,桃園市,大園區,沙崙里,510,1414,537,182,719,66,785
公投第７案,桃園市,大園區,後厝里,511,1238,541,146,687,48,735
公投第７案,桃園市,大園區,後厝里,512,1227,545,145,690,49,739
公投第７案,桃園市,大園區,圳頭里,513,1199,424,138,562,20,582
公投第７案,桃園市,大園區,圳頭里,514,1349,433,38,471,27,498
公投第７案,桃園市,大園區,內海里,515,1120,414,109,523,29,552
公投第７案,桃園市,大園區,內海里,516,1080,407,107,514,31,545
公投第７案,桃園市,大園區,北港里,517,1341,491,131,622,36,658
公投第７案,桃園市,大園區,北港里,518,1345,507,169,676,33,709
公投第７案,桃園市,大園區,南港里,519,1565,548,134,682,43,725
公投第７案,桃園市,大園區,南港里,520,1519,483,151,634,23,657
公投第７案,桃園市,大園區,南港里,521,2130,737,190,927,58,985
公投第７案,桃園市,大溪區,興和里,522,1477,555,208,763,62,825
公投第７案,桃園市,大溪區,福仁里,523,1006,382,118,500,43,543
公投第７案,桃園市,大溪區,田心里,524,1553,569,170,739,77,816
公投第７案,桃園市,大溪區,田心里,525,1597,614,180,794,71,865
公投第７案,桃園市,大溪區,田心里,526,1358,536,137,673,58,731
公投第７案,桃園市,大溪區,一心里,527,1585,549,151,700,50,750
公投第７案,桃園市,大溪區,一心里,528,1612,616,176,792,43,835
公投第７案,桃園市,大溪區,一心里,529,1555,558,129,687,17,704
公投第７案,桃園市,大溪區,一德里,530,1282,539,173,712,62,774
公投第７案,桃園市,大溪區,一德里,531,1392,543,130,673,59,732
公投第７案,桃園市,大溪區,一德里,532,1422,501,163,664,54,718
公投第７案,桃園市,大溪區,一德里,533,1448,573,152,725,63,788
公投第７案,桃園市,大溪區,月眉里,534,1269,551,167,718,56,774
公投第７案,桃園市,大溪區,永福里,535,977,379,144,523,68,591
公投第７案,桃園市,大溪區,康安里,536,1359,535,181,716,37,753
公投第７案,桃園市,大溪區,義和里,537,1135,465,161,626,64,690
公投第７案,桃園市,大溪區,義和里,538,660,239,78,317,35,352
公投第７案,桃園市,大溪區,美華里,539,1056,376,108,484,38,522
公投第７案,桃園市,大溪區,美華里,540,1263,494,104,598,52,650
公投第７案,桃園市,大溪區,美華里,541,717,279,81,360,36,396
公投第７案,桃園市,大溪區,福安里,542,1299,367,139,506,20,526
公投第７案,桃園市,大溪區,福安里,543,976,391,102,493,46,539
公投第７案,桃園市,大溪區,復興里,544,938,351,108,459,45,504
公投第７案,桃園市,大溪區,新峰里,545,832,287,86,373,33,406
公投第７案,桃園市,大溪區,中新里,546,866,289,73,362,24,386
公投第７案,桃園市,大溪區,中新里,547,694,217,80,297,35,332
公投第７案,桃園市,大溪區,瑞興里,548,1410,442,177,619,40,659
公投第７案,桃園市,大溪區,瑞興里,549,1303,455,133,588,58,646
公投第７案,桃園市,大溪區,仁善里,550,1125,452,102,554,35,589
公投第７案,桃園市,大溪區,仁善里,551,1170,495,105,600,36,636
公投第７案,桃園市,大溪區,仁善里,552,1308,563,155,718,43,761
公投第７案,桃園市,大溪區,仁美里,553,1094,433,131,564,55,619
公投第７案,桃園市,大溪區,仁美里,554,2153,920,164,1084,61,1145
公投第７案,桃園市,大溪區,僑愛里,555,1173,564,71,635,43,678
公投第７案,桃園市,大溪區,僑愛里,556,1369,556,124,680,25,705
公投第７案,桃園市,大溪區,仁義里,557,1446,572,117,689,55,744
公投第７案,桃園市,大溪區,仁義里,558,1406,495,81,576,50,626
公投第７案,桃園市,大溪區,仁和里,559,1592,687,143,830,29,859
公投第７案,桃園市,大溪區,仁和里,560,1497,612,168,780,71,851
公投第７案,桃園市,大溪區,仁和里,561,1559,653,167,820,92,912
公投第７案,桃園市,大溪區,仁愛里,562,1684,649,152,801,23,824
公投第７案,桃園市,大溪區,仁愛里,563,1959,844,79,923,58,981
公投第７案,桃園市,大溪區,仁愛里,564,1369,560,143,703,74,777
公投第７案,桃園市,大溪區,仁武里,565,1431,592,136,728,66,794
公投第７案,桃園市,大溪區,仁武里,566,1657,494,129,623,25,648
公投第７案,桃園市,大溪區,仁文里,567,1387,441,126,567,30,597
公投第７案,桃園市,大溪區,仁文里,568,1085,423,102,525,42,567
公投第７案,桃園市,大溪區,仁文里,569,1403,599,140,739,52,791
公投第７案,桃園市,大溪區,南興里,570,1511,545,151,696,88,784
公投第７案,桃園市,大溪區,南興里,571,1719,534,178,712,85,797
公投第７案,桃園市,大溪區,南興里,572,1717,541,166,707,84,791
公投第７案,桃園市,大溪區,光明里,573,1207,458,124,582,68,650
公投第７案,桃園市,大溪區,光明里,574,1188,511,94,605,67,672
公投第７案,桃園市,大溪區,員林里,575,1514,528,148,676,29,705
公投第７案,桃園市,大溪區,三元里,576,1529,646,144,790,66,856
公投第７案,桃園市,大溪區,三元里,577,1260,574,121,695,45,740
公投第７案,桃園市,大溪區,瑞源里,578,831,357,95,452,19,471
公投第７案,桃園市,大溪區,瑞源里,579,1407,584,146,730,47,777
公投第７案,桃園市,大溪區,瑞源里,580,1494,524,132,656,65,721
公投第７案,桃園市,復興區,三民里,581,1991,796,205,1001,98,1099
公投第７案,桃園市,復興區,澤仁里,582,1392,574,143,717,65,782
公投第７案,桃園市,復興區,霞雲里,583,564,230,48,278,14,292
公投第７案,桃園市,復興區,義盛里,584,716,251,67,318,23,341
公投第７案,桃園市,復興區,羅浮里,585,1016,450,117,567,61,628
公投第７案,桃園市,復興區,長興里,586,669,195,54,249,13,262
公投第７案,桃園市,復興區,奎輝里,587,760,277,58,335,19,354
公投第７案,桃園市,復興區,高義里,588,751,326,11,337,20,357
公投第７案,桃園市,復興區,三光里,589,683,189,36,225,7,232
公投第７案,桃園市,復興區,華陵里,590,1224,452,104,556,35,591
公投第７案,桃園市,中壢區,後寮里,591,1401,605,85,690,45,735
公投第７案,桃園市,中壢區,後寮里,592,1798,666,188,854,46,900
公投第７案,桃園市,中壢區,後寮里,593,1642,579,146,725,47,772
公投第７案,桃園市,中壢區,明德里,594,1670,666,173,839,44,883
公投第７案,桃園市,中壢區,明德里,595,1456,606,164,770,21,791
公投第７案,桃園市,中壢區,明德里,596,1531,721,144,865,51,916
公投第７案,桃園市,中壢區,至善里,597,1623,738,153,891,41,932
公投第７案,桃園市,中壢區,至善里,598,1953,729,131,860,34,894
公投第７案,桃園市,中壢區,龍慈里,599,1155,520,114,634,23,657
公投第７案,桃園市,中壢區,龍慈里,600,1800,669,135,804,42,846
公投第７案,桃園市,中壢區,龍慈里,601,1757,697,121,818,33,851
公投第７案,桃園市,中壢區,龍興里,602,1281,580,130,710,47,757
公投第７案,桃園市,中壢區,龍興里,603,1462,638,159,797,31,828
公投第７案,桃園市,中壢區,龍興里,604,1560,585,133,718,54,772
公投第７案,桃園市,中壢區,龍德里,605,1602,722,170,892,33,925
公投第７案,桃園市,中壢區,龍德里,606,1006,502,114,616,29,645
公投第７案,桃園市,中壢區,龍德里,607,1474,655,137,792,25,817
公投第７案,桃園市,中壢區,龍岡里,608,1627,664,156,820,68,888
公投第７案,桃園市,中壢區,龍岡里,609,1519,650,171,821,38,859
公投第７案,桃園市,中壢區,龍岡里,610,1526,639,140,779,70,849
公投第７案,桃園市,中壢區,龍東里,611,1618,688,119,807,66,873
公投第７案,桃園市,中壢區,龍東里,612,1554,720,133,853,50,903
公投第７案,桃園市,中壢區,龍東里,613,1706,739,120,859,70,929
公投第７案,桃園市,中壢區,龍昌里,614,1818,817,170,987,36,1023
公投第７案,桃園市,中壢區,龍昌里,615,1991,875,53,928,39,967
公投第７案,桃園市,中壢區,龍昌里,616,1609,691,117,808,31,839
公投第７案,桃園市,中壢區,龍平里,617,1329,540,76,616,17,633
公投第７案,桃園市,中壢區,龍平里,618,1587,603,126,729,63,792
公投第７案,桃園市,中壢區,仁美里,619,1955,800,162,962,32,994
公投第７案,桃園市,中壢區,仁美里,620,1711,657,188,845,38,883
公投第７案,桃園市,中壢區,仁美里,621,1712,672,150,822,49,871
公投第７案,桃園市,中壢區,仁福里,622,1448,657,134,791,43,834
公投第７案,桃園市,中壢區,仁福里,623,1605,631,147,778,40,818
公投第７案,桃園市,中壢區,仁福里,624,1633,601,137,738,14,752
公投第７案,桃園市,中壢區,華愛里,625,1795,805,158,963,53,1016
公投第７案,桃園市,中壢區,華愛里,626,1689,725,159,884,30,914
公投第７案,桃園市,中壢區,普仁里,627,1201,607,30,637,33,670
公投第７案,桃園市,中壢區,普仁里,628,1353,537,138,675,34,709
公投第７案,桃園市,中壢區,普仁里,629,1587,625,138,763,32,795
公投第７案,桃園市,中壢區,普忠里,630,1883,786,170,956,50,1006
公投第７案,桃園市,中壢區,普忠里,631,1448,556,159,715,32,747
公投第７案,桃園市,中壢區,普強里,632,1810,765,156,921,33,954
公投第７案,桃園市,中壢區,普強里,633,1916,744,177,921,59,980
公投第７案,桃園市,中壢區,普慶里,634,1177,523,126,649,21,670
公投第７案,桃園市,中壢區,普慶里,635,1410,625,168,793,39,832
公投第７案,桃園市,中壢區,信義里,636,1368,553,137,690,18,708
公投第７案,桃園市,中壢區,信義里,637,1424,664,150,814,45,859
公投第７案,桃園市,中壢區,信義里,638,1573,687,157,844,34,878
公投第７案,桃園市,中壢區,正義里,639,1152,491,123,614,28,642
公投第７案,桃園市,中壢區,正義里,640,1178,484,139,623,10,633
公投第７案,桃園市,中壢區,正義里,641,1966,773,198,971,59,1030
公投第７案,桃園市,中壢區,普義里,642,3474,546,131,677,30,707
公投第７案,桃園市,中壢區,普義里,643,2099,865,204,1069,52,1121
公投第７案,桃園市,中壢區,德義里,644,1178,183,419,602,37,639
公投第７案,桃園市,中壢區,德義里,645,1397,640,166,806,51,857
公投第７案,桃園市,中壢區,仁義里,646,1669,681,182,863,58,921
公投第７案,桃園市,中壢區,仁義里,647,2087,796,168,964,52,1016
公投第７案,桃園市,中壢區,忠義里,648,1900,734,192,926,46,972
公投第７案,桃園市,中壢區,忠義里,649,1640,562,121,683,24,707
公投第７案,桃園市,中壢區,龍安里,650,994,469,99,568,27,595
公投第７案,桃園市,中壢區,龍安里,651,1131,581,99,680,49,729
公投第７案,桃園市,中壢區,仁愛里,652,1625,745,166,911,43,954
公投第７案,桃園市,中壢區,仁愛里,653,1384,640,182,822,36,858
公投第７案,桃園市,中壢區,仁德里,654,1588,652,155,807,46,853
公投第７案,桃園市,中壢區,仁德里,655,1445,631,119,750,32,782
公投第７案,桃園市,中壢區,仁和里,656,1743,618,132,750,43,793
公投第７案,桃園市,中壢區,仁和里,657,1812,697,122,819,33,852
公投第７案,桃園市,中壢區,仁祥里,658,1546,607,129,736,54,790
公投第７案,桃園市,中壢區,仁祥里,659,1290,537,110,647,42,689
公投第７案,桃園市,中壢區,華勛里,660,2145,798,159,957,83,1040
公投第７案,桃園市,中壢區,華勛里,661,1451,544,135,679,38,717
公投第７案,桃園市,中壢區,中堅里,662,1489,628,121,749,32,781
公投第７案,桃園市,中壢區,中堅里,663,827,367,67,434,24,458
公投第７案,桃園市,中壢區,中堅里,664,1442,606,103,709,30,739
公投第７案,桃園市,中壢區,興仁里,665,1842,681,147,828,16,844
公投第７案,桃園市,中壢區,興仁里,666,1520,569,112,681,21,702
公投第７案,桃園市,中壢區,中正里,667,1764,637,136,773,40,813
公投第７案,桃園市,中壢區,中正里,668,1488,659,139,798,25,823
公投第７案,桃園市,中壢區,中正里,669,1593,649,154,803,42,845
公投第７案,桃園市,中壢區,中山里,670,1505,641,132,773,30,803
公投第７案,桃園市,中壢區,中山里,671,1661,673,144,817,28,845
公投第７案,桃園市,中壢區,中山里,672,1492,666,125,791,26,817
公投第７案,桃園市,中壢區,篤行里,673,1249,467,119,586,30,616
公投第７案,桃園市,中壢區,篤行里,674,1257,560,118,678,26,704
公投第７案,桃園市,中壢區,自強里,675,1659,639,156,795,68,863
公投第７案,桃園市,中壢區,自強里,676,1815,787,144,931,62,993
公投第７案,桃園市,中壢區,中興里,677,1702,673,143,816,39,855
公投第７案,桃園市,中壢區,中興里,678,1541,629,156,785,21,806
公投第７案,桃園市,中壢區,自立里,679,1659,663,122,785,34,819
公投第７案,桃園市,中壢區,自立里,680,1874,753,131,884,81,965
公投第７案,桃園市,中壢區,自立里,681,1603,646,116,762,39,801
公投第７案,桃園市,中壢區,自信里,682,1735,676,163,839,39,878
公投第７案,桃園市,中壢區,自信里,683,1815,723,158,881,19,900
公投第７案,桃園市,中壢區,自信里,684,1873,610,183,793,34,827
公投第７案,桃園市,中壢區,莊敬里,685,1739,773,142,915,51,966
公投第７案,桃園市,中壢區,莊敬里,686,1709,675,128,803,31,834
公投第７案,桃園市,中壢區,自治里,687,1655,701,175,876,36,912
公投第７案,桃園市,中壢區,自治里,688,1664,724,114,838,43,881
公投第７案,桃園市,中壢區,內壢里,689,1087,405,83,488,25,513
公投第７案,桃園市,中壢區,內壢里,690,1065,456,98,554,49,603
公投第７案,桃園市,中壢區,成功里,691,1844,745,172,917,76,993
公投第７案,桃園市,中壢區,成功里,692,1220,442,89,531,45,576
公投第７案,桃園市,中壢區,成功里,693,1219,497,125,622,31,653
公投第７案,桃園市,中壢區,福德里,694,1260,513,132,645,48,693
公投第７案,桃園市,中壢區,福德里,695,1594,673,185,858,69,927
公投第７案,桃園市,中壢區,中原里,696,1733,673,192,865,73,938
公投第７案,桃園市,中壢區,中原里,697,1979,830,155,985,53,1038
公投第７案,桃園市,中壢區,忠孝里,698,1621,661,161,822,22,844
公投第７案,桃園市,中壢區,忠孝里,699,1391,577,162,739,36,775
公投第７案,桃園市,中壢區,忠孝里,700,1531,675,134,809,29,838
公投第７案,桃園市,中壢區,復興里,701,1943,733,158,891,43,934
公投第７案,桃園市,中壢區,復興里,702,1363,579,116,695,19,714
公投第７案,桃園市,中壢區,復興里,703,2172,769,162,931,57,988
公投第７案,桃園市,中壢區,復興里,704,1798,730,109,839,40,879
公投第７案,桃園市,中壢區,復興里,705,1671,663,143,806,18,824
公投第７案,桃園市,中壢區,復華里,706,1969,764,167,931,40,971
公投第７案,桃園市,中壢區,復華里,707,1563,777,161,938,47,985
公投第７案,桃園市,中壢區,復華里,708,1762,784,149,933,40,973
公投第７案,桃園市,中壢區,文化里,709,1923,651,114,765,45,810
公投第７案,桃園市,中壢區,文化里,710,1572,678,154,832,64,896
公投第７案,桃園市,中壢區,文化里,711,1850,795,176,971,41,1012
公投第７案,桃園市,中壢區,文化里,712,1583,635,126,761,56,817
公投第７案,桃園市,中壢區,文化里,713,1735,648,191,839,50,889
公投第７案,桃園市,中壢區,和平里,714,1292,520,115,635,36,671
公投第７案,桃園市,中壢區,和平里,715,1265,528,107,635,21,656
公投第７案,桃園市,中壢區,內定里,716,1798,663,198,861,36,897
公投第７案,桃園市,中壢區,內定里,717,1822,812,176,988,51,1039
公投第７案,桃園市,中壢區,內定里,718,1613,661,163,824,20,844
公投第７案,桃園市,中壢區,內定里,719,1405,580,145,725,31,756
公投第７案,桃園市,中壢區,石頭里,720,1730,708,204,912,62,974
公投第７案,桃園市,中壢區,中央里,721,1384,672,122,794,34,828
公投第７案,桃園市,中壢區,中央里,722,1122,475,133,608,19,627
公投第７案,桃園市,中壢區,中央里,723,992,460,110,570,32,602
公投第７案,桃園市,中壢區,新興里,724,1820,698,180,878,42,920
公投第７案,桃園市,中壢區,新興里,725,1847,723,162,885,47,932
公投第７案,桃園市,中壢區,林森里,726,1302,584,125,709,53,762
公投第７案,桃園市,中壢區,林森里,727,1203,531,121,652,33,685
公投第７案,桃園市,中壢區,林森里,728,1226,587,157,744,16,760
公投第７案,桃園市,中壢區,振興里,729,1234,550,132,682,44,726
公投第７案,桃園市,中壢區,振興里,730,2023,762,141,903,50,953
公投第７案,桃園市,中壢區,振興里,731,1555,582,136,718,16,734
公投第７案,桃園市,中壢區,東興里,732,1951,726,196,922,57,979
公投第７案,桃園市,中壢區,東興里,733,1383,609,142,751,49,800
公投第７案,桃園市,中壢區,健行里,734,1164,524,133,657,48,705
公投第７案,桃園市,中壢區,健行里,735,1482,643,141,784,27,811
公投第７案,桃園市,中壢區,健行里,736,1770,701,200,901,48,949
公投第７案,桃園市,中壢區,水尾里,737,1703,731,194,925,66,991
公投第７案,桃園市,中壢區,水尾里,738,1841,733,169,902,67,969
公投第７案,桃園市,中壢區,金華里,739,1941,830,191,1021,40,1061
公投第７案,桃園市,中壢區,金華里,740,2029,890,186,1076,42,1118
公投第７案,桃園市,中壢區,忠福里,741,1636,716,152,868,30,898
公投第７案,桃園市,中壢區,忠福里,742,1528,692,155,847,23,870
公投第７案,桃園市,中壢區,忠福里,743,2289,810,211,1021,82,1103
公投第７案,桃園市,中壢區,忠福里,744,2020,738,200,938,52,990
公投第７案,桃園市,中壢區,幸福里,745,2027,826,175,1001,50,1051
公投第７案,桃園市,中壢區,幸福里,746,1883,650,154,804,27,831
公投第７案,桃園市,中壢區,幸福里,747,2080,798,183,981,46,1027
公投第７案,桃園市,中壢區,永福里,748,646,242,69,311,15,326
公投第７案,桃園市,中壢區,永福里,749,1780,847,211,1058,55,1113
公投第７案,桃園市,中壢區,永福里,750,1372,622,128,750,23,773
公投第７案,桃園市,中壢區,永福里,751,1668,699,207,906,42,948
公投第７案,桃園市,中壢區,青埔里,752,1987,779,166,945,47,992
公投第７案,桃園市,中壢區,青埔里,753,1520,622,163,785,24,809
公投第７案,桃園市,中壢區,新街里,754,852,329,99,428,35,463
公投第７案,桃園市,中壢區,新街里,755,1209,501,120,621,43,664
公投第７案,桃園市,中壢區,興南里,756,1481,581,141,722,72,794
公投第７案,桃園市,中壢區,興南里,757,1564,594,125,719,20,739
公投第７案,桃園市,中壢區,興國里,758,1957,800,205,1005,55,1060
公投第７案,桃園市,中壢區,興平里,759,1223,519,163,682,57,739
公投第７案,桃園市,中壢區,興平里,760,1182,487,146,633,35,668
公投第７案,桃園市,中壢區,興和里,761,1066,460,129,589,39,628
公投第７案,桃園市,中壢區,興和里,762,1701,732,173,905,56,961
公投第７案,桃園市,中壢區,永興里,763,943,367,101,468,33,501
公投第７案,桃園市,中壢區,中壢里,764,731,325,87,412,30,442
公投第７案,桃園市,中壢區,中榮里,765,851,365,88,453,33,486
公投第７案,桃園市,中壢區,中建里,766,1011,388,118,506,40,546
公投第７案,桃園市,中壢區,舊明里,767,1532,617,170,787,44,831
公投第７案,桃園市,中壢區,新明里,768,1028,423,90,513,48,561
公投第７案,桃園市,中壢區,新明里,769,1157,484,149,633,39,672
公投第７案,桃園市,中壢區,新明里,770,1591,600,198,798,42,840
公投第７案,桃園市,中壢區,光明里,771,2156,780,190,970,51,1021
公投第７案,桃園市,中壢區,光明里,772,1479,514,129,643,29,672
公投第７案,桃園市,中壢區,光明里,773,1780,726,160,886,40,926
公投第７案,桃園市,中壢區,永光里,774,1651,680,155,835,55,890
公投第７案,桃園市,中壢區,永光里,775,1870,744,207,951,38,989
公投第７案,桃園市,中壢區,永光里,776,1913,681,155,836,33,869
公投第７案,桃園市,中壢區,三民里,777,1609,573,141,714,32,746
公投第７案,桃園市,中壢區,三民里,778,1539,587,143,730,30,760
公投第７案,桃園市,中壢區,五權里,779,1426,550,167,717,40,757
公投第７案,桃園市,中壢區,五權里,780,1618,578,163,741,28,769
公投第７案,桃園市,中壢區,五權里,781,1441,571,161,732,52,784
公投第７案,桃園市,中壢區,五權里,782,1528,660,148,808,35,843
公投第７案,桃園市,中壢區,五福里,783,1683,640,191,831,52,883
公投第７案,桃園市,中壢區,五福里,784,1945,796,205,1001,73,1074
公投第７案,桃園市,中壢區,芝芭里,785,1534,570,181,751,58,809
公投第７案,桃園市,中壢區,芝芭里,786,1810,662,185,847,63,910
公投第７案,桃園市,中壢區,洽溪里,787,1097,393,124,517,45,562
公投第７案,桃園市,中壢區,洽溪里,788,1917,714,188,902,31,933
公投第７案,桃園市,中壢區,洽溪里,789,1858,707,197,904,49,953
公投第７案,桃園市,中壢區,內厝里,790,1576,649,161,810,32,842
公投第７案,桃園市,中壢區,內厝里,791,1478,611,183,794,30,824
公投第７案,桃園市,中壢區,內厝里,792,1589,610,193,803,37,840
公投第７案,桃園市,中壢區,月眉里,793,2037,785,242,1027,87,1114
公投第７案,桃園市,中壢區,月眉里,794,1158,519,134,653,43,696
公投第７案,桃園市,中壢區,月眉里,795,1967,764,230,994,66,1060
公投第７案,桃園市,中壢區,山東里,796,1830,682,170,852,72,924
公投第７案,桃園市,中壢區,山東里,797,1856,640,196,836,69,905
公投第７案,桃園市,中壢區,過嶺里,798,2068,797,162,959,86,1045
公投第７案,桃園市,中壢區,過嶺里,799,2152,674,175,849,44,893
公投第７案,桃園市,中壢區,過嶺里,800,2158,730,203,933,55,988
公投第７案,桃園市,平鎮區,平鎮里,801,1487,534,145,679,43,722
公投第７案,桃園市,平鎮區,平鎮里,802,1453,587,124,711,49,760
公投第７案,桃園市,平鎮區,平鎮里,803,1491,613,159,772,40,812
公投第７案,桃園市,平鎮區,鎮興里,804,1346,507,143,650,49,699
公投第７案,桃園市,平鎮區,鎮興里,805,1660,663,152,815,38,853
公投第７案,桃園市,平鎮區,南勢里,806,1921,693,157,850,34,884
公投第７案,桃園市,平鎮區,南勢里,807,1974,850,159,1009,57,1066
公投第７案,桃園市,平鎮區,南勢里,808,1867,725,174,899,35,934
公投第７案,桃園市,平鎮區,金星里,809,1786,729,151,880,41,921
公投第７案,桃園市,平鎮區,金星里,810,1634,548,116,664,22,686
公投第７案,桃園市,平鎮區,金星里,811,1080,469,100,569,15,584
公投第７案,桃園市,平鎮區,金星里,812,1514,640,137,777,19,796
公投第７案,桃園市,平鎮區,平安里,813,1918,681,142,823,58,881
公投第７案,桃園市,平鎮區,平安里,814,1182,455,140,595,63,658
公投第７案,桃園市,平鎮區,平安里,815,1667,623,146,769,35,804
公投第７案,桃園市,平鎮區,平南里,816,1640,585,147,732,32,764
公投第７案,桃園市,平鎮區,平南里,817,1603,635,153,788,29,817
公投第７案,桃園市,平鎮區,平南里,818,1556,691,145,836,11,847
公投第７案,桃園市,平鎮區,平南里,819,1697,665,131,796,33,829
公投第７案,桃園市,平鎮區,山峰里,820,1130,424,82,506,18,524
公投第７案,桃園市,平鎮區,山峰里,821,1196,473,120,593,33,626
公投第７案,桃園市,平鎮區,福林里,822,1685,683,159,842,30,872
公投第７案,桃園市,平鎮區,福林里,823,1532,639,175,814,44,858
公投第７案,桃園市,平鎮區,湧光里,824,1564,670,101,771,31,802
公投第７案,桃園市,平鎮區,湧光里,825,1824,604,126,730,30,760
公投第７案,桃園市,平鎮區,湧光里,826,1912,701,182,883,24,907
公投第７案,桃園市,平鎮區,莊敬里,827,1048,411,107,518,42,560
公投第７案,桃園市,平鎮區,莊敬里,828,1259,544,116,660,44,704
公投第７案,桃園市,平鎮區,莊敬里,829,1061,432,99,531,15,546
公投第７案,桃園市,平鎮區,莊敬里,830,1072,512,102,614,25,639
公投第７案,桃園市,平鎮區,湧豐里,831,1788,677,166,843,51,894
公投第７案,桃園市,平鎮區,湧安里,832,1510,672,103,775,22,797
公投第７案,桃園市,平鎮區,湧安里,833,1403,565,137,702,38,740
公投第７案,桃園市,平鎮區,湧安里,834,1407,583,136,719,48,767
公投第７案,桃園市,平鎮區,宋屋里,835,1901,772,200,972,44,1016
公投第７案,桃園市,平鎮區,宋屋里,836,1994,721,161,882,31,913
公投第７案,桃園市,平鎮區,平興里,837,1730,676,182,858,42,900
公投第７案,桃園市,平鎮區,平興里,838,1905,767,190,957,47,1004
公投第７案,桃園市,平鎮區,平興里,839,1723,720,89,809,26,835
公投第７案,桃園市,平鎮區,廣興里,840,1307,530,138,668,48,716
公投第７案,桃園市,平鎮區,廣興里,841,1337,552,142,694,40,734
公投第７案,桃園市,平鎮區,廣興里,842,980,491,104,595,39,634
公投第７案,桃園市,平鎮區,廣興里,843,1818,704,173,877,55,932
公投第７案,桃園市,平鎮區,廣達里,844,1463,579,170,749,54,803
公投第７案,桃園市,平鎮區,廣達里,845,1213,555,128,683,21,704
公投第７案,桃園市,平鎮區,廣達里,846,1085,462,116,578,38,616
公投第７案,桃園市,平鎮區,廣仁里,847,1458,553,130,683,37,720
公投第７案,桃園市,平鎮區,廣仁里,848,1408,574,157,731,47,778
公投第７案,桃園市,平鎮區,廣仁里,849,1396,530,141,671,48,719
公投第７案,桃園市,平鎮區,復旦里,850,1044,510,131,641,25,666
公投第７案,桃園市,平鎮區,復旦里,851,1124,505,98,603,10,613
公投第７案,桃園市,平鎮區,復旦里,852,1517,648,244,892,24,916
公投第７案,桃園市,平鎮區,復旦里,853,1571,644,139,783,28,811
公投第７案,桃園市,平鎮區,復興里,854,1752,769,164,933,30,963
公投第７案,桃園市,平鎮區,復興里,855,1434,712,114,826,29,855
公投第７案,桃園市,平鎮區,復興里,856,1710,753,191,944,39,983
公投第７案,桃園市,平鎮區,義民里,857,1555,674,152,826,34,860
公投第７案,桃園市,平鎮區,義民里,858,2051,741,190,931,32,963
公投第７案,桃園市,平鎮區,義民里,859,1477,595,167,762,24,786
公投第７案,桃園市,平鎮區,義興里,860,1501,611,143,754,25,779
公投第７案,桃園市,平鎮區,義興里,861,1405,570,150,720,58,778
公投第７案,桃園市,平鎮區,義興里,862,1656,652,166,818,55,873
公投第７案,桃園市,平鎮區,義興里,863,1921,681,181,862,29,891
公投第７案,桃園市,平鎮區,雙連里,864,1717,667,118,785,21,806
公投第７案,桃園市,平鎮區,雙連里,865,1319,524,159,683,35,718
公投第７案,桃園市,平鎮區,雙連里,866,1745,665,163,828,56,884
公投第７案,桃園市,平鎮區,高雙里,867,1721,712,181,893,49,942
公投第７案,桃園市,平鎮區,高雙里,868,1206,521,115,636,23,659
公投第７案,桃園市,平鎮區,高雙里,869,1202,608,140,748,31,779
公投第７案,桃園市,平鎮區,北勢里,870,1208,526,133,659,46,705
公投第７案,桃園市,平鎮區,北勢里,871,1267,537,171,708,35,743
公投第７案,桃園市,平鎮區,北華里,872,1094,499,89,588,20,608
公投第７案,桃園市,平鎮區,北華里,873,1394,607,159,766,51,817
公投第７案,桃園市,平鎮區,北華里,874,1215,583,111,694,16,710
公投第７案,桃園市,平鎮區,新勢里,875,1010,451,93,544,37,581
公投第７案,桃園市,平鎮區,新勢里,876,1261,532,139,671,31,702
公投第７案,桃園市,平鎮區,新勢里,877,1314,708,31,739,26,765
公投第７案,桃園市,平鎮區,北安里,878,722,309,78,387,34,421
公投第７案,桃園市,平鎮區,北安里,879,839,309,117,426,26,452
公投第７案,桃園市,平鎮區,新榮里,880,1399,575,151,726,22,748
公投第７案,桃園市,平鎮區,新榮里,881,1968,747,190,937,48,985
公投第７案,桃園市,平鎮區,新榮里,882,1672,690,170,860,34,894
公投第７案,桃園市,平鎮區,新富里,883,2213,498,128,626,24,650
公投第７案,桃園市,平鎮區,新富里,884,949,454,111,565,22,587
公投第７案,桃園市,平鎮區,新富里,885,1621,726,188,914,49,963
公投第７案,桃園市,平鎮區,新富里,886,1643,675,138,813,29,842
公投第７案,桃園市,平鎮區,新英里,887,1844,766,194,960,48,1008
公投第７案,桃園市,平鎮區,新英里,888,1752,736,175,911,35,946
公投第７案,桃園市,平鎮區,新貴里,889,1577,593,147,740,42,782
公投第７案,桃園市,平鎮區,新貴里,890,1517,668,153,821,24,845
公投第７案,桃園市,平鎮區,北興里,891,1039,441,135,576,35,611
公投第７案,桃園市,平鎮區,北興里,892,1318,583,146,729,47,776
公投第７案,桃園市,平鎮區,北興里,893,1636,686,142,828,34,862
公投第７案,桃園市,平鎮區,金陵里,894,1316,546,160,706,59,765
公投第７案,桃園市,平鎮區,金陵里,895,1474,629,158,787,30,817
公投第７案,桃園市,平鎮區,北貴里,896,1480,542,120,662,40,702
公投第７案,桃園市,平鎮區,北貴里,897,1330,670,12,682,23,705
公投第７案,桃園市,平鎮區,北貴里,898,1228,539,116,655,24,679
公投第７案,桃園市,平鎮區,北富里,899,1377,602,169,771,35,806
公投第７案,桃園市,平鎮區,北富里,900,1198,562,133,695,26,721
公投第７案,桃園市,平鎮區,北富里,901,1231,478,243,721,24,745
公投第７案,桃園市,平鎮區,建安里,902,1243,506,147,653,58,711
公投第７案,桃園市,平鎮區,建安里,903,1590,568,226,794,45,839
公投第７案,桃園市,平鎮區,建安里,904,1366,543,152,695,41,736
公投第７案,桃園市,平鎮區,華安里,905,1332,567,107,674,41,715
公投第７案,桃園市,平鎮區,華安里,906,1201,446,96,542,24,566
公投第７案,桃園市,平鎮區,華安里,907,1668,598,134,732,35,767
公投第７案,桃園市,平鎮區,東安里,908,1351,543,109,652,56,708
公投第７案,桃園市,平鎮區,東安里,909,1460,522,118,640,22,662
公投第７案,桃園市,平鎮區,新安里,910,1841,743,146,889,38,927
公投第７案,桃園市,平鎮區,新安里,911,1475,561,111,672,20,692
公投第７案,桃園市,平鎮區,新安里,912,1011,440,93,533,25,558
公投第７案,桃園市,平鎮區,東勢里,913,1052,385,100,485,31,516
公投第７案,桃園市,平鎮區,東勢里,914,1154,534,122,656,51,707
公投第７案,桃園市,平鎮區,東勢里,915,1645,633,141,774,22,796
公投第７案,桃園市,平鎮區,東勢里,916,1539,575,156,731,42,773
公投第７案,桃園市,平鎮區,龍恩里,917,1385,581,103,684,64,748
公投第７案,桃園市,平鎮區,龍恩里,918,1395,605,112,717,32,749
公投第７案,桃園市,平鎮區,東社里,919,1711,676,142,818,30,848
公投第７案,桃園市,平鎮區,東社里,920,1631,653,131,784,49,833
公投第７案,桃園市,平鎮區,忠貞里,921,1110,516,73,589,14,603
公投第７案,桃園市,平鎮區,貿易里,922,1931,846,152,998,46,1044
公投第７案,桃園市,平鎮區,龍興里,923,1127,486,93,579,38,617
公投第７案,桃園市,平鎮區,龍興里,924,1414,628,95,723,65,788
公投第７案,桃園市,平鎮區,中正里,925,1609,686,117,803,37,840
公投第７案,桃園市,楊梅區,仁美里,926,1269,526,131,657,50,707
公投第７案,桃園市,楊梅區,仁美里,927,1246,599,125,724,42,766
公投第７案,桃園市,楊梅區,仁美里,928,1408,657,129,786,34,820
公投第７案,桃園市,楊梅區,埔心里,929,1434,601,144,745,55,800
公投第７案,桃園市,楊梅區,光華里,930,1515,601,122,723,45,768
公投第７案,桃園市,楊梅區,光華里,931,1657,615,140,755,43,798
公投第７案,桃園市,楊梅區,金龍里,932,1137,523,104,627,24,651
公投第７案,桃園市,楊梅區,四維里,933,2211,884,179,1063,36,1099
公投第７案,桃園市,楊梅區,四維里,934,2008,771,189,960,31,991
公投第７案,桃園市,楊梅區,永平里,935,1911,793,190,983,36,1019
公投第７案,桃園市,楊梅區,瑞塘里,936,1449,598,168,766,48,814
公投第７案,桃園市,楊梅區,瑞塘里,937,1877,653,159,812,53,865
公投第７案,桃園市,楊梅區,瑞塘里,938,1988,725,173,898,56,954
公投第７案,桃園市,楊梅區,瑞坪里,939,1931,791,168,959,28,987
公投第７案,桃園市,楊梅區,瑞坪里,940,1938,760,158,918,31,949
公投第７案,桃園市,楊梅區,瑞坪里,941,1677,742,115,857,25,882
公投第７案,桃園市,楊梅區,梅溪里,942,1848,733,157,890,32,922
公投第７案,桃園市,楊梅區,梅溪里,943,1882,742,171,913,31,944
公投第７案,桃園市,楊梅區,瑞溪里,944,1541,479,103,582,21,603
公投第７案,桃園市,楊梅區,瑞溪里,945,1938,748,152,900,37,937
公投第７案,桃園市,楊梅區,金溪里,946,1562,554,111,665,16,681
公投第７案,桃園市,楊梅區,金溪里,947,2125,886,238,1124,56,1180
公投第７案,桃園市,楊梅區,三民里,948,1516,692,155,847,41,888
公投第７案,桃園市,楊梅區,三民里,949,1807,700,160,860,29,889
公投第７案,桃園市,楊梅區,楊明里,950,2101,744,205,949,41,990
公投第７案,桃園市,楊梅區,楊明里,951,2054,940,84,1024,47,1071
公投第７案,桃園市,楊梅區,楊明里,952,2226,852,146,998,30,1028
公投第７案,桃園市,楊梅區,裕成里,953,1405,602,127,729,13,742
公投第７案,桃園市,楊梅區,裕成里,954,1843,661,170,831,42,873
公投第７案,桃園市,楊梅區,裕新里,955,2324,796,186,982,53,1035
公投第７案,桃園市,楊梅區,大同里,956,1713,802,48,850,25,875
公投第７案,桃園市,楊梅區,大同里,957,1587,737,149,886,49,935
公投第７案,桃園市,楊梅區,中山里,958,1416,622,129,751,24,775
公投第７案,桃園市,楊梅區,中山里,959,1591,699,141,840,31,871
公投第７案,桃園市,楊梅區,楊梅里,960,1943,770,182,952,49,1001
公投第７案,桃園市,楊梅區,楊梅里,961,1762,704,169,873,33,906
公投第７案,桃園市,楊梅區,楊江里,962,1083,442,105,547,26,573
公投第７案,桃園市,楊梅區,梅新里,963,2027,809,188,997,53,1050
公投第７案,桃園市,楊梅區,紅梅里,964,1274,535,137,672,57,729
公投第７案,桃園市,楊梅區,紅梅里,965,1359,608,124,732,49,781
公投第７案,桃園市,楊梅區,永寧里,966,2444,648,157,805,56,861
公投第７案,桃園市,楊梅區,永寧里,967,2298,806,169,975,29,1004
公投第７案,桃園市,楊梅區,永寧里,968,2222,848,198,1046,41,1087
公投第７案,桃園市,楊梅區,大平里,969,1610,638,149,787,59,846
公投第７案,桃園市,楊梅區,大平里,970,1627,638,146,784,81,865
公投第７案,桃園市,楊梅區,秀才里,971,1589,653,160,813,51,864
公投第７案,桃園市,楊梅區,秀才里,972,1758,700,160,860,75,935
公投第７案,桃園市,楊梅區,東流里,973,1776,595,145,740,47,787
公投第７案,桃園市,楊梅區,東流里,974,1000,366,81,447,23,470
公投第７案,桃園市,楊梅區,豐野里,975,2290,811,166,977,73,1050
公投第７案,桃園市,楊梅區,豐野里,976,1551,631,145,776,42,818
公投第７案,桃園市,楊梅區,富岡里,977,1861,706,148,854,66,920
公投第７案,桃園市,楊梅區,富豐里,978,1141,394,105,499,38,537
公投第７案,桃園市,楊梅區,富豐里,979,1785,676,143,819,43,862
公投第７案,桃園市,楊梅區,員本里,980,1498,601,141,742,57,799
公投第７案,桃園市,楊梅區,員本里,981,1187,346,235,581,41,622
公投第７案,桃園市,楊梅區,三湖里,982,1270,522,131,653,55,708
公投第７案,桃園市,楊梅區,三湖里,983,1424,601,113,714,41,755
公投第７案,桃園市,楊梅區,頭湖里,984,1273,620,27,647,23,670
公投第７案,桃園市,楊梅區,頭湖里,985,1534,500,161,661,27,688
公投第７案,桃園市,楊梅區,上湖里,986,1783,592,163,755,60,815
公投第７案,桃園市,楊梅區,上湖里,987,1709,680,108,788,21,809
公投第７案,桃園市,楊梅區,上湖里,988,1920,672,153,825,59,884
公投第７案,桃園市,楊梅區,上田里,989,1194,487,109,596,29,625
公投第７案,桃園市,楊梅區,上田里,990,1408,591,135,726,19,745
公投第７案,桃園市,楊梅區,高山里,991,1737,608,127,735,32,767
公投第７案,桃園市,楊梅區,高山里,992,1920,759,149,908,32,940
公投第７案,桃園市,楊梅區,高上里,993,1234,483,140,623,32,655
公投第７案,桃園市,楊梅區,高上里,994,1491,617,162,779,50,829
公投第７案,桃園市,楊梅區,青山里,995,2020,715,178,893,52,945
公投第７案,桃園市,楊梅區,青山里,996,1863,647,155,802,32,834
公投第７案,桃園市,楊梅區,高榮里,997,1692,671,149,820,55,875
公投第７案,桃園市,楊梅區,高榮里,998,1686,673,149,822,28,850
公投第７案,桃園市,楊梅區,雙榮里,999,1626,659,175,834,53,887
公投第７案,桃園市,楊梅區,雙榮里,1000,1557,695,131,826,17,843
公投第７案,桃園市,楊梅區,新榮里,1001,1603,711,166,877,51,928
公投第７案,桃園市,楊梅區,新榮里,1002,1889,700,160,860,69,929
公投第７案,桃園市,楊梅區,水美里,1003,1448,623,140,763,30,793
公投第７案,桃園市,楊梅區,水美里,1004,1351,578,142,720,44,764
公投第７案,桃園市,楊梅區,水美里,1005,1313,580,126,706,55,761
公投第７案,桃園市,楊梅區,瑞原里,1006,1689,650,192,842,33,875
公投第７案,桃園市,楊梅區,瑞原里,1007,2063,722,182,904,30,934
公投第７案,桃園市,龍潭區,黃唐里,1008,1482,568,139,707,30,737
公投第７案,桃園市,龍潭區,黃唐里,1009,1528,590,136,726,46,772
公投第７案,桃園市,龍潭區,黃唐里,1010,1503,593,134,727,45,772
公投第７案,桃園市,龍潭區,永興里,1011,1568,607,140,747,47,794
公投第７案,桃園市,龍潭區,永興里,1012,1216,469,104,573,59,632
公投第７案,桃園市,龍潭區,中山里,1013,2088,708,172,880,69,949
公投第７案,桃園市,龍潭區,中山里,1014,1987,841,186,1027,73,1100
公投第７案,桃園市,龍潭區,中山里,1015,1586,722,141,863,45,908
公投第７案,桃園市,龍潭區,烏樹林里,1016,1221,435,141,576,39,615
公投第７案,桃園市,龍潭區,烏樹林里,1017,1134,484,118,602,44,646
公投第７案,桃園市,龍潭區,烏林里,1018,2081,740,182,922,52,974
公投第７案,桃園市,龍潭區,烏林里,1019,1925,704,150,854,30,884
公投第７案,桃園市,龍潭區,百年里,1020,2095,934,157,1091,32,1123
公投第７案,桃園市,龍潭區,百年里,1021,2040,945,167,1112,48,1160
公投第７案,桃園市,龍潭區,凌雲里,1022,1790,677,149,826,51,877
公投第７案,桃園市,龍潭區,凌雲里,1023,1872,728,216,944,77,1021
公投第７案,桃園市,龍潭區,龍祥里,1024,1726,729,167,896,65,961
公投第７案,桃園市,龍潭區,龍祥里,1025,1792,749,170,919,58,977
公投第７案,桃園市,龍潭區,八德里,1026,1398,580,117,697,38,735
公投第７案,桃園市,龍潭區,八德里,1027,1345,502,122,624,41,665
公投第７案,桃園市,龍潭區,八德里,1028,1409,602,126,728,40,768
公投第７案,桃園市,龍潭區,聖德里,1029,1362,488,122,610,26,636
公投第７案,桃園市,龍潭區,聖德里,1030,1650,691,193,884,52,936
公投第７案,桃園市,龍潭區,上林里,1031,1597,657,137,794,38,832
公投第７案,桃園市,龍潭區,上林里,1032,1410,570,143,713,24,737
公投第７案,桃園市,龍潭區,上林里,1033,1275,530,135,665,44,709
公投第７案,桃園市,龍潭區,龍潭里,1034,1909,810,220,1030,60,1090
公投第７案,桃園市,龍潭區,龍星里,1035,2024,868,188,1056,34,1090
公投第７案,桃園市,龍潭區,龍星里,1036,2002,839,182,1021,55,1076
公投第７案,桃園市,龍潭區,中正里,1037,1786,788,174,962,47,1009
公投第７案,桃園市,龍潭區,中正里,1038,1756,739,163,902,52,954
公投第７案,桃園市,龍潭區,中正里,1039,1830,909,53,962,37,999
公投第７案,桃園市,龍潭區,上華里,1040,1697,804,167,971,29,1000
公投第７案,桃園市,龍潭區,上華里,1041,1519,697,101,798,30,828
公投第７案,桃園市,龍潭區,九龍里,1042,1805,707,152,859,30,889
公投第７案,桃園市,龍潭區,九龍里,1043,1792,644,141,785,27,812
公投第７案,桃園市,龍潭區,武漢里,1044,1500,672,142,814,65,879
公投第７案,桃園市,龍潭區,祥和里,1045,1427,548,116,664,29,693
公投第７案,桃園市,龍潭區,東興里,1046,1444,484,120,604,46,650
公投第７案,桃園市,龍潭區,東興里,1047,1321,520,116,636,35,671
公投第７案,桃園市,龍潭區,東興里,1048,1215,561,135,696,31,727
公投第７案,桃園市,龍潭區,中興里,1049,1297,530,111,641,53,694
公投第７案,桃園市,龍潭區,中興里,1050,1407,546,113,659,19,678
公投第７案,桃園市,龍潭區,中興里,1051,1564,578,153,731,43,774
公投第７案,桃園市,龍潭區,北興里,1052,1317,516,122,638,63,701
公投第７案,桃園市,龍潭區,北興里,1053,1023,385,81,466,42,508
公投第７案,桃園市,龍潭區,佳安里,1054,1721,699,172,871,47,918
公投第７案,桃園市,龍潭區,佳安里,1055,1764,768,151,919,56,975
公投第７案,桃園市,龍潭區,三坑里,1056,1499,609,144,753,51,804
公投第７案,桃園市,龍潭區,大平里,1057,2151,798,159,957,41,998
公投第７案,桃園市,龍潭區,三林里,1058,1524,697,121,818,28,846
公投第７案,桃園市,龍潭區,三林里,1059,1456,690,143,833,31,864
公投第７案,桃園市,龍潭區,建林里,1060,1847,949,138,1087,29,1116
公投第７案,桃園市,龍潭區,建林里,1061,1899,936,157,1093,33,1126
公投第７案,桃園市,龍潭區,富林里,1062,1725,746,146,892,37,929
公投第７案,桃園市,龍潭區,富林里,1063,1665,797,165,962,50,1012
公投第７案,桃園市,龍潭區,高平里,1064,1649,649,132,781,30,811
公投第７案,桃園市,龍潭區,高平里,1065,1539,591,110,701,35,736
公投第７案,桃園市,龍潭區,高原里,1066,1541,676,161,837,46,883
公投第７案,桃園市,龍潭區,高原里,1067,1375,568,143,711,39,750
公投第７案,桃園市,龍潭區,高原里,1068,1453,611,146,757,28,785
公投第７案,桃園市,龍潭區,三和里,1069,1074,451,117,568,42,610
公投第７案,桃園市,龍潭區,三和里,1070,1299,622,118,740,15,755
公投第７案,桃園市,龍潭區,三水里,1071,678,232,65,297,21,318
公投第７案,桃園市,新屋區,新屋里,1072,1306,605,131,736,23,759
公投第７案,桃園市,新屋區,新屋里,1073,1556,634,194,828,38,866
公投第７案,桃園市,新屋區,新生里,1074,1849,849,210,1059,53,1112
公投第７案,桃園市,新屋區,新生里,1075,2096,912,250,1162,64,1226
公投第７案,桃園市,新屋區,後湖里,1076,1517,572,171,743,53,796
公投第７案,桃園市,新屋區,清華里,1077,2095,911,229,1140,55,1195
公投第７案,桃園市,新屋區,清華里,1078,1856,652,174,826,35,861
公投第７案,桃園市,新屋區,石磊里,1079,1986,824,204,1028,58,1086
公投第７案,桃園市,新屋區,東明里,1080,1425,546,126,672,25,697
公投第７案,桃園市,新屋區,社子里,1081,1385,517,124,641,37,678
公投第７案,桃園市,新屋區,埔頂里,1082,1271,566,170,736,45,781
公投第７案,桃園市,新屋區,埔頂里,1083,1271,516,137,653,29,682
公投第７案,桃園市,新屋區,九斗里,1084,1234,489,168,657,46,703
公投第７案,桃園市,新屋區,九斗里,1085,1085,440,114,554,51,605
公投第７案,桃園市,新屋區,頭洲里,1086,1992,859,180,1039,37,1076
公投第７案,桃園市,新屋區,頭洲里,1087,2032,917,211,1128,61,1189
公投第７案,桃園市,新屋區,大坡里,1088,1291,515,136,651,56,707
公投第７案,桃園市,新屋區,望間里,1089,1401,525,124,649,30,679
公投第７案,桃園市,新屋區,後庄里,1090,1106,457,148,605,42,647
公投第７案,桃園市,新屋區,蚵間里,1091,908,343,100,443,11,454
公投第７案,桃園市,新屋區,深圳里,1092,663,301,74,375,33,408
公投第７案,桃園市,新屋區,槺榔里,1093,1088,412,118,530,48,578
公投第７案,桃園市,新屋區,笨港里,1094,1050,481,139,620,47,667
公投第７案,桃園市,新屋區,永安里,1095,896,398,90,488,19,507
公投第７案,桃園市,新屋區,永安里,1096,1369,611,135,746,74,820
公投第７案,桃園市,新屋區,永興里,1097,995,344,107,451,32,483
公投第７案,桃園市,新屋區,下埔里,1098,741,315,73,388,17,405
公投第７案,桃園市,新屋區,石牌里,1099,943,402,124,526,56,582
公投第７案,桃園市,新屋區,下田里,1100,1714,618,191,809,74,883
公投第７案,桃園市,新屋區,赤欄里,1101,1340,559,119,678,18,696
公投第７案,桃園市,觀音區,觀音里,1102,1371,475,116,591,28,619
公投第７案,桃園市,觀音區,觀音里,1103,1362,431,101,532,25,557
公投第７案,桃園市,觀音區,白玉里,1104,997,367,90,457,72,529
公投第７案,桃園市,觀音區,廣興里,1105,1407,498,121,619,25,644
公投第７案,桃園市,觀音區,大潭里,1106,1692,691,153,844,29,873
公投第７案,桃園市,觀音區,保生里,1107,1279,512,108,620,22,642
公投第７案,桃園市,觀音區,保生里,1108,791,318,71,389,18,407
公投第７案,桃園市,觀音區,武威里,1109,892,377,90,467,36,503
公投第７案,桃園市,觀音區,三和里,1110,886,408,100,508,24,532
公投第７案,桃園市,觀音區,新興里,1111,712,279,87,366,32,398
公投第７案,桃園市,觀音區,坑尾里,1112,1609,561,163,724,88,812
公投第７案,桃園市,觀音區,金湖里,1113,1274,510,148,658,47,705
公投第７案,桃園市,觀音區,金湖里,1114,1351,451,107,558,17,575
公投第７案,桃園市,觀音區,藍埔里,1115,1262,547,127,674,54,728
公投第７案,桃園市,觀音區,藍埔里,1116,1242,506,137,643,62,705
公投第７案,桃園市,觀音區,大同里,1117,1461,551,157,708,64,772
公投第７案,桃園市,觀音區,大同里,1118,1613,606,169,775,40,815
公投第７案,桃園市,觀音區,大堀里,1119,1479,574,181,755,41,796
公投第７案,桃園市,觀音區,崙坪里,1120,1552,535,158,693,48,741
公投第７案,桃園市,觀音區,崙坪里,1121,1517,561,167,728,25,753
公投第７案,桃園市,觀音區,崙坪里,1122,1691,611,172,783,53,836
公投第７案,桃園市,觀音區,富源里,1123,1157,485,125,610,18,628
公投第７案,桃園市,觀音區,富源里,1124,1455,539,157,696,46,742
公投第７案,桃園市,觀音區,富源里,1125,1150,474,105,579,25,604
公投第７案,桃園市,觀音區,上大里,1126,1112,455,136,591,36,627
公投第７案,桃園市,觀音區,上大里,1127,1251,473,113,586,20,606
公投第７案,桃園市,觀音區,新坡里,1128,1446,557,137,694,90,784
公投第７案,桃園市,觀音區,新坡里,1129,1493,547,164,711,80,791
公投第７案,桃園市,觀音區,廣福里,1130,1339,529,128,657,45,702
公投第７案,桃園市,觀音區,廣福里,1131,1137,509,112,621,31,652
公投第７案,桃園市,觀音區,塔腳里,1132,1043,407,76,483,41,524
公投第７案,桃園市,觀音區,保障里,1133,993,344,86,430,31,461
公投第７案,桃園市,觀音區,保障里,1134,975,350,113,463,20,483
公投第７案,桃園市,觀音區,草漯里,1135,2029,650,167,817,49,866
公投第７案,桃園市,觀音區,草新里,1136,1765,706,202,908,34,942
公投第７案,桃園市,觀音區,草新里,1137,1809,688,184,872,46,918
公投第７案,桃園市,觀音區,草新里,1138,1869,714,153,867,43,910
公投第７案,桃園市,觀音區,樹林里,1139,1870,628,134,762,51,813
公投第７案,桃園市,觀音區,樹林里,1140,1932,508,141,649,37,686
公投第７案,桃園市,觀音區,富林里,1141,899,276,81,357,8,365
公投第７案,桃園市,觀音區,富林里,1142,985,306,89,395,15,410
