公投案編號,縣市,行政區,村里,投開票所,投票權人數,同意票數,不同意票數,有效票數,無效票數,投票人數
公投第１１案,連江縣,,,,11205,4131,1461,5592,195,5787
公投第１１案,金門縣,,,,122695,30593,11206,41799,2129,43928
公投第１１案,宜蘭縣,,,,386089,136422,67663,204085,12028,216113
公投第１１案,新竹縣,,,,445051,168550,75167,243717,10127,253844
公投第１１案,苗栗縣,,,,461580,175397,74340,249737,13713,263450
公投第１１案,彰化縣,,,,1066994,404865,177099,581964,33576,615540
公投第１１案,南投縣,,,,427089,165850,68818,234668,13875,248543
公投第１１案,雲林縣,,,,584480,196214,88271,284485,20234,304719
公投第１１案,嘉義縣,,,,442775,148475,64207,212682,15372,228054
公投第１１案,屏東縣,,,,711720,244464,110273,354737,22276,377013
公投第１１案,臺東縣,,,,185996,65985,26076,92061,5202,97263
公投第１１案,花蓮縣,,,,278059,99444,40126,139570,8244,147814
公投第１１案,澎湖縣,,,,90405,27546,11418,38964,2193,41157
公投第１１案,基隆市,,,,320030,106801,52811,159612,6826,166438
公投第１１案,新竹市,,,,351775,127376,65250,192626,7741,200367
公投第１１案,嘉義市,,,,221553,80216,38442,118658,4412,123070
公投第１１案,臺北市,,,,2228430,779447,462976,1242423,50717,1293140
公投第１１案,高雄市,,,,2353342,934858,413374,1348232,58167,1406399
公投第１１案,新北市,,,,3375513,1174782,617886,1792668,83090,1875758
公投第１１案,臺中市,,,,2295642,868563,406665,1275228,60763,1335991
公投第１１案,臺南市,,,,1594821,537623,254622,792245,39589,831834
公投第１１案,桃園市,,,,1801823,605777,291473,897250,36632,933882
公投第１１案,連江縣,東引鄉,,,1138,400,170,570,16,586
公投第１１案,連江縣,南竿鄉,,,6461,2385,796,3181,104,3285
公投第１１案,連江縣,莒光鄉,,,1481,544,225,769,37,806
公投第１１案,連江縣,北竿鄉,,,2125,802,270,1072,38,1110
公投第１１案,金門縣,金湖鎮,,,25915,6676,2333,9009,485,9494
公投第１１案,金門縣,烈嶼鄉,,,11676,3063,965,4028,227,4255
公投第１１案,金門縣,烏坵鄉,,,567,125,34,159,6,165
公投第１１案,金門縣,金寧鄉,,,28162,6500,3260,9760,435,10195
公投第１１案,金門縣,金沙鎮,,,18560,4856,1367,6223,350,6573
公投第１１案,金門縣,金城鎮,,,37815,9373,3247,12620,626,13246
公投第１１案,宜蘭縣,壯圍鄉,,,21447,7858,3818,11676,868,12544
公投第１１案,宜蘭縣,冬山鄉,,,45405,15402,7791,23193,1246,24439
公投第１１案,宜蘭縣,南澳鄉,,,4644,2199,551,2750,144,2894
公投第１１案,宜蘭縣,礁溪鄉,,,31084,10409,5498,15907,970,16877
公投第１１案,宜蘭縣,宜蘭市,,,79167,28367,14687,43054,2099,45153
公投第１１案,宜蘭縣,蘇澳鎮,,,34512,12078,5794,17872,1418,19290
公投第１１案,宜蘭縣,三星鄉,,,19051,6484,3005,9489,588,10077
公投第１１案,宜蘭縣,羅東鎮,,,57686,20888,10793,31681,1618,33299
公投第１１案,宜蘭縣,五結鄉,,,34892,11876,5992,17868,967,18835
公投第１１案,宜蘭縣,大同鄉,,,4935,2772,647,3419,138,3557
公投第１１案,宜蘭縣,頭城鎮,,,25135,8612,4223,12835,1004,13839
公投第１１案,宜蘭縣,員山鄉,,,28131,9477,4864,14341,968,15309
公投第１１案,新竹縣,橫山鄉,,,11346,4589,1707,6296,426,6722
公投第１１案,新竹縣,寶山鄉,,,12973,4929,2292,7221,408,7629
公投第１１案,新竹縣,芎林鄉,,,17293,6800,2943,9743,493,10236
公投第１１案,新竹縣,北埔鄉,,,8180,3132,1308,4440,218,4658
公投第１１案,新竹縣,新豐鄉,,,45790,17326,7381,24707,1014,25721
公投第１１案,新竹縣,竹北市,,,137129,51290,26410,77700,2476,80176
公投第１１案,新竹縣,竹東鎮,,,78794,28870,12312,41182,1681,42863
公投第１１案,新竹縣,湖口鄉,,,63511,24223,10192,34415,1399,35814
公投第１１案,新竹縣,關西鎮,,,24712,9618,3802,13420,717,14137
公投第１１案,新竹縣,五峰鄉,,,3997,1584,532,2116,74,2190
公投第１１案,新竹縣,尖石鄉,,,7364,3206,938,4144,150,4294
公投第１１案,新竹縣,新埔鎮,,,28894,10885,4581,15466,863,16329
公投第１１案,新竹縣,峨眉鄉,,,5068,2098,769,2867,208,3075
公投第１１案,苗栗縣,三灣鄉,,,5852,2215,927,3142,238,3380
公投第１１案,苗栗縣,泰安鄉,,,5180,2400,925,3325,146,3471
公投第１１案,苗栗縣,頭份市,,,83617,32171,13439,45610,1974,47584
公投第１１案,苗栗縣,卓蘭鎮,,,14772,5637,2514,8151,529,8680
公投第１１案,苗栗縣,通霄鎮,,,29709,10718,4625,15343,995,16338
公投第１１案,苗栗縣,苑裡鎮,,,38890,14746,6423,21169,1276,22445
公投第１１案,苗栗縣,頭屋鄉,,,9390,4268,1522,5790,325,6115
公投第１１案,苗栗縣,竹南鎮,,,68528,25657,11311,36968,1650,38618
公投第１１案,苗栗縣,後龍鎮,,,30948,10907,5134,16041,1123,17164
公投第１１案,苗栗縣,大湖鄉,,,12653,4454,1872,6326,445,6771
公投第１１案,苗栗縣,公館鄉,,,28318,10842,4804,15646,1089,16735
公投第１１案,苗栗縣,三義鄉,,,13889,5554,2183,7737,418,8155
公投第１１案,苗栗縣,苗栗市,,,74249,29311,11785,41096,1864,42960
公投第１１案,苗栗縣,西湖鄉,,,6382,2341,983,3324,224,3548
公投第１１案,苗栗縣,造橋鄉,,,11027,4225,1791,6016,420,6436
公投第１１案,苗栗縣,銅鑼鄉,,,15424,5749,2363,8112,546,8658
公投第１１案,苗栗縣,南庄鄉,,,8784,2800,1253,4053,297,4350
公投第１１案,苗栗縣,獅潭鄉,,,3968,1402,486,1888,154,2042
公投第１１案,彰化縣,芳苑鄉,,,29291,9516,3827,13343,1210,14553
公投第１１案,彰化縣,花壇鄉,,,38924,15812,6438,22250,1024,23274
公投第１１案,彰化縣,田中鎮,,,35391,13537,5892,19429,1116,20545
公投第１１案,彰化縣,大村鄉,,,31492,12091,5404,17495,1069,18564
公投第１１案,彰化縣,二水鄉,,,13339,5450,2119,7569,545,8114
公投第１１案,彰化縣,埔鹽鄉,,,28026,11384,4379,15763,1180,16943
公投第１１案,彰化縣,埔心鄉,,,29642,11880,5347,17227,1107,18334
公投第１１案,彰化縣,社頭鄉,,,36306,14152,5816,19968,1071,21039
公投第１１案,彰化縣,鹿港鎮,,,70505,27150,11839,38989,2260,41249
公投第１１案,彰化縣,田尾鄉,,,23179,8969,3949,12918,891,13809
公投第１１案,彰化縣,伸港鄉,,,30407,11059,5132,16191,1028,17219
公投第１１案,彰化縣,福興鄉,,,39745,14430,5939,20369,1303,21672
公投第１１案,彰化縣,秀水鄉,,,32394,12650,5582,18232,1063,19295
公投第１１案,彰化縣,二林鎮,,,42976,15018,6114,21132,1552,22684
公投第１１案,彰化縣,線西鄉,,,14065,5502,2363,7865,563,8428
公投第１１案,彰化縣,彰化市,,,190995,76438,34580,111018,4959,115977
公投第１１案,彰化縣,芬園鄉,,,20408,7522,3102,10624,734,11358
公投第１１案,彰化縣,永靖鄉,,,31239,12176,5389,17565,1112,18677
公投第１１案,彰化縣,大城鄉,,,14713,3724,1500,5224,493,5717
公投第１１案,彰化縣,竹塘鄉,,,12821,4362,2048,6410,622,7032
公投第１１案,彰化縣,溪州鄉,,,25405,8627,3673,12300,966,13266
公投第１１案,彰化縣,和美鎮,,,75286,28171,12933,41104,1937,43041
公投第１１案,彰化縣,埤頭鄉,,,25677,8843,4208,13051,1048,14099
公投第１１案,彰化縣,員林市,,,102028,38409,17556,55965,2342,58307
公投第１１案,彰化縣,溪湖鎮,,,45147,17125,7662,24787,1425,26212
公投第１１案,彰化縣,北斗鎮,,,27593,10868,4308,15176,956,16132
公投第１１案,南投縣,集集鎮,,,9611,3586,1648,5234,355,5589
公投第１１案,南投縣,南投市,,,84328,34407,14480,48887,2254,51141
公投第１１案,南投縣,仁愛鄉,,,12589,5232,1742,6974,291,7265
公投第１１案,南投縣,中寮鄉,,,13181,5044,2026,7070,587,7657
公投第１１案,南投縣,水里鄉,,,15458,5746,2368,8114,538,8652
公投第１１案,南投縣,國姓鄉,,,16597,6299,2465,8764,612,9376
公投第１１案,南投縣,信義鄉,,,13299,6243,1740,7983,491,8474
公投第１１案,南投縣,魚池鄉,,,13958,4991,2126,7117,511,7628
公投第１１案,南投縣,名間鄉,,,33408,13206,5577,18783,1352,20135
公投第１１案,南投縣,鹿谷鄉,,,15941,5692,2331,8023,595,8618
公投第１１案,南投縣,竹山鎮,,,47034,17492,7053,24545,1663,26208
公投第１１案,南投縣,草屯鎮,,,82922,31801,14221,46022,2280,48302
公投第１１案,南投縣,埔里鎮,,,68763,26111,11041,37152,2346,39498
公投第１１案,雲林縣,元長鄉,,,22830,6424,2790,9214,798,10012
公投第１１案,雲林縣,北港鎮,,,33958,11976,5371,17347,1286,18633
公投第１１案,雲林縣,莿桐鄉,,,24570,8646,3946,12592,1037,13629
公投第１１案,雲林縣,土庫鎮,,,24412,8315,3744,12059,990,13049
公投第１１案,雲林縣,西螺鎮,,,38142,12953,6017,18970,1440,20410
公投第１１案,雲林縣,二崙鄉,,,23367,6969,3256,10225,1037,11262
公投第１１案,雲林縣,古坑鄉,,,27477,9531,4178,13709,954,14663
公投第１１案,雲林縣,林內鄉,,,15551,5670,2494,8164,676,8840
公投第１１案,雲林縣,斗南鎮,,,38138,14373,6241,20614,1261,21875
公投第１１案,雲林縣,虎尾鎮,,,58167,20035,9568,29603,1552,31155
公投第１１案,雲林縣,斗六市,,,89761,33938,15650,49588,2140,51728
公投第１１案,雲林縣,臺西鄉,,,21125,6443,2561,9004,770,9774
公投第１１案,雲林縣,褒忠鄉,,,11381,3677,1798,5475,395,5870
公投第１１案,雲林縣,麥寮鄉,,,37119,11773,5253,17026,1267,18293
公投第１１案,雲林縣,東勢鄉,,,13239,4225,1866,6091,527,6618
公投第１１案,雲林縣,口湖鄉,,,24193,7386,3160,10546,1103,11649
公投第１１案,雲林縣,水林鄉,,,22508,6291,2698,8989,896,9885
公投第１１案,雲林縣,大埤鄉,,,16509,5518,2526,8044,577,8621
公投第１１案,雲林縣,四湖鄉,,,20983,5432,2260,7692,712,8404
公投第１１案,雲林縣,崙背鄉,,,21050,6639,2894,9533,816,10349
公投第１１案,嘉義縣,溪口鄉,,,13105,4582,1735,6317,549,6866
公投第１１案,嘉義縣,阿里山鄉,,,4691,1511,595,2106,94,2200
公投第１１案,嘉義縣,太保市,,,31568,11095,5051,16146,1019,17165
公投第１１案,嘉義縣,布袋鎮,,,23965,7832,3134,10966,838,11804
公投第１１案,嘉義縣,朴子市,,,35191,11894,5250,17144,1245,18389
公投第１１案,嘉義縣,義竹鄉,,,16647,5456,2316,7772,753,8525
公投第１１案,嘉義縣,竹崎鄉,,,31228,11132,4513,15645,851,16496
公投第１１案,嘉義縣,鹿草鄉,,,13937,4061,1849,5910,617,6527
公投第１１案,嘉義縣,中埔鄉,,,39139,12230,5403,17633,1031,18664
公投第１１案,嘉義縣,民雄鄉,,,61209,21384,9645,31029,2011,33040
公投第１１案,嘉義縣,大埔鄉,,,3999,1457,613,2070,126,2196
公投第１１案,嘉義縣,新港鄉,,,27342,9438,4225,13663,1326,14989
公投第１１案,嘉義縣,六腳鄉,,,20821,5883,2405,8288,744,9032
公投第１１案,嘉義縣,番路鄉,,,10156,3791,1470,5261,435,5696
公投第１１案,嘉義縣,水上鄉,,,43857,15297,6915,22212,1350,23562
公投第１１案,嘉義縣,東石鄉,,,21915,6163,2341,8504,711,9215
公投第１１案,嘉義縣,大林鎮,,,26922,9104,4064,13168,1008,14176
公投第１１案,嘉義縣,梅山鄉,,,17083,6165,2683,8848,664,9512
公投第１１案,屏東縣,屏東市,,,170148,59826,27326,87152,3688,90840
公投第１１案,屏東縣,竹田鄉,,,15353,5613,2696,8309,672,8981
公投第１１案,屏東縣,鹽埔鄉,,,22402,7456,3572,11028,773,11801
公投第１１案,屏東縣,新園鄉,,,30706,10302,4796,15098,1184,16282
公投第１１案,屏東縣,南州鄉,,,9479,3161,1531,4692,417,5109
公投第１１案,屏東縣,林邊鄉,,,15691,5745,2409,8154,677,8831
公投第１１案,屏東縣,崁頂鄉,,,12270,4115,1955,6070,422,6492
公投第１１案,屏東縣,佳冬鄉,,,17063,5306,2532,7838,717,8555
公投第１１案,屏東縣,車城鄉,,,7595,1901,1063,2964,239,3203
公投第１１案,屏東縣,春日鄉,,,3923,1141,552,1693,50,1743
公投第１１案,屏東縣,枋山鄉,,,4856,1618,740,2358,176,2534
公投第１１案,屏東縣,三地門鄉,,,6373,2700,1086,3786,199,3985
公投第１１案,屏東縣,霧臺鄉,,,2950,1628,548,2176,75,2251
公投第１１案,屏東縣,滿州鄉,,,7206,1923,979,2902,148,3050
公投第１１案,屏東縣,泰武鄉,,,4344,1967,782,2749,148,2897
公投第１１案,屏東縣,牡丹鄉,,,4314,1211,558,1769,82,1851
公投第１１案,屏東縣,獅子鄉,,,4230,1938,615,2553,103,2656
公投第１１案,屏東縣,瑪家鄉,,,5663,2625,924,3549,129,3678
公投第１１案,屏東縣,來義鄉,,,6257,2652,928,3580,225,3805
公投第１１案,屏東縣,麟洛鄉,,,9970,3670,1913,5583,283,5866
公投第１１案,屏東縣,長治鄉,,,26256,9356,4260,13616,895,14511
公投第１１案,屏東縣,九如鄉,,,19132,6634,3021,9655,793,10448
公投第１１案,屏東縣,萬丹鄉,,,43478,15225,6826,22051,1443,23494
公投第１１案,屏東縣,恆春鎮,,,25661,7601,3748,11349,750,12099
公投第１１案,屏東縣,枋寮鄉,,,21394,7401,3213,10614,900,11514
公投第１１案,屏東縣,潮州鎮,,,46444,16355,6934,23289,1169,24458
公投第１１案,屏東縣,里港鄉,,,22128,7569,3695,11264,952,12216
公投第１１案,屏東縣,東港鎮,,,39495,13670,6084,19754,1405,21159
公投第１１案,屏東縣,萬巒鄉,,,17945,6179,2566,8745,630,9375
公投第１１案,屏東縣,琉球鄉,,,10706,3222,1192,4414,341,4755
公投第１１案,屏東縣,新埤鄉,,,9033,2876,1332,4208,381,4589
公投第１１案,屏東縣,內埔鄉,,,47558,15255,6597,21852,1282,23134
公投第１１案,屏東縣,高樹鄉,,,21697,6623,3300,9923,928,10851
公投第１１案,臺東縣,臺東市,,,87803,32943,13026,45969,1978,47947
公投第１１案,臺東縣,太麻里鄉,,,9666,3792,1252,5044,314,5358
公投第１１案,臺東縣,鹿野鄉,,,6936,1975,932,2907,226,3133
公投第１１案,臺東縣,池上鄉,,,7162,2041,940,2981,309,3290
公投第１１案,臺東縣,大武鄉,,,5266,1874,712,2586,192,2778
公投第１１案,臺東縣,東河鄉,,,7635,2281,843,3124,269,3393
公投第１１案,臺東縣,延平鄉,,,2930,1176,462,1638,63,1701
公投第１１案,臺東縣,蘭嶼鄉,,,4181,999,600,1599,72,1671
公投第１１案,臺東縣,金峰鄉,,,3028,1425,492,1917,88,2005
公投第１１案,臺東縣,成功鎮,,,12426,4334,1480,5814,475,6289
公投第１１案,臺東縣,綠島鄉,,,3579,1048,489,1537,52,1589
公投第１１案,臺東縣,關山鎮,,,7509,2490,1051,3541,202,3743
公投第１１案,臺東縣,達仁鄉,,,3137,1326,471,1797,83,1880
公投第１１案,臺東縣,海端鄉,,,3278,1215,482,1697,76,1773
公投第１１案,臺東縣,長濱鄉,,,6484,1872,691,2563,243,2806
公投第１１案,臺東縣,卑南鄉,,,14976,5194,2153,7347,560,7907
公投第１１案,花蓮縣,新城鄉,,,17029,6304,2510,8814,464,9278
公投第１１案,花蓮縣,花蓮市,,,84807,30824,12989,43813,1967,45780
公投第１１案,花蓮縣,鳳林鎮,,,9676,3595,1381,4976,407,5383
公投第１１案,花蓮縣,豐濱鄉,,,4395,1447,592,2039,135,2174
公投第１１案,花蓮縣,光復鄉,,,11417,4121,1485,5606,469,6075
公投第１１案,花蓮縣,壽豐鄉,,,15847,5779,2394,8173,651,8824
公投第１１案,花蓮縣,吉安鄉,,,72116,25828,10468,36296,1867,38163
公投第１１案,花蓮縣,玉里鎮,,,20650,6862,2490,9352,784,10136
公投第１１案,花蓮縣,瑞穗鄉,,,10279,3545,1299,4844,387,5231
公投第１１案,花蓮縣,秀林鄉,,,12562,4352,1869,6221,340,6561
公投第１１案,花蓮縣,萬榮鄉,,,5269,2116,824,2940,178,3118
公投第１１案,花蓮縣,富里鄉,,,9065,2600,1144,3744,410,4154
公投第１１案,花蓮縣,卓溪鄉,,,4947,2071,681,2752,185,2937
公投第１１案,澎湖縣,馬公市,,,53655,17651,7463,25114,1229,26343
公投第１１案,澎湖縣,白沙鄉,,,8625,2506,961,3467,230,3697
公投第１１案,澎湖縣,七美鄉,,,3374,644,325,969,58,1027
公投第１１案,澎湖縣,西嶼鄉,,,7382,1620,678,2298,252,2550
公投第１１案,澎湖縣,望安鄉,,,4628,1270,535,1805,105,1910
公投第１１案,澎湖縣,湖西鄉,,,12741,3855,1456,5311,319,5630
公投第１１案,基隆市,七堵區,,,46256,15867,7761,23628,1044,24672
公投第１１案,基隆市,安樂區,,,70396,23424,11849,35273,1319,36592
公投第１１案,基隆市,信義區,,,46014,15769,7829,23598,849,24447
公投第１１案,基隆市,暖暖區,,,33225,11394,5797,17191,575,17766
公投第１１案,基隆市,中山區,,,41856,13795,6824,20619,933,21552
公投第１１案,基隆市,中正區,,,45545,13964,6670,20634,1086,21720
公投第１１案,基隆市,仁愛區,,,36738,12588,6081,18669,1020,19689
公投第１１案,新竹市,香山區,,,64896,23729,11396,35125,1662,36787
公投第１１案,新竹市,東區,,,163757,58811,31895,90706,3309,94015
公投第１１案,新竹市,北區,,,123122,44836,21959,66795,2770,69565
公投第１１案,嘉義市,西區,,,120906,44050,20801,64851,2530,67381
公投第１１案,嘉義市,東區,,,100647,36166,17641,53807,1882,55689
公投第１１案,臺北市,士林區,,,241854,82768,50109,132877,6015,138892
公投第１１案,臺北市,萬華區,,,164020,55309,31888,87197,4541,91738
公投第１１案,臺北市,大安區,,,252645,88535,52709,141244,4992,146236
公投第１１案,臺北市,北投區,,,213250,72981,42896,115877,4930,120807
公投第１１案,臺北市,內湖區,,,236824,83195,50907,134102,4545,138647
公投第１１案,臺北市,中山區,,,195148,66307,40817,107124,4427,111551
公投第１１案,臺北市,中正區,,,128292,45658,26747,72405,2797,75202
公投第１１案,臺北市,信義區,,,190444,67363,39247,106610,4367,110977
公投第１１案,臺北市,文山區,,,227211,84069,47142,131211,5129,136340
公投第１１案,臺北市,松山區,,,169278,60838,35764,96602,3958,100560
公投第１１案,臺北市,南港區,,,101907,35738,21712,57450,2126,59576
公投第１１案,臺北市,大同區,,,107557,36686,23038,59724,2890,62614
公投第１１案,高雄市,苓雅區,,,146786,60784,27867,88651,3234,91885
公投第１１案,高雄市,新興區,,,44355,17782,8806,26588,958,27546
公投第１１案,高雄市,三民區,,,289519,114862,54188,169050,5602,174652
公投第１１案,高雄市,左營區,,,161367,66941,29138,96079,3098,99177
公投第１１案,高雄市,鼓山區,,,114979,46387,20737,67124,2272,69396
公投第１１案,高雄市,楠梓區,,,153132,61146,26996,88142,3731,91873
公投第１１案,高雄市,永安區,,,12001,5024,2184,7208,425,7633
公投第１１案,高雄市,林園區,,,59129,21650,9762,31412,1728,33140
公投第１１案,高雄市,彌陀區,,,16487,6857,2749,9606,631,10237
公投第１１案,高雄市,鹽埕區,,,21617,8291,4133,12424,457,12881
公投第１１案,高雄市,大寮區,,,97309,38167,15802,53969,2822,56791
公投第１１案,高雄市,前鎮區,,,161797,63672,28519,92191,4237,96428
公投第１１案,高雄市,燕巢區,,,26012,9918,4252,14170,907,15077
公投第１１案,高雄市,旗山區,,,31996,11950,5192,17142,1199,18341
公投第１１案,高雄市,那瑪夏區,,,2424,1311,358,1669,93,1762
公投第１１案,高雄市,六龜區,,,11501,3535,1464,4999,554,5553
公投第１１案,高雄市,杉林區,,,10607,3336,1323,4659,372,5031
公投第１１案,高雄市,美濃區,,,35311,13222,4696,17918,1573,19491
公投第１１案,高雄市,內門區,,,13002,4380,1717,6097,461,6558
公投第１１案,高雄市,桃源區,,,3498,1615,547,2162,61,2223
公投第１１案,高雄市,甲仙區,,,5417,1740,736,2476,268,2744
公投第１１案,高雄市,茂林區,,,1615,812,263,1075,53,1128
公投第１１案,高雄市,湖內區,,,25729,9636,4230,13866,723,14589
公投第１１案,高雄市,路竹區,,,43850,17063,7678,24741,1465,26206
公投第１１案,高雄市,梓官區,,,31025,12908,4912,17820,882,18702
公投第１１案,高雄市,阿蓮區,,,24534,8913,3926,12839,667,13506
公投第１１案,高雄市,茄萣區,,,26212,9593,3958,13551,870,14421
公投第１１案,高雄市,橋頭區,,,32565,13696,5911,19607,1066,20673
公投第１１案,高雄市,大社區,,,30046,11060,5656,16716,789,17505
公投第１１案,高雄市,仁武區,,,73611,29527,12770,42297,1475,43772
公投第１１案,高雄市,鳥松區,,,39191,15786,7300,23086,1011,24097
公投第１１案,高雄市,岡山區,,,81244,34306,14078,48384,2165,50549
公投第１１案,高雄市,田寮區,,,6671,2120,895,3015,281,3296
公投第１１案,高雄市,大樹區,,,36772,13883,5704,19587,1216,20803
公投第１１案,高雄市,小港區,,,132733,52471,23338,75809,3205,79014
公投第１１案,高雄市,前金區,,,23928,9711,4547,14258,553,14811
公投第１１案,高雄市,旗津區,,,24860,9013,3854,12867,663,13530
公投第１１案,高雄市,鳳山區,,,300510,121790,53188,174978,6400,181378
公投第１１案,新北市,土城區,,,200783,68330,37301,105631,4977,110608
公投第１１案,新北市,三重區,,,329846,112720,62661,175381,10091,185472
公投第１１案,新北市,新店區,,,264053,96556,47821,144377,5820,150197
公投第１１案,新北市,板橋區,,,463411,165739,87319,253058,11481,264539
公投第１１案,新北市,瑞芳區,,,35036,10789,5332,16121,1060,17181
公投第１１案,新北市,永和區,,,187798,70523,36568,107091,4290,111381
公投第１１案,新北市,新莊區,,,344981,122586,65677,188263,9065,197328
公投第１１案,新北市,泰山區,,,64252,22738,11509,34247,1389,35636
公投第１１案,新北市,雙溪區,,,7999,2499,1075,3574,328,3902
公投第１１案,新北市,中和區,,,355978,128026,63253,191279,7610,198889
公投第１１案,新北市,蘆洲區,,,167457,54605,31092,85697,4278,89975
公投第１１案,新北市,金山區,,,18978,6061,2900,8961,688,9649
公投第１１案,新北市,平溪區,,,4321,1375,567,1942,181,2123
公投第１１案,新北市,烏來區,,,5264,2001,807,2808,86,2894
公投第１１案,新北市,萬里區,,,19297,6308,2705,9013,645,9658
公投第１１案,新北市,八里區,,,32970,11117,5506,16623,890,17513
公投第１１案,新北市,貢寮區,,,11279,3111,1518,4629,401,5030
公投第１１案,新北市,石碇區,,,6861,2196,1094,3290,226,3516
公投第１１案,新北市,三芝區,,,20119,6012,3223,9235,572,9807
公投第１１案,新北市,石門區,,,10528,3393,1701,5094,374,5468
公投第１１案,新北市,深坑區,,,20624,7111,3814,10925,475,11400
公投第１１案,新北市,五股區,,,72443,24500,12684,37184,1782,38966
公投第１１案,新北市,林口區,,,86203,29960,16503,46463,1896,48359
公投第１１案,新北市,坪林區,,,5891,1929,851,2780,247,3027
公投第１１案,新北市,淡水區,,,147272,49398,25857,75255,2900,78155
公投第１１案,新北市,三峽區,,,94291,31817,16221,48038,2032,50070
公投第１１案,新北市,樹林區,,,152102,52556,28151,80707,3757,84464
公投第１１案,新北市,鶯歌區,,,71645,23926,12697,36623,1652,38275
公投第１１案,新北市,汐止區,,,173831,56900,31479,88379,3897,92276
公投第１１案,臺中市,新社區,,,20860,7761,2917,10678,655,11333
公投第１１案,臺中市,霧峰區,,,55225,21953,9437,31390,2097,33487
公投第１１案,臺中市,大里區,,,171769,63580,28967,92547,3890,96437
公投第１１案,臺中市,和平區,,,9498,4135,1469,5604,327,5931
公投第１１案,臺中市,太平區,,,157926,57059,25896,82955,3799,86754
公投第１１案,臺中市,龍井區,,,63584,23555,10673,34228,1830,36058
公投第１１案,臺中市,外埔區,,,27059,10586,4461,15047,878,15925
公投第１１案,臺中市,大安區,,,16520,6273,2753,9026,748,9774
公投第１１案,臺中市,烏日區,,,61705,23651,10951,34602,1712,36314
公投第１１案,臺中市,大雅區,,,77189,29388,13270,42658,1954,44612
公投第１１案,臺中市,石岡區,,,12880,4924,2182,7106,531,7637
公投第１１案,臺中市,沙鹿區,,,74207,27449,12792,40241,2066,42307
公投第１１案,臺中市,神岡區,,,54565,21304,9614,30918,1720,32638
公投第１１案,臺中市,后里區,,,44962,16916,7801,24717,1491,26208
公投第１１案,臺中市,潭子區,,,89487,34158,15445,49603,2182,51785
公投第１１案,臺中市,大甲區,,,63069,24051,10532,34583,1977,36560
公投第１１案,臺中市,東勢區,,,43181,17480,6486,23966,1495,25461
公投第１１案,臺中市,梧棲區,,,47040,17011,8468,25479,1494,26973
公投第１１案,臺中市,西屯區,,,183814,68518,34238,102756,4187,106943
公投第１１案,臺中市,南區,,,103643,40885,20374,61259,2702,63961
公投第１１案,臺中市,南屯區,,,135448,52490,26682,79172,3118,82290
公投第１１案,臺中市,北區,,,124621,45623,22559,68182,2632,70814
公投第１１案,臺中市,北屯區,,,227720,85446,40801,126247,4916,131163
公投第１１案,臺中市,中區,,,14696,5461,2373,7834,383,8217
公投第１１案,臺中市,東區,,,64291,24849,11683,36532,1696,38228
公投第１１案,臺中市,西區,,,95040,35073,18648,53721,2119,55840
公投第１１案,臺中市,豐原區,,,136658,53764,24741,78505,3979,82484
公投第１１案,臺中市,清水區,,,71528,27102,12389,39491,2569,42060
公投第１１案,臺中市,大肚區,,,47457,18118,8063,26181,1616,27797
公投第１１案,臺南市,柳營區,,,18804,6119,2643,8762,733,9495
公投第１１案,臺南市,仁德區,,,64632,23066,10194,33260,1673,34933
公投第１１案,臺南市,東區,,,153359,53914,27491,81405,3074,84479
公投第１１案,臺南市,歸仁區,,,57387,19859,9577,29436,1448,30884
公投第１１案,臺南市,西港區,,,21564,6625,3138,9763,552,10315
公投第１１案,臺南市,新化區,,,37296,13367,5896,19263,1024,20287
公投第１１案,臺南市,佳里區,,,50407,17476,7728,25204,1549,26753
公投第１１案,臺南市,將軍區,,,17754,5782,2179,7961,505,8466
公投第１１案,臺南市,北門區,,,9925,2877,1136,4013,245,4258
公投第１１案,臺南市,新市區,,,30386,10824,4984,15808,673,16481
公投第１１案,臺南市,善化區,,,39950,13383,6569,19952,933,20885
公投第１１案,臺南市,玉井區,,,12357,4277,1474,5751,388,6139
公投第１１案,臺南市,楠西區,,,8528,2651,998,3649,265,3914
公投第１１案,臺南市,山上區,,,6511,1895,874,2769,165,2934
公投第１１案,臺南市,安定區,,,26104,9457,4068,13525,748,14273
公投第１１案,臺南市,左鎮區,,,4418,1429,492,1921,153,2074
公投第１１案,臺南市,南區,,,108650,36989,17349,54338,2377,56715
公投第１１案,臺南市,安南區,,,159654,54063,26146,80209,4033,84242
公投第１１案,臺南市,學甲區,,,22567,7157,3174,10331,600,10931
公投第１１案,臺南市,鹽水區,,,22121,6910,3187,10097,745,10842
公投第１１案,臺南市,白河區,,,24894,7052,3223,10275,873,11148
公投第１１案,臺南市,六甲區,,,19144,5759,2850,8609,710,9319
公投第１１案,臺南市,永康區,,,195001,66331,32457,98788,3609,102397
公投第１１案,臺南市,東山區,,,18471,4753,1967,6720,580,7300
公投第１１案,臺南市,後壁區,,,20841,6350,2695,9045,847,9892
公投第１１案,臺南市,新營區,,,64949,21028,10123,31151,1675,32826
公投第１１案,臺南市,下營區,,,20947,6638,2777,9415,683,10098
公投第１１案,臺南市,官田區,,,18675,5914,2786,8700,632,9332
公投第１１案,臺南市,麻豆區,,,37963,12006,6114,18120,948,19068
公投第１１案,臺南市,七股區,,,19950,6592,2505,9097,565,9662
公投第１１案,臺南市,大內區,,,8654,2824,1111,3935,334,4269
公投第１１案,臺南市,南化區,,,7786,2436,1020,3456,278,3734
公投第１１案,臺南市,中西區,,,65261,23013,11907,34920,1641,36561
公投第１１案,臺南市,北區,,,110906,38923,19106,58029,2351,60380
公投第１１案,臺南市,安平區,,,55379,18147,9409,27556,835,28391
公投第１１案,臺南市,龍崎區,,,3713,1246,474,1720,146,1866
公投第１１案,臺南市,關廟區,,,29913,10491,4801,15292,999,16291
公投第１１案,桃園市,龜山區,,,131702,40956,21628,62584,2587,65171
公投第１１案,桃園市,龍潭區,,,101574,36975,15576,52551,2070,54621
公投第１１案,桃園市,中壢區,,,334402,115927,54953,170880,6498,177378
公投第１１案,桃園市,八德區,,,165065,53759,25976,79735,3777,83512
公投第１１案,桃園市,蘆竹區,,,129252,42768,21052,63820,2404,66224
公投第１１案,桃園市,平鎮區,,,183560,65194,29119,94313,3617,97930
公投第１１案,桃園市,觀音區,,,55149,18060,8670,26730,1265,27995
公投第１１案,桃園市,復興區,,,9766,4141,1209,5350,243,5593
公投第１１案,桃園市,新屋區,,,41461,15252,6774,22026,1198,23224
公投第１１案,桃園市,大溪區,,,78285,26867,12405,39272,2276,41548
公投第１１案,桃園市,大園區,,,73900,24004,11708,35712,1452,37164
公投第１１案,桃園市,楊梅區,,,137917,47427,20443,67870,2644,70514
公投第１１案,桃園市,桃園區,,,359790,114447,61960,176407,6601,183008
公投第１１案,連江縣,南竿鄉,介壽村,1,1967,698,273,971,43,1014
公投第１１案,連江縣,南竿鄉,福沃村、復興村,2,1837,646,207,853,31,884
公投第１１案,連江縣,南竿鄉,清水村、珠螺村,3,1114,427,148,575,12,587
公投第１１案,連江縣,南竿鄉,馬祖村、津沙村、四維村、仁愛村,4,1543,614,168,782,18,800
公投第１１案,連江縣,北竿鄉,后沃村、橋仔村、塘岐村,5,1515,588,199,787,27,814
公投第１１案,連江縣,北竿鄉,坂里村、白沙村、芹壁村,6,610,214,71,285,11,296
公投第１１案,連江縣,莒光鄉,田沃村、西坵村、青帆村,7,698,227,108,335,15,350
公投第１１案,連江縣,莒光鄉,大坪村、福正村,8,783,317,117,434,22,456
公投第１１案,連江縣,東引鄉,樂華村、中柳村,9,1138,400,170,570,16,586
公投第１１案,金門縣,金城鎮,東門里,1,1396,359,114,473,25,498
公投第１１案,金門縣,金城鎮,東門里,2,1831,510,166,676,20,696
公投第１１案,金門縣,金城鎮,東門里,3,1750,455,153,608,33,641
公投第１１案,金門縣,金城鎮,南門里,4,1889,496,165,661,57,718
公投第１１案,金門縣,金城鎮,南門里,5,1675,350,160,510,26,536
公投第１１案,金門縣,金城鎮,南門里,6,1901,583,171,754,26,780
公投第１１案,金門縣,金城鎮,西門里,7,1610,365,152,517,41,558
公投第１１案,金門縣,金城鎮,西門里,8,1687,424,153,577,29,606
公投第１１案,金門縣,金城鎮,西門里,9,1594,436,128,564,17,581
公投第１１案,金門縣,金城鎮,西門里,10,1726,417,179,596,18,614
公投第１１案,金門縣,金城鎮,西門里,11,1733,462,146,608,23,631
公投第１１案,金門縣,金城鎮,西門里,12,1532,447,160,607,18,625
公投第１１案,金門縣,金城鎮,北門里,13,2079,501,189,690,37,727
公投第１１案,金門縣,金城鎮,北門里,14,2033,457,168,625,29,654
公投第１１案,金門縣,金城鎮,賢庵里,15,2517,606,235,841,42,883
公投第１１案,金門縣,金城鎮,賢庵里,16,2083,520,167,687,39,726
公投第１１案,金門縣,金城鎮,金水里,17,2140,535,162,697,40,737
公投第１１案,金門縣,金城鎮,古城里,18,2435,500,183,683,29,712
公投第１１案,金門縣,金城鎮,古城里,19,1353,238,78,316,30,346
公投第１１案,金門縣,金城鎮,珠沙里,20,1574,374,106,480,16,496
公投第１１案,金門縣,金城鎮,珠沙里,21,1277,338,112,450,31,481
公投第１１案,金門縣,金寧鄉,古寧村,22,1735,380,121,501,40,541
公投第１１案,金門縣,金寧鄉,古寧村,23,1537,345,116,461,25,486
公投第１１案,金門縣,金寧鄉,安美村,24,1766,379,187,566,28,594
公投第１１案,金門縣,金寧鄉,安美村,25,1015,271,88,359,16,375
公投第１１案,金門縣,金寧鄉,安美村,26,1726,466,123,589,33,622
公投第１１案,金門縣,金寧鄉,湖埔村,27,1691,391,128,519,21,540
公投第１１案,金門縣,金寧鄉,湖埔村,28,2044,321,517,838,28,866
公投第１１案,金門縣,金寧鄉,湖埔村,29,1848,536,207,743,21,764
公投第１１案,金門縣,金寧鄉,湖埔村,30,1735,442,146,588,25,613
公投第１１案,金門縣,金寧鄉,榜林村,31,1795,431,164,595,32,627
公投第１１案,金門縣,金寧鄉,榜林村,32,1834,412,133,545,36,581
公投第１１案,金門縣,金寧鄉,榜林村,33,1528,348,134,482,28,510
公投第１１案,金門縣,金寧鄉,盤山村,34,1473,418,127,545,23,568
公投第１１案,金門縣,金寧鄉,盤山村,35,1679,426,147,573,28,601
公投第１１案,金門縣,金寧鄉,盤山村,36,1921,265,661,926,7,933
公投第１１案,金門縣,金寧鄉,盤山村,37,1298,308,148,456,12,468
公投第１１案,金門縣,金寧鄉,后盤村,38,1537,361,113,474,32,506
公投第１１案,金門縣,烈嶼鄉,林湖村,39,1647,527,158,685,37,722
公投第１１案,金門縣,烈嶼鄉,林湖村,40,1733,454,128,582,35,617
公投第１１案,金門縣,烈嶼鄉,黃埔村,41,1635,430,147,577,30,607
公投第１１案,金門縣,烈嶼鄉,西口村,42,1296,313,109,422,18,440
公投第１１案,金門縣,烈嶼鄉,西口村,43,1099,257,75,332,23,355
公投第１１案,金門縣,烈嶼鄉,上林村,44,1425,339,114,453,31,484
公投第１１案,金門縣,烈嶼鄉,上岐村,45,1412,375,126,501,24,525
公投第１１案,金門縣,烈嶼鄉,上岐村,46,1429,368,108,476,29,505
公投第１１案,金門縣,烏坵鄉,大坵村,47,275,55,20,75,3,78
公投第１１案,金門縣,烏坵鄉,小坵村,48,292,70,14,84,3,87
公投第１１案,金門縣,金湖鎮,新市里,49,1348,376,142,518,22,540
公投第１１案,金門縣,金湖鎮,新市里,50,1386,312,142,454,30,484
公投第１１案,金門縣,金湖鎮,新市里,51,1403,436,133,569,36,605
公投第１１案,金門縣,金湖鎮,山外里,52,1771,488,154,642,33,675
公投第１１案,金門縣,金湖鎮,山外里,53,1493,362,162,524,34,558
公投第１１案,金門縣,金湖鎮,溪湖里,54,1510,365,129,494,40,534
公投第１１案,金門縣,金湖鎮,蓮庵里,55,1607,436,133,569,40,609
公投第１１案,金門縣,金湖鎮,料羅里,56,2006,479,151,630,37,667
公投第１１案,金門縣,金湖鎮,新湖里,57,1780,431,186,617,26,643
公投第１１案,金門縣,金湖鎮,新湖里,58,1739,441,179,620,15,635
公投第１１案,金門縣,金湖鎮,新湖里,59,1384,345,111,456,23,479
公投第１１案,金門縣,金湖鎮,新湖里,60,1400,366,138,504,24,528
公投第１１案,金門縣,金湖鎮,新湖里,61,1325,440,129,569,16,585
公投第１１案,金門縣,金湖鎮,正義里,62,1236,300,97,397,19,416
公投第１１案,金門縣,金湖鎮,正義里,63,1382,336,116,452,31,483
公投第１１案,金門縣,金湖鎮,瓊林里,64,1631,421,125,546,14,560
公投第１１案,金門縣,金湖鎮,瓊林里,65,1514,342,106,448,45,493
公投第１１案,金門縣,金沙鎮,汶沙里,66,1909,478,141,619,37,656
公投第１１案,金門縣,金沙鎮,汶沙里,67,1524,460,134,594,31,625
公投第１１案,金門縣,金沙鎮,汶沙里,68,1673,409,114,523,24,547
公投第１１案,金門縣,金沙鎮,何斗里,69,2003,513,111,624,36,660
公投第１１案,金門縣,金沙鎮,浦山里,70,1212,354,118,472,23,495
公投第１１案,金門縣,金沙鎮,浦山里,71,1126,287,94,381,29,410
公投第１１案,金門縣,金沙鎮,西園里,72,1540,352,99,451,28,479
公投第１１案,金門縣,金沙鎮,官嶼里,73,1216,272,83,355,21,376
公投第１１案,金門縣,金沙鎮,官嶼里,74,950,193,54,247,12,259
公投第１１案,金門縣,金沙鎮,三山里,75,1895,539,127,666,35,701
公投第１１案,金門縣,金沙鎮,大洋里,76,1135,336,96,432,32,464
公投第１１案,金門縣,金沙鎮,光前里,77,1252,317,100,417,21,438
公投第１１案,金門縣,金沙鎮,光前里,78,1125,346,96,442,21,463
公投第１１案,宜蘭縣,宜蘭市,民族里,1,982,347,174,521,15,536
公投第１１案,宜蘭縣,宜蘭市,民族里,2,1270,472,198,670,32,702
公投第１１案,宜蘭縣,宜蘭市,建軍里,3,849,295,168,463,12,475
公投第１１案,宜蘭縣,宜蘭市,建軍里,4,756,259,161,420,20,440
公投第１１案,宜蘭縣,宜蘭市,泰山里,5,1107,393,151,544,18,562
公投第１１案,宜蘭縣,宜蘭市,泰山里,6,893,325,143,468,29,497
公投第１１案,宜蘭縣,宜蘭市,負郭里,7,912,312,166,478,30,508
公投第１１案,宜蘭縣,宜蘭市,負郭里,8,1335,464,243,707,47,754
公投第１１案,宜蘭縣,宜蘭市,負郭里,9,686,223,120,343,24,367
公投第１１案,宜蘭縣,宜蘭市,思源里,10,1366,512,310,822,30,852
公投第１１案,宜蘭縣,宜蘭市,思源里,11,1363,468,294,762,15,777
公投第１１案,宜蘭縣,宜蘭市,思源里,12,1540,557,297,854,36,890
公投第１１案,宜蘭縣,宜蘭市,七結里,13,1341,451,286,737,25,762
公投第１１案,宜蘭縣,宜蘭市,七結里,14,1209,467,199,666,23,689
公投第１１案,宜蘭縣,宜蘭市,文化里,15,900,323,166,489,30,519
公投第１１案,宜蘭縣,宜蘭市,文化里,16,980,325,173,498,21,519
公投第１１案,宜蘭縣,宜蘭市,文化里,17,1165,377,250,627,28,655
公投第１１案,宜蘭縣,宜蘭市,復興里,18,904,332,152,484,21,505
公投第１１案,宜蘭縣,宜蘭市,復興里,19,813,290,160,450,19,469
公投第１１案,宜蘭縣,宜蘭市,復興里,20,978,348,171,519,27,546
公投第１１案,宜蘭縣,宜蘭市,民權里,21,1282,387,185,572,15,587
公投第１１案,宜蘭縣,宜蘭市,民權里,22,465,173,91,264,10,274
公投第１１案,宜蘭縣,宜蘭市,神農里,23,669,261,110,371,26,397
公投第１１案,宜蘭縣,宜蘭市,神農里,24,923,337,163,500,26,526
公投第１１案,宜蘭縣,宜蘭市,神農里,25,1006,339,180,519,18,537
公投第１１案,宜蘭縣,宜蘭市,大新里,26,762,333,144,477,28,505
公投第１１案,宜蘭縣,宜蘭市,新民里,27,727,307,136,443,26,469
公投第１１案,宜蘭縣,宜蘭市,新民里,28,833,372,156,528,37,565
公投第１１案,宜蘭縣,宜蘭市,進士里,29,1143,384,234,618,36,654
公投第１１案,宜蘭縣,宜蘭市,進士里,30,979,351,181,532,15,547
公投第１１案,宜蘭縣,宜蘭市,南橋里,31,1214,441,203,644,41,685
公投第１１案,宜蘭縣,宜蘭市,凱旋里,32,1283,458,229,687,51,738
公投第１１案,宜蘭縣,宜蘭市,南津里,33,946,339,190,529,25,554
公投第１１案,宜蘭縣,宜蘭市,南津里,34,1090,370,187,557,30,587
公投第１１案,宜蘭縣,宜蘭市,建業里,35,943,347,200,547,22,569
公投第１１案,宜蘭縣,宜蘭市,建業里,36,774,275,200,475,24,499
公投第１１案,宜蘭縣,宜蘭市,擺厘里,37,968,367,205,572,18,590
公投第１１案,宜蘭縣,宜蘭市,擺厘里,38,926,349,200,549,22,571
公投第１１案,宜蘭縣,宜蘭市,擺厘里,39,1019,379,206,585,27,612
公投第１１案,宜蘭縣,宜蘭市,延平里,40,1084,362,218,580,38,618
公投第１１案,宜蘭縣,宜蘭市,延平里,41,1095,377,199,576,20,596
公投第１１案,宜蘭縣,宜蘭市,延平里,42,1083,385,214,599,25,624
公投第１１案,宜蘭縣,宜蘭市,成功里,43,1108,374,200,574,22,596
公投第１１案,宜蘭縣,宜蘭市,成功里,44,848,309,172,481,15,496
公投第１１案,宜蘭縣,宜蘭市,成功里,45,1095,399,188,587,22,609
公投第１１案,宜蘭縣,宜蘭市,東村里,46,1110,396,211,607,21,628
公投第１１案,宜蘭縣,宜蘭市,東村里,47,1104,407,215,622,24,646
公投第１１案,宜蘭縣,宜蘭市,新東里,48,1134,405,225,630,20,650
公投第１１案,宜蘭縣,宜蘭市,新東里,49,1146,419,219,638,23,661
公投第１１案,宜蘭縣,宜蘭市,新東里,50,876,340,169,509,26,535
公投第１１案,宜蘭縣,宜蘭市,黎明里,51,905,315,161,476,32,508
公投第１１案,宜蘭縣,宜蘭市,黎明里,52,910,328,179,507,28,535
公投第１１案,宜蘭縣,宜蘭市,七張里,53,1434,460,234,694,37,731
公投第１１案,宜蘭縣,宜蘭市,孝廉里,54,1152,389,207,596,43,639
公投第１１案,宜蘭縣,宜蘭市,東門里,55,966,360,193,553,29,582
公投第１１案,宜蘭縣,宜蘭市,小東里,56,711,260,138,398,18,416
公投第１１案,宜蘭縣,宜蘭市,小東里,57,884,341,166,507,30,537
公投第１１案,宜蘭縣,宜蘭市,菜園里,58,1326,486,244,730,37,767
公投第１１案,宜蘭縣,宜蘭市,慈安里,59,909,285,164,449,27,476
公投第１１案,宜蘭縣,宜蘭市,慈安里,60,894,306,153,459,31,490
公投第１１案,宜蘭縣,宜蘭市,中興里,61,1259,431,190,621,19,640
公投第１１案,宜蘭縣,宜蘭市,中興里,62,789,265,129,394,23,417
公投第１１案,宜蘭縣,宜蘭市,中興里,63,867,299,155,454,27,481
公投第１１案,宜蘭縣,宜蘭市,新生里,64,1454,494,265,759,55,814
公投第１１案,宜蘭縣,宜蘭市,新生里,65,1130,496,179,675,16,691
公投第１１案,宜蘭縣,宜蘭市,茭白里,66,1087,360,166,526,11,537
公投第１１案,宜蘭縣,宜蘭市,茭白里,67,938,367,166,533,47,580
公投第１１案,宜蘭縣,宜蘭市,北津里,68,1285,500,232,732,34,766
公投第１１案,宜蘭縣,宜蘭市,北津里,69,952,349,170,519,13,532
公投第１１案,宜蘭縣,宜蘭市,梅洲里,70,948,339,204,543,29,572
公投第１１案,宜蘭縣,宜蘭市,梅洲里,71,1160,360,225,585,31,616
公投第１１案,宜蘭縣,宜蘭市,梅洲里,72,1015,373,178,551,53,604
公投第１１案,宜蘭縣,宜蘭市,南門里,73,424,158,89,247,16,263
公投第１１案,宜蘭縣,宜蘭市,南門里,74,964,353,181,534,37,571
公投第１１案,宜蘭縣,宜蘭市,中山里,75,959,309,178,487,31,518
公投第１１案,宜蘭縣,宜蘭市,西門里,76,814,349,143,492,24,516
公投第１１案,宜蘭縣,宜蘭市,西門里,77,885,348,160,508,18,526
公投第１１案,宜蘭縣,宜蘭市,北門里,78,1162,405,226,631,48,679
公投第１１案,宜蘭縣,羅東鎮,開明里,79,689,248,128,376,32,408
公投第１１案,宜蘭縣,羅東鎮,開明里,80,718,266,114,380,20,400
公投第１１案,宜蘭縣,羅東鎮,大新里,81,1475,508,251,759,61,820
公投第１１案,宜蘭縣,羅東鎮,東安里,82,1466,466,284,750,48,798
公投第１１案,宜蘭縣,羅東鎮,東安里,83,1075,376,207,583,25,608
公投第１１案,宜蘭縣,羅東鎮,東安里,84,963,347,169,516,21,537
公投第１１案,宜蘭縣,羅東鎮,新群里,85,1511,508,242,750,65,815
公投第１１案,宜蘭縣,羅東鎮,新群里,86,1166,398,216,614,29,643
公投第１１案,宜蘭縣,羅東鎮,羅莊里,87,1273,443,250,693,43,736
公投第１１案,宜蘭縣,羅東鎮,羅莊里,88,1735,608,289,897,18,915
公投第１１案,宜蘭縣,羅東鎮,南昌里,89,1487,539,278,817,33,850
公投第１１案,宜蘭縣,羅東鎮,南昌里,90,837,302,179,481,22,503
公投第１１案,宜蘭縣,羅東鎮,南豪里,91,1312,495,248,743,49,792
公投第１１案,宜蘭縣,羅東鎮,成功里,92,1502,497,261,758,43,801
公投第１１案,宜蘭縣,羅東鎮,仁德里,93,1138,383,203,586,19,605
公投第１１案,宜蘭縣,羅東鎮,仁和里,94,1010,349,186,535,30,565
公投第１１案,宜蘭縣,羅東鎮,中山里,95,1373,502,243,745,51,796
公投第１１案,宜蘭縣,羅東鎮,漢民里,96,1089,442,163,605,28,633
公投第１１案,宜蘭縣,羅東鎮,漢民里,97,1304,464,218,682,32,714
公投第１１案,宜蘭縣,羅東鎮,漢民里,98,1288,419,223,642,54,696
公投第１１案,宜蘭縣,羅東鎮,維揚里,99,1036,389,218,607,35,642
公投第１１案,宜蘭縣,羅東鎮,維揚里,100,969,406,181,587,32,619
公投第１１案,宜蘭縣,羅東鎮,維揚里,101,985,362,203,565,28,593
公投第１１案,宜蘭縣,羅東鎮,西安里,102,1420,524,271,795,39,834
公投第１１案,宜蘭縣,羅東鎮,西安里,103,1430,527,253,780,40,820
公投第１１案,宜蘭縣,羅東鎮,北成里,104,1075,401,191,592,42,634
公投第１１案,宜蘭縣,羅東鎮,北成里,105,879,315,187,502,29,531
公投第１１案,宜蘭縣,羅東鎮,北成里,106,850,284,177,461,14,475
公投第１１案,宜蘭縣,羅東鎮,國華里,107,1111,402,235,637,27,664
公投第１１案,宜蘭縣,羅東鎮,國華里,108,1139,465,224,689,25,714
公投第１１案,宜蘭縣,羅東鎮,國華里,109,1130,433,239,672,26,698
公投第１１案,宜蘭縣,羅東鎮,國華里,110,980,355,207,562,17,579
公投第１１案,宜蘭縣,羅東鎮,賢文里,111,1431,499,268,767,39,806
公投第１１案,宜蘭縣,羅東鎮,賢文里,112,1109,395,205,600,35,635
公投第１１案,宜蘭縣,羅東鎮,賢文里,113,1083,406,183,589,25,614
公投第１１案,宜蘭縣,羅東鎮,公正里,114,1404,520,254,774,43,817
公投第１１案,宜蘭縣,羅東鎮,公正里,115,1288,464,243,707,36,743
公投第１１案,宜蘭縣,羅東鎮,集祥里,116,1183,328,191,519,28,547
公投第１１案,宜蘭縣,羅東鎮,信義里,117,1105,412,223,635,27,662
公投第１１案,宜蘭縣,羅東鎮,信義里,118,987,368,206,574,32,606
公投第１１案,宜蘭縣,羅東鎮,信義里,119,773,299,150,449,27,476
公投第１１案,宜蘭縣,羅東鎮,樹林里,120,1366,543,300,843,26,869
公投第１１案,宜蘭縣,羅東鎮,樹林里,121,907,366,199,565,20,585
公投第１１案,宜蘭縣,羅東鎮,樹林里,122,1158,465,234,699,21,720
公投第１１案,宜蘭縣,羅東鎮,竹林里,123,977,350,189,539,30,569
公投第１１案,宜蘭縣,羅東鎮,竹林里,124,972,325,176,501,30,531
公投第１１案,宜蘭縣,羅東鎮,竹林里,125,977,357,196,553,29,582
公投第１１案,宜蘭縣,羅東鎮,仁愛里,126,1398,527,263,790,35,825
公投第１１案,宜蘭縣,羅東鎮,仁愛里,127,1022,356,197,553,26,579
公投第１１案,宜蘭縣,羅東鎮,仁愛里,128,1131,485,178,663,32,695
公投第１１案,宜蘭縣,蘇澳鎮,龍德里,129,1194,422,216,638,37,675
公投第１１案,宜蘭縣,蘇澳鎮,龍德里,130,1128,412,182,594,26,620
公投第１１案,宜蘭縣,蘇澳鎮,龍德里,131,1042,370,223,593,42,635
公投第１１案,宜蘭縣,蘇澳鎮,頂寮里,132,997,362,202,564,22,586
公投第１１案,宜蘭縣,蘇澳鎮,永榮里,133,1303,448,238,686,52,738
公投第１１案,宜蘭縣,蘇澳鎮,永榮里,134,1260,468,237,705,48,753
公投第１１案,宜蘭縣,蘇澳鎮,永榮里,135,1130,395,205,600,47,647
公投第１１案,宜蘭縣,蘇澳鎮,存仁里,136,559,185,103,288,28,316
公投第１１案,宜蘭縣,蘇澳鎮,存仁里,137,351,101,61,162,20,182
公投第１１案,宜蘭縣,蘇澳鎮,港邊里,138,889,298,146,444,53,497
公投第１１案,宜蘭縣,蘇澳鎮,港邊里,139,434,142,76,218,23,241
公投第１１案,宜蘭縣,蘇澳鎮,隘丁里,140,835,329,154,483,28,511
公投第１１案,宜蘭縣,蘇澳鎮,隘丁里,141,975,347,181,528,33,561
公投第１１案,宜蘭縣,蘇澳鎮,隘丁里,142,1135,434,209,643,33,676
公投第１１案,宜蘭縣,蘇澳鎮,新城里,143,788,304,181,485,29,514
公投第１１案,宜蘭縣,蘇澳鎮,新城里,144,469,156,82,238,20,258
公投第１１案,宜蘭縣,蘇澳鎮,聖愛里,145,811,290,126,416,28,444
公投第１１案,宜蘭縣,蘇澳鎮,聖愛里,146,867,312,148,460,20,480
公投第１１案,宜蘭縣,蘇澳鎮,聖愛里,147,1139,426,189,615,27,642
公投第１１案,宜蘭縣,蘇澳鎮,聖湖里,148,1146,413,160,573,29,602
公投第１１案,宜蘭縣,蘇澳鎮,聖湖里,149,1154,397,204,601,48,649
公投第１１案,宜蘭縣,蘇澳鎮,蘇西里,150,908,316,36,352,22,374
公投第１１案,宜蘭縣,蘇澳鎮,蘇西里,151,656,257,91,348,16,364
公投第１１案,宜蘭縣,蘇澳鎮,蘇西里,152,834,333,140,473,41,514
公投第１１案,宜蘭縣,蘇澳鎮,蘇北里,153,1025,387,200,587,28,615
公投第１１案,宜蘭縣,蘇澳鎮,蘇南里,154,455,156,91,247,17,264
公投第１１案,宜蘭縣,蘇澳鎮,蘇東里,155,535,194,98,292,22,314
公投第１１案,宜蘭縣,蘇澳鎮,長安里,156,536,213,104,317,26,343
公投第１１案,宜蘭縣,蘇澳鎮,永光里,157,451,168,91,259,12,271
公投第１１案,宜蘭縣,蘇澳鎮,永春里,158,593,204,94,298,34,332
公投第１１案,宜蘭縣,蘇澳鎮,永樂里,159,441,163,70,233,25,258
公投第１１案,宜蘭縣,蘇澳鎮,南安里,160,954,350,151,501,47,548
公投第１１案,宜蘭縣,蘇澳鎮,南正里,161,952,329,141,470,48,518
公投第１１案,宜蘭縣,蘇澳鎮,南成里,162,1125,310,176,486,60,546
公投第１１案,宜蘭縣,蘇澳鎮,南興里,163,763,263,115,378,52,430
公投第１１案,宜蘭縣,蘇澳鎮,南興里,164,706,197,96,293,28,321
公投第１１案,宜蘭縣,蘇澳鎮,南寧里,165,1068,328,130,458,59,517
公投第１１案,宜蘭縣,蘇澳鎮,南建里,166,666,210,126,336,52,388
公投第１１案,宜蘭縣,蘇澳鎮,南建里,167,574,169,94,263,65,328
公投第１１案,宜蘭縣,蘇澳鎮,東澳里,168,351,94,66,160,5,165
公投第１１案,宜蘭縣,蘇澳鎮,南強里,169,717,261,104,365,40,405
公投第１１案,宜蘭縣,蘇澳鎮,朝陽里,170,373,112,30,142,12,154
公投第１１案,宜蘭縣,蘇澳鎮,朝陽里,171,223,53,27,80,14,94
公投第１１案,宜蘭縣,頭城鎮,石城里,172,292,69,26,95,12,107
公投第１１案,宜蘭縣,頭城鎮,大里里,173,688,213,112,325,44,369
公投第１１案,宜蘭縣,頭城鎮,龜山里,174,688,252,116,368,26,394
公投第１１案,宜蘭縣,頭城鎮,大溪里,175,879,274,131,405,73,478
公投第１１案,宜蘭縣,頭城鎮,合興里,176,335,124,58,182,22,204
公投第１１案,宜蘭縣,頭城鎮,更新里,177,624,261,110,371,22,393
公投第１１案,宜蘭縣,頭城鎮,更新里,178,732,211,111,322,22,344
公投第１１案,宜蘭縣,頭城鎮,外澳里,179,892,250,139,389,30,419
公投第１１案,宜蘭縣,頭城鎮,港口里,180,690,183,105,288,25,313
公投第１１案,宜蘭縣,頭城鎮,武營里,181,842,286,135,421,31,452
公投第１１案,宜蘭縣,頭城鎮,武營里,182,736,241,144,385,26,411
公投第１１案,宜蘭縣,頭城鎮,大坑里,183,788,252,134,386,17,403
公投第１１案,宜蘭縣,頭城鎮,大坑里,184,560,167,100,267,20,287
公投第１１案,宜蘭縣,頭城鎮,城東里,185,712,292,110,402,23,425
公投第１１案,宜蘭縣,頭城鎮,城北里,186,502,215,87,302,20,322
公投第１１案,宜蘭縣,頭城鎮,城西里,187,569,214,118,332,27,359
公投第１１案,宜蘭縣,頭城鎮,城南里,188,633,236,100,336,25,361
公投第１１案,宜蘭縣,頭城鎮,竹安里,189,1132,328,166,494,44,538
公投第１１案,宜蘭縣,頭城鎮,竹安里,190,1035,312,150,462,34,496
公投第１１案,宜蘭縣,頭城鎮,新建里,191,847,323,148,471,33,504
公投第１１案,宜蘭縣,頭城鎮,新建里,192,1172,401,230,631,29,660
公投第１１案,宜蘭縣,頭城鎮,拔雅里,193,896,288,162,450,21,471
公投第１１案,宜蘭縣,頭城鎮,拔雅里,194,1075,389,221,610,17,627
公投第１１案,宜蘭縣,頭城鎮,福成里,195,931,326,177,503,46,549
公投第１１案,宜蘭縣,頭城鎮,金面里,196,1021,372,152,524,38,562
公投第１１案,宜蘭縣,頭城鎮,金面里,197,709,227,97,324,27,351
公投第１１案,宜蘭縣,頭城鎮,金盈里,198,689,282,125,407,35,442
公投第１１案,宜蘭縣,頭城鎮,頂埔里,199,615,226,120,346,38,384
公投第１１案,宜蘭縣,頭城鎮,頂埔里,200,759,264,123,387,28,415
公投第１１案,宜蘭縣,頭城鎮,下埔里,201,917,352,164,516,48,564
公投第１１案,宜蘭縣,頭城鎮,中崙里,202,1045,370,172,542,58,600
公投第１１案,宜蘭縣,頭城鎮,二城里,203,1130,412,180,592,43,635
公投第１１案,宜蘭縣,礁溪鄉,白雲村,204,1122,358,168,526,36,562
公投第１１案,宜蘭縣,礁溪鄉,白雲村,205,505,161,92,253,14,267
公投第１１案,宜蘭縣,礁溪鄉,玉石村,206,988,333,155,488,25,513
公投第１１案,宜蘭縣,礁溪鄉,玉石村,207,971,307,187,494,26,520
公投第１１案,宜蘭縣,礁溪鄉,德陽村,208,1246,389,203,592,31,623
公投第１１案,宜蘭縣,礁溪鄉,德陽村,209,1655,499,263,762,24,786
公投第１１案,宜蘭縣,礁溪鄉,德陽村,210,1132,310,189,499,16,515
公投第１１案,宜蘭縣,礁溪鄉,大忠村,211,783,275,148,423,21,444
公投第１１案,宜蘭縣,礁溪鄉,大忠村,212,928,308,166,474,26,500
公投第１１案,宜蘭縣,礁溪鄉,大忠村,213,848,287,135,422,36,458
公投第１１案,宜蘭縣,礁溪鄉,大義村,214,663,258,135,393,28,421
公投第１１案,宜蘭縣,礁溪鄉,六結村,215,608,228,104,332,16,348
公投第１１案,宜蘭縣,礁溪鄉,六結村,216,833,307,141,448,26,474
公投第１１案,宜蘭縣,礁溪鄉,二龍村,217,1233,335,223,558,26,584
公投第１１案,宜蘭縣,礁溪鄉,時潮村,218,854,286,152,438,42,480
公投第１１案,宜蘭縣,礁溪鄉,時潮村,219,575,183,99,282,21,303
公投第１１案,宜蘭縣,礁溪鄉,玉田村,220,835,261,169,430,39,469
公投第１１案,宜蘭縣,礁溪鄉,玉田村,221,1305,463,242,705,43,748
公投第１１案,宜蘭縣,礁溪鄉,三民村,222,830,270,152,422,39,461
公投第１１案,宜蘭縣,礁溪鄉,三民村,223,649,248,146,394,34,428
公投第１１案,宜蘭縣,礁溪鄉,三民村,224,923,277,144,421,38,459
公投第１１案,宜蘭縣,礁溪鄉,林美村,225,1177,342,183,525,34,559
公投第１１案,宜蘭縣,礁溪鄉,白鵝村,226,840,292,144,436,27,463
公投第１１案,宜蘭縣,礁溪鄉,玉光村,227,1051,370,199,569,30,599
公投第１１案,宜蘭縣,礁溪鄉,光武村,228,1339,432,223,655,30,685
公投第１１案,宜蘭縣,礁溪鄉,吳沙村,229,1194,470,202,672,35,707
公投第１１案,宜蘭縣,礁溪鄉,吳沙村,230,1314,519,237,756,34,790
公投第１１案,宜蘭縣,礁溪鄉,龍潭村,231,1125,350,241,591,31,622
公投第１１案,宜蘭縣,礁溪鄉,龍潭村,232,1207,451,222,673,51,724
公投第１１案,宜蘭縣,礁溪鄉,龍潭村,233,979,337,170,507,42,549
公投第１１案,宜蘭縣,礁溪鄉,匏崙村,234,954,356,187,543,41,584
公投第１１案,宜蘭縣,礁溪鄉,二結村,235,418,147,77,224,8,232
公投第１１案,宜蘭縣,壯圍鄉,吉祥村,236,1435,534,259,793,76,869
公投第１１案,宜蘭縣,壯圍鄉,吉祥村,237,1049,411,196,607,25,632
公投第１１案,宜蘭縣,壯圍鄉,古結村,238,1068,413,200,613,45,658
公投第１１案,宜蘭縣,壯圍鄉,美福村,239,868,312,145,457,48,505
公投第１１案,宜蘭縣,壯圍鄉,美福村,240,967,335,177,512,31,543
公投第１１案,宜蘭縣,壯圍鄉,新南村,241,940,354,178,532,55,587
公投第１１案,宜蘭縣,壯圍鄉,東港村,242,975,318,142,460,25,485
公投第１１案,宜蘭縣,壯圍鄉,復興村,243,797,294,145,439,49,488
公投第１１案,宜蘭縣,壯圍鄉,復興村,244,808,319,127,446,27,473
公投第１１案,宜蘭縣,壯圍鄉,過嶺村,245,911,323,176,499,50,549
公投第１１案,宜蘭縣,壯圍鄉,過嶺村,246,612,202,88,290,24,314
公投第１１案,宜蘭縣,壯圍鄉,永鎮村,247,790,323,139,462,39,501
公投第１１案,宜蘭縣,壯圍鄉,忠孝村,248,878,337,158,495,34,529
公投第１１案,宜蘭縣,壯圍鄉,忠孝村,249,723,286,159,445,32,477
公投第１１案,宜蘭縣,壯圍鄉,忠孝村,250,737,266,119,385,18,403
公投第１１案,宜蘭縣,壯圍鄉,古亭村,251,686,248,127,375,39,414
公投第１１案,宜蘭縣,壯圍鄉,古亭村,252,895,317,161,478,8,486
公投第１１案,宜蘭縣,壯圍鄉,功勞村,253,1237,494,208,702,55,757
公投第１１案,宜蘭縣,壯圍鄉,美城村,254,1134,383,221,604,48,652
公投第１１案,宜蘭縣,壯圍鄉,美城村,255,1107,394,194,588,33,621
公投第１１案,宜蘭縣,壯圍鄉,新社村,256,1057,424,181,605,43,648
公投第１１案,宜蘭縣,壯圍鄉,大福村,257,1051,335,179,514,35,549
公投第１１案,宜蘭縣,壯圍鄉,大福村,258,722,236,139,375,29,404
公投第１１案,宜蘭縣,員山鄉,員山村,259,1393,487,254,741,24,765
公投第１１案,宜蘭縣,員山鄉,員山村,260,895,275,173,448,17,465
公投第１１案,宜蘭縣,員山鄉,員山村,261,1231,448,176,624,42,666
公投第１１案,宜蘭縣,員山鄉,員山村,262,1098,349,195,544,24,568
公投第１１案,宜蘭縣,員山鄉,員山村,263,1031,359,163,522,25,547
公投第１１案,宜蘭縣,員山鄉,尚德村,264,1030,348,160,508,49,557
公投第１１案,宜蘭縣,員山鄉,尚德村,265,1168,300,225,525,33,558
公投第１１案,宜蘭縣,員山鄉,惠好村,266,809,284,138,422,42,464
公投第１１案,宜蘭縣,員山鄉,惠好村,267,778,257,158,415,32,447
公投第１１案,宜蘭縣,員山鄉,七賢村,268,1465,532,267,799,48,847
公投第１１案,宜蘭縣,員山鄉,深溝村,269,979,357,187,544,41,585
公投第１１案,宜蘭縣,員山鄉,深溝村,270,860,315,139,454,29,483
公投第１１案,宜蘭縣,員山鄉,蓁巷村,271,1205,304,246,550,50,600
公投第１１案,宜蘭縣,員山鄉,內城村,272,1082,400,172,572,37,609
公投第１１案,宜蘭縣,員山鄉,內城村,273,412,159,71,230,17,247
公投第１１案,宜蘭縣,員山鄉,中華村,274,403,135,60,195,11,206
公投第１１案,宜蘭縣,員山鄉,中華村,275,232,77,23,100,4,104
公投第１１案,宜蘭縣,員山鄉,永和村,276,944,312,171,483,29,512
公投第１１案,宜蘭縣,員山鄉,永和村,277,894,304,158,462,40,502
公投第１１案,宜蘭縣,員山鄉,頭分村,278,1356,526,202,728,30,758
公投第１１案,宜蘭縣,員山鄉,枕山村,279,780,285,140,425,34,459
公投第１１案,宜蘭縣,員山鄉,枕山村,280,932,375,176,551,39,590
公投第１１案,宜蘭縣,員山鄉,枕山村,281,583,174,104,278,29,307
公投第１１案,宜蘭縣,員山鄉,同樂村,282,900,352,126,478,26,504
公投第１１案,宜蘭縣,員山鄉,同樂村,283,747,262,132,394,19,413
公投第１１案,宜蘭縣,員山鄉,同樂村,284,788,264,136,400,34,434
公投第１１案,宜蘭縣,員山鄉,湖東村,285,884,271,157,428,40,468
公投第１１案,宜蘭縣,員山鄉,逸仙村,286,857,278,148,426,19,445
公投第１１案,宜蘭縣,員山鄉,湖北村,287,1016,319,180,499,26,525
公投第１１案,宜蘭縣,員山鄉,湖西村,288,690,168,116,284,24,308
公投第１１案,宜蘭縣,員山鄉,湖西村,289,689,201,111,312,54,366
公投第１１案,宜蘭縣,冬山鄉,珍珠村,290,807,296,155,451,35,486
公投第１１案,宜蘭縣,冬山鄉,珍珠村,291,817,305,163,468,18,486
公投第１１案,宜蘭縣,冬山鄉,補城村,292,1156,402,219,621,38,659
公投第１１案,宜蘭縣,冬山鄉,三奇村,293,892,310,148,458,27,485
公投第１１案,宜蘭縣,冬山鄉,大興村,294,897,319,181,500,29,529
公投第１１案,宜蘭縣,冬山鄉,東城村,295,1392,524,257,781,49,830
公投第１１案,宜蘭縣,冬山鄉,香和村,296,1471,474,334,808,35,843
公投第１１案,宜蘭縣,冬山鄉,香和村,297,1435,444,214,658,30,688
公投第１１案,宜蘭縣,冬山鄉,南興村,298,1519,478,265,743,48,791
公投第１１案,宜蘭縣,冬山鄉,南興村,299,1456,531,288,819,29,848
公投第１１案,宜蘭縣,冬山鄉,安平村,300,711,265,144,409,31,440
公投第１１案,宜蘭縣,冬山鄉,冬山村,301,694,252,127,379,28,407
公投第１１案,宜蘭縣,冬山鄉,太和村,302,1526,608,312,920,44,964
公投第１１案,宜蘭縣,冬山鄉,八寶村,303,884,285,184,469,23,492
公投第１１案,宜蘭縣,冬山鄉,丸山村,304,1465,423,31,454,63,517
公投第１１案,宜蘭縣,冬山鄉,中山村,305,488,174,95,269,16,285
公投第１１案,宜蘭縣,冬山鄉,順安村,306,1218,445,163,608,40,648
公投第１１案,宜蘭縣,冬山鄉,順安村,307,1291,429,201,630,33,663
公投第１１案,宜蘭縣,冬山鄉,順安村,308,1324,441,198,639,32,671
公投第１１案,宜蘭縣,冬山鄉,順安村,309,1160,360,175,535,40,575
公投第１１案,宜蘭縣,冬山鄉,永美村,310,1246,425,207,632,42,674
公投第１１案,宜蘭縣,冬山鄉,永美村,311,1754,577,301,878,35,913
公投第１１案,宜蘭縣,冬山鄉,武淵村,312,1217,404,209,613,35,648
公投第１１案,宜蘭縣,冬山鄉,群英村,313,1495,444,245,689,32,721
公投第１１案,宜蘭縣,冬山鄉,群英村,314,937,312,173,485,26,511
公投第１１案,宜蘭縣,冬山鄉,群英村,315,1101,365,200,565,19,584
公投第１１案,宜蘭縣,冬山鄉,群英村,316,1118,365,185,550,35,585
公投第１１案,宜蘭縣,冬山鄉,清溝村,317,1301,472,249,721,29,750
公投第１１案,宜蘭縣,冬山鄉,清溝村,318,1225,406,228,634,24,658
公投第１１案,宜蘭縣,冬山鄉,清溝村,319,1206,435,239,674,33,707
公投第１１案,宜蘭縣,冬山鄉,鹿埔村,320,1278,409,216,625,26,651
公投第１１案,宜蘭縣,冬山鄉,鹿埔村,321,1151,382,197,579,25,604
公投第１１案,宜蘭縣,冬山鄉,得安村,322,1094,351,151,502,40,542
公投第１１案,宜蘭縣,冬山鄉,廣興村,323,1247,443,224,667,39,706
公投第１１案,宜蘭縣,冬山鄉,廣興村,324,1247,410,186,596,33,629
公投第１１案,宜蘭縣,冬山鄉,廣安村,325,979,342,175,517,19,536
公投第１１案,宜蘭縣,冬山鄉,廣安村,326,698,286,117,403,20,423
公投第１１案,宜蘭縣,冬山鄉,柯林村,327,1726,581,311,892,26,918
公投第１１案,宜蘭縣,冬山鄉,大進村,328,782,228,124,352,20,372
公投第１１案,宜蘭縣,五結鄉,三興村,329,1076,359,164,523,37,560
公投第１１案,宜蘭縣,五結鄉,三興村,330,944,305,179,484,19,503
公投第１１案,宜蘭縣,五結鄉,二結村,331,836,348,128,476,17,493
公投第１１案,宜蘭縣,五結鄉,二結村,332,937,327,191,518,20,538
公投第１１案,宜蘭縣,五結鄉,鎮安村,333,1255,420,224,644,20,664
公投第１１案,宜蘭縣,五結鄉,鎮安村,334,1270,417,232,649,36,685
公投第１１案,宜蘭縣,五結鄉,上四村,335,801,269,121,390,26,416
公投第１１案,宜蘭縣,五結鄉,上四村,336,802,242,153,395,24,419
公投第１１案,宜蘭縣,五結鄉,中興村,337,1306,408,207,615,37,652
公投第１１案,宜蘭縣,五結鄉,四結村,338,1190,395,205,600,29,629
公投第１１案,宜蘭縣,五結鄉,四結村,339,1316,444,251,695,19,714
公投第１１案,宜蘭縣,五結鄉,福興村,340,965,364,166,530,21,551
公投第１１案,宜蘭縣,五結鄉,福興村,341,814,278,139,417,22,439
公投第１１案,宜蘭縣,五結鄉,五結村,342,1254,421,203,624,27,651
公投第１１案,宜蘭縣,五結鄉,五結村,343,1060,402,180,582,21,603
公投第１１案,宜蘭縣,五結鄉,五結村,344,1323,462,253,715,24,739
公投第１１案,宜蘭縣,五結鄉,協和村,345,1120,410,197,607,34,641
公投第１１案,宜蘭縣,五結鄉,協和村,346,893,315,152,467,14,481
公投第１１案,宜蘭縣,五結鄉,協和村,347,1220,361,238,599,46,645
公投第１１案,宜蘭縣,五結鄉,大吉村,348,924,353,171,524,13,537
公投第１１案,宜蘭縣,五結鄉,大吉村,349,933,367,174,541,26,567
公投第１１案,宜蘭縣,五結鄉,大吉村,350,986,361,147,508,20,528
公投第１１案,宜蘭縣,五結鄉,大吉村,351,748,260,124,384,24,408
公投第１１案,宜蘭縣,五結鄉,孝威村,352,1550,523,251,774,64,838
公投第１１案,宜蘭縣,五結鄉,錦眾村,353,629,238,105,343,21,364
公投第１１案,宜蘭縣,五結鄉,錦眾村,354,806,283,140,423,21,444
公投第１１案,宜蘭縣,五結鄉,利澤村,355,956,287,182,469,33,502
公投第１１案,宜蘭縣,五結鄉,利澤村,356,1066,378,157,535,33,568
公投第１１案,宜蘭縣,五結鄉,成興村,357,1513,468,226,694,57,751
公投第１１案,宜蘭縣,五結鄉,成興村,358,1566,521,268,789,41,830
公投第１１案,宜蘭縣,五結鄉,季新村,359,894,307,149,456,40,496
公投第１１案,宜蘭縣,五結鄉,季新村,360,1235,339,195,534,49,583
公投第１１案,宜蘭縣,五結鄉,季新村,361,704,244,120,364,32,396
公投第１１案,宜蘭縣,三星鄉,員山村,362,215,78,31,109,10,119
公投第１１案,宜蘭縣,三星鄉,天山村,363,523,169,54,223,18,241
公投第１１案,宜蘭縣,三星鄉,天福村,364,745,223,147,370,20,390
公投第１１案,宜蘭縣,三星鄉,萬德村,365,617,214,90,304,17,321
公投第１１案,宜蘭縣,三星鄉,貴林村,366,497,175,80,255,12,267
公投第１１案,宜蘭縣,三星鄉,萬富村,367,735,249,126,375,40,415
公投第１１案,宜蘭縣,三星鄉,雙賢村,368,583,215,85,300,27,327
公投第１１案,宜蘭縣,三星鄉,人和村,369,436,169,48,217,18,235
公投第１１案,宜蘭縣,三星鄉,義德村,370,1224,416,202,618,34,652
公投第１１案,宜蘭縣,三星鄉,集慶村,371,1151,381,173,554,28,582
公投第１１案,宜蘭縣,三星鄉,月眉村,372,870,306,151,457,22,479
公投第１１案,宜蘭縣,三星鄉,拱照村,373,1284,364,143,507,30,537
公投第１１案,宜蘭縣,三星鄉,行健村,374,897,325,168,493,40,533
公投第１１案,宜蘭縣,三星鄉,大隱村,375,1439,507,224,731,44,775
公投第１１案,宜蘭縣,三星鄉,大隱村,376,1445,453,251,704,34,738
公投第１１案,宜蘭縣,三星鄉,大隱村,377,1402,487,220,707,37,744
公投第１１案,宜蘭縣,三星鄉,大義村,378,1230,406,213,619,30,649
公投第１１案,宜蘭縣,三星鄉,尚武村,379,774,284,112,396,36,432
公投第１１案,宜蘭縣,三星鄉,大洲村,380,827,304,148,452,30,482
公投第１１案,宜蘭縣,三星鄉,大洲村,381,736,247,139,386,22,408
公投第１１案,宜蘭縣,三星鄉,尾塹村,382,1421,512,200,712,39,751
公投第１１案,宜蘭縣,大同鄉,寒溪村,383,893,442,110,552,28,580
公投第１１案,宜蘭縣,大同鄉,崙埤村,384,632,347,103,450,12,462
公投第１１案,宜蘭縣,大同鄉,松羅村,385,684,357,88,445,16,461
公投第１１案,宜蘭縣,大同鄉,復興村,386,264,117,49,166,11,177
公投第１１案,宜蘭縣,大同鄉,英士村,387,337,191,33,224,7,231
公投第１１案,宜蘭縣,大同鄉,樂水村,388,404,271,45,316,11,327
公投第１１案,宜蘭縣,大同鄉,太平村,389,55,16,8,24,3,27
公投第１１案,宜蘭縣,大同鄉,茂安村,390,199,110,36,146,10,156
公投第１１案,宜蘭縣,大同鄉,四季村,391,787,499,98,597,19,616
公投第１１案,宜蘭縣,大同鄉,南山村,392,680,422,77,499,21,520
公投第１１案,宜蘭縣,南澳鄉,東岳村,393,444,246,35,281,5,286
公投第１１案,宜蘭縣,南澳鄉,南澳村,394,1210,462,126,588,26,614
公投第１１案,宜蘭縣,南澳鄉,碧候村,395,962,503,99,602,39,641
公投第１１案,宜蘭縣,南澳鄉,金岳村,396,411,195,49,244,11,255
公投第１１案,宜蘭縣,南澳鄉,武塔村,397,447,237,64,301,14,315
公投第１１案,宜蘭縣,南澳鄉,金洋村,398,475,261,85,346,22,368
公投第１１案,宜蘭縣,南澳鄉,澳花村,399,695,295,93,388,27,415
公投第１１案,新竹縣,竹北市,鹿場里,1,1319,565,266,831,23,854
公投第１１案,新竹縣,竹北市,鹿場里,2,1321,522,265,787,18,805
公投第１１案,新竹縣,竹北市,鹿場里,3,1272,527,257,784,21,805
公投第１１案,新竹縣,竹北市,鹿場里,4,1467,536,289,825,25,850
公投第１１案,新竹縣,竹北市,鹿場里,5,1226,438,264,702,11,713
公投第１１案,新竹縣,竹北市,鹿場里,6,1412,527,275,802,11,813
公投第１１案,新竹縣,竹北市,鹿場里,7,1400,538,331,869,14,883
公投第１１案,新竹縣,竹北市,東平里,8,1415,530,319,849,29,878
公投第１１案,新竹縣,竹北市,東平里,9,1361,478,309,787,16,803
公投第１１案,新竹縣,竹北市,東平里,10,1515,483,346,829,8,837
公投第１１案,新竹縣,竹北市,東平里,11,1495,521,359,880,18,898
公投第１１案,新竹縣,竹北市,東平里,12,1417,502,329,831,9,840
公投第１１案,新竹縣,竹北市,東平里,13,1548,484,381,865,21,886
公投第１１案,新竹縣,竹北市,東平里,14,1434,438,346,784,12,796
公投第１１案,新竹縣,竹北市,中興里,15,1385,506,287,793,24,817
公投第１１案,新竹縣,竹北市,中興里,16,1247,494,282,776,18,794
公投第１１案,新竹縣,竹北市,中興里,17,1373,484,294,778,20,798
公投第１１案,新竹縣,竹北市,中興里,18,1345,512,336,848,12,860
公投第１１案,新竹縣,竹北市,中興里,19,1165,452,186,638,36,674
公投第１１案,新竹縣,竹北市,隘口里,20,1164,440,292,732,25,757
公投第１１案,新竹縣,竹北市,隘口里,21,1212,474,265,739,18,757
公投第１１案,新竹縣,竹北市,東海里,22,1507,516,222,738,24,762
公投第１１案,新竹縣,竹北市,東海里,23,1576,582,223,805,33,838
公投第１１案,新竹縣,竹北市,東興里,24,1464,516,293,809,21,830
公投第１１案,新竹縣,竹北市,東興里,25,1428,485,312,797,20,817
公投第１１案,新竹縣,竹北市,東興里,26,1442,370,349,719,12,731
公投第１１案,新竹縣,竹北市,東興里,27,1415,533,276,809,38,847
公投第１１案,新竹縣,竹北市,北興里,28,1666,522,322,844,13,857
公投第１１案,新竹縣,竹北市,北興里,29,1751,552,368,920,21,941
公投第１１案,新竹縣,竹北市,十興里,30,1196,456,271,727,16,743
公投第１１案,新竹縣,竹北市,十興里,31,1235,490,234,724,19,743
公投第１１案,新竹縣,竹北市,十興里,32,1204,448,228,676,10,686
公投第１１案,新竹縣,竹北市,十興里,33,1308,524,258,782,21,803
公投第１１案,新竹縣,竹北市,十興里,34,1233,446,256,702,16,718
公投第１１案,新竹縣,竹北市,興安里,35,1129,454,209,663,15,678
公投第１１案,新竹縣,竹北市,興安里,36,1069,440,207,647,15,662
公投第１１案,新竹縣,竹北市,興安里,37,1114,480,214,694,20,714
公投第１１案,新竹縣,竹北市,文化里,38,1103,438,235,673,18,691
公投第１１案,新竹縣,竹北市,文化里,39,1029,396,245,641,28,669
公投第１１案,新竹縣,竹北市,文化里,40,1133,473,238,711,19,730
公投第１１案,新竹縣,竹北市,斗崙里,41,1301,480,264,744,13,757
公投第１１案,新竹縣,竹北市,斗崙里,42,1798,629,388,1017,23,1040
公投第１１案,新竹縣,竹北市,斗崙里,43,1427,547,287,834,18,852
公投第１１案,新竹縣,竹北市,斗崙里,44,1462,629,268,897,19,916
公投第１１案,新竹縣,竹北市,中崙里,45,1342,553,273,826,27,853
公投第１１案,新竹縣,竹北市,中崙里,46,1480,565,321,886,11,897
公投第１１案,新竹縣,竹北市,中崙里,47,1645,585,328,913,18,931
公投第１１案,新竹縣,竹北市,中崙里,48,1256,525,268,793,14,807
公投第１１案,新竹縣,竹北市,北崙里,49,1181,457,245,702,22,724
公投第１１案,新竹縣,竹北市,北崙里,50,1329,553,283,836,25,861
公投第１１案,新竹縣,竹北市,北崙里,51,1228,540,237,777,17,794
公投第１１案,新竹縣,竹北市,新崙里,52,1552,540,305,845,31,876
公投第１１案,新竹縣,竹北市,新崙里,53,1480,582,286,868,27,895
公投第１１案,新竹縣,竹北市,新崙里,54,1487,527,286,813,17,830
公投第１１案,新竹縣,竹北市,新崙里,55,1470,505,275,780,29,809
公投第１１案,新竹縣,竹北市,竹北里,56,1477,544,224,768,22,790
公投第１１案,新竹縣,竹北市,竹北里,57,1611,635,319,954,33,987
公投第１１案,新竹縣,竹北市,竹北里,58,1555,607,269,876,35,911
公投第１１案,新竹縣,竹北市,竹北里,59,1468,511,258,769,33,802
公投第１１案,新竹縣,竹北市,竹仁里,60,1509,596,281,877,22,899
公投第１１案,新竹縣,竹北市,竹仁里,61,1602,588,273,861,29,890
公投第１１案,新竹縣,竹北市,竹仁里,62,1448,586,258,844,25,869
公投第１１案,新竹縣,竹北市,竹仁里,63,1318,538,244,782,17,799
公投第１１案,新竹縣,竹北市,竹仁里,64,1634,638,341,979,26,1005
公投第１１案,新竹縣,竹北市,竹仁里,65,1345,528,206,734,39,773
公投第１１案,新竹縣,竹北市,福德里,66,958,431,189,620,17,637
公投第１１案,新竹縣,竹北市,福德里,67,1112,473,205,678,27,705
公投第１１案,新竹縣,竹北市,福德里,68,1134,457,180,637,35,672
公投第１１案,新竹縣,竹北市,竹義里,69,1483,577,257,834,30,864
公投第１１案,新竹縣,竹北市,竹義里,70,1332,482,236,718,34,752
公投第１１案,新竹縣,竹北市,竹義里,71,1482,520,219,739,25,764
公投第１１案,新竹縣,竹北市,竹義里,72,1449,392,218,610,12,622
公投第１１案,新竹縣,竹北市,泰和里,73,1319,506,201,707,14,721
公投第１１案,新竹縣,竹北市,泰和里,74,1332,493,212,705,23,728
公投第１１案,新竹縣,竹北市,泰和里,75,1412,476,259,735,20,755
公投第１１案,新竹縣,竹北市,泰和里,76,1640,607,260,867,24,891
公投第１１案,新竹縣,竹北市,新社里,77,1323,491,244,735,28,763
公投第１１案,新竹縣,竹北市,新社里,78,1428,538,273,811,42,853
公投第１１案,新竹縣,竹北市,新社里,79,1533,593,277,870,29,899
公投第１１案,新竹縣,竹北市,新社里,80,1346,475,243,718,16,734
公投第１１案,新竹縣,竹北市,新社里,81,1219,467,168,635,34,669
公投第１１案,新竹縣,竹北市,新國里,82,1466,580,281,861,37,898
公投第１１案,新竹縣,竹北市,新國里,83,1147,388,219,607,26,633
公投第１１案,新竹縣,竹北市,新國里,84,1529,481,234,715,37,752
公投第１１案,新竹縣,竹北市,新國里,85,1522,587,258,845,36,881
公投第１１案,新竹縣,竹北市,聯興里,86,1383,552,241,793,38,831
公投第１１案,新竹縣,竹北市,聯興里,87,1569,586,295,881,35,916
公投第１１案,新竹縣,竹北市,聯興里,88,1506,551,245,796,20,816
公投第１１案,新竹縣,竹北市,麻園里,89,877,355,137,492,16,508
公投第１１案,新竹縣,竹北市,麻園里,90,1074,387,211,598,30,628
公投第１１案,新竹縣,竹北市,溪州里,91,1089,459,217,676,32,708
公投第１１案,新竹縣,竹北市,溪州里,92,1336,513,249,762,31,793
公投第１１案,新竹縣,竹北市,新庄里,93,1058,387,188,575,28,603
公投第１１案,新竹縣,竹北市,白地里,94,937,401,195,596,34,630
公投第１１案,新竹縣,竹北市,白地里,95,1206,461,204,665,25,690
公投第１１案,新竹縣,竹北市,新港里,96,1205,468,212,680,36,716
公投第１１案,新竹縣,竹北市,大眉里,97,1718,644,328,972,59,1031
公投第１１案,新竹縣,竹北市,大義里,98,917,352,148,500,27,527
公投第１１案,新竹縣,竹北市,大義里,99,668,257,132,389,13,402
公投第１１案,新竹縣,竹北市,尚義里,100,824,301,149,450,26,476
公投第１１案,新竹縣,竹北市,尚義里,101,782,312,105,417,51,468
公投第１１案,新竹縣,竹北市,崇義里,102,977,386,153,539,48,587
公投第１１案,新竹縣,竹北市,崇義里,103,937,344,143,487,21,508
公投第１１案,新竹縣,竹東鎮,上坪里,104,309,104,38,142,12,154
公投第１１案,新竹縣,竹東鎮,瑞峰里,105,416,139,59,198,20,218
公投第１１案,新竹縣,竹東鎮,軟橋里,106,386,132,66,198,6,204
公投第１１案,新竹縣,竹東鎮,員崠里,107,950,331,136,467,27,494
公投第１１案,新竹縣,竹東鎮,員崠里,108,1275,490,179,669,11,680
公投第１１案,新竹縣,竹東鎮,上舘里,109,1213,445,177,622,34,656
公投第１１案,新竹縣,竹東鎮,上舘里,110,1548,593,254,847,28,875
公投第１１案,新竹縣,竹東鎮,上舘里,111,1246,429,183,612,29,641
公投第１１案,新竹縣,竹東鎮,上舘里,112,1252,382,179,561,20,581
公投第１１案,新竹縣,竹東鎮,上舘里,113,1359,527,164,691,32,723
公投第１１案,新竹縣,竹東鎮,上舘里,114,1255,439,208,647,32,679
公投第１１案,新竹縣,竹東鎮,上舘里,115,1304,534,196,730,24,754
公投第１１案,新竹縣,竹東鎮,東寧里,116,1292,488,212,700,28,728
公投第１１案,新竹縣,竹東鎮,東寧里,117,1111,416,147,563,21,584
公投第１１案,新竹縣,竹東鎮,東寧里,118,880,345,146,491,39,530
公投第１１案,新竹縣,竹東鎮,中正里,119,670,273,104,377,17,394
公投第１１案,新竹縣,竹東鎮,中正里,120,1244,487,215,702,24,726
公投第１１案,新竹縣,竹東鎮,大鄉里,121,1126,419,149,568,42,610
公投第１１案,新竹縣,竹東鎮,大鄉里,122,1073,399,158,557,34,591
公投第１１案,新竹縣,竹東鎮,大鄉里,123,1215,475,199,674,23,697
公投第１１案,新竹縣,竹東鎮,大鄉里,124,1155,456,188,644,16,660
公投第１１案,新竹縣,竹東鎮,中山里,125,852,321,145,466,24,490
公投第１１案,新竹縣,竹東鎮,中山里,126,875,348,154,502,25,527
公投第１１案,新竹縣,竹東鎮,南華里,127,1070,452,178,630,23,653
公投第１１案,新竹縣,竹東鎮,東華里,128,704,265,101,366,23,389
公投第１１案,新竹縣,竹東鎮,商華里,129,951,271,94,365,17,382
公投第１１案,新竹縣,竹東鎮,商華里,130,984,379,178,557,14,571
公投第１１案,新竹縣,竹東鎮,商華里,131,1113,349,139,488,18,506
公投第１１案,新竹縣,竹東鎮,竹東里,132,595,259,83,342,14,356
公投第１１案,新竹縣,竹東鎮,竹東里,133,762,303,126,429,41,470
公投第１１案,新竹縣,竹東鎮,忠孝里,134,763,278,135,413,12,425
公投第１１案,新竹縣,竹東鎮,忠孝里,135,813,334,86,420,10,430
公投第１１案,新竹縣,竹東鎮,鷄林里,136,1310,455,152,607,31,638
公投第１１案,新竹縣,竹東鎮,鷄林里,137,1434,496,175,671,34,705
公投第１１案,新竹縣,竹東鎮,鷄林里,138,1131,434,188,622,23,645
公投第１１案,新竹縣,竹東鎮,仁愛里,139,967,359,154,513,19,532
公投第１１案,新竹縣,竹東鎮,仁愛里,140,1196,419,164,583,30,613
公投第１１案,新竹縣,竹東鎮,仁愛里,141,1154,444,189,633,23,656
公投第１１案,新竹縣,竹東鎮,榮樂里,142,715,282,134,416,24,440
公投第１１案,新竹縣,竹東鎮,榮樂里,143,685,274,120,394,17,411
公投第１１案,新竹縣,竹東鎮,榮華里,144,1352,486,206,692,26,718
公投第１１案,新竹縣,竹東鎮,榮華里,145,1407,557,215,772,33,805
公投第１１案,新竹縣,竹東鎮,榮華里,146,1362,553,181,734,19,753
公投第１１案,新竹縣,竹東鎮,榮華里,147,1330,526,214,740,31,771
公投第１１案,新竹縣,竹東鎮,榮華里,148,1441,521,226,747,33,780
公投第１１案,新竹縣,竹東鎮,五豐里,149,1248,424,215,639,15,654
公投第１１案,新竹縣,竹東鎮,五豐里,150,1263,378,186,564,9,573
公投第１１案,新竹縣,竹東鎮,五豐里,151,1232,424,180,604,18,622
公投第１１案,新竹縣,竹東鎮,五豐里,152,1143,367,155,522,19,541
公投第１１案,新竹縣,竹東鎮,五豐里,153,1529,572,248,820,24,844
公投第１１案,新竹縣,竹東鎮,五豐里,154,1140,414,183,597,32,629
公投第１１案,新竹縣,竹東鎮,陸豐里,155,570,249,91,340,25,365
公投第１１案,新竹縣,竹東鎮,三重里,156,1345,459,195,654,17,671
公投第１１案,新竹縣,竹東鎮,三重里,157,1381,455,253,708,33,741
公投第１１案,新竹縣,竹東鎮,三重里,158,1379,483,259,742,20,762
公投第１１案,新竹縣,竹東鎮,三重里,159,1033,401,176,577,25,602
公投第１１案,新竹縣,竹東鎮,三重里,160,1066,393,173,566,22,588
公投第１１案,新竹縣,竹東鎮,二重里,161,938,383,144,527,29,556
公投第１１案,新竹縣,竹東鎮,二重里,162,952,402,157,559,30,589
公投第１１案,新竹縣,竹東鎮,二重里,163,1468,564,284,848,27,875
公投第１１案,新竹縣,竹東鎮,二重里,164,1915,550,418,968,17,985
公投第１１案,新竹縣,竹東鎮,二重里,165,1220,444,177,621,26,647
公投第１１案,新竹縣,竹東鎮,二重里,166,1166,364,154,518,16,534
公投第１１案,新竹縣,竹東鎮,二重里,167,1492,500,211,711,22,733
公投第１１案,新竹縣,竹東鎮,二重里,168,1245,440,198,638,30,668
公投第１１案,新竹縣,竹東鎮,頭重里,169,1083,391,203,594,30,624
公投第１１案,新竹縣,竹東鎮,頭重里,170,1102,387,197,584,23,607
公投第１１案,新竹縣,竹東鎮,頭重里,171,1068,408,190,598,17,615
公投第１１案,新竹縣,竹東鎮,頭重里,172,1097,411,201,612,16,628
公投第１１案,新竹縣,竹東鎮,員山里,173,962,375,136,511,17,528
公投第１１案,新竹縣,竹東鎮,員山里,174,909,358,158,516,18,534
公投第１１案,新竹縣,竹東鎮,柯湖里,175,603,206,76,282,21,303
公投第１１案,新竹縣,新埔鎮,新埔里,176,983,410,151,561,28,589
公投第１１案,新竹縣,新埔鎮,新生里,177,597,227,115,342,27,369
公投第１１案,新竹縣,新埔鎮,新民里,178,1070,405,171,576,28,604
公投第１１案,新竹縣,新埔鎮,田新里,179,935,378,125,503,26,529
公投第１１案,新竹縣,新埔鎮,田新里,180,753,290,120,410,28,438
公投第１１案,新竹縣,新埔鎮,田新里,181,838,377,153,530,21,551
公投第１１案,新竹縣,新埔鎮,旱坑里,182,924,351,144,495,34,529
公投第１１案,新竹縣,新埔鎮,旱坑里,183,905,304,139,443,19,462
公投第１１案,新竹縣,新埔鎮,五埔里,184,948,395,124,519,20,539
公投第１１案,新竹縣,新埔鎮,五埔里,185,1017,403,148,551,41,592
公投第１１案,新竹縣,新埔鎮,四座里,186,1176,470,215,685,35,720
公投第１１案,新竹縣,新埔鎮,四座里,187,1122,478,187,665,33,698
公投第１１案,新竹縣,新埔鎮,四座里,188,1022,320,163,483,9,492
公投第１１案,新竹縣,新埔鎮,照門里,189,1429,456,223,679,34,713
公投第１１案,新竹縣,新埔鎮,清水里,190,451,201,74,275,30,305
公投第１１案,新竹縣,新埔鎮,鹿鳴里,191,724,262,134,396,18,414
公投第１１案,新竹縣,新埔鎮,新北里,192,617,263,103,366,29,395
公投第１１案,新竹縣,新埔鎮,巨埔里,193,1144,418,211,629,51,680
公投第１１案,新竹縣,新埔鎮,內立里,194,1139,435,185,620,39,659
公投第１１案,新竹縣,新埔鎮,寶石里,195,861,353,121,474,12,486
公投第１１案,新竹縣,新埔鎮,文山里,196,1093,370,167,537,25,562
公投第１１案,新竹縣,新埔鎮,文山里,197,978,341,135,476,28,504
公投第１１案,新竹縣,新埔鎮,文山里,198,1040,357,146,503,21,524
公投第１１案,新竹縣,新埔鎮,文山里,199,1160,422,173,595,26,621
公投第１１案,新竹縣,新埔鎮,上寮里,200,950,374,180,554,26,580
公投第１１案,新竹縣,新埔鎮,上寮里,201,882,353,121,474,25,499
公投第１１案,新竹縣,新埔鎮,下寮里,202,1281,479,222,701,38,739
公投第１１案,新竹縣,新埔鎮,下寮里,203,1212,396,214,610,40,650
公投第１１案,新竹縣,新埔鎮,南平里,204,1013,338,108,446,37,483
公投第１１案,新竹縣,新埔鎮,北平里,205,630,259,109,368,35,403
公投第１１案,新竹縣,關西鎮,東興里,206,480,234,65,299,9,308
公投第１１案,新竹縣,關西鎮,西安里,207,903,365,154,519,21,540
公投第１１案,新竹縣,關西鎮,西安里,208,1020,407,158,565,29,594
公投第１１案,新竹縣,關西鎮,南雄里,209,705,294,110,404,14,418
公投第１１案,新竹縣,關西鎮,北斗里,210,1056,403,154,557,26,583
公投第１１案,新竹縣,關西鎮,北斗里,211,1275,443,223,666,37,703
公投第１１案,新竹縣,關西鎮,北斗里,212,1287,497,223,720,40,760
公投第１１案,新竹縣,關西鎮,北山里,213,771,318,116,434,32,466
公投第１１案,新竹縣,關西鎮,仁安里,214,1046,378,151,529,41,570
公投第１１案,新竹縣,關西鎮,南山里,215,1030,428,139,567,38,605
公投第１１案,新竹縣,關西鎮,東安里,216,1208,463,203,666,26,692
公投第１１案,新竹縣,關西鎮,東安里,217,1095,384,156,540,9,549
公投第１１案,新竹縣,關西鎮,東安里,218,1350,457,220,677,38,715
公投第１１案,新竹縣,關西鎮,東山里,219,846,370,137,507,30,537
公投第１１案,新竹縣,關西鎮,東光里,220,1362,505,197,702,45,747
公投第１１案,新竹縣,關西鎮,南新里,221,903,348,111,459,20,479
公投第１１案,新竹縣,關西鎮,新富里,222,551,180,70,250,19,269
公投第１１案,新竹縣,關西鎮,玉山里,223,461,123,57,180,11,191
公投第１１案,新竹縣,關西鎮,金山里,224,572,231,66,297,22,319
公投第１１案,新竹縣,關西鎮,錦山里,225,943,356,129,485,26,511
公投第１１案,新竹縣,關西鎮,大同里,226,808,305,135,440,34,474
公投第１１案,新竹縣,關西鎮,石光里,227,923,411,150,561,23,584
公投第１１案,新竹縣,關西鎮,石光里,228,903,373,144,517,21,538
公投第１１案,新竹縣,關西鎮,東平里,229,977,391,140,531,40,571
公投第１１案,新竹縣,關西鎮,上林里,230,824,348,140,488,30,518
公投第１１案,新竹縣,關西鎮,新力里,231,559,250,98,348,14,362
公投第１１案,新竹縣,關西鎮,南和里,232,854,356,156,512,22,534
公投第１１案,新竹縣,湖口鄉,和興村,233,1393,440,237,677,40,717
公投第１１案,新竹縣,湖口鄉,和興村,234,1505,592,247,839,34,873
公投第１１案,新竹縣,湖口鄉,東興村,235,1188,512,234,746,18,764
公投第１１案,新竹縣,湖口鄉,東興村,236,1267,526,174,700,27,727
公投第１１案,新竹縣,湖口鄉,東興村,237,1668,658,266,924,33,957
公投第１１案,新竹縣,湖口鄉,德盛村,238,1719,650,302,952,46,998
公投第１１案,新竹縣,湖口鄉,德盛村,239,1162,501,191,692,34,726
公投第１１案,新竹縣,湖口鄉,德盛村,240,1833,611,278,889,51,940
公投第１１案,新竹縣,湖口鄉,愛勢村,241,1444,555,254,809,23,832
公投第１１案,新竹縣,湖口鄉,愛勢村,242,1347,566,222,788,47,835
公投第１１案,新竹縣,湖口鄉,愛勢村,243,1202,497,209,706,16,722
公投第１１案,新竹縣,湖口鄉,仁勢村,244,851,356,139,495,21,516
公投第１１案,新竹縣,湖口鄉,孝勢村,245,1272,505,233,738,33,771
公投第１１案,新竹縣,湖口鄉,中勢村,246,1275,514,193,707,26,733
公投第１１案,新竹縣,湖口鄉,中勢村,247,1560,751,94,845,34,879
公投第１１案,新竹縣,湖口鄉,中正村,248,1147,482,202,684,53,737
公投第１１案,新竹縣,湖口鄉,中正村,249,1729,689,240,929,32,961
公投第１１案,新竹縣,湖口鄉,信勢村,250,1402,513,217,730,26,756
公投第１１案,新竹縣,湖口鄉,信勢村,251,1183,453,228,681,24,705
公投第１１案,新竹縣,湖口鄉,信勢村,252,1282,538,201,739,33,772
公投第１１案,新竹縣,湖口鄉,信勢村,253,1335,520,255,775,27,802
公投第１１案,新竹縣,湖口鄉,信義村,254,1493,624,284,908,26,934
公投第１１案,新竹縣,湖口鄉,信義村,255,1877,708,344,1052,21,1073
公投第１１案,新竹縣,湖口鄉,波羅村,256,1082,466,170,636,35,671
公投第１１案,新竹縣,湖口鄉,波羅村,257,1115,466,187,653,34,687
公投第１１案,新竹縣,湖口鄉,長嶺村,258,1193,389,200,589,28,617
公投第１１案,新竹縣,湖口鄉,長嶺村,259,1947,710,299,1009,34,1043
公投第１１案,新竹縣,湖口鄉,長安村,260,1125,450,197,647,32,679
公投第１１案,新竹縣,湖口鄉,湖口村,261,1050,416,160,576,38,614
公投第１１案,新竹縣,湖口鄉,湖口村,262,1733,658,331,989,18,1007
公投第１１案,新竹縣,湖口鄉,湖鏡村,263,1284,491,234,725,33,758
公投第１１案,新竹縣,湖口鄉,湖鏡村,264,1062,450,161,611,21,632
公投第１１案,新竹縣,湖口鄉,湖南村,265,1547,579,236,815,53,868
公投第１１案,新竹縣,湖口鄉,中興村,266,1494,536,208,744,30,774
公投第１１案,新竹縣,湖口鄉,中興村,267,1634,554,217,771,21,792
公投第１１案,新竹縣,湖口鄉,中興村,268,1444,461,212,673,16,689
公投第１１案,新竹縣,湖口鄉,中興村,269,1324,472,208,680,19,699
公投第１１案,新竹縣,湖口鄉,鳳凰村,270,1058,409,165,574,27,601
公投第１１案,新竹縣,湖口鄉,鳳凰村,271,1220,334,175,509,20,529
公投第１１案,新竹縣,湖口鄉,鳳凰村,272,1333,488,235,723,26,749
公投第１１案,新竹縣,湖口鄉,鳳凰村,273,1461,509,216,725,42,767
公投第１１案,新竹縣,湖口鄉,勝利村,274,1429,550,230,780,20,800
公投第１１案,新竹縣,湖口鄉,勝利村,275,1506,487,215,702,14,716
公投第１１案,新竹縣,湖口鄉,勝利村,276,1103,458,174,632,38,670
公投第１１案,新竹縣,湖口鄉,鳳山村,277,1495,490,222,712,29,741
公投第１１案,新竹縣,湖口鄉,鳳山村,278,752,293,113,406,27,433
公投第１１案,新竹縣,湖口鄉,鳳山村,279,986,346,183,529,19,548
公投第１１案,新竹縣,新豐鄉,福興村,280,1080,383,167,550,29,579
公投第１１案,新竹縣,新豐鄉,青埔村,281,887,289,155,444,24,468
公投第１１案,新竹縣,新豐鄉,青埔村,282,954,350,161,511,27,538
公投第１１案,新竹縣,新豐鄉,中崙村,283,1003,403,146,549,29,578
公投第１１案,新竹縣,新豐鄉,中崙村,284,1106,402,184,586,18,604
公投第１１案,新竹縣,新豐鄉,中崙村,285,1123,439,192,631,24,655
公投第１１案,新竹縣,新豐鄉,瑞興村,286,891,318,158,476,40,516
公投第１１案,新竹縣,新豐鄉,瑞興村,287,874,278,136,414,26,440
公投第１１案,新竹縣,新豐鄉,後湖村,288,824,294,159,453,23,476
公投第１１案,新竹縣,新豐鄉,後湖村,289,975,338,125,463,26,489
公投第１１案,新竹縣,新豐鄉,坡頭村,290,847,325,154,479,30,509
公投第１１案,新竹縣,新豐鄉,埔和村,291,1477,550,232,782,52,834
公投第１１案,新竹縣,新豐鄉,埔和村,292,1266,409,221,630,41,671
公投第１１案,新竹縣,新豐鄉,新豐村,293,1029,380,137,517,44,561
公投第１１案,新竹縣,新豐鄉,新豐村,294,1063,392,152,544,31,575
公投第１１案,新竹縣,新豐鄉,員山村,295,1055,407,159,566,17,583
公投第１１案,新竹縣,新豐鄉,員山村,296,1445,560,231,791,19,810
公投第１１案,新竹縣,新豐鄉,忠孝村,297,1413,581,264,845,22,867
公投第１１案,新竹縣,新豐鄉,忠孝村,298,971,412,192,604,18,622
公投第１１案,新竹縣,新豐鄉,忠孝村,299,1135,444,204,648,24,672
公投第１１案,新竹縣,新豐鄉,山崎村,300,1269,463,194,657,26,683
公投第１１案,新竹縣,新豐鄉,山崎村,301,1257,482,207,689,23,712
公投第１１案,新竹縣,新豐鄉,山崎村,302,1662,653,285,938,30,968
公投第１１案,新竹縣,新豐鄉,上坑村,303,1486,543,224,767,22,789
公投第１１案,新竹縣,新豐鄉,鳳坑村,304,1067,447,187,634,37,671
公投第１１案,新竹縣,新豐鄉,重興村,305,1302,548,207,755,33,788
公投第１１案,新竹縣,新豐鄉,重興村,306,1410,548,215,763,26,789
公投第１１案,新竹縣,新豐鄉,重興村,307,1267,461,210,671,24,695
公投第１１案,新竹縣,新豐鄉,重興村,308,1258,423,178,601,28,629
公投第１１案,新竹縣,新豐鄉,崎頂村,309,1217,414,200,614,12,626
公投第１１案,新竹縣,新豐鄉,崎頂村,310,1456,578,202,780,24,804
公投第１１案,新竹縣,新豐鄉,松林村,311,1157,461,200,661,18,679
公投第１１案,新竹縣,新豐鄉,松林村,312,1089,405,151,556,24,580
公投第１１案,新竹縣,新豐鄉,松林村,313,1160,476,182,658,10,668
公投第１１案,新竹縣,新豐鄉,松林村,314,976,427,171,598,15,613
公投第１１案,新竹縣,新豐鄉,松柏村,315,1443,537,244,781,34,815
公投第１１案,新竹縣,新豐鄉,松柏村,316,1247,435,177,612,24,636
公投第１１案,新竹縣,新豐鄉,松柏村,317,1411,553,226,779,12,791
公投第１１案,新竹縣,新豐鄉,松柏村,318,1238,518,192,710,28,738
公投第１１案,新竹縣,芎林鄉,華龍村,319,417,162,78,240,6,246
公投第１１案,新竹縣,芎林鄉,五龍村,320,534,206,157,363,17,380
公投第１１案,新竹縣,芎林鄉,秀湖村,321,963,376,162,538,28,566
公投第１１案,新竹縣,芎林鄉,永興村,322,418,172,79,251,22,273
公投第１１案,新竹縣,芎林鄉,石潭村,323,1312,513,185,698,30,728
公投第１１案,新竹縣,芎林鄉,石潭村,324,1354,467,191,658,26,684
公投第１１案,新竹縣,芎林鄉,新鳳村,325,785,302,144,446,31,477
公投第１１案,新竹縣,芎林鄉,新鳳村,326,797,334,111,445,46,491
公投第１１案,新竹縣,芎林鄉,中坑村,327,623,269,115,384,17,401
公投第１１案,新竹縣,芎林鄉,水坑村,328,759,309,123,432,22,454
公投第１１案,新竹縣,芎林鄉,文林村,329,1272,417,199,616,34,650
公投第１１案,新竹縣,芎林鄉,文林村,330,1129,473,178,651,24,675
公投第１１案,新竹縣,芎林鄉,芎林村,331,713,293,126,419,25,444
公投第１１案,新竹縣,芎林鄉,芎林村,332,839,355,145,500,22,522
公投第１１案,新竹縣,芎林鄉,上山村,333,1123,537,182,719,24,743
公投第１１案,新竹縣,芎林鄉,上山村,334,981,404,171,575,18,593
公投第１１案,新竹縣,芎林鄉,上山村,335,1078,397,223,620,37,657
公投第１１案,新竹縣,芎林鄉,上山村,336,1094,382,191,573,23,596
公投第１１案,新竹縣,芎林鄉,下山村,337,1102,432,183,615,41,656
公投第１１案,新竹縣,橫山鄉,橫山村,338,1231,490,208,698,53,751
公投第１１案,新竹縣,橫山鄉,橫山村,339,1041,466,100,566,43,609
公投第１１案,新竹縣,橫山鄉,橫山村,340,1132,472,187,659,27,686
公投第１１案,新竹縣,橫山鄉,田寮村,341,859,364,150,514,25,539
公投第１１案,新竹縣,橫山鄉,南昌村,342,204,74,32,106,15,121
公投第１１案,新竹縣,橫山鄉,豐鄉村,343,222,73,25,98,4,102
公投第１１案,新竹縣,橫山鄉,豐田村,344,338,128,67,195,24,219
公投第１１案,新竹縣,橫山鄉,內灣村,345,916,339,131,470,25,495
公投第１１案,新竹縣,橫山鄉,力行村,346,573,178,53,231,11,242
公投第１１案,新竹縣,橫山鄉,力行村,347,275,117,64,181,9,190
公投第１１案,新竹縣,橫山鄉,福興村,348,463,160,53,213,16,229
公投第１１案,新竹縣,橫山鄉,沙坑村,349,690,293,110,403,37,440
公投第１１案,新竹縣,橫山鄉,沙坑村,350,288,107,36,143,8,151
公投第１１案,新竹縣,橫山鄉,新興村,351,685,301,109,410,32,442
公投第１１案,新竹縣,橫山鄉,新興村,352,868,361,143,504,33,537
公投第１１案,新竹縣,橫山鄉,大肚村,353,1561,666,239,905,64,969
公投第１１案,新竹縣,北埔鄉,北埔村,354,1158,404,183,587,18,605
公投第１１案,新竹縣,北埔鄉,南興村,355,1238,464,225,689,54,743
公投第１１案,新竹縣,北埔鄉,大湖村,356,580,226,102,328,14,342
公投第１１案,新竹縣,北埔鄉,埔尾村,357,931,372,153,525,24,549
公投第１１案,新竹縣,北埔鄉,埔尾村,358,1653,639,248,887,49,936
公投第１１案,新竹縣,北埔鄉,水磜村,359,845,327,131,458,26,484
公投第１１案,新竹縣,北埔鄉,南埔村,360,384,170,48,218,5,223
公投第１１案,新竹縣,北埔鄉,大林村,361,763,297,121,418,12,430
公投第１１案,新竹縣,北埔鄉,南坑村,362,333,109,65,174,11,185
公投第１１案,新竹縣,北埔鄉,外坪村,363,295,124,32,156,5,161
公投第１１案,新竹縣,寶山鄉,雙溪村,364,1158,416,214,630,44,674
公投第１１案,新竹縣,寶山鄉,雙溪村,365,1437,501,300,801,18,819
公投第１１案,新竹縣,寶山鄉,雙新村,366,1470,546,258,804,31,835
公投第１１案,新竹縣,寶山鄉,雙新村,367,1170,445,230,675,37,712
公投第１１案,新竹縣,寶山鄉,大崎村,368,1900,715,305,1020,84,1104
公投第１１案,新竹縣,寶山鄉,三峰村,369,1056,358,167,525,19,544
公投第１１案,新竹縣,寶山鄉,新城村,370,1205,501,207,708,50,758
公投第１１案,新竹縣,寶山鄉,寶斗村,371,766,312,92,404,33,437
公投第１１案,新竹縣,寶山鄉,深井村,372,846,345,139,484,35,519
公投第１１案,新竹縣,寶山鄉,寶山村,373,804,317,146,463,29,492
公投第１１案,新竹縣,寶山鄉,油田村,374,607,248,110,358,13,371
公投第１１案,新竹縣,寶山鄉,山湖村,375,554,225,124,349,15,364
公投第１１案,新竹縣,峨眉鄉,峨眉村,376,879,394,138,532,44,576
公投第１１案,新竹縣,峨眉鄉,中盛村,377,683,283,116,399,34,433
公投第１１案,新竹縣,峨眉鄉,石井村,378,604,251,91,342,25,367
公投第１１案,新竹縣,峨眉鄉,七星村,379,339,137,47,184,15,199
公投第１１案,新竹縣,峨眉鄉,七星村,380,276,90,29,119,6,125
公投第１１案,新竹縣,峨眉鄉,富興村,381,1406,593,214,807,51,858
公投第１１案,新竹縣,峨眉鄉,湖光村,382,462,211,58,269,20,289
公投第１１案,新竹縣,峨眉鄉,湖光村,383,419,139,76,215,13,228
公投第１１案,新竹縣,尖石鄉,嘉樂村,384,474,180,56,236,5,241
公投第１１案,新竹縣,尖石鄉,嘉樂村,385,357,153,49,202,7,209
公投第１１案,新竹縣,尖石鄉,義興村,386,225,75,24,99,12,111
公投第１１案,新竹縣,尖石鄉,義興村,387,374,176,48,224,5,229
公投第１１案,新竹縣,尖石鄉,新樂村,388,773,329,93,422,17,439
公投第１１案,新竹縣,尖石鄉,新樂村,389,490,295,45,340,13,353
公投第１１案,新竹縣,尖石鄉,錦屏村,390,531,206,61,267,5,272
公投第１１案,新竹縣,尖石鄉,錦屏村,391,660,321,74,395,13,408
公投第１１案,新竹縣,尖石鄉,梅花村,392,613,332,82,414,17,431
公投第１１案,新竹縣,尖石鄉,玉峰村,393,593,215,107,322,5,327
公投第１１案,新竹縣,尖石鄉,玉峰村,394,575,242,83,325,14,339
公投第１１案,新竹縣,尖石鄉,玉峰村,395,126,61,20,81,3,84
公投第１１案,新竹縣,尖石鄉,秀巒村,396,499,237,41,278,4,282
公投第１１案,新竹縣,尖石鄉,秀巒村,397,785,255,95,350,17,367
公投第１１案,新竹縣,尖石鄉,秀巒村,398,289,129,60,189,13,202
公投第１１案,新竹縣,五峰鄉,大隘村,399,672,331,83,414,14,428
公投第１１案,新竹縣,五峰鄉,大隘村,400,713,247,99,346,17,363
公投第１１案,新竹縣,五峰鄉,桃山村,401,594,197,73,270,2,272
公投第１１案,新竹縣,五峰鄉,桃山村,402,896,337,113,450,28,478
公投第１１案,新竹縣,五峰鄉,花園村,403,727,308,96,404,8,412
公投第１１案,新竹縣,五峰鄉,竹林村,404,395,164,68,232,5,237
公投第１１案,苗栗縣,苗栗市,中苗里,1,1087,435,166,601,29,630
公投第１１案,苗栗縣,苗栗市,青苗里,2,1018,386,160,546,23,569
公投第１１案,苗栗縣,苗栗市,維祥里,3,1156,452,170,622,19,641
公投第１１案,苗栗縣,苗栗市,維祥里,4,1118,444,155,599,31,630
公投第１１案,苗栗縣,苗栗市,維祥里,5,1084,416,178,594,43,637
公投第１１案,苗栗縣,苗栗市,維新里,6,1203,485,199,684,37,721
公投第１１案,苗栗縣,苗栗市,維新里,7,1306,545,191,736,46,782
公投第１１案,苗栗縣,苗栗市,維新里,8,1193,486,185,671,39,710
公投第１１案,苗栗縣,苗栗市,玉清里,9,1115,443,183,626,33,659
公投第１１案,苗栗縣,苗栗市,玉清里,10,1119,475,177,652,36,688
公投第１１案,苗栗縣,苗栗市,玉華里,11,1132,473,201,674,22,696
公投第１１案,苗栗縣,苗栗市,玉華里,12,1289,529,189,718,29,747
公投第１１案,苗栗縣,苗栗市,玉華里,13,1264,506,221,727,31,758
公投第１１案,苗栗縣,苗栗市,綠苗里,14,870,366,108,474,20,494
公投第１１案,苗栗縣,苗栗市,高苗里,15,1008,337,133,470,44,514
公投第１１案,苗栗縣,苗栗市,高苗里,16,1078,379,156,535,37,572
公投第１１案,苗栗縣,苗栗市,高苗里,17,1077,447,179,626,29,655
公投第１１案,苗栗縣,苗栗市,新苗里,18,880,360,145,505,15,520
公投第１１案,苗栗縣,苗栗市,玉苗里,19,894,339,124,463,40,503
公投第１１案,苗栗縣,苗栗市,大同里,20,522,216,69,285,20,305
公投第１１案,苗栗縣,苗栗市,恭敬里,21,1376,549,273,822,51,873
公投第１１案,苗栗縣,苗栗市,水源里,22,1391,521,216,737,32,769
公投第１１案,苗栗縣,苗栗市,水源里,23,1081,446,172,618,35,653
公投第１１案,苗栗縣,苗栗市,勝利里,24,1272,474,206,680,31,711
公投第１１案,苗栗縣,苗栗市,勝利里,25,1112,478,189,667,38,705
公投第１１案,苗栗縣,苗栗市,勝利里,26,813,379,149,528,19,547
公投第１１案,苗栗縣,苗栗市,勝利里,27,767,297,124,421,17,438
公投第１１案,苗栗縣,苗栗市,清華里,28,1010,382,179,561,19,580
公投第１１案,苗栗縣,苗栗市,清華里,29,1182,462,181,643,25,668
公投第１１案,苗栗縣,苗栗市,清華里,30,965,386,152,538,18,556
公投第１１案,苗栗縣,苗栗市,上苗里,31,607,238,114,352,13,365
公投第１１案,苗栗縣,苗栗市,上苗里,32,990,410,181,591,24,615
公投第１１案,苗栗縣,苗栗市,北苗里,33,1230,425,165,590,79,669
公投第１１案,苗栗縣,苗栗市,北苗里,34,1372,544,219,763,33,796
公投第１１案,苗栗縣,苗栗市,北苗里,35,1213,474,212,686,26,712
公投第１１案,苗栗縣,苗栗市,北苗里,36,1272,491,208,699,26,725
公投第１１案,苗栗縣,苗栗市,嘉盛里,37,1221,562,170,732,18,750
公投第１１案,苗栗縣,苗栗市,嘉盛里,38,1104,419,191,610,38,648
公投第１１案,苗栗縣,苗栗市,嘉盛里,39,1171,438,181,619,10,629
公投第１１案,苗栗縣,苗栗市,福星里,40,1392,530,207,737,45,782
公投第１１案,苗栗縣,苗栗市,福星里,41,1356,550,221,771,25,796
公投第１１案,苗栗縣,苗栗市,福星里,42,1387,543,237,780,27,807
公投第１１案,苗栗縣,苗栗市,福安里,43,1206,451,199,650,25,675
公投第１１案,苗栗縣,苗栗市,福安里,44,1004,439,179,618,23,641
公投第１１案,苗栗縣,苗栗市,福安里,45,1202,462,197,659,19,678
公投第１１案,苗栗縣,苗栗市,嘉新里,46,1052,430,183,613,28,641
公投第１１案,苗栗縣,苗栗市,嘉新里,47,873,385,133,518,21,539
公投第１１案,苗栗縣,苗栗市,嘉新里,48,975,448,166,614,39,653
公投第１１案,苗栗縣,苗栗市,建功里,49,1003,447,148,595,48,643
公投第１１案,苗栗縣,苗栗市,建功里,50,1000,389,103,492,17,509
公投第１１案,苗栗縣,苗栗市,建功里,51,1047,393,176,569,22,591
公投第１１案,苗栗縣,苗栗市,建功里,52,1025,428,173,601,28,629
公投第１１案,苗栗縣,苗栗市,福麗里,53,1130,429,166,595,15,610
公投第１１案,苗栗縣,苗栗市,福麗里,54,1146,429,204,633,20,653
公投第１１案,苗栗縣,苗栗市,福麗里,55,1432,561,241,802,33,835
公投第１１案,苗栗縣,苗栗市,福麗里,56,1492,514,176,690,22,712
公投第１１案,苗栗縣,苗栗市,文山里,57,1125,477,196,673,18,691
公投第１１案,苗栗縣,苗栗市,文山里,58,1241,476,201,677,18,695
公投第１１案,苗栗縣,苗栗市,文山里,59,1278,517,228,745,24,769
公投第１１案,苗栗縣,苗栗市,文聖里,60,1293,528,178,706,20,726
公投第１１案,苗栗縣,苗栗市,文聖里,61,1342,470,222,692,23,715
公投第１１案,苗栗縣,苗栗市,文聖里,62,857,311,138,449,26,475
公投第１１案,苗栗縣,苗栗市,新川里,63,1180,454,158,612,35,647
公投第１１案,苗栗縣,苗栗市,南勢里,64,1072,426,195,621,15,636
公投第１１案,苗栗縣,苗栗市,南勢里,65,912,358,129,487,19,506
公投第１１案,苗栗縣,苗栗市,新英里,66,796,295,112,407,19,426
公投第１１案,苗栗縣,苗栗市,新英里,67,869,277,148,425,15,440
公投第１１案,苗栗縣,公館鄉,館中村,68,789,337,148,485,38,523
公投第１１案,苗栗縣,公館鄉,館中村,69,792,347,162,509,16,525
公投第１１案,苗栗縣,公館鄉,館東村,70,1117,472,188,660,59,719
公投第１１案,苗栗縣,公館鄉,館東村,71,1255,518,233,751,40,791
公投第１１案,苗栗縣,公館鄉,館南村,72,1141,448,191,639,43,682
公投第１１案,苗栗縣,公館鄉,館南村,73,1172,427,240,667,20,687
公投第１１案,苗栗縣,公館鄉,館南村,74,1100,455,216,671,26,697
公投第１１案,苗栗縣,公館鄉,中義村,75,1232,423,191,614,37,651
公投第１１案,苗栗縣,公館鄉,中義村,76,1081,390,138,528,45,573
公投第１１案,苗栗縣,公館鄉,玉泉村,77,1250,539,176,715,63,778
公投第１１案,苗栗縣,公館鄉,玉泉村,78,1081,408,177,585,46,631
公投第１１案,苗栗縣,公館鄉,大坑村,79,964,338,167,505,48,553
公投第１１案,苗栗縣,公館鄉,福基村,80,1038,410,168,578,56,634
公投第１１案,苗栗縣,公館鄉,福德村,81,360,146,67,213,14,227
公投第１１案,苗栗縣,公館鄉,福星村,82,865,325,138,463,35,498
公投第１１案,苗栗縣,公館鄉,福星村,83,1166,390,213,603,49,652
公投第１１案,苗栗縣,公館鄉,石墻村,84,719,301,114,415,16,431
公投第１１案,苗栗縣,公館鄉,石墻村,85,788,271,127,398,37,435
公投第１１案,苗栗縣,公館鄉,開礦村,86,303,116,65,181,21,202
公投第１１案,苗栗縣,公館鄉,五谷村,87,1322,525,263,788,8,796
公投第１１案,苗栗縣,公館鄉,五谷村,88,933,341,145,486,49,535
公投第１１案,苗栗縣,公館鄉,玉谷村,89,1455,513,223,736,54,790
公投第１１案,苗栗縣,公館鄉,鶴岡村,90,1615,641,292,933,66,999
公投第１１案,苗栗縣,公館鄉,鶴山村,91,1451,545,197,742,58,800
公投第１１案,苗栗縣,公館鄉,尖山村,92,1462,555,265,820,62,882
公投第１１案,苗栗縣,公館鄉,仁安村,93,1317,452,217,669,68,737
公投第１１案,苗栗縣,公館鄉,南河村,94,221,84,42,126,6,132
公投第１１案,苗栗縣,公館鄉,北河村,95,329,125,41,166,9,175
公投第１１案,苗栗縣,頭屋鄉,頭屋村,96,1335,638,205,843,52,895
公投第１１案,苗栗縣,頭屋鄉,頭屋村,97,1168,560,206,766,63,829
公投第１１案,苗栗縣,頭屋鄉,獅潭村,98,792,360,134,494,25,519
公投第１１案,苗栗縣,頭屋鄉,獅潭村,99,918,433,201,634,24,658
公投第１１案,苗栗縣,頭屋鄉,北坑村,100,725,333,104,437,28,465
公投第１１案,苗栗縣,頭屋鄉,曲洞村,101,899,381,151,532,23,555
公投第１１案,苗栗縣,頭屋鄉,飛鳳村,102,369,140,38,178,5,183
公投第１１案,苗栗縣,頭屋鄉,象山村,103,844,334,151,485,19,504
公投第１１案,苗栗縣,頭屋鄉,象山村,104,1007,388,189,577,31,608
公投第１１案,苗栗縣,頭屋鄉,明德村,105,794,440,41,481,22,503
公投第１１案,苗栗縣,頭屋鄉,明德村,106,211,104,40,144,13,157
公投第１１案,苗栗縣,頭屋鄉,鳴鳳村,107,328,157,62,219,20,239
公投第１１案,苗栗縣,銅鑼鄉,銅鑼村,108,887,373,144,517,31,548
公投第１１案,苗栗縣,銅鑼鄉,銅鑼村,109,1052,423,171,594,37,631
公投第１１案,苗栗縣,銅鑼鄉,銅鑼村,110,1347,588,201,789,34,823
公投第１１案,苗栗縣,銅鑼鄉,銅鑼村,111,1177,445,193,638,35,673
公投第１１案,苗栗縣,銅鑼鄉,樟樹村,112,1268,444,204,648,35,683
公投第１１案,苗栗縣,銅鑼鄉,九湖村,113,1185,358,188,546,36,582
公投第１１案,苗栗縣,銅鑼鄉,福興村,114,1029,413,142,555,45,600
公投第１１案,苗栗縣,銅鑼鄉,朝陽村,115,905,375,120,495,30,525
公投第１１案,苗栗縣,銅鑼鄉,朝陽村,116,750,316,127,443,25,468
公投第１１案,苗栗縣,銅鑼鄉,竹森村,117,1080,393,136,529,30,559
公投第１１案,苗栗縣,銅鑼鄉,中平村,118,1108,377,173,550,56,606
公投第１１案,苗栗縣,銅鑼鄉,中平村,119,862,292,140,432,25,457
公投第１１案,苗栗縣,銅鑼鄉,中平村,120,1216,403,202,605,43,648
公投第１１案,苗栗縣,銅鑼鄉,興隆村,121,588,204,74,278,25,303
公投第１１案,苗栗縣,銅鑼鄉,盛隆村,122,429,137,63,200,35,235
公投第１１案,苗栗縣,銅鑼鄉,新隆村,123,541,208,85,293,24,317
公投第１１案,苗栗縣,三義鄉,廣盛村,124,853,353,131,484,40,524
公投第１１案,苗栗縣,三義鄉,廣盛村,125,983,460,131,591,21,612
公投第１１案,苗栗縣,三義鄉,廣盛村,126,1080,419,188,607,41,648
公投第１１案,苗栗縣,三義鄉,廣盛村,127,1216,456,175,631,18,649
公投第１１案,苗栗縣,三義鄉,勝興村,128,1017,407,165,572,33,605
公投第１１案,苗栗縣,三義鄉,勝興村,129,1180,454,158,612,20,632
公投第１１案,苗栗縣,三義鄉,勝興村,130,1198,503,162,665,19,684
公投第１１案,苗栗縣,三義鄉,龍騰村,131,417,160,64,224,16,240
公投第１１案,苗栗縣,三義鄉,双湖村,132,991,362,145,507,18,525
公投第１１案,苗栗縣,三義鄉,双湖村,133,834,349,124,473,19,492
公投第１１案,苗栗縣,三義鄉,双潭村,134,622,238,111,349,18,367
公投第１１案,苗栗縣,三義鄉,双潭村,135,749,279,135,414,47,461
公投第１１案,苗栗縣,三義鄉,西湖村,136,692,314,110,424,36,460
公投第１１案,苗栗縣,三義鄉,西湖村,137,759,368,140,508,27,535
公投第１１案,苗栗縣,三義鄉,鯉魚潭村,138,629,209,105,314,22,336
公投第１１案,苗栗縣,三義鄉,鯉魚潭村,139,669,223,139,362,23,385
公投第１１案,苗栗縣,西湖鄉,高埔村,140,601,227,91,318,22,340
公投第１１案,苗栗縣,西湖鄉,下埔村,141,566,224,98,322,19,341
公投第１１案,苗栗縣,西湖鄉,五湖村,142,843,325,130,455,36,491
公投第１１案,苗栗縣,西湖鄉,四湖村,143,648,220,103,323,21,344
公投第１１案,苗栗縣,西湖鄉,三湖村,144,936,306,145,451,24,475
公投第１１案,苗栗縣,西湖鄉,龍洞村,145,461,153,77,230,18,248
公投第１１案,苗栗縣,西湖鄉,金獅村,146,515,193,86,279,19,298
公投第１１案,苗栗縣,西湖鄉,湖東村,147,1141,431,146,577,38,615
公投第１１案,苗栗縣,西湖鄉,二湖村,148,671,262,107,369,27,396
公投第１１案,苗栗縣,通霄鎮,通東里,149,1142,401,222,623,49,672
公投第１１案,苗栗縣,通霄鎮,通西里,150,884,370,168,538,39,577
公投第１１案,苗栗縣,通霄鎮,通西里,151,1068,416,150,566,40,606
公投第１１案,苗栗縣,通霄鎮,平元里,152,1009,443,177,620,31,651
公投第１１案,苗栗縣,通霄鎮,平元里,153,859,397,151,548,15,563
公投第１１案,苗栗縣,通霄鎮,平安里,154,1040,397,190,587,22,609
公投第１１案,苗栗縣,通霄鎮,平安里,155,1008,341,138,479,18,497
公投第１１案,苗栗縣,通霄鎮,圳頭里,156,686,273,104,377,31,408
公投第１１案,苗栗縣,通霄鎮,梅南里,157,761,363,137,500,20,520
公投第１１案,苗栗縣,通霄鎮,梅南里,158,790,299,106,405,12,417
公投第１１案,苗栗縣,通霄鎮,通南里,159,966,359,151,510,24,534
公投第１１案,苗栗縣,通霄鎮,通南里,160,972,353,118,471,34,505
公投第１１案,苗栗縣,通霄鎮,通南里,161,771,311,108,419,25,444
公投第１１案,苗栗縣,通霄鎮,內湖里,162,758,222,117,339,27,366
公投第１１案,苗栗縣,通霄鎮,內湖里,163,1078,374,183,557,28,585
公投第１１案,苗栗縣,通霄鎮,楓樹里,164,459,124,54,178,21,199
公投第１１案,苗栗縣,通霄鎮,烏眉里,165,894,301,118,419,30,449
公投第１１案,苗栗縣,通霄鎮,福龍里,166,402,99,49,148,11,159
公投第１１案,苗栗縣,通霄鎮,福源里,167,802,290,122,412,22,434
公投第１１案,苗栗縣,通霄鎮,城北里,168,684,225,118,343,17,360
公投第１１案,苗栗縣,通霄鎮,城南里,169,943,296,120,416,29,445
公投第１１案,苗栗縣,通霄鎮,南和里,170,790,313,132,445,35,480
公投第１１案,苗栗縣,通霄鎮,福興里,171,673,212,76,288,8,296
公投第１１案,苗栗縣,通霄鎮,坪頂里,172,1232,440,163,603,49,652
公投第１１案,苗栗縣,通霄鎮,五南里,173,1286,501,200,701,57,758
公投第１１案,苗栗縣,通霄鎮,五北里,174,649,255,108,363,25,388
公投第１１案,苗栗縣,通霄鎮,五北里,175,769,239,121,360,28,388
公投第１１案,苗栗縣,通霄鎮,通灣里,176,1148,389,197,586,60,646
公投第１１案,苗栗縣,通霄鎮,通灣里,177,1138,355,174,529,46,575
公投第１１案,苗栗縣,通霄鎮,新埔里,178,1121,383,159,542,49,591
公投第１１案,苗栗縣,通霄鎮,內島里,179,769,262,144,406,21,427
公投第１１案,苗栗縣,通霄鎮,白東里,180,616,199,100,299,12,311
公投第１１案,苗栗縣,通霄鎮,白東里,181,799,269,132,401,39,440
公投第１１案,苗栗縣,通霄鎮,白西里,182,743,247,118,365,21,386
公投第１１案,苗栗縣,苑裡鎮,苑東里,183,873,344,151,495,29,524
公投第１１案,苗栗縣,苑裡鎮,苑東里,184,1346,535,218,753,27,780
公投第１１案,苗栗縣,苑裡鎮,苑南里,185,951,415,182,597,35,632
公投第１１案,苗栗縣,苑裡鎮,苑南里,186,615,261,75,336,20,356
公投第１１案,苗栗縣,苑裡鎮,苑北里,187,878,382,135,517,33,550
公投第１１案,苗栗縣,苑裡鎮,西平里,188,767,313,143,456,19,475
公投第１１案,苗栗縣,苑裡鎮,西平里,189,776,309,110,419,29,448
公投第１１案,苗栗縣,苑裡鎮,苑港里,190,1231,446,177,623,48,671
公投第１１案,苗栗縣,苑裡鎮,西勢里,191,1145,452,209,661,29,690
公投第１１案,苗栗縣,苑裡鎮,西勢里,192,850,321,135,456,25,481
公投第１１案,苗栗縣,苑裡鎮,海岸里,193,1052,384,162,546,41,587
公投第１１案,苗栗縣,苑裡鎮,房裡里,194,1114,418,187,605,34,639
公投第１１案,苗栗縣,苑裡鎮,房裡里,195,1136,416,216,632,45,677
公投第１１案,苗栗縣,苑裡鎮,客庄里,196,1194,449,193,642,37,679
公投第１１案,苗栗縣,苑裡鎮,客庄里,197,1579,623,247,870,36,906
公投第１１案,苗栗縣,苑裡鎮,客庄里,198,1149,459,219,678,35,713
公投第１１案,苗栗縣,苑裡鎮,中正里,199,1057,395,209,604,39,643
公投第１１案,苗栗縣,苑裡鎮,中正里,200,1101,378,164,542,24,566
公投第１１案,苗栗縣,苑裡鎮,苑坑里,201,912,282,145,427,29,456
公投第１１案,苗栗縣,苑裡鎮,水坡里,202,652,228,107,335,33,368
公投第１１案,苗栗縣,苑裡鎮,新復里,203,1348,497,225,722,58,780
公投第１１案,苗栗縣,苑裡鎮,山脚里,204,733,254,114,368,16,384
公投第１１案,苗栗縣,苑裡鎮,山脚里,205,662,235,95,330,14,344
公投第１１案,苗栗縣,苑裡鎮,舊社里,206,893,331,159,490,30,520
公投第１１案,苗栗縣,苑裡鎮,舊社里,207,910,371,147,518,31,549
公投第１１案,苗栗縣,苑裡鎮,福田里,208,1270,448,211,659,48,707
公投第１１案,苗栗縣,苑裡鎮,石鎮里,209,545,185,85,270,22,292
公投第１１案,苗栗縣,苑裡鎮,蕉埔里,210,792,358,110,468,35,503
公投第１１案,苗栗縣,苑裡鎮,南勢里,211,726,266,131,397,20,417
公投第１１案,苗栗縣,苑裡鎮,泰田里,212,827,251,109,360,10,370
公投第１１案,苗栗縣,苑裡鎮,泰田里,213,782,311,128,439,31,470
公投第１１案,苗栗縣,苑裡鎮,上舘里,214,788,291,115,406,29,435
公投第１１案,苗栗縣,苑裡鎮,上舘里,215,846,276,155,431,35,466
公投第１１案,苗栗縣,苑裡鎮,玉田里,216,828,322,145,467,38,505
公投第１１案,苗栗縣,苑裡鎮,玉田里,217,943,362,149,511,39,550
公投第１１案,苗栗縣,苑裡鎮,社苓里,218,1082,426,191,617,24,641
公投第１１案,苗栗縣,苑裡鎮,社苓里,219,1234,488,220,708,41,749
公投第１１案,苗栗縣,苑裡鎮,山柑里,220,1434,511,228,739,48,787
公投第１１案,苗栗縣,苑裡鎮,田心里,221,987,396,146,542,29,571
公投第１１案,苗栗縣,苑裡鎮,田心里,222,882,357,176,533,31,564
公投第１１案,苗栗縣,後龍鎮,南龍里,223,590,208,106,314,31,345
公投第１１案,苗栗縣,後龍鎮,南龍里,224,883,349,175,524,43,567
公投第１１案,苗栗縣,後龍鎮,中龍里,225,793,301,165,466,30,496
公投第１１案,苗栗縣,後龍鎮,北龍里,226,732,292,135,427,15,442
公投第１１案,苗栗縣,後龍鎮,北龍里,227,592,233,115,348,16,364
公投第１１案,苗栗縣,後龍鎮,大庄里,228,1113,411,222,633,33,666
公投第１１案,苗栗縣,後龍鎮,大庄里,229,1195,429,219,648,29,677
公投第１１案,苗栗縣,後龍鎮,大庄里,230,997,418,180,598,31,629
公投第１１案,苗栗縣,後龍鎮,大庄里,231,913,300,151,451,15,466
公投第１１案,苗栗縣,後龍鎮,東明里,232,641,196,112,308,30,338
公投第１１案,苗栗縣,後龍鎮,東明里,233,848,272,151,423,28,451
公投第１１案,苗栗縣,後龍鎮,灣寶里,234,1264,447,199,646,58,704
公投第１１案,苗栗縣,後龍鎮,海寶里,235,965,311,151,462,40,502
公投第１１案,苗栗縣,後龍鎮,豐富里,236,1216,589,207,796,56,852
公投第１１案,苗栗縣,後龍鎮,校椅里,237,977,357,145,502,31,533
公投第１１案,苗栗縣,後龍鎮,埔頂里,238,943,299,144,443,34,477
公投第１１案,苗栗縣,後龍鎮,埔頂里,239,910,329,148,477,44,521
公投第１１案,苗栗縣,後龍鎮,埔頂里,240,851,319,122,441,33,474
公投第１１案,苗栗縣,後龍鎮,新民里,241,725,278,167,445,20,465
公投第１１案,苗栗縣,後龍鎮,新民里,242,650,225,141,366,24,390
公投第１１案,苗栗縣,後龍鎮,復興里,243,706,219,115,334,35,369
公投第１１案,苗栗縣,後龍鎮,大山里,244,748,272,138,410,28,438
公投第１１案,苗栗縣,後龍鎮,大山里,245,801,227,126,353,24,377
公投第１１案,苗栗縣,後龍鎮,溪洲里,246,1107,435,156,591,32,623
公投第１１案,苗栗縣,後龍鎮,溪洲里,247,1197,416,187,603,52,655
公投第１１案,苗栗縣,後龍鎮,外埔里,248,1036,336,157,493,37,530
公投第１１案,苗栗縣,後龍鎮,海埔里,249,913,267,134,401,28,429
公投第１１案,苗栗縣,後龍鎮,秀水里,250,719,285,115,400,40,440
公投第１１案,苗栗縣,後龍鎮,水尾里,251,1037,409,142,551,48,599
公投第１１案,苗栗縣,後龍鎮,龍津里,252,601,175,113,288,19,307
公投第１１案,苗栗縣,後龍鎮,龍坑里,253,1269,356,193,549,35,584
公投第１１案,苗栗縣,後龍鎮,福寧里,254,735,232,107,339,29,368
公投第１１案,苗栗縣,後龍鎮,中和里,255,422,95,41,136,12,148
公投第１１案,苗栗縣,後龍鎮,中和里,256,625,230,111,341,23,364
公投第１１案,苗栗縣,後龍鎮,南港里,257,1234,390,144,534,40,574
公投第１１案,苗栗縣,造橋鄉,造橋村,258,1171,517,211,728,42,770
公投第１１案,苗栗縣,造橋鄉,造橋村,259,889,384,122,506,23,529
公投第１１案,苗栗縣,造橋鄉,平興村,260,479,163,62,225,14,239
公投第１１案,苗栗縣,造橋鄉,豐湖村,261,1024,427,155,582,22,604
公投第１１案,苗栗縣,造橋鄉,大西村,262,1214,413,201,614,44,658
公投第１１案,苗栗縣,造橋鄉,大西村,263,1071,364,166,530,31,561
公投第１１案,苗栗縣,造橋鄉,大西村,264,1157,395,170,565,43,608
公投第１１案,苗栗縣,造橋鄉,錦水村,265,512,192,85,277,25,302
公投第１１案,苗栗縣,造橋鄉,大龍村,266,491,193,100,293,16,309
公投第１１案,苗栗縣,造橋鄉,朝陽村,267,1272,495,216,711,56,767
公投第１１案,苗栗縣,造橋鄉,談文村,268,785,289,128,417,35,452
公投第１１案,苗栗縣,造橋鄉,龍昇村,269,962,393,175,568,69,637
公投第１１案,苗栗縣,竹南鎮,竹南里,270,1086,415,232,647,9,656
公投第１１案,苗栗縣,竹南鎮,竹南里,271,826,330,133,463,28,491
公投第１１案,苗栗縣,竹南鎮,照南里,272,1051,336,195,531,30,561
公投第１１案,苗栗縣,竹南鎮,照南里,273,1235,506,193,699,32,731
公投第１１案,苗栗縣,竹南鎮,照南里,274,1016,382,185,567,51,618
公投第１１案,苗栗縣,竹南鎮,正南里,275,1472,509,257,766,30,796
公投第１１案,苗栗縣,竹南鎮,正南里,276,1301,432,203,635,16,651
公投第１１案,苗栗縣,竹南鎮,新南里,277,1544,510,253,763,23,786
公投第１１案,苗栗縣,竹南鎮,新南里,278,1512,545,260,805,25,830
公投第１１案,苗栗縣,竹南鎮,新南里,279,1463,507,237,744,35,779
公投第１１案,苗栗縣,竹南鎮,大厝里,280,1073,356,196,552,17,569
公投第１１案,苗栗縣,竹南鎮,大厝里,281,1453,551,256,807,22,829
公投第１１案,苗栗縣,竹南鎮,大厝里,282,1245,516,225,741,15,756
公投第１１案,苗栗縣,竹南鎮,大厝里,283,1487,614,248,862,25,887
公投第１１案,苗栗縣,竹南鎮,營盤里,284,1018,410,164,574,29,603
公投第１１案,苗栗縣,竹南鎮,營盤里,285,1105,422,213,635,23,658
公投第１１案,苗栗縣,竹南鎮,營盤里,286,1322,459,216,675,29,704
公投第１１案,苗栗縣,竹南鎮,聖福里,287,1140,471,177,648,18,666
公投第１１案,苗栗縣,竹南鎮,聖福里,288,1067,436,189,625,30,655
公投第１１案,苗栗縣,竹南鎮,聖福里,289,1136,480,201,681,33,714
公投第１１案,苗栗縣,竹南鎮,竹興里,290,1253,446,187,633,20,653
公投第１１案,苗栗縣,竹南鎮,竹興里,291,963,330,152,482,31,513
公投第１１案,苗栗縣,竹南鎮,竹興里,292,1021,350,184,534,23,557
公投第１１案,苗栗縣,竹南鎮,龍山里,293,1154,453,214,667,31,698
公投第１１案,苗栗縣,竹南鎮,龍山里,294,1042,380,193,573,26,599
公投第１１案,苗栗縣,竹南鎮,天文里,295,1293,514,195,709,36,745
公投第１１案,苗栗縣,竹南鎮,天文里,296,816,350,125,475,13,488
公投第１１案,苗栗縣,竹南鎮,龍鳳里,297,989,352,180,532,31,563
公投第１１案,苗栗縣,竹南鎮,龍鳳里,298,1122,479,163,642,37,679
公投第１１案,苗栗縣,竹南鎮,山佳里,299,1111,330,179,509,17,526
公投第１１案,苗栗縣,竹南鎮,山佳里,300,1036,431,153,584,33,617
公投第１１案,苗栗縣,竹南鎮,山佳里,301,1112,403,139,542,18,560
公投第１１案,苗栗縣,竹南鎮,山佳里,302,1348,492,196,688,15,703
公投第１１案,苗栗縣,竹南鎮,佳興里,303,1114,418,219,637,21,658
公投第１１案,苗栗縣,竹南鎮,佳興里,304,1119,437,195,632,42,674
公投第１１案,苗栗縣,竹南鎮,佳興里,305,878,356,118,474,24,498
公投第１１案,苗栗縣,竹南鎮,中港里,306,1059,433,184,617,37,654
公投第１１案,苗栗縣,竹南鎮,中華里,307,869,338,168,506,19,525
公投第１１案,苗栗縣,竹南鎮,中華里,308,800,295,135,430,20,450
公投第１１案,苗栗縣,竹南鎮,中華里,309,1165,470,213,683,28,711
公投第１１案,苗栗縣,竹南鎮,中英里,310,791,303,138,441,21,462
公投第１１案,苗栗縣,竹南鎮,中英里,311,677,265,102,367,23,390
公投第１１案,苗栗縣,竹南鎮,中美里,312,797,327,151,478,43,521
公投第１１案,苗栗縣,竹南鎮,中美里,313,1191,470,175,645,18,663
公投第１１案,苗栗縣,竹南鎮,開元里,314,1027,359,172,531,16,547
公投第１１案,苗栗縣,竹南鎮,海口里,315,1341,552,210,762,27,789
公投第１１案,苗栗縣,竹南鎮,海口里,316,1378,474,197,671,33,704
公投第１１案,苗栗縣,竹南鎮,海口里,317,1216,461,204,665,17,682
公投第１１案,苗栗縣,竹南鎮,港墘里,318,1570,600,216,816,31,847
公投第１１案,苗栗縣,竹南鎮,港墘里,319,538,233,84,317,23,340
公投第１１案,苗栗縣,竹南鎮,公舘里,320,1166,424,136,560,26,586
公投第１１案,苗栗縣,竹南鎮,大埔里,321,1488,502,261,763,17,780
公投第１１案,苗栗縣,竹南鎮,大埔里,322,1449,517,197,714,18,732
公投第１１案,苗栗縣,竹南鎮,大埔里,323,1182,437,184,621,43,664
公投第１１案,苗栗縣,竹南鎮,頂埔里,324,1175,391,209,600,72,672
公投第１１案,苗栗縣,竹南鎮,頂埔里,325,983,374,153,527,44,571
公投第１１案,苗栗縣,竹南鎮,崎頂里,326,492,201,89,290,19,309
公投第１１案,苗栗縣,竹南鎮,崎頂里,327,1074,398,196,594,29,623
公投第１１案,苗栗縣,竹南鎮,崎頂里,328,852,303,140,443,31,474
公投第１１案,苗栗縣,竹南鎮,崎頂里,329,1297,464,204,668,24,692
公投第１１案,苗栗縣,竹南鎮,公義里,330,1028,358,168,526,33,559
公投第１１案,苗栗縣,頭份市,流東里,331,915,328,130,458,40,498
公投第１１案,苗栗縣,頭份市,流東里,332,1292,521,178,699,37,736
公投第１１案,苗栗縣,頭份市,珊湖里,333,928,375,156,531,21,552
公投第１１案,苗栗縣,頭份市,珊湖里,334,835,315,117,432,16,448
公投第１１案,苗栗縣,頭份市,斗煥里,335,1070,407,159,566,23,589
公投第１１案,苗栗縣,頭份市,斗煥里,336,879,311,141,452,9,461
公投第１１案,苗栗縣,頭份市,斗煥里,337,1039,346,174,520,21,541
公投第１１案,苗栗縣,頭份市,新華里,338,1129,465,171,636,25,661
公投第１１案,苗栗縣,頭份市,新華里,339,1041,379,156,535,37,572
公投第１１案,苗栗縣,頭份市,新華里,340,1546,566,198,764,33,797
公投第１１案,苗栗縣,頭份市,興隆里,341,935,400,154,554,34,588
公投第１１案,苗栗縣,頭份市,興隆里,342,1180,383,212,595,24,619
公投第１１案,苗栗縣,頭份市,興隆里,343,1499,542,204,746,31,777
公投第１１案,苗栗縣,頭份市,興隆里,344,747,257,142,399,8,407
公投第１１案,苗栗縣,頭份市,上埔里,345,1406,532,205,737,39,776
公投第１１案,苗栗縣,頭份市,上埔里,346,1193,458,168,626,47,673
公投第１１案,苗栗縣,頭份市,土牛里,347,948,376,156,532,26,558
公投第１１案,苗栗縣,頭份市,頭份里,348,869,330,123,453,14,467
公投第１１案,苗栗縣,頭份市,頭份里,349,1142,434,209,643,23,666
公投第１１案,苗栗縣,頭份市,頭份里,350,1286,484,220,704,12,716
公投第１１案,苗栗縣,頭份市,忠孝里,351,903,351,162,513,28,541
公投第１１案,苗栗縣,頭份市,忠孝里,352,1186,510,193,703,31,734
公投第１１案,苗栗縣,頭份市,忠孝里,353,1016,425,165,590,13,603
公投第１１案,苗栗縣,頭份市,自強里,354,985,368,167,535,25,560
公投第１１案,苗栗縣,頭份市,自強里,355,1037,392,153,545,19,564
公投第１１案,苗栗縣,頭份市,信義里,356,947,300,137,437,27,464
公投第１１案,苗栗縣,頭份市,仁愛里,357,890,360,143,503,18,521
公投第１１案,苗栗縣,頭份市,仁愛里,358,646,254,137,391,21,412
公投第１１案,苗栗縣,頭份市,上興里,359,975,362,183,545,38,583
公投第１１案,苗栗縣,頭份市,上興里,360,1015,260,127,387,11,398
公投第１１案,苗栗縣,頭份市,下興里,361,1399,584,236,820,45,865
公投第１１案,苗栗縣,頭份市,下興里,362,1143,455,193,648,40,688
公投第１１案,苗栗縣,頭份市,和平里,363,1030,466,160,626,46,672
公投第１１案,苗栗縣,頭份市,山下里,364,1338,511,234,745,30,775
公投第１１案,苗栗縣,頭份市,山下里,365,1450,553,226,779,20,799
公投第１１案,苗栗縣,頭份市,山下里,366,1042,422,177,599,10,609
公投第１１案,苗栗縣,頭份市,後庄里,367,1326,531,242,773,23,796
公投第１１案,苗栗縣,頭份市,後庄里,368,1270,547,225,772,30,802
公投第１１案,苗栗縣,頭份市,後庄里,369,1288,489,220,709,22,731
公投第１１案,苗栗縣,頭份市,合興里,370,1243,536,201,737,22,759
公投第１１案,苗栗縣,頭份市,合興里,371,1280,541,194,735,21,756
公投第１１案,苗栗縣,頭份市,文化里,372,1618,612,263,875,32,907
公投第１１案,苗栗縣,頭份市,文化里,373,1759,640,267,907,39,946
公投第１１案,苗栗縣,頭份市,中興里,374,1264,524,209,733,22,755
公投第１１案,苗栗縣,頭份市,中興里,375,1326,514,232,746,22,768
公投第１１案,苗栗縣,頭份市,蟠桃里,376,1551,623,253,876,22,898
公投第１１案,苗栗縣,頭份市,蟠桃里,377,1574,542,248,790,29,819
公投第１１案,苗栗縣,頭份市,建國里,378,1262,474,226,700,31,731
公投第１１案,苗栗縣,頭份市,建國里,379,1171,445,212,657,32,689
公投第１１案,苗栗縣,頭份市,建國里,380,1074,469,211,680,18,698
公投第１１案,苗栗縣,頭份市,成功里,381,1141,487,181,668,26,694
公投第１１案,苗栗縣,頭份市,成功里,382,1259,491,216,707,29,736
公投第１１案,苗栗縣,頭份市,成功里,383,1186,453,190,643,18,661
公投第１１案,苗栗縣,頭份市,民族里,384,1121,412,144,556,29,585
公投第１１案,苗栗縣,頭份市,民族里,385,847,325,137,462,25,487
公投第１１案,苗栗縣,頭份市,民權里,386,993,388,189,577,22,599
公投第１１案,苗栗縣,頭份市,民權里,387,1055,385,173,558,22,580
公投第１１案,苗栗縣,頭份市,東庄里,388,1655,582,226,808,32,840
公投第１１案,苗栗縣,頭份市,東庄里,389,1799,680,268,948,42,990
公投第１１案,苗栗縣,頭份市,田寮里,390,1141,452,179,631,32,663
公投第１１案,苗栗縣,頭份市,田寮里,391,1431,499,244,743,41,784
公投第１１案,苗栗縣,頭份市,田寮里,392,1412,462,197,659,21,680
公投第１１案,苗栗縣,頭份市,民生里,393,1074,390,151,541,25,566
公投第１１案,苗栗縣,頭份市,民生里,394,1245,593,118,711,32,743
公投第１１案,苗栗縣,頭份市,蘆竹里,395,1344,490,259,749,53,802
公投第１１案,苗栗縣,頭份市,尖山里,396,1363,568,234,802,41,843
公投第１１案,苗栗縣,頭份市,廣興里,397,898,385,154,539,33,572
公投第１１案,苗栗縣,頭份市,尖下里,398,1182,455,223,678,42,720
公投第１１案,苗栗縣,頭份市,尖下里,399,1413,558,192,750,32,782
公投第１１案,苗栗縣,頭份市,濫坑里,400,991,396,187,583,33,616
公投第１１案,苗栗縣,頭份市,濫坑里,401,1180,451,208,659,37,696
公投第１１案,苗栗縣,三灣鄉,三灣村,402,996,397,167,564,30,594
公投第１１案,苗栗縣,三灣鄉,三灣村,403,1205,463,184,647,40,687
公投第１１案,苗栗縣,三灣鄉,內灣村,404,635,250,106,356,33,389
公投第１１案,苗栗縣,三灣鄉,銅鏡村,405,862,328,143,471,25,496
公投第１１案,苗栗縣,三灣鄉,頂寮村,406,238,75,30,105,13,118
公投第１１案,苗栗縣,三灣鄉,北埔村,407,541,182,89,271,23,294
公投第１１案,苗栗縣,三灣鄉,大河村,408,578,192,83,275,24,299
公投第１１案,苗栗縣,三灣鄉,大坪村,409,405,180,70,250,29,279
公投第１１案,苗栗縣,三灣鄉,永和村,410,392,148,55,203,21,224
公投第１１案,苗栗縣,南庄鄉,東村,411,1155,402,192,594,49,643
公投第１１案,苗栗縣,南庄鄉,西村,412,650,206,137,343,30,373
公投第１１案,苗栗縣,南庄鄉,南江村,413,1353,463,190,653,46,699
公投第１１案,苗栗縣,南庄鄉,田美村,414,813,223,94,317,38,355
公投第１１案,苗栗縣,南庄鄉,獅山村,415,837,255,83,338,24,362
公投第１１案,苗栗縣,南庄鄉,南富村,416,1093,382,172,554,23,577
公投第１１案,苗栗縣,南庄鄉,員林村,417,1048,374,167,541,36,577
公投第１１案,苗栗縣,南庄鄉,蓬萊村,418,872,294,116,410,38,448
公投第１１案,苗栗縣,南庄鄉,東河村,419,963,201,102,303,13,316
公投第１１案,苗栗縣,大湖鄉,大湖村,420,744,264,119,383,23,406
公投第１１案,苗栗縣,大湖鄉,大湖村,421,881,347,118,465,22,487
公投第１１案,苗栗縣,大湖鄉,明湖村,422,596,237,83,320,20,340
公投第１１案,苗栗縣,大湖鄉,大寮村,423,1260,414,188,602,53,655
公投第１１案,苗栗縣,大湖鄉,靜湖村,424,867,312,119,431,26,457
公投第１１案,苗栗縣,大湖鄉,靜湖村,425,923,368,134,502,18,520
公投第１１案,苗栗縣,大湖鄉,富興村,426,1395,476,193,669,67,736
公投第１１案,苗栗縣,大湖鄉,大南村,427,561,137,61,198,14,212
公投第１１案,苗栗縣,大湖鄉,南湖村,428,638,253,96,349,22,371
公投第１１案,苗栗縣,大湖鄉,東興村,429,754,257,108,365,35,400
公投第１１案,苗栗縣,大湖鄉,武榮村,430,501,170,71,241,12,253
公投第１１案,苗栗縣,大湖鄉,義和村,431,652,211,121,332,28,360
公投第１１案,苗栗縣,大湖鄉,義和村,432,843,257,131,388,27,415
公投第１１案,苗栗縣,大湖鄉,栗林村,433,1020,366,174,540,40,580
公投第１１案,苗栗縣,大湖鄉,新開村,434,1018,385,156,541,38,579
公投第１１案,苗栗縣,獅潭鄉,百壽村,435,328,90,34,124,6,130
公投第１１案,苗栗縣,獅潭鄉,永興村,436,565,160,65,225,27,252
公投第１１案,苗栗縣,獅潭鄉,新店村,437,911,367,114,481,43,524
公投第１１案,苗栗縣,獅潭鄉,和興村,438,568,175,68,243,27,270
公投第１１案,苗栗縣,獅潭鄉,豐林村,439,580,230,85,315,26,341
公投第１１案,苗栗縣,獅潭鄉,新豐村,440,333,129,35,164,7,171
公投第１１案,苗栗縣,獅潭鄉,竹木村,441,683,251,85,336,18,354
公投第１１案,苗栗縣,卓蘭鎮,老庄里,442,961,400,157,557,29,586
公投第１１案,苗栗縣,卓蘭鎮,老庄里,443,1017,366,178,544,32,576
公投第１１案,苗栗縣,卓蘭鎮,新榮里,444,1095,420,230,650,54,704
公投第１１案,苗栗縣,卓蘭鎮,中街里,445,745,319,122,441,19,460
公投第１１案,苗栗縣,卓蘭鎮,新厝里,446,783,269,132,401,31,432
公投第１１案,苗栗縣,卓蘭鎮,新厝里,447,745,256,103,359,16,375
公投第１１案,苗栗縣,卓蘭鎮,豐田里,448,999,332,139,471,32,503
公投第１１案,苗栗縣,卓蘭鎮,西坪里,449,671,275,111,386,32,418
公投第１１案,苗栗縣,卓蘭鎮,苗豐里,450,734,306,129,435,48,483
公投第１１案,苗栗縣,卓蘭鎮,上新里,451,865,353,149,502,38,540
公投第１１案,苗栗縣,卓蘭鎮,上新里,452,828,358,138,496,31,527
公投第１１案,苗栗縣,卓蘭鎮,上新里,453,386,145,68,213,30,243
公投第１１案,苗栗縣,卓蘭鎮,內灣里,454,688,279,135,414,30,444
公投第１１案,苗栗縣,卓蘭鎮,內灣里,455,792,317,150,467,26,493
公投第１１案,苗栗縣,卓蘭鎮,內灣里,456,729,273,134,407,26,433
公投第１１案,苗栗縣,卓蘭鎮,坪林里,457,1093,335,166,501,31,532
公投第１１案,苗栗縣,卓蘭鎮,坪林里,458,615,243,105,348,17,365
公投第１１案,苗栗縣,卓蘭鎮,西坪里,459,86,35,10,45,1,46
公投第１１案,苗栗縣,卓蘭鎮,景山里,460,940,356,158,514,6,520
公投第１１案,苗栗縣,泰安鄉,八卦村,461,325,88,54,142,7,149
公投第１１案,苗栗縣,泰安鄉,錦水村,462,484,183,88,271,15,286
公投第１１案,苗栗縣,泰安鄉,錦水村,463,666,335,124,459,27,486
公投第１１案,苗栗縣,泰安鄉,清安村,464,574,272,93,365,24,389
公投第１１案,苗栗縣,泰安鄉,清安村,465,333,129,41,170,7,177
公投第１１案,苗栗縣,泰安鄉,大興村,466,495,251,81,332,16,348
公投第１１案,苗栗縣,泰安鄉,中興村,467,544,257,129,386,15,401
公投第１１案,苗栗縣,泰安鄉,梅園村,468,500,221,83,304,13,317
公投第１１案,苗栗縣,泰安鄉,象鼻村,469,670,350,113,463,17,480
公投第１１案,苗栗縣,泰安鄉,士林村,470,589,314,119,433,5,438
公投第１１案,彰化縣,彰化市,桃源里,1,871,358,162,520,17,537
公投第１１案,彰化縣,彰化市,桃源里,2,751,229,106,335,30,365
公投第１１案,彰化縣,彰化市,桃源里,3,923,384,201,585,25,610
公投第１１案,彰化縣,彰化市,東興里,4,779,300,153,453,31,484
公投第１１案,彰化縣,彰化市,東興里,5,779,306,156,462,18,480
公投第１１案,彰化縣,彰化市,華北里,6,720,293,126,419,17,436
公投第１１案,彰化縣,彰化市,華北里,7,749,278,145,423,24,447
公投第１１案,彰化縣,彰化市,華陽里,8,767,330,139,469,30,499
公投第１１案,彰化縣,彰化市,華陽里,9,1047,430,195,625,37,662
公投第１１案,彰化縣,彰化市,大同里,10,1027,373,188,561,27,588
公投第１１案,彰化縣,彰化市,永生里,11,1249,470,212,682,34,716
公投第１１案,彰化縣,彰化市,建寶里,12,1136,458,200,658,21,679
公投第１１案,彰化縣,彰化市,建寶里,13,1169,510,192,702,25,727
公投第１１案,彰化縣,彰化市,光南里,14,766,318,155,473,16,489
公投第１１案,彰化縣,彰化市,光南里,15,643,282,95,377,16,393
公投第１１案,彰化縣,彰化市,介壽里,16,1251,502,211,713,32,745
公投第１１案,彰化縣,彰化市,介壽里,17,1301,324,158,482,27,509
公投第１１案,彰化縣,彰化市,延平里,18,1280,501,248,749,23,772
公投第１１案,彰化縣,彰化市,延平里,19,1179,512,203,715,19,734
公投第１１案,彰化縣,彰化市,延平里,20,1168,462,210,672,17,689
公投第１１案,彰化縣,彰化市,延平里,21,1218,510,179,689,31,720
公投第１１案,彰化縣,彰化市,延平里,22,1351,581,274,855,25,880
公投第１１案,彰化縣,彰化市,延平里,23,1204,452,258,710,18,728
公投第１１案,彰化縣,彰化市,延平里,24,1189,482,223,705,14,719
公投第１１案,彰化縣,彰化市,延和里,25,1207,457,211,668,32,700
公投第１１案,彰化縣,彰化市,延和里,26,1161,479,187,666,31,697
公投第１１案,彰化縣,彰化市,延和里,27,1166,420,222,642,28,670
公投第１１案,彰化縣,彰化市,延和里,28,1362,544,270,814,19,833
公投第１１案,彰化縣,彰化市,南興里,29,1236,465,266,731,38,769
公投第１１案,彰化縣,彰化市,南興里,30,1065,414,194,608,30,638
公投第１１案,彰化縣,彰化市,南興里,31,1199,450,229,679,32,711
公投第１１案,彰化縣,彰化市,南興里,32,1233,464,260,724,11,735
公投第１１案,彰化縣,彰化市,南興里,33,1245,462,232,694,20,714
公投第１１案,彰化縣,彰化市,南興里,34,1153,475,222,697,22,719
公投第１１案,彰化縣,彰化市,南瑤里,35,1045,390,186,576,18,594
公投第１１案,彰化縣,彰化市,南瑤里,36,1097,418,220,638,12,650
公投第１１案,彰化縣,彰化市,南瑤里,37,1190,457,216,673,24,697
公投第１１案,彰化縣,彰化市,南瑤里,38,1106,447,233,680,13,693
公投第１１案,彰化縣,彰化市,南瑤里,39,1097,453,186,639,24,663
公投第１１案,彰化縣,彰化市,南瑤里,40,1048,402,211,613,30,643
公投第１１案,彰化縣,彰化市,南瑤里,41,980,403,192,595,23,618
公投第１１案,彰化縣,彰化市,成功里,42,707,298,135,433,15,448
公投第１１案,彰化縣,彰化市,成功里,43,809,304,163,467,22,489
公投第１１案,彰化縣,彰化市,福安里,44,1008,386,208,594,39,633
公投第１１案,彰化縣,彰化市,西安里,45,901,328,161,489,29,518
公投第１１案,彰化縣,彰化市,西安里,46,951,358,171,529,22,551
公投第１１案,彰化縣,彰化市,西安里,47,1076,407,216,623,25,648
公投第１１案,彰化縣,彰化市,彰安里,48,1022,382,174,556,19,575
公投第１１案,彰化縣,彰化市,彰安里,49,894,357,170,527,23,550
公投第１１案,彰化縣,彰化市,彰安里,50,1016,400,203,603,29,632
公投第１１案,彰化縣,彰化市,中央里,51,771,305,167,472,27,499
公投第１１案,彰化縣,彰化市,富貴里,52,868,345,171,516,19,535
公投第１１案,彰化縣,彰化市,民權里,53,1135,453,205,658,31,689
公投第１１案,彰化縣,彰化市,萬壽里,54,910,338,182,520,43,563
公投第１１案,彰化縣,彰化市,長樂里,55,1004,406,215,621,17,638
公投第１１案,彰化縣,彰化市,西興里,56,1077,434,208,642,31,673
公投第１１案,彰化縣,彰化市,西興里,57,1258,543,250,793,34,827
公投第１１案,彰化縣,彰化市,西興里,58,1025,447,189,636,21,657
公投第１１案,彰化縣,彰化市,西勢里,59,1177,495,230,725,26,751
公投第１１案,彰化縣,彰化市,西勢里,60,1262,469,238,707,19,726
公投第１１案,彰化縣,彰化市,西勢里,61,1209,603,110,713,42,755
公投第１１案,彰化縣,彰化市,忠權里,62,1041,424,204,628,33,661
公投第１１案,彰化縣,彰化市,忠權里,63,1075,472,180,652,24,676
公投第１１案,彰化縣,彰化市,忠權里,64,1029,399,170,569,23,592
公投第１１案,彰化縣,彰化市,忠孝里,65,1203,444,212,656,48,704
公投第１１案,彰化縣,彰化市,五權里,66,1014,416,152,568,23,591
公投第１１案,彰化縣,彰化市,五權里,67,1069,438,188,626,22,648
公投第１１案,彰化縣,彰化市,五權里,68,969,357,155,512,15,527
公投第１１案,彰化縣,彰化市,五權里,69,1105,414,173,587,10,597
公投第１１案,彰化縣,彰化市,平和里,70,981,430,174,604,30,634
公投第１１案,彰化縣,彰化市,平和里,71,1095,436,230,666,34,700
公投第１１案,彰化縣,彰化市,平和里,72,1087,458,202,660,23,683
公投第１１案,彰化縣,彰化市,平和里,73,1050,391,226,617,23,640
公投第１１案,彰化縣,彰化市,崙平里,74,1252,484,255,739,36,775
公投第１１案,彰化縣,彰化市,崙平里,75,1113,412,202,614,20,634
公投第１１案,彰化縣,彰化市,崙平里,76,1009,408,199,607,28,635
公投第１１案,彰化縣,彰化市,崙平里,77,999,383,173,556,25,581
公投第１１案,彰化縣,彰化市,崙平里,78,997,391,183,574,15,589
公投第１１案,彰化縣,彰化市,向陽里,79,1145,467,253,720,27,747
公投第１１案,彰化縣,彰化市,向陽里,80,1227,487,230,717,27,744
公投第１１案,彰化縣,彰化市,向陽里,81,1208,484,247,731,23,754
公投第１１案,彰化縣,彰化市,向陽里,82,1598,635,279,914,16,930
公投第１１案,彰化縣,彰化市,莿桐里,83,890,366,162,528,23,551
公投第１１案,彰化縣,彰化市,莿桐里,84,1104,449,225,674,34,708
公投第１１案,彰化縣,彰化市,莿桐里,85,1097,416,200,616,21,637
公投第１１案,彰化縣,彰化市,南美里,86,799,326,124,450,26,476
公投第１１案,彰化縣,彰化市,南美里,87,1000,439,164,603,28,631
公投第１１案,彰化縣,彰化市,南安里,88,1153,470,162,632,51,683
公投第１１案,彰化縣,彰化市,南安里,89,977,403,159,562,44,606
公投第１１案,彰化縣,彰化市,東芳里,90,1201,433,237,670,30,700
公投第１１案,彰化縣,彰化市,東芳里,91,1057,404,221,625,41,666
公投第１１案,彰化縣,彰化市,東芳里,92,1238,470,207,677,54,731
公投第１１案,彰化縣,彰化市,磚磘里,93,1210,498,221,719,28,747
公投第１１案,彰化縣,彰化市,磚磘里,94,1026,441,166,607,32,639
公投第１１案,彰化縣,彰化市,磚磘里,95,1061,445,217,662,31,693
公投第１１案,彰化縣,彰化市,卦山里,96,1213,462,222,684,41,725
公投第１１案,彰化縣,彰化市,卦山里,97,1264,489,265,754,27,781
公投第１１案,彰化縣,彰化市,光復里,98,691,294,156,450,16,466
公投第１１案,彰化縣,彰化市,永福里,99,893,361,179,540,36,576
公投第１１案,彰化縣,彰化市,光華里,100,733,293,131,424,36,460
公投第１１案,彰化縣,彰化市,中正里,101,692,294,126,420,26,446
公投第１１案,彰化縣,彰化市,中正里,102,728,270,146,416,27,443
公投第１１案,彰化縣,彰化市,中山里,103,773,340,141,481,24,505
公投第１１案,彰化縣,彰化市,龍山里,104,975,368,152,520,13,533
公投第１１案,彰化縣,彰化市,龍山里,105,908,383,150,533,31,564
公投第１１案,彰化縣,彰化市,新興里,106,1156,486,198,684,13,697
公投第１１案,彰化縣,彰化市,新興里,107,1235,485,250,735,25,760
公投第１１案,彰化縣,彰化市,新興里,108,1376,527,230,757,27,784
公投第１１案,彰化縣,彰化市,新興里,109,1389,513,267,780,17,797
公投第１１案,彰化縣,彰化市,新華里,110,846,357,167,524,35,559
公投第１１案,彰化縣,彰化市,新華里,111,859,393,141,534,23,557
公投第１１案,彰化縣,彰化市,興北里,112,781,296,175,471,14,485
公投第１１案,彰化縣,彰化市,興北里,113,875,341,160,501,24,525
公投第１１案,彰化縣,彰化市,信義里,114,816,321,147,468,18,486
公投第１１案,彰化縣,彰化市,民生里,115,687,289,127,416,26,442
公投第１１案,彰化縣,彰化市,民生里,116,727,318,136,454,17,471
公投第１１案,彰化縣,彰化市,文化里,117,662,288,132,420,13,433
公投第１１案,彰化縣,彰化市,文化里,118,633,279,115,394,12,406
公投第１１案,彰化縣,彰化市,陽明里,119,906,403,166,569,24,593
公投第１１案,彰化縣,彰化市,陽明里,120,853,340,131,471,24,495
公投第１１案,彰化縣,彰化市,萬安里,121,1027,433,198,631,19,650
公投第１１案,彰化縣,彰化市,萬安里,122,993,440,168,608,25,633
公投第１１案,彰化縣,彰化市,萬安里,123,848,356,140,496,29,525
公投第１１案,彰化縣,彰化市,萬安里,124,1118,471,221,692,15,707
公投第１１案,彰化縣,彰化市,下廍里,125,1263,505,237,742,35,777
公投第１１案,彰化縣,彰化市,下廍里,126,1268,555,219,774,31,805
公投第１１案,彰化縣,彰化市,下廍里,127,1258,541,200,741,29,770
公投第１１案,彰化縣,彰化市,下廍里,128,1212,529,217,746,11,757
公投第１１案,彰化縣,彰化市,茄苳里,129,924,376,161,537,36,573
公投第１１案,彰化縣,彰化市,茄南里,130,939,395,188,583,18,601
公投第１１案,彰化縣,彰化市,茄南里,131,953,421,173,594,43,637
公投第１１案,彰化縣,彰化市,茄南里,132,981,441,189,630,19,649
公投第１１案,彰化縣,彰化市,寶廍里,133,1249,529,223,752,44,796
公投第１１案,彰化縣,彰化市,古夷里,134,817,350,141,491,24,515
公投第１１案,彰化縣,彰化市,古夷里,135,872,341,159,500,39,539
公投第１１案,彰化縣,彰化市,古夷里,136,689,262,127,389,20,409
公投第１１案,彰化縣,彰化市,阿夷里,137,1156,508,201,709,20,729
公投第１１案,彰化縣,彰化市,阿夷里,138,1291,487,235,722,21,743
公投第１１案,彰化縣,彰化市,阿夷里,139,1139,452,187,639,26,665
公投第１１案,彰化縣,彰化市,阿夷里,140,1125,445,221,666,28,694
公投第１１案,彰化縣,彰化市,阿夷里,141,1258,474,213,687,39,726
公投第１１案,彰化縣,彰化市,阿夷里,142,1123,458,185,643,25,668
公投第１１案,彰化縣,彰化市,阿夷里,143,1175,484,190,674,29,703
公投第１１案,彰化縣,彰化市,和調里,144,862,365,186,551,20,571
公投第１１案,彰化縣,彰化市,和調里,145,872,336,172,508,21,529
公投第１１案,彰化縣,彰化市,和調里,146,897,402,164,566,15,581
公投第１１案,彰化縣,彰化市,復興里,147,1003,387,166,553,25,578
公投第１１案,彰化縣,彰化市,復興里,148,915,374,156,530,17,547
公投第１１案,彰化縣,彰化市,復興里,149,1158,433,200,633,35,668
公投第１１案,彰化縣,彰化市,復興里,150,1084,450,203,653,32,685
公投第１１案,彰化縣,彰化市,中庄里,151,1372,516,229,745,38,783
公投第１１案,彰化縣,彰化市,中庄里,152,1113,458,172,630,35,665
公投第１１案,彰化縣,彰化市,竹中里,153,800,342,139,481,25,506
公投第１１案,彰化縣,彰化市,竹中里,154,885,361,155,516,21,537
公投第１１案,彰化縣,彰化市,香山里,155,1000,429,178,607,25,632
公投第１１案,彰化縣,彰化市,香山里,156,1159,426,201,627,29,656
公投第１１案,彰化縣,彰化市,香山里,157,1123,411,204,615,26,641
公投第１１案,彰化縣,彰化市,牛埔里,158,907,374,180,554,47,601
公投第１１案,彰化縣,彰化市,牛埔里,159,989,376,152,528,38,566
公投第１１案,彰化縣,彰化市,牛埔里,160,1012,432,165,597,43,640
公投第１１案,彰化縣,彰化市,台鳳里,161,1033,400,150,550,21,571
公投第１１案,彰化縣,彰化市,台鳳里,162,1116,458,202,660,29,689
公投第１１案,彰化縣,彰化市,台鳳里,163,1154,479,210,689,26,715
公投第１１案,彰化縣,彰化市,台鳳里,164,1064,449,191,640,23,663
公投第１１案,彰化縣,彰化市,國聖里,165,770,338,137,475,36,511
公投第１１案,彰化縣,彰化市,國聖里,166,889,336,188,524,33,557
公投第１１案,彰化縣,彰化市,國聖里,167,786,336,124,460,42,502
公投第１１案,彰化縣,彰化市,福山里,168,1120,394,177,571,49,620
公投第１１案,彰化縣,彰化市,福山里,169,1269,486,182,668,29,697
公投第１１案,彰化縣,彰化市,福山里,170,1159,490,186,676,32,708
公投第１１案,彰化縣,彰化市,福山里,171,1184,466,210,676,49,725
公投第１１案,彰化縣,彰化市,福山里,172,1089,424,174,598,36,634
公投第１１案,彰化縣,彰化市,福山里,173,968,401,169,570,35,605
公投第１１案,彰化縣,彰化市,安溪里,174,930,376,149,525,23,548
公投第１１案,彰化縣,彰化市,安溪里,175,973,406,180,586,21,607
公投第１１案,彰化縣,彰化市,三村里,176,1184,389,255,644,14,658
公投第１１案,彰化縣,彰化市,大竹里,177,1002,416,170,586,38,624
公投第１１案,彰化縣,彰化市,大竹里,178,1148,448,178,626,21,647
公投第１１案,彰化縣,彰化市,大竹里,179,1112,437,183,620,26,646
公投第１１案,彰化縣,彰化市,田中里,180,907,418,170,588,38,626
公投第１１案,彰化縣,彰化市,快官里,181,1112,438,194,632,45,677
公投第１１案,彰化縣,彰化市,竹巷里,182,823,290,133,423,31,454
公投第１１案,彰化縣,彰化市,福田里,183,1276,478,228,706,52,758
公投第１１案,彰化縣,彰化市,石牌里,184,1161,477,171,648,22,670
公投第１１案,彰化縣,花壇鄉,花壇村,185,901,375,150,525,29,554
公投第１１案,彰化縣,花壇鄉,花壇村,186,1042,436,200,636,25,661
公投第１１案,彰化縣,花壇鄉,花壇村,187,1314,486,242,728,10,738
公投第１１案,彰化縣,花壇鄉,金墩村,188,808,360,121,481,25,506
公投第１１案,彰化縣,花壇鄉,金墩村,189,1019,399,169,568,22,590
公投第１１案,彰化縣,花壇鄉,中庄村,190,1144,489,190,679,33,712
公投第１１案,彰化縣,花壇鄉,中庄村,191,1240,518,173,691,57,748
公投第１１案,彰化縣,花壇鄉,崙雅村,192,1425,660,191,851,28,879
公投第１１案,彰化縣,花壇鄉,劉厝村,193,1095,494,180,674,35,709
公投第１１案,彰化縣,花壇鄉,南口村,194,910,373,145,518,28,546
公投第１１案,彰化縣,花壇鄉,南口村,195,982,435,153,588,18,606
公投第１１案,彰化縣,花壇鄉,北口村,196,1070,390,213,603,16,619
公投第１１案,彰化縣,花壇鄉,北口村,197,700,248,139,387,17,404
公投第１１案,彰化縣,花壇鄉,中口村,198,764,325,143,468,37,505
公投第１１案,彰化縣,花壇鄉,文德村,199,953,407,170,577,27,604
公投第１１案,彰化縣,花壇鄉,文德村,200,974,378,159,537,20,557
公投第１１案,彰化縣,花壇鄉,文德村,201,1111,418,189,607,40,647
公投第１１案,彰化縣,花壇鄉,白沙村,202,1101,469,161,630,45,675
公投第１１案,彰化縣,花壇鄉,白沙村,203,1110,435,161,596,23,619
公投第１１案,彰化縣,花壇鄉,白沙村,204,1262,475,226,701,33,734
公投第１１案,彰化縣,花壇鄉,白沙村,205,1103,394,234,628,25,653
公投第１１案,彰化縣,花壇鄉,岩竹村,206,1347,468,209,677,34,711
公投第１１案,彰化縣,花壇鄉,長沙村,207,1169,427,183,610,28,638
公投第１１案,彰化縣,花壇鄉,長沙村,208,1274,532,209,741,30,771
公投第１１案,彰化縣,花壇鄉,長沙村,209,1280,571,203,774,19,793
公投第１１案,彰化縣,花壇鄉,長沙村,210,1244,530,175,705,25,730
公投第１１案,彰化縣,花壇鄉,橋頭村,211,1159,452,194,646,39,685
公投第１１案,彰化縣,花壇鄉,橋頭村,212,1042,441,193,634,23,657
公投第１１案,彰化縣,花壇鄉,橋頭村,213,1111,432,172,604,25,629
公投第１１案,彰化縣,花壇鄉,灣雅村,214,893,387,149,536,35,571
公投第１１案,彰化縣,花壇鄉,灣東村,215,953,390,149,539,28,567
公投第１１案,彰化縣,花壇鄉,三春村,216,987,364,170,534,27,561
公投第１１案,彰化縣,花壇鄉,三春村,217,925,414,169,583,27,610
公投第１１案,彰化縣,花壇鄉,永春村,218,951,410,132,542,27,569
公投第１１案,彰化縣,花壇鄉,永春村,219,955,370,159,529,20,549
公投第１１案,彰化縣,花壇鄉,長春村,220,895,370,148,518,24,542
公投第１１案,彰化縣,花壇鄉,長春村,221,711,290,115,405,20,425
公投第１１案,彰化縣,芬園鄉,舊社村,222,958,373,141,514,24,538
公投第１１案,彰化縣,芬園鄉,舊社村,223,794,299,119,418,39,457
公投第１１案,彰化縣,芬園鄉,大埔村,224,1415,460,220,680,67,747
公投第１１案,彰化縣,芬園鄉,竹林村,225,927,341,149,490,28,518
公投第１１案,彰化縣,芬園鄉,竹林村,226,831,337,107,444,30,474
公投第１１案,彰化縣,芬園鄉,楓坑村,227,570,216,106,322,17,339
公投第１１案,彰化縣,芬園鄉,社口村,228,1227,426,205,631,25,656
公投第１１案,彰化縣,芬園鄉,社口村,229,1238,463,177,640,43,683
公投第１１案,彰化縣,芬園鄉,茄荖村,230,1362,507,229,736,51,787
公投第１１案,彰化縣,芬園鄉,茄荖村,231,989,403,141,544,45,589
公投第１１案,彰化縣,芬園鄉,嘉興村,232,1054,474,161,635,35,670
公投第１１案,彰化縣,芬園鄉,嘉興村,233,607,270,102,372,29,401
公投第１１案,彰化縣,芬園鄉,芬園村,234,882,366,136,502,34,536
公投第１１案,彰化縣,芬園鄉,縣庄村,235,1143,382,145,527,32,559
公投第１１案,彰化縣,芬園鄉,圳墘村,236,661,230,85,315,22,337
公投第１１案,彰化縣,芬園鄉,溪頭村,237,838,312,114,426,3,429
公投第１１案,彰化縣,芬園鄉,溪頭村,238,847,276,138,414,31,445
公投第１１案,彰化縣,芬園鄉,進芬村,239,987,388,163,551,41,592
公投第１１案,彰化縣,芬園鄉,同安村,240,1217,410,183,593,50,643
公投第１１案,彰化縣,芬園鄉,中崙村,241,865,274,119,393,51,444
公投第１１案,彰化縣,芬園鄉,大竹村,242,996,315,162,477,37,514
公投第１１案,彰化縣,鹿港鎮,大有里,243,1140,364,323,687,31,718
公投第１１案,彰化縣,鹿港鎮,中興里,244,511,184,102,286,20,306
公投第１１案,彰化縣,鹿港鎮,洛津里,245,857,292,132,424,15,439
公投第１１案,彰化縣,鹿港鎮,順興里,246,946,411,163,574,36,610
公投第１１案,彰化縣,鹿港鎮,埔崙里,247,945,339,195,534,31,565
公投第１１案,彰化縣,鹿港鎮,埔崙里,248,1097,446,185,631,27,658
公投第１１案,彰化縣,鹿港鎮,埔崙里,249,1479,479,239,718,23,741
公投第１１案,彰化縣,鹿港鎮,埔崙里,250,1425,571,252,823,35,858
公投第１１案,彰化縣,鹿港鎮,新宮里,251,880,330,166,496,58,554
公投第１１案,彰化縣,鹿港鎮,玉順里,252,1183,445,187,632,43,675
公投第１１案,彰化縣,鹿港鎮,東石里,253,1047,412,186,598,48,646
公投第１１案,彰化縣,鹿港鎮,東石里,254,1097,425,177,602,26,628
公投第１１案,彰化縣,鹿港鎮,東石里,255,1030,401,149,550,43,593
公投第１１案,彰化縣,鹿港鎮,東石里,256,1161,441,200,641,35,676
公投第１１案,彰化縣,鹿港鎮,郭厝里,257,540,248,58,306,38,344
公投第１１案,彰化縣,鹿港鎮,永安里,258,1135,410,201,611,32,643
公投第１１案,彰化縣,鹿港鎮,永安里,259,1155,460,165,625,46,671
公投第１１案,彰化縣,鹿港鎮,永安里,260,1127,453,215,668,31,699
公投第１１案,彰化縣,鹿港鎮,永安里,261,1045,410,182,592,34,626
公投第１１案,彰化縣,鹿港鎮,景福里,262,1127,431,186,617,49,666
公投第１１案,彰化縣,鹿港鎮,泰興里,263,1178,561,169,730,35,765
公投第１１案,彰化縣,鹿港鎮,長興里,264,284,112,52,164,5,169
公投第１１案,彰化縣,鹿港鎮,興化里,265,584,227,103,330,20,350
公投第１１案,彰化縣,鹿港鎮,龍山里,266,659,302,112,414,22,436
公投第１１案,彰化縣,鹿港鎮,菜園里,267,915,363,172,535,20,555
公投第１１案,彰化縣,鹿港鎮,街尾里,268,1079,463,192,655,28,683
公投第１１案,彰化縣,鹿港鎮,街尾里,269,1129,482,212,694,39,733
公投第１１案,彰化縣,鹿港鎮,詔安里,270,1273,475,198,673,35,708
公投第１１案,彰化縣,鹿港鎮,詔安里,271,706,253,99,352,29,381
公投第１１案,彰化縣,鹿港鎮,海埔里,272,1137,370,190,560,73,633
公投第１１案,彰化縣,鹿港鎮,海埔里,273,1195,429,205,634,29,663
公投第１１案,彰化縣,鹿港鎮,海埔里,274,1225,457,165,622,41,663
公投第１１案,彰化縣,鹿港鎮,洋厝里,275,957,417,177,594,36,630
公投第１１案,彰化縣,鹿港鎮,洋厝里,276,758,278,92,370,43,413
公投第１１案,彰化縣,鹿港鎮,洋厝里,277,723,286,117,403,38,441
公投第１１案,彰化縣,鹿港鎮,草中里,278,984,372,161,533,23,556
公投第１１案,彰化縣,鹿港鎮,草中里,279,1018,459,153,612,36,648
公投第１１案,彰化縣,鹿港鎮,草中里,280,1165,430,185,615,31,646
公投第１１案,彰化縣,鹿港鎮,頭南里,281,1161,501,74,575,40,615
公投第１１案,彰化縣,鹿港鎮,頭南里,282,1020,362,172,534,31,565
公投第１１案,彰化縣,鹿港鎮,山崙里,283,1068,425,145,570,45,615
公投第１１案,彰化縣,鹿港鎮,山崙里,284,1024,476,150,626,36,662
公投第１１案,彰化縣,鹿港鎮,山崙里,285,974,399,152,551,57,608
公投第１１案,彰化縣,鹿港鎮,頂番里,286,1505,524,238,762,58,820
公投第１１案,彰化縣,鹿港鎮,頂番里,287,1092,375,202,577,30,607
公投第１１案,彰化縣,鹿港鎮,頂番里,288,1223,478,207,685,57,742
公投第１１案,彰化縣,鹿港鎮,頭崙里,289,1572,550,207,757,21,778
公投第１１案,彰化縣,鹿港鎮,頭崙里,290,1003,420,162,582,40,622
公投第１１案,彰化縣,鹿港鎮,溝墘里,291,933,389,147,536,27,563
公投第１１案,彰化縣,鹿港鎮,溝墘里,292,1093,444,170,614,49,663
公投第１１案,彰化縣,鹿港鎮,溝墘里,293,907,366,139,505,12,517
公投第１１案,彰化縣,鹿港鎮,溝墘里,294,1219,442,203,645,28,673
公投第１１案,彰化縣,鹿港鎮,廖厝里,295,1397,615,242,857,43,900
公投第１１案,彰化縣,鹿港鎮,廖厝里,296,1229,186,492,678,27,705
公投第１１案,彰化縣,鹿港鎮,廖厝里,297,1444,579,193,772,25,797
公投第１１案,彰化縣,鹿港鎮,東崎里,298,1227,489,203,692,42,734
公投第１１案,彰化縣,鹿港鎮,東崎里,299,1187,448,228,676,40,716
公投第１１案,彰化縣,鹿港鎮,東崎里,300,1296,506,190,696,18,714
公投第１１案,彰化縣,鹿港鎮,東崎里,301,1451,482,229,711,43,754
公投第１１案,彰化縣,鹿港鎮,頂厝里,302,1299,457,225,682,48,730
公投第１１案,彰化縣,鹿港鎮,頂厝里,303,1298,550,225,775,30,805
公投第１１案,彰化縣,鹿港鎮,頂厝里,304,1458,569,242,811,32,843
公投第１１案,彰化縣,鹿港鎮,頂厝里,305,1138,459,201,660,33,693
公投第１１案,彰化縣,鹿港鎮,頂厝里,306,1170,456,186,642,30,672
公投第１１案,彰化縣,鹿港鎮,頂厝里,307,1221,515,198,713,34,747
公投第１１案,彰化縣,福興鄉,三汴村,308,1363,421,271,692,44,736
公投第１１案,彰化縣,福興鄉,萬豐村,309,821,322,131,453,19,472
公投第１１案,彰化縣,福興鄉,元中村,310,1256,436,180,616,51,667
公投第１１案,彰化縣,福興鄉,外中村,311,1166,393,179,572,68,640
公投第１１案,彰化縣,福興鄉,外埔村,312,1464,518,204,722,45,767
公投第１１案,彰化縣,福興鄉,大崙村,313,1251,415,206,621,39,660
公投第１１案,彰化縣,福興鄉,番婆村,314,1465,501,231,732,44,776
公投第１１案,彰化縣,福興鄉,番婆村,315,960,323,129,452,23,475
公投第１１案,彰化縣,福興鄉,橋頭村,316,1323,458,213,671,47,718
公投第１１案,彰化縣,福興鄉,橋頭村,317,1365,491,218,709,43,752
公投第１１案,彰化縣,福興鄉,社尾村,318,1458,454,190,644,35,679
公投第１１案,彰化縣,福興鄉,番社村,319,1492,544,218,762,43,805
公投第１１案,彰化縣,福興鄉,西勢村,320,888,333,131,464,28,492
公投第１１案,彰化縣,福興鄉,西勢村,321,1054,435,163,598,27,625
公投第１１案,彰化縣,福興鄉,同安村,322,1043,366,120,486,37,523
公投第１１案,彰化縣,福興鄉,同安村,323,1340,492,198,690,52,742
公投第１１案,彰化縣,福興鄉,秀厝村,324,1085,356,184,540,35,575
公投第１１案,彰化縣,福興鄉,秀厝村,325,1392,496,212,708,28,736
公投第１１案,彰化縣,福興鄉,福興村,326,1316,529,194,723,52,775
公投第１１案,彰化縣,福興鄉,福興村,327,1255,522,210,732,29,761
公投第１１案,彰化縣,福興鄉,福興村,328,1101,468,183,651,25,676
公投第１１案,彰化縣,福興鄉,福南村,329,1167,456,146,602,56,658
公投第１１案,彰化縣,福興鄉,福南村,330,1393,492,230,722,22,744
公投第１１案,彰化縣,福興鄉,鎮平村,331,1216,483,181,664,32,696
公投第１１案,彰化縣,福興鄉,三和村,332,1063,391,144,535,33,568
公投第１１案,彰化縣,福興鄉,二港村,333,1306,453,201,654,54,708
公投第１１案,彰化縣,福興鄉,福寶村,334,1287,385,160,545,49,594
公投第１１案,彰化縣,福興鄉,頂粘村,335,994,396,138,534,24,558
公投第１１案,彰化縣,福興鄉,頂粘村,336,1311,509,171,680,60,740
公投第１１案,彰化縣,福興鄉,廈粘村,337,926,392,138,530,28,558
公投第１１案,彰化縣,福興鄉,廈粘村,338,995,325,163,488,28,516
公投第１１案,彰化縣,福興鄉,麥厝村,339,1079,443,176,619,55,674
公投第１１案,彰化縣,福興鄉,麥厝村,340,1150,432,126,558,48,606
公投第１１案,彰化縣,秀水鄉,秀水村,341,1066,435,169,604,60,664
公投第１１案,彰化縣,秀水鄉,秀水村,342,620,259,107,366,31,397
公投第１１案,彰化縣,秀水鄉,安溪村,343,876,293,146,439,19,458
公投第１１案,彰化縣,秀水鄉,安溪村,344,1196,485,221,706,29,735
公投第１１案,彰化縣,秀水鄉,莊雅村,345,1369,539,213,752,37,789
公投第１１案,彰化縣,秀水鄉,莊雅村,346,1273,508,210,718,39,757
公投第１１案,彰化縣,秀水鄉,陝西村,347,1433,545,221,766,40,806
公投第１１案,彰化縣,秀水鄉,金興村,348,967,375,176,551,23,574
公投第１１案,彰化縣,秀水鄉,金興村,349,921,376,162,538,15,553
公投第１１案,彰化縣,秀水鄉,安東村,350,689,298,118,416,19,435
公投第１１案,彰化縣,秀水鄉,安東村,351,688,263,122,385,36,421
公投第１１案,彰化縣,秀水鄉,安東村,352,1252,494,249,743,38,781
公投第１１案,彰化縣,秀水鄉,安東村,353,1281,464,212,676,43,719
公投第１１案,彰化縣,秀水鄉,鶴鳴村,354,754,283,127,410,19,429
公投第１１案,彰化縣,秀水鄉,鶴鳴村,355,1024,379,174,553,33,586
公投第１１案,彰化縣,秀水鄉,鶴鳴村,356,1433,535,230,765,25,790
公投第１１案,彰化縣,秀水鄉,馬興村,357,1366,562,272,834,46,880
公投第１１案,彰化縣,秀水鄉,馬興村,358,895,343,163,506,40,546
公投第１１案,彰化縣,秀水鄉,義興村,359,1386,439,255,694,44,738
公投第１１案,彰化縣,秀水鄉,福安村,360,896,352,138,490,54,544
公投第１１案,彰化縣,秀水鄉,福安村,361,804,349,149,498,39,537
公投第１１案,彰化縣,秀水鄉,福安村,362,827,360,145,505,19,524
公投第１１案,彰化縣,秀水鄉,福安村,363,996,389,172,561,32,593
公投第１１案,彰化縣,秀水鄉,福安村,364,931,381,197,578,41,619
公投第１１案,彰化縣,秀水鄉,埔崙村,365,715,261,129,390,21,411
公投第１１案,彰化縣,秀水鄉,埔崙村,366,1229,517,215,732,36,768
公投第１１案,彰化縣,秀水鄉,曾厝村,367,890,308,125,433,28,461
公投第１１案,彰化縣,秀水鄉,曾厝村,368,811,308,169,477,32,509
公投第１１案,彰化縣,秀水鄉,金陵村,369,786,317,142,459,31,490
公投第１１案,彰化縣,秀水鄉,金陵村,370,931,374,148,522,21,543
公投第１１案,彰化縣,秀水鄉,下崙村,371,1265,533,195,728,45,773
公投第１１案,彰化縣,秀水鄉,下崙村,372,824,326,111,437,28,465
公投第１１案,彰化縣,和美鎮,竹營里,373,1341,475,235,710,32,742
公投第１１案,彰化縣,和美鎮,竹營里,374,1480,507,227,734,38,772
公投第１１案,彰化縣,和美鎮,竹營里,375,1529,562,267,829,35,864
公投第１１案,彰化縣,和美鎮,竹營里,376,1711,605,257,862,18,880
公投第１１案,彰化縣,和美鎮,和東里,377,1057,388,206,594,24,618
公投第１１案,彰化縣,和美鎮,和東里,378,1032,370,216,586,29,615
公投第１１案,彰化縣,和美鎮,和東里,379,1015,404,195,599,24,623
公投第１１案,彰化縣,和美鎮,和東里,380,1209,487,220,707,26,733
公投第１１案,彰化縣,和美鎮,和南里,381,430,149,95,244,8,252
公投第１１案,彰化縣,和美鎮,和北里,382,856,299,166,465,18,483
公投第１１案,彰化縣,和美鎮,和北里,383,966,404,155,559,22,581
公投第１１案,彰化縣,和美鎮,和西里,384,1059,381,183,564,20,584
公投第１１案,彰化縣,和美鎮,和西里,385,1117,416,206,622,27,649
公投第１１案,彰化縣,和美鎮,和西里,386,1066,380,185,565,28,593
公投第１１案,彰化縣,和美鎮,四張里,387,1252,443,208,651,33,684
公投第１１案,彰化縣,和美鎮,四張里,388,1528,535,242,777,29,806
公投第１１案,彰化縣,和美鎮,頭前里,389,826,250,217,467,26,493
公投第１１案,彰化縣,和美鎮,頭前里,390,854,324,140,464,22,486
公投第１１案,彰化縣,和美鎮,面前里,391,1387,470,237,707,35,742
公投第１１案,彰化縣,和美鎮,面前里,392,765,342,125,467,16,483
公投第１１案,彰化縣,和美鎮,鎮平里,393,1438,526,190,716,37,753
公投第１１案,彰化縣,和美鎮,鎮平里,394,1396,553,232,785,46,831
公投第１１案,彰化縣,和美鎮,大霞里,395,658,257,111,368,16,384
公投第１１案,彰化縣,和美鎮,大霞里,396,809,349,148,497,19,516
公投第１１案,彰化縣,和美鎮,源埤里,397,932,373,136,509,8,517
公投第１１案,彰化縣,和美鎮,源埤里,398,888,340,129,469,20,489
公投第１１案,彰化縣,和美鎮,南佃里,399,1144,473,192,665,31,696
公投第１１案,彰化縣,和美鎮,南佃里,400,1077,404,174,578,34,612
公投第１１案,彰化縣,和美鎮,雅溝里,401,1349,440,227,667,46,713
公投第１１案,彰化縣,和美鎮,山犁里,402,1155,474,225,699,25,724
公投第１１案,彰化縣,和美鎮,山犁里,403,1253,464,209,673,25,698
公投第１１案,彰化縣,和美鎮,山犁里,404,1252,487,184,671,22,693
公投第１１案,彰化縣,和美鎮,山犁里,405,1474,513,259,772,27,799
公投第１１案,彰化縣,和美鎮,仁愛里,406,1396,470,224,694,27,721
公投第１１案,彰化縣,和美鎮,仁愛里,407,1348,483,229,712,23,735
公投第１１案,彰化縣,和美鎮,嘉犁里,408,999,459,141,600,21,621
公投第１１案,彰化縣,和美鎮,嘉犁里,409,911,353,171,524,26,550
公投第１１案,彰化縣,和美鎮,詔安里,410,1005,410,175,585,13,598
公投第１１案,彰化縣,和美鎮,詔安里,411,967,383,153,536,28,564
公投第１１案,彰化縣,和美鎮,鐵山里,412,1308,526,220,746,22,768
公投第１１案,彰化縣,和美鎮,鐵山里,413,1324,501,219,720,30,750
公投第１１案,彰化縣,和美鎮,柑井里,414,1102,408,207,615,44,659
公投第１１案,彰化縣,和美鎮,柑井里,415,1124,410,186,596,30,626
公投第１１案,彰化縣,和美鎮,柑井里,416,1211,460,196,656,46,702
公投第１１案,彰化縣,和美鎮,竹園里,417,884,409,156,565,35,600
公投第１１案,彰化縣,和美鎮,新庄里,418,1119,414,188,602,48,650
公投第１１案,彰化縣,和美鎮,新庄里,419,1300,473,239,712,31,743
公投第１１案,彰化縣,和美鎮,犁盛里,420,1104,382,194,576,30,606
公投第１１案,彰化縣,和美鎮,犁盛里,421,1213,496,207,703,42,745
公投第１１案,彰化縣,和美鎮,中寮里,422,1127,380,179,559,24,583
公投第１１案,彰化縣,和美鎮,中圍里,423,919,340,162,502,25,527
公投第１１案,彰化縣,和美鎮,中圍里,424,987,384,176,560,35,595
公投第１１案,彰化縣,和美鎮,中圍里,425,958,389,170,559,35,594
公投第１１案,彰化縣,和美鎮,糖友里,426,1362,543,222,765,28,793
公投第１１案,彰化縣,和美鎮,糖友里,427,1461,541,247,788,25,813
公投第１１案,彰化縣,和美鎮,糖友里,428,1405,546,257,803,23,826
公投第１１案,彰化縣,和美鎮,還社里,429,860,333,160,493,28,521
公投第１１案,彰化縣,和美鎮,塗厝里,430,875,351,118,469,21,490
公投第１１案,彰化縣,和美鎮,塗厝里,431,871,323,156,479,30,509
公投第１１案,彰化縣,和美鎮,地潭里,432,883,340,175,515,36,551
公投第１１案,彰化縣,和美鎮,湖內里,433,1224,421,223,644,45,689
公投第１１案,彰化縣,和美鎮,嘉寶里,434,1075,379,192,571,31,602
公投第１１案,彰化縣,和美鎮,嘉寶里,435,956,333,180,513,28,541
公投第１１案,彰化縣,和美鎮,月眉里,436,1037,367,177,544,42,586
公投第１１案,彰化縣,和美鎮,月眉里,437,1011,394,160,554,21,575
公投第１１案,彰化縣,和美鎮,月眉里,438,1023,346,204,550,39,589
公投第１１案,彰化縣,和美鎮,好修里,439,719,255,111,366,27,393
公投第１１案,彰化縣,和美鎮,好修里,440,913,325,161,486,32,518
公投第１１案,彰化縣,伸港鄉,大同村,441,1182,386,184,570,37,607
公投第１１案,彰化縣,伸港鄉,大同村,442,1166,485,201,686,34,720
公投第１１案,彰化縣,伸港鄉,海尾村,443,966,369,160,529,29,558
公投第１１案,彰化縣,伸港鄉,海尾村,444,873,323,143,466,27,493
公投第１１案,彰化縣,伸港鄉,全興村,445,812,320,140,460,30,490
公投第１１案,彰化縣,伸港鄉,全興村,446,875,308,156,464,28,492
公投第１１案,彰化縣,伸港鄉,溪底村,447,904,312,161,473,38,511
公投第１１案,彰化縣,伸港鄉,溪底村,448,1008,360,165,525,35,560
公投第１１案,彰化縣,伸港鄉,定興村,449,1154,450,193,643,38,681
公投第１１案,彰化縣,伸港鄉,定興村,450,1486,483,235,718,65,783
公投第１１案,彰化縣,伸港鄉,什股村,451,1095,410,160,570,40,610
公投第１１案,彰化縣,伸港鄉,什股村,452,1087,367,174,541,17,558
公投第１１案,彰化縣,伸港鄉,泉州村,453,1085,404,187,591,55,646
公投第１１案,彰化縣,伸港鄉,泉州村,454,908,364,148,512,31,543
公投第１１案,彰化縣,伸港鄉,泉厝村,455,1264,529,201,730,12,742
公投第１１案,彰化縣,伸港鄉,曾家村,456,854,317,123,440,38,478
公投第１１案,彰化縣,伸港鄉,曾家村,457,846,276,129,405,25,430
公投第１１案,彰化縣,伸港鄉,蚵寮村,458,1143,325,198,523,88,611
公投第１１案,彰化縣,伸港鄉,新港村,459,1357,496,236,732,28,760
公投第１１案,彰化縣,伸港鄉,新港村,460,1349,449,249,698,40,738
公投第１１案,彰化縣,伸港鄉,新港村,461,1154,431,196,627,49,676
公投第１１案,彰化縣,伸港鄉,新港村,462,1279,431,237,668,29,697
公投第１１案,彰化縣,伸港鄉,埤墘村,463,1317,502,233,735,43,778
公投第１１案,彰化縣,伸港鄉,七嘉村,464,990,396,180,576,31,607
公投第１１案,彰化縣,伸港鄉,七嘉村,465,852,324,162,486,20,506
公投第１１案,彰化縣,伸港鄉,七嘉村,466,1178,450,209,659,17,676
公投第１１案,彰化縣,伸港鄉,汴頭村,467,1088,386,173,559,59,618
公投第１１案,彰化縣,伸港鄉,汴頭村,468,1135,406,199,605,45,650
公投第１１案,彰化縣,線西鄉,線西村,469,1071,427,187,614,15,629
公投第１１案,彰化縣,線西鄉,線西村,470,1166,470,202,672,27,699
公投第１１案,彰化縣,線西鄉,頂庄村,471,1269,486,197,683,72,755
公投第１１案,彰化縣,線西鄉,寓埔村,472,1138,432,179,611,39,650
公投第１１案,彰化縣,線西鄉,寓埔村,473,1128,464,195,659,64,723
公投第１１案,彰化縣,線西鄉,塭仔村,474,1275,468,242,710,63,773
公投第１１案,彰化縣,線西鄉,溝內村,475,1187,449,213,662,47,709
公投第１１案,彰化縣,線西鄉,下犁村,476,991,405,160,565,39,604
公投第１１案,彰化縣,線西鄉,下犁村,477,938,362,156,518,48,566
公投第１１案,彰化縣,線西鄉,頂犁村,478,1276,451,182,633,48,681
公投第１１案,彰化縣,線西鄉,頂犁村,479,1285,487,224,711,50,761
公投第１１案,彰化縣,線西鄉,德興村,480,1341,601,226,827,51,878
公投第１１案,彰化縣,員林市,崙雅里,481,1087,418,133,551,16,567
公投第１１案,彰化縣,員林市,崙雅里,482,1353,480,207,687,26,713
公投第１１案,彰化縣,員林市,振興里,483,1313,453,212,665,37,702
公投第１１案,彰化縣,員林市,振興里,484,1328,421,182,603,31,634
公投第１１案,彰化縣,員林市,林厝里,485,1055,396,183,579,21,600
公投第１１案,彰化縣,員林市,林厝里,486,959,354,150,504,29,533
公投第１１案,彰化縣,員林市,林厝里,487,772,300,122,422,29,451
公投第１１案,彰化縣,員林市,出水里,488,831,151,325,476,34,510
公投第１１案,彰化縣,員林市,出水里,489,854,256,119,375,12,387
公投第１１案,彰化縣,員林市,湖水里,490,1190,382,138,520,21,541
公投第１１案,彰化縣,員林市,大峯里,491,726,265,116,381,20,401
公投第１１案,彰化縣,員林市,鎮興里,492,1124,405,202,607,24,631
公投第１１案,彰化縣,員林市,鎮興里,493,860,279,145,424,23,447
公投第１１案,彰化縣,員林市,浮圳里,494,1122,462,194,656,29,685
公投第１１案,彰化縣,員林市,浮圳里,495,1075,421,186,607,31,638
公投第１１案,彰化縣,員林市,西東里,496,993,368,151,519,31,550
公投第１１案,彰化縣,員林市,西東里,497,967,368,137,505,23,528
公投第１１案,彰化縣,員林市,南東里,498,1008,379,172,551,30,581
公投第１１案,彰化縣,員林市,南東里,499,804,296,135,431,27,458
公投第１１案,彰化縣,員林市,中東里,500,867,309,152,461,24,485
公投第１１案,彰化縣,員林市,中東里,501,885,332,136,468,15,483
公投第１１案,彰化縣,員林市,東北里,502,1097,328,170,498,15,513
公投第１１案,彰化縣,員林市,東北里,503,1255,467,191,658,20,678
公投第１１案,彰化縣,員林市,東和里,504,1063,401,187,588,31,619
公投第１１案,彰化縣,員林市,民生里,505,925,318,181,499,18,517
公投第１１案,彰化縣,員林市,民生里,506,947,393,141,534,25,559
公投第１１案,彰化縣,員林市,民生里,507,916,375,154,529,18,547
公投第１１案,彰化縣,員林市,黎明里,508,862,315,155,470,11,481
公投第１１案,彰化縣,員林市,黎明里,509,987,384,168,552,16,568
公投第１１案,彰化縣,員林市,惠來里,510,1085,412,155,567,32,599
公投第１１案,彰化縣,員林市,惠來里,511,1110,418,197,615,19,634
公投第１１案,彰化縣,員林市,惠來里,512,1095,389,175,564,25,589
公投第１１案,彰化縣,員林市,惠來里,513,1278,516,242,758,27,785
公投第１１案,彰化縣,員林市,惠來里,514,1109,439,187,626,29,655
公投第１１案,彰化縣,員林市,中央里,515,1055,406,166,572,33,605
公投第１１案,彰化縣,員林市,中央里,516,876,329,155,484,27,511
公投第１１案,彰化縣,員林市,溝皂里,517,1115,370,165,535,20,555
公投第１１案,彰化縣,員林市,溝皂里,518,1186,479,198,677,12,689
公投第１１案,彰化縣,員林市,大饒里,519,995,401,163,564,38,602
公投第１１案,彰化縣,員林市,大饒里,520,999,378,148,526,16,542
公投第１１案,彰化縣,員林市,大饒里,521,1201,454,196,650,17,667
公投第１１案,彰化縣,員林市,大明里,522,1342,512,221,733,18,751
公投第１１案,彰化縣,員林市,大明里,523,1086,402,174,576,28,604
公投第１１案,彰化縣,員林市,萬年里,524,854,300,131,431,27,458
公投第１１案,彰化縣,員林市,萬年里,525,1064,424,156,580,26,606
公投第１１案,彰化縣,員林市,萬年里,526,879,359,170,529,6,535
公投第１１案,彰化縣,員林市,萬年里,527,827,384,160,544,19,563
公投第１１案,彰化縣,員林市,中正里,528,867,335,148,483,7,490
公投第１１案,彰化縣,員林市,中正里,529,1201,469,191,660,20,680
公投第１１案,彰化縣,員林市,中正里,530,1106,439,183,622,22,644
公投第１１案,彰化縣,員林市,仁美里,531,845,327,162,489,20,509
公投第１１案,彰化縣,員林市,仁美里,532,894,337,174,511,15,526
公投第１１案,彰化縣,員林市,仁美里,533,849,337,147,484,17,501
公投第１１案,彰化縣,員林市,新興里,534,747,302,148,450,23,473
公投第１１案,彰化縣,員林市,和平里,535,884,342,182,524,28,552
公投第１１案,彰化縣,員林市,和平里,536,900,313,132,445,24,469
公投第１１案,彰化縣,員林市,和平里,537,1040,487,145,632,18,650
公投第１１案,彰化縣,員林市,光明里,538,831,311,152,463,14,477
公投第１１案,彰化縣,員林市,中山里,539,591,244,122,366,27,393
公投第１１案,彰化縣,員林市,三條里,540,1330,479,223,702,19,721
公投第１１案,彰化縣,員林市,三條里,541,1295,479,231,710,23,733
公投第１１案,彰化縣,員林市,忠孝里,542,1283,449,232,681,36,717
公投第１１案,彰化縣,員林市,忠孝里,543,943,396,161,557,16,573
公投第１１案,彰化縣,員林市,仁愛里,544,1388,575,255,830,34,864
公投第１１案,彰化縣,員林市,三和里,545,1176,450,224,674,19,693
公投第１１案,彰化縣,員林市,三和里,546,867,311,135,446,7,453
公投第１１案,彰化縣,員林市,三和里,547,1121,382,222,604,22,626
公投第１１案,彰化縣,員林市,三和里,548,1190,417,199,616,16,632
公投第１１案,彰化縣,員林市,三和里,549,945,390,157,547,20,567
公投第１１案,彰化縣,員林市,三和里,550,906,372,156,528,21,549
公投第１１案,彰化縣,員林市,三橋里,551,978,375,198,573,23,596
公投第１１案,彰化縣,員林市,三橋里,552,949,370,157,527,33,560
公投第１１案,彰化縣,員林市,三橋里,553,949,386,162,548,24,572
公投第１１案,彰化縣,員林市,三愛里,554,1006,391,162,553,20,573
公投第１１案,彰化縣,員林市,三愛里,555,889,328,175,503,25,528
公投第１１案,彰化縣,員林市,三愛里,556,923,378,179,557,14,571
公投第１１案,彰化縣,員林市,三信里,557,1209,487,236,723,29,752
公投第１１案,彰化縣,員林市,三信里,558,1075,433,193,626,23,649
公投第１１案,彰化縣,員林市,三多里,559,1342,532,265,797,26,823
公投第１１案,彰化縣,員林市,三多里,560,1039,421,250,671,21,692
公投第１１案,彰化縣,員林市,三義里,561,1131,415,161,576,57,633
公投第１１案,彰化縣,員林市,三義里,562,1356,448,233,681,27,708
公投第１１案,彰化縣,員林市,新生里,563,1370,482,251,733,41,774
公投第１１案,彰化縣,員林市,新生里,564,1090,384,225,609,25,634
公投第１１案,彰化縣,員林市,新生里,565,821,329,190,519,15,534
公投第１１案,彰化縣,員林市,新生里,566,910,372,150,522,21,543
公投第１１案,彰化縣,員林市,南平里,567,1203,460,203,663,21,684
公投第１１案,彰化縣,員林市,南平里,568,1378,474,276,750,24,774
公投第１１案,彰化縣,員林市,南平里,569,1352,523,215,738,32,770
公投第１１案,彰化縣,員林市,南平里,570,1060,436,206,642,19,661
公投第１１案,彰化縣,員林市,南興里,571,1317,481,207,688,37,725
公投第１１案,彰化縣,員林市,南興里,572,1120,399,192,591,26,617
公投第１１案,彰化縣,員林市,南興里,573,1025,390,127,517,38,555
公投第１１案,彰化縣,員林市,南興里,574,1097,424,168,592,36,628
公投第１１案,彰化縣,員林市,源潭里,575,859,331,171,502,29,531
公投第１１案,彰化縣,員林市,源潭里,576,837,305,144,449,19,468
公投第１１案,彰化縣,員林市,大埔里,577,1090,463,197,660,25,685
公投第１１案,彰化縣,員林市,大埔里,578,1073,401,179,580,38,618
公投第１１案,彰化縣,大村鄉,大村村,579,1426,581,274,855,52,907
公投第１１案,彰化縣,大村鄉,大村村,580,1726,697,315,1012,48,1060
公投第１１案,彰化縣,大村鄉,茄苳村,581,797,340,136,476,35,511
公投第１１案,彰化縣,大村鄉,茄苳村,582,745,296,126,422,24,446
公投第１１案,彰化縣,大村鄉,田洋村,583,1125,483,143,626,59,685
公投第１１案,彰化縣,大村鄉,貢旗村,584,1486,548,260,808,56,864
公投第１１案,彰化縣,大村鄉,南勢村,585,1426,534,242,776,58,834
公投第１１案,彰化縣,大村鄉,大橋村,586,824,345,145,490,34,524
公投第１１案,彰化縣,大村鄉,大橋村,587,1177,407,185,592,32,624
公投第１１案,彰化縣,大村鄉,加錫村,588,1478,560,273,833,49,882
公投第１１案,彰化縣,大村鄉,大崙村,589,779,276,132,408,16,424
公投第１１案,彰化縣,大村鄉,大崙村,590,812,321,152,473,35,508
公投第１１案,彰化縣,大村鄉,新興村,591,1161,419,185,604,43,647
公投第１１案,彰化縣,大村鄉,擺塘村,592,1238,441,197,638,29,667
公投第１１案,彰化縣,大村鄉,擺塘村,593,1259,484,201,685,43,728
公投第１１案,彰化縣,大村鄉,過溝村,594,1412,521,250,771,50,821
公投第１１案,彰化縣,大村鄉,過溝村,595,1401,530,249,779,24,803
公投第１１案,彰化縣,大村鄉,村上村,596,1395,537,252,789,54,843
公投第１１案,彰化縣,大村鄉,美港村,597,996,374,189,563,35,598
公投第１１案,彰化縣,大村鄉,美港村,598,1047,402,177,579,34,613
公投第１１案,彰化縣,大村鄉,美港村,599,985,398,154,552,32,584
公投第１１案,彰化縣,大村鄉,黃厝村,600,1054,431,187,618,42,660
公投第１１案,彰化縣,大村鄉,黃厝村,601,1200,491,189,680,31,711
公投第１１案,彰化縣,大村鄉,福興村,602,1003,383,186,569,49,618
公投第１１案,彰化縣,大村鄉,福興村,603,1046,353,187,540,35,575
公投第１１案,彰化縣,大村鄉,平和村,604,1189,455,222,677,38,715
公投第１１案,彰化縣,大村鄉,平和村,605,1305,484,196,680,32,712
公投第１１案,彰化縣,永靖鄉,浮圳村,606,1255,438,183,621,44,665
公投第１１案,彰化縣,永靖鄉,東寧村,607,889,352,153,505,42,547
公投第１１案,彰化縣,永靖鄉,東寧村,608,1026,376,183,559,23,582
公投第１１案,彰化縣,永靖鄉,光雲村,609,724,303,116,419,33,452
公投第１１案,彰化縣,永靖鄉,光雲村,610,924,349,165,514,37,551
公投第１１案,彰化縣,永靖鄉,五汴村,611,659,271,121,392,26,418
公投第１１案,彰化縣,永靖鄉,五汴村,612,734,260,144,404,30,434
公投第１１案,彰化縣,永靖鄉,永興村,613,758,238,119,357,18,375
公投第１１案,彰化縣,永靖鄉,永興村,614,848,366,150,516,35,551
公投第１１案,彰化縣,永靖鄉,崙子村,615,1404,480,219,699,54,753
公投第１１案,彰化縣,永靖鄉,永東村,616,792,355,167,522,28,550
公投第１１案,彰化縣,永靖鄉,永西村,617,695,275,152,427,23,450
公投第１１案,彰化縣,永靖鄉,永西村,618,821,342,147,489,20,509
公投第１１案,彰化縣,永靖鄉,永南村,619,1064,440,187,627,46,673
公投第１１案,彰化縣,永靖鄉,永南村,620,840,307,146,453,31,484
公投第１１案,彰化縣,永靖鄉,永北村,621,1079,412,225,637,28,665
公投第１１案,彰化縣,永靖鄉,永北村,622,1048,416,207,623,31,654
公投第１１案,彰化縣,永靖鄉,港西村,623,960,418,162,580,43,623
公投第１１案,彰化縣,永靖鄉,港西村,624,798,314,166,480,16,496
公投第１１案,彰化縣,永靖鄉,五福村,625,796,349,139,488,31,519
公投第１１案,彰化縣,永靖鄉,五福村,626,662,257,100,357,29,386
公投第１１案,彰化縣,永靖鄉,湳港村,627,1040,404,173,577,30,607
公投第１１案,彰化縣,永靖鄉,新莊村,628,1025,390,162,552,40,592
公投第１１案,彰化縣,永靖鄉,瑚璉村,629,1357,598,233,831,44,875
公投第１１案,彰化縣,永靖鄉,瑚璉村,630,1236,474,220,694,47,741
公投第１１案,彰化縣,永靖鄉,獨鰲村,631,871,346,140,486,38,524
公投第１１案,彰化縣,永靖鄉,敦厚村,632,706,245,112,357,28,385
公投第１１案,彰化縣,永靖鄉,崙美村,633,770,321,144,465,34,499
公投第１１案,彰化縣,永靖鄉,同安村,634,669,297,124,421,17,438
公投第１１案,彰化縣,永靖鄉,同仁村,635,862,335,136,471,35,506
公投第１１案,彰化縣,永靖鄉,湳墘村,636,847,330,126,456,23,479
公投第１１案,彰化縣,永靖鄉,四芳村,637,668,267,122,389,41,430
公投第１１案,彰化縣,永靖鄉,福興村,638,1073,387,156,543,26,569
公投第１１案,彰化縣,永靖鄉,竹子村,639,1339,464,190,654,41,695
公投第１１案,彰化縣,溪湖鎮,光平里,640,1221,460,195,655,25,680
公投第１１案,彰化縣,溪湖鎮,平和里,641,638,258,124,382,27,409
公投第１１案,彰化縣,溪湖鎮,太平里,642,817,309,146,455,32,487
公投第１１案,彰化縣,溪湖鎮,太平里,643,968,422,141,563,23,586
公投第１１案,彰化縣,溪湖鎮,光華里,644,448,197,92,289,6,295
公投第１１案,彰化縣,溪湖鎮,湖東里,645,1123,434,158,592,21,613
公投第１１案,彰化縣,溪湖鎮,湖東里,646,1166,428,197,625,36,661
公投第１１案,彰化縣,溪湖鎮,湖東里,647,1151,431,180,611,27,638
公投第１１案,彰化縣,溪湖鎮,湖東里,648,1249,492,207,699,22,721
公投第１１案,彰化縣,溪湖鎮,中山里,649,1146,471,177,648,34,682
公投第１１案,彰化縣,溪湖鎮,中山里,650,1199,473,169,642,53,695
公投第１１案,彰化縣,溪湖鎮,西溪里,651,895,337,156,493,28,521
公投第１１案,彰化縣,溪湖鎮,西溪里,652,964,425,150,575,16,591
公投第１１案,彰化縣,溪湖鎮,中竹里,653,851,311,164,475,26,501
公投第１１案,彰化縣,溪湖鎮,東寮里,654,1072,422,164,586,31,617
公投第１１案,彰化縣,溪湖鎮,東寮里,655,1113,438,188,626,40,666
公投第１１案,彰化縣,溪湖鎮,東寮里,656,1090,416,207,623,31,654
公投第１１案,彰化縣,溪湖鎮,西寮里,657,1193,496,186,682,36,718
公投第１１案,彰化縣,溪湖鎮,西寮里,658,952,430,133,563,33,596
公投第１１案,彰化縣,溪湖鎮,大突里,659,1172,444,195,639,41,680
公投第１１案,彰化縣,溪湖鎮,大突里,660,1027,371,189,560,32,592
公投第１１案,彰化縣,溪湖鎮,大突里,661,1188,507,215,722,24,746
公投第１１案,彰化縣,溪湖鎮,北勢里,662,1403,492,226,718,36,754
公投第１１案,彰化縣,溪湖鎮,汴頭里,663,1397,438,236,674,49,723
公投第１１案,彰化縣,溪湖鎮,汴頭里,664,1636,601,282,883,51,934
公投第１１案,彰化縣,溪湖鎮,大竹里,665,1298,528,101,629,44,673
公投第１１案,彰化縣,溪湖鎮,大竹里,666,1214,482,181,663,42,705
公投第１１案,彰化縣,溪湖鎮,湖西里,667,1297,522,228,750,26,776
公投第１１案,彰化縣,溪湖鎮,湖西里,668,968,411,171,582,23,605
公投第１１案,彰化縣,溪湖鎮,田中里,669,839,327,146,473,33,506
公投第１１案,彰化縣,溪湖鎮,河東里,670,907,355,154,509,41,550
公投第１１案,彰化縣,溪湖鎮,河東里,671,898,325,127,452,19,471
公投第１１案,彰化縣,溪湖鎮,頂庄里,672,650,296,129,425,24,449
公投第１１案,彰化縣,溪湖鎮,忠覺里,673,1279,171,504,675,62,737
公投第１１案,彰化縣,溪湖鎮,湳底里,674,730,325,116,441,24,465
公投第１１案,彰化縣,溪湖鎮,大庭里,675,1407,550,222,772,53,825
公投第１１案,彰化縣,溪湖鎮,媽厝里,676,1273,412,183,595,45,640
公投第１１案,彰化縣,溪湖鎮,番婆里,677,988,351,165,516,30,546
公投第１１案,彰化縣,溪湖鎮,番婆里,678,754,301,147,448,33,481
公投第１１案,彰化縣,溪湖鎮,西勢里,679,1052,324,157,481,46,527
公投第１１案,彰化縣,溪湖鎮,西勢里,680,1149,400,187,587,32,619
公投第１１案,彰化縣,溪湖鎮,東溪里,681,1365,542,267,809,68,877
公投第１１案,彰化縣,埔鹽鄉,埔鹽村,682,958,417,147,564,31,595
公投第１１案,彰化縣,埔鹽鄉,埔鹽村,683,754,341,125,466,23,489
公投第１１案,彰化縣,埔鹽鄉,埔南村,684,757,318,159,477,25,502
公投第１１案,彰化縣,埔鹽鄉,埔南村,685,806,323,149,472,33,505
公投第１１案,彰化縣,埔鹽鄉,廍子村,686,1280,554,173,727,37,764
公投第１１案,彰化縣,埔鹽鄉,出水村,687,928,357,156,513,39,552
公投第１１案,彰化縣,埔鹽鄉,南港村,688,895,391,162,553,40,593
公投第１１案,彰化縣,埔鹽鄉,南港村,689,815,350,132,482,41,523
公投第１１案,彰化縣,埔鹽鄉,打廉村,690,957,356,172,528,32,560
公投第１１案,彰化縣,埔鹽鄉,豐澤村,691,1338,538,191,729,67,796
公投第１１案,彰化縣,埔鹽鄉,崑崙村,692,1106,404,179,583,55,638
公投第１１案,彰化縣,埔鹽鄉,角樹村,693,690,333,127,460,20,480
公投第１１案,彰化縣,埔鹽鄉,瓦磘村,694,1230,471,192,663,41,704
公投第１１案,彰化縣,埔鹽鄉,好修村,695,847,322,158,480,27,507
公投第１１案,彰化縣,埔鹽鄉,好修村,696,897,428,115,543,19,562
公投第１１案,彰化縣,埔鹽鄉,西湖村,697,882,336,154,490,41,531
公投第１１案,彰化縣,埔鹽鄉,西湖村,698,1180,505,173,678,39,717
公投第１１案,彰化縣,埔鹽鄉,大有村,699,1215,462,191,653,53,706
公投第１１案,彰化縣,埔鹽鄉,新興村,700,422,196,66,262,20,282
公投第１１案,彰化縣,埔鹽鄉,永平村,701,1106,440,132,572,46,618
公投第１１案,彰化縣,埔鹽鄉,永樂村,702,874,395,115,510,52,562
公投第１１案,彰化縣,埔鹽鄉,石埤村,703,1445,510,236,746,112,858
公投第１１案,彰化縣,埔鹽鄉,天盛村,704,875,354,147,501,48,549
公投第１１案,彰化縣,埔鹽鄉,太平村,705,837,298,114,412,35,447
公投第１１案,彰化縣,埔鹽鄉,太平村,706,685,294,88,382,31,413
公投第１１案,彰化縣,埔鹽鄉,新水村,707,733,306,136,442,31,473
公投第１１案,彰化縣,埔鹽鄉,新水村,708,798,340,122,462,40,502
公投第１１案,彰化縣,埔鹽鄉,三省村,709,1381,548,187,735,60,795
公投第１１案,彰化縣,埔鹽鄉,南新村,710,1335,497,181,678,42,720
公投第１１案,彰化縣,埔心鄉,東門村,711,1139,452,210,662,51,713
公投第１１案,彰化縣,埔心鄉,東門村,712,1217,466,208,674,43,717
公投第１１案,彰化縣,埔心鄉,東門村,713,1248,493,260,753,20,773
公投第１１案,彰化縣,埔心鄉,埔心村,714,1248,502,246,748,59,807
公投第１１案,彰化縣,埔心鄉,義民村,715,916,383,153,536,30,566
公投第１１案,彰化縣,埔心鄉,義民村,716,625,252,134,386,23,409
公投第１１案,彰化縣,埔心鄉,油車村,717,1271,454,224,678,57,735
公投第１１案,彰化縣,埔心鄉,瓦北村,718,608,287,89,376,20,396
公投第１１案,彰化縣,埔心鄉,瓦北村,719,1132,478,167,645,56,701
公投第１１案,彰化縣,埔心鄉,瓦中村,720,1027,428,169,597,44,641
公投第１１案,彰化縣,埔心鄉,瓦中村,721,926,382,172,554,36,590
公投第１１案,彰化縣,埔心鄉,瓦南村,722,778,300,140,440,42,482
公投第１１案,彰化縣,埔心鄉,瓦南村,723,660,295,115,410,23,433
公投第１１案,彰化縣,埔心鄉,經口村,724,1330,539,234,773,43,816
公投第１１案,彰化縣,埔心鄉,經口村,725,991,381,208,589,19,608
公投第１１案,彰化縣,埔心鄉,太平村,726,985,408,177,585,27,612
公投第１１案,彰化縣,埔心鄉,太平村,727,1034,366,193,559,36,595
公投第１１案,彰化縣,埔心鄉,大華村,728,612,253,110,363,37,400
公投第１１案,彰化縣,埔心鄉,仁里村,729,1236,517,228,745,44,789
公投第１１案,彰化縣,埔心鄉,舊舘村,730,775,337,125,462,32,494
公投第１１案,彰化縣,埔心鄉,舊舘村,731,738,316,157,473,25,498
公投第１１案,彰化縣,埔心鄉,南舘村,732,1036,407,203,610,29,639
公投第１１案,彰化縣,埔心鄉,新舘村,733,975,341,187,528,38,566
公投第１１案,彰化縣,埔心鄉,芎蕉村,734,885,341,147,488,36,524
公投第１１案,彰化縣,埔心鄉,芎蕉村,735,939,372,180,552,41,593
公投第１１案,彰化縣,埔心鄉,羅厝村,736,689,299,97,396,23,419
公投第１１案,彰化縣,埔心鄉,羅厝村,737,659,271,101,372,28,400
公投第１１案,彰化縣,埔心鄉,梧鳳村,738,910,337,146,483,30,513
公投第１１案,彰化縣,埔心鄉,二重村,739,1352,581,264,845,48,893
公投第１１案,彰化縣,埔心鄉,埤霞村,740,759,286,138,424,20,444
公投第１１案,彰化縣,埔心鄉,埤脚村,741,942,356,165,521,47,568
公投第１１案,彰化縣,田中鎮,香山里,742,854,308,134,442,39,481
公投第１１案,彰化縣,田中鎮,碧峰里,743,963,139,327,466,26,492
公投第１１案,彰化縣,田中鎮,碧峰里,744,175,31,9,40,5,45
公投第１１案,彰化縣,田中鎮,東源里,745,739,275,102,377,19,396
公投第１１案,彰化縣,田中鎮,復興里,746,826,323,109,432,15,447
公投第１１案,彰化縣,田中鎮,復興里,747,741,306,116,422,30,452
公投第１１案,彰化縣,田中鎮,平和里,748,506,160,70,230,9,239
公投第１１案,彰化縣,田中鎮,平和里,749,1001,316,152,468,54,522
公投第１１案,彰化縣,田中鎮,頂潭里,750,1281,517,181,698,45,743
公投第１１案,彰化縣,田中鎮,新庄里,751,1035,404,168,572,26,598
公投第１１案,彰化縣,田中鎮,新庄里,752,1327,529,219,748,33,781
公投第１１案,彰化縣,田中鎮,中潭里,753,844,366,136,502,21,523
公投第１１案,彰化縣,田中鎮,中潭里,754,913,357,146,503,25,528
公投第１１案,彰化縣,田中鎮,龍潭里,755,613,282,98,380,26,406
公投第１１案,彰化縣,田中鎮,北路里,756,1382,552,219,771,52,823
公投第１１案,彰化縣,田中鎮,北路里,757,1034,454,181,635,37,672
公投第１１案,彰化縣,田中鎮,北路里,758,935,433,162,595,22,617
公投第１１案,彰化縣,田中鎮,西路里,759,1301,501,209,710,37,747
公投第１１案,彰化縣,田中鎮,西路里,760,1100,463,177,640,22,662
公投第１１案,彰化縣,田中鎮,東路里,761,1071,430,187,617,36,653
公投第１１案,彰化縣,田中鎮,南路里,762,1163,520,167,687,35,722
公投第１１案,彰化縣,田中鎮,中路里,763,809,369,138,507,28,535
公投第１１案,彰化縣,田中鎮,中路里,764,1155,475,213,688,28,716
公投第１１案,彰化縣,田中鎮,梅州里,765,1270,477,205,682,49,731
公投第１１案,彰化縣,田中鎮,三安里,766,870,310,150,460,30,490
公投第１１案,彰化縣,田中鎮,三安里,767,736,274,117,391,38,429
公投第１１案,彰化縣,田中鎮,大崙里,768,1335,478,189,667,34,701
公投第１１案,彰化縣,田中鎮,沙崙里,769,876,312,162,474,28,502
公投第１１案,彰化縣,田中鎮,沙崙里,770,898,295,167,462,35,497
公投第１１案,彰化縣,田中鎮,新民里,771,1298,525,217,742,19,761
公投第１１案,彰化縣,田中鎮,新民里,772,1451,536,243,779,40,819
公投第１１案,彰化縣,田中鎮,新民里,773,1475,550,256,806,34,840
公投第１１案,彰化縣,田中鎮,三民里,774,766,252,112,364,37,401
公投第１１案,彰化縣,田中鎮,三民里,775,810,321,104,425,19,444
公投第１１案,彰化縣,田中鎮,三光里,776,953,322,208,530,43,573
公投第１１案,彰化縣,田中鎮,大社里,777,885,375,142,517,40,557
公投第１１案,彰化縣,社頭鄉,社頭村,778,791,289,149,438,30,468
公投第１１案,彰化縣,社頭鄉,社頭村,779,984,367,168,535,27,562
公投第１１案,彰化縣,社頭鄉,社頭村,780,990,356,165,521,17,538
公投第１１案,彰化縣,社頭鄉,廣興村,781,1016,440,166,606,25,631
公投第１１案,彰化縣,社頭鄉,廣興村,782,1091,632,3,635,24,659
公投第１１案,彰化縣,社頭鄉,廣興村,783,1236,470,228,698,45,743
公投第１１案,彰化縣,社頭鄉,廣興村,784,1203,441,202,643,21,664
公投第１１案,彰化縣,社頭鄉,東興村,785,753,285,125,410,17,427
公投第１１案,彰化縣,社頭鄉,東興村,786,725,211,138,349,37,386
公投第１１案,彰化縣,社頭鄉,松竹村,787,1023,412,169,581,43,624
公投第１１案,彰化縣,社頭鄉,舊社村,788,562,244,123,367,15,382
公投第１１案,彰化縣,社頭鄉,舊社村,789,1049,393,174,567,24,591
公投第１１案,彰化縣,社頭鄉,廣福村,790,933,385,147,532,30,562
公投第１１案,彰化縣,社頭鄉,橋頭村,791,990,414,161,575,31,606
公投第１１案,彰化縣,社頭鄉,橋頭村,792,1076,395,173,568,22,590
公投第１１案,彰化縣,社頭鄉,新厝村,793,742,304,146,450,8,458
公投第１１案,彰化縣,社頭鄉,新厝村,794,672,273,99,372,15,387
公投第１１案,彰化縣,社頭鄉,張厝村,795,1235,438,162,600,31,631
公投第１１案,彰化縣,社頭鄉,湳底村,796,750,296,134,430,25,455
公投第１１案,彰化縣,社頭鄉,湳底村,797,895,306,150,456,32,488
公投第１１案,彰化縣,社頭鄉,仁雅村,798,688,286,111,397,15,412
公投第１１案,彰化縣,社頭鄉,仁雅村,799,870,362,119,481,12,493
公投第１１案,彰化縣,社頭鄉,仁雅村,800,1140,474,183,657,31,688
公投第１１案,彰化縣,社頭鄉,里仁村,801,985,402,144,546,38,584
公投第１１案,彰化縣,社頭鄉,美雅村,802,1266,534,200,734,56,790
公投第１１案,彰化縣,社頭鄉,崙雅村,803,937,370,160,530,25,555
公投第１１案,彰化縣,社頭鄉,清水村,804,1219,478,189,667,25,692
公投第１１案,彰化縣,社頭鄉,山湖村,805,1165,445,183,628,52,680
公投第１１案,彰化縣,社頭鄉,埤斗村,806,986,384,152,536,54,590
公投第１１案,彰化縣,社頭鄉,仁和村,807,724,287,144,431,28,459
公投第１１案,彰化縣,社頭鄉,平和村,808,1015,409,148,557,34,591
公投第１１案,彰化縣,社頭鄉,協和村,809,1116,370,174,544,28,572
公投第１１案,彰化縣,社頭鄉,協和村,810,1061,379,168,547,29,576
公投第１１案,彰化縣,社頭鄉,泰安村,811,992,387,185,572,29,601
公投第１１案,彰化縣,社頭鄉,朝興村,812,1092,398,188,586,19,605
公投第１１案,彰化縣,社頭鄉,龍井村,813,828,352,135,487,22,509
公投第１１案,彰化縣,社頭鄉,湳雅村,814,787,251,137,388,34,422
公投第１１案,彰化縣,社頭鄉,湳雅村,815,719,233,114,347,21,368
公投第１１案,彰化縣,二水鄉,復興村,816,1028,383,177,560,50,610
公投第１１案,彰化縣,二水鄉,十五村,817,689,284,108,392,41,433
公投第１１案,彰化縣,二水鄉,合和村,818,871,324,118,442,39,481
公投第１１案,彰化縣,二水鄉,上豊村,819,953,392,131,523,49,572
公投第１１案,彰化縣,二水鄉,過圳村,820,624,235,86,321,26,347
公投第１１案,彰化縣,二水鄉,五伯村,821,645,280,122,402,32,434
公投第１１案,彰化縣,二水鄉,文化村,822,986,466,161,627,23,650
公投第１１案,彰化縣,二水鄉,光化村,823,943,407,167,574,50,624
公投第１１案,彰化縣,二水鄉,聖化村,824,455,208,75,283,4,287
公投第１１案,彰化縣,二水鄉,二水村,825,831,391,140,531,28,559
公投第１１案,彰化縣,二水鄉,惠民村,826,831,346,138,484,34,518
公投第１１案,彰化縣,二水鄉,裕民村,827,1013,372,164,536,30,566
公投第１１案,彰化縣,二水鄉,大園村,828,796,349,126,475,30,505
公投第１１案,彰化縣,二水鄉,修仁村,829,781,309,104,413,42,455
公投第１１案,彰化縣,二水鄉,合興村,830,692,240,110,350,18,368
公投第１１案,彰化縣,二水鄉,源泉村,831,635,254,100,354,19,373
公投第１１案,彰化縣,二水鄉,倡和村,832,566,210,92,302,30,332
公投第１１案,彰化縣,北斗鎮,中寮里,833,925,352,129,481,40,521
公投第１１案,彰化縣,北斗鎮,中寮里,834,869,357,134,491,38,529
公投第１１案,彰化縣,北斗鎮,中寮里,835,855,386,142,528,28,556
公投第１１案,彰化縣,北斗鎮,大道里,836,1065,454,184,638,31,669
公投第１１案,彰化縣,北斗鎮,大道里,837,828,333,118,451,57,508
公投第１１案,彰化縣,北斗鎮,西德里,838,1124,460,177,637,40,677
公投第１１案,彰化縣,北斗鎮,西德里,839,1096,435,208,643,28,671
公投第１１案,彰化縣,北斗鎮,西德里,840,1213,479,207,686,29,715
公投第１１案,彰化縣,北斗鎮,西德里,841,1164,431,167,598,46,644
公投第１１案,彰化縣,北斗鎮,西安里,842,730,281,108,389,28,417
公投第１１案,彰化縣,北斗鎮,西安里,843,878,458,19,477,19,496
公投第１１案,彰化縣,北斗鎮,光復里,844,833,364,127,491,23,514
公投第１１案,彰化縣,北斗鎮,光復里,845,957,290,257,547,22,569
公投第１１案,彰化縣,北斗鎮,新政里,846,783,304,107,411,30,441
公投第１１案,彰化縣,北斗鎮,重慶里,847,573,192,106,298,23,321
公投第１１案,彰化縣,北斗鎮,五權里,848,672,240,127,367,20,387
公投第１１案,彰化縣,北斗鎮,七星里,849,695,231,113,344,37,381
公投第１１案,彰化縣,北斗鎮,七星里,850,747,245,123,368,34,402
公投第１１案,彰化縣,北斗鎮,居仁里,851,643,274,122,396,18,414
公投第１１案,彰化縣,北斗鎮,居仁里,852,662,354,15,369,29,398
公投第１１案,彰化縣,北斗鎮,東光里,853,1085,484,168,652,30,682
公投第１１案,彰化縣,北斗鎮,東光里,854,1121,435,190,625,44,669
公投第１１案,彰化縣,北斗鎮,文昌里,855,830,347,128,475,33,508
公投第１１案,彰化縣,北斗鎮,文昌里,856,975,353,169,522,22,544
公投第１１案,彰化縣,北斗鎮,文昌里,857,1212,443,197,640,18,658
公投第１１案,彰化縣,北斗鎮,中和里,858,1302,522,214,736,45,781
公投第１１案,彰化縣,北斗鎮,新生里,859,1077,353,152,505,27,532
公投第１１案,彰化縣,北斗鎮,新生里,860,917,326,138,464,43,507
公投第１１案,彰化縣,北斗鎮,大新里,861,825,321,123,444,26,470
公投第１１案,彰化縣,北斗鎮,大新里,862,937,364,139,503,48,551
公投第１１案,彰化縣,田尾鄉,田尾村,863,1284,422,206,628,40,668
公投第１１案,彰化縣,田尾鄉,溪畔村,864,1187,473,199,672,53,725
公投第１１案,彰化縣,田尾鄉,打簾村,865,1033,413,184,597,37,634
公投第１１案,彰化縣,田尾鄉,打簾村,866,696,305,94,399,24,423
公投第１１案,彰化縣,田尾鄉,正義村,867,872,362,150,512,27,539
公投第１１案,彰化縣,田尾鄉,北曾村,868,680,258,100,358,19,377
公投第１１案,彰化縣,田尾鄉,北曾村,869,875,346,184,530,29,559
公投第１１案,彰化縣,田尾鄉,南曾村,870,1337,501,226,727,39,766
公投第１１案,彰化縣,田尾鄉,饒平村,871,1376,546,257,803,40,843
公投第１１案,彰化縣,田尾鄉,饒平村,872,1186,494,207,701,36,737
公投第１１案,彰化縣,田尾鄉,豐田村,873,874,413,151,564,41,605
公投第１１案,彰化縣,田尾鄉,仁里村,874,647,244,97,341,27,368
公投第１１案,彰化縣,田尾鄉,仁里村,875,959,413,129,542,32,574
公投第１１案,彰化縣,田尾鄉,新厝村,876,263,93,37,130,14,144
公投第１１案,彰化縣,田尾鄉,溪頂村,877,618,221,90,311,26,337
公投第１１案,彰化縣,田尾鄉,柳鳳村,878,938,395,180,575,25,600
公投第１１案,彰化縣,田尾鄉,陸豐村,879,880,362,163,525,40,565
公投第１１案,彰化縣,田尾鄉,海豐村,880,804,276,129,405,24,429
公投第１１案,彰化縣,田尾鄉,海豐村,881,592,196,106,302,27,329
公投第１１案,彰化縣,田尾鄉,睦宜村,882,1079,433,181,614,71,685
公投第１１案,彰化縣,田尾鄉,新生村,883,1336,485,251,736,42,778
公投第１１案,彰化縣,田尾鄉,北鎮村,884,1198,415,191,606,47,653
公投第１１案,彰化縣,田尾鄉,南鎮村,885,621,216,105,321,34,355
公投第１１案,彰化縣,田尾鄉,福田村,886,760,265,120,385,31,416
公投第１１案,彰化縣,田尾鄉,新興村,887,1084,422,212,634,66,700
公投第１１案,彰化縣,埤頭鄉,和豊村,888,1178,376,157,533,77,610
公投第１１案,彰化縣,埤頭鄉,和豊村,889,1290,458,205,663,32,695
公投第１１案,彰化縣,埤頭鄉,興農村,890,973,320,179,499,37,536
公投第１１案,彰化縣,埤頭鄉,興農村,891,783,265,124,389,31,420
公投第１１案,彰化縣,埤頭鄉,埤頭村,892,733,274,101,375,43,418
公投第１１案,彰化縣,埤頭鄉,埤頭村,893,899,330,149,479,50,529
公投第１１案,彰化縣,埤頭鄉,豊崙村,894,965,367,132,499,46,545
公投第１１案,彰化縣,埤頭鄉,豊崙村,895,1356,504,173,677,38,715
公投第１１案,彰化縣,埤頭鄉,崙子村,896,1265,458,198,656,37,693
公投第１１案,彰化縣,埤頭鄉,永豊村,897,877,360,117,477,37,514
公投第１１案,彰化縣,埤頭鄉,永豊村,898,705,241,101,342,40,382
公投第１１案,彰化縣,埤頭鄉,合興村,899,1062,458,172,630,27,657
公投第１１案,彰化縣,埤頭鄉,合興村,900,1300,498,205,703,40,743
公投第１１案,彰化縣,埤頭鄉,合興村,901,923,373,126,499,43,542
公投第１１案,彰化縣,埤頭鄉,平原村,902,1085,398,147,545,28,573
公投第１１案,彰化縣,埤頭鄉,平原村,903,1103,17,586,603,51,654
公投第１１案,彰化縣,埤頭鄉,崙腳村,904,735,263,105,368,18,386
公投第１１案,彰化縣,埤頭鄉,元埔村,905,574,191,89,280,36,316
公投第１１案,彰化縣,埤頭鄉,芙朝村,906,767,268,84,352,35,387
公投第１１案,彰化縣,埤頭鄉,芙朝村,907,737,266,115,381,27,408
公投第１１案,彰化縣,埤頭鄉,新庄村,908,1058,323,155,478,43,521
公投第１１案,彰化縣,埤頭鄉,陸嘉村,909,826,252,120,372,54,426
公投第１１案,彰化縣,埤頭鄉,竹圍村,910,1082,340,141,481,66,547
公投第１１案,彰化縣,埤頭鄉,中和村,911,737,290,117,407,41,448
公投第１１案,彰化縣,埤頭鄉,中和村,912,711,246,106,352,16,368
公投第１１案,彰化縣,埤頭鄉,庄內村,913,1043,379,184,563,35,598
公投第１１案,彰化縣,埤頭鄉,大湖村,914,910,328,120,448,20,468
公投第１１案,彰化縣,溪州鄉,溪厝村,915,778,306,93,399,33,432
公投第１１案,彰化縣,溪州鄉,溪厝村,916,1061,344,157,501,23,524
公投第１１案,彰化縣,溪州鄉,坑厝村,917,701,251,79,330,33,363
公投第１１案,彰化縣,溪州鄉,瓦厝村,918,879,383,142,525,23,548
公投第１１案,彰化縣,溪州鄉,溪州村,919,654,294,105,399,35,434
公投第１１案,彰化縣,溪州鄉,溪州村,920,878,351,131,482,23,505
公投第１１案,彰化縣,溪州鄉,尾厝村,921,942,412,148,560,26,586
公投第１１案,彰化縣,溪州鄉,尾厝村,922,871,317,138,455,30,485
公投第１１案,彰化縣,溪州鄉,東州村,923,1047,399,134,533,23,556
公投第１１案,彰化縣,溪州鄉,東州村,924,858,304,160,464,44,508
公投第１１案,彰化縣,溪州鄉,舊眉村,925,1409,435,163,598,54,652
公投第１１案,彰化縣,溪州鄉,圳寮村,926,792,282,121,403,18,421
公投第１１案,彰化縣,溪州鄉,圳寮村,927,714,242,104,346,40,386
公投第１１案,彰化縣,溪州鄉,西畔村,928,1109,341,157,498,42,540
公投第１１案,彰化縣,溪州鄉,西畔村,929,962,259,143,402,38,440
公投第１１案,彰化縣,溪州鄉,柑園村,930,1157,341,138,479,51,530
公投第１１案,彰化縣,溪州鄉,成功村,931,952,323,142,465,33,498
公投第１１案,彰化縣,溪州鄉,成功村,932,887,288,146,434,42,476
公投第１１案,彰化縣,溪州鄉,大庄村,933,866,223,117,340,43,383
公投第１１案,彰化縣,溪州鄉,大庄村,934,1010,264,169,433,55,488
公投第１１案,彰化縣,溪州鄉,榮光村,935,853,256,151,407,20,427
公投第１１案,彰化縣,溪州鄉,潮洋村,936,843,272,121,393,46,439
公投第１１案,彰化縣,溪州鄉,張厝村,937,711,177,83,260,10,270
公投第１１案,彰化縣,溪州鄉,菜公村,938,851,296,127,423,49,472
公投第１１案,彰化縣,溪州鄉,三條村,939,883,294,115,409,30,439
公投第１１案,彰化縣,溪州鄉,三圳村,940,1247,446,141,587,46,633
公投第１１案,彰化縣,溪州鄉,水尾村,941,1490,527,248,775,56,831
公投第１１案,彰化縣,二林鎮,豐田里,942,731,202,89,291,28,319
公投第１１案,彰化縣,二林鎮,豐田里,943,1025,393,166,559,31,590
公投第１１案,彰化縣,二林鎮,豐田里,944,784,292,137,429,27,456
公投第１１案,彰化縣,二林鎮,東和里,945,892,346,141,487,30,517
公投第１１案,彰化縣,二林鎮,東和里,946,1256,470,216,686,37,723
公投第１１案,彰化縣,二林鎮,南光里,947,1043,379,152,531,44,575
公投第１１案,彰化縣,二林鎮,南光里,948,1076,421,199,620,29,649
公投第１１案,彰化縣,二林鎮,南光里,949,1082,421,175,596,39,635
公投第１１案,彰化縣,二林鎮,西平里,950,1427,404,335,739,38,777
公投第１１案,彰化縣,二林鎮,北平里,951,1030,314,153,467,59,526
公投第１１案,彰化縣,二林鎮,北平里,952,1033,329,172,501,45,546
公投第１１案,彰化縣,二林鎮,北平里,953,977,328,172,500,42,542
公投第１１案,彰化縣,二林鎮,中西里,954,683,241,93,334,20,354
公投第１１案,彰化縣,二林鎮,中西里,955,975,419,29,448,67,515
公投第１１案,彰化縣,二林鎮,廣興里,956,1336,511,43,554,57,611
公投第１１案,彰化縣,二林鎮,香田里,957,1019,292,141,433,51,484
公投第１１案,彰化縣,二林鎮,外竹里,958,1003,286,123,409,33,442
公投第１１案,彰化縣,二林鎮,興華里,959,1151,441,154,595,54,649
公投第１１案,彰化縣,二林鎮,東興里,960,1598,624,239,863,51,914
公投第１１案,彰化縣,二林鎮,後厝里,961,1488,545,202,747,54,801
公投第１１案,彰化縣,二林鎮,後厝里,962,1771,663,288,951,48,999
公投第１１案,彰化縣,二林鎮,頂厝里,963,1360,379,164,543,45,588
公投第１１案,彰化縣,二林鎮,趙甲里,964,1613,500,207,707,46,753
公投第１１案,彰化縣,二林鎮,振興里,965,1228,385,178,563,78,641
公投第１１案,彰化縣,二林鎮,萬興里,966,771,314,105,419,19,438
公投第１１案,彰化縣,二林鎮,永興里,967,858,347,133,480,28,508
公投第１１案,彰化縣,二林鎮,永興里,968,661,217,77,294,0,294
公投第１１案,彰化縣,二林鎮,西庄里,969,1268,413,164,577,60,637
公投第１１案,彰化縣,二林鎮,梅芳里,970,1081,344,150,494,37,531
公投第１１案,彰化縣,二林鎮,華崙里,971,1213,412,155,567,27,594
公投第１１案,彰化縣,二林鎮,華崙里,972,1328,499,202,701,40,741
公投第１１案,彰化縣,二林鎮,華崙里,973,1118,347,136,483,51,534
公投第１１案,彰化縣,二林鎮,萬合里,974,1157,343,150,493,41,534
公投第１１案,彰化縣,二林鎮,東勢里,975,972,326,122,448,33,481
公投第１１案,彰化縣,二林鎮,大永里,976,902,306,153,459,26,485
公投第１１案,彰化縣,二林鎮,原斗里,977,1273,571,191,762,34,796
公投第１１案,彰化縣,二林鎮,西斗里,978,1087,392,155,547,35,582
公投第１１案,彰化縣,二林鎮,東華里,979,987,395,148,543,47,590
公投第１１案,彰化縣,二林鎮,復豐里,980,719,207,105,312,21,333
公投第１１案,彰化縣,大城鄉,山腳村,981,1288,292,127,419,26,445
公投第１１案,彰化縣,大城鄉,潭墘村,982,1104,268,111,379,48,427
公投第１１案,彰化縣,大城鄉,大城村,983,964,363,136,499,42,541
公投第１１案,彰化縣,大城鄉,東城村,984,1312,426,138,564,45,609
公投第１１案,彰化縣,大城鄉,西城村,985,853,234,87,321,45,366
公投第１１案,彰化縣,大城鄉,上山村,986,518,140,30,170,13,183
公投第１１案,彰化縣,大城鄉,上山村,987,574,160,67,227,23,250
公投第１１案,彰化縣,大城鄉,永和村,988,702,172,72,244,25,269
公投第１１案,彰化縣,大城鄉,公館村,989,376,80,25,105,14,119
公投第１１案,彰化縣,大城鄉,公館村,990,693,145,56,201,16,217
公投第１１案,彰化縣,大城鄉,豐美村,991,877,241,103,344,42,386
公投第１１案,彰化縣,大城鄉,三豐村,992,655,127,65,192,14,206
公投第１１案,彰化縣,大城鄉,菜寮村,993,1103,282,99,381,29,410
公投第１１案,彰化縣,大城鄉,東港村,994,1192,240,132,372,45,417
公投第１１案,彰化縣,大城鄉,西港村,995,917,215,123,338,23,361
公投第１１案,彰化縣,大城鄉,頂庄村,996,686,157,53,210,20,230
公投第１１案,彰化縣,大城鄉,臺西村,997,899,182,76,258,23,281
公投第１１案,彰化縣,芳苑鄉,芳苑村,998,940,213,92,305,32,337
公投第１１案,彰化縣,芳苑鄉,芳中村,999,403,118,35,153,17,170
公投第１１案,彰化縣,芳苑鄉,仁愛村,1000,756,243,106,349,30,379
公投第１１案,彰化縣,芳苑鄉,信義村,1001,548,105,55,160,18,178
公投第１１案,彰化縣,芳苑鄉,後寮村,1002,997,348,140,488,32,520
公投第１１案,彰化縣,芳苑鄉,三合村,1003,1300,376,171,547,46,593
公投第１１案,彰化縣,芳苑鄉,三合村,1004,859,284,130,414,29,443
公投第１１案,彰化縣,芳苑鄉,永興村,1005,734,252,106,358,27,385
公投第１１案,彰化縣,芳苑鄉,永興村,1006,636,207,78,285,20,305
公投第１１案,彰化縣,芳苑鄉,新街村,1007,808,225,114,339,45,384
公投第１１案,彰化縣,芳苑鄉,路上村,1008,668,181,79,260,35,295
公投第１１案,彰化縣,芳苑鄉,路平村,1009,744,228,118,346,32,378
公投第１１案,彰化縣,芳苑鄉,三成村,1010,1026,323,124,447,48,495
公投第１１案,彰化縣,芳苑鄉,福榮村,1011,586,164,59,223,18,241
公投第１１案,彰化縣,芳苑鄉,頂廍村,1012,593,200,83,283,31,314
公投第１１案,彰化縣,芳苑鄉,王功村,1013,1071,377,141,518,54,572
公投第１１案,彰化縣,芳苑鄉,王功村,1014,1060,337,166,503,56,559
公投第１１案,彰化縣,芳苑鄉,博愛村,1015,708,286,90,376,20,396
公投第１１案,彰化縣,芳苑鄉,和平村,1016,735,252,77,329,38,367
公投第１１案,彰化縣,芳苑鄉,興仁村,1017,571,212,88,300,35,335
公投第１１案,彰化縣,芳苑鄉,興仁村,1018,729,228,68,296,29,325
公投第１１案,彰化縣,芳苑鄉,民生村,1019,674,238,78,316,43,359
公投第１１案,彰化縣,芳苑鄉,新寶村,1020,846,273,133,406,27,433
公投第１１案,彰化縣,芳苑鄉,新寶村,1021,806,346,107,453,27,480
公投第１１案,彰化縣,芳苑鄉,五俊村,1022,470,135,53,188,12,200
公投第１１案,彰化縣,芳苑鄉,草湖村,1023,1124,420,144,564,53,617
公投第１１案,彰化縣,芳苑鄉,草湖村,1024,317,108,32,140,12,152
公投第１１案,彰化縣,芳苑鄉,建平村,1025,1158,323,122,445,52,497
公投第１１案,彰化縣,芳苑鄉,建平村,1026,967,309,121,430,30,460
公投第１１案,彰化縣,芳苑鄉,崙腳村,1027,762,267,96,363,45,408
公投第１１案,彰化縣,芳苑鄉,文津村,1028,1086,310,136,446,35,481
公投第１１案,彰化縣,芳苑鄉,新生村,1029,747,232,109,341,27,368
公投第１１案,彰化縣,芳苑鄉,新生村,1030,653,175,68,243,23,266
公投第１１案,彰化縣,芳苑鄉,漢寶村,1031,872,356,113,469,45,514
公投第１１案,彰化縣,芳苑鄉,漢寶村,1032,1235,466,235,701,44,745
公投第１１案,彰化縣,芳苑鄉,漢寶村,1033,1102,399,160,559,43,602
公投第１１案,彰化縣,竹塘鄉,竹元村,1034,1168,536,80,616,65,681
公投第１１案,彰化縣,竹塘鄉,竹塘村,1035,965,373,172,545,29,574
公投第１１案,彰化縣,竹塘鄉,竹塘村,1036,960,376,176,552,50,602
公投第１１案,彰化縣,竹塘鄉,小西村,1037,743,98,333,431,52,483
公投第１１案,彰化縣,竹塘鄉,民靖村,1038,751,212,94,306,36,342
公投第１１案,彰化縣,竹塘鄉,五庄村,1039,792,264,101,365,27,392
公投第１１案,彰化縣,竹塘鄉,五庄村,1040,733,233,108,341,17,358
公投第１１案,彰化縣,竹塘鄉,樹腳村,1041,657,240,87,327,33,360
公投第１１案,彰化縣,竹塘鄉,田頭村,1042,1063,372,154,526,38,564
公投第１１案,彰化縣,竹塘鄉,新廣村,1043,1114,401,164,565,74,639
公投第１１案,彰化縣,竹塘鄉,溪墘村,1044,506,207,102,309,35,344
公投第１１案,彰化縣,竹塘鄉,竹林村,1045,823,262,126,388,36,424
公投第１１案,彰化縣,竹塘鄉,土庫村,1046,654,202,104,306,30,336
公投第１１案,彰化縣,竹塘鄉,內新村,1047,577,182,70,252,18,270
公投第１１案,彰化縣,竹塘鄉,長安村,1048,772,256,109,365,46,411
公投第１１案,彰化縣,竹塘鄉,永安村,1049,543,148,68,216,36,252
公投第１１案,南投縣,南投市,龍泉里,1,927,367,171,538,30,568
公投第１１案,南投縣,南投市,康壽里,2,667,311,126,437,20,457
公投第１１案,南投縣,南投市,康壽里,3,773,334,145,479,16,495
公投第１１案,南投縣,南投市,三民里,4,818,333,163,496,21,517
公投第１１案,南投縣,南投市,仁和里,5,525,234,108,342,15,357
公投第１１案,南投縣,南投市,南投里,6,575,256,102,358,25,383
公投第１１案,南投縣,南投市,彰仁里,7,368,175,70,245,11,256
公投第１１案,南投縣,南投市,崇文里,8,956,438,170,608,25,633
公投第１１案,南投縣,南投市,三興里,9,1245,444,203,647,27,674
公投第１１案,南投縣,南投市,三興里,10,1484,599,251,850,13,863
公投第１１案,南投縣,南投市,三興里,11,1191,545,210,755,29,784
公投第１１案,南投縣,南投市,三興里,12,1506,607,267,874,45,919
公投第１１案,南投縣,南投市,三和里,13,1070,436,212,648,29,677
公投第１１案,南投縣,南投市,三和里,14,670,295,114,409,19,428
公投第１１案,南投縣,南投市,三和里,15,1050,467,193,660,41,701
公投第１１案,南投縣,南投市,嘉興里,16,1122,420,162,582,36,618
公投第１１案,南投縣,南投市,嘉興里,17,984,352,175,527,31,558
公投第１１案,南投縣,南投市,嘉和里,18,1062,456,220,676,29,705
公投第１１案,南投縣,南投市,嘉和里,19,1053,419,179,598,44,642
公投第１１案,南投縣,南投市,嘉和里,20,1104,436,234,670,32,702
公投第１１案,南投縣,南投市,嘉和里,21,1192,433,217,650,48,698
公投第１１案,南投縣,南投市,平和里,22,960,377,158,535,20,555
公投第１１案,南投縣,南投市,平和里,23,906,375,149,524,35,559
公投第１１案,南投縣,南投市,平和里,24,957,408,172,580,18,598
公投第１１案,南投縣,南投市,平和里,25,997,448,179,627,25,652
公投第１１案,南投縣,南投市,平和里,26,1008,429,182,611,18,629
公投第１１案,南投縣,南投市,平和里,27,1164,454,214,668,17,685
公投第１１案,南投縣,南投市,振興里,28,587,227,105,332,18,350
公投第１１案,南投縣,南投市,振興里,29,734,260,129,389,26,415
公投第１１案,南投縣,南投市,振興里,30,724,277,122,399,33,432
公投第１１案,南投縣,南投市,千秋里,31,1003,431,138,569,30,599
公投第１１案,南投縣,南投市,軍功里,32,1356,529,220,749,40,789
公投第１１案,南投縣,南投市,軍功里,33,1373,484,229,713,38,751
公投第１１案,南投縣,南投市,軍功里,34,1452,557,226,783,30,813
公投第１１案,南投縣,南投市,軍功里,35,362,156,45,201,11,212
公投第１１案,南投縣,南投市,東山里,36,389,157,61,218,17,235
公投第１１案,南投縣,南投市,營南里,37,1276,537,254,791,39,830
公投第１１案,南投縣,南投市,營南里,38,1089,459,221,680,39,719
公投第１１案,南投縣,南投市,營北里,39,921,358,193,551,42,593
公投第１１案,南投縣,南投市,營北里,40,892,426,178,604,14,618
公投第１１案,南投縣,南投市,營北里,41,1050,463,194,657,28,685
公投第１１案,南投縣,南投市,營北里,42,1078,473,194,667,16,683
公投第１１案,南投縣,南投市,營北里,43,1078,458,182,640,28,668
公投第１１案,南投縣,南投市,營北里,44,861,401,197,598,25,623
公投第１１案,南投縣,南投市,內興里,45,1221,515,182,697,43,740
公投第１１案,南投縣,南投市,內興里,46,1105,475,179,654,14,668
公投第１１案,南投縣,南投市,內興里,47,1230,522,220,742,16,758
公投第１１案,南投縣,南投市,內興里,48,1092,448,205,653,22,675
公投第１１案,南投縣,南投市,內興里,49,1286,560,242,802,18,820
公投第１１案,南投縣,南投市,內興里,50,655,301,135,436,22,458
公投第１１案,南投縣,南投市,內新里,51,719,323,134,457,15,472
公投第１１案,南投縣,南投市,內新里,52,720,285,133,418,26,444
公投第１１案,南投縣,南投市,光輝里,53,509,241,85,326,16,342
公投第１１案,南投縣,南投市,光榮里,54,492,221,48,269,14,283
公投第１１案,南投縣,南投市,光榮里,55,616,283,78,361,13,374
公投第１１案,南投縣,南投市,光明里,56,1010,477,127,604,21,625
公投第１１案,南投縣,南投市,光華里,57,848,381,104,485,26,511
公投第１１案,南投縣,南投市,漳興里,58,1387,605,238,843,42,885
公投第１１案,南投縣,南投市,漳興里,59,1245,517,257,774,30,804
公投第１１案,南投縣,南投市,漳和里,60,1199,471,205,676,19,695
公投第１１案,南投縣,南投市,漳和里,61,1288,554,209,763,38,801
公投第１１案,南投縣,南投市,漳和里,62,1040,419,170,589,34,623
公投第１１案,南投縣,南投市,漳和里,63,1070,432,202,634,34,668
公投第１１案,南投縣,南投市,漳和里,64,1299,450,240,690,30,720
公投第１１案,南投縣,南投市,漳和里,65,1122,500,196,696,28,724
公投第１１案,南投縣,南投市,平山里,66,1414,587,218,805,37,842
公投第１１案,南投縣,南投市,平山里,67,1121,454,180,634,37,671
公投第１１案,南投縣,南投市,平山里,68,1434,556,245,801,22,823
公投第１１案,南投縣,南投市,平山里,69,1393,482,263,745,28,773
公投第１１案,南投縣,南投市,新興里,70,1059,436,164,600,13,613
公投第１１案,南投縣,南投市,新興里,71,1218,511,182,693,15,708
公投第１１案,南投縣,南投市,新興里,72,1293,578,119,697,18,715
公投第１１案,南投縣,南投市,新興里,73,1337,484,169,653,17,670
公投第１１案,南投縣,南投市,永豐里,74,876,356,180,536,33,569
公投第１１案,南投縣,南投市,永豐里,75,971,376,166,542,26,568
公投第１１案,南投縣,南投市,永豐里,76,1012,385,183,568,26,594
公投第１１案,南投縣,南投市,福興里,77,973,383,143,526,26,552
公投第１１案,南投縣,南投市,福興里,78,1002,454,175,629,21,650
公投第１１案,南投縣,南投市,福興里,79,1024,382,192,574,35,609
公投第１１案,南投縣,南投市,鳳山里,80,1122,350,163,513,80,593
公投第１１案,南投縣,南投市,永興里,81,790,253,124,377,23,400
公投第１１案,南投縣,南投市,鳳鳴里,82,647,215,73,288,19,307
公投第１１案,南投縣,南投市,福山里,83,950,342,155,497,40,537
公投第１１案,南投縣,南投市,福山里,84,980,342,163,505,24,529
公投第１１案,南投縣,埔里鎮,東門里,85,828,346,123,469,29,498
公投第１１案,南投縣,埔里鎮,東門里,86,786,306,151,457,34,491
公投第１１案,南投縣,埔里鎮,東門里,87,1062,427,143,570,38,608
公投第１１案,南投縣,埔里鎮,杷城里,88,1201,292,225,517,36,553
公投第１１案,南投縣,埔里鎮,杷城里,89,1415,419,212,631,34,665
公投第１１案,南投縣,埔里鎮,枇杷里,90,1282,497,209,706,24,730
公投第１１案,南投縣,埔里鎮,枇杷里,91,859,352,128,480,26,506
公投第１１案,南投縣,埔里鎮,枇杷里,92,1288,471,201,672,78,750
公投第１１案,南投縣,埔里鎮,枇杷里,93,1330,507,224,731,35,766
公投第１１案,南投縣,埔里鎮,枇杷里,94,1416,492,233,725,44,769
公投第１１案,南投縣,埔里鎮,枇杷里,95,1283,462,186,648,27,675
公投第１１案,南投縣,埔里鎮,水頭里,96,1151,452,184,636,57,693
公投第１１案,南投縣,埔里鎮,水頭里,97,1193,427,178,605,30,635
公投第１１案,南投縣,埔里鎮,水頭里,98,1471,545,236,781,69,850
公投第１１案,南投縣,埔里鎮,麒麟里,99,1044,323,149,472,61,533
公投第１１案,南投縣,埔里鎮,珠格里,100,1122,434,190,624,43,667
公投第１１案,南投縣,埔里鎮,溪南里,101,1129,589,186,775,33,808
公投第１１案,南投縣,埔里鎮,西門里,102,901,347,142,489,15,504
公投第１１案,南投縣,埔里鎮,西門里,103,997,376,128,504,40,544
公投第１１案,南投縣,埔里鎮,西門里,104,1209,447,201,648,33,681
公投第１１案,南投縣,埔里鎮,南門里,105,838,394,129,523,32,555
公投第１１案,南投縣,埔里鎮,北門里,106,1226,399,181,580,34,614
公投第１１案,南投縣,埔里鎮,北門里,107,1263,523,218,741,54,795
公投第１１案,南投縣,埔里鎮,北安里,108,1045,427,184,611,26,637
公投第１１案,南投縣,埔里鎮,北安里,109,1120,458,202,660,36,696
公投第１１案,南投縣,埔里鎮,北安里,110,1062,472,187,659,34,693
公投第１１案,南投縣,埔里鎮,北梅里,111,1022,391,172,563,33,596
公投第１１案,南投縣,埔里鎮,北梅里,112,1051,391,183,574,24,598
公投第１１案,南投縣,埔里鎮,北梅里,113,1106,417,180,597,27,624
公投第１１案,南投縣,埔里鎮,泰安里,114,1098,434,163,597,23,620
公投第１１案,南投縣,埔里鎮,泰安里,115,1067,433,177,610,20,630
公投第１１案,南投縣,埔里鎮,大湳里,116,725,267,127,394,37,431
公投第１１案,南投縣,埔里鎮,大湳里,117,905,335,182,517,25,542
公投第１１案,南投縣,埔里鎮,蜈蚣里,118,1179,417,180,597,50,647
公投第１１案,南投縣,埔里鎮,蜈蚣里,119,944,348,111,459,37,496
公投第１１案,南投縣,埔里鎮,蜈蚣里,120,465,178,62,240,29,269
公投第１１案,南投縣,埔里鎮,同聲里,121,1133,415,187,602,38,640
公投第１１案,南投縣,埔里鎮,同聲里,122,1100,382,174,556,46,602
公投第１１案,南投縣,埔里鎮,清新里,123,1155,456,178,634,41,675
公投第１１案,南投縣,埔里鎮,清新里,124,1254,428,200,628,45,673
公投第１１案,南投縣,埔里鎮,清新里,125,1296,554,102,656,42,698
公投第１１案,南投縣,埔里鎮,薰化里,126,1023,429,199,628,36,664
公投第１１案,南投縣,埔里鎮,大城里,127,964,348,134,482,19,501
公投第１１案,南投縣,埔里鎮,大城里,128,986,396,161,557,25,582
公投第１１案,南投縣,埔里鎮,大城里,129,1016,404,180,584,32,616
公投第１１案,南投縣,埔里鎮,大城里,130,898,360,133,493,41,534
公投第１１案,南投縣,埔里鎮,大城里,131,980,397,170,567,32,599
公投第１１案,南投縣,埔里鎮,大城里,132,933,397,138,535,30,565
公投第１１案,南投縣,埔里鎮,籃城里,133,929,402,204,606,47,653
公投第１１案,南投縣,埔里鎮,桃米里,134,1032,398,170,568,25,593
公投第１１案,南投縣,埔里鎮,成功里,135,315,113,36,149,8,157
公投第１１案,南投縣,埔里鎮,南村里,136,1363,446,221,667,65,732
公投第１１案,南投縣,埔里鎮,愛蘭里,137,725,297,124,421,22,443
公投第１１案,南投縣,埔里鎮,愛蘭里,138,705,300,114,414,13,427
公投第１１案,南投縣,埔里鎮,鐵山里,139,751,302,152,454,31,485
公投第１１案,南投縣,埔里鎮,鐵山里,140,932,336,167,503,31,534
公投第１１案,南投縣,埔里鎮,房里里,141,956,340,187,527,36,563
公投第１１案,南投縣,埔里鎮,房里里,142,376,143,59,202,12,214
公投第１１案,南投縣,埔里鎮,向善里,143,682,260,117,377,30,407
公投第１１案,南投縣,埔里鎮,一新里,144,990,516,88,604,42,646
公投第１１案,南投縣,埔里鎮,合成里,145,1324,418,191,609,62,671
公投第１１案,南投縣,埔里鎮,合成里,146,298,87,49,136,12,148
公投第１１案,南投縣,埔里鎮,廣成里,147,1170,361,238,599,53,652
公投第１１案,南投縣,埔里鎮,史港里,148,604,241,105,346,15,361
公投第１１案,南投縣,埔里鎮,福興里,149,999,367,147,514,38,552
公投第１１案,南投縣,埔里鎮,牛眠里,150,923,315,138,453,17,470
公投第１１案,南投縣,埔里鎮,牛眠里,151,887,357,152,509,28,537
公投第１１案,南投縣,埔里鎮,牛眠里,152,981,351,159,510,25,535
公投第１１案,南投縣,草屯鎮,玉峰里,153,998,423,180,603,19,622
公投第１１案,南投縣,草屯鎮,玉峰里,154,1127,400,209,609,19,628
公投第１１案,南投縣,草屯鎮,明正里,155,1401,452,320,772,14,786
公投第１１案,南投縣,草屯鎮,明正里,156,1110,397,205,602,29,631
公投第１１案,南投縣,草屯鎮,明正里,157,1285,518,204,722,45,767
公投第１１案,南投縣,草屯鎮,炎峰里,158,936,363,151,514,26,540
公投第１１案,南投縣,草屯鎮,炎峰里,159,1141,432,194,626,31,657
公投第１１案,南投縣,草屯鎮,中正里,160,705,294,131,425,18,443
公投第１１案,南投縣,草屯鎮,和平里,161,1121,476,214,690,20,710
公投第１１案,南投縣,草屯鎮,中山里,162,877,400,164,564,18,582
公投第１１案,南投縣,草屯鎮,中山里,163,1401,533,248,781,43,824
公投第１１案,南投縣,草屯鎮,敦和里,164,1267,491,172,663,37,700
公投第１１案,南投縣,草屯鎮,敦和里,165,1214,479,198,677,44,721
公投第１１案,南投縣,草屯鎮,敦和里,166,1259,475,234,709,44,753
公投第１１案,南投縣,草屯鎮,敦和里,167,1442,600,256,856,23,879
公投第１１案,南投縣,草屯鎮,敦和里,168,1273,524,213,737,29,766
公投第１１案,南投縣,草屯鎮,山腳里,169,1145,424,208,632,26,658
公投第１１案,南投縣,草屯鎮,山腳里,170,1279,501,199,700,25,725
公投第１１案,南投縣,草屯鎮,山腳里,171,1158,449,182,631,25,656
公投第１１案,南投縣,草屯鎮,山腳里,172,1335,593,256,849,31,880
公投第１１案,南投縣,草屯鎮,山腳里,173,1178,506,220,726,39,765
公投第１１案,南投縣,草屯鎮,山腳里,174,1327,499,253,752,30,782
公投第１１案,南投縣,草屯鎮,新厝里,175,1000,409,175,584,22,606
公投第１１案,南投縣,草屯鎮,新厝里,176,1257,495,207,702,21,723
公投第１１案,南投縣,草屯鎮,新厝里,177,883,406,146,552,16,568
公投第１１案,南投縣,草屯鎮,上林里,178,1121,430,166,596,28,624
公投第１１案,南投縣,草屯鎮,上林里,179,1043,421,175,596,26,622
公投第１１案,南投縣,草屯鎮,上林里,180,979,412,183,595,10,605
公投第１１案,南投縣,草屯鎮,碧峰里,181,1048,343,177,520,27,547
公投第１１案,南投縣,草屯鎮,碧峰里,182,1009,397,151,548,26,574
公投第１１案,南投縣,草屯鎮,碧峰里,183,1138,429,175,604,15,619
公投第１１案,南投縣,草屯鎮,碧峰里,184,1197,454,193,647,23,670
公投第１１案,南投縣,草屯鎮,碧洲里,185,1364,547,228,775,36,811
公投第１１案,南投縣,草屯鎮,碧洲里,186,1059,405,193,598,40,638
公投第１１案,南投縣,草屯鎮,復興里,187,1108,423,190,613,41,654
公投第１１案,南投縣,草屯鎮,復興里,188,879,357,124,481,24,505
公投第１１案,南投縣,草屯鎮,復興里,189,957,391,135,526,40,566
公投第１１案,南投縣,草屯鎮,御史里,190,1395,452,196,648,21,669
公投第１１案,南投縣,草屯鎮,御史里,191,1101,452,205,657,25,682
公投第１１案,南投縣,草屯鎮,御史里,192,1297,443,226,669,32,701
公投第１１案,南投縣,草屯鎮,御史里,193,877,262,127,389,25,414
公投第１１案,南投縣,草屯鎮,御史里,194,1376,440,204,644,37,681
公投第１１案,南投縣,草屯鎮,新豐里,195,1008,432,172,604,50,654
公投第１１案,南投縣,草屯鎮,新豐里,196,1080,442,196,638,39,677
公投第１１案,南投縣,草屯鎮,新豐里,197,1017,334,183,517,42,559
公投第１１案,南投縣,草屯鎮,新豐里,198,961,400,176,576,36,612
公投第１１案,南投縣,草屯鎮,新庄里,199,1160,455,211,666,47,713
公投第１１案,南投縣,草屯鎮,新庄里,200,1121,431,192,623,32,655
公投第１１案,南投縣,草屯鎮,新庄里,201,1243,456,231,687,26,713
公投第１１案,南投縣,草屯鎮,加老里,202,932,371,171,542,25,567
公投第１１案,南投縣,草屯鎮,加老里,203,1323,548,270,818,43,861
公投第１１案,南投縣,草屯鎮,石川里,204,1518,555,205,760,42,802
公投第１１案,南投縣,草屯鎮,北投里,205,923,380,176,556,21,577
公投第１１案,南投縣,草屯鎮,北投里,206,970,353,159,512,27,539
公投第１１案,南投縣,草屯鎮,北投里,207,1026,396,192,588,20,608
公投第１１案,南投縣,草屯鎮,富寮里,208,1466,550,240,790,45,835
公投第１１案,南投縣,草屯鎮,富寮里,209,1180,459,190,649,31,680
公投第１１案,南投縣,草屯鎮,富寮里,210,1006,398,192,590,20,610
公投第１１案,南投縣,草屯鎮,富寮里,211,1000,329,145,474,31,505
公投第１１案,南投縣,草屯鎮,富寮里,212,1128,459,207,666,27,693
公投第１１案,南投縣,草屯鎮,富寮里,213,623,228,115,343,9,352
公投第１１案,南投縣,草屯鎮,北勢里,214,707,253,133,386,31,417
公投第１１案,南投縣,草屯鎮,北勢里,215,719,284,95,379,26,405
公投第１１案,南投縣,草屯鎮,北勢里,216,527,174,67,241,18,259
公投第１１案,南投縣,草屯鎮,中原里,217,1183,440,226,666,42,708
公投第１１案,南投縣,草屯鎮,中原里,218,869,359,152,511,28,539
公投第１１案,南投縣,草屯鎮,南埔里,219,1132,378,202,580,16,596
公投第１１案,南投縣,草屯鎮,南埔里,220,949,361,157,518,50,568
公投第１１案,南投縣,草屯鎮,南埔里,221,965,379,185,564,21,585
公投第１１案,南投縣,草屯鎮,南埔里,222,1068,365,187,552,32,584
公投第１１案,南投縣,草屯鎮,坪頂里,223,1024,396,179,575,52,627
公投第１１案,南投縣,草屯鎮,土城里,224,642,236,96,332,20,352
公投第１１案,南投縣,草屯鎮,土城里,225,1017,342,159,501,38,539
公投第１１案,南投縣,草屯鎮,平林里,226,1092,418,182,600,28,628
公投第１１案,南投縣,草屯鎮,雙冬里,227,1170,426,189,615,47,662
公投第１１案,南投縣,草屯鎮,雙冬里,228,1106,417,202,619,48,667
公投第１１案,南投縣,竹山鎮,竹山里,229,1170,480,181,661,44,705
公投第１１案,南投縣,竹山鎮,竹山里,230,850,353,149,502,33,535
公投第１１案,南投縣,竹山鎮,中正里,231,621,210,108,318,25,343
公投第１１案,南投縣,竹山鎮,中山里,232,905,338,146,484,22,506
公投第１１案,南投縣,竹山鎮,中山里,233,1099,363,152,515,41,556
公投第１１案,南投縣,竹山鎮,中山里,234,1214,431,158,589,55,644
公投第１１案,南投縣,竹山鎮,中山里,235,1287,508,212,720,59,779
公投第１１案,南投縣,竹山鎮,雲林里,236,1191,451,181,632,48,680
公投第１１案,南投縣,竹山鎮,雲林里,237,1118,432,148,580,57,637
公投第１１案,南投縣,竹山鎮,雲林里,238,1278,485,218,703,21,724
公投第１１案,南投縣,竹山鎮,竹圍里,239,1153,439,184,623,50,673
公投第１１案,南投縣,竹山鎮,竹圍里,240,1243,431,186,617,43,660
公投第１１案,南投縣,竹山鎮,桂林里,241,1308,499,201,700,39,739
公投第１１案,南投縣,竹山鎮,桂林里,242,1358,508,191,699,32,731
公投第１１案,南投縣,竹山鎮,桂林里,243,1044,385,152,537,39,576
公投第１１案,南投縣,竹山鎮,下坪里,244,511,215,85,300,21,321
公投第１１案,南投縣,竹山鎮,下坪里,245,682,260,92,352,18,370
公投第１１案,南投縣,竹山鎮,中和里,246,989,333,156,489,23,512
公投第１１案,南投縣,竹山鎮,中崎里,247,1378,523,200,723,53,776
公投第１１案,南投縣,竹山鎮,秀林里,248,217,61,47,108,6,114
公投第１１案,南投縣,竹山鎮,秀林里,249,479,178,87,265,23,288
公投第１１案,南投縣,竹山鎮,大鞍里,250,430,139,62,201,10,211
公投第１１案,南投縣,竹山鎮,延和里,251,1437,531,229,760,50,810
公投第１１案,南投縣,竹山鎮,延和里,252,1286,515,229,744,30,774
公投第１１案,南投縣,竹山鎮,延和里,253,1080,537,77,614,44,658
公投第１１案,南投縣,竹山鎮,延和里,254,1070,391,175,566,33,599
公投第１１案,南投縣,竹山鎮,延祥里,255,1295,509,209,718,35,753
公投第１１案,南投縣,竹山鎮,延祥里,256,1047,429,147,576,27,603
公投第１１案,南投縣,竹山鎮,延祥里,257,1300,566,215,781,41,822
公投第１１案,南投縣,竹山鎮,延正里,258,908,288,128,416,18,434
公投第１１案,南投縣,竹山鎮,延正里,259,821,241,134,375,46,421
公投第１１案,南投縣,竹山鎮,延平里,260,1320,530,190,720,47,767
公投第１１案,南投縣,竹山鎮,延平里,261,967,351,141,492,22,514
公投第１１案,南投縣,竹山鎮,延平里,262,595,201,80,281,18,299
公投第１１案,南投縣,竹山鎮,延山里,263,859,290,135,425,52,477
公投第１１案,南投縣,竹山鎮,山崇里,264,1196,442,169,611,35,646
公投第１１案,南投縣,竹山鎮,山崇里,265,649,247,96,343,27,370
公投第１１案,南投縣,竹山鎮,社寮里,266,1341,497,215,712,44,756
公投第１１案,南投縣,竹山鎮,中央里,267,1222,438,163,601,41,642
公投第１１案,南投縣,竹山鎮,富州里,268,602,223,100,323,27,350
公投第１１案,南投縣,竹山鎮,田子里,269,617,225,95,320,26,346
公投第１１案,南投縣,竹山鎮,硘磘里,270,793,315,141,456,34,490
公投第１１案,南投縣,竹山鎮,硘磘里,271,922,348,156,504,20,524
公投第１１案,南投縣,竹山鎮,德興里,272,366,135,46,181,16,197
公投第１１案,南投縣,竹山鎮,德興里,273,509,175,58,233,0,233
公投第１１案,南投縣,竹山鎮,福興里,274,193,72,30,102,7,109
公投第１１案,南投縣,竹山鎮,福興里,275,406,166,69,235,17,252
公投第１１案,南投縣,竹山鎮,鯉魚里,276,495,158,70,228,24,252
公投第１１案,南投縣,竹山鎮,鯉魚里,277,307,78,27,105,10,115
公投第１１案,南投縣,竹山鎮,坪頂里,278,440,151,54,205,30,235
公投第１１案,南投縣,竹山鎮,瑞竹里,279,577,202,73,275,39,314
公投第１１案,南投縣,竹山鎮,桶頭里,280,486,126,63,189,26,215
公投第１１案,南投縣,竹山鎮,桶頭里,281,403,93,43,136,15,151
公投第１１案,南投縣,集集鎮,集集里,282,1070,445,172,617,34,651
公投第１１案,南投縣,集集鎮,和平里,283,918,394,142,536,24,560
公投第１１案,南投縣,集集鎮,林尾里,284,581,229,96,325,28,353
公投第１１案,南投縣,集集鎮,田寮里,285,1194,486,200,686,33,719
公投第１１案,南投縣,集集鎮,隘寮里,286,488,142,66,208,17,225
公投第１１案,南投縣,集集鎮,玉映里,287,504,206,88,294,19,313
公投第１１案,南投縣,集集鎮,吳厝里,288,910,344,155,499,64,563
公投第１１案,南投縣,集集鎮,八張里,289,773,247,197,444,42,486
公投第１１案,南投縣,集集鎮,八張里,290,709,257,126,383,20,403
公投第１１案,南投縣,集集鎮,永昌里,291,960,352,174,526,27,553
公投第１１案,南投縣,集集鎮,廣明里,292,503,173,86,259,18,277
公投第１１案,南投縣,集集鎮,廣明里,293,419,128,69,197,16,213
公投第１１案,南投縣,集集鎮,富山里,294,582,183,77,260,13,273
公投第１１案,南投縣,名間鄉,南雅村,295,1050,492,193,685,48,733
公投第１１案,南投縣,名間鄉,中正村,296,920,384,131,515,46,561
公投第１１案,南投縣,名間鄉,中正村,297,727,337,113,450,27,477
公投第１１案,南投縣,名間鄉,中正村,298,861,390,136,526,27,553
公投第１１案,南投縣,名間鄉,中正村,299,897,344,152,496,33,529
公投第１１案,南投縣,名間鄉,中山村,300,1055,427,184,611,37,648
公投第１１案,南投縣,名間鄉,中山村,301,1184,447,206,653,29,682
公投第１１案,南投縣,名間鄉,濁水村,302,783,285,127,412,34,446
公投第１１案,南投縣,名間鄉,濁水村,303,781,335,122,457,31,488
公投第１１案,南投縣,名間鄉,新民村,304,977,396,136,532,28,560
公投第１１案,南投縣,名間鄉,炭寮村,305,1015,359,144,503,68,571
公投第１１案,南投縣,名間鄉,新街村,306,914,376,155,531,29,560
公投第１１案,南投縣,名間鄉,新街村,307,1028,392,179,571,20,591
公投第１１案,南投縣,名間鄉,新街村,308,1018,427,165,592,29,621
公投第１１案,南投縣,名間鄉,新街村,309,1274,518,195,713,43,756
公投第１１案,南投縣,名間鄉,東湖村,310,755,302,123,425,31,456
公投第１１案,南投縣,名間鄉,東湖村,311,895,380,168,548,44,592
公投第１１案,南投縣,名間鄉,仁和村,312,892,386,120,506,24,530
公投第１１案,南投縣,名間鄉,萬丹村,313,951,349,156,505,49,554
公投第１１案,南投縣,名間鄉,田仔村,314,1261,489,189,678,48,726
公投第１１案,南投縣,名間鄉,大坑村,315,768,281,134,415,30,445
公投第１１案,南投縣,名間鄉,大庄村,316,962,387,160,547,36,583
公投第１１案,南投縣,名間鄉,大庄村,317,867,352,143,495,40,535
公投第１１案,南投縣,名間鄉,廍下村,318,930,352,169,521,46,567
公投第１１案,南投縣,名間鄉,赤水村,319,641,241,95,336,53,389
公投第１１案,南投縣,名間鄉,赤水村,320,530,196,73,269,15,284
公投第１１案,南投縣,名間鄉,竹圍村,321,931,351,162,513,47,560
公投第１１案,南投縣,名間鄉,三崙村,322,1127,447,182,629,43,672
公投第１１案,南投縣,名間鄉,三崙村,323,443,184,91,275,21,296
公投第１１案,南投縣,名間鄉,松山村,324,870,362,132,494,41,535
公投第１１案,南投縣,名間鄉,松山村,325,621,257,113,370,23,393
公投第１１案,南投縣,名間鄉,松柏村,326,1179,442,167,609,36,645
公投第１１案,南投縣,名間鄉,崁腳村,327,881,369,144,513,46,559
公投第１１案,南投縣,名間鄉,埔中村,328,876,398,158,556,40,596
公投第１１案,南投縣,名間鄉,新厝村,329,783,329,106,435,41,476
公投第１１案,南投縣,名間鄉,新光村,330,778,288,101,389,36,425
公投第１１案,南投縣,名間鄉,新光村,331,983,155,353,508,33,541
公投第１１案,南投縣,鹿谷鄉,鹿谷村,332,934,355,102,457,29,486
公投第１１案,南投縣,鹿谷鄉,鹿谷村,333,940,362,147,509,31,540
公投第１１案,南投縣,鹿谷鄉,彰雅村,334,852,293,142,435,22,457
公投第１１案,南投縣,鹿谷鄉,彰雅村,335,451,134,70,204,12,216
公投第１１案,南投縣,鹿谷鄉,廣興村,336,810,347,121,468,28,496
公投第１１案,南投縣,鹿谷鄉,廣興村,337,1142,475,192,667,46,713
公投第１１案,南投縣,鹿谷鄉,永隆村,338,766,250,103,353,21,374
公投第１１案,南投縣,鹿谷鄉,永隆村,339,884,358,124,482,36,518
公投第１１案,南投縣,鹿谷鄉,鳳凰村,340,811,269,157,426,34,460
公投第１１案,南投縣,鹿谷鄉,鳳凰村,341,581,176,79,255,23,278
公投第１１案,南投縣,鹿谷鄉,內湖村,342,578,188,79,267,29,296
公投第１１案,南投縣,鹿谷鄉,內湖村,343,467,181,75,256,23,279
公投第１１案,南投縣,鹿谷鄉,和雅村,344,622,249,67,316,30,346
公投第１１案,南投縣,鹿谷鄉,竹林村,345,740,257,100,357,28,385
公投第１１案,南投縣,鹿谷鄉,竹林村,346,767,298,96,394,39,433
公投第１１案,南投縣,鹿谷鄉,竹豐村,347,909,337,149,486,45,531
公投第１１案,南投縣,鹿谷鄉,初鄉村,348,713,252,102,354,22,376
公投第１１案,南投縣,鹿谷鄉,初鄉村,349,717,226,93,319,19,338
公投第１１案,南投縣,鹿谷鄉,秀峰村,350,794,264,111,375,31,406
公投第１１案,南投縣,鹿谷鄉,清水村,351,726,223,126,349,21,370
公投第１１案,南投縣,鹿谷鄉,瑞田村,352,737,198,96,294,26,320
公投第１１案,南投縣,中寮鄉,廣興村,353,822,333,139,472,37,509
公投第１１案,南投縣,中寮鄉,崁頂村,354,253,109,37,146,9,155
公投第１１案,南投縣,中寮鄉,崁頂村,355,221,61,21,82,12,94
公投第１１案,南投縣,中寮鄉,八仙村,356,353,108,41,149,7,156
公投第１１案,南投縣,中寮鄉,八仙村,357,427,148,70,218,19,237
公投第１１案,南投縣,中寮鄉,福盛村,358,406,153,60,213,17,230
公投第１１案,南投縣,中寮鄉,福盛村,359,307,98,44,142,19,161
公投第１１案,南投縣,中寮鄉,和興村,360,661,284,91,375,29,404
公投第１１案,南投縣,中寮鄉,復興村,361,290,137,42,179,14,193
公投第１１案,南投縣,中寮鄉,永平村,362,973,348,187,535,39,574
公投第１１案,南投縣,中寮鄉,永平村,363,754,306,122,428,28,456
公投第１１案,南投縣,中寮鄉,中寮村,364,662,240,103,343,26,369
公投第１１案,南投縣,中寮鄉,廣福村,365,490,186,53,239,13,252
公投第１１案,南投縣,中寮鄉,永福村,366,335,111,50,161,15,176
公投第１１案,南投縣,中寮鄉,永福村,367,990,387,150,537,39,576
公投第１１案,南投縣,中寮鄉,義和村,368,461,214,61,275,21,296
公投第１１案,南投縣,中寮鄉,義和村,369,614,242,125,367,14,381
公投第１１案,南投縣,中寮鄉,清水村,370,895,320,138,458,56,514
公投第１１案,南投縣,中寮鄉,內城村,371,465,190,63,253,14,267
公投第１１案,南投縣,中寮鄉,龍安村,372,682,234,114,348,57,405
公投第１１案,南投縣,中寮鄉,爽文村,373,490,193,79,272,31,303
公投第１１案,南投縣,中寮鄉,龍岩村,374,643,262,93,355,41,396
公投第１１案,南投縣,中寮鄉,永芳村,375,459,201,67,268,17,285
公投第１１案,南投縣,中寮鄉,永和村,376,528,179,76,255,13,268
公投第１１案,南投縣,魚池鄉,魚池村,377,922,341,159,500,31,531
公投第１１案,南投縣,魚池鄉,魚池村,378,1098,398,192,590,58,648
公投第１１案,南投縣,魚池鄉,東池村,379,720,239,121,360,27,387
公投第１１案,南投縣,魚池鄉,東池村,380,860,350,128,478,32,510
公投第１１案,南投縣,魚池鄉,大林村,381,514,169,66,235,29,264
公投第１１案,南投縣,魚池鄉,大林村,382,574,197,87,284,8,292
公投第１１案,南投縣,魚池鄉,東光村,383,1249,444,190,634,42,676
公投第１１案,南投縣,魚池鄉,共和村,384,293,136,50,186,8,194
公投第１１案,南投縣,魚池鄉,共和村,385,513,176,83,259,19,278
公投第１１案,南投縣,魚池鄉,共和村,386,186,57,37,94,9,103
公投第１１案,南投縣,魚池鄉,新城村,387,841,298,118,416,20,436
公投第１１案,南投縣,魚池鄉,新城村,388,270,99,54,153,17,170
公投第１１案,南投縣,魚池鄉,新城村,389,275,96,48,144,10,154
公投第１１案,南投縣,魚池鄉,大雁村,390,282,89,34,123,8,131
公投第１１案,南投縣,魚池鄉,大雁村,391,392,122,57,179,14,193
公投第１１案,南投縣,魚池鄉,五城村,392,556,206,74,280,25,305
公投第１１案,南投縣,魚池鄉,五城村,393,176,71,21,92,5,97
公投第１１案,南投縣,魚池鄉,中明村,394,578,179,79,258,18,276
公投第１１案,南投縣,魚池鄉,中明村,395,439,136,71,207,17,224
公投第１１案,南投縣,魚池鄉,水社村,396,844,342,130,472,27,499
公投第１１案,南投縣,魚池鄉,日月村,397,868,302,146,448,27,475
公投第１１案,南投縣,魚池鄉,頭社村,398,405,134,46,180,11,191
公投第１１案,南投縣,魚池鄉,頭社村,399,537,209,80,289,17,306
公投第１１案,南投縣,魚池鄉,武登村,400,335,124,39,163,21,184
公投第１１案,南投縣,魚池鄉,武登村,401,231,77,16,93,11,104
公投第１１案,南投縣,國姓鄉,國姓村,402,964,402,152,554,47,601
公投第１１案,南投縣,國姓鄉,國姓村,403,736,295,103,398,17,415
公投第１１案,南投縣,國姓鄉,石門村,404,801,325,104,429,43,472
公投第１１案,南投縣,國姓鄉,石門村,405,964,358,174,532,17,549
公投第１１案,南投縣,國姓鄉,大旗村,406,686,247,109,356,31,387
公投第１１案,南投縣,國姓鄉,長流村,407,661,244,91,335,27,362
公投第１１案,南投縣,國姓鄉,長流村,408,730,264,99,363,19,382
公投第１１案,南投縣,國姓鄉,長豐村,409,774,266,127,393,43,436
公投第１１案,南投縣,國姓鄉,長福村,410,706,281,124,405,19,424
公投第１１案,南投縣,國姓鄉,北港村,411,1012,400,138,538,38,576
公投第１１案,南投縣,國姓鄉,北港村,412,868,287,121,408,12,420
公投第１１案,南投縣,國姓鄉,福龜村,413,918,419,116,535,26,561
公投第１１案,南投縣,國姓鄉,福龜村,414,937,347,144,491,47,538
公投第１１案,南投縣,國姓鄉,乾溝村,415,815,290,122,412,38,450
公投第１１案,南投縣,國姓鄉,柑林村,416,1134,453,192,645,40,685
公投第１１案,南投縣,國姓鄉,大石村,417,714,250,117,367,20,387
公投第１１案,南投縣,國姓鄉,北山村,418,1095,418,166,584,38,622
公投第１１案,南投縣,國姓鄉,北山村,419,448,150,62,212,25,237
公投第１１案,南投縣,國姓鄉,南港村,420,1064,402,132,534,39,573
公投第１１案,南投縣,國姓鄉,南港村,421,570,201,72,273,26,299
公投第１１案,南投縣,水里鄉,水里村,422,757,294,113,407,16,423
公投第１１案,南投縣,水里鄉,新城村,423,554,203,79,282,32,314
公投第１１案,南投縣,水里鄉,新城村,424,999,359,178,537,42,579
公投第１１案,南投縣,水里鄉,中央村,425,616,252,76,328,12,340
公投第１１案,南投縣,水里鄉,城中村,426,875,373,129,502,27,529
公投第１１案,南投縣,水里鄉,農富村,427,480,202,76,278,14,292
公投第１１案,南投縣,水里鄉,車埕村,428,450,172,52,224,24,248
公投第１１案,南投縣,水里鄉,新興村,429,643,217,102,319,37,356
公投第１１案,南投縣,水里鄉,北埔村,430,1004,399,172,571,20,591
公投第１１案,南投縣,水里鄉,南光村,431,741,264,117,381,22,403
公投第１１案,南投縣,水里鄉,南光村,432,802,281,180,461,10,471
公投第１１案,南投縣,水里鄉,鉅工村,433,998,417,182,599,40,639
公投第１１案,南投縣,水里鄉,永豐村,434,800,266,131,397,45,442
公投第１１案,南投縣,水里鄉,永豐村,435,589,251,97,348,19,367
公投第１１案,南投縣,水里鄉,民和村,436,887,320,107,427,41,468
公投第１１案,南投縣,水里鄉,頂崁村,437,1217,438,165,603,35,638
公投第１１案,南投縣,水里鄉,新山村,438,205,57,18,75,4,79
公投第１１案,南投縣,水里鄉,郡坑村,439,330,137,56,193,16,209
公投第１１案,南投縣,水里鄉,上安村,440,1100,395,154,549,29,578
公投第１１案,南投縣,水里鄉,興隆村,441,275,71,26,97,7,104
公投第１１案,南投縣,水里鄉,永興村,442,318,81,50,131,5,136
公投第１１案,南投縣,水里鄉,玉峰村,443,818,297,108,405,41,446
公投第１１案,南投縣,信義鄉,明德村,444,1201,493,154,647,33,680
公投第１１案,南投縣,信義鄉,明德村,445,329,125,37,162,14,176
公投第１１案,南投縣,信義鄉,愛國村,446,516,171,90,261,12,273
公投第１１案,南投縣,信義鄉,自強村,447,424,124,59,183,17,200
公投第１１案,南投縣,信義鄉,自強村,448,321,122,42,164,5,169
公投第１１案,南投縣,信義鄉,豐丘村,449,648,321,80,401,30,431
公投第１１案,南投縣,信義鄉,新鄉村,450,584,342,60,402,27,429
公投第１１案,南投縣,信義鄉,羅娜村,451,1376,740,144,884,29,913
公投第１１案,南投縣,信義鄉,望美村,452,979,482,127,609,20,629
公投第１１案,南投縣,信義鄉,望美村,453,530,289,82,371,29,400
公投第１１案,南投縣,信義鄉,同富村,454,961,362,123,485,28,513
公投第１１案,南投縣,信義鄉,同富村,455,464,190,58,248,9,257
公投第１１案,南投縣,信義鄉,神木村,456,517,194,92,286,22,308
公投第１１案,南投縣,信義鄉,神木村,457,149,57,24,81,8,89
公投第１１案,南投縣,信義鄉,東埔村,458,1020,620,112,732,32,764
公投第１１案,南投縣,信義鄉,人和村,459,929,468,105,573,64,637
公投第１１案,南投縣,信義鄉,人和村,460,274,93,31,124,6,130
公投第１１案,南投縣,信義鄉,地利村,461,900,480,110,590,43,633
公投第１１案,南投縣,信義鄉,雙龍村,462,617,307,105,412,39,451
公投第１１案,南投縣,信義鄉,潭南村,463,560,263,105,368,24,392
公投第１１案,南投縣,仁愛鄉,南豐村,464,973,409,163,572,14,586
公投第１１案,南投縣,仁愛鄉,南豐村,465,296,93,47,140,10,150
公投第１１案,南投縣,仁愛鄉,大同村,466,900,294,131,425,14,439
公投第１１案,南投縣,仁愛鄉,大同村,467,460,196,84,280,18,298
公投第１１案,南投縣,仁愛鄉,大同村,468,305,127,43,170,13,183
公投第１１案,南投縣,仁愛鄉,榮興村,469,58,17,1,18,2,20
公投第１１案,南投縣,仁愛鄉,春陽村,470,952,344,105,449,11,460
公投第１１案,南投縣,仁愛鄉,精英村,471,679,255,71,326,6,332
公投第１１案,南投縣,仁愛鄉,都達村,472,623,270,81,351,18,369
公投第１１案,南投縣,仁愛鄉,合作村,473,597,253,72,325,8,333
公投第１１案,南投縣,仁愛鄉,發祥村,474,384,182,45,227,21,248
公投第１１案,南投縣,仁愛鄉,發祥村,475,121,48,13,61,1,62
公投第１１案,南投縣,仁愛鄉,發祥村,476,264,131,30,161,6,167
公投第１１案,南投縣,仁愛鄉,力行村,477,509,286,87,373,17,390
公投第１１案,南投縣,仁愛鄉,翠華村,478,338,147,46,193,14,207
公投第１１案,南投縣,仁愛鄉,翠華村,479,169,65,22,87,0,87
公投第１１案,南投縣,仁愛鄉,親愛村,480,613,203,80,283,10,293
公投第１１案,南投縣,仁愛鄉,親愛村,481,404,122,63,185,5,190
公投第１１案,南投縣,仁愛鄉,親愛村,482,134,52,21,73,4,77
公投第１１案,南投縣,仁愛鄉,萬豐村,483,630,287,106,393,20,413
公投第１１案,南投縣,仁愛鄉,法治村,484,763,260,104,364,8,372
公投第１１案,南投縣,仁愛鄉,中正村,485,889,426,113,539,35,574
公投第１１案,南投縣,仁愛鄉,互助村,486,672,343,79,422,18,440
公投第１１案,南投縣,仁愛鄉,互助村,487,447,191,73,264,8,272
公投第１１案,南投縣,仁愛鄉,新生村,488,409,231,62,293,10,303
公投第１１案,雲林縣,麥寮鄉,麥豐村,1,1497,426,187,613,43,656
公投第１１案,雲林縣,麥寮鄉,麥豐村,2,1738,574,256,830,44,874
公投第１１案,雲林縣,麥寮鄉,麥豐村,3,1921,631,277,908,49,957
公投第１１案,雲林縣,麥寮鄉,麥豐村,4,1832,576,268,844,48,892
公投第１１案,雲林縣,麥寮鄉,麥津村,5,1340,387,191,578,39,617
公投第１１案,雲林縣,麥寮鄉,麥津村,6,1138,328,176,504,50,554
公投第１１案,雲林縣,麥寮鄉,麥津村,7,1551,513,213,726,45,771
公投第１１案,雲林縣,麥寮鄉,瓦磘村,8,715,214,77,291,26,317
公投第１１案,雲林縣,麥寮鄉,瓦磘村,9,1194,379,100,479,41,520
公投第１１案,雲林縣,麥寮鄉,興華村,10,1023,301,154,455,34,489
公投第１１案,雲林縣,麥寮鄉,興華村,11,1558,407,162,569,38,607
公投第１１案,雲林縣,麥寮鄉,海豐村,12,1187,303,165,468,20,488
公投第１１案,雲林縣,麥寮鄉,海豐村,13,983,276,126,402,20,422
公投第１１案,雲林縣,麥寮鄉,後安村,14,1363,416,191,607,66,673
公投第１１案,雲林縣,麥寮鄉,後安村,15,1596,502,198,700,67,767
公投第１１案,雲林縣,麥寮鄉,中興村,16,1469,542,254,796,68,864
公投第１１案,雲林縣,麥寮鄉,三盛村,17,964,258,133,391,45,436
公投第１１案,雲林縣,麥寮鄉,三盛村,18,1038,285,137,422,31,453
公投第１１案,雲林縣,麥寮鄉,崙後村,19,1230,402,172,574,47,621
公投第１１案,雲林縣,麥寮鄉,崙後村,20,1329,425,182,607,43,650
公投第１１案,雲林縣,麥寮鄉,橋頭村,21,1129,422,143,565,43,608
公投第１１案,雲林縣,麥寮鄉,橋頭村,22,1241,420,215,635,61,696
公投第１１案,雲林縣,麥寮鄉,橋頭村,23,1471,530,218,748,56,804
公投第１１案,雲林縣,麥寮鄉,新吉村,24,1107,392,182,574,63,637
公投第１１案,雲林縣,麥寮鄉,施厝村,25,1636,586,250,836,66,902
公投第１１案,雲林縣,麥寮鄉,施厝村,26,1755,563,267,830,41,871
公投第１１案,雲林縣,麥寮鄉,雷厝村,27,1158,396,191,587,43,630
公投第１１案,雲林縣,麥寮鄉,雷厝村,28,956,319,168,487,30,517
公投第１１案,雲林縣,臺西鄉,臺西村,29,1238,458,182,640,45,685
公投第１１案,雲林縣,臺西鄉,海南村,30,1091,330,148,478,36,514
公投第１１案,雲林縣,臺西鄉,海北村,31,1098,385,146,531,50,581
公投第１１案,雲林縣,臺西鄉,海口村,32,1048,309,124,433,18,451
公投第１１案,雲林縣,臺西鄉,海口村,33,1025,344,112,456,40,496
公投第１１案,雲林縣,臺西鄉,山寮村,34,850,285,109,394,38,432
公投第１１案,雲林縣,臺西鄉,溪頂村,35,1460,443,142,585,51,636
公投第１１案,雲林縣,臺西鄉,牛厝村,36,1180,260,122,382,62,444
公投第１１案,雲林縣,臺西鄉,牛厝村,37,710,159,62,221,18,239
公投第１１案,雲林縣,臺西鄉,泉州村,38,620,189,74,263,12,275
公投第１１案,雲林縣,臺西鄉,五榔村,39,449,118,74,192,23,215
公投第１１案,雲林縣,臺西鄉,光華村,40,687,174,83,257,26,283
公投第１１案,雲林縣,臺西鄉,五港村,41,1247,367,150,517,42,559
公投第１１案,雲林縣,臺西鄉,五港村,42,583,154,47,201,8,209
公投第１１案,雲林縣,臺西鄉,富琦村,43,1042,347,155,502,50,552
公投第１１案,雲林縣,臺西鄉,富琦村,44,472,139,66,205,15,220
公投第１１案,雲林縣,臺西鄉,永豐村,45,1409,438,160,598,21,619
公投第１１案,雲林縣,臺西鄉,和豐村,46,1061,354,145,499,68,567
公投第１１案,雲林縣,臺西鄉,和豐村,47,993,300,112,412,18,430
公投第１１案,雲林縣,臺西鄉,和豐村,48,1013,306,117,423,70,493
公投第１１案,雲林縣,臺西鄉,蚊港村,49,1233,414,152,566,44,610
公投第１１案,雲林縣,臺西鄉,蚊港村,50,616,170,79,249,15,264
公投第１１案,雲林縣,東勢鄉,月眉村,51,1207,319,185,504,39,543
公投第１１案,雲林縣,東勢鄉,復興村,52,540,215,95,310,19,329
公投第１１案,雲林縣,東勢鄉,嘉隆村,53,896,264,106,370,27,397
公投第１１案,雲林縣,東勢鄉,嘉隆村,54,728,247,119,366,28,394
公投第１１案,雲林縣,東勢鄉,東南村,55,1533,592,233,825,49,874
公投第１１案,雲林縣,東勢鄉,東北村,56,1203,482,191,673,46,719
公投第１１案,雲林縣,東勢鄉,龍潭村,57,817,247,110,357,38,395
公投第１１案,雲林縣,東勢鄉,程海村,58,546,206,86,292,33,325
公投第１１案,雲林縣,東勢鄉,昌南村,59,853,298,98,396,42,438
公投第１１案,雲林縣,東勢鄉,安南村,60,856,216,103,319,54,373
公投第１１案,雲林縣,東勢鄉,同安村,61,923,269,139,408,39,447
公投第１１案,雲林縣,東勢鄉,同安村,62,1022,331,161,492,37,529
公投第１１案,雲林縣,東勢鄉,四美村,63,634,153,65,218,24,242
公投第１１案,雲林縣,東勢鄉,四美村,64,394,121,44,165,13,178
公投第１１案,雲林縣,東勢鄉,新坤村,65,1087,265,131,396,39,435
公投第１１案,雲林縣,褒忠鄉,中民村,66,923,340,140,480,40,520
公投第１１案,雲林縣,褒忠鄉,中民村,67,993,369,188,557,30,587
公投第１１案,雲林縣,褒忠鄉,埔姜村,68,748,246,129,375,21,396
公投第１１案,雲林縣,褒忠鄉,埔姜村,69,702,253,94,347,12,359
公投第１１案,雲林縣,褒忠鄉,中勝村,70,752,270,97,367,18,385
公投第１１案,雲林縣,褒忠鄉,中勝村,71,756,271,125,396,13,409
公投第１１案,雲林縣,褒忠鄉,馬鳴村,72,490,167,72,239,17,256
公投第１１案,雲林縣,褒忠鄉,馬鳴村,73,1034,290,148,438,22,460
公投第１１案,雲林縣,褒忠鄉,新湖村,74,470,137,78,215,17,232
公投第１１案,雲林縣,褒忠鄉,新湖村,75,737,215,153,368,23,391
公投第１１案,雲林縣,褒忠鄉,有才村,76,878,294,123,417,27,444
公投第１１案,雲林縣,褒忠鄉,田洋村,77,778,230,112,342,48,390
公投第１１案,雲林縣,褒忠鄉,龍岩村,78,1224,358,211,569,43,612
公投第１１案,雲林縣,褒忠鄉,潮厝村,79,896,237,128,365,64,429
公投第１１案,雲林縣,土庫鎮,忠正里,80,809,327,148,475,39,514
公投第１１案,雲林縣,土庫鎮,順天里,81,896,390,271,661,30,691
公投第１１案,雲林縣,土庫鎮,宮北里,82,687,259,120,379,26,405
公投第１１案,雲林縣,土庫鎮,宮北里,83,702,328,129,457,18,475
公投第１１案,雲林縣,土庫鎮,越港里,84,1032,425,190,615,26,641
公投第１１案,雲林縣,土庫鎮,溪邊里,85,697,215,113,328,43,371
公投第１１案,雲林縣,土庫鎮,溪邊里,86,427,123,69,192,34,226
公投第１１案,雲林縣,土庫鎮,石廟里,87,1451,546,241,787,56,843
公投第１１案,雲林縣,土庫鎮,石廟里,88,1283,512,209,721,22,743
公投第１１案,雲林縣,土庫鎮,興新里,89,634,175,104,279,15,294
公投第１１案,雲林縣,土庫鎮,興新里,90,796,272,134,406,32,438
公投第１１案,雲林縣,土庫鎮,奮起里,91,745,201,99,300,32,332
公投第１１案,雲林縣,土庫鎮,奮起里,92,576,174,93,267,21,288
公投第１１案,雲林縣,土庫鎮,埤腳里,93,743,225,83,308,47,355
公投第１１案,雲林縣,土庫鎮,埤腳里,94,534,140,87,227,11,238
公投第１１案,雲林縣,土庫鎮,後埔里,95,1199,336,156,492,54,546
公投第１１案,雲林縣,土庫鎮,後埔里,96,1077,336,155,491,56,547
公投第１１案,雲林縣,土庫鎮,崙內里,97,819,206,108,314,21,335
公投第１１案,雲林縣,土庫鎮,崙內里,98,684,247,101,348,24,372
公投第１１案,雲林縣,土庫鎮,大荖里,99,843,316,123,439,32,471
公投第１１案,雲林縣,土庫鎮,東平里,100,916,328,119,447,46,493
公投第１１案,雲林縣,土庫鎮,東平里,101,948,304,147,451,30,481
公投第１１案,雲林縣,土庫鎮,南平里,102,914,425,44,469,29,498
公投第１１案,雲林縣,土庫鎮,南平里,103,860,312,118,430,52,482
公投第１１案,雲林縣,土庫鎮,西平里,104,929,289,143,432,39,471
公投第１１案,雲林縣,土庫鎮,西平里,105,875,257,125,382,43,425
公投第１１案,雲林縣,土庫鎮,北平里,106,896,248,112,360,36,396
公投第１１案,雲林縣,土庫鎮,新庄里,107,757,204,96,300,47,347
公投第１１案,雲林縣,土庫鎮,新庄里,108,683,195,107,302,29,331
公投第１１案,雲林縣,虎尾鎮,東仁里,109,1347,478,232,710,34,744
公投第１１案,雲林縣,虎尾鎮,東仁里,110,1258,472,236,708,31,739
公投第１１案,雲林縣,虎尾鎮,新興里,111,785,295,125,420,24,444
公投第１１案,雲林縣,虎尾鎮,新興里,112,890,283,126,409,29,438
公投第１１案,雲林縣,虎尾鎮,公安里,113,1413,563,245,808,38,846
公投第１１案,雲林縣,虎尾鎮,公安里,114,1431,583,259,842,34,876
公投第１１案,雲林縣,虎尾鎮,德興里,115,1224,434,191,625,34,659
公投第１１案,雲林縣,虎尾鎮,德興里,116,1325,335,206,541,22,563
公投第１１案,雲林縣,虎尾鎮,中山里,117,941,360,174,534,39,573
公投第１１案,雲林縣,虎尾鎮,西安里,118,1613,596,264,860,23,883
公投第１１案,雲林縣,虎尾鎮,西安里,119,1641,557,287,844,26,870
公投第１１案,雲林縣,虎尾鎮,立仁里,120,1200,462,219,681,31,712
公投第１１案,雲林縣,虎尾鎮,立仁里,121,1294,473,245,718,42,760
公投第１１案,雲林縣,虎尾鎮,立仁里,122,1273,489,228,717,12,729
公投第１１案,雲林縣,虎尾鎮,安慶里,123,1438,511,346,857,29,886
公投第１１案,雲林縣,虎尾鎮,平和里,124,1361,521,241,762,24,786
公投第１１案,雲林縣,虎尾鎮,平和里,125,1444,583,246,829,39,868
公投第１１案,雲林縣,虎尾鎮,平和里,126,1490,635,273,908,30,938
公投第１１案,雲林縣,虎尾鎮,興南里,127,1307,510,277,787,44,831
公投第１１案,雲林縣,虎尾鎮,興南里,128,967,293,177,470,18,488
公投第１１案,雲林縣,虎尾鎮,新吉里,129,1865,663,311,974,20,994
公投第１１案,雲林縣,虎尾鎮,新吉里,130,1880,676,333,1009,33,1042
公投第１１案,雲林縣,虎尾鎮,穎川里,131,1099,375,173,548,35,583
公投第１１案,雲林縣,虎尾鎮,穎川里,132,901,346,153,499,17,516
公投第１１案,雲林縣,虎尾鎮,延平里,133,1120,389,191,580,31,611
公投第１１案,雲林縣,虎尾鎮,建國里,134,545,168,79,247,5,252
公投第１１案,雲林縣,虎尾鎮,埒內里,135,1420,498,230,728,43,771
公投第１１案,雲林縣,虎尾鎮,埒內里,136,1248,427,191,618,26,644
公投第１１案,雲林縣,虎尾鎮,堀頭里,137,799,291,127,418,19,437
公投第１１案,雲林縣,虎尾鎮,安溪里,138,836,264,149,413,34,447
公投第１１案,雲林縣,虎尾鎮,安溪里,139,924,264,161,425,30,455
公投第１１案,雲林縣,虎尾鎮,興中里,140,1648,488,215,703,24,727
公投第１１案,雲林縣,虎尾鎮,廉使里,141,1616,474,231,705,74,779
公投第１１案,雲林縣,虎尾鎮,廉使里,142,1546,499,244,743,44,787
公投第１１案,雲林縣,虎尾鎮,惠來里,143,1283,466,167,633,31,664
公投第１１案,雲林縣,虎尾鎮,惠來里,144,1078,377,169,546,26,572
公投第１１案,雲林縣,虎尾鎮,頂溪里,145,1313,425,191,616,36,652
公投第１１案,雲林縣,虎尾鎮,頂溪里,146,1284,399,203,602,32,634
公投第１１案,雲林縣,虎尾鎮,中溪里,147,1356,464,209,673,55,728
公投第１１案,雲林縣,虎尾鎮,下溪里,148,1504,528,243,771,51,822
公投第１１案,雲林縣,虎尾鎮,東屯里,149,1224,357,168,525,30,555
公投第１１案,雲林縣,虎尾鎮,西屯里,150,1509,454,212,666,45,711
公投第１１案,雲林縣,虎尾鎮,芳草里,151,855,184,117,301,65,366
公投第１１案,雲林縣,虎尾鎮,墾地里,152,1549,431,214,645,76,721
公投第１１案,雲林縣,虎尾鎮,北溪里,153,851,274,122,396,17,413
公投第１１案,雲林縣,虎尾鎮,三合里,154,1272,421,168,589,50,639
公投第１１案,雲林縣,四湖鄉,四湖村,155,1082,329,113,442,40,482
公投第１１案,雲林縣,四湖鄉,四湖村,156,676,255,82,337,37,374
公投第１１案,雲林縣,四湖鄉,湖西村,157,862,304,113,417,16,433
公投第１１案,雲林縣,四湖鄉,湖西村,158,477,127,55,182,12,194
公投第１１案,雲林縣,四湖鄉,湖西村,159,952,370,144,514,28,542
公投第１１案,雲林縣,四湖鄉,新庄村,160,650,159,75,234,14,248
公投第１１案,雲林縣,四湖鄉,溪底村,161,969,292,118,410,25,435
公投第１１案,雲林縣,四湖鄉,鹿場村,162,925,223,113,336,39,375
公投第１１案,雲林縣,四湖鄉,蔡厝村,163,914,266,110,376,25,401
公投第１１案,雲林縣,四湖鄉,湖寮村,164,759,136,70,206,39,245
公投第１１案,雲林縣,四湖鄉,施湖村,165,1219,315,123,438,34,472
公投第１１案,雲林縣,四湖鄉,羊調村,166,937,215,81,296,28,324
公投第１１案,雲林縣,四湖鄉,內湖村,167,773,159,79,238,19,257
公投第１１案,雲林縣,四湖鄉,飛東村,168,555,134,59,193,32,225
公投第１１案,雲林縣,四湖鄉,飛沙村,169,876,196,91,287,21,308
公投第１１案,雲林縣,四湖鄉,三姓村,170,360,84,40,124,15,139
公投第１１案,雲林縣,四湖鄉,崙北村,171,885,167,68,235,32,267
公投第１１案,雲林縣,四湖鄉,崙北村,172,833,171,84,255,31,286
公投第１１案,雲林縣,四湖鄉,崙南村,173,785,200,95,295,31,326
公投第１１案,雲林縣,四湖鄉,廣溝村,174,705,237,75,312,25,337
公投第１１案,雲林縣,四湖鄉,箔子村,175,927,230,83,313,22,335
公投第１１案,雲林縣,四湖鄉,箔東村,176,1058,227,111,338,50,388
公投第１１案,雲林縣,四湖鄉,林厝村,177,1071,260,109,369,40,409
公投第１１案,雲林縣,四湖鄉,林東村,178,1022,179,88,267,21,288
公投第１１案,雲林縣,四湖鄉,溪尾村,179,711,197,81,278,36,314
公投第１１案,雲林縣,元長鄉,長南村,180,915,311,121,432,33,465
公投第１１案,雲林縣,元長鄉,長南村,181,1284,419,177,596,24,620
公投第１１案,雲林縣,元長鄉,長南村,182,1150,354,149,503,44,547
公投第１１案,雲林縣,元長鄉,長北村,183,744,211,97,308,28,336
公投第１１案,雲林縣,元長鄉,長北村,184,790,261,97,358,36,394
公投第１１案,雲林縣,元長鄉,子茂村,185,1356,359,150,509,54,563
公投第１１案,雲林縣,元長鄉,後湖村,186,739,213,111,324,37,361
公投第１１案,雲林縣,元長鄉,山內村,187,965,254,115,369,29,398
公投第１１案,雲林縣,元長鄉,合和村,188,1080,297,123,420,44,464
公投第１１案,雲林縣,元長鄉,五塊村,189,948,247,100,347,40,387
公投第１１案,雲林縣,元長鄉,潭西村,190,762,139,80,219,18,237
公投第１１案,雲林縣,元長鄉,潭東村,191,582,148,108,256,14,270
公投第１１案,雲林縣,元長鄉,客厝村,192,865,215,105,320,17,337
公投第１１案,雲林縣,元長鄉,卓運村,193,362,60,17,77,6,83
公投第１１案,雲林縣,元長鄉,頂寮村,194,1162,308,142,450,25,475
公投第１１案,雲林縣,元長鄉,下寮村,195,1527,465,169,634,47,681
公投第１１案,雲林縣,元長鄉,龍岩村,196,1006,307,128,435,55,490
公投第１１案,雲林縣,元長鄉,西莊村,197,855,261,98,359,14,373
公投第１１案,雲林縣,元長鄉,鹿北村,198,1181,358,148,506,53,559
公投第１１案,雲林縣,元長鄉,鹿南村,199,864,242,90,332,27,359
公投第１１案,雲林縣,元長鄉,瓦磘村,200,667,165,79,244,29,273
公投第１１案,雲林縣,元長鄉,瓦磘村,201,878,219,107,326,33,359
公投第１１案,雲林縣,元長鄉,內寮村,202,610,142,72,214,12,226
公投第１１案,雲林縣,元長鄉,崙仔村,203,837,245,105,350,49,399
公投第１１案,雲林縣,元長鄉,新吉村,204,701,224,102,326,30,356
公投第１１案,雲林縣,口湖鄉,口湖村,205,1134,355,198,553,48,601
公投第１１案,雲林縣,口湖鄉,湖東村,206,1225,401,181,582,83,665
公投第１１案,雲林縣,口湖鄉,頂湖村,207,647,181,67,248,29,277
公投第１１案,雲林縣,口湖鄉,埔南村,208,709,233,108,341,21,362
公投第１１案,雲林縣,口湖鄉,埔北村,209,900,255,126,381,55,436
公投第１１案,雲林縣,口湖鄉,謝厝村,210,1011,305,152,457,52,509
公投第１１案,雲林縣,口湖鄉,蚵寮村,211,1437,434,164,598,25,623
公投第１１案,雲林縣,口湖鄉,下崙村,212,848,197,83,280,12,292
公投第１１案,雲林縣,口湖鄉,下崙村,213,1193,345,135,480,23,503
公投第１１案,雲林縣,口湖鄉,崙中村,214,759,172,74,246,42,288
公投第１１案,雲林縣,口湖鄉,崙中村,215,815,207,127,334,37,371
公投第１１案,雲林縣,口湖鄉,崙東村,216,1460,463,197,660,65,725
公投第１１案,雲林縣,口湖鄉,青蚶村,217,556,110,70,180,10,190
公投第１１案,雲林縣,口湖鄉,港東村,218,1532,472,193,665,49,714
公投第１１案,雲林縣,口湖鄉,港西村,219,847,286,86,372,22,394
公投第１１案,雲林縣,口湖鄉,台子村,220,374,98,57,155,27,182
公投第１１案,雲林縣,口湖鄉,台子村,221,1508,484,221,705,130,835
公投第１１案,雲林縣,口湖鄉,成龍村,222,951,379,106,485,48,533
公投第１１案,雲林縣,口湖鄉,梧南村,223,910,326,138,464,63,527
公投第１１案,雲林縣,口湖鄉,梧南村,224,879,328,146,474,44,518
公投第１１案,雲林縣,口湖鄉,梧北村,225,1213,374,133,507,88,595
公投第１１案,雲林縣,口湖鄉,水井村,226,952,317,110,427,51,478
公投第１１案,雲林縣,口湖鄉,後厝村,227,720,235,119,354,35,389
公投第１１案,雲林縣,口湖鄉,湖口村,228,1006,240,126,366,33,399
公投第１１案,雲林縣,口湖鄉,過港村,229,607,189,43,232,11,243
公投第１１案,雲林縣,水林鄉,水北村,230,1355,387,187,574,52,626
公投第１１案,雲林縣,水林鄉,水北村,231,887,312,143,455,8,463
公投第１１案,雲林縣,水林鄉,水南村,232,1234,448,173,621,47,668
公投第１１案,雲林縣,水林鄉,水南村,233,763,231,129,360,14,374
公投第１１案,雲林縣,水林鄉,萬興村,234,721,173,96,269,40,309
公投第１１案,雲林縣,水林鄉,尖山村,235,647,169,58,227,15,242
公投第１１案,雲林縣,水林鄉,大溝村,236,989,248,126,374,61,435
公投第１１案,雲林縣,水林鄉,順興村,237,837,219,97,316,19,335
公投第１１案,雲林縣,水林鄉,大山村,238,1081,275,110,385,20,405
公投第１１案,雲林縣,水林鄉,後寮村,239,704,213,95,308,29,337
公投第１１案,雲林縣,水林鄉,春埔村,240,1006,309,133,442,59,501
公投第１１案,雲林縣,水林鄉,西井村,241,651,185,70,255,10,265
公投第１１案,雲林縣,水林鄉,車港村,242,607,160,73,233,16,249
公投第１１案,雲林縣,水林鄉,蘇秦村,243,1033,248,127,375,70,445
公投第１１案,雲林縣,水林鄉,灣東村,244,631,141,49,190,15,205
公投第１１案,雲林縣,水林鄉,灣西村,245,961,265,105,370,45,415
公投第１１案,雲林縣,水林鄉,蕃薯村,246,951,240,122,362,63,425
公投第１１案,雲林縣,水林鄉,山腳村,247,838,252,102,354,18,372
公投第１１案,雲林縣,水林鄉,松北村,248,1055,328,105,433,70,503
公投第１１案,雲林縣,水林鄉,松中村,249,512,112,42,154,25,179
公投第１１案,雲林縣,水林鄉,松西村,250,671,158,74,232,13,245
公投第１１案,雲林縣,水林鄉,欍埔村,251,693,119,64,183,39,222
公投第１１案,雲林縣,水林鄉,塭底村,252,689,155,60,215,31,246
公投第１１案,雲林縣,水林鄉,海埔村,253,1022,315,128,443,52,495
公投第１１案,雲林縣,水林鄉,土厝村,254,1191,354,118,472,32,504
公投第１１案,雲林縣,水林鄉,溪墘村,255,779,275,112,387,33,420
公投第１１案,雲林縣,北港鎮,東陽里,256,724,267,115,382,45,427
公投第１１案,雲林縣,北港鎮,光民里,257,688,247,143,390,49,439
公投第１１案,雲林縣,北港鎮,東華里,258,452,178,59,237,31,268
公投第１１案,雲林縣,北港鎮,南安里,259,866,340,129,469,41,510
公投第１１案,雲林縣,北港鎮,中和里,260,336,115,56,171,11,182
公投第１１案,雲林縣,北港鎮,義民里,261,395,145,52,197,19,216
公投第１１案,雲林縣,北港鎮,共榮里,262,376,173,48,221,18,239
公投第１１案,雲林縣,北港鎮,西勢里,263,950,351,174,525,21,546
公投第１１案,雲林縣,北港鎮,仁和里,264,512,210,93,303,28,331
公投第１１案,雲林縣,北港鎮,賜福里,265,324,114,56,170,31,201
公投第１１案,雲林縣,北港鎮,公舘里,266,546,199,81,280,24,304
公投第１１案,雲林縣,北港鎮,大同里,267,433,183,71,254,18,272
公投第１１案,雲林縣,北港鎮,大同里,268,751,272,114,386,46,432
公投第１１案,雲林縣,北港鎮,仁安里,269,442,193,58,251,22,273
公投第１１案,雲林縣,北港鎮,華勝里,270,1151,420,209,629,40,669
公投第１１案,雲林縣,北港鎮,華勝里,271,1224,471,212,683,36,719
公投第１１案,雲林縣,北港鎮,華勝里,272,1211,464,185,649,31,680
公投第１１案,雲林縣,北港鎮,華勝里,273,1326,511,199,710,41,751
公投第１１案,雲林縣,北港鎮,光復里,274,744,309,145,454,29,483
公投第１１案,雲林縣,北港鎮,光復里,275,977,417,175,592,35,627
公投第１１案,雲林縣,北港鎮,扶朝里,276,960,343,152,495,41,536
公投第１１案,雲林縣,北港鎮,水埔里,277,494,129,57,186,9,195
公投第１１案,雲林縣,北港鎮,新街里,278,1364,519,228,747,43,790
公投第１１案,雲林縣,北港鎮,新街里,279,1123,382,218,600,58,658
公投第１１案,雲林縣,北港鎮,新街里,280,1451,532,258,790,34,824
公投第１１案,雲林縣,北港鎮,新街里,281,1162,420,237,657,38,695
公投第１１案,雲林縣,北港鎮,新街里,282,1130,386,176,562,32,594
公投第１１案,雲林縣,北港鎮,劉厝里,283,1149,394,176,570,34,604
公投第１１案,雲林縣,北港鎮,後溝里,284,533,152,70,222,18,240
公投第１１案,雲林縣,北港鎮,後溝里,285,433,180,91,271,19,290
公投第１１案,雲林縣,北港鎮,新厝里,286,377,140,42,182,8,190
公投第１１案,雲林縣,北港鎮,府番里,287,809,240,93,333,23,356
公投第１１案,雲林縣,北港鎮,草湖里,288,1397,428,176,604,47,651
公投第１１案,雲林縣,北港鎮,溝皂里,289,1145,318,155,473,57,530
公投第１１案,雲林縣,北港鎮,番溝里,290,828,194,80,274,43,317
公投第１１案,雲林縣,北港鎮,大北里,291,557,145,72,217,12,229
公投第１１案,雲林縣,北港鎮,好收里,292,1060,316,157,473,35,508
公投第１１案,雲林縣,北港鎮,好收里,293,577,191,68,259,28,287
公投第１１案,雲林縣,北港鎮,樹腳里,294,931,235,135,370,44,414
公投第１１案,雲林縣,北港鎮,樹腳里,295,1018,350,167,517,32,549
公投第１１案,雲林縣,北港鎮,樹腳里,296,1032,403,189,592,15,607
公投第１１案,雲林縣,崙背鄉,東明村,297,1176,410,191,601,62,663
公投第１１案,雲林縣,崙背鄉,西榮村,298,1439,478,205,683,50,733
公投第１１案,雲林縣,崙背鄉,南陽村,299,1027,405,165,570,44,614
公投第１１案,雲林縣,崙背鄉,南陽村,300,1259,485,192,677,42,719
公投第１１案,雲林縣,崙背鄉,崙前村,301,1058,347,151,498,19,517
公投第１１案,雲林縣,崙背鄉,崙前村,302,998,325,118,443,24,467
公投第１１案,雲林縣,崙背鄉,羅厝村,303,968,324,134,458,26,484
公投第１１案,雲林縣,崙背鄉,羅厝村,304,1055,348,161,509,45,554
公投第１１案,雲林縣,崙背鄉,港尾村,305,1315,373,199,572,58,630
公投第１１案,雲林縣,崙背鄉,阿勸村,306,1027,219,97,316,28,344
公投第１１案,雲林縣,崙背鄉,阿勸村,307,997,388,137,525,68,593
公投第１１案,雲林縣,崙背鄉,五魁村,308,807,285,110,395,27,422
公投第１１案,雲林縣,崙背鄉,大有村,309,698,179,91,270,21,291
公投第１１案,雲林縣,崙背鄉,大有村,310,804,201,130,331,44,375
公投第１１案,雲林縣,崙背鄉,豐榮村,311,867,280,127,407,27,434
公投第１１案,雲林縣,崙背鄉,豐榮村,312,886,228,117,345,34,379
公投第１１案,雲林縣,崙背鄉,草湖村,313,1476,365,166,531,81,612
公投第１１案,雲林縣,崙背鄉,舊庄村,314,1159,290,91,381,30,411
公投第１１案,雲林縣,崙背鄉,水尾村,315,1220,453,178,631,53,684
公投第１１案,雲林縣,崙背鄉,枋南村,316,814,256,134,390,33,423
公投第１１案,雲林縣,二崙鄉,崙東村,317,1463,437,217,654,33,687
公投第１１案,雲林縣,二崙鄉,崙西村,318,1738,508,254,762,55,817
公投第１１案,雲林縣,二崙鄉,來惠村,319,625,179,77,256,45,301
公投第１１案,雲林縣,二崙鄉,來惠村,320,1018,310,149,459,48,507
公投第１１案,雲林縣,二崙鄉,三和村,321,448,122,51,173,3,176
公投第１１案,雲林縣,二崙鄉,三和村,322,1048,244,125,369,41,410
公投第１１案,雲林縣,二崙鄉,湳仔村,323,1161,363,203,566,68,634
公投第１１案,雲林縣,二崙鄉,田尾村,324,991,321,155,476,39,515
公投第１１案,雲林縣,二崙鄉,田尾村,325,849,314,147,461,43,504
公投第１１案,雲林縣,二崙鄉,定安村,326,890,278,128,406,44,450
公投第１１案,雲林縣,二崙鄉,永定村,327,1427,435,201,636,71,707
公投第１１案,雲林縣,二崙鄉,大華村,328,891,311,140,451,22,473
公投第１１案,雲林縣,二崙鄉,義庄村,329,757,206,98,304,26,330
公投第１１案,雲林縣,二崙鄉,楊賢村,330,1497,440,200,640,93,733
公投第１１案,雲林縣,二崙鄉,港後村,331,1171,346,159,505,60,565
公投第１１案,雲林縣,二崙鄉,港後村,332,686,259,102,361,38,399
公投第１１案,雲林縣,二崙鄉,大義村,333,864,234,85,319,68,387
公投第１１案,雲林縣,二崙鄉,油車村,334,1073,375,178,553,63,616
公投第１１案,雲林縣,二崙鄉,油車村,335,696,187,98,285,18,303
公投第１１案,雲林縣,二崙鄉,大庄村,336,1271,310,138,448,45,493
公投第１１案,雲林縣,二崙鄉,庄西村,337,912,267,104,371,37,408
公投第１１案,雲林縣,二崙鄉,大同村,338,861,246,112,358,32,390
公投第１１案,雲林縣,二崙鄉,復興村,339,1030,277,135,412,45,457
公投第１１案,雲林縣,西螺鎮,振興里,340,1590,511,279,790,60,850
公投第１１案,雲林縣,西螺鎮,大園里,341,1741,604,293,897,58,955
公投第１１案,雲林縣,西螺鎮,廣福里,342,1080,461,206,667,39,706
公投第１１案,雲林縣,西螺鎮,廣福里,343,1040,444,82,526,35,561
公投第１１案,雲林縣,西螺鎮,正興里,344,1346,503,259,762,23,785
公投第１１案,雲林縣,西螺鎮,正興里,345,1625,605,247,852,45,897
公投第１１案,雲林縣,西螺鎮,永安里,346,354,161,58,219,13,232
公投第１１案,雲林縣,西螺鎮,中和里,347,580,205,92,297,27,324
公投第１１案,雲林縣,西螺鎮,福興里,348,591,236,115,351,23,374
公投第１１案,雲林縣,西螺鎮,光華里,349,1050,394,203,597,20,617
公投第１１案,雲林縣,西螺鎮,中興里,350,1147,456,206,662,51,713
公投第１１案,雲林縣,西螺鎮,中興里,351,1602,437,374,811,53,864
公投第１１案,雲林縣,西螺鎮,漢光里,352,1452,625,114,739,39,778
公投第１１案,雲林縣,西螺鎮,漢光里,353,1578,589,251,840,54,894
公投第１１案,雲林縣,西螺鎮,漢光里,354,1305,457,181,638,23,661
公投第１１案,雲林縣,西螺鎮,新安里,355,1327,405,203,608,41,649
公投第１１案,雲林縣,西螺鎮,新豐里,356,1516,496,252,748,61,809
公投第１１案,雲林縣,西螺鎮,大新里,357,828,232,110,342,26,368
公投第１１案,雲林縣,西螺鎮,大新里,358,788,237,88,325,13,338
公投第１１案,雲林縣,西螺鎮,埤頭里,359,863,267,141,408,58,466
公投第１１案,雲林縣,西螺鎮,東興里,360,984,300,150,450,71,521
公投第１１案,雲林縣,西螺鎮,鹿場里,361,1514,515,211,726,97,823
公投第１１案,雲林縣,西螺鎮,廣興里,362,870,279,132,411,57,468
公投第１１案,雲林縣,西螺鎮,頂湳里,363,971,317,162,479,43,522
公投第１１案,雲林縣,西螺鎮,吳厝里,364,1304,361,192,553,54,607
公投第１１案,雲林縣,西螺鎮,九隆里,365,726,221,112,333,27,360
公投第１１案,雲林縣,西螺鎮,下湳里,366,823,291,130,421,26,447
公投第１１案,雲林縣,西螺鎮,七座里,367,886,236,125,361,10,371
公投第１１案,雲林縣,西螺鎮,公舘里,368,1373,413,224,637,46,683
公投第１１案,雲林縣,西螺鎮,詔安里,369,983,342,144,486,62,548
公投第１１案,雲林縣,西螺鎮,河南里,370,1014,346,173,519,35,554
公投第１１案,雲林縣,西螺鎮,安定里,371,939,273,151,424,51,475
公投第１１案,雲林縣,西螺鎮,安定里,372,866,301,131,432,29,461
公投第１１案,雲林縣,西螺鎮,福田里,373,1486,433,226,659,70,729
公投第１１案,雲林縣,莿桐鄉,莿桐村,374,1507,547,260,807,48,855
公投第１１案,雲林縣,莿桐鄉,莿桐村,375,1300,472,205,677,32,709
公投第１１案,雲林縣,莿桐鄉,莿桐村,376,1272,555,129,684,73,757
公投第１１案,雲林縣,莿桐鄉,甘厝村,377,861,257,155,412,47,459
公投第１１案,雲林縣,莿桐鄉,甘西村,378,1565,485,225,710,47,757
公投第１１案,雲林縣,莿桐鄉,興桐村,379,577,219,78,297,12,309
公投第１１案,雲林縣,莿桐鄉,興桐村,380,636,186,96,282,25,307
公投第１１案,雲林縣,莿桐鄉,義和村,381,1110,347,176,523,59,582
公投第１１案,雲林縣,莿桐鄉,埔子村,382,973,342,200,542,47,589
公投第１１案,雲林縣,莿桐鄉,埔子村,383,985,341,190,531,46,577
公投第１１案,雲林縣,莿桐鄉,大美村,384,1707,644,292,936,81,1017
公投第１１案,雲林縣,莿桐鄉,大美村,385,1284,475,217,692,40,732
公投第１１案,雲林縣,莿桐鄉,埔尾村,386,1293,478,217,695,46,741
公投第１１案,雲林縣,莿桐鄉,興貴村,387,900,327,138,465,45,510
公投第１１案,雲林縣,莿桐鄉,興貴村,388,1040,376,177,553,70,623
公投第１１案,雲林縣,莿桐鄉,饒平村,389,1165,392,178,570,32,602
公投第１１案,雲林縣,莿桐鄉,四合村,390,871,304,147,451,44,495
公投第１１案,雲林縣,莿桐鄉,四合村,391,885,358,148,506,36,542
公投第１１案,雲林縣,莿桐鄉,麻園村,392,1489,477,216,693,41,734
公投第１１案,雲林縣,莿桐鄉,五華村,393,1347,409,188,597,74,671
公投第１１案,雲林縣,莿桐鄉,六合村,394,1150,399,206,605,64,669
公投第１１案,雲林縣,莿桐鄉,六合村,395,653,256,108,364,28,392
公投第１１案,雲林縣,林內鄉,林南村,396,1036,437,176,613,43,656
公投第１１案,雲林縣,林內鄉,林中村,397,1490,543,257,800,39,839
公投第１１案,雲林縣,林內鄉,林中村,398,1491,520,226,746,57,803
公投第１１案,雲林縣,林內鄉,林中村,399,671,244,84,328,30,358
公投第１１案,雲林縣,林內鄉,林北村,400,1436,572,220,792,74,866
公投第１１案,雲林縣,林內鄉,林北村,401,751,273,125,398,46,444
公投第１１案,雲林縣,林內鄉,坪頂村,402,535,191,97,288,13,301
公投第１１案,雲林縣,林內鄉,林茂村,403,811,250,107,357,34,391
公投第１１案,雲林縣,林內鄉,九芎村,404,1339,468,237,705,65,770
公投第１１案,雲林縣,林內鄉,九芎村,405,1286,467,189,656,52,708
公投第１１案,雲林縣,林內鄉,湖本村,406,646,212,118,330,29,359
公投第１１案,雲林縣,林內鄉,烏塗村,407,1158,440,181,621,41,662
公投第１１案,雲林縣,林內鄉,烏麻村,408,1090,400,176,576,43,619
公投第１１案,雲林縣,林內鄉,重興村,409,950,368,141,509,68,577
公投第１１案,雲林縣,林內鄉,重興村,410,861,285,160,445,42,487
公投第１１案,雲林縣,斗六市,信義里,411,644,204,133,337,18,355
公投第１１案,雲林縣,斗六市,四維里,412,617,219,110,329,20,349
公投第１１案,雲林縣,斗六市,太平里,413,764,303,168,471,33,504
公投第１１案,雲林縣,斗六市,中和里,414,784,324,149,473,20,493
公投第１１案,雲林縣,斗六市,光興里,415,760,275,131,406,22,428
公投第１１案,雲林縣,斗六市,鎮西里,416,1881,733,355,1088,51,1139
公投第１１案,雲林縣,斗六市,鎮西里,417,1829,673,285,958,47,1005
公投第１１案,雲林縣,斗六市,鎮東里,418,1255,532,238,770,26,796
公投第１１案,雲林縣,斗六市,鎮東里,419,1090,476,205,681,23,704
公投第１１案,雲林縣,斗六市,文化里,420,1103,453,194,647,28,675
公投第１１案,雲林縣,斗六市,文化里,421,1176,464,216,680,31,711
公投第１１案,雲林縣,斗六市,三平里,422,1529,596,250,846,27,873
公投第１１案,雲林縣,斗六市,三平里,423,1335,554,207,761,27,788
公投第１１案,雲林縣,斗六市,三平里,424,1770,692,341,1033,45,1078
公投第１１案,雲林縣,斗六市,明德里,425,1308,515,233,748,31,779
公投第１１案,雲林縣,斗六市,明德里,426,2171,796,333,1129,47,1176
公投第１１案,雲林縣,斗六市,鎮北里,427,1193,476,193,669,26,695
公投第１１案,雲林縣,斗六市,鎮北里,428,1572,661,288,949,28,977
公投第１１案,雲林縣,斗六市,公誠里,429,1009,389,168,557,21,578
公投第１１案,雲林縣,斗六市,公誠里,430,1195,488,228,716,33,749
公投第１１案,雲林縣,斗六市,忠孝里,431,1415,572,250,822,51,873
公投第１１案,雲林縣,斗六市,仁愛里,432,1101,452,197,649,28,677
公投第１１案,雲林縣,斗六市,八德里,433,1648,602,288,890,30,920
公投第１１案,雲林縣,斗六市,八德里,434,1588,577,229,806,30,836
公投第１１案,雲林縣,斗六市,公正里,435,1392,532,276,808,21,829
公投第１１案,雲林縣,斗六市,公正里,436,1422,441,273,714,24,738
公投第１１案,雲林縣,斗六市,重光里,437,1187,404,145,549,28,577
公投第１１案,雲林縣,斗六市,重光里,438,1142,381,191,572,27,599
公投第１１案,雲林縣,斗六市,林頭里,439,1421,583,264,847,28,875
公投第１１案,雲林縣,斗六市,林頭里,440,1261,475,225,700,25,725
公投第１１案,雲林縣,斗六市,林頭里,441,1506,535,265,800,24,824
公投第１１案,雲林縣,斗六市,成功里,442,1214,440,253,693,32,725
公投第１１案,雲林縣,斗六市,成功里,443,1362,577,259,836,36,872
公投第１１案,雲林縣,斗六市,鎮南里,444,1097,397,200,597,17,614
公投第１１案,雲林縣,斗六市,鎮南里,445,1262,503,216,719,23,742
公投第１１案,雲林縣,斗六市,鎮南里,446,1154,409,201,610,26,636
公投第１１案,雲林縣,斗六市,社口里,447,847,314,160,474,22,496
公投第１１案,雲林縣,斗六市,社口里,448,1439,543,272,815,28,843
公投第１１案,雲林縣,斗六市,龍潭里,449,1747,672,351,1023,48,1071
公投第１１案,雲林縣,斗六市,嘉東里,450,1418,524,270,794,25,819
公投第１１案,雲林縣,斗六市,崙峰里,451,1112,425,171,596,32,628
公投第１１案,雲林縣,斗六市,崙峰里,452,1302,485,246,731,29,760
公投第１１案,雲林縣,斗六市,溝埧里,453,669,289,131,420,24,444
公投第１１案,雲林縣,斗六市,江厝里,454,752,264,144,408,27,435
公投第１１案,雲林縣,斗六市,江厝里,455,1450,528,243,771,24,795
公投第１１案,雲林縣,斗六市,三光里,456,555,211,85,296,25,321
公投第１１案,雲林縣,斗六市,久安里,457,1470,514,227,741,31,772
公投第１１案,雲林縣,斗六市,久安里,458,927,386,162,548,15,563
公投第１１案,雲林縣,斗六市,虎溪里,459,1893,720,346,1066,37,1103
公投第１１案,雲林縣,斗六市,虎溪里,460,1708,638,292,930,62,992
公投第１１案,雲林縣,斗六市,虎溪里,461,1773,602,264,866,42,908
公投第１１案,雲林縣,斗六市,保庄里,462,1412,558,252,810,28,838
公投第１１案,雲林縣,斗六市,保庄里,463,1354,571,248,819,29,848
公投第１１案,雲林縣,斗六市,保庄里,464,1267,461,241,702,24,726
公投第１１案,雲林縣,斗六市,保庄里,465,1273,457,222,679,21,700
公投第１１案,雲林縣,斗六市,長平里,466,1748,616,232,848,52,900
公投第１１案,雲林縣,斗六市,榴中里,467,1238,491,201,692,42,734
公投第１１案,雲林縣,斗六市,榴中里,468,1648,607,247,854,36,890
公投第１１案,雲林縣,斗六市,榴中里,469,1520,608,278,886,30,916
公投第１１案,雲林縣,斗六市,榴北里,470,1087,410,156,566,27,593
公投第１１案,雲林縣,斗六市,榴南里,471,1904,702,333,1035,47,1082
公投第１１案,雲林縣,斗六市,梅林里,472,702,295,115,410,26,436
公投第１１案,雲林縣,斗六市,梅林里,473,1111,451,196,647,28,675
公投第１１案,雲林縣,斗六市,湖山里,474,1123,384,161,545,26,571
公投第１１案,雲林縣,斗六市,長安里,475,1146,409,186,595,34,629
公投第１１案,雲林縣,斗六市,長安里,476,1786,599,323,922,41,963
公投第１１案,雲林縣,斗六市,溪洲里,477,1023,369,190,559,44,603
公投第１１案,雲林縣,斗六市,溪洲里,478,2072,735,360,1095,57,1152
公投第１１案,雲林縣,斗六市,十三里,479,1128,397,188,585,23,608
公投第１１案,雲林縣,大埤鄉,北和村,480,750,272,111,383,20,403
公投第１１案,雲林縣,大埤鄉,吉田村,481,719,241,110,351,22,373
公投第１１案,雲林縣,大埤鄉,豐岡村,482,603,242,66,308,15,323
公投第１１案,雲林縣,大埤鄉,聯美村,483,1106,332,152,484,46,530
公投第１１案,雲林縣,大埤鄉,南和村,484,1495,495,250,745,51,796
公投第１１案,雲林縣,大埤鄉,南和村,485,600,232,102,334,25,359
公投第１１案,雲林縣,大埤鄉,大德村,486,1004,366,183,549,45,594
公投第１１案,雲林縣,大埤鄉,松竹村,487,948,251,126,377,22,399
公投第１１案,雲林縣,大埤鄉,豐田村,488,1539,542,232,774,57,831
公投第１１案,雲林縣,大埤鄉,尚義村,489,1430,456,214,670,38,708
公投第１１案,雲林縣,大埤鄉,尚義村,490,465,159,66,225,15,240
公投第１１案,雲林縣,大埤鄉,嘉興村,491,1307,439,186,625,39,664
公投第１１案,雲林縣,大埤鄉,嘉興村,492,474,156,82,238,11,249
公投第１１案,雲林縣,大埤鄉,三結村,493,1220,428,235,663,69,732
公投第１１案,雲林縣,大埤鄉,怡然村,494,733,266,108,374,18,392
公投第１１案,雲林縣,大埤鄉,北鎮村,495,681,240,110,350,26,376
公投第１１案,雲林縣,大埤鄉,興安村,496,712,186,96,282,21,303
公投第１１案,雲林縣,大埤鄉,西鎮村,497,723,215,97,312,37,349
公投第１１案,雲林縣,斗南鎮,東仁里,498,1166,480,197,677,36,713
公投第１１案,雲林縣,斗南鎮,西岐里,499,1135,480,198,678,34,712
公投第１１案,雲林縣,斗南鎮,西岐里,500,975,409,175,584,21,605
公投第１１案,雲林縣,斗南鎮,大同里,501,1459,568,272,840,37,877
公投第１１案,雲林縣,斗南鎮,大同里,502,1351,488,267,755,41,796
公投第１１案,雲林縣,斗南鎮,南昌里,503,1321,488,225,713,35,748
公投第１１案,雲林縣,斗南鎮,南昌里,504,907,341,126,467,32,499
公投第１１案,雲林縣,斗南鎮,北銘里,505,1473,608,273,881,47,928
公投第１１案,雲林縣,斗南鎮,中天里,506,1277,495,256,751,53,804
公投第１１案,雲林縣,斗南鎮,林子里,507,1333,488,214,702,55,757
公投第１１案,雲林縣,斗南鎮,石龜里,508,777,300,111,411,21,432
公投第１１案,雲林縣,斗南鎮,石溪里,509,877,274,165,439,31,470
公投第１１案,雲林縣,斗南鎮,靖興里,510,899,341,108,449,44,493
公投第１１案,雲林縣,斗南鎮,新南里,511,688,225,78,303,31,334
公投第１１案,雲林縣,斗南鎮,阿丹里,512,1147,424,60,484,31,515
公投第１１案,雲林縣,斗南鎮,將軍里,513,1709,591,309,900,65,965
公投第１１案,雲林縣,斗南鎮,舊社里,514,1042,426,180,606,36,642
公投第１１案,雲林縣,斗南鎮,舊社里,515,1631,569,285,854,49,903
公投第１１案,雲林縣,斗南鎮,明昌里,516,1702,676,296,972,57,1029
公投第１１案,雲林縣,斗南鎮,明昌里,517,1564,638,251,889,39,928
公投第１１案,雲林縣,斗南鎮,僑真里,518,910,291,120,411,26,437
公投第１１案,雲林縣,斗南鎮,僑真里,519,1276,536,222,758,37,795
公投第１１案,雲林縣,斗南鎮,大東里,520,897,317,109,426,19,445
公投第１１案,雲林縣,斗南鎮,埤麻里,521,803,299,130,429,26,455
公投第１１案,雲林縣,斗南鎮,西伯里,522,866,319,138,457,49,506
公投第１１案,雲林縣,斗南鎮,新崙里,523,852,327,134,461,42,503
公投第１１案,雲林縣,斗南鎮,新崙里,524,671,251,111,362,25,387
公投第１１案,雲林縣,斗南鎮,東明里,525,981,339,175,514,23,537
公投第１１案,雲林縣,斗南鎮,新光里,526,1129,354,167,521,24,545
公投第１１案,雲林縣,斗南鎮,新光里,527,1586,583,280,863,77,940
公投第１１案,雲林縣,斗南鎮,田頭里,528,1243,503,225,728,36,764
公投第１１案,雲林縣,斗南鎮,田頭里,529,984,357,140,497,17,514
公投第１１案,雲林縣,斗南鎮,小東里,530,1507,588,244,832,65,897
公投第１１案,雲林縣,古坑鄉,棋盤村,531,1126,418,176,594,30,624
公投第１１案,雲林縣,古坑鄉,棋盤村,532,994,319,161,480,47,527
公投第１１案,雲林縣,古坑鄉,新庄村,533,1517,494,266,760,61,821
公投第１１案,雲林縣,古坑鄉,東和村,534,1302,477,192,669,48,717
公投第１１案,雲林縣,古坑鄉,東和村,535,1772,582,264,846,56,902
公投第１１案,雲林縣,古坑鄉,荷苞村,536,1122,427,169,596,53,649
公投第１１案,雲林縣,古坑鄉,荷苞村,537,304,81,25,106,4,110
公投第１１案,雲林縣,古坑鄉,高林村,538,1169,469,150,619,64,683
公投第１１案,雲林縣,古坑鄉,水碓村,539,1255,414,195,609,48,657
公投第１１案,雲林縣,古坑鄉,田心村,540,1078,405,213,618,35,653
公投第１１案,雲林縣,古坑鄉,古坑村,541,943,313,131,444,30,474
公投第１１案,雲林縣,古坑鄉,古坑村,542,1300,425,204,629,46,675
公投第１１案,雲林縣,古坑鄉,朝陽村,543,964,341,119,460,37,497
公投第１１案,雲林縣,古坑鄉,朝陽村,544,1144,418,159,577,41,618
公投第１１案,雲林縣,古坑鄉,西平村,545,1482,515,234,749,48,797
公投第１１案,雲林縣,古坑鄉,湳仔村,546,688,265,99,364,29,393
公投第１１案,雲林縣,古坑鄉,永光村,547,998,331,148,479,29,508
公投第１１案,雲林縣,古坑鄉,永光村,548,1140,425,198,623,29,652
公投第１１案,雲林縣,古坑鄉,永昌村,549,1102,377,189,566,36,602
公投第１１案,雲林縣,古坑鄉,永昌村,550,956,342,145,487,20,507
公投第１１案,雲林縣,古坑鄉,麻園村,551,695,225,133,358,27,385
公投第１１案,雲林縣,古坑鄉,崁腳村,552,1233,444,139,583,35,618
公投第１１案,雲林縣,古坑鄉,華南村,553,285,82,40,122,6,128
公投第１１案,雲林縣,古坑鄉,華山村,554,734,208,82,290,12,302
公投第１１案,雲林縣,古坑鄉,桂林村,555,1150,367,230,597,39,636
公投第１１案,雲林縣,古坑鄉,樟湖村,556,453,182,51,233,17,250
公投第１１案,雲林縣,古坑鄉,草嶺村,557,571,185,66,251,27,278
公投第１１案,嘉義縣,太保市,太保里,1,1210,435,201,636,45,681
公投第１１案,嘉義縣,太保市,太保里,2,1076,390,186,576,31,607
公投第１１案,嘉義縣,太保市,後庄里,3,488,151,70,221,29,250
公投第１１案,嘉義縣,太保市,前潭里,4,1475,481,219,700,55,755
公投第１１案,嘉義縣,太保市,後潭里,5,790,235,115,350,29,379
公投第１１案,嘉義縣,太保市,後潭里,6,883,305,114,419,31,450
公投第１１案,嘉義縣,太保市,梅埔里,7,758,240,113,353,42,395
公投第１１案,嘉義縣,太保市,梅埔里,8,389,131,39,170,6,176
公投第１１案,嘉義縣,太保市,春珠里,9,1101,316,162,478,40,518
公投第１１案,嘉義縣,太保市,崙頂里,10,853,354,121,475,13,488
公投第１１案,嘉義縣,太保市,安仁里,11,224,51,35,86,6,92
公投第１１案,嘉義縣,太保市,安仁里,12,662,202,90,292,37,329
公投第１１案,嘉義縣,太保市,安仁里,13,1630,678,263,941,32,973
公投第１１案,嘉義縣,太保市,東勢里,14,913,309,116,425,31,456
公投第１１案,嘉義縣,太保市,東勢里,15,779,286,139,425,9,434
公投第１１案,嘉義縣,太保市,新埤里,16,1278,417,217,634,83,717
公投第１１案,嘉義縣,太保市,舊埤里,17,819,264,102,366,38,404
公投第１１案,嘉義縣,太保市,舊埤里,18,1573,537,255,792,20,812
公投第１１案,嘉義縣,太保市,田尾里,19,481,165,86,251,20,271
公投第１１案,嘉義縣,太保市,田尾里,20,245,95,47,142,5,147
公投第１１案,嘉義縣,太保市,港尾里,21,317,113,56,169,14,183
公投第１１案,嘉義縣,太保市,港尾里,22,258,89,44,133,7,140
公投第１１案,嘉義縣,太保市,過溝里,23,611,229,76,305,28,333
公投第１１案,嘉義縣,太保市,過溝里,24,1526,594,274,868,34,902
公投第１１案,嘉義縣,太保市,過溝里,25,1196,421,238,659,20,679
公投第１１案,嘉義縣,太保市,麻寮里,26,1536,519,263,782,65,847
公投第１１案,嘉義縣,太保市,麻寮里,27,1481,525,250,775,52,827
公投第１１案,嘉義縣,太保市,麻寮里,28,1450,550,227,777,24,801
公投第１１案,嘉義縣,太保市,南新里,29,840,307,133,440,26,466
公投第１１案,嘉義縣,太保市,南新里,30,989,375,191,566,21,587
公投第１１案,嘉義縣,太保市,北新里,31,1529,566,230,796,64,860
公投第１１案,嘉義縣,太保市,北新里,32,1511,536,284,820,31,851
公投第１１案,嘉義縣,太保市,埤鄉里,33,697,229,95,324,31,355
公投第１１案,嘉義縣,鹿草鄉,後寮村,34,522,122,86,208,36,244
公投第１１案,嘉義縣,鹿草鄉,鹿東村,35,563,173,103,276,27,303
公投第１１案,嘉義縣,鹿草鄉,鹿草村,36,1304,379,195,574,75,649
公投第１１案,嘉義縣,鹿草鄉,西井村,37,1312,411,209,620,40,660
公投第１１案,嘉義縣,鹿草鄉,豊稠村,38,320,98,47,145,4,149
公投第１１案,嘉義縣,鹿草鄉,豊稠村,39,418,74,31,105,5,110
公投第１１案,嘉義縣,鹿草鄉,重寮村,40,1025,281,119,400,51,451
公投第１１案,嘉義縣,鹿草鄉,施家村,41,451,125,51,176,19,195
公投第１１案,嘉義縣,鹿草鄉,下潭村,42,830,302,89,391,56,447
公投第１１案,嘉義縣,鹿草鄉,光潭村,43,1050,328,131,459,40,499
公投第１１案,嘉義縣,鹿草鄉,碧潭村,44,972,234,123,357,43,400
公投第１１案,嘉義縣,鹿草鄉,松竹村,45,962,287,125,412,33,445
公投第１１案,嘉義縣,鹿草鄉,竹山村,46,678,95,109,204,46,250
公投第１１案,嘉義縣,鹿草鄉,竹山村,47,262,108,20,128,10,138
公投第１１案,嘉義縣,鹿草鄉,後堀村,48,906,242,122,364,34,398
公投第１１案,嘉義縣,鹿草鄉,後堀村,49,306,79,25,104,6,110
公投第１１案,嘉義縣,鹿草鄉,三角村,50,1062,371,128,499,52,551
公投第１１案,嘉義縣,鹿草鄉,三角村,51,373,135,57,192,13,205
公投第１１案,嘉義縣,鹿草鄉,下麻村,52,324,114,47,161,14,175
公投第１１案,嘉義縣,鹿草鄉,下麻村,53,297,103,32,135,13,148
公投第１１案,嘉義縣,水上鄉,水上村,54,1024,358,137,495,27,522
公投第１１案,嘉義縣,水上鄉,水上村,55,1015,372,193,565,49,614
公投第１１案,嘉義縣,水上鄉,水上村,56,1932,620,280,900,50,950
公投第１１案,嘉義縣,水上鄉,水頭村,57,1170,442,216,658,30,688
公投第１１案,嘉義縣,水上鄉,水頭村,58,1305,505,215,720,46,766
公投第１１案,嘉義縣,水上鄉,粗溪村,59,1242,403,180,583,38,621
公投第１１案,嘉義縣,水上鄉,粗溪村,60,324,100,48,148,18,166
公投第１１案,嘉義縣,水上鄉,下寮村,61,622,234,84,318,13,331
公投第１１案,嘉義縣,水上鄉,下寮村,62,1216,412,175,587,50,637
公投第１１案,嘉義縣,水上鄉,三和村,63,1020,386,157,543,21,564
公投第１１案,嘉義縣,水上鄉,三和村,64,771,305,153,458,23,481
公投第１１案,嘉義縣,水上鄉,回歸村,65,441,175,84,259,20,279
公投第１１案,嘉義縣,水上鄉,大堀村,66,626,292,107,399,21,420
公投第１１案,嘉義縣,水上鄉,大堀村,67,570,212,110,322,20,342
公投第１１案,嘉義縣,水上鄉,大堀村,68,368,125,51,176,16,192
公投第１１案,嘉義縣,水上鄉,大崙村,69,1037,324,146,470,70,540
公投第１１案,嘉義縣,水上鄉,大崙村,70,1065,369,178,547,33,580
公投第１１案,嘉義縣,水上鄉,塗溝村,71,802,316,151,467,45,512
公投第１１案,嘉義縣,水上鄉,龍德村,72,1948,660,312,972,53,1025
公投第１１案,嘉義縣,水上鄉,溪洲村,73,1028,355,138,493,32,525
公投第１１案,嘉義縣,水上鄉,三鎮村,74,641,244,113,357,18,375
公投第１１案,嘉義縣,水上鄉,靖和村,75,408,168,66,234,12,246
公投第１１案,嘉義縣,水上鄉,南和村,76,794,295,132,427,32,459
公投第１１案,嘉義縣,水上鄉,南和村,77,569,159,97,256,17,273
公投第１１案,嘉義縣,水上鄉,柳新村,78,806,289,141,430,24,454
公投第１１案,嘉義縣,水上鄉,柳新村,79,960,349,172,521,38,559
公投第１１案,嘉義縣,水上鄉,柳林村,80,2035,707,336,1043,69,1112
公投第１１案,嘉義縣,水上鄉,柳鄉村,81,1987,717,300,1017,73,1090
公投第１１案,嘉義縣,水上鄉,內溪村,82,1154,442,187,629,22,651
公投第１１案,嘉義縣,水上鄉,寬士村,83,2208,711,351,1062,51,1113
公投第１１案,嘉義縣,水上鄉,寬士村,84,2102,640,250,890,58,948
公投第１１案,嘉義縣,水上鄉,民生村,85,1309,467,163,630,44,674
公投第１１案,嘉義縣,水上鄉,民生村,86,1671,601,274,875,34,909
公投第１１案,嘉義縣,水上鄉,義興村,87,822,280,138,418,32,450
公投第１１案,嘉義縣,水上鄉,中庄村,88,1772,655,240,895,31,926
公投第１１案,嘉義縣,水上鄉,忠和村,89,1919,674,290,964,59,1023
公投第１１案,嘉義縣,水上鄉,南鄉村,90,912,196,246,442,13,455
公投第１１案,嘉義縣,水上鄉,三界村,91,992,368,132,500,18,518
公投第１１案,嘉義縣,水上鄉,國姓村,92,1270,370,172,542,30,572
公投第１１案,嘉義縣,民雄鄉,東榮村,93,1267,462,242,704,28,732
公投第１１案,嘉義縣,民雄鄉,東榮村,94,1030,341,145,486,39,525
公投第１１案,嘉義縣,民雄鄉,中樂村,95,1590,607,279,886,63,949
公投第１１案,嘉義縣,民雄鄉,西安村,96,1673,582,254,836,27,863
公投第１１案,嘉義縣,民雄鄉,西安村,97,1718,609,326,935,56,991
公投第１１案,嘉義縣,民雄鄉,寮頂村,98,1040,403,175,578,43,621
公投第１１案,嘉義縣,民雄鄉,寮頂村,99,1100,377,183,560,34,594
公投第１１案,嘉義縣,民雄鄉,福權村,100,1559,506,238,744,63,807
公投第１１案,嘉義縣,民雄鄉,東湖村,101,1862,609,298,907,46,953
公投第１１案,嘉義縣,民雄鄉,頂崙村,102,1435,494,255,749,60,809
公投第１１案,嘉義縣,民雄鄉,菁埔村,103,1751,575,259,834,85,919
公投第１１案,嘉義縣,民雄鄉,中和村,104,933,348,141,489,48,537
公投第１１案,嘉義縣,民雄鄉,平和村,105,827,316,169,485,32,517
公投第１１案,嘉義縣,民雄鄉,西昌村,106,843,268,128,396,30,426
公投第１１案,嘉義縣,民雄鄉,豊收村,107,1774,627,255,882,54,936
公投第１１案,嘉義縣,民雄鄉,豊收村,108,385,115,57,172,11,183
公投第１１案,嘉義縣,民雄鄉,三興村,109,1306,479,252,731,41,772
公投第１１案,嘉義縣,民雄鄉,東興村,110,535,205,85,290,30,320
公投第１１案,嘉義縣,民雄鄉,鎮北村,111,1055,405,161,566,56,622
公投第１１案,嘉義縣,民雄鄉,北斗村,112,1476,527,228,755,51,806
公投第１１案,嘉義縣,民雄鄉,北斗村,113,1583,560,197,757,40,797
公投第１１案,嘉義縣,民雄鄉,北斗村,114,758,219,120,339,31,370
公投第１１案,嘉義縣,民雄鄉,北斗村,115,1354,461,189,650,26,676
公投第１１案,嘉義縣,民雄鄉,双福村,116,1202,455,186,641,66,707
公投第１１案,嘉義縣,民雄鄉,双福村,117,1175,418,196,614,35,649
公投第１１案,嘉義縣,民雄鄉,福樂村,118,1423,456,236,692,36,728
公投第１１案,嘉義縣,民雄鄉,福樂村,119,1612,580,242,822,20,842
公投第１１案,嘉義縣,民雄鄉,福樂村,120,1695,630,296,926,27,953
公投第１１案,嘉義縣,民雄鄉,福樂村,121,1665,560,211,771,51,822
公投第１１案,嘉義縣,民雄鄉,大崎村,122,1019,333,126,459,44,503
公投第１１案,嘉義縣,民雄鄉,大崎村,123,1352,459,201,660,50,710
公投第１１案,嘉義縣,民雄鄉,秀林村,124,1620,558,289,847,56,903
公投第１１案,嘉義縣,民雄鄉,秀林村,125,943,297,143,440,32,472
公投第１１案,嘉義縣,民雄鄉,松山村,126,1720,519,249,768,35,803
公投第１１案,嘉義縣,民雄鄉,興中村,127,1875,664,246,910,58,968
公投第１１案,嘉義縣,民雄鄉,興南村,128,1305,464,221,685,36,721
公投第１１案,嘉義縣,民雄鄉,興南村,129,1441,469,243,712,41,753
公投第１１案,嘉義縣,民雄鄉,金興村,130,1413,519,219,738,53,791
公投第１１案,嘉義縣,民雄鄉,金興村,131,1560,539,238,777,53,830
公投第１１案,嘉義縣,民雄鄉,福興村,132,2004,698,341,1039,81,1120
公投第１１案,嘉義縣,民雄鄉,文隆村,133,1354,527,239,766,35,801
公投第１１案,嘉義縣,民雄鄉,文隆村,134,1076,404,166,570,27,597
公投第１１案,嘉義縣,民雄鄉,山中村,135,1629,619,252,871,61,932
公投第１１案,嘉義縣,民雄鄉,山中村,136,1977,690,271,961,54,1015
公投第１１案,嘉義縣,民雄鄉,中央村,137,1295,431,198,629,66,695
公投第１１案,嘉義縣,新港鄉,宮前村,138,1087,396,180,576,26,602
公投第１１案,嘉義縣,新港鄉,宮前村,139,1116,494,198,692,49,741
公投第１１案,嘉義縣,新港鄉,宮後村,140,740,290,95,385,27,412
公投第１１案,嘉義縣,新港鄉,宮後村,141,827,264,116,380,60,440
公投第１１案,嘉義縣,新港鄉,大興村,142,704,290,114,404,35,439
公投第１１案,嘉義縣,新港鄉,大興村,143,768,299,139,438,46,484
公投第１１案,嘉義縣,新港鄉,福德村,144,761,274,150,424,35,459
公投第１１案,嘉義縣,新港鄉,福德村,145,850,274,130,404,51,455
公投第１１案,嘉義縣,新港鄉,古民村,146,1327,453,200,653,67,720
公投第１１案,嘉義縣,新港鄉,中庄村,147,756,252,128,380,43,423
公投第１１案,嘉義縣,新港鄉,中庄村,148,816,289,113,402,63,465
公投第１１案,嘉義縣,新港鄉,大潭村,149,667,215,111,326,25,351
公投第１１案,嘉義縣,新港鄉,大潭村,150,942,335,141,476,40,516
公投第１１案,嘉義縣,新港鄉,西庄村,151,918,271,117,388,56,444
公投第１１案,嘉義縣,新港鄉,埤子村,152,554,190,69,259,18,277
公投第１１案,嘉義縣,新港鄉,南崙村,153,929,303,120,423,42,465
公投第１１案,嘉義縣,新港鄉,北崙村,154,487,107,67,174,33,207
公投第１１案,嘉義縣,新港鄉,海瀛村,155,487,172,62,234,36,270
公投第１１案,嘉義縣,新港鄉,月眉村,156,836,255,148,403,39,442
公投第１１案,嘉義縣,新港鄉,月眉村,157,845,272,155,427,49,476
公投第１１案,嘉義縣,新港鄉,月潭村,158,834,288,138,426,41,467
公投第１１案,嘉義縣,新港鄉,月潭村,159,753,263,125,388,37,425
公投第１１案,嘉義縣,新港鄉,溪北村,160,1328,431,207,638,61,699
公投第１１案,嘉義縣,新港鄉,菜公村,161,969,351,166,517,41,558
公投第１１案,嘉義縣,新港鄉,中洋村,162,1043,367,194,561,62,623
公投第１１案,嘉義縣,新港鄉,三間村,163,1400,549,241,790,54,844
公投第１１案,嘉義縣,新港鄉,安和村,164,1017,268,106,374,27,401
公投第１１案,嘉義縣,新港鄉,潭大村,165,1132,349,154,503,50,553
公投第１１案,嘉義縣,新港鄉,南港村,166,1037,347,142,489,55,544
公投第１１案,嘉義縣,新港鄉,板頭村,167,563,216,78,294,39,333
公投第１１案,嘉義縣,新港鄉,共和村,168,849,314,121,435,19,454
公投第１１案,嘉義縣,大林鎮,東林里,169,483,181,70,251,19,270
公投第１１案,嘉義縣,大林鎮,西林里,170,1823,669,295,964,63,1027
公投第１１案,嘉義縣,大林鎮,吉林里,171,955,368,153,521,22,543
公投第１１案,嘉義縣,大林鎮,平林里,172,1436,497,232,729,33,762
公投第１１案,嘉義縣,大林鎮,平林里,173,1390,461,255,716,68,784
公投第１１案,嘉義縣,大林鎮,平林里,174,1512,529,267,796,55,851
公投第１１案,嘉義縣,大林鎮,平林里,175,1536,529,286,815,57,872
公投第１１案,嘉義縣,大林鎮,明華里,176,1165,361,154,515,52,567
公投第１１案,嘉義縣,大林鎮,明和里,177,1730,638,330,968,60,1028
公投第１１案,嘉義縣,大林鎮,排路里,178,602,183,71,254,22,276
公投第１１案,嘉義縣,大林鎮,西結里,179,716,224,97,321,38,359
公投第１１案,嘉義縣,大林鎮,湖北里,180,625,196,65,261,17,278
公投第１１案,嘉義縣,大林鎮,大糖里,181,193,50,21,71,3,74
公投第１１案,嘉義縣,大林鎮,大美里,182,1642,514,195,709,61,770
公投第１１案,嘉義縣,大林鎮,過溪里,183,1465,503,208,711,63,774
公投第１１案,嘉義縣,大林鎮,中坑里,184,928,258,113,371,46,417
公投第１１案,嘉義縣,大林鎮,中坑里,185,361,97,45,142,17,159
公投第１１案,嘉義縣,大林鎮,上林里,186,814,296,102,398,24,422
公投第１１案,嘉義縣,大林鎮,中林里,187,1579,509,220,729,45,774
公投第１１案,嘉義縣,大林鎮,三和里,188,2041,670,328,998,69,1067
公投第１１案,嘉義縣,大林鎮,溝背里,189,931,319,118,437,42,479
公投第１１案,嘉義縣,大林鎮,義和里,190,675,223,109,332,29,361
公投第１１案,嘉義縣,大林鎮,內林里,191,655,239,83,322,25,347
公投第１１案,嘉義縣,大林鎮,三角里,192,833,270,103,373,42,415
公投第１１案,嘉義縣,大林鎮,三村里,193,832,320,144,464,36,500
公投第１１案,嘉義縣,溪口鄉,溪東村,194,1318,485,202,687,77,764
公投第１１案,嘉義縣,溪口鄉,溪西村,195,677,261,114,375,25,400
公投第１１案,嘉義縣,溪口鄉,溪北村,196,417,151,51,202,18,220
公投第１１案,嘉義縣,溪口鄉,溪北村,197,273,91,46,137,21,158
公投第１１案,嘉義縣,溪口鄉,柳溝村,198,908,335,147,482,52,534
公投第１１案,嘉義縣,溪口鄉,柳溝村,199,386,101,66,167,13,180
公投第１１案,嘉義縣,溪口鄉,疊溪村,200,1039,386,156,542,36,578
公投第１１案,嘉義縣,溪口鄉,妙崙村,201,708,199,93,292,41,333
公投第１１案,嘉義縣,溪口鄉,坪頂村,202,909,330,121,451,17,468
公投第１１案,嘉義縣,溪口鄉,柴林村,203,786,360,32,392,43,435
公投第１１案,嘉義縣,溪口鄉,林腳村,204,807,289,91,380,24,404
公投第１１案,嘉義縣,溪口鄉,美南村,205,1168,358,143,501,19,520
公投第１１案,嘉義縣,溪口鄉,美北村,206,1052,377,159,536,58,594
公投第１１案,嘉義縣,溪口鄉,本厝村,207,565,170,84,254,31,285
公投第１１案,嘉義縣,溪口鄉,本厝村,208,388,147,44,191,19,210
公投第１１案,嘉義縣,溪口鄉,游西村,209,701,224,74,298,24,322
公投第１１案,嘉義縣,溪口鄉,游東村,210,1003,318,112,430,31,461
公投第１１案,嘉義縣,梅山鄉,梅東村,211,1041,347,178,525,27,552
公投第１１案,嘉義縣,梅山鄉,梅東村,212,1245,493,202,695,60,755
公投第１１案,嘉義縣,梅山鄉,梅南村,213,917,374,171,545,28,573
公投第１１案,嘉義縣,梅山鄉,梅北村,214,1189,451,177,628,36,664
公投第１１案,嘉義縣,梅山鄉,梅北村,215,1388,506,228,734,52,786
公投第１１案,嘉義縣,梅山鄉,梅北村,216,1827,635,313,948,50,998
公投第１１案,嘉義縣,梅山鄉,過山村,217,545,203,105,308,35,343
公投第１１案,嘉義縣,梅山鄉,圳南村,218,407,118,44,162,21,183
公投第１１案,嘉義縣,梅山鄉,圳北村,219,636,256,94,350,22,372
公投第１１案,嘉義縣,梅山鄉,双溪村,220,576,217,94,311,29,340
公投第１１案,嘉義縣,梅山鄉,大南村,221,1674,610,269,879,55,934
公投第１１案,嘉義縣,梅山鄉,安靖村,222,858,282,98,380,17,397
公投第１１案,嘉義縣,梅山鄉,永興村,223,526,215,95,310,18,328
公投第１１案,嘉義縣,梅山鄉,半天村,224,372,105,62,167,17,184
公投第１１案,嘉義縣,梅山鄉,太平村,225,506,153,68,221,33,254
公投第１１案,嘉義縣,梅山鄉,太興村,226,433,192,71,263,37,300
公投第１１案,嘉義縣,梅山鄉,龍眼村,227,404,115,38,153,13,166
公投第１１案,嘉義縣,梅山鄉,碧湖村,228,293,94,46,140,6,146
公投第１１案,嘉義縣,梅山鄉,瑞峯村,229,712,269,129,398,50,448
公投第１１案,嘉義縣,梅山鄉,瑞里村,230,602,254,91,345,29,374
公投第１１案,嘉義縣,梅山鄉,太和村,231,515,169,67,236,16,252
公投第１１案,嘉義縣,梅山鄉,太和村,232,417,107,43,150,13,163
公投第１１案,嘉義縣,朴子市,安福里,233,1183,423,196,619,26,645
公投第１１案,嘉義縣,朴子市,安福里,234,755,265,122,387,29,416
公投第１１案,嘉義縣,朴子市,平和里,235,1253,452,199,651,31,682
公投第１１案,嘉義縣,朴子市,平和里,236,1078,410,191,601,43,644
公投第１１案,嘉義縣,朴子市,內厝里,237,1117,419,216,635,50,685
公投第１１案,嘉義縣,朴子市,開元里,238,387,155,62,217,14,231
公投第１１案,嘉義縣,朴子市,順天里,239,633,232,95,327,32,359
公投第１１案,嘉義縣,朴子市,中正里,240,650,227,121,348,23,371
公投第１１案,嘉義縣,朴子市,博厚里,241,825,357,145,502,27,529
公投第１１案,嘉義縣,朴子市,文化里,242,810,296,124,420,33,453
公投第１１案,嘉義縣,朴子市,文化里,243,940,387,126,513,39,552
公投第１１案,嘉義縣,朴子市,永和里,244,905,313,139,452,40,492
公投第１１案,嘉義縣,朴子市,永和里,245,1605,490,238,728,40,768
公投第１１案,嘉義縣,朴子市,竹圍里,246,1479,550,270,820,34,854
公投第１１案,嘉義縣,朴子市,竹圍里,247,1218,446,213,659,48,707
公投第１１案,嘉義縣,朴子市,竹圍里,248,1496,530,275,805,53,858
公投第１１案,嘉義縣,朴子市,新寮里,249,667,222,117,339,29,368
公投第１１案,嘉義縣,朴子市,双溪里,250,627,167,72,239,18,257
公投第１１案,嘉義縣,朴子市,溪口里,251,791,281,86,367,29,396
公投第１１案,嘉義縣,朴子市,德興里,252,1034,341,153,494,79,573
公投第１１案,嘉義縣,朴子市,仁和里,253,1710,520,280,800,28,828
公投第１１案,嘉義縣,朴子市,大鄉里,254,1671,539,236,775,46,821
公投第１１案,嘉義縣,朴子市,大鄉里,255,1547,478,190,668,43,711
公投第１１案,嘉義縣,朴子市,大葛里,256,1602,428,189,617,18,635
公投第１１案,嘉義縣,朴子市,大葛里,257,1302,504,217,721,20,741
公投第１１案,嘉義縣,朴子市,佳禾里,258,740,251,93,344,37,381
公投第１１案,嘉義縣,朴子市,竹村里,259,1054,402,161,563,59,622
公投第１１案,嘉義縣,朴子市,崁前里,260,907,264,109,373,19,392
公投第１１案,嘉義縣,朴子市,崁後里,261,720,197,86,283,32,315
公投第１１案,嘉義縣,朴子市,順安里,262,251,88,48,136,14,150
公投第１１案,嘉義縣,朴子市,德家里,263,767,214,89,303,40,343
公投第１１案,嘉義縣,朴子市,新庄里,264,702,245,104,349,44,393
公投第１１案,嘉義縣,朴子市,梅華里,265,1038,337,112,449,54,503
公投第１１案,嘉義縣,朴子市,松華里,266,1228,301,116,417,40,457
公投第１１案,嘉義縣,朴子市,南竹里,267,499,163,60,223,34,257
公投第１１案,嘉義縣,六腳鄉,蒜頭村,268,1165,352,137,489,36,525
公投第１１案,嘉義縣,六腳鄉,蒜東村,269,825,217,72,289,17,306
公投第１１案,嘉義縣,六腳鄉,蒜南村,270,850,251,108,359,33,392
公投第１１案,嘉義縣,六腳鄉,工廠村,271,222,78,35,113,19,132
公投第１１案,嘉義縣,六腳鄉,灣南村,272,1216,393,161,554,52,606
公投第１１案,嘉義縣,六腳鄉,灣北村,273,1200,313,132,445,44,489
公投第１１案,嘉義縣,六腳鄉,雙涵村,274,877,267,103,370,49,419
公投第１１案,嘉義縣,六腳鄉,塗師村,275,644,166,76,242,36,278
公投第１１案,嘉義縣,六腳鄉,三義村,276,594,144,75,219,14,233
公投第１１案,嘉義縣,六腳鄉,三義村,277,167,38,9,47,3,50
公投第１１案,嘉義縣,六腳鄉,正義村,278,204,42,29,71,3,74
公投第１１案,嘉義縣,六腳鄉,正義村,279,234,52,41,93,2,95
公投第１１案,嘉義縣,六腳鄉,正義村,280,361,86,46,132,14,146
公投第１１案,嘉義縣,六腳鄉,正義村,281,592,224,78,302,34,336
公投第１１案,嘉義縣,六腳鄉,溪厝村,282,619,202,82,284,32,316
公投第１１案,嘉義縣,六腳鄉,港美村,283,714,206,63,269,22,291
公投第１１案,嘉義縣,六腳鄉,豐美村,284,1051,372,119,491,45,536
公投第１１案,嘉義縣,六腳鄉,六斗村,285,934,329,126,455,32,487
公投第１１案,嘉義縣,六腳鄉,崙陽村,286,1044,323,154,477,41,518
公投第１１案,嘉義縣,六腳鄉,蘇厝村,287,1476,450,176,626,42,668
公投第１１案,嘉義縣,六腳鄉,竹本村,288,618,136,77,213,19,232
公投第１１案,嘉義縣,六腳鄉,永賢村,289,478,111,28,139,23,162
公投第１１案,嘉義縣,六腳鄉,魚寮村,290,642,154,54,208,27,235
公投第１１案,嘉義縣,六腳鄉,潭墘村,291,883,191,100,291,15,306
公投第１１案,嘉義縣,六腳鄉,六腳村,292,739,174,70,244,11,255
公投第１１案,嘉義縣,六腳鄉,六南村,293,554,141,60,201,17,218
公投第１１案,嘉義縣,六腳鄉,崩山村,294,649,155,57,212,20,232
公投第１１案,嘉義縣,六腳鄉,古林村,295,689,175,74,249,26,275
公投第１１案,嘉義縣,六腳鄉,更寮村,296,455,116,51,167,15,182
公投第１１案,嘉義縣,六腳鄉,更寮村,297,125,25,12,37,1,38
公投第１１案,嘉義縣,東石鄉,東石村,298,1915,628,256,884,55,939
公投第１１案,嘉義縣,東石鄉,猿樹村,299,938,233,107,340,43,383
公投第１１案,嘉義縣,東石鄉,型厝村,300,1366,288,123,411,22,433
公投第１１案,嘉義縣,東石鄉,塭港村,301,1676,501,171,672,7,679
公投第１１案,嘉義縣,東石鄉,三家村,302,1151,308,115,423,60,483
公投第１１案,嘉義縣,東石鄉,永屯村,303,716,211,82,293,30,323
公投第１１案,嘉義縣,東石鄉,海埔村,304,387,126,28,154,5,159
公投第１１案,嘉義縣,東石鄉,龍港村,305,864,199,63,262,11,273
公投第１１案,嘉義縣,東石鄉,副瀨村,306,910,215,79,294,22,316
公投第１１案,嘉義縣,東石鄉,下揖村,307,760,198,88,286,12,298
公投第１１案,嘉義縣,東石鄉,頂揖村,308,166,67,18,85,4,89
公投第１１案,嘉義縣,東石鄉,頂揖村,309,212,56,14,70,10,80
公投第１１案,嘉義縣,東石鄉,溪下村,310,993,238,86,324,26,350
公投第１１案,嘉義縣,東石鄉,港口村,311,306,77,30,107,13,120
公投第１１案,嘉義縣,東石鄉,鰲鼓村,312,1046,269,101,370,41,411
公投第１１案,嘉義縣,東石鄉,鰲鼓村,313,235,58,19,77,13,90
公投第１１案,嘉義縣,東石鄉,港墘村,314,1226,357,145,502,55,557
公投第１１案,嘉義縣,東石鄉,蔦松村,315,843,229,100,329,38,367
公投第１１案,嘉義縣,東石鄉,圍潭村,316,693,203,71,274,26,300
公投第１１案,嘉義縣,東石鄉,洲仔村,317,839,282,97,379,33,412
公投第１１案,嘉義縣,東石鄉,東崙村,318,363,107,42,149,10,159
公投第１１案,嘉義縣,東石鄉,東崙村,319,321,79,27,106,9,115
公投第１１案,嘉義縣,東石鄉,西崙村,320,1083,388,140,528,68,596
公投第１１案,嘉義縣,東石鄉,塭仔村,321,901,264,121,385,32,417
公投第１１案,嘉義縣,東石鄉,網寮村,322,1216,323,102,425,27,452
公投第１１案,嘉義縣,東石鄉,掌潭村,323,418,152,68,220,32,252
公投第１１案,嘉義縣,東石鄉,掌潭村,324,371,107,48,155,7,162
公投第１１案,嘉義縣,布袋鎮,岱江里,325,614,223,68,291,18,309
公投第１１案,嘉義縣,布袋鎮,九龍里,326,372,121,39,160,11,171
公投第１１案,嘉義縣,布袋鎮,岑海里,327,914,321,133,454,56,510
公投第１１案,嘉義縣,布袋鎮,岑海里,328,1198,435,177,612,39,651
公投第１１案,嘉義縣,布袋鎮,興中里,329,1113,366,118,484,44,528
公投第１１案,嘉義縣,布袋鎮,光復里,330,992,343,158,501,32,533
公投第１１案,嘉義縣,布袋鎮,光復里,331,689,250,89,339,14,353
公投第１１案,嘉義縣,布袋鎮,見龍里,332,882,294,126,420,45,465
公投第１１案,嘉義縣,布袋鎮,新厝里,333,731,263,97,360,22,382
公投第１１案,嘉義縣,布袋鎮,龍江里,334,779,299,112,411,19,430
公投第１１案,嘉義縣,布袋鎮,振寮里,335,762,232,85,317,26,343
公投第１１案,嘉義縣,布袋鎮,西安里,336,1184,345,159,504,36,540
公投第１１案,嘉義縣,布袋鎮,中安里,337,1423,382,130,512,64,576
公投第１１案,嘉義縣,布袋鎮,東安里,338,1351,369,147,516,49,565
公投第１１案,嘉義縣,布袋鎮,樹林里,339,275,94,31,125,4,129
公投第１１案,嘉義縣,布袋鎮,樹林里,340,243,82,27,109,7,116
公投第１１案,嘉義縣,布袋鎮,貴舍里,341,661,258,71,329,34,363
公投第１１案,嘉義縣,布袋鎮,永安里,342,1145,373,135,508,37,545
公投第１１案,嘉義縣,布袋鎮,東港里,343,936,284,142,426,22,448
公投第１１案,嘉義縣,布袋鎮,東港里,344,958,275,138,413,41,454
公投第１１案,嘉義縣,布袋鎮,江山里,345,298,93,42,135,9,144
公投第１１案,嘉義縣,布袋鎮,菜舖里,346,428,159,63,222,33,255
公投第１１案,嘉義縣,布袋鎮,考試里,347,121,37,10,47,3,50
公投第１１案,嘉義縣,布袋鎮,考試里,348,174,37,11,48,3,51
公投第１１案,嘉義縣,布袋鎮,新岑里,349,953,301,120,421,37,458
公投第１１案,嘉義縣,布袋鎮,新民里,350,1292,429,211,640,54,694
公投第１１案,嘉義縣,布袋鎮,復興里,351,1127,427,147,574,29,603
公投第１１案,嘉義縣,布袋鎮,復興里,352,1244,383,178,561,35,596
公投第１１案,嘉義縣,布袋鎮,好美里,353,1106,357,170,527,15,542
公投第１１案,嘉義縣,義竹鄉,岸腳村,354,482,154,60,214,17,231
公投第１１案,嘉義縣,義竹鄉,岸腳村,355,223,84,37,121,13,134
公投第１１案,嘉義縣,義竹鄉,義竹村,356,1529,516,255,771,66,837
公投第１１案,嘉義縣,義竹鄉,六桂村,357,1175,435,184,619,50,669
公投第１１案,嘉義縣,義竹鄉,仁里村,358,886,372,136,508,45,553
公投第１１案,嘉義縣,義竹鄉,傳芳村,359,743,215,100,315,20,335
公投第１１案,嘉義縣,義竹鄉,頭竹村,360,1236,426,192,618,66,684
公投第１１案,嘉義縣,義竹鄉,五厝村,361,377,128,50,178,16,194
公投第１１案,嘉義縣,義竹鄉,中平村,362,338,103,33,136,19,155
公投第１１案,嘉義縣,義竹鄉,中平村,363,102,48,9,57,3,60
公投第１１案,嘉義縣,義竹鄉,埤前村,364,763,241,107,348,17,365
公投第１１案,嘉義縣,義竹鄉,平溪村,365,429,150,78,228,23,251
公投第１１案,嘉義縣,義竹鄉,後鎮村,366,427,130,66,196,19,215
公投第１１案,嘉義縣,義竹鄉,北華村,367,607,206,88,294,42,336
公投第１１案,嘉義縣,義竹鄉,新店村,368,1486,463,184,647,49,696
公投第１１案,嘉義縣,義竹鄉,東過村,369,835,294,124,418,66,484
公投第１１案,嘉義縣,義竹鄉,西過村,370,816,218,88,306,49,355
公投第１１案,嘉義縣,義竹鄉,官和村,371,833,223,115,338,48,386
公投第１１案,嘉義縣,義竹鄉,官順村,372,433,150,52,202,11,213
公投第１１案,嘉義縣,義竹鄉,新富村,373,558,162,71,233,12,245
公投第１１案,嘉義縣,義竹鄉,東光村,374,602,196,81,277,38,315
公投第１１案,嘉義縣,義竹鄉,東光村,375,140,45,7,52,3,55
公投第１１案,嘉義縣,義竹鄉,東榮村,376,393,111,46,157,28,185
公投第１１案,嘉義縣,義竹鄉,龍蛟村,377,585,188,76,264,26,290
公投第１１案,嘉義縣,義竹鄉,溪洲村,378,526,143,60,203,3,206
公投第１１案,嘉義縣,義竹鄉,溪洲村,379,123,55,17,72,4,76
公投第１１案,嘉義縣,中埔鄉,富收村,380,1046,281,134,415,27,442
公投第１１案,嘉義縣,中埔鄉,富收村,381,1788,543,250,793,51,844
公投第１１案,嘉義縣,中埔鄉,和睦村,382,1730,517,258,775,35,810
公投第１１案,嘉義縣,中埔鄉,和睦村,383,1581,513,223,736,40,776
公投第１１案,嘉義縣,中埔鄉,和美村,384,1594,453,200,653,27,680
公投第１１案,嘉義縣,中埔鄉,和美村,385,1801,609,290,899,25,924
公投第１１案,嘉義縣,中埔鄉,和美村,386,1862,637,246,883,40,923
公投第１１案,嘉義縣,中埔鄉,和美村,387,1803,529,235,764,25,789
公投第１１案,嘉義縣,中埔鄉,和興村,388,1481,520,218,738,35,773
公投第１１案,嘉義縣,中埔鄉,和興村,389,1366,464,220,684,45,729
公投第１１案,嘉義縣,中埔鄉,和興村,390,1599,484,199,683,37,720
公投第１１案,嘉義縣,中埔鄉,和興村,391,1196,435,166,601,21,622
公投第１１案,嘉義縣,中埔鄉,中埔村,392,1809,542,238,780,51,831
公投第１１案,嘉義縣,中埔鄉,塩舘村,393,953,309,147,456,16,472
公投第１１案,嘉義縣,中埔鄉,金蘭村,394,1441,439,179,618,54,672
公投第１１案,嘉義縣,中埔鄉,隆興村,395,1882,582,233,815,56,871
公投第１１案,嘉義縣,中埔鄉,義仁村,396,1470,500,188,688,25,713
公投第１１案,嘉義縣,中埔鄉,社口村,397,1699,481,221,702,55,757
公投第１１案,嘉義縣,中埔鄉,社口村,398,422,110,53,163,15,178
公投第１１案,嘉義縣,中埔鄉,灣潭村,399,1030,324,145,469,47,516
公投第１１案,嘉義縣,中埔鄉,裕民村,400,879,293,122,415,26,441
公投第１１案,嘉義縣,中埔鄉,龍門村,401,828,255,101,356,11,367
公投第１１案,嘉義縣,中埔鄉,石硦村,402,881,329,145,474,31,505
公投第１１案,嘉義縣,中埔鄉,石硦村,403,296,99,40,139,9,148
公投第１１案,嘉義縣,中埔鄉,頂埔村,404,979,312,131,443,36,479
公投第１１案,嘉義縣,中埔鄉,同仁村,405,1268,365,177,542,35,577
公投第１１案,嘉義縣,中埔鄉,同仁村,406,670,149,64,213,16,229
公投第１１案,嘉義縣,中埔鄉,深坑村,407,754,253,134,387,44,431
公投第１１案,嘉義縣,中埔鄉,三層村,408,648,216,112,328,28,356
公投第１１案,嘉義縣,中埔鄉,瑞豐村,409,741,179,102,281,21,302
公投第１１案,嘉義縣,中埔鄉,沄水村,410,518,164,69,233,5,238
公投第１１案,嘉義縣,中埔鄉,沄水村,411,482,141,78,219,25,244
公投第１１案,嘉義縣,中埔鄉,東興村,412,348,102,48,150,9,159
公投第１１案,嘉義縣,中埔鄉,中崙村,413,294,101,37,138,8,146
公投第１１案,嘉義縣,竹崎鄉,竹崎村,414,1312,471,230,701,35,736
公投第１１案,嘉義縣,竹崎鄉,竹崎村,415,1210,484,186,670,25,695
公投第１１案,嘉義縣,竹崎鄉,和平村,416,991,363,150,513,41,554
公投第１１案,嘉義縣,竹崎鄉,和平村,417,1207,487,174,661,29,690
公投第１１案,嘉義縣,竹崎鄉,坑頭村,418,752,245,112,357,15,372
公投第１１案,嘉義縣,竹崎鄉,沙坑村,419,833,342,123,465,29,494
公投第１１案,嘉義縣,竹崎鄉,獅埜村,420,1220,482,175,657,35,692
公投第１１案,嘉義縣,竹崎鄉,義和村,421,616,257,118,375,9,384
公投第１１案,嘉義縣,竹崎鄉,義仁村,422,1031,367,111,478,53,531
公投第１１案,嘉義縣,竹崎鄉,灣橋村,423,1292,464,168,632,39,671
公投第１１案,嘉義縣,竹崎鄉,灣橋村,424,1995,720,325,1045,57,1102
公投第１１案,嘉義縣,竹崎鄉,灣橋村,425,1996,680,249,929,21,950
公投第１１案,嘉義縣,竹崎鄉,鹿滿村,426,1449,520,212,732,31,763
公投第１１案,嘉義縣,竹崎鄉,紫雲村,427,1420,545,194,739,32,771
公投第１１案,嘉義縣,竹崎鄉,內埔村,428,1590,594,254,848,34,882
公投第１１案,嘉義縣,竹崎鄉,昇平村,429,771,259,107,366,21,387
公投第１１案,嘉義縣,竹崎鄉,昇平村,430,1014,283,158,441,39,480
公投第１１案,嘉義縣,竹崎鄉,桃源村,431,327,96,33,129,9,138
公投第１１案,嘉義縣,竹崎鄉,桃源村,432,687,258,87,345,18,363
公投第１１案,嘉義縣,竹崎鄉,白杞村,433,641,222,86,308,19,327
公投第１１案,嘉義縣,竹崎鄉,塘興村,434,474,186,70,256,8,264
公投第１１案,嘉義縣,竹崎鄉,塘興村,435,383,124,54,178,14,192
公投第１１案,嘉義縣,竹崎鄉,義隆村,436,619,242,103,345,34,379
公投第１１案,嘉義縣,竹崎鄉,龍山村,437,214,63,31,94,5,99
公投第１１案,嘉義縣,竹崎鄉,龍山村,438,1568,534,239,773,53,826
公投第１１案,嘉義縣,竹崎鄉,文峯村,439,658,216,87,303,10,313
公投第１１案,嘉義縣,竹崎鄉,金獅村,440,434,172,64,236,19,255
公投第１１案,嘉義縣,竹崎鄉,復金村,441,917,353,133,486,28,514
公投第１１案,嘉義縣,竹崎鄉,復金村,442,981,294,159,453,32,485
公投第１１案,嘉義縣,竹崎鄉,緞繻村,443,789,256,102,358,11,369
公投第１１案,嘉義縣,竹崎鄉,緞繻村,444,108,20,9,29,2,31
公投第１１案,嘉義縣,竹崎鄉,仁壽村,445,235,49,20,69,1,70
公投第１１案,嘉義縣,竹崎鄉,中和村,446,331,91,45,136,6,142
公投第１１案,嘉義縣,竹崎鄉,中和村,447,450,179,90,269,15,284
公投第１１案,嘉義縣,竹崎鄉,光華村,448,462,131,41,172,12,184
公投第１１案,嘉義縣,竹崎鄉,光華村,449,251,83,14,97,10,107
公投第１１案,嘉義縣,番路鄉,江西村,450,1174,438,204,642,70,712
公投第１１案,嘉義縣,番路鄉,內甕村,451,449,184,76,260,20,280
公投第１１案,嘉義縣,番路鄉,新福村,452,753,305,123,428,33,461
公投第１１案,嘉義縣,番路鄉,新福村,453,551,162,62,224,39,263
公投第１１案,嘉義縣,番路鄉,下坑村,454,1791,625,310,935,71,1006
公投第１１案,嘉義縣,番路鄉,番路村,455,849,343,149,492,45,537
公投第１１案,嘉義縣,番路鄉,民和村,456,866,340,131,471,31,502
公投第１１案,嘉義縣,番路鄉,觸口村,457,800,317,92,409,31,440
公投第１１案,嘉義縣,番路鄉,觸口村,458,444,159,77,236,21,257
公投第１１案,嘉義縣,番路鄉,大湖村,459,635,195,55,250,13,263
公投第１１案,嘉義縣,番路鄉,公田村,460,319,102,36,138,12,150
公投第１１案,嘉義縣,番路鄉,公田村,461,642,282,73,355,23,378
公投第１１案,嘉義縣,番路鄉,公興村,462,509,169,42,211,20,231
公投第１１案,嘉義縣,番路鄉,草山村,463,162,80,15,95,0,95
公投第１１案,嘉義縣,番路鄉,草山村,464,212,90,25,115,6,121
公投第１１案,嘉義縣,大埔鄉,大埔村,465,1468,523,234,757,50,807
公投第１１案,嘉義縣,大埔鄉,和平村,466,320,88,30,118,7,125
公投第１１案,嘉義縣,大埔鄉,和平村,467,304,105,59,164,11,175
公投第１１案,嘉義縣,大埔鄉,永樂村,468,184,65,26,91,2,93
公投第１１案,嘉義縣,大埔鄉,永樂村,469,234,105,46,151,6,157
公投第１１案,嘉義縣,大埔鄉,茄苳村,470,495,171,79,250,13,263
公投第１１案,嘉義縣,大埔鄉,茄苳村,471,199,76,30,106,6,112
公投第１１案,嘉義縣,大埔鄉,茄苳村,472,226,73,33,106,9,115
公投第１１案,嘉義縣,大埔鄉,西興村,473,569,251,76,327,22,349
公投第１１案,嘉義縣,阿里山鄉,中山村,474,371,125,51,176,6,182
公投第１１案,嘉義縣,阿里山鄉,中正村,475,197,61,21,82,3,85
公投第１１案,嘉義縣,阿里山鄉,香林村,476,152,50,19,69,4,73
公投第１１案,嘉義縣,阿里山鄉,十字村,477,231,55,20,75,4,79
公投第１１案,嘉義縣,阿里山鄉,十字村,478,72,16,3,19,2,21
公投第１１案,嘉義縣,阿里山鄉,豐山村,479,311,86,36,122,2,124
公投第１１案,嘉義縣,阿里山鄉,來吉村,480,306,123,36,159,5,164
公投第１１案,嘉義縣,阿里山鄉,樂野村,481,970,294,138,432,13,445
公投第１１案,嘉義縣,阿里山鄉,達邦村,482,827,296,126,422,32,454
公投第１１案,嘉義縣,阿里山鄉,里佳村,483,238,87,38,125,1,126
公投第１１案,嘉義縣,阿里山鄉,山美村,484,479,107,44,151,6,157
公投第１１案,嘉義縣,阿里山鄉,新美村,485,291,86,36,122,8,130
公投第１１案,嘉義縣,阿里山鄉,茶山村,486,246,125,27,152,8,160
公投第１１案,屏東縣,屏東市,端正里,1,237,76,47,123,5,128
公投第１１案,屏東縣,屏東市,武廟里,2,294,93,59,152,14,166
公投第１１案,屏東縣,屏東市,大同里,3,582,181,122,303,8,311
公投第１１案,屏東縣,屏東市,光榮里,4,713,257,140,397,22,419
公投第１１案,屏東縣,屏東市,民權里,5,572,185,109,294,25,319
公投第１１案,屏東縣,屏東市,泰安里,6,455,196,79,275,7,282
公投第１１案,屏東縣,屏東市,文明里,7,249,90,57,147,0,147
公投第１１案,屏東縣,屏東市,維新里,8,1315,441,179,620,27,647
公投第１１案,屏東縣,屏東市,維新里,9,1373,389,249,638,35,673
公投第１１案,屏東縣,屏東市,大埔里,10,713,268,152,420,30,450
公投第１１案,屏東縣,屏東市,必信里,11,573,215,122,337,32,369
公投第１１案,屏東縣,屏東市,崇禮里,12,297,123,64,187,16,203
公投第１１案,屏東縣,屏東市,崇智里,13,409,187,78,265,16,281
公投第１１案,屏東縣,屏東市,慶春里,14,286,91,57,148,12,160
公投第１１案,屏東縣,屏東市,楠樹里,15,421,176,72,248,8,256
公投第１１案,屏東縣,屏東市,扶風里,16,569,202,116,318,11,329
公投第１１案,屏東縣,屏東市,安樂里,17,459,129,105,234,15,249
公投第１１案,屏東縣,屏東市,平和里,18,672,260,154,414,19,433
公投第１１案,屏東縣,屏東市,金泉里,19,668,237,162,399,24,423
公投第１１案,屏東縣,屏東市,勝豐里,20,411,166,82,248,8,256
公投第１１案,屏東縣,屏東市,橋南里,21,768,288,130,418,25,443
公投第１１案,屏東縣,屏東市,橋南里,22,786,267,154,421,18,439
公投第１１案,屏東縣,屏東市,橋北里,23,890,352,148,500,29,529
公投第１１案,屏東縣,屏東市,大連里,24,1353,516,218,734,28,762
公投第１１案,屏東縣,屏東市,大連里,25,1386,512,221,733,12,745
公投第１１案,屏東縣,屏東市,大連里,26,1413,494,244,738,22,760
公投第１１案,屏東縣,屏東市,大連里,27,1272,481,187,668,22,690
公投第１１案,屏東縣,屏東市,大連里,28,1287,452,234,686,17,703
公投第１１案,屏東縣,屏東市,大連里,29,1311,492,247,739,26,765
公投第１１案,屏東縣,屏東市,大連里,30,1285,485,126,611,17,628
公投第１１案,屏東縣,屏東市,豐田里,31,1297,484,234,718,26,744
公投第１１案,屏東縣,屏東市,豐田里,32,1361,497,225,722,22,744
公投第１１案,屏東縣,屏東市,豐田里,33,1381,463,220,683,28,711
公投第１１案,屏東縣,屏東市,豐榮里,34,1258,496,217,713,34,747
公投第１１案,屏東縣,屏東市,豐榮里,35,1259,476,209,685,29,714
公投第１１案,屏東縣,屏東市,豐源里,36,1076,386,197,583,13,596
公投第１１案,屏東縣,屏東市,豐源里,37,1162,433,231,664,11,675
公投第１１案,屏東縣,屏東市,豐源里,38,1318,488,249,737,19,756
公投第１１案,屏東縣,屏東市,長春里,39,939,332,165,497,26,523
公投第１１案,屏東縣,屏東市,長春里,40,972,369,177,546,17,563
公投第１１案,屏東縣,屏東市,瑞光里,41,1535,553,284,837,30,867
公投第１１案,屏東縣,屏東市,瑞光里,42,1419,472,190,662,25,687
公投第１１案,屏東縣,屏東市,瑞光里,43,1398,485,198,683,13,696
公投第１１案,屏東縣,屏東市,瑞光里,44,1405,507,210,717,30,747
公投第１１案,屏東縣,屏東市,瑞光里,45,1486,567,232,799,20,819
公投第１１案,屏東縣,屏東市,湖南里,46,1061,375,189,564,28,592
公投第１１案,屏東縣,屏東市,湖西里,47,1540,471,237,708,48,756
公投第１１案,屏東縣,屏東市,歸心里,48,1141,349,193,542,10,552
公投第１１案,屏東縣,屏東市,清溪里,49,1247,393,208,601,22,623
公投第１１案,屏東縣,屏東市,清溪里,50,1446,453,245,698,38,736
公投第１１案,屏東縣,屏東市,清溪里,51,1303,506,210,716,23,739
公投第１１案,屏東縣,屏東市,大武里,52,1253,471,196,667,22,689
公投第１１案,屏東縣,屏東市,大武里,53,1315,476,211,687,29,716
公投第１１案,屏東縣,屏東市,大武里,54,1425,435,266,701,29,730
公投第１１案,屏東縣,屏東市,大武里,55,1423,487,227,714,25,739
公投第１１案,屏東縣,屏東市,大武里,56,1400,530,227,757,34,791
公投第１１案,屏東縣,屏東市,大武里,57,1359,480,282,762,26,788
公投第１１案,屏東縣,屏東市,崇武里,58,1328,528,164,692,26,718
公投第１１案,屏東縣,屏東市,崇武里,59,1539,591,204,795,23,818
公投第１１案,屏東縣,屏東市,凌雲里,60,391,92,47,139,4,143
公投第１１案,屏東縣,屏東市,永昌里,61,200,72,31,103,14,117
公投第１１案,屏東縣,屏東市,永順里,62,328,96,52,148,20,168
公投第１１案,屏東縣,屏東市,鵬程里,63,231,88,29,117,3,120
公投第１１案,屏東縣,屏東市,安鎮里,64,945,325,156,481,38,519
公投第１１案,屏東縣,屏東市,安鎮里,65,1053,344,176,520,46,566
公投第１１案,屏東縣,屏東市,永光里,66,1043,325,174,499,44,543
公投第１１案,屏東縣,屏東市,長安里,67,1061,354,157,511,56,567
公投第１１案,屏東縣,屏東市,長安里,68,876,296,136,432,25,457
公投第１１案,屏東縣,屏東市,前進里,69,1468,498,207,705,74,779
公投第１１案,屏東縣,屏東市,前進里,70,1454,477,212,689,40,729
公投第１１案,屏東縣,屏東市,大洲里,71,1205,430,234,664,15,679
公投第１１案,屏東縣,屏東市,新興里,72,1284,402,234,636,29,665
公投第１１案,屏東縣,屏東市,新興里,73,1219,419,167,586,29,615
公投第１１案,屏東縣,屏東市,公館里,74,1544,563,259,822,48,870
公投第１１案,屏東縣,屏東市,新生里,75,1485,525,230,755,57,812
公投第１１案,屏東縣,屏東市,新生里,76,1387,491,218,709,43,752
公投第１１案,屏東縣,屏東市,新生里,77,953,342,135,477,18,495
公投第１１案,屏東縣,屏東市,新生里,78,1603,661,197,858,25,883
公投第１１案,屏東縣,屏東市,頂宅里,79,535,179,94,273,25,298
公投第１１案,屏東縣,屏東市,頂柳里,80,1119,399,179,578,22,600
公投第１１案,屏東縣,屏東市,大湖里,81,847,328,118,446,29,475
公投第１１案,屏東縣,屏東市,大湖里,82,923,307,184,491,61,552
公投第１１案,屏東縣,屏東市,龍華里,83,1227,412,200,612,25,637
公投第１１案,屏東縣,屏東市,龍華里,84,1039,392,163,555,24,579
公投第１１案,屏東縣,屏東市,玉成里,85,1485,504,242,746,48,794
公投第１１案,屏東縣,屏東市,擇仁里,86,867,304,136,440,36,476
公投第１１案,屏東縣,屏東市,建國里,87,918,344,144,488,32,520
公投第１１案,屏東縣,屏東市,萬年里,88,663,213,105,318,28,346
公投第１１案,屏東縣,屏東市,厚生里,89,1215,384,185,569,18,587
公投第１１案,屏東縣,屏東市,厚生里,90,1628,483,276,759,47,806
公投第１１案,屏東縣,屏東市,一心里,91,1209,418,232,650,30,680
公投第１１案,屏東縣,屏東市,義勇里,92,1110,466,224,690,20,710
公投第１１案,屏東縣,屏東市,光華里,93,684,228,96,324,9,333
公投第１１案,屏東縣,屏東市,永安里,94,1349,410,180,590,26,616
公投第１１案,屏東縣,屏東市,永安里,95,1457,518,190,708,43,751
公投第１１案,屏東縣,屏東市,永安里,96,1447,521,244,765,31,796
公投第１１案,屏東縣,屏東市,永安里,97,1354,431,239,670,17,687
公投第１１案,屏東縣,屏東市,永安里,98,1583,564,273,837,46,883
公投第１１案,屏東縣,屏東市,崇蘭里,99,1707,623,245,868,17,885
公投第１１案,屏東縣,屏東市,崇蘭里,100,1637,560,219,779,25,804
公投第１１案,屏東縣,屏東市,崇蘭里,101,1459,495,204,699,8,707
公投第１１案,屏東縣,屏東市,崇蘭里,102,1759,661,267,928,23,951
公投第１１案,屏東縣,屏東市,崇蘭里,103,1950,681,272,953,28,981
公投第１１案,屏東縣,屏東市,崇蘭里,104,1729,626,263,889,32,921
公投第１１案,屏東縣,屏東市,崇蘭里,105,1592,548,257,805,18,823
公投第１１案,屏東縣,屏東市,潭墘里,106,1437,517,192,709,23,732
公投第１１案,屏東縣,屏東市,潭墘里,107,1204,431,175,606,20,626
公投第１１案,屏東縣,屏東市,潭墘里,108,1340,513,198,711,22,733
公投第１１案,屏東縣,屏東市,潭墘里,109,1322,476,225,701,20,721
公投第１１案,屏東縣,屏東市,潭墘里,110,1462,510,205,715,29,744
公投第１１案,屏東縣,屏東市,潭墘里,111,3241,1093,461,1554,38,1592
公投第１１案,屏東縣,屏東市,潭墘里,112,1477,517,201,718,11,729
公投第１１案,屏東縣,屏東市,永城里,113,821,280,106,386,15,401
公投第１１案,屏東縣,屏東市,永城里,114,1099,328,150,478,18,496
公投第１１案,屏東縣,屏東市,空翔里,115,1688,617,222,839,29,868
公投第１１案,屏東縣,屏東市,廣興里,116,1167,360,205,565,36,601
公投第１１案,屏東縣,屏東市,廣興里,117,915,330,135,465,27,492
公投第１１案,屏東縣,屏東市,勝利里,118,1683,362,151,513,19,532
公投第１１案,屏東縣,屏東市,勝利里,119,1497,518,228,746,17,763
公投第１１案,屏東縣,屏東市,勝利里,120,1129,388,190,578,20,598
公投第１１案,屏東縣,屏東市,勝利里,121,1232,473,176,649,17,666
公投第１１案,屏東縣,屏東市,斯文里,122,853,321,120,441,15,456
公投第１１案,屏東縣,屏東市,斯文里,123,869,336,153,489,20,509
公投第１１案,屏東縣,屏東市,華山里,124,1169,437,200,637,32,669
公投第１１案,屏東縣,屏東市,華山里,125,1058,413,162,575,21,596
公投第１１案,屏東縣,屏東市,華山里,126,1344,445,203,648,21,669
公投第１１案,屏東縣,屏東市,華山里,127,1299,466,209,675,24,699
公投第１１案,屏東縣,屏東市,溝美里,128,1204,418,189,607,35,642
公投第１１案,屏東縣,屏東市,溝美里,129,1123,394,178,572,28,600
公投第１１案,屏東縣,屏東市,三山里,130,1318,422,189,611,24,635
公投第１１案,屏東縣,屏東市,海豐里,131,865,341,142,483,37,520
公投第１１案,屏東縣,屏東市,仁義里,132,1100,362,165,527,14,541
公投第１１案,屏東縣,屏東市,北興里,133,1215,396,192,588,17,605
公投第１１案,屏東縣,屏東市,北興里,134,1370,516,190,706,24,730
公投第１１案,屏東縣,屏東市,北興里,135,1240,478,176,654,9,663
公投第１１案,屏東縣,屏東市,北興里,136,1168,427,220,647,19,666
公投第１１案,屏東縣,屏東市,北興里,137,1079,416,157,573,20,593
公投第１１案,屏東縣,屏東市,北勢里,138,1289,480,226,706,40,746
公投第１１案,屏東縣,屏東市,北勢里,139,1115,389,184,573,21,594
公投第１１案,屏東縣,屏東市,中正里,140,1491,536,270,806,36,842
公投第１１案,屏東縣,屏東市,中正里,141,1411,468,199,667,22,689
公投第１１案,屏東縣,屏東市,中正里,142,1803,598,295,893,18,911
公投第１１案,屏東縣,屏東市,興樂里,143,744,275,138,413,15,428
公投第１１案,屏東縣,屏東市,明正里,144,678,237,122,359,12,371
公投第１１案,屏東縣,屏東市,太平里,145,681,256,134,390,15,405
公投第１１案,屏東縣,屏東市,信和里,146,1535,466,241,707,23,730
公投第１１案,屏東縣,屏東市,和興里,147,954,351,141,492,53,545
公投第１１案,屏東縣,屏東市,仁愛里,148,1018,403,195,598,19,617
公投第１１案,屏東縣,屏東市,仁愛里,149,1154,413,223,636,21,657
公投第１１案,屏東縣,潮州鎮,潮州里,150,504,200,91,291,14,305
公投第１１案,屏東縣,潮州鎮,光華里,151,1711,543,248,791,29,820
公投第１１案,屏東縣,潮州鎮,光華里,152,1634,560,263,823,22,845
公投第１１案,屏東縣,潮州鎮,光華里,153,1414,475,183,658,25,683
公投第１１案,屏東縣,潮州鎮,同榮里,154,603,244,109,353,28,381
公投第１１案,屏東縣,潮州鎮,彭城里,155,896,311,143,454,35,489
公投第１１案,屏東縣,潮州鎮,三星里,156,1285,468,188,656,21,677
公投第１１案,屏東縣,潮州鎮,三星里,157,1744,583,253,836,33,869
公投第１１案,屏東縣,潮州鎮,三星里,158,1071,419,180,599,21,620
公投第１１案,屏東縣,潮州鎮,三星里,159,1209,480,193,673,35,708
公投第１１案,屏東縣,潮州鎮,三共里,160,1159,410,185,595,28,623
公投第１１案,屏東縣,潮州鎮,三共里,161,1296,432,203,635,29,664
公投第１１案,屏東縣,潮州鎮,三共里,162,1466,509,214,723,35,758
公投第１１案,屏東縣,潮州鎮,三共里,163,1130,433,190,623,32,655
公投第１１案,屏東縣,潮州鎮,三共里,164,1439,515,234,749,29,778
公投第１１案,屏東縣,潮州鎮,三和里,165,897,368,121,489,37,526
公投第１１案,屏東縣,潮州鎮,三和里,166,1225,474,197,671,31,702
公投第１１案,屏東縣,潮州鎮,九塊里,167,1158,375,176,551,36,587
公投第１１案,屏東縣,潮州鎮,九塊里,168,481,124,71,195,25,220
公投第１１案,屏東縣,潮州鎮,新生里,169,972,355,167,522,78,600
公投第１１案,屏東縣,潮州鎮,新榮里,170,1245,501,208,709,27,736
公投第１１案,屏東縣,潮州鎮,五魁里,171,1415,525,191,716,39,755
公投第１１案,屏東縣,潮州鎮,蓬萊里,172,1255,405,182,587,13,600
公投第１１案,屏東縣,潮州鎮,蓬萊里,173,1058,292,129,421,22,443
公投第１１案,屏東縣,潮州鎮,八爺里,174,1187,413,175,588,27,615
公投第１１案,屏東縣,潮州鎮,八爺里,175,1083,420,156,576,31,607
公投第１１案,屏東縣,潮州鎮,永春里,176,1590,524,228,752,25,777
公投第１１案,屏東縣,潮州鎮,永春里,177,1543,568,237,805,45,850
公投第１１案,屏東縣,潮州鎮,永春里,178,1631,536,245,781,31,812
公投第１１案,屏東縣,潮州鎮,永春里,179,1159,445,167,612,15,627
公投第１１案,屏東縣,潮州鎮,永春里,180,1099,422,181,603,19,622
公投第１１案,屏東縣,潮州鎮,富春里,181,1200,399,162,561,34,595
公投第１１案,屏東縣,潮州鎮,光春里,182,1391,479,186,665,39,704
公投第１１案,屏東縣,潮州鎮,興美里,183,881,328,146,474,39,513
公投第１１案,屏東縣,潮州鎮,檨子里,184,454,163,52,215,15,230
公投第１１案,屏東縣,潮州鎮,泗林里,185,1658,647,230,877,34,911
公投第１１案,屏東縣,潮州鎮,四春里,186,822,287,109,396,26,422
公投第１１案,屏東縣,潮州鎮,四春里,187,948,274,143,417,15,432
公投第１１案,屏東縣,潮州鎮,崙東里,188,1194,329,150,479,27,506
公投第１１案,屏東縣,潮州鎮,崙東里,189,337,120,48,168,23,191
公投第１１案,屏東縣,東港鎮,新勝里,190,981,410,151,561,31,592
公投第１１案,屏東縣,東港鎮,新勝里,191,1070,422,180,602,32,634
公投第１１案,屏東縣,東港鎮,頂新里,192,527,222,89,311,37,348
公投第１１案,屏東縣,東港鎮,頂中里,193,395,162,69,231,15,246
公投第１１案,屏東縣,東港鎮,東和里,194,659,221,94,315,23,338
公投第１１案,屏東縣,東港鎮,興台里,195,513,188,76,264,24,288
公投第１１案,屏東縣,東港鎮,興東里,196,1732,574,269,843,51,894
公投第１１案,屏東縣,東港鎮,興東里,197,1779,626,297,923,31,954
公投第１１案,屏東縣,東港鎮,興東里,198,1270,440,177,617,25,642
公投第１１案,屏東縣,東港鎮,興東里,199,1327,451,216,667,36,703
公投第１１案,屏東縣,東港鎮,興東里,200,1242,460,202,662,35,697
公投第１１案,屏東縣,東港鎮,興東里,201,1607,577,269,846,44,890
公投第１１案,屏東縣,東港鎮,興農里,202,1305,418,189,607,43,650
公投第１１案,屏東縣,東港鎮,中興里,203,695,228,140,368,23,391
公投第１１案,屏東縣,東港鎮,朝安里,204,1076,423,190,613,47,660
公投第１１案,屏東縣,東港鎮,朝安里,205,567,188,88,276,16,292
公投第１１案,屏東縣,東港鎮,八德里,206,806,295,119,414,25,439
公投第１１案,屏東縣,東港鎮,東隆里,207,1227,465,182,647,41,688
公投第１１案,屏東縣,東港鎮,豐漁里,208,599,204,85,289,38,327
公投第１１案,屏東縣,東港鎮,盛漁里,209,1354,387,155,542,35,577
公投第１１案,屏東縣,東港鎮,興漁里,210,734,229,124,353,38,391
公投第１１案,屏東縣,東港鎮,興漁里,211,1107,389,179,568,67,635
公投第１１案,屏東縣,東港鎮,鎮海里,212,1198,382,152,534,59,593
公投第１１案,屏東縣,東港鎮,鎮海里,213,1614,517,282,799,67,866
公投第１１案,屏東縣,東港鎮,嘉蓮里,214,826,253,135,388,37,425
公投第１１案,屏東縣,東港鎮,嘉蓮里,215,912,390,103,493,28,521
公投第１１案,屏東縣,東港鎮,南平里,216,432,147,50,197,26,223
公投第１１案,屏東縣,東港鎮,南平里,217,1204,434,177,611,78,689
公投第１１案,屏東縣,東港鎮,船頭里,218,1304,476,199,675,50,725
公投第１１案,屏東縣,東港鎮,船頭里,219,1317,497,210,707,43,750
公投第１１案,屏東縣,東港鎮,船頭里,220,1387,484,206,690,22,712
公投第１１案,屏東縣,東港鎮,船頭里,221,1310,423,169,592,22,614
公投第１１案,屏東縣,東港鎮,下廍里,222,1228,369,189,558,47,605
公投第１１案,屏東縣,東港鎮,下廍里,223,766,216,125,341,32,373
公投第１１案,屏東縣,東港鎮,大潭里,224,823,281,159,440,36,476
公投第１１案,屏東縣,東港鎮,大潭里,225,755,213,82,295,21,316
公投第１１案,屏東縣,東港鎮,興和里,226,1094,352,207,559,62,621
公投第１１案,屏東縣,東港鎮,共和里,227,753,257,99,356,18,374
公投第１１案,屏東縣,恆春鎮,城南里,228,902,306,120,426,24,450
公投第１１案,屏東縣,恆春鎮,城北里,229,969,374,146,520,33,553
公投第１１案,屏東縣,恆春鎮,城北里,230,1280,379,214,593,40,633
公投第１１案,屏東縣,恆春鎮,城西里,231,1133,391,192,583,29,612
公投第１１案,屏東縣,恆春鎮,網紗里,232,1552,410,228,638,16,654
公投第１１案,屏東縣,恆春鎮,網紗里,233,1485,386,190,576,43,619
公投第１１案,屏東縣,恆春鎮,仁壽里,234,896,297,158,455,25,480
公投第１１案,屏東縣,恆春鎮,茄湖里,235,531,154,77,231,19,250
公投第１１案,屏東縣,恆春鎮,頭溝里,236,478,152,60,212,12,224
公投第１１案,屏東縣,恆春鎮,四溝里,237,1020,311,143,454,35,489
公投第１１案,屏東縣,恆春鎮,德和里,238,924,243,190,433,20,453
公投第１１案,屏東縣,恆春鎮,龍水里,239,1079,268,174,442,28,470
公投第１１案,屏東縣,恆春鎮,山海里,240,775,220,80,300,25,325
公投第１１案,屏東縣,恆春鎮,山海里,241,813,274,121,395,49,444
公投第１１案,屏東縣,恆春鎮,大光里,242,1104,390,100,490,39,529
公投第１１案,屏東縣,恆春鎮,大光里,243,1110,295,172,467,35,502
公投第１１案,屏東縣,恆春鎮,水泉里,244,692,163,93,256,41,297
公投第１１案,屏東縣,恆春鎮,水泉里,245,708,135,104,239,12,251
公投第１１案,屏東縣,恆春鎮,山腳里,246,1505,473,221,694,31,725
公投第１１案,屏東縣,恆春鎮,山腳里,247,1111,329,158,487,34,521
公投第１１案,屏東縣,恆春鎮,山腳里,248,1543,475,200,675,34,709
公投第１１案,屏東縣,恆春鎮,南灣里,249,828,206,115,321,20,341
公投第１１案,屏東縣,恆春鎮,南灣里,250,844,266,149,415,30,445
公投第１１案,屏東縣,恆春鎮,墾丁里,251,1253,372,199,571,39,610
公投第１１案,屏東縣,恆春鎮,鵝鑾里,252,1126,332,144,476,37,513
公投第１１案,屏東縣,萬丹鄉,香社村,253,1527,468,192,660,37,697
公投第１１案,屏東縣,萬丹鄉,新庄村,254,1147,359,172,531,41,572
公投第１１案,屏東縣,萬丹鄉,新庄村,255,949,291,152,443,36,479
公投第１１案,屏東縣,萬丹鄉,新鐘村,256,990,315,151,466,18,484
公投第１１案,屏東縣,萬丹鄉,新鐘村,257,1022,350,144,494,18,512
公投第１１案,屏東縣,萬丹鄉,水仙村,258,545,248,83,331,40,371
公投第１１案,屏東縣,萬丹鄉,興全村,259,1159,472,176,648,54,702
公投第１１案,屏東縣,萬丹鄉,興安村,260,837,313,157,470,41,511
公投第１１案,屏東縣,萬丹鄉,甘棠村,261,392,134,55,189,11,200
公投第１１案,屏東縣,萬丹鄉,萬惠村,262,847,318,141,459,29,488
公投第１１案,屏東縣,萬丹鄉,萬全村,263,1149,392,173,565,30,595
公投第１１案,屏東縣,萬丹鄉,萬全村,264,1131,420,171,591,25,616
公投第１１案,屏東縣,萬丹鄉,萬全村,265,1178,406,171,577,33,610
公投第１１案,屏東縣,萬丹鄉,萬後村,266,711,272,134,406,21,427
公投第１１案,屏東縣,萬丹鄉,萬安村,267,595,246,117,363,19,382
公投第１１案,屏東縣,萬丹鄉,萬生村,268,1403,531,233,764,42,806
公投第１１案,屏東縣,萬丹鄉,寶厝村,269,1094,381,166,547,20,567
公投第１１案,屏東縣,萬丹鄉,寶厝村,270,1158,433,204,637,27,664
公投第１１案,屏東縣,萬丹鄉,四維村,271,963,380,180,560,40,600
公投第１１案,屏東縣,萬丹鄉,四維村,272,1062,393,176,569,27,596
公投第１１案,屏東縣,萬丹鄉,竹林村,273,1684,567,269,836,55,891
公投第１１案,屏東縣,萬丹鄉,水泉村,274,1702,543,260,803,33,836
公投第１１案,屏東縣,萬丹鄉,田厝村,275,976,374,177,551,23,574
公投第１１案,屏東縣,萬丹鄉,崙頂村,276,1013,348,156,504,56,560
公投第１１案,屏東縣,萬丹鄉,崙頂村,277,847,243,112,355,33,388
公投第１１案,屏東縣,萬丹鄉,厦北村,278,1570,573,252,825,87,912
公投第１１案,屏東縣,萬丹鄉,厦南村,279,1411,451,196,647,56,703
公投第１１案,屏東縣,萬丹鄉,後村村,280,1046,365,194,559,46,605
公投第１１案,屏東縣,萬丹鄉,灣內村,281,1385,458,223,681,32,713
公投第１１案,屏東縣,萬丹鄉,上村村,282,804,287,123,410,38,448
公投第１１案,屏東縣,萬丹鄉,加興村,283,1284,447,213,660,45,705
公投第１１案,屏東縣,萬丹鄉,社口村,284,1430,451,226,677,32,709
公投第１１案,屏東縣,萬丹鄉,磚寮村,285,960,392,170,562,40,602
公投第１１案,屏東縣,萬丹鄉,社皮村,286,786,321,127,448,35,483
公投第１１案,屏東縣,萬丹鄉,社皮村,287,1158,399,192,591,57,648
公投第１１案,屏東縣,萬丹鄉,社中村,288,1647,475,193,668,44,712
公投第１１案,屏東縣,萬丹鄉,社上村,289,1666,512,215,727,52,779
公投第１１案,屏東縣,萬丹鄉,廣安村,290,1023,418,173,591,37,628
公投第１１案,屏東縣,萬丹鄉,廣安村,291,1227,479,207,686,33,719
公投第１１案,屏東縣,長治鄉,進興村,292,1018,364,161,525,44,569
公投第１１案,屏東縣,長治鄉,進興村,293,1614,579,254,833,43,876
公投第１１案,屏東縣,長治鄉,新潭村,294,1848,703,313,1016,43,1059
公投第１１案,屏東縣,長治鄉,新潭村,295,1707,640,240,880,50,930
公投第１１案,屏東縣,長治鄉,潭頭村,296,972,379,162,541,13,554
公投第１１案,屏東縣,長治鄉,潭頭村,297,989,372,163,535,36,571
公投第１１案,屏東縣,長治鄉,香楊村,298,735,289,131,420,25,445
公投第１１案,屏東縣,長治鄉,香楊村,299,1813,538,316,854,43,897
公投第１１案,屏東縣,長治鄉,長興村,300,1073,426,197,623,28,651
公投第１１案,屏東縣,長治鄉,崙上村,301,1654,575,253,828,47,875
公投第１１案,屏東縣,長治鄉,德榮村,302,1205,400,239,639,46,685
公投第１１案,屏東縣,長治鄉,德和村,303,758,252,154,406,28,434
公投第１１案,屏東縣,長治鄉,復興村,304,1492,510,251,761,66,827
公投第１１案,屏東縣,長治鄉,德成村,305,884,351,132,483,33,516
公投第１１案,屏東縣,長治鄉,德協村,306,1090,421,171,592,36,628
公投第１１案,屏東縣,長治鄉,繁榮村,307,1422,416,225,641,71,712
公投第１１案,屏東縣,長治鄉,繁昌村,308,845,297,130,427,41,468
公投第１１案,屏東縣,長治鄉,繁昌村,309,925,309,147,456,80,536
公投第１１案,屏東縣,長治鄉,繁隆村,310,1138,460,163,623,11,634
公投第１１案,屏東縣,長治鄉,繁華村,311,1242,455,171,626,64,690
公投第１１案,屏東縣,長治鄉,繁華村,312,1159,372,163,535,18,553
公投第１１案,屏東縣,長治鄉,榮華村,313,673,248,124,372,29,401
公投第１１案,屏東縣,麟洛鄉,新田村,314,788,269,159,428,22,450
公投第１１案,屏東縣,麟洛鄉,新田村,315,1386,555,257,812,24,836
公投第１１案,屏東縣,麟洛鄉,麟頂村,316,957,362,196,558,28,586
公投第１１案,屏東縣,麟洛鄉,麟蹄村,317,731,256,160,416,36,452
公投第１１案,屏東縣,麟洛鄉,麟蹄村,318,806,306,159,465,39,504
公投第１１案,屏東縣,麟洛鄉,麟趾村,319,1207,414,200,614,14,628
公投第１１案,屏東縣,麟洛鄉,麟趾村,320,1340,490,277,767,53,820
公投第１１案,屏東縣,麟洛鄉,田中村,321,1221,461,248,709,41,750
公投第１１案,屏東縣,麟洛鄉,田心村,322,851,313,155,468,15,483
公投第１１案,屏東縣,麟洛鄉,田道村,323,683,244,102,346,11,357
公投第１１案,屏東縣,九如鄉,九清村,324,1491,546,237,783,59,842
公投第１１案,屏東縣,九如鄉,九塊村,325,1375,474,228,702,38,740
公投第１１案,屏東縣,九如鄉,九明村,326,1678,552,242,794,50,844
公投第１１案,屏東縣,九如鄉,大坵村,327,1166,405,213,618,67,685
公投第１１案,屏東縣,九如鄉,玉水村,328,1276,438,90,528,40,568
公投第１１案,屏東縣,九如鄉,玉泉村,329,1033,382,166,548,38,586
公投第１１案,屏東縣,九如鄉,玉泉村,330,577,255,114,369,28,397
公投第１１案,屏東縣,九如鄉,東寧村,331,649,256,105,361,39,400
公投第１１案,屏東縣,九如鄉,東寧村,332,1999,696,320,1016,80,1096
公投第１１案,屏東縣,九如鄉,東寧村,333,1766,568,296,864,52,916
公投第１１案,屏東縣,九如鄉,三塊村,334,1600,502,267,769,66,835
公投第１１案,屏東縣,九如鄉,耆老村,335,1248,406,229,635,49,684
公投第１１案,屏東縣,九如鄉,後庄村,336,1792,645,285,930,112,1042
公投第１１案,屏東縣,九如鄉,洽興村,337,1482,509,229,738,75,813
公投第１１案,屏東縣,里港鄉,玉田村,338,1552,566,289,855,62,917
公投第１１案,屏東縣,里港鄉,玉田村,339,1480,497,231,728,60,788
公投第１１案,屏東縣,里港鄉,塔樓村,340,1534,422,224,646,42,688
公投第１１案,屏東縣,里港鄉,潮厝村,341,1578,572,239,811,44,855
公投第１１案,屏東縣,里港鄉,大平村,342,1127,440,193,633,40,673
公投第１１案,屏東縣,里港鄉,永春村,343,845,323,142,465,32,497
公投第１１案,屏東縣,里港鄉,春林村,344,1282,451,192,643,42,685
公投第１１案,屏東縣,里港鄉,過江村,345,981,372,162,534,36,570
公投第１１案,屏東縣,里港鄉,過江村,346,1031,355,195,550,49,599
公投第１１案,屏東縣,里港鄉,鐵店村,347,1423,469,261,730,72,802
公投第１１案,屏東縣,里港鄉,茄苳村,348,363,112,50,162,18,180
公投第１１案,屏東縣,里港鄉,茄苳村,349,1203,374,238,612,91,703
公投第１１案,屏東縣,里港鄉,載興村,350,1027,383,192,575,63,638
公投第１１案,屏東縣,里港鄉,載興村,351,1384,453,217,670,52,722
公投第１１案,屏東縣,里港鄉,土庫村,352,1512,499,241,740,44,784
公投第１１案,屏東縣,里港鄉,土庫村,353,522,215,78,293,15,308
公投第１１案,屏東縣,里港鄉,三廍村,354,822,271,136,407,52,459
公投第１１案,屏東縣,里港鄉,三廍村,355,1007,304,163,467,62,529
公投第１１案,屏東縣,里港鄉,中和村,356,956,324,156,480,57,537
公投第１１案,屏東縣,里港鄉,瀰力村,357,499,167,96,263,19,282
公投第１１案,屏東縣,鹽埔鄉,鹽北村,358,951,352,133,485,26,511
公投第１１案,屏東縣,鹽埔鄉,鹽北村,359,899,296,138,434,22,456
公投第１１案,屏東縣,鹽埔鄉,鹽中村,360,1116,360,161,521,17,538
公投第１１案,屏東縣,鹽埔鄉,鹽中村,361,1241,408,189,597,32,629
公投第１１案,屏東縣,鹽埔鄉,鹽南村,362,770,234,129,363,43,406
公投第１１案,屏東縣,鹽埔鄉,鹽南村,363,962,340,143,483,27,510
公投第１１案,屏東縣,鹽埔鄉,仕絨村,364,1041,406,187,593,39,632
公投第１１案,屏東縣,鹽埔鄉,高朗村,365,1367,441,213,654,55,709
公投第１１案,屏東縣,鹽埔鄉,高朗村,366,1465,440,245,685,50,735
公投第１１案,屏東縣,鹽埔鄉,振興村,367,894,247,133,380,40,420
公投第１１案,屏東縣,鹽埔鄉,振興村,368,958,271,139,410,3,413
公投第１１案,屏東縣,鹽埔鄉,久愛村,369,924,291,151,442,53,495
公投第１１案,屏東縣,鹽埔鄉,新圍村,370,1598,529,209,738,24,762
公投第１１案,屏東縣,鹽埔鄉,新圍村,371,1550,501,259,760,72,832
公投第１１案,屏東縣,鹽埔鄉,新二村,372,1127,380,182,562,41,603
公投第１１案,屏東縣,鹽埔鄉,新二村,373,1150,415,201,616,56,672
公投第１１案,屏東縣,鹽埔鄉,新二村,374,1233,441,204,645,38,683
公投第１１案,屏東縣,鹽埔鄉,彭厝村,375,984,378,152,530,64,594
公投第１１案,屏東縣,鹽埔鄉,洛陽村,376,1619,542,301,843,50,893
公投第１１案,屏東縣,鹽埔鄉,永隆村,377,553,184,103,287,21,308
公投第１１案,屏東縣,高樹鄉,高樹村,378,883,331,164,495,60,555
公投第１１案,屏東縣,高樹鄉,高樹村,379,1255,337,145,482,16,498
公投第１１案,屏東縣,高樹鄉,長榮村,380,1278,566,77,643,26,669
公投第１１案,屏東縣,高樹鄉,東興村,381,738,237,81,318,27,345
公投第１１案,屏東縣,高樹鄉,東振村,382,585,166,101,267,13,280
公投第１１案,屏東縣,高樹鄉,源泉村,383,1012,328,188,516,82,598
公投第１１案,屏東縣,高樹鄉,建興村,384,1148,242,293,535,52,587
公投第１１案,屏東縣,高樹鄉,大埔村,385,591,173,102,275,29,304
公投第１１案,屏東縣,高樹鄉,菜寮村,386,786,200,116,316,51,367
公投第１１案,屏東縣,高樹鄉,司馬村,387,649,187,77,264,22,286
公投第１１案,屏東縣,高樹鄉,舊寮村,388,1229,333,144,477,47,524
公投第１１案,屏東縣,高樹鄉,新豐村,389,1446,415,170,585,39,624
公投第１１案,屏東縣,高樹鄉,泰山村,390,899,205,139,344,16,360
公投第１１案,屏東縣,高樹鄉,泰山村,391,922,284,143,427,51,478
公投第１１案,屏東縣,高樹鄉,南華村,392,1259,344,193,537,58,595
公投第１１案,屏東縣,高樹鄉,廣福村,393,1056,345,114,459,13,472
公投第１１案,屏東縣,高樹鄉,廣興村,394,1116,358,208,566,50,616
公投第１１案,屏東縣,高樹鄉,舊庄村,395,1020,347,165,512,60,572
公投第１１案,屏東縣,高樹鄉,田子村,396,1055,327,190,517,58,575
公投第１１案,屏東縣,高樹鄉,鹽樹村,397,738,250,147,397,45,442
公投第１１案,屏東縣,高樹鄉,鹽樹村,398,493,145,66,211,24,235
公投第１１案,屏東縣,高樹鄉,新南村,399,1539,503,277,780,89,869
公投第１１案,屏東縣,萬巒鄉,萬巒村,400,1239,421,185,606,30,636
公投第１１案,屏東縣,萬巒鄉,萬全村,401,759,282,122,404,36,440
公投第１１案,屏東縣,萬巒鄉,萬和村,402,932,350,146,496,52,548
公投第１１案,屏東縣,萬巒鄉,萬和村,403,769,290,131,421,46,467
公投第１１案,屏東縣,萬巒鄉,鹿寮村,404,920,314,138,452,55,507
公投第１１案,屏東縣,萬巒鄉,硫黃村,405,560,199,99,298,27,325
公投第１１案,屏東縣,萬巒鄉,泗溝村,406,1120,375,142,517,22,539
公投第１１案,屏東縣,萬巒鄉,五溝村,407,1048,375,134,509,23,532
公投第１１案,屏東縣,萬巒鄉,成德村,408,1438,439,174,613,44,657
公投第１１案,屏東縣,萬巒鄉,赤山村,409,834,251,138,389,27,416
公投第１１案,屏東縣,萬巒鄉,赤山村,410,813,279,116,395,38,433
公投第１１案,屏東縣,萬巒鄉,萬金村,411,1020,412,122,534,20,554
公投第１１案,屏東縣,萬巒鄉,萬金村,412,1007,398,161,559,40,599
公投第１１案,屏東縣,萬巒鄉,佳佐村,413,1648,471,199,670,59,729
公投第１１案,屏東縣,萬巒鄉,佳和村,414,1437,491,211,702,41,743
公投第１１案,屏東縣,萬巒鄉,新厝村,415,1228,390,170,560,0,560
公投第１１案,屏東縣,萬巒鄉,新置村,416,597,243,84,327,32,359
公投第１１案,屏東縣,萬巒鄉,新置村,417,576,199,94,293,38,331
公投第１１案,屏東縣,內埔鄉,內埔村,418,1305,413,164,577,28,605
公投第１１案,屏東縣,內埔鄉,內埔村,419,1287,423,163,586,36,622
公投第１１案,屏東縣,內埔鄉,內埔村,420,1387,452,188,640,14,654
公投第１１案,屏東縣,內埔鄉,內田村,421,1540,484,208,692,37,729
公投第１１案,屏東縣,內埔鄉,內田村,422,1605,511,243,754,34,788
公投第１１案,屏東縣,內埔鄉,興南村,423,1326,427,200,627,45,672
公投第１１案,屏東縣,內埔鄉,義亭村,424,591,193,100,293,41,334
公投第１１案,屏東縣,內埔鄉,美和村,425,1123,343,159,502,31,533
公投第１１案,屏東縣,內埔鄉,美和村,426,1079,378,141,519,18,537
公投第１１案,屏東縣,內埔鄉,和興村,427,1485,515,223,738,32,770
公投第１１案,屏東縣,內埔鄉,和興村,428,1248,499,190,689,25,714
公投第１１案,屏東縣,內埔鄉,東寧村,429,1569,521,253,774,38,812
公投第１１案,屏東縣,內埔鄉,東寧村,430,1493,467,211,678,38,716
公投第１１案,屏東縣,內埔鄉,東寧村,431,1420,451,205,656,10,666
公投第１１案,屏東縣,內埔鄉,豐田村,432,1334,456,197,653,41,694
公投第１１案,屏東縣,內埔鄉,豐田村,433,1519,468,230,698,42,740
公投第１１案,屏東縣,內埔鄉,振豐村,434,784,271,115,386,35,421
公投第１１案,屏東縣,內埔鄉,振豐村,435,888,316,144,460,46,506
公投第１１案,屏東縣,內埔鄉,富田村,436,747,254,87,341,10,351
公投第１１案,屏東縣,內埔鄉,富田村,437,1168,352,146,498,28,526
公投第１１案,屏東縣,內埔鄉,竹圍村,438,546,181,104,285,27,312
公投第１１案,屏東縣,內埔鄉,竹圍村,439,1278,401,193,594,45,639
公投第１１案,屏東縣,內埔鄉,東勢村,440,1348,406,177,583,40,623
公投第１１案,屏東縣,內埔鄉,東勢村,441,1550,412,170,582,57,639
公投第１１案,屏東縣,內埔鄉,東片村,442,947,381,144,525,53,578
公投第１１案,屏東縣,內埔鄉,上樹村,443,1097,370,151,521,42,563
公投第１１案,屏東縣,內埔鄉,老埤村,444,1128,274,165,439,42,481
公投第１１案,屏東縣,內埔鄉,老埤村,445,1253,310,133,443,20,463
公投第１１案,屏東縣,內埔鄉,中林村,446,1525,492,180,672,15,687
公投第１１案,屏東縣,內埔鄉,龍泉村,447,1215,394,209,603,43,646
公投第１１案,屏東縣,內埔鄉,龍泉村,448,1216,368,140,508,22,530
公投第１１案,屏東縣,內埔鄉,龍潭村,449,1353,418,177,595,22,617
公投第１１案,屏東縣,內埔鄉,龍潭村,450,1026,360,141,501,20,521
公投第１１案,屏東縣,內埔鄉,建興村,451,862,270,103,373,33,406
公投第１１案,屏東縣,內埔鄉,大新村,452,921,247,127,374,30,404
公投第１１案,屏東縣,內埔鄉,大新村,453,854,267,146,413,29,442
公投第１１案,屏東縣,內埔鄉,黎明村,454,1230,418,121,539,25,564
公投第１１案,屏東縣,內埔鄉,黎明村,455,1204,404,151,555,19,574
公投第１１案,屏東縣,內埔鄉,隘寮村,456,1301,392,177,569,32,601
公投第１１案,屏東縣,內埔鄉,水門村,457,806,296,121,417,37,454
公投第１１案,屏東縣,竹田鄉,竹田村,458,1503,560,222,782,63,845
公投第１１案,屏東縣,竹田鄉,竹南村,459,899,355,174,529,28,557
公投第１１案,屏東縣,竹田鄉,糶糴村,460,716,233,169,402,49,451
公投第１１案,屏東縣,竹田鄉,履豐村,461,581,233,124,357,26,383
公投第１１案,屏東縣,竹田鄉,頭崙村,462,1327,470,203,673,66,739
公投第１１案,屏東縣,竹田鄉,二崙村,463,997,387,177,564,66,630
公投第１１案,屏東縣,竹田鄉,美崙村,464,649,226,110,336,27,363
公投第１１案,屏東縣,竹田鄉,南勢村,465,476,240,95,335,13,348
公投第１１案,屏東縣,竹田鄉,西勢村,466,1259,488,200,688,55,743
公投第１１案,屏東縣,竹田鄉,西勢村,467,1227,414,180,594,51,645
公投第１１案,屏東縣,竹田鄉,福田村,468,504,201,96,297,25,322
公投第１１案,屏東縣,竹田鄉,永豐村,469,860,294,138,432,35,467
公投第１１案,屏東縣,竹田鄉,六巷村,470,800,277,131,408,26,434
公投第１１案,屏東縣,竹田鄉,泗洲村,471,1134,422,188,610,51,661
公投第１１案,屏東縣,竹田鄉,大湖村,472,1229,425,296,721,44,765
公投第１１案,屏東縣,竹田鄉,鳳明村,473,1192,388,193,581,47,628
公投第１１案,屏東縣,新埤鄉,新埤村,474,1712,570,244,814,32,846
公投第１１案,屏東縣,新埤鄉,新埤村,475,314,104,49,153,24,177
公投第１１案,屏東縣,新埤鄉,建功村,476,752,245,137,382,28,410
公投第１１案,屏東縣,新埤鄉,建功村,477,334,122,47,169,13,182
公投第１１案,屏東縣,新埤鄉,打鐵村,478,957,349,157,506,43,549
公投第１１案,屏東縣,新埤鄉,南豐村,479,764,285,119,404,47,451
公投第１１案,屏東縣,新埤鄉,萬隆村,480,373,130,64,194,18,212
公投第１１案,屏東縣,新埤鄉,萬隆村,481,678,190,94,284,33,317
公投第１１案,屏東縣,新埤鄉,萬隆村,482,701,200,90,290,29,319
公投第１１案,屏東縣,新埤鄉,餉潭村,483,1323,325,175,500,46,546
公投第１１案,屏東縣,新埤鄉,箕湖村,484,541,189,88,277,35,312
公投第１１案,屏東縣,新埤鄉,箕湖村,485,584,167,68,235,33,268
公投第１１案,屏東縣,枋寮鄉,枋寮村,486,1213,460,184,644,35,679
公投第１１案,屏東縣,枋寮鄉,新龍村,487,891,334,149,483,42,525
公投第１１案,屏東縣,枋寮鄉,保生村,488,970,334,113,447,49,496
公投第１１案,屏東縣,枋寮鄉,中寮村,489,629,239,83,322,17,339
公投第１１案,屏東縣,枋寮鄉,安樂村,490,840,320,146,466,31,497
公投第１１案,屏東縣,枋寮鄉,安樂村,491,774,308,125,433,26,459
公投第１１案,屏東縣,枋寮鄉,隆山村,492,1379,474,190,664,50,714
公投第１１案,屏東縣,枋寮鄉,隆山村,493,1502,534,266,800,40,840
公投第１１案,屏東縣,枋寮鄉,隆山村,494,1276,417,210,627,49,676
公投第１１案,屏東縣,枋寮鄉,天時村,495,964,341,133,474,48,522
公投第１１案,屏東縣,枋寮鄉,天時村,496,1005,392,161,553,60,613
公投第１１案,屏東縣,枋寮鄉,地利村,497,734,244,117,361,24,385
公投第１１案,屏東縣,枋寮鄉,地利村,498,725,280,104,384,34,418
公投第１１案,屏東縣,枋寮鄉,人和村,499,1046,329,167,496,54,550
公投第１１案,屏東縣,枋寮鄉,人和村,500,1067,388,169,557,54,611
公投第１１案,屏東縣,枋寮鄉,內寮村,501,718,169,76,245,39,284
公投第１１案,屏東縣,枋寮鄉,新開村,502,903,260,124,384,40,424
公投第１１案,屏東縣,枋寮鄉,東海村,503,1387,467,179,646,60,706
公投第１１案,屏東縣,枋寮鄉,東海村,504,1367,481,211,692,63,755
公投第１１案,屏東縣,枋寮鄉,大庄村,505,618,225,133,358,34,392
公投第１１案,屏東縣,枋寮鄉,太源村,506,959,259,104,363,28,391
公投第１１案,屏東縣,枋寮鄉,玉泉村,507,427,146,69,215,23,238
公投第１１案,屏東縣,新園鄉,瓦磘村,508,820,275,153,428,44,472
公投第１１案,屏東縣,新園鄉,瓦磘村,509,843,325,143,468,45,513
公投第１１案,屏東縣,新園鄉,仙吉村,510,1242,308,299,607,36,643
公投第１１案,屏東縣,新園鄉,仙吉村,511,1290,484,211,695,48,743
公投第１１案,屏東縣,新園鄉,田洋村,512,1073,372,162,534,30,564
公投第１１案,屏東縣,新園鄉,田洋村,513,1088,388,192,580,69,649
公投第１１案,屏東縣,新園鄉,港墘村,514,845,284,113,397,23,420
公投第１１案,屏東縣,新園鄉,內庄村,515,862,281,159,440,30,470
公投第１１案,屏東縣,新園鄉,新東村,516,1183,371,177,548,39,587
公投第１１案,屏東縣,新園鄉,新東村,517,1109,377,174,551,59,610
公投第１１案,屏東縣,新園鄉,新園村,518,1119,315,194,509,16,525
公投第１１案,屏東縣,新園鄉,新園村,519,1152,348,196,544,25,569
公投第１１案,屏東縣,新園鄉,港西村,520,1030,380,151,531,44,575
公投第１１案,屏東縣,新園鄉,港西村,521,1104,359,170,529,57,586
公投第１１案,屏東縣,新園鄉,烏龍村,522,1240,410,169,579,32,611
公投第１１案,屏東縣,新園鄉,興龍村,523,1120,280,164,444,19,463
公投第１１案,屏東縣,新園鄉,興龍村,524,1074,403,162,565,59,624
公投第１１案,屏東縣,新園鄉,中洲村,525,849,243,126,369,33,402
公投第１１案,屏東縣,新園鄉,中洲村,526,749,252,124,376,35,411
公投第１１案,屏東縣,新園鄉,南龍村,527,1416,433,225,658,64,722
公投第１１案,屏東縣,新園鄉,五房村,528,895,332,130,462,34,496
公投第１１案,屏東縣,新園鄉,五房村,529,933,326,129,455,61,516
公投第１１案,屏東縣,新園鄉,五房村,530,972,352,144,496,26,522
公投第１１案,屏東縣,新園鄉,鹽埔村,531,1454,453,186,639,40,679
公投第１１案,屏東縣,新園鄉,鹽埔村,532,1653,646,250,896,69,965
公投第１１案,屏東縣,新園鄉,鹽埔村,533,1270,458,153,611,32,643
公投第１１案,屏東縣,新園鄉,共和村,534,1123,425,178,603,79,682
公投第１１案,屏東縣,新園鄉,共和村,535,1198,422,162,584,36,620
公投第１１案,屏東縣,崁頂鄉,崁頂村,536,1190,387,170,557,32,589
公投第１１案,屏東縣,崁頂鄉,崁頂村,537,1044,389,188,577,36,613
公投第１１案,屏東縣,崁頂鄉,園寮村,538,818,282,137,419,37,456
公投第１１案,屏東縣,崁頂鄉,園寮村,539,1214,380,216,596,34,630
公投第１１案,屏東縣,崁頂鄉,力社村,540,1325,432,179,611,32,643
公投第１１案,屏東縣,崁頂鄉,圍內村,541,1253,480,200,680,39,719
公投第１１案,屏東縣,崁頂鄉,洲子村,542,1039,335,160,495,33,528
公投第１１案,屏東縣,崁頂鄉,北勢村,543,813,247,116,363,33,396
公投第１１案,屏東縣,崁頂鄉,北勢村,544,736,233,115,348,23,371
公投第１１案,屏東縣,崁頂鄉,越溪村,545,934,318,183,501,31,532
公投第１１案,屏東縣,崁頂鄉,港東村,546,900,277,147,424,50,474
公投第１１案,屏東縣,崁頂鄉,港東村,547,1004,355,144,499,42,541
公投第１１案,屏東縣,林邊鄉,林邊村,548,1458,596,222,818,48,866
公投第１１案,屏東縣,林邊鄉,光林村,549,891,381,148,529,32,561
公投第１１案,屏東縣,林邊鄉,光林村,550,695,279,111,390,31,421
公投第１１案,屏東縣,林邊鄉,永樂村,551,1015,403,163,566,42,608
公投第１１案,屏東縣,林邊鄉,永樂村,552,1171,445,188,633,43,676
公投第１１案,屏東縣,林邊鄉,永樂村,553,1003,341,162,503,40,543
公投第１１案,屏東縣,林邊鄉,中林村,554,725,303,125,428,34,462
公投第１１案,屏東縣,林邊鄉,仁和村,555,841,337,124,461,40,501
公投第１１案,屏東縣,林邊鄉,仁和村,556,793,295,142,437,36,473
公投第１１案,屏東縣,林邊鄉,田厝村,557,919,365,136,501,46,547
公投第１１案,屏東縣,林邊鄉,崎峯村,558,1283,408,203,611,55,666
公投第１１案,屏東縣,林邊鄉,水利村,559,783,240,119,359,35,394
公投第１１案,屏東縣,林邊鄉,水利村,560,1033,332,142,474,35,509
公投第１１案,屏東縣,林邊鄉,竹林村,561,1186,402,159,561,81,642
公投第１１案,屏東縣,林邊鄉,竹林村,562,773,246,126,372,50,422
公投第１１案,屏東縣,林邊鄉,鎮安村,563,1122,372,139,511,29,540
公投第１１案,屏東縣,南州鄉,溪洲村,564,872,296,125,421,52,473
公投第１１案,屏東縣,南州鄉,溪洲村,565,794,280,133,413,25,438
公投第１１案,屏東縣,南州鄉,溪南村,566,962,354,160,514,47,561
公投第１１案,屏東縣,南州鄉,七塊村,567,1033,346,174,520,57,577
公投第１１案,屏東縣,南州鄉,萬華村,568,1007,314,165,479,42,521
公投第１１案,屏東縣,南州鄉,仁里村,569,466,184,77,261,17,278
公投第１１案,屏東縣,南州鄉,溪北村,570,708,275,113,388,27,415
公投第１１案,屏東縣,南州鄉,米崙村,571,1044,352,188,540,51,591
公投第１１案,屏東縣,南州鄉,壽元村,572,1071,290,147,437,39,476
公投第１１案,屏東縣,南州鄉,同安村,573,979,298,178,476,29,505
公投第１１案,屏東縣,南州鄉,南安村,574,543,172,71,243,31,274
公投第１１案,屏東縣,佳冬鄉,佳冬村,575,1472,425,222,647,40,687
公投第１１案,屏東縣,佳冬鄉,六根村,576,1360,398,164,562,50,612
公投第１１案,屏東縣,佳冬鄉,賴家村,577,804,303,107,410,59,469
公投第１１案,屏東縣,佳冬鄉,萬建村,578,925,270,159,429,57,486
公投第１１案,屏東縣,佳冬鄉,萬建村,579,855,230,141,371,18,389
公投第１１案,屏東縣,佳冬鄉,石光村,580,981,289,149,438,49,487
公投第１１案,屏東縣,佳冬鄉,石光村,581,1007,289,165,454,47,501
公投第１１案,屏東縣,佳冬鄉,玉光村,582,872,240,128,368,45,413
公投第１１案,屏東縣,佳冬鄉,玉光村,583,1255,333,193,526,47,573
公投第１１案,屏東縣,佳冬鄉,昌隆村,584,995,377,134,511,55,566
公投第１１案,屏東縣,佳冬鄉,豐隆村,585,734,191,107,298,28,326
公投第１１案,屏東縣,佳冬鄉,大同村,586,1178,300,209,509,27,536
公投第１１案,屏東縣,佳冬鄉,羌園村,587,1095,309,167,476,53,529
公投第１１案,屏東縣,佳冬鄉,燄溫村,588,1097,438,156,594,61,655
公投第１１案,屏東縣,佳冬鄉,塭豐村,589,1273,471,153,624,45,669
公投第１１案,屏東縣,佳冬鄉,塭豐村,590,1160,443,178,621,36,657
公投第１１案,屏東縣,琉球鄉,本福村,591,1111,294,144,438,31,469
公投第１１案,屏東縣,琉球鄉,本福村,592,972,292,119,411,29,440
公投第１１案,屏東縣,琉球鄉,中福村,593,1278,451,149,600,55,655
公投第１１案,屏東縣,琉球鄉,漁福村,594,976,333,121,454,41,495
公投第１１案,屏東縣,琉球鄉,大福村,595,1658,531,192,723,67,790
公投第１１案,屏東縣,琉球鄉,南福村,596,1146,319,106,425,24,449
公投第１１案,屏東縣,琉球鄉,天福村,597,1079,288,98,386,35,421
公投第１１案,屏東縣,琉球鄉,上福村,598,1613,423,149,572,20,592
公投第１１案,屏東縣,琉球鄉,杉福村,599,873,291,114,405,39,444
公投第１１案,屏東縣,車城鄉,海口村,600,737,163,116,279,31,310
公投第１１案,屏東縣,車城鄉,田中村,601,647,133,83,216,25,241
公投第１１案,屏東縣,車城鄉,福興村,602,491,136,72,208,22,230
公投第１１案,屏東縣,車城鄉,福興村,603,856,240,147,387,23,410
公投第１１案,屏東縣,車城鄉,福安村,604,554,174,79,253,8,261
公投第１１案,屏東縣,車城鄉,統埔村,605,388,98,40,138,6,144
公投第１１案,屏東縣,車城鄉,溫泉村,606,922,215,118,333,40,373
公投第１１案,屏東縣,車城鄉,保力村,607,597,121,75,196,10,206
公投第１１案,屏東縣,車城鄉,保力村,608,623,134,73,207,14,221
公投第１１案,屏東縣,車城鄉,新街村,609,425,111,76,187,14,201
公投第１１案,屏東縣,車城鄉,埔墘村,610,428,147,55,202,14,216
公投第１１案,屏東縣,車城鄉,射寮村,611,504,110,60,170,11,181
公投第１１案,屏東縣,車城鄉,後灣村,612,423,119,69,188,21,209
公投第１１案,屏東縣,滿州鄉,滿州村,613,1575,434,257,691,40,731
公投第１１案,屏東縣,滿州鄉,里德村,614,420,127,63,190,10,200
公投第１１案,屏東縣,滿州鄉,响林村,615,602,242,83,325,25,350
公投第１１案,屏東縣,滿州鄉,永靖村,616,1302,349,139,488,23,511
公投第１１案,屏東縣,滿州鄉,港口村,617,1314,353,187,540,7,547
公投第１１案,屏東縣,滿州鄉,長樂村,618,1308,235,142,377,17,394
公投第１１案,屏東縣,滿州鄉,九棚村,619,367,88,51,139,12,151
公投第１１案,屏東縣,滿州鄉,港仔村,620,318,95,57,152,14,166
公投第１１案,屏東縣,枋山鄉,枋山村,621,604,243,86,329,35,364
公投第１１案,屏東縣,枋山鄉,枋山村,622,428,193,58,251,14,265
公投第１１案,屏東縣,枋山鄉,加祿村,623,928,373,164,537,54,591
公投第１１案,屏東縣,枋山鄉,加祿村,624,972,321,164,485,16,501
公投第１１案,屏東縣,枋山鄉,楓港村,625,1041,292,144,436,41,477
公投第１１案,屏東縣,枋山鄉,善餘村,626,883,196,124,320,16,336
公投第１１案,屏東縣,三地門鄉,大社村,627,616,231,73,304,10,314
公投第１１案,屏東縣,三地門鄉,德文村,628,572,223,83,306,52,358
公投第１１案,屏東縣,三地門鄉,達來村,629,323,160,39,199,2,201
公投第１１案,屏東縣,三地門鄉,三地村,630,1448,583,293,876,33,909
公投第１１案,屏東縣,三地門鄉,賽嘉村,631,726,281,106,387,9,396
公投第１１案,屏東縣,三地門鄉,口社村,632,554,198,100,298,8,306
公投第１１案,屏東縣,三地門鄉,馬兒村,633,346,154,75,229,6,235
公投第１１案,屏東縣,三地門鄉,安坡村,634,458,277,58,335,5,340
公投第１１案,屏東縣,三地門鄉,青山村,635,692,323,135,458,16,474
公投第１１案,屏東縣,三地門鄉,青葉村,636,638,270,124,394,58,452
公投第１１案,屏東縣,霧臺鄉,霧台村,637,346,188,73,261,10,271
公投第１１案,屏東縣,霧臺鄉,霧台村,638,677,371,127,498,19,517
公投第１１案,屏東縣,霧臺鄉,霧台村,639,162,72,22,94,2,96
公投第１１案,屏東縣,霧臺鄉,吉露村,640,189,88,25,113,4,117
公投第１１案,屏東縣,霧臺鄉,阿禮村,641,296,181,44,225,9,234
公投第１１案,屏東縣,霧臺鄉,好茶村,642,483,293,100,393,14,407
公投第１１案,屏東縣,霧臺鄉,佳暮村,643,347,159,75,234,5,239
公投第１１案,屏東縣,霧臺鄉,大武村,644,450,276,82,358,12,370
公投第１１案,屏東縣,瑪家鄉,瑪家村,645,455,167,88,255,3,258
公投第１１案,屏東縣,瑪家鄉,北葉村,646,821,379,148,527,20,547
公投第１１案,屏東縣,瑪家鄉,三和村,647,635,320,127,447,20,467
公投第１１案,屏東縣,瑪家鄉,三和村,648,695,400,103,503,23,526
公投第１１案,屏東縣,瑪家鄉,三和村,649,671,302,92,394,12,406
公投第１１案,屏東縣,瑪家鄉,凉山村,650,1057,473,154,627,22,649
公投第１１案,屏東縣,瑪家鄉,佳義村,651,900,383,140,523,23,546
公投第１１案,屏東縣,瑪家鄉,排灣村,652,429,201,72,273,6,279
公投第１１案,屏東縣,泰武鄉,佳平村,653,669,255,144,399,17,416
公投第１１案,屏東縣,泰武鄉,佳平村,654,190,85,35,120,4,124
公投第１１案,屏東縣,泰武鄉,武潭村,655,922,389,172,561,46,607
公投第１１案,屏東縣,泰武鄉,平和村,656,598,318,126,444,18,462
公投第１１案,屏東縣,泰武鄉,萬安村,657,771,376,98,474,29,503
公投第１１案,屏東縣,泰武鄉,佳興村,658,414,222,66,288,15,303
公投第１１案,屏東縣,泰武鄉,泰武村,659,780,322,141,463,19,482
公投第１１案,屏東縣,來義鄉,來義村,660,917,455,116,571,53,624
公投第１１案,屏東縣,來義鄉,義林村,661,361,157,71,228,7,235
公投第１１案,屏東縣,來義鄉,義林村,662,216,106,28,134,2,136
公投第１１案,屏東縣,來義鄉,丹林村,663,445,258,66,324,13,337
公投第１１案,屏東縣,來義鄉,丹林村,664,280,135,39,174,9,183
公投第１１案,屏東縣,來義鄉,古樓村,665,1097,450,147,597,51,648
公投第１１案,屏東縣,來義鄉,文樂村,666,840,396,129,525,40,565
公投第１１案,屏東縣,來義鄉,望嘉村,667,889,290,152,442,14,456
公投第１１案,屏東縣,來義鄉,南和村,668,1212,405,180,585,36,621
公投第１１案,屏東縣,春日鄉,春日村,669,909,271,126,397,7,404
公投第１１案,屏東縣,春日鄉,古華村,670,663,251,105,356,10,366
公投第１１案,屏東縣,春日鄉,士文村,671,304,92,30,122,0,122
公投第１１案,屏東縣,春日鄉,七佳村,672,928,292,152,444,18,462
公投第１１案,屏東縣,春日鄉,歸崇村,673,641,140,79,219,11,230
公投第１１案,屏東縣,春日鄉,力里村,674,478,95,60,155,4,159
公投第１１案,屏東縣,獅子鄉,楓林村,675,751,338,72,410,12,422
公投第１１案,屏東縣,獅子鄉,丹路村,676,776,307,119,426,31,457
公投第１１案,屏東縣,獅子鄉,草埔村,677,711,399,90,489,15,504
公投第１１案,屏東縣,獅子鄉,內文村,678,243,114,58,172,16,188
公投第１１案,屏東縣,獅子鄉,竹坑村,679,325,167,57,224,6,230
公投第１１案,屏東縣,獅子鄉,獅子村,680,476,178,84,262,1,263
公投第１１案,屏東縣,獅子鄉,內獅村,681,602,324,76,400,15,415
公投第１１案,屏東縣,獅子鄉,南世村,682,346,111,59,170,7,177
公投第１１案,屏東縣,牡丹鄉,石門村,683,342,94,47,141,2,143
公投第１１案,屏東縣,牡丹鄉,石門村,684,1306,419,197,616,47,663
公投第１１案,屏東縣,牡丹鄉,牡丹村,685,693,136,60,196,4,200
公投第１１案,屏東縣,牡丹鄉,東源村,686,437,141,53,194,11,205
公投第１１案,屏東縣,牡丹鄉,旭海村,687,392,143,51,194,2,196
公投第１１案,屏東縣,牡丹鄉,高士村,688,593,182,115,297,11,308
公投第１１案,屏東縣,牡丹鄉,四林村,689,551,96,35,131,5,136
公投第１１案,臺東縣,臺東市,文化里,1,874,305,113,418,16,434
公投第１１案,臺東縣,臺東市,民族里,2,1469,619,252,871,36,907
公投第１１案,臺東縣,臺東市,自強里,3,1259,493,197,690,14,704
公投第１１案,臺東縣,臺東市,自強里,4,1399,519,237,756,25,781
公投第１１案,臺東縣,臺東市,自強里,5,1363,565,245,810,32,842
公投第１１案,臺東縣,臺東市,民生里,6,1651,636,244,880,28,908
公投第１１案,臺東縣,臺東市,民生里,7,1490,649,242,891,36,927
公投第１１案,臺東縣,臺東市,寶桑里,8,859,300,126,426,36,462
公投第１１案,臺東縣,臺東市,民權里,9,890,354,166,520,22,542
公投第１１案,臺東縣,臺東市,四維里,10,651,257,104,361,16,377
公投第１１案,臺東縣,臺東市,中華里,11,1650,549,240,789,41,830
公投第１１案,臺東縣,臺東市,仁愛里,12,724,294,140,434,22,456
公投第１１案,臺東縣,臺東市,強國里,13,632,249,115,364,18,382
公投第１１案,臺東縣,臺東市,大同里,14,771,313,122,435,28,463
公投第１１案,臺東縣,臺東市,成功里,15,798,291,119,410,17,427
公投第１１案,臺東縣,臺東市,建國里,16,1299,484,175,659,58,717
公投第１１案,臺東縣,臺東市,中正里,17,811,316,143,459,25,484
公投第１１案,臺東縣,臺東市,中山里,18,764,332,142,474,19,493
公投第１１案,臺東縣,臺東市,興國里,19,784,263,144,407,15,422
公投第１１案,臺東縣,臺東市,鐵花里,20,427,157,61,218,7,225
公投第１１案,臺東縣,臺東市,東海里,21,1292,544,93,637,20,657
公投第１１案,臺東縣,臺東市,東海里,22,1501,610,255,865,12,877
公投第１１案,臺東縣,臺東市,復國里,23,601,206,94,300,12,312
公投第１１案,臺東縣,臺東市,復興里,24,417,138,79,217,6,223
公投第１１案,臺東縣,臺東市,新興里,25,1001,396,139,535,29,564
公投第１１案,臺東縣,臺東市,新生里,26,1638,645,279,924,30,954
公投第１１案,臺東縣,臺東市,新生里,27,1576,616,221,837,38,875
公投第１１案,臺東縣,臺東市,新生里,28,1595,588,275,863,38,901
公投第１１案,臺東縣,臺東市,新生里,29,1734,669,272,941,27,968
公投第１１案,臺東縣,臺東市,中心里,30,1476,573,237,810,42,852
公投第１１案,臺東縣,臺東市,中心里,31,1545,625,285,910,25,935
公投第１１案,臺東縣,臺東市,馬蘭里,32,1313,579,183,762,35,797
公投第１１案,臺東縣,臺東市,馬蘭里,33,1338,604,190,794,27,821
公投第１１案,臺東縣,臺東市,光明里,34,1312,613,102,715,25,740
公投第１１案,臺東縣,臺東市,光明里,35,1265,504,105,609,23,632
公投第１１案,臺東縣,臺東市,豐年里,36,1407,451,205,656,25,681
公投第１１案,臺東縣,臺東市,豐年里,37,1552,548,183,731,30,761
公投第１１案,臺東縣,臺東市,豐樂里,38,1445,540,121,661,48,709
公投第１１案,臺東縣,臺東市,永樂里,39,2098,816,369,1185,31,1216
公投第１１案,臺東縣,臺東市,康樂里,40,1324,546,190,736,53,789
公投第１１案,臺東縣,臺東市,豐榮里,41,1598,649,208,857,29,886
公投第１１案,臺東縣,臺東市,豐榮里,42,1513,577,216,793,14,807
公投第１１案,臺東縣,臺東市,豐榮里,43,1679,594,229,823,25,848
公投第１１案,臺東縣,臺東市,豐榮里,44,1414,505,220,725,12,737
公投第１１案,臺東縣,臺東市,豐榮里,45,1798,670,247,917,24,941
公投第１１案,臺東縣,臺東市,豐谷里,46,1749,579,227,806,45,851
公投第１１案,臺東縣,臺東市,豐谷里,47,1709,652,243,895,43,938
公投第１１案,臺東縣,臺東市,豐谷里,48,1629,599,229,828,36,864
公投第１１案,臺東縣,臺東市,豐里里,49,1116,405,155,560,37,597
公投第１１案,臺東縣,臺東市,豐里里,50,1259,370,182,552,24,576
公投第１１案,臺東縣,臺東市,豐原里,51,1232,382,170,552,26,578
公投第１１案,臺東縣,臺東市,富岡里,52,1505,511,193,704,69,773
公投第１１案,臺東縣,臺東市,富豐里,53,836,272,104,376,28,404
公投第１１案,臺東縣,臺東市,南榮里,54,1294,490,206,696,40,736
公投第１１案,臺東縣,臺東市,南榮里,55,1350,488,197,685,38,723
公投第１１案,臺東縣,臺東市,岩灣里,56,2162,827,326,1153,45,1198
公投第１１案,臺東縣,臺東市,卑南里,57,1627,655,279,934,34,968
公投第１１案,臺東縣,臺東市,卑南里,58,1140,442,211,653,22,675
公投第１１案,臺東縣,臺東市,南王里,59,1359,495,212,707,29,736
公投第１１案,臺東縣,臺東市,南王里,60,1329,497,221,718,21,739
公投第１１案,臺東縣,臺東市,豐田里,61,990,367,125,492,24,516
公投第１１案,臺東縣,臺東市,豐田里,62,1038,379,169,548,43,591
公投第１１案,臺東縣,臺東市,新園里,63,1597,584,228,812,36,848
公投第１１案,臺東縣,臺東市,建和里,64,1385,453,247,700,44,744
公投第１１案,臺東縣,臺東市,建興里,65,939,274,152,426,21,447
公投第１１案,臺東縣,臺東市,建業里,66,1258,389,160,549,30,579
公投第１１案,臺東縣,臺東市,知本里,67,1350,433,222,655,10,665
公投第１１案,臺東縣,臺東市,建農里,68,1058,345,134,479,27,506
公投第１１案,臺東縣,臺東市,建農里,69,895,304,110,414,15,429
公投第１１案,臺東縣,成功鎮,信義里,70,516,157,68,225,24,249
公投第１１案,臺東縣,成功鎮,信義里,71,960,418,139,557,36,593
公投第１１案,臺東縣,成功鎮,信義里,72,365,134,27,161,9,170
公投第１１案,臺東縣,成功鎮,和平里,73,747,244,65,309,36,345
公投第１１案,臺東縣,成功鎮,忠仁里,74,339,123,23,146,14,160
公投第１１案,臺東縣,成功鎮,忠仁里,75,995,321,135,456,16,472
公投第１１案,臺東縣,成功鎮,忠仁里,76,863,303,135,438,43,481
公投第１１案,臺東縣,成功鎮,忠智里,77,931,342,123,465,42,507
公投第１１案,臺東縣,成功鎮,忠智里,78,970,347,122,469,22,491
公投第１１案,臺東縣,成功鎮,三民里,79,1365,479,156,635,61,696
公投第１１案,臺東縣,成功鎮,三民里,80,1366,500,160,660,60,720
公投第１１案,臺東縣,成功鎮,三仙里,81,516,184,59,243,21,264
公投第１１案,臺東縣,成功鎮,三仙里,82,887,295,91,386,33,419
公投第１１案,臺東縣,成功鎮,忠孝里,83,488,156,50,206,13,219
公投第１１案,臺東縣,成功鎮,忠孝里,84,481,131,52,183,13,196
公投第１１案,臺東縣,成功鎮,博愛里,85,373,116,41,157,4,161
公投第１１案,臺東縣,成功鎮,博愛里,86,264,84,34,118,28,146
公投第１１案,臺東縣,關山鎮,里壠里,87,909,369,146,515,22,537
公投第１１案,臺東縣,關山鎮,里壠里,88,790,216,101,317,21,338
公投第１１案,臺東縣,關山鎮,中福里,89,828,345,120,465,36,501
公投第１１案,臺東縣,關山鎮,新福里,90,887,269,110,379,18,397
公投第１１案,臺東縣,關山鎮,豐泉里,91,1137,436,161,597,24,621
公投第１１案,臺東縣,關山鎮,月眉里,92,732,225,104,329,23,352
公投第１１案,臺東縣,關山鎮,德高里,93,912,300,147,447,26,473
公投第１１案,臺東縣,關山鎮,德高里,94,779,212,94,306,14,320
公投第１１案,臺東縣,關山鎮,電光里,95,535,118,68,186,18,204
公投第１１案,臺東縣,卑南鄉,賓朗村,96,1041,399,162,561,46,607
公投第１１案,臺東縣,卑南鄉,賓朗村,97,1165,405,149,554,24,578
公投第１１案,臺東縣,卑南鄉,美農村,98,219,62,34,96,8,104
公投第１１案,臺東縣,卑南鄉,美農村,99,460,136,62,198,24,222
公投第１１案,臺東縣,卑南鄉,美農村,100,387,96,45,141,14,155
公投第１１案,臺東縣,卑南鄉,初鹿村,101,767,234,102,336,27,363
公投第１１案,臺東縣,卑南鄉,初鹿村,102,503,197,56,253,20,273
公投第１１案,臺東縣,卑南鄉,明峰村,103,727,218,108,326,26,352
公投第１１案,臺東縣,卑南鄉,明峰村,104,436,153,62,215,16,231
公投第１１案,臺東縣,卑南鄉,嘉豐村,105,261,53,34,87,9,96
公投第１１案,臺東縣,卑南鄉,嘉豐村,106,215,68,38,106,11,117
公投第１１案,臺東縣,卑南鄉,太平村,107,1442,551,202,753,52,805
公投第１１案,臺東縣,卑南鄉,太平村,108,527,202,52,254,10,264
公投第１１案,臺東縣,卑南鄉,太平村,109,1046,373,165,538,44,582
公投第１１案,臺東縣,卑南鄉,泰安村,110,1110,355,193,548,49,597
公投第１１案,臺東縣,卑南鄉,利嘉村,111,1105,404,181,585,48,633
公投第１１案,臺東縣,卑南鄉,東興村,112,1167,494,194,688,43,731
公投第１１案,臺東縣,卑南鄉,溫泉村,113,968,303,137,440,35,475
公投第１１案,臺東縣,卑南鄉,溫泉村,114,159,38,20,58,3,61
公投第１１案,臺東縣,卑南鄉,富山村,115,488,146,52,198,22,220
公投第１１案,臺東縣,卑南鄉,富源村,116,347,135,56,191,13,204
公投第１１案,臺東縣,卑南鄉,利吉村,117,436,172,49,221,16,237
公投第１１案,臺東縣,鹿野鄉,鹿野村,118,522,135,57,192,5,197
公投第１１案,臺東縣,鹿野鄉,鹿野村,119,574,201,88,289,20,309
公投第１１案,臺東縣,鹿野鄉,龍田村,120,1055,261,131,392,22,414
公投第１１案,臺東縣,鹿野鄉,永安村,121,1104,323,159,482,35,517
公投第１１案,臺東縣,鹿野鄉,永安村,122,342,107,38,145,10,155
公投第１１案,臺東縣,鹿野鄉,瑞隆村,123,895,272,109,381,42,423
公投第１１案,臺東縣,鹿野鄉,瑞源村,124,864,273,120,393,31,424
公投第１１案,臺東縣,鹿野鄉,瑞和村,125,675,177,86,263,29,292
公投第１１案,臺東縣,鹿野鄉,瑞豐村,126,435,129,74,203,13,216
公投第１１案,臺東縣,鹿野鄉,瑞豐村,127,470,97,70,167,19,186
公投第１１案,臺東縣,池上鄉,福原村,128,992,315,130,445,24,469
公投第１１案,臺東縣,池上鄉,福原村,129,929,338,141,479,36,515
公投第１１案,臺東縣,池上鄉,福文村,130,434,119,68,187,24,211
公投第１１案,臺東縣,池上鄉,福文村,131,703,159,108,267,40,307
公投第１１案,臺東縣,池上鄉,慶豐村,132,654,174,88,262,24,286
公投第１１案,臺東縣,池上鄉,大坡村,133,324,74,40,114,15,129
公投第１１案,臺東縣,池上鄉,大埔村,134,794,226,103,329,28,357
公投第１１案,臺東縣,池上鄉,新興村,135,856,262,109,371,43,414
公投第１１案,臺東縣,池上鄉,錦園村,136,344,94,34,128,14,142
公投第１１案,臺東縣,池上鄉,萬安村,137,311,110,40,150,22,172
公投第１１案,臺東縣,池上鄉,富興村,138,386,84,38,122,15,137
公投第１１案,臺東縣,池上鄉,振興村,139,435,86,41,127,24,151
公投第１１案,臺東縣,東河鄉,都蘭村,140,290,76,32,108,20,128
公投第１１案,臺東縣,東河鄉,都蘭村,141,620,248,80,328,25,353
公投第１１案,臺東縣,東河鄉,都蘭村,142,1196,482,203,685,61,746
公投第１１案,臺東縣,東河鄉,興昌村,143,918,309,97,406,47,453
公投第１１案,臺東縣,東河鄉,隆昌村,144,555,188,62,250,11,261
公投第１１案,臺東縣,東河鄉,東河村,145,977,294,106,400,24,424
公投第１１案,臺東縣,東河鄉,泰源村,146,1197,265,94,359,24,383
公投第１１案,臺東縣,東河鄉,北源村,147,867,134,53,187,26,213
公投第１１案,臺東縣,東河鄉,北源村,148,345,106,33,139,9,148
公投第１１案,臺東縣,東河鄉,北源村,149,408,106,50,156,14,170
公投第１１案,臺東縣,東河鄉,尚德村,150,262,73,33,106,8,114
公投第１１案,臺東縣,長濱鄉,寧埔村,151,536,195,86,281,28,309
公投第１１案,臺東縣,長濱鄉,寧埔村,152,689,158,58,216,13,229
公投第１１案,臺東縣,長濱鄉,竹湖村,153,913,339,110,449,62,511
公投第１１案,臺東縣,長濱鄉,長濱村,154,1268,347,116,463,22,485
公投第１１案,臺東縣,長濱鄉,長濱村,155,725,252,90,342,28,370
公投第１１案,臺東縣,長濱鄉,忠勇村,156,532,99,52,151,9,160
公投第１１案,臺東縣,長濱鄉,三間村,157,660,159,80,239,40,279
公投第１１案,臺東縣,長濱鄉,三間村,158,336,81,26,107,6,113
公投第１１案,臺東縣,長濱鄉,三間村,159,195,44,12,56,8,64
公投第１１案,臺東縣,長濱鄉,樟原村,160,25,7,2,9,4,13
公投第１１案,臺東縣,長濱鄉,樟原村,161,605,191,59,250,23,273
公投第１１案,臺東縣,太麻里鄉,美和村,162,722,255,101,356,30,386
公投第１１案,臺東縣,太麻里鄉,美和村,163,575,209,67,276,21,297
公投第１１案,臺東縣,太麻里鄉,三和村,164,623,213,78,291,24,315
公投第１１案,臺東縣,太麻里鄉,華源村,165,622,209,70,279,24,303
公投第１１案,臺東縣,太麻里鄉,北里村,166,560,204,65,269,15,284
公投第１１案,臺東縣,太麻里鄉,大王村,167,957,431,120,551,27,578
公投第１１案,臺東縣,太麻里鄉,大王村,168,809,274,103,377,34,411
公投第１１案,臺東縣,太麻里鄉,泰和村,169,673,272,123,395,22,417
公投第１１案,臺東縣,太麻里鄉,泰和村,170,737,269,87,356,24,380
公投第１１案,臺東縣,太麻里鄉,香蘭村,171,424,169,54,223,19,242
公投第１１案,臺東縣,太麻里鄉,香蘭村,172,374,121,49,170,9,179
公投第１１案,臺東縣,太麻里鄉,金崙村,173,829,417,115,532,19,551
公投第１１案,臺東縣,太麻里鄉,金崙村,174,869,408,108,516,12,528
公投第１１案,臺東縣,太麻里鄉,多良村,175,223,98,20,118,4,122
公投第１１案,臺東縣,太麻里鄉,多良村,176,669,243,92,335,30,365
公投第１１案,臺東縣,大武鄉,南興村,177,568,278,62,340,11,351
公投第１１案,臺東縣,大武鄉,尚武村,178,1474,467,201,668,68,736
公投第１１案,臺東縣,大武鄉,大武村,179,1327,483,181,664,43,707
公投第１１案,臺東縣,大武鄉,大鳥村,180,1134,339,160,499,43,542
公投第１１案,臺東縣,大武鄉,大竹村,181,386,166,47,213,9,222
公投第１１案,臺東縣,大武鄉,大竹村,182,377,141,61,202,18,220
公投第１１案,臺東縣,綠島鄉,南寮村,183,1474,423,190,613,18,631
公投第１１案,臺東縣,綠島鄉,中寮村,184,1082,308,145,453,19,472
公投第１１案,臺東縣,綠島鄉,公舘村,185,813,247,120,367,14,381
公投第１１案,臺東縣,綠島鄉,公舘村,186,210,70,34,104,1,105
公投第１１案,臺東縣,海端鄉,加拿村,187,497,176,72,248,15,263
公投第１１案,臺東縣,海端鄉,崁頂村,188,569,240,74,314,16,330
公投第１１案,臺東縣,海端鄉,海端村,189,971,337,137,474,14,488
公投第１１案,臺東縣,海端鄉,廣原村,190,728,275,100,375,19,394
公投第１１案,臺東縣,海端鄉,霧鹿村,191,259,88,55,143,7,150
公投第１１案,臺東縣,海端鄉,利稻村,192,254,99,44,143,5,148
公投第１１案,臺東縣,延平鄉,桃源村,193,1014,376,162,538,21,559
公投第１１案,臺東縣,延平鄉,紅葉村,194,426,195,87,282,17,299
公投第１１案,臺東縣,延平鄉,永康村,195,315,158,41,199,6,205
公投第１１案,臺東縣,延平鄉,武陵村,196,579,264,92,356,7,363
公投第１１案,臺東縣,延平鄉,鸞山村,197,596,183,80,263,12,275
公投第１１案,臺東縣,金峰鄉,嘉蘭村,198,1241,540,161,701,23,724
公投第１１案,臺東縣,金峰鄉,正興村,199,601,305,117,422,14,436
公投第１１案,臺東縣,金峰鄉,新興村,200,520,252,115,367,26,393
公投第１１案,臺東縣,金峰鄉,賓茂村,201,336,132,47,179,8,187
公投第１１案,臺東縣,金峰鄉,歷坵村,202,330,196,52,248,17,265
公投第１１案,臺東縣,達仁鄉,安朔村,203,246,127,23,150,4,154
公投第１１案,臺東縣,達仁鄉,安朔村,204,340,183,34,217,8,225
公投第１１案,臺東縣,達仁鄉,南田村,205,296,134,52,186,9,195
公投第１１案,臺東縣,達仁鄉,森永村,206,429,209,70,279,16,295
公投第１１案,臺東縣,達仁鄉,新化村,207,331,179,43,222,11,233
公投第１１案,臺東縣,達仁鄉,台坂村,208,628,202,90,292,10,302
公投第１１案,臺東縣,達仁鄉,土坂村,209,867,292,159,451,25,476
公投第１１案,臺東縣,蘭嶼鄉,椰油村,210,943,240,135,375,20,395
公投第１１案,臺東縣,蘭嶼鄉,紅頭村,211,1238,306,194,500,24,524
公投第１１案,臺東縣,蘭嶼鄉,東清村,212,1240,307,153,460,13,473
公投第１１案,臺東縣,蘭嶼鄉,朗島村,213,760,146,118,264,15,279
公投第１１案,花蓮縣,花蓮市,民德里,1,1522,598,257,855,11,866
公投第１１案,花蓮縣,花蓮市,民勤里,2,1114,448,188,636,16,652
公投第１１案,花蓮縣,花蓮市,民勤里,3,670,265,94,359,18,377
公投第１１案,花蓮縣,花蓮市,民勤里,4,1397,495,230,725,13,738
公投第１１案,花蓮縣,花蓮市,民意里,5,470,152,76,228,11,239
公投第１１案,花蓮縣,花蓮市,民意里,6,838,299,105,404,32,436
公投第１１案,花蓮縣,花蓮市,民意里,7,721,244,62,306,14,320
公投第１１案,花蓮縣,花蓮市,民心里,8,918,355,143,498,35,533
公投第１１案,花蓮縣,花蓮市,民享里,9,1539,522,263,785,27,812
公投第１１案,花蓮縣,花蓮市,民享里,10,1403,518,202,720,28,748
公投第１１案,花蓮縣,花蓮市,民孝里,11,1068,396,153,549,20,569
公投第１１案,花蓮縣,花蓮市,民孝里,12,1167,448,172,620,22,642
公投第１１案,花蓮縣,花蓮市,民孝里,13,1259,519,201,720,34,754
公投第１１案,花蓮縣,花蓮市,民運里,14,1071,399,148,547,43,590
公投第１１案,花蓮縣,花蓮市,民運里,15,925,358,151,509,20,529
公投第１１案,花蓮縣,花蓮市,民政里,16,1141,465,201,666,47,713
公投第１１案,花蓮縣,花蓮市,民政里,17,1163,431,169,600,16,616
公投第１１案,花蓮縣,花蓮市,民政里,18,1279,506,219,725,22,747
公投第１１案,花蓮縣,花蓮市,民立里,19,1512,521,209,730,22,752
公投第１１案,花蓮縣,花蓮市,民樂里,20,615,226,98,324,10,334
公投第１１案,花蓮縣,花蓮市,民有里,21,606,224,121,345,13,358
公投第１１案,花蓮縣,花蓮市,民主里,22,559,200,67,267,14,281
公投第１１案,花蓮縣,花蓮市,民族里,23,442,167,70,237,10,247
公投第１１案,花蓮縣,花蓮市,民生里,24,1114,392,164,556,23,579
公投第１１案,花蓮縣,花蓮市,民權里,25,416,163,68,231,10,241
公投第１１案,花蓮縣,花蓮市,主商里,26,577,229,104,333,21,354
公投第１１案,花蓮縣,花蓮市,主勤里,27,810,319,156,475,19,494
公投第１１案,花蓮縣,花蓮市,主工里,28,538,200,88,288,21,309
公投第１１案,花蓮縣,花蓮市,主信里,29,566,195,90,285,25,310
公投第１１案,花蓮縣,花蓮市,主義里,30,469,193,70,263,10,273
公投第１１案,花蓮縣,花蓮市,主睦里,31,565,224,87,311,15,326
公投第１１案,花蓮縣,花蓮市,主計里,32,816,288,100,388,15,403
公投第１１案,花蓮縣,花蓮市,主和里,33,911,312,133,445,33,478
公投第１１案,花蓮縣,花蓮市,主和里,34,1029,366,135,501,37,538
公投第１１案,花蓮縣,花蓮市,主和里,35,1043,423,167,590,26,616
公投第１１案,花蓮縣,花蓮市,主學里,36,856,315,157,472,23,495
公投第１１案,花蓮縣,花蓮市,主學里,37,979,346,165,511,25,536
公投第１１案,花蓮縣,花蓮市,主農里,38,1331,493,224,717,36,753
公投第１１案,花蓮縣,花蓮市,主農里,39,1228,466,213,679,15,694
公投第１１案,花蓮縣,花蓮市,主農里,40,955,371,155,526,22,548
公投第１１案,花蓮縣,花蓮市,主安里,41,1268,422,190,612,31,643
公投第１１案,花蓮縣,花蓮市,主安里,42,1230,420,185,605,39,644
公投第１１案,花蓮縣,花蓮市,主權里,43,1369,541,188,729,43,772
公投第１１案,花蓮縣,花蓮市,主權里,44,1435,450,200,650,25,675
公投第１１案,花蓮縣,花蓮市,主權里,45,1164,438,166,604,35,639
公投第１１案,花蓮縣,花蓮市,主權里,46,1249,498,206,704,38,742
公投第１１案,花蓮縣,花蓮市,主力里,47,1184,427,189,616,42,658
公投第１１案,花蓮縣,花蓮市,主力里,48,1490,530,234,764,18,782
公投第１１案,花蓮縣,花蓮市,國風里,49,1022,427,186,613,31,644
公投第１１案,花蓮縣,花蓮市,國風里,50,1135,443,161,604,33,637
公投第１１案,花蓮縣,花蓮市,國風里,51,1084,429,153,582,28,610
公投第１１案,花蓮縣,花蓮市,國威里,52,1339,316,160,476,23,499
公投第１１案,花蓮縣,花蓮市,國威里,53,501,204,81,285,16,301
公投第１１案,花蓮縣,花蓮市,國治里,54,904,356,134,490,16,506
公投第１１案,花蓮縣,花蓮市,國安里,55,490,203,89,292,12,304
公投第１１案,花蓮縣,花蓮市,國光里,56,1192,388,165,553,28,581
公投第１１案,花蓮縣,花蓮市,國防里,57,869,284,132,416,19,435
公投第１１案,花蓮縣,花蓮市,國華里,58,1267,445,210,655,22,677
公投第１１案,花蓮縣,花蓮市,國華里,59,959,383,150,533,22,555
公投第１１案,花蓮縣,花蓮市,國魂里,60,993,385,136,521,24,545
公投第１１案,花蓮縣,花蓮市,國魂里,61,982,351,167,518,34,552
公投第１１案,花蓮縣,花蓮市,國聯里,62,1311,431,201,632,11,643
公投第１１案,花蓮縣,花蓮市,國聯里,63,1455,483,229,712,38,750
公投第１１案,花蓮縣,花蓮市,國盛里,64,1151,386,130,516,22,538
公投第１１案,花蓮縣,花蓮市,國盛里,65,1237,408,183,591,20,611
公投第１１案,花蓮縣,花蓮市,國盛里,66,1339,427,190,617,28,645
公投第１１案,花蓮縣,花蓮市,國強里,67,715,282,113,395,21,416
公投第１１案,花蓮縣,花蓮市,國強里,68,1000,364,175,539,20,559
公投第１１案,花蓮縣,花蓮市,國富里,69,1410,474,188,662,35,697
公投第１１案,花蓮縣,花蓮市,國富里,70,1303,470,207,677,20,697
公投第１１案,花蓮縣,花蓮市,國富里,71,1256,455,197,652,21,673
公投第１１案,花蓮縣,花蓮市,國富里,72,1105,437,159,596,40,636
公投第１１案,花蓮縣,花蓮市,國裕里,73,1089,364,173,537,21,558
公投第１１案,花蓮縣,花蓮市,國裕里,74,1043,355,151,506,26,532
公投第１１案,花蓮縣,花蓮市,國裕里,75,1080,440,157,597,22,619
公投第１１案,花蓮縣,花蓮市,國裕里,76,971,377,147,524,20,544
公投第１１案,花蓮縣,花蓮市,國慶里,77,1068,382,205,587,26,613
公投第１１案,花蓮縣,花蓮市,國興里,78,1379,504,165,669,24,693
公投第１１案,花蓮縣,花蓮市,國興里,79,1362,463,215,678,36,714
公投第１１案,花蓮縣,花蓮市,國興里,80,1323,489,241,730,29,759
公投第１１案,花蓮縣,花蓮市,國福里,81,1482,442,206,648,34,682
公投第１１案,花蓮縣,新城鄉,新城村,82,367,131,69,200,17,217
公投第１１案,花蓮縣,新城鄉,新城村,83,929,328,131,459,12,471
公投第１１案,花蓮縣,新城鄉,順安村,84,590,204,105,309,48,357
公投第１１案,花蓮縣,新城鄉,順安村,85,307,107,53,160,13,173
公投第１１案,花蓮縣,新城鄉,康樂村,86,260,109,38,147,14,161
公投第１１案,花蓮縣,新城鄉,康樂村,87,1283,468,221,689,30,719
公投第１１案,花蓮縣,新城鄉,康樂村,88,885,322,123,445,17,462
公投第１１案,花蓮縣,新城鄉,大漢村,89,770,284,138,422,28,450
公投第１１案,花蓮縣,新城鄉,大漢村,90,1363,538,171,709,31,740
公投第１１案,花蓮縣,新城鄉,大漢村,91,366,117,64,181,14,195
公投第１１案,花蓮縣,新城鄉,北埔村,92,1163,398,160,558,32,590
公投第１１案,花蓮縣,新城鄉,北埔村,93,1605,593,230,823,29,852
公投第１１案,花蓮縣,新城鄉,北埔村,94,1194,459,168,627,33,660
公投第１１案,花蓮縣,新城鄉,佳林村,95,979,380,150,530,26,556
公投第１１案,花蓮縣,新城鄉,嘉里村,96,1485,561,235,796,30,826
公投第１１案,花蓮縣,新城鄉,嘉里村,97,1070,377,156,533,25,558
公投第１１案,花蓮縣,新城鄉,嘉里村,98,1164,513,96,609,26,635
公投第１１案,花蓮縣,新城鄉,嘉新村,99,880,293,145,438,32,470
公投第１１案,花蓮縣,新城鄉,嘉新村,100,369,122,57,179,7,186
公投第１１案,花蓮縣,秀林鄉,和平村,101,867,310,124,434,17,451
公投第１１案,花蓮縣,秀林鄉,和平村,102,575,175,110,285,20,305
公投第１１案,花蓮縣,秀林鄉,崇德村,103,1373,376,163,539,27,566
公投第１１案,花蓮縣,秀林鄉,富世村,104,1644,556,191,747,45,792
公投第１１案,花蓮縣,秀林鄉,富世村,105,162,63,23,86,4,90
公投第１１案,花蓮縣,秀林鄉,秀林村,106,384,119,62,181,20,201
公投第１１案,花蓮縣,秀林鄉,秀林村,107,1382,422,209,631,38,669
公投第１１案,花蓮縣,秀林鄉,景美村,108,1125,393,180,573,31,604
公投第１１案,花蓮縣,秀林鄉,景美村,109,627,206,96,302,14,316
公投第１１案,花蓮縣,秀林鄉,佳民村,110,987,410,155,565,36,601
公投第１１案,花蓮縣,秀林鄉,水源村,111,1139,463,189,652,51,703
公投第１１案,花蓮縣,秀林鄉,銅門村,112,1213,472,194,666,8,674
公投第１１案,花蓮縣,秀林鄉,文蘭村,113,754,276,131,407,19,426
公投第１１案,花蓮縣,秀林鄉,文蘭村,114,330,111,42,153,10,163
公投第１１案,花蓮縣,吉安鄉,永安村,115,1059,370,169,539,20,559
公投第１１案,花蓮縣,吉安鄉,永安村,116,983,365,156,521,26,547
公投第１１案,花蓮縣,吉安鄉,永安村,117,1031,388,155,543,23,566
公投第１１案,花蓮縣,吉安鄉,永安村,118,1105,382,151,533,38,571
公投第１１案,花蓮縣,吉安鄉,太昌村,119,1107,392,164,556,26,582
公投第１１案,花蓮縣,吉安鄉,太昌村,120,1179,386,163,549,42,591
公投第１１案,花蓮縣,吉安鄉,太昌村,121,1453,416,209,625,40,665
公投第１１案,花蓮縣,吉安鄉,慶豐村,122,1432,545,247,792,47,839
公投第１１案,花蓮縣,吉安鄉,慶豐村,123,1320,474,212,686,42,728
公投第１１案,花蓮縣,吉安鄉,慶豐村,124,1356,491,188,679,23,702
公投第１１案,花蓮縣,吉安鄉,慶豐村,125,1295,476,177,653,24,677
公投第１１案,花蓮縣,吉安鄉,慶豐村,126,1467,507,237,744,54,798
公投第１１案,花蓮縣,吉安鄉,吉安村,127,1515,539,232,771,20,791
公投第１１案,花蓮縣,吉安鄉,吉安村,128,1063,413,182,595,34,629
公投第１１案,花蓮縣,吉安鄉,吉安村,129,1284,381,176,557,13,570
公投第１１案,花蓮縣,吉安鄉,吉安村,130,1380,528,219,747,27,774
公投第１１案,花蓮縣,吉安鄉,福興村,131,1297,476,219,695,42,737
公投第１１案,花蓮縣,吉安鄉,福興村,132,1662,422,364,786,71,857
公投第１１案,花蓮縣,吉安鄉,南華村,133,1563,500,201,701,57,758
公投第１１案,花蓮縣,吉安鄉,干城村,134,1288,421,151,572,49,621
公投第１１案,花蓮縣,吉安鄉,永興村,135,907,361,125,486,35,521
公投第１１案,花蓮縣,吉安鄉,永興村,136,917,321,131,452,22,474
公投第１１案,花蓮縣,吉安鄉,永興村,137,1021,356,149,505,21,526
公投第１１案,花蓮縣,吉安鄉,稻香村,138,1033,431,162,593,21,614
公投第１１案,花蓮縣,吉安鄉,稻香村,139,966,383,133,516,39,555
公投第１１案,花蓮縣,吉安鄉,稻香村,140,1188,422,157,579,48,627
公投第１１案,花蓮縣,吉安鄉,南昌村,141,1480,540,217,757,16,773
公投第１１案,花蓮縣,吉安鄉,南昌村,142,1393,465,168,633,41,674
公投第１１案,花蓮縣,吉安鄉,南昌村,143,1193,424,160,584,27,611
公投第１１案,花蓮縣,吉安鄉,宜昌村,144,1445,495,181,676,26,702
公投第１１案,花蓮縣,吉安鄉,宜昌村,145,1301,433,208,641,72,713
公投第１１案,花蓮縣,吉安鄉,宜昌村,146,1215,444,209,653,40,693
公投第１１案,花蓮縣,吉安鄉,北昌村,147,1135,405,176,581,30,611
公投第１１案,花蓮縣,吉安鄉,北昌村,148,1223,494,182,676,19,695
公投第１１案,花蓮縣,吉安鄉,北昌村,149,1274,495,175,670,29,699
公投第１１案,花蓮縣,吉安鄉,北昌村,150,1124,423,150,573,24,597
公投第１１案,花蓮縣,吉安鄉,北昌村,151,1158,435,194,629,21,650
公投第１１案,花蓮縣,吉安鄉,北昌村,152,1157,448,191,639,10,649
公投第１１案,花蓮縣,吉安鄉,勝安村,153,1258,477,186,663,30,693
公投第１１案,花蓮縣,吉安鄉,勝安村,154,1257,445,198,643,29,672
公投第１１案,花蓮縣,吉安鄉,勝安村,155,1245,447,173,620,28,648
公投第１１案,花蓮縣,吉安鄉,勝安村,156,1166,453,181,634,15,649
公投第１１案,花蓮縣,吉安鄉,仁里村,157,1358,508,178,686,28,714
公投第１１案,花蓮縣,吉安鄉,仁里村,158,1214,496,133,629,27,656
公投第１１案,花蓮縣,吉安鄉,仁里村,159,1151,426,168,594,25,619
公投第１１案,花蓮縣,吉安鄉,仁里村,160,1157,428,168,596,31,627
公投第１１案,花蓮縣,吉安鄉,仁里村,161,1161,446,180,626,28,654
公投第１１案,花蓮縣,吉安鄉,東昌村,162,1304,511,200,711,26,737
公投第１１案,花蓮縣,吉安鄉,東昌村,163,1367,488,196,684,40,724
公投第１１案,花蓮縣,吉安鄉,東昌村,164,1411,459,182,641,27,668
公投第１１案,花蓮縣,吉安鄉,東昌村,165,1409,484,170,654,27,681
公投第１１案,花蓮縣,吉安鄉,仁安村,166,1125,378,138,516,23,539
公投第１１案,花蓮縣,吉安鄉,仁安村,167,1213,453,170,623,49,672
公投第１１案,花蓮縣,吉安鄉,仁和村,168,1141,443,165,608,18,626
公投第１１案,花蓮縣,吉安鄉,仁和村,169,1156,400,126,526,24,550
公投第１１案,花蓮縣,吉安鄉,仁和村,170,1092,392,133,525,40,565
公投第１１案,花蓮縣,吉安鄉,仁和村,171,1026,308,127,435,33,468
公投第１１案,花蓮縣,吉安鄉,光華村,172,804,305,104,409,19,428
公投第１１案,花蓮縣,吉安鄉,光華村,173,1132,434,152,586,41,627
公投第１１案,花蓮縣,壽豐鄉,溪口村,174,1052,382,127,509,35,544
公投第１１案,花蓮縣,壽豐鄉,樹湖村,175,357,140,51,191,27,218
公投第１１案,花蓮縣,壽豐鄉,豐山村,176,1022,322,149,471,49,520
公投第１１案,花蓮縣,壽豐鄉,豐山村,177,875,377,141,518,30,548
公投第１１案,花蓮縣,壽豐鄉,豐裡村,178,691,276,120,396,30,426
公投第１１案,花蓮縣,壽豐鄉,豐裡村,179,708,246,97,343,22,365
公投第１１案,花蓮縣,壽豐鄉,豐坪村,180,894,294,140,434,41,475
公投第１１案,花蓮縣,壽豐鄉,壽豐村,181,746,270,114,384,28,412
公投第１１案,花蓮縣,壽豐鄉,壽豐村,182,881,293,132,425,23,448
公投第１１案,花蓮縣,壽豐鄉,共和村,183,695,290,119,409,22,431
公投第１１案,花蓮縣,壽豐鄉,光榮村,184,816,349,128,477,38,515
公投第１１案,花蓮縣,壽豐鄉,池南村,185,773,266,102,368,28,396
公投第１１案,花蓮縣,壽豐鄉,平和村,186,1029,390,164,554,35,589
公投第１１案,花蓮縣,壽豐鄉,平和村,187,407,176,60,236,21,257
公投第１１案,花蓮縣,壽豐鄉,志學村,188,1139,433,172,605,45,650
公投第１１案,花蓮縣,壽豐鄉,志學村,189,996,318,223,541,30,571
公投第１１案,花蓮縣,壽豐鄉,志學村,190,414,139,42,181,8,189
公投第１１案,花蓮縣,壽豐鄉,米棧村,191,270,98,44,142,14,156
公投第１１案,花蓮縣,壽豐鄉,月眉村,192,836,317,101,418,70,488
公投第１１案,花蓮縣,壽豐鄉,鹽寮村,193,507,189,94,283,27,310
公投第１１案,花蓮縣,壽豐鄉,水璉村,194,739,214,74,288,28,316
公投第１１案,花蓮縣,鳳林鎮,鳳仁里,195,1192,521,171,692,45,737
公投第１１案,花蓮縣,鳳林鎮,鳳義里,196,639,213,94,307,18,325
公投第１１案,花蓮縣,鳳林鎮,鳳禮里,197,601,267,103,370,32,402
公投第１１案,花蓮縣,鳳林鎮,鳳智里,198,1137,482,200,682,47,729
公投第１１案,花蓮縣,鳳林鎮,鳳信里,199,742,270,112,382,34,416
公投第１１案,花蓮縣,鳳林鎮,鳳信里,200,610,245,82,327,24,351
公投第１１案,花蓮縣,鳳林鎮,山興里,201,295,109,59,168,24,192
公投第１１案,花蓮縣,鳳林鎮,山興里,202,218,63,11,74,3,77
公投第１１案,花蓮縣,鳳林鎮,大榮里,203,720,225,90,315,20,335
公投第１１案,花蓮縣,鳳林鎮,大榮里,204,528,174,87,261,29,290
公投第１１案,花蓮縣,鳳林鎮,北林里,205,560,185,86,271,22,293
公投第１１案,花蓮縣,鳳林鎮,南平里,206,541,213,50,263,27,290
公投第１１案,花蓮縣,鳳林鎮,林榮里,207,818,311,106,417,47,464
公投第１１案,花蓮縣,鳳林鎮,長橋里,208,984,290,115,405,27,432
公投第１１案,花蓮縣,鳳林鎮,森榮里,209,91,27,15,42,8,50
公投第１１案,花蓮縣,光復鄉,大華村,210,1295,497,184,681,50,731
公投第１１案,花蓮縣,光復鄉,大安村,211,859,358,133,491,25,516
公投第１１案,花蓮縣,光復鄉,大平村,212,958,401,122,523,47,570
公投第１１案,花蓮縣,光復鄉,大馬村,213,1011,403,133,536,57,593
公投第１１案,花蓮縣,光復鄉,大同村,214,1041,423,143,566,40,606
公投第１１案,花蓮縣,光復鄉,東富村,215,821,295,112,407,49,456
公投第１１案,花蓮縣,光復鄉,東富村,216,188,35,11,46,2,48
公投第１１案,花蓮縣,光復鄉,西富村,217,514,196,63,259,24,283
公投第１１案,花蓮縣,光復鄉,西富村,218,446,145,42,187,10,197
公投第１１案,花蓮縣,光復鄉,南富村,219,851,336,113,449,31,480
公投第１１案,花蓮縣,光復鄉,北富村,220,932,270,125,395,23,418
公投第１１案,花蓮縣,光復鄉,大進村,221,471,189,65,254,14,268
公投第１１案,花蓮縣,光復鄉,大全村,222,640,205,101,306,49,355
公投第１１案,花蓮縣,光復鄉,大全村,223,116,32,12,44,4,48
公投第１１案,花蓮縣,光復鄉,大興村,224,496,124,45,169,10,179
公投第１１案,花蓮縣,光復鄉,大富村,225,324,97,35,132,14,146
公投第１１案,花蓮縣,光復鄉,大豐村,226,454,115,46,161,20,181
公投第１１案,花蓮縣,豐濱鄉,靜浦村,227,717,232,89,321,30,351
公投第１１案,花蓮縣,豐濱鄉,港口村,228,751,183,129,312,14,326
公投第１１案,花蓮縣,豐濱鄉,豐濱村,229,613,195,77,272,26,298
公投第１１案,花蓮縣,豐濱鄉,豐濱村,230,809,344,106,450,22,472
公投第１１案,花蓮縣,豐濱鄉,豐濱村,231,357,107,36,143,11,154
公投第１１案,花蓮縣,豐濱鄉,新社村,232,669,230,88,318,23,341
公投第１１案,花蓮縣,豐濱鄉,磯崎村,233,479,156,67,223,9,232
公投第１１案,花蓮縣,萬榮鄉,西林村,234,1072,398,164,562,41,603
公投第１１案,花蓮縣,萬榮鄉,見晴村,235,560,222,85,307,9,316
公投第１１案,花蓮縣,萬榮鄉,萬榮村,236,773,328,127,455,30,485
公投第１１案,花蓮縣,萬榮鄉,明利村,237,661,227,89,316,11,327
公投第１１案,花蓮縣,萬榮鄉,馬遠村,238,442,201,68,269,11,280
公投第１１案,花蓮縣,萬榮鄉,馬遠村,239,675,259,81,340,21,361
公投第１１案,花蓮縣,萬榮鄉,紅葉村,240,1086,481,210,691,55,746
公投第１１案,花蓮縣,瑞穗鄉,瑞穗村,241,813,347,95,442,31,473
公投第１１案,花蓮縣,瑞穗鄉,瑞穗村,242,1091,407,162,569,41,610
公投第１１案,花蓮縣,瑞穗鄉,瑞美村,243,839,319,131,450,30,480
公投第１１案,花蓮縣,瑞穗鄉,瑞美村,244,975,381,137,518,39,557
公投第１１案,花蓮縣,瑞穗鄉,瑞良村,245,546,182,68,250,11,261
公投第１１案,花蓮縣,瑞穗鄉,瑞祥村,246,1002,370,151,521,50,571
公投第１１案,花蓮縣,瑞穗鄉,瑞北村,247,593,171,72,243,33,276
公投第１１案,花蓮縣,瑞穗鄉,舞鶴村,248,965,358,144,502,53,555
公投第１１案,花蓮縣,瑞穗鄉,鶴岡村,249,863,332,100,432,46,478
公投第１１案,花蓮縣,瑞穗鄉,奇美村,250,340,80,27,107,6,113
公投第１１案,花蓮縣,瑞穗鄉,富源村,251,764,237,95,332,22,354
公投第１１案,花蓮縣,瑞穗鄉,富民村,252,868,182,74,256,8,264
公投第１１案,花蓮縣,瑞穗鄉,富興村,253,620,179,43,222,17,239
公投第１１案,花蓮縣,玉里鎮,中城里,254,1008,360,153,513,31,544
公投第１１案,花蓮縣,玉里鎮,中城里,255,939,405,125,530,31,561
公投第１１案,花蓮縣,玉里鎮,中城里,256,1256,468,148,616,42,658
公投第１１案,花蓮縣,玉里鎮,中城里,257,929,335,138,473,34,507
公投第１１案,花蓮縣,玉里鎮,中城里,258,979,358,148,506,31,537
公投第１１案,花蓮縣,玉里鎮,國武里,259,1244,503,200,703,26,729
公投第１１案,花蓮縣,玉里鎮,啟模里,260,847,286,111,397,21,418
公投第１１案,花蓮縣,玉里鎮,啟模里,261,772,237,109,346,36,382
公投第１１案,花蓮縣,玉里鎮,泰昌里,262,558,182,84,266,13,279
公投第１１案,花蓮縣,玉里鎮,泰昌里,263,800,185,54,239,22,261
公投第１１案,花蓮縣,玉里鎮,永昌里,264,1286,421,133,554,45,599
公投第１１案,花蓮縣,玉里鎮,源城里,265,1246,398,146,544,54,598
公投第１１案,花蓮縣,玉里鎮,長良里,266,647,206,95,301,46,347
公投第１１案,花蓮縣,玉里鎮,樂合里,267,990,279,87,366,25,391
公投第１１案,花蓮縣,玉里鎮,東豐里,268,530,188,57,245,22,267
公投第１１案,花蓮縣,玉里鎮,觀音里,269,979,296,99,395,41,436
公投第１１案,花蓮縣,玉里鎮,觀音里,270,557,239,50,289,31,320
公投第１１案,花蓮縣,玉里鎮,松浦里,271,434,160,30,190,21,211
公投第１１案,花蓮縣,玉里鎮,松浦里,272,1065,241,91,332,65,397
公投第１１案,花蓮縣,玉里鎮,春日里,273,866,305,110,415,53,468
公投第１１案,花蓮縣,玉里鎮,德武里,274,769,284,94,378,24,402
公投第１１案,花蓮縣,玉里鎮,三民里,275,869,220,119,339,32,371
公投第１１案,花蓮縣,玉里鎮,大禹里,276,1080,306,109,415,38,453
公投第１１案,花蓮縣,富里鄉,吳江村,277,467,119,61,180,19,199
公投第１１案,花蓮縣,富里鄉,東里村,278,1032,259,105,364,43,407
公投第１１案,花蓮縣,富里鄉,萬寧村,279,638,199,64,263,21,284
公投第１１案,花蓮縣,富里鄉,新興村,280,591,210,75,285,37,322
公投第１１案,花蓮縣,富里鄉,竹田村,281,1087,381,158,539,54,593
公投第１１案,花蓮縣,富里鄉,羅山村,282,431,134,70,204,20,224
公投第１１案,花蓮縣,富里鄉,石牌村,283,893,278,125,403,33,436
公投第１１案,花蓮縣,富里鄉,明里村,284,361,81,46,127,22,149
公投第１１案,花蓮縣,富里鄉,富里村,285,1362,338,171,509,39,548
公投第１１案,花蓮縣,富里鄉,永豐村,286,458,146,65,211,28,239
公投第１１案,花蓮縣,富里鄉,豐南村,287,621,123,49,172,37,209
公投第１１案,花蓮縣,富里鄉,富南村,288,493,151,66,217,26,243
公投第１１案,花蓮縣,富里鄉,學田村,289,631,181,89,270,31,301
公投第１１案,花蓮縣,卓溪鄉,崙山村,290,533,187,78,265,25,290
公投第１１案,花蓮縣,卓溪鄉,立山村,291,522,229,85,314,23,337
公投第１１案,花蓮縣,卓溪鄉,立山村,292,493,232,80,312,10,322
公投第１１案,花蓮縣,卓溪鄉,太平村,293,701,334,81,415,26,441
公投第１１案,花蓮縣,卓溪鄉,卓溪村,294,746,306,104,410,33,443
公投第１１案,花蓮縣,卓溪鄉,卓清村,295,616,257,99,356,33,389
公投第１１案,花蓮縣,卓溪鄉,卓清村,296,405,150,48,198,5,203
公投第１１案,花蓮縣,卓溪鄉,古風村,297,329,125,43,168,10,178
公投第１１案,花蓮縣,卓溪鄉,古風村,298,428,180,43,223,13,236
公投第１１案,花蓮縣,卓溪鄉,古風村,299,174,71,20,91,7,98
公投第１１案,澎湖縣,馬公市,復興里,1,481,151,64,215,10,225
公投第１１案,澎湖縣,馬公市,長安里,2,558,203,74,277,11,288
公投第１１案,澎湖縣,馬公市,中央里,3,533,181,57,238,26,264
公投第１１案,澎湖縣,馬公市,啟明里,4,922,317,144,461,21,482
公投第１１案,澎湖縣,馬公市,重慶里,5,1021,374,164,538,22,560
公投第１１案,澎湖縣,馬公市,中興里,6,793,253,129,382,22,404
公投第１１案,澎湖縣,馬公市,光復里,7,954,343,146,489,24,513
公投第１１案,澎湖縣,馬公市,光復里,8,1001,338,145,483,21,504
公投第１１案,澎湖縣,馬公市,光明里,9,1192,352,161,513,23,536
公投第１１案,澎湖縣,馬公市,光榮里,10,1402,468,152,620,40,660
公投第１１案,澎湖縣,馬公市,光榮里,11,1389,524,183,707,22,729
公投第１１案,澎湖縣,馬公市,光榮里,12,1339,475,197,672,26,698
公投第１１案,澎湖縣,馬公市,朝陽里,13,1254,402,156,558,29,587
公投第１１案,澎湖縣,馬公市,朝陽里,14,1194,423,146,569,32,601
公投第１１案,澎湖縣,馬公市,朝陽里,15,1393,448,184,632,41,673
公投第１１案,澎湖縣,馬公市,朝陽里,16,1440,519,216,735,17,752
公投第１１案,澎湖縣,馬公市,陽明里,17,1215,370,185,555,43,598
公投第１１案,澎湖縣,馬公市,陽明里,18,1284,459,137,596,37,633
公投第１１案,澎湖縣,馬公市,重光里,19,1512,533,179,712,34,746
公投第１１案,澎湖縣,馬公市,西衛里,20,1181,365,166,531,37,568
公投第１１案,澎湖縣,馬公市,西衛里,21,1348,465,186,651,27,678
公投第１１案,澎湖縣,馬公市,西衛里,22,1391,389,313,702,15,717
公投第１１案,澎湖縣,馬公市,西衛里,23,2124,293,642,935,8,943
公投第１１案,澎湖縣,馬公市,西文里,24,1500,531,186,717,26,743
公投第１１案,澎湖縣,馬公市,西文里,25,1582,577,179,756,24,780
公投第１１案,澎湖縣,馬公市,東文里,26,1638,561,216,777,22,799
公投第１１案,澎湖縣,馬公市,東文里,27,1554,551,233,784,33,817
公投第１１案,澎湖縣,馬公市,案山里,28,980,262,106,368,16,384
公投第１１案,澎湖縣,馬公市,案山里,29,892,307,124,431,20,451
公投第１１案,澎湖縣,馬公市,光華里,30,778,218,93,311,11,322
公投第１１案,澎湖縣,馬公市,前寮里,31,930,326,130,456,23,479
公投第１１案,澎湖縣,馬公市,石泉里,32,1481,617,223,840,23,863
公投第１１案,澎湖縣,馬公市,石泉里,33,1128,434,155,589,16,605
公投第１１案,澎湖縣,馬公市,菜園里,34,415,171,42,213,16,229
公投第１１案,澎湖縣,馬公市,東衛里,35,1120,399,137,536,23,559
公投第１１案,澎湖縣,馬公市,東衛里,36,950,375,122,497,19,516
公投第１１案,澎湖縣,馬公市,安宅里,37,627,190,74,264,17,281
公投第１１案,澎湖縣,馬公市,興仁里,38,1055,386,146,532,20,552
公投第１１案,澎湖縣,馬公市,烏崁里,39,989,373,111,484,36,520
公投第１１案,澎湖縣,馬公市,鐵線里,40,591,205,93,298,33,331
公投第１１案,澎湖縣,馬公市,鎖港里,41,1387,443,167,610,52,662
公投第１１案,澎湖縣,馬公市,鎖港里,42,1079,298,130,428,44,472
公投第１１案,澎湖縣,馬公市,山水里,43,797,288,86,374,32,406
公投第１１案,澎湖縣,馬公市,山水里,44,903,302,107,409,21,430
公投第１１案,澎湖縣,馬公市,五德里,45,376,101,59,160,15,175
公投第１１案,澎湖縣,馬公市,井垵里,46,371,112,69,181,14,195
公投第１１案,澎湖縣,馬公市,嵵裡里,47,1173,354,118,472,23,495
公投第１１案,澎湖縣,馬公市,風櫃里,48,1389,369,135,504,22,526
公投第１１案,澎湖縣,馬公市,虎井里,49,761,140,49,189,25,214
公投第１１案,澎湖縣,馬公市,桶盤里,50,288,116,47,163,15,178
公投第１１案,澎湖縣,湖西鄉,湖西村,51,1120,418,135,553,30,583
公投第１１案,澎湖縣,湖西鄉,湖東村,52,332,97,36,133,8,141
公投第１１案,澎湖縣,湖西鄉,青螺村,53,242,71,21,92,2,94
公投第１１案,澎湖縣,湖西鄉,白坑村,54,293,75,34,109,6,115
公投第１１案,澎湖縣,湖西鄉,南寮村,55,666,173,73,246,30,276
公投第１１案,澎湖縣,湖西鄉,北寮村,56,326,109,38,147,16,163
公投第１１案,澎湖縣,湖西鄉,紅羅村,57,732,203,79,282,16,298
公投第１１案,澎湖縣,湖西鄉,西溪村,58,651,216,73,289,11,300
公投第１１案,澎湖縣,湖西鄉,成功村,59,744,235,88,323,14,337
公投第１１案,澎湖縣,湖西鄉,東石村,60,134,55,16,71,2,73
公投第１１案,澎湖縣,湖西鄉,沙港村,61,794,190,91,281,17,298
公投第１１案,澎湖縣,湖西鄉,中西村,62,216,59,16,75,3,78
公投第１１案,澎湖縣,湖西鄉,鼎灣村,63,664,139,46,185,12,197
公投第１１案,澎湖縣,湖西鄉,潭邊村,64,279,96,26,122,12,134
公投第１１案,澎湖縣,湖西鄉,許家村,65,296,124,27,151,3,154
公投第１１案,澎湖縣,湖西鄉,城北村,66,257,82,38,120,1,121
公投第１１案,澎湖縣,湖西鄉,太武村,67,89,20,7,27,2,29
公投第１１案,澎湖縣,湖西鄉,隘門村,68,815,263,119,382,17,399
公投第１１案,澎湖縣,湖西鄉,林投村,69,975,270,113,383,15,398
公投第１１案,澎湖縣,湖西鄉,尖山村,70,648,213,85,298,24,322
公投第１１案,澎湖縣,湖西鄉,龍門村,71,893,263,108,371,19,390
公投第１１案,澎湖縣,湖西鄉,龍門村,72,846,280,107,387,51,438
公投第１１案,澎湖縣,湖西鄉,菓葉村,73,729,204,80,284,8,292
公投第１１案,澎湖縣,白沙鄉,中屯村,74,514,173,71,244,12,256
公投第１１案,澎湖縣,白沙鄉,講美村,75,657,227,104,331,9,340
公投第１１案,澎湖縣,白沙鄉,城前村,76,109,54,14,68,4,72
公投第１１案,澎湖縣,白沙鄉,鎮海村,77,156,44,22,66,3,69
公投第１１案,澎湖縣,白沙鄉,港子村,78,293,77,41,118,4,122
公投第１１案,澎湖縣,白沙鄉,岐頭村,79,231,46,22,68,4,72
公投第１１案,澎湖縣,白沙鄉,小赤村,80,161,57,25,82,6,88
公投第１１案,澎湖縣,白沙鄉,赤崁村,81,1705,536,221,757,33,790
公投第１１案,澎湖縣,白沙鄉,瓦硐村,82,285,90,29,119,8,127
公投第１１案,澎湖縣,白沙鄉,後寮村,83,723,152,65,217,13,230
公投第１１案,澎湖縣,白沙鄉,通梁村,84,774,185,76,261,25,286
公投第１１案,澎湖縣,白沙鄉,吉貝村,85,1429,352,118,470,50,520
公投第１１案,澎湖縣,白沙鄉,鳥嶼村,86,1084,377,90,467,41,508
公投第１１案,澎湖縣,白沙鄉,員貝村,87,251,86,33,119,7,126
公投第１１案,澎湖縣,白沙鄉,大倉村,88,253,50,30,80,11,91
公投第１１案,澎湖縣,西嶼鄉,橫礁村,89,283,30,20,50,1,51
公投第１１案,澎湖縣,西嶼鄉,合界村,90,424,71,40,111,10,121
公投第１１案,澎湖縣,西嶼鄉,竹灣村,91,826,180,76,256,36,292
公投第１１案,澎湖縣,西嶼鄉,小門村,92,282,67,33,100,9,109
公投第１１案,澎湖縣,西嶼鄉,大池村,93,661,148,88,236,28,264
公投第１１案,澎湖縣,西嶼鄉,二崁村,94,141,15,13,28,2,30
公投第１１案,澎湖縣,西嶼鄉,池東村,95,635,154,40,194,8,202
公投第１１案,澎湖縣,西嶼鄉,池西村,96,216,60,12,72,3,75
公投第１１案,澎湖縣,西嶼鄉,赤馬村,97,572,96,28,124,15,139
公投第１１案,澎湖縣,西嶼鄉,內垵村,98,1267,330,117,447,68,515
公投第１１案,澎湖縣,西嶼鄉,外垵村,99,942,214,76,290,22,312
公投第１１案,澎湖縣,西嶼鄉,外垵村,100,1133,255,135,390,50,440
公投第１１案,澎湖縣,望安鄉,東安村,101,734,203,105,308,23,331
公投第１１案,澎湖縣,望安鄉,西安村,102,454,142,38,180,10,190
公投第１１案,澎湖縣,望安鄉,中社村,103,300,80,29,109,4,113
公投第１１案,澎湖縣,望安鄉,水垵村,104,471,146,63,209,29,238
公投第１１案,澎湖縣,望安鄉,將軍村,105,672,169,70,239,7,246
公投第１１案,澎湖縣,望安鄉,將軍村,106,742,230,68,298,16,314
公投第１１案,澎湖縣,望安鄉,東吉村,107,264,77,30,107,4,111
公投第１１案,澎湖縣,望安鄉,東坪村,108,476,133,76,209,5,214
公投第１１案,澎湖縣,望安鄉,西坪村,109,208,33,27,60,2,62
公投第１１案,澎湖縣,望安鄉,花嶼村,110,307,57,29,86,5,91
公投第１１案,澎湖縣,七美鄉,東湖村,111,248,41,18,59,7,66
公投第１１案,澎湖縣,七美鄉,西湖村,112,581,129,61,190,14,204
公投第１１案,澎湖縣,七美鄉,中和村,113,641,126,83,209,19,228
公投第１１案,澎湖縣,七美鄉,平和村,114,382,91,27,118,3,121
公投第１１案,澎湖縣,七美鄉,海豐村,115,351,57,27,84,2,86
公投第１１案,澎湖縣,七美鄉,南港村,116,1171,200,109,309,13,322
公投第１１案,基隆市,中正區,長潭里,1,466,165,80,245,17,262
公投第１１案,基隆市,中正區,砂子里,2,1262,353,185,538,19,557
公投第１１案,基隆市,中正區,砂子里,3,1171,349,169,518,42,560
公投第１１案,基隆市,中正區,砂子里,4,2823,744,319,1063,14,1077
公投第１１案,基隆市,中正區,八斗里,5,1474,420,198,618,41,659
公投第１１案,基隆市,中正區,碧砂里,6,1271,329,179,508,48,556
公投第１１案,基隆市,中正區,新富里,7,2707,792,350,1142,31,1173
公投第１１案,基隆市,中正區,新富里,8,1545,473,212,685,64,749
公投第１１案,基隆市,中正區,新富里,9,761,223,84,307,15,322
公投第１１案,基隆市,中正區,新豐里,10,1352,412,230,642,15,657
公投第１１案,基隆市,中正區,新豐里,11,1413,459,189,648,15,663
公投第１１案,基隆市,中正區,新豐里,12,2665,762,352,1114,33,1147
公投第１１案,基隆市,中正區,平寮里,13,1261,397,168,565,40,605
公投第１１案,基隆市,中正區,社寮里,14,1753,561,275,836,53,889
公投第１１案,基隆市,中正區,和憲里,15,984,286,133,419,28,447
公投第１１案,基隆市,中正區,海濱里,16,1166,410,136,546,25,571
公投第１１案,基隆市,中正區,正濱里,17,973,296,166,462,15,477
公投第１１案,基隆市,中正區,中正里,18,1694,389,230,619,20,639
公投第１１案,基隆市,中正區,中濱里,19,1270,399,203,602,35,637
公投第１１案,基隆市,中正區,建國里,20,1090,392,168,560,19,579
公投第１１案,基隆市,中正區,建國里,21,870,298,152,450,20,470
公投第１１案,基隆市,中正區,砂灣里,22,1138,345,195,540,34,574
公投第１１案,基隆市,中正區,砂灣里,23,862,282,119,401,23,424
公投第１１案,基隆市,中正區,真砂里,24,1341,461,232,693,47,740
公投第１１案,基隆市,中正區,正砂里,25,859,293,149,442,38,480
公投第１１案,基隆市,中正區,正砂里,26,1457,435,211,646,29,675
公投第１１案,基隆市,中正區,中砂里,27,1594,427,197,624,30,654
公投第１１案,基隆市,中正區,入船里,28,802,270,125,395,34,429
公投第１１案,基隆市,中正區,正船里,29,1267,410,179,589,32,621
公投第１１案,基隆市,中正區,中船里,30,1175,364,218,582,47,629
公投第１１案,基隆市,中正區,港通里,31,1210,443,202,645,39,684
公投第１１案,基隆市,中正區,義重里,32,1037,338,181,519,33,552
公投第１１案,基隆市,中正區,正義里,33,1219,408,194,602,41,643
公投第１１案,基隆市,中正區,信義里,34,904,301,147,448,26,474
公投第１１案,基隆市,中正區,德義里,35,709,278,143,421,24,445
公投第１１案,基隆市,信義區,仁壽里,36,1096,381,202,583,36,619
公投第１１案,基隆市,信義區,仁義里,37,1232,463,253,716,24,740
公投第１１案,基隆市,信義區,義昭里,38,1184,418,226,644,28,672
公投第１１案,基隆市,信義區,義幸里,39,1133,452,183,635,32,667
公投第１１案,基隆市,信義區,義幸里,40,1188,444,201,645,21,666
公投第１１案,基隆市,信義區,義民里,41,725,282,124,406,21,427
公投第１１案,基隆市,信義區,義和里,42,1524,472,218,690,34,724
公投第１１案,基隆市,信義區,智慧里,43,736,252,147,399,20,419
公投第１１案,基隆市,信義區,智誠里,44,611,218,91,309,17,326
公投第１１案,基隆市,信義區,智誠里,45,951,327,140,467,8,475
公投第１１案,基隆市,信義區,禮儀里,46,1616,552,266,818,41,859
公投第１１案,基隆市,信義區,禮東里,47,1516,519,280,799,26,825
公投第１１案,基隆市,信義區,信綠里,48,1049,366,170,536,18,554
公投第１１案,基隆市,信義區,信綠里,49,1069,349,196,545,17,562
公投第１１案,基隆市,信義區,東信里,50,727,273,134,407,17,424
公投第１１案,基隆市,信義區,東信里,51,929,345,188,533,22,555
公投第１１案,基隆市,信義區,東信里,52,1118,422,246,668,23,691
公投第１１案,基隆市,信義區,東信里,53,1339,467,261,728,26,754
公投第１１案,基隆市,信義區,東光里,54,999,358,150,508,21,529
公投第１１案,基隆市,信義區,東光里,55,764,284,119,403,9,412
公投第１１案,基隆市,信義區,東明里,56,1555,503,222,725,28,753
公投第１１案,基隆市,信義區,東明里,57,2015,634,347,981,20,1001
公投第１１案,基隆市,信義區,東安里,58,1268,465,231,696,26,722
公投第１１案,基隆市,信義區,東安里,59,1569,512,391,903,33,936
公投第１１案,基隆市,信義區,孝賢里,60,1985,629,306,935,25,960
公投第１１案,基隆市,信義區,孝賢里,61,1476,570,222,792,20,812
公投第１１案,基隆市,信義區,孝忠里,62,1493,527,288,815,26,841
公投第１１案,基隆市,信義區,孝忠里,63,1249,475,272,747,20,767
公投第１１案,基隆市,信義區,孝忠里,64,1559,540,236,776,14,790
公投第１１案,基隆市,信義區,孝忠里,65,1168,376,189,565,13,578
公投第１１案,基隆市,信義區,孝忠里,66,1602,543,252,795,32,827
公投第１１案,基隆市,信義區,孝德里,67,1485,460,206,666,26,692
公投第１１案,基隆市,信義區,孝德里,68,1009,352,152,504,23,527
公投第１１案,基隆市,信義區,孝深里,69,2016,569,260,829,39,868
公投第１１案,基隆市,信義區,孝深里,70,1764,520,229,749,19,768
公投第１１案,基隆市,信義區,孝岡里,71,1295,450,231,681,24,705
公投第１１案,基隆市,仁愛區,林泉里,72,1782,525,131,656,79,735
公投第１１案,基隆市,仁愛區,花崗里,73,1055,383,191,574,22,596
公投第１１案,基隆市,仁愛區,虹橋里,74,1558,500,224,724,25,749
公投第１１案,基隆市,仁愛區,水錦里,75,1736,628,252,880,28,908
公投第１１案,基隆市,仁愛區,智仁里,76,1243,488,227,715,18,733
公投第１１案,基隆市,仁愛區,智仁里,77,1109,407,193,600,27,627
公投第１１案,基隆市,仁愛區,和明里,78,1684,644,272,916,46,962
公投第１１案,基隆市,仁愛區,忠勇里,79,919,308,179,487,25,512
公投第１１案,基隆市,仁愛區,玉田里,80,991,311,188,499,14,513
公投第１１案,基隆市,仁愛區,仁德里,81,876,315,164,479,8,487
公投第１１案,基隆市,仁愛區,博愛里,82,1046,385,198,583,30,613
公投第１１案,基隆市,仁愛區,博愛里,83,434,179,73,252,11,263
公投第１１案,基隆市,仁愛區,福仁里,84,764,283,141,424,29,453
公投第１１案,基隆市,仁愛區,誠仁里,85,968,323,166,489,18,507
公投第１１案,基隆市,仁愛區,吉仁里,86,1326,408,229,637,48,685
公投第１１案,基隆市,仁愛區,吉仁里,87,1315,349,188,537,38,575
公投第１１案,基隆市,仁愛區,育仁里,88,775,300,118,418,32,450
公投第１１案,基隆市,仁愛區,英仁里,89,652,226,124,350,25,375
公投第１１案,基隆市,仁愛區,英仁里,90,674,234,125,359,20,379
公投第１１案,基隆市,仁愛區,龍門里,91,789,266,122,388,24,412
公投第１１案,基隆市,仁愛區,德厚里,92,1715,584,275,859,43,902
公投第１１案,基隆市,仁愛區,曲水里,93,849,285,145,430,33,463
公投第１１案,基隆市,仁愛區,崇文里,94,875,330,140,470,23,493
公投第１１案,基隆市,仁愛區,文安里,95,851,272,136,408,26,434
公投第１１案,基隆市,仁愛區,兆連里,96,735,271,131,402,25,427
公投第１１案,基隆市,仁愛區,獅球里,97,1009,332,164,496,42,538
公投第１１案,基隆市,仁愛區,書院里,98,1082,332,175,507,34,541
公投第１１案,基隆市,仁愛區,朝棟里,99,1278,403,223,626,39,665
公投第１１案,基隆市,仁愛區,朝棟里,100,1519,604,237,841,30,871
公投第１１案,基隆市,仁愛區,光華里,101,1336,359,219,578,26,604
公投第１１案,基隆市,仁愛區,光華里,102,1178,479,199,678,33,711
公投第１１案,基隆市,仁愛區,明德里,103,708,231,125,356,23,379
公投第１１案,基隆市,仁愛區,同風里,104,567,227,112,339,17,356
公投第１１案,基隆市,仁愛區,文昌里,105,751,223,152,375,42,417
公投第１１案,基隆市,仁愛區,新店里,106,589,194,143,337,17,354
公投第１１案,基隆市,中山區,新建里,107,796,279,124,403,22,425
公投第１１案,基隆市,中山區,安民里,108,1036,420,195,615,28,643
公投第１１案,基隆市,中山區,安平里,109,756,298,125,423,19,442
公投第１１案,基隆市,中山區,中山里,110,957,277,180,457,19,476
公投第１１案,基隆市,中山區,民治里,111,802,282,140,422,10,432
公投第１１案,基隆市,中山區,中興里,112,1263,432,205,637,40,677
公投第１１案,基隆市,中山區,仁正里,113,778,297,136,433,15,448
公投第１１案,基隆市,中山區,健民里,114,1180,406,201,607,54,661
公投第１１案,基隆市,中山區,通化里,115,990,330,139,469,20,489
公投第１１案,基隆市,中山區,居仁里,116,1332,373,173,546,28,574
公投第１１案,基隆市,中山區,通明里,117,848,240,139,379,27,406
公投第１１案,基隆市,中山區,通明里,118,922,307,123,430,23,453
公投第１１案,基隆市,中山區,和平里,119,459,182,78,260,13,273
公投第１１案,基隆市,中山區,仙洞里,120,574,196,73,269,22,291
公投第１１案,基隆市,中山區,太白里,121,877,264,158,422,33,455
公投第１１案,基隆市,中山區,協和里,122,1584,436,251,687,23,710
公投第１１案,基隆市,中山區,文化里,123,1319,335,143,478,21,499
公投第１１案,基隆市,中山區,德安里,124,1938,629,315,944,46,990
公投第１１案,基隆市,中山區,德安里,125,1877,568,319,887,25,912
公投第１１案,基隆市,中山區,德和里,126,2088,737,346,1083,39,1122
公投第１１案,基隆市,中山區,德和里,127,1946,689,343,1032,21,1053
公投第１１案,基隆市,中山區,德和里,128,1353,488,233,721,45,766
公投第１１案,基隆市,中山區,中和里,129,1317,442,210,652,40,692
公投第１１案,基隆市,中山區,中和里,130,870,292,187,479,17,496
公投第１１案,基隆市,中山區,中和里,131,1322,464,239,703,18,721
公投第１１案,基隆市,中山區,中和里,132,1295,385,214,599,17,616
公投第１１案,基隆市,中山區,中和里,133,756,300,138,438,22,460
公投第１１案,基隆市,中山區,和慶里,134,1602,477,247,724,21,745
公投第１１案,基隆市,中山區,和慶里,135,1568,509,221,730,24,754
公投第１１案,基隆市,中山區,和慶里,136,1404,461,249,710,27,737
公投第１１案,基隆市,中山區,和慶里,137,1909,639,279,918,22,940
公投第１１案,基隆市,中山區,西康里,138,1642,473,234,707,57,764
公投第１１案,基隆市,中山區,西定里,139,932,310,156,466,16,482
公投第１１案,基隆市,中山區,西華里,140,849,349,146,495,25,520
公投第１１案,基隆市,中山區,西榮里,141,715,229,165,394,34,428
公投第１１案,基隆市,安樂區,新西里,142,1361,416,204,620,47,667
公投第１１案,基隆市,安樂區,西川里,143,1213,409,181,590,17,607
公投第１１案,基隆市,安樂區,定國里,144,1026,328,121,449,18,467
公投第１１案,基隆市,安樂區,定邦里,145,1038,404,169,573,56,629
公投第１１案,基隆市,安樂區,慈仁里,146,897,399,80,479,38,517
公投第１１案,基隆市,安樂區,干城里,147,1401,487,231,718,31,749
公投第１１案,基隆市,安樂區,干城里,148,641,154,76,230,12,242
公投第１１案,基隆市,安樂區,永康里,149,1472,465,247,712,38,750
公投第１１案,基隆市,安樂區,永康里,150,472,162,86,248,15,263
公投第１１案,基隆市,安樂區,安和里,151,841,338,149,487,18,505
公投第１１案,基隆市,安樂區,樂一里,152,571,182,104,286,25,311
公投第１１案,基隆市,安樂區,嘉仁里,153,1901,617,316,933,32,965
公投第１１案,基隆市,安樂區,嘉仁里,154,1349,431,221,652,46,698
公投第１１案,基隆市,安樂區,三民里,155,1225,426,175,601,27,628
公投第１１案,基隆市,安樂區,三民里,156,1351,475,232,707,42,749
公投第１１案,基隆市,安樂區,壯觀里,157,1601,559,325,884,26,910
公投第１１案,基隆市,安樂區,壯觀里,158,2513,866,358,1224,36,1260
公投第１１案,基隆市,安樂區,四維里,159,1613,559,279,838,34,872
公投第１１案,基隆市,安樂區,四維里,160,1731,621,299,920,25,945
公投第１１案,基隆市,安樂區,四維里,161,1424,526,301,827,20,847
公投第１１案,基隆市,安樂區,五福里,162,1806,608,266,874,37,911
公投第１１案,基隆市,安樂區,五福里,163,1679,610,283,893,42,935
公投第１１案,基隆市,安樂區,六合里,164,1902,648,343,991,21,1012
公投第１１案,基隆市,安樂區,六合里,165,2040,563,451,1014,30,1044
公投第１１案,基隆市,安樂區,七賢里,166,1313,462,208,670,35,705
公投第１１案,基隆市,安樂區,七賢里,167,1243,407,201,608,17,625
公投第１１案,基隆市,安樂區,長樂里,168,1759,563,319,882,22,904
公投第１１案,基隆市,安樂區,長樂里,169,694,261,165,426,12,438
公投第１１案,基隆市,安樂區,長樂里,170,866,326,212,538,13,551
公投第１１案,基隆市,安樂區,鶯歌里,171,1557,419,236,655,25,680
公投第１１案,基隆市,安樂區,鶯歌里,172,1411,459,235,694,26,720
公投第１１案,基隆市,安樂區,鶯安里,173,1568,580,293,873,19,892
公投第１１案,基隆市,安樂區,鶯安里,174,1400,458,239,697,28,725
公投第１１案,基隆市,安樂區,鶯安里,175,1531,535,252,787,8,795
公投第１１案,基隆市,安樂區,興寮里,176,1673,545,257,802,13,815
公投第１１案,基隆市,安樂區,興寮里,177,1054,367,168,535,27,562
公投第１１案,基隆市,安樂區,興寮里,178,1923,527,274,801,24,825
公投第１１案,基隆市,安樂區,外寮里,179,1960,703,315,1018,35,1053
公投第１１案,基隆市,安樂區,外寮里,180,1962,629,305,934,46,980
公投第１１案,基隆市,安樂區,新崙里,181,2117,715,349,1064,36,1100
公投第１１案,基隆市,安樂區,新崙里,182,1829,550,308,858,35,893
公投第１１案,基隆市,安樂區,武崙里,183,1529,487,233,720,19,739
公投第１１案,基隆市,安樂區,武崙里,184,1869,610,327,937,15,952
公投第１１案,基隆市,安樂區,武崙里,185,1140,415,210,625,9,634
公投第１１案,基隆市,安樂區,中崙里,186,1641,511,299,810,30,840
公投第１１案,基隆市,安樂區,內寮里,187,1279,427,208,635,29,664
公投第１１案,基隆市,安樂區,內寮里,188,1360,352,230,582,18,600
公投第１１案,基隆市,安樂區,內寮里,189,1399,458,281,739,27,766
公投第１１案,基隆市,安樂區,內寮里,190,1251,405,228,633,18,651
公投第１１案,基隆市,暖暖區,八西里,191,1431,447,234,681,27,708
公投第１１案,基隆市,暖暖區,八中里,192,456,162,75,237,7,244
公投第１１案,基隆市,暖暖區,八堵里,193,637,227,117,344,20,364
公投第１１案,基隆市,暖暖區,八南里,194,735,290,131,421,22,443
公投第１１案,基隆市,暖暖區,過港里,195,1078,358,151,509,22,531
公投第１１案,基隆市,暖暖區,過港里,196,1238,370,232,602,31,633
公投第１１案,基隆市,暖暖區,過港里,197,1325,424,238,662,12,674
公投第１１案,基隆市,暖暖區,暖暖里,198,1475,604,275,879,17,896
公投第１１案,基隆市,暖暖區,暖暖里,199,1179,363,193,556,18,574
公投第１１案,基隆市,暖暖區,暖同里,200,1110,414,214,628,33,661
公投第１１案,基隆市,暖暖區,暖同里,201,1443,446,219,665,19,684
公投第１１案,基隆市,暖暖區,暖東里,202,415,143,71,214,12,226
公投第１１案,基隆市,暖暖區,暖西里,203,1378,429,250,679,17,696
公投第１１案,基隆市,暖暖區,暖西里,204,1570,522,274,796,24,820
公投第１１案,基隆市,暖暖區,暖西里,205,1603,592,297,889,46,935
公投第１１案,基隆市,暖暖區,碇內里,206,1267,468,230,698,31,729
公投第１１案,基隆市,暖暖區,碇內里,207,1359,463,228,691,27,718
公投第１１案,基隆市,暖暖區,碇和里,208,970,393,157,550,24,574
公投第１１案,基隆市,暖暖區,碇和里,209,1002,356,167,523,13,536
公投第１１案,基隆市,暖暖區,碇和里,210,944,306,163,469,21,490
公投第１１案,基隆市,暖暖區,碇祥里,211,1500,543,286,829,20,849
公投第１１案,基隆市,暖暖區,碇祥里,212,1442,393,187,580,20,600
公投第１１案,基隆市,暖暖區,碇祥里,213,1165,414,215,629,6,635
公投第１１案,基隆市,暖暖區,碇祥里,214,1610,536,266,802,22,824
公投第１１案,基隆市,暖暖區,碇安里,215,1328,467,252,719,20,739
公投第１１案,基隆市,暖暖區,碇安里,216,1173,411,211,622,7,629
公投第１１案,基隆市,暖暖區,碇安里,217,1019,363,217,580,26,606
公投第１１案,基隆市,暖暖區,碇安里,218,1373,490,247,737,11,748
公投第１１案,基隆市,七堵區,長興里,219,1258,486,189,675,41,716
公投第１１案,基隆市,七堵區,長興里,220,1237,456,202,658,36,694
公投第１１案,基隆市,七堵區,長興里,221,1259,422,229,651,17,668
公投第１１案,基隆市,七堵區,正光里,222,1120,368,176,544,35,579
公投第１１案,基隆市,七堵區,正光里,223,1344,415,192,607,26,633
公投第１１案,基隆市,七堵區,正明里,224,1011,402,192,594,27,621
公投第１１案,基隆市,七堵區,正明里,225,925,334,162,496,11,507
公投第１１案,基隆市,七堵區,富民里,226,1735,663,270,933,42,975
公投第１１案,基隆市,七堵區,富民里,227,1833,654,332,986,52,1038
公投第１１案,基隆市,七堵區,永平里,228,938,345,175,520,15,535
公投第１１案,基隆市,七堵區,永平里,229,962,367,178,545,29,574
公投第１１案,基隆市,七堵區,永安里,230,1191,442,217,659,19,678
公投第１１案,基隆市,七堵區,永安里,231,999,397,163,560,18,578
公投第１１案,基隆市,七堵區,八德里,232,282,88,43,131,8,139
公投第１１案,基隆市,七堵區,八德里,233,1243,389,216,605,35,640
公投第１１案,基隆市,七堵區,自強里,234,1092,374,176,550,35,585
公投第１１案,基隆市,七堵區,泰安里,235,1246,424,221,645,26,671
公投第１１案,基隆市,七堵區,泰安里,236,1722,542,282,824,43,867
公投第１１案,基隆市,七堵區,泰安里,237,1318,469,220,689,25,714
公投第１１案,基隆市,七堵區,六堵里,238,975,324,138,462,17,479
公投第１１案,基隆市,七堵區,六堵里,239,1285,421,227,648,28,676
公投第１１案,基隆市,七堵區,堵南里,240,1077,322,164,486,35,521
公投第１１案,基隆市,七堵區,堵南里,241,989,307,144,451,20,471
公投第１１案,基隆市,七堵區,長安里,242,1193,372,199,571,27,598
公投第１１案,基隆市,七堵區,長安里,243,1273,424,215,639,28,667
公投第１１案,基隆市,七堵區,堵北里,244,1774,627,283,910,46,956
公投第１１案,基隆市,七堵區,堵北里,245,1689,572,298,870,41,911
公投第１１案,基隆市,七堵區,百福里,246,1355,444,215,659,36,695
公投第１１案,基隆市,七堵區,百福里,247,1512,440,290,730,36,766
公投第１１案,基隆市,七堵區,百福里,248,1486,467,242,709,21,730
公投第１１案,基隆市,七堵區,百福里,249,1706,564,277,841,23,864
公投第１１案,基隆市,七堵區,實踐里,250,1384,487,243,730,31,761
公投第１１案,基隆市,七堵區,實踐里,251,1045,414,196,610,24,634
公投第１１案,基隆市,七堵區,實踐里,252,1374,464,248,712,23,735
公投第１１案,基隆市,七堵區,瑪南里,253,428,157,69,226,6,232
公投第１１案,基隆市,七堵區,瑪東里,254,326,120,65,185,14,199
公投第１１案,基隆市,七堵區,瑪西里,255,351,173,64,237,14,251
公投第１１案,基隆市,七堵區,友一里,256,1871,568,287,855,26,881
公投第１１案,基隆市,七堵區,友二里,257,448,163,62,225,8,233
公投第１１案,新竹市,東區,育賢里,1,1512,319,183,502,10,512
公投第１１案,新竹市,東區,親仁里,2,953,367,202,569,16,585
公投第１１案,新竹市,東區,親仁里,3,729,261,131,392,28,420
公投第１１案,新竹市,東區,東門里,4,566,226,110,336,18,354
公投第１１案,新竹市,東區,成功里,5,640,250,110,360,18,378
公投第１１案,新竹市,東區,榮光里,6,305,100,57,157,16,173
公投第１１案,新竹市,東區,中正里,7,563,230,102,332,15,347
公投第１１案,新竹市,東區,錦華里,8,741,265,143,408,12,420
公投第１１案,新竹市,東區,錦華里,9,1041,369,232,601,15,616
公投第１１案,新竹市,東區,文華里,10,1615,547,302,849,23,872
公投第１１案,新竹市,東區,文華里,11,1287,471,244,715,33,748
公投第１１案,新竹市,東區,文華里,12,1554,602,273,875,23,898
公投第１１案,新竹市,東區,復中里,13,1388,536,273,809,16,825
公投第１１案,新竹市,東區,復中里,14,1419,533,285,818,26,844
公投第１１案,新竹市,東區,復中里,15,1355,451,273,724,33,757
公投第１１案,新竹市,東區,復興里,16,1490,549,267,816,27,843
公投第１１案,新竹市,東區,復興里,17,1615,591,315,906,15,921
公投第１１案,新竹市,東區,復興里,18,1672,611,321,932,30,962
公投第１１案,新竹市,東區,三民里,19,1062,371,237,608,19,627
公投第１１案,新竹市,東區,三民里,20,1315,462,262,724,29,753
公投第１１案,新竹市,東區,三民里,21,1000,392,188,580,19,599
公投第１１案,新竹市,東區,三民里,22,1337,513,252,765,34,799
公投第１１案,新竹市,東區,東園里,23,1747,592,344,936,20,956
公投第１１案,新竹市,東區,東園里,24,1600,577,366,943,16,959
公投第１１案,新竹市,東區,東園里,25,1158,408,220,628,28,656
公投第１１案,新竹市,東區,東園里,26,828,338,183,521,21,542
公投第１１案,新竹市,東區,公園里,27,1573,536,303,839,35,874
公投第１１案,新竹市,東區,公園里,28,1550,607,259,866,23,889
公投第１１案,新竹市,東區,建華里,29,1317,473,257,730,27,757
公投第１１案,新竹市,東區,建華里,30,1040,384,230,614,35,649
公投第１１案,新竹市,東區,東山里,31,935,385,164,549,17,566
公投第１１案,新竹市,東區,東山里,32,1074,377,218,595,20,615
公投第１１案,新竹市,東區,東山里,33,1133,425,232,657,42,699
公投第１１案,新竹市,東區,綠水里,34,1262,476,247,723,36,759
公投第１１案,新竹市,東區,綠水里,35,1199,441,229,670,20,690
公投第１１案,新竹市,東區,綠水里,36,1226,484,265,749,21,770
公投第１１案,新竹市,東區,綠水里,37,1377,543,318,861,25,886
公投第１１案,新竹市,東區,綠水里,38,991,398,227,625,11,636
公投第１１案,新竹市,東區,東勢里,39,1271,448,267,715,47,762
公投第１１案,新竹市,東區,東勢里,40,1012,406,233,639,13,652
公投第１１案,新竹市,東區,光復里,41,1001,368,183,551,36,587
公投第１１案,新竹市,東區,光復里,42,1603,511,306,817,39,856
公投第１１案,新竹市,東區,前溪里,43,1236,448,226,674,31,705
公投第１１案,新竹市,東區,前溪里,44,1532,493,190,683,50,733
公投第１１案,新竹市,東區,水源里,45,1306,518,213,731,18,749
公投第１１案,新竹市,東區,水源里,46,1073,393,194,587,43,630
公投第１１案,新竹市,東區,水源里,47,952,335,199,534,18,552
公投第１１案,新竹市,東區,千甲里,48,1298,430,189,619,26,645
公投第１１案,新竹市,東區,千甲里,49,778,316,126,442,9,451
公投第１１案,新竹市,東區,豐功里,50,1195,417,268,685,21,706
公投第１１案,新竹市,東區,豐功里,51,1569,550,281,831,37,868
公投第１１案,新竹市,東區,豐功里,52,1533,570,369,939,24,963
公投第１１案,新竹市,東區,武功里,53,1336,582,204,786,27,813
公投第１１案,新竹市,東區,武功里,54,1367,534,249,783,30,813
公投第１１案,新竹市,東區,武功里,55,1289,716,52,768,23,791
公投第１１案,新竹市,東區,軍功里,56,960,368,161,529,22,551
公投第１１案,新竹市,東區,軍功里,57,843,334,186,520,18,538
公投第１１案,新竹市,東區,軍功里,58,948,414,163,577,21,598
公投第１１案,新竹市,東區,立功里,59,915,364,135,499,23,522
公投第１１案,新竹市,東區,建功里,60,1801,720,289,1009,40,1049
公投第１１案,新竹市,東區,建功里,61,1079,401,215,616,12,628
公投第１１案,新竹市,東區,建功里,62,676,296,118,414,9,423
公投第１１案,新竹市,東區,光明里,63,1132,404,236,640,37,677
公投第１１案,新竹市,東區,光明里,64,251,76,70,146,6,152
公投第１１案,新竹市,東區,光明里,65,1620,567,326,893,35,928
公投第１１案,新竹市,東區,龍山里,66,1479,447,333,780,20,800
公投第１１案,新竹市,東區,龍山里,67,1402,408,332,740,16,756
公投第１１案,新竹市,東區,龍山里,68,1280,448,252,700,29,729
公投第１１案,新竹市,東區,龍山里,69,1228,383,336,719,13,732
公投第１１案,新竹市,東區,龍山里,70,1157,330,305,635,4,639
公投第１１案,新竹市,東區,龍山里,71,1354,475,272,747,23,770
公投第１１案,新竹市,東區,科園里,72,1334,499,337,836,19,855
公投第１１案,新竹市,東區,科園里,73,1234,469,296,765,27,792
公投第１１案,新竹市,東區,科園里,74,1398,575,296,871,25,896
公投第１１案,新竹市,東區,科園里,75,928,323,237,560,13,573
公投第１１案,新竹市,東區,科園里,76,1368,531,297,828,33,861
公投第１１案,新竹市,東區,埔頂里,77,1215,436,249,685,17,702
公投第１１案,新竹市,東區,埔頂里,78,1067,393,161,554,20,574
公投第１１案,新竹市,東區,埔頂里,79,1194,336,312,648,14,662
公投第１１案,新竹市,東區,埔頂里,80,1193,336,289,625,16,641
公投第１１案,新竹市,東區,新莊里,81,1388,469,292,761,48,809
公投第１１案,新竹市,東區,新莊里,82,1267,480,246,726,27,753
公投第１１案,新竹市,東區,新莊里,83,1299,468,254,722,17,739
公投第１１案,新竹市,東區,新莊里,84,1288,445,278,723,17,740
公投第１１案,新竹市,東區,關新里,85,1228,405,329,734,18,752
公投第１１案,新竹市,東區,關新里,86,1135,382,299,681,13,694
公投第１１案,新竹市,東區,關新里,87,1237,432,342,774,11,785
公投第１１案,新竹市,東區,關東里,88,1135,398,183,581,31,612
公投第１１案,新竹市,東區,關東里,89,1165,410,183,593,23,616
公投第１１案,新竹市,東區,關東里,90,1124,397,216,613,21,634
公投第１１案,新竹市,東區,關東里,91,1210,427,266,693,23,716
公投第１１案,新竹市,東區,金山里,92,1323,471,218,689,27,716
公投第１１案,新竹市,東區,金山里,93,1207,454,187,641,22,663
公投第１１案,新竹市,東區,金山里,94,1264,416,202,618,26,644
公投第１１案,新竹市,東區,金山里,95,1248,400,269,669,16,685
公投第１１案,新竹市,東區,仙水里,96,1400,532,309,841,32,873
公投第１１案,新竹市,東區,仙水里,97,1473,532,327,859,26,885
公投第１１案,新竹市,東區,仙水里,98,1367,450,289,739,32,771
公投第１１案,新竹市,東區,仙宮里,99,1233,443,270,713,16,729
公投第１１案,新竹市,東區,關帝里,100,507,186,92,278,8,286
公投第１１案,新竹市,東區,南門里,101,714,268,132,400,22,422
公投第１１案,新竹市,東區,南市里,102,875,323,155,478,38,516
公投第１１案,新竹市,東區,福德里,103,1396,528,239,767,30,797
公投第１１案,新竹市,東區,振興里,104,1232,416,235,651,27,678
公投第１１案,新竹市,東區,振興里,105,1323,409,274,683,37,720
公投第１１案,新竹市,東區,振興里,106,1516,462,249,711,23,734
公投第１１案,新竹市,東區,振興里,107,1453,446,271,717,28,745
公投第１１案,新竹市,東區,新興里,108,880,332,164,496,21,517
公投第１１案,新竹市,東區,新興里,109,1058,400,161,561,22,583
公投第１１案,新竹市,東區,新興里,110,1061,370,203,573,27,600
公投第１１案,新竹市,東區,寺前里,111,710,274,115,389,32,421
公投第１１案,新竹市,東區,竹蓮里,112,752,294,133,427,34,461
公投第１１案,新竹市,東區,下竹里,113,475,206,81,287,14,301
公投第１１案,新竹市,東區,頂竹里,114,880,279,177,456,29,485
公投第１１案,新竹市,東區,頂竹里,115,989,339,213,552,23,575
公投第１１案,新竹市,東區,頂竹里,116,1059,395,190,585,30,615
公投第１１案,新竹市,東區,南大里,117,607,223,125,348,25,373
公投第１１案,新竹市,東區,南大里,118,815,292,157,449,28,477
公投第１１案,新竹市,東區,新光里,119,777,321,141,462,22,484
公投第１１案,新竹市,東區,新光里,120,1399,458,226,684,27,711
公投第１１案,新竹市,東區,新光里,121,1216,436,223,659,27,686
公投第１１案,新竹市,東區,光鎮里,122,1062,367,162,529,32,561
公投第１１案,新竹市,東區,光鎮里,123,1046,418,193,611,12,623
公投第１１案,新竹市,東區,光鎮里,124,1332,464,227,691,17,708
公投第１１案,新竹市,東區,高峰里,125,1350,448,285,733,35,768
公投第１１案,新竹市,東區,高峰里,126,1438,493,247,740,16,756
公投第１１案,新竹市,東區,高峰里,127,1414,484,236,720,35,755
公投第１１案,新竹市,東區,高峰里,128,1476,538,310,848,18,866
公投第１１案,新竹市,東區,湖濱里,129,1326,542,238,780,41,821
公投第１１案,新竹市,東區,湖濱里,130,927,347,231,578,24,602
公投第１１案,新竹市,東區,湖濱里,131,1273,463,247,710,27,737
公投第１１案,新竹市,東區,柴橋里,132,1315,448,231,679,26,705
公投第１１案,新竹市,東區,柴橋里,133,1413,507,273,780,30,810
公投第１１案,新竹市,東區,柴橋里,134,1064,357,228,585,14,599
公投第１１案,新竹市,東區,柴橋里,135,1244,483,291,774,17,791
公投第１１案,新竹市,東區,明湖里,136,1160,395,218,613,3,616
公投第１１案,新竹市,東區,明湖里,137,1398,449,231,680,19,699
公投第１１案,新竹市,東區,明湖里,138,1384,366,191,557,15,572
公投第１１案,新竹市,東區,明湖里,139,874,346,165,511,32,543
公投第１１案,新竹市,北區,中央里,140,477,165,95,260,9,269
公投第１１案,新竹市,北區,西門里,141,535,210,96,306,23,329
公投第１１案,新竹市,北區,潛園里,142,746,258,146,404,44,448
公投第１１案,新竹市,北區,石坊里,143,546,190,105,295,9,304
公投第１１案,新竹市,北區,仁德里,144,711,289,130,419,23,442
公投第１１案,新竹市,北區,崇禮里,145,1143,417,174,591,29,620
公投第１１案,新竹市,北區,興南里,146,1370,461,246,707,27,734
公投第１１案,新竹市,北區,育英里,147,1390,458,276,734,24,758
公投第１１案,新竹市,北區,育英里,148,962,352,186,538,11,549
公投第１１案,新竹市,北區,育英里,149,1237,437,249,686,11,697
公投第１１案,新竹市,北區,台溪里,150,1604,492,263,755,39,794
公投第１１案,新竹市,北區,曲溪里,151,758,263,113,376,14,390
公投第１１案,新竹市,北區,曲溪里,152,1320,478,193,671,20,691
公投第１１案,新竹市,北區,曲溪里,153,1519,494,229,723,48,771
公投第１１案,新竹市,北區,曲溪里,154,347,86,41,127,7,134
公投第１１案,新竹市,北區,曲溪里,155,1212,485,205,690,34,724
公投第１１案,新竹市,北區,西雅里,156,1484,523,263,786,31,817
公投第１１案,新竹市,北區,西雅里,157,1428,477,263,740,53,793
公投第１１案,新竹市,北區,客雅里,158,1128,482,159,641,22,663
公投第１１案,新竹市,北區,客雅里,159,638,232,114,346,12,358
公投第１１案,新竹市,北區,中雅里,160,1222,499,177,676,37,713
公投第１１案,新竹市,北區,中雅里,161,1076,357,198,555,28,583
公投第１１案,新竹市,北區,中雅里,162,937,405,180,585,17,602
公投第１１案,新竹市,北區,南勢里,163,1394,491,237,728,39,767
公投第１１案,新竹市,北區,南勢里,164,1568,522,259,781,30,811
公投第１１案,新竹市,北區,南勢里,165,1159,406,268,674,32,706
公投第１１案,新竹市,北區,大鵬里,166,252,74,27,101,4,105
公投第１１案,新竹市,北區,大同里,167,761,309,159,468,13,481
公投第１１案,新竹市,北區,中山里,168,788,285,157,442,31,473
公投第１１案,新竹市,北區,中興里,169,561,222,115,337,23,360
公投第１１案,新竹市,北區,新民里,170,1558,499,277,776,53,829
公投第１１案,新竹市,北區,長和里,171,1398,444,249,693,23,716
公投第１１案,新竹市,北區,北門里,172,957,347,156,503,33,536
公投第１１案,新竹市,北區,民富里,173,1195,465,203,668,28,696
公投第１１案,新竹市,北區,民富里,174,1236,365,225,590,27,617
公投第１１案,新竹市,北區,民富里,175,1255,419,212,631,36,667
公投第１１案,新竹市,北區,民富里,176,1114,399,234,633,9,642
公投第１１案,新竹市,北區,磐石里,177,1396,504,252,756,24,780
公投第１１案,新竹市,北區,磐石里,178,1456,542,263,805,32,837
公投第１１案,新竹市,北區,磐石里,179,1374,476,266,742,18,760
公投第１１案,新竹市,北區,磐石里,180,1070,379,172,551,27,578
公投第１１案,新竹市,北區,新雅里,181,1142,437,171,608,38,646
公投第１１案,新竹市,北區,新雅里,182,1103,370,211,581,14,595
公投第１１案,新竹市,北區,新雅里,183,1190,438,191,629,50,679
公投第１１案,新竹市,北區,新雅里,184,1089,473,189,662,15,677
公投第１１案,新竹市,北區,文雅里,185,1272,414,197,611,12,623
公投第１１案,新竹市,北區,文雅里,186,1306,488,225,713,36,749
公投第１１案,新竹市,北區,文雅里,187,1328,470,252,722,30,752
公投第１１案,新竹市,北區,水田里,188,1457,497,251,748,24,772
公投第１１案,新竹市,北區,水田里,189,1492,521,276,797,31,828
公投第１１案,新竹市,北區,光田里,190,1160,449,224,673,35,708
公投第１１案,新竹市,北區,光田里,191,971,367,171,538,37,575
公投第１１案,新竹市,北區,光華里,192,1401,296,150,446,10,456
公投第１１案,新竹市,北區,光華里,193,1340,464,283,747,29,776
公投第１１案,新竹市,北區,光華里,194,1371,504,290,794,29,823
公投第１１案,新竹市,北區,金華里,195,1267,434,256,690,20,710
公投第１１案,新竹市,北區,金華里,196,1073,420,226,646,32,678
公投第１１案,新竹市,北區,金華里,197,1159,443,219,662,17,679
公投第１１案,新竹市,北區,金華里,198,1294,436,278,714,19,733
公投第１１案,新竹市,北區,湳雅里,199,1442,518,258,776,28,804
公投第１１案,新竹市,北區,湳雅里,200,1270,476,256,732,20,752
公投第１１案,新竹市,北區,金雅里,201,1179,506,234,740,29,769
公投第１１案,新竹市,北區,金雅里,202,949,407,173,580,20,600
公投第１１案,新竹市,北區,湳中里,203,1163,412,248,660,24,684
公投第１１案,新竹市,北區,湳中里,204,1334,453,285,738,9,747
公投第１１案,新竹市,北區,湳中里,205,1415,482,296,778,26,804
公投第１１案,新竹市,北區,湳中里,206,1305,462,316,778,18,796
公投第１１案,新竹市,北區,湳中里,207,1200,430,234,664,18,682
公投第１１案,新竹市,北區,舊社里,208,1106,398,233,631,23,654
公投第１１案,新竹市,北區,舊社里,209,1044,396,217,613,15,628
公投第１１案,新竹市,北區,舊社里,210,1061,390,221,611,19,630
公投第１１案,新竹市,北區,舊社里,211,1518,559,301,860,41,901
公投第１１案,新竹市,北區,舊社里,212,1220,467,259,726,31,757
公投第１１案,新竹市,北區,金竹里,213,1475,564,290,854,10,864
公投第１１案,新竹市,北區,金竹里,214,1373,489,226,715,35,750
公投第１１案,新竹市,北區,金竹里,215,1450,557,270,827,22,849
公投第１１案,新竹市,北區,金竹里,216,1423,572,233,805,24,829
公投第１１案,新竹市,北區,武陵里,217,1059,434,159,593,18,611
公投第１１案,新竹市,北區,武陵里,218,1130,477,180,657,30,687
公投第１１案,新竹市,北區,武陵里,219,1208,513,209,722,27,749
公投第１１案,新竹市,北區,武陵里,220,1226,562,183,745,20,765
公投第１１案,新竹市,北區,福林里,221,1175,446,220,666,21,687
公投第１１案,新竹市,北區,福林里,222,1371,503,269,772,24,796
公投第１１案,新竹市,北區,福林里,223,1306,468,212,680,38,718
公投第１１案,新竹市,北區,境福里,224,1340,513,201,714,20,734
公投第１１案,新竹市,北區,境福里,225,1111,510,132,642,39,681
公投第１１案,新竹市,北區,境福里,226,1197,514,222,736,28,764
公投第１１案,新竹市,北區,境福里,227,1008,420,141,561,23,584
公投第１１案,新竹市,北區,士林里,228,946,350,164,514,12,526
公投第１１案,新竹市,北區,士林里,229,705,297,107,404,24,428
公投第１１案,新竹市,北區,古賢里,230,848,302,156,458,50,508
公投第１１案,新竹市,北區,南寮里,231,1295,454,224,678,21,699
公投第１１案,新竹市,北區,南寮里,232,1467,506,224,730,32,762
公投第１１案,新竹市,北區,南寮里,233,1659,515,237,752,27,779
公投第１１案,新竹市,北區,南寮里,234,1297,454,206,660,27,687
公投第１１案,新竹市,北區,康樂里,235,1374,502,252,754,37,791
公投第１１案,新竹市,北區,康樂里,236,1457,535,262,797,44,841
公投第１１案,新竹市,北區,中寮里,237,1072,432,184,616,21,637
公投第１１案,新竹市,北區,中寮里,238,1350,462,235,697,35,732
公投第１１案,新竹市,北區,中寮里,239,971,387,201,588,21,609
公投第１１案,新竹市,北區,海濱里,240,1450,552,234,786,64,850
公投第１１案,新竹市,北區,海濱里,241,895,338,154,492,18,510
公投第１１案,新竹市,北區,海濱里,242,1378,497,217,714,28,742
公投第１１案,新竹市,北區,港北里,243,1609,571,218,789,49,838
公投第１１案,新竹市,北區,舊港里,244,594,205,114,319,28,347
公投第１１案,新竹市,香山區,頂埔里,245,1443,531,223,754,30,784
公投第１１案,新竹市,香山區,頂埔里,246,1241,422,240,662,23,685
公投第１１案,新竹市,香山區,頂埔里,247,1194,442,198,640,21,661
公投第１１案,新竹市,香山區,頂埔里,248,1081,393,201,594,11,605
公投第１１案,新竹市,香山區,頂福里,249,807,312,152,464,17,481
公投第１１案,新竹市,香山區,頂福里,250,1760,609,311,920,37,957
公投第１１案,新竹市,香山區,頂福里,251,1635,598,281,879,37,916
公投第１１案,新竹市,香山區,中埔里,252,1473,577,259,836,31,867
公投第１１案,新竹市,香山區,中埔里,253,1408,541,251,792,16,808
公投第１１案,新竹市,香山區,牛埔里,254,1318,453,184,637,13,650
公投第１１案,新竹市,香山區,牛埔里,255,1337,473,250,723,32,755
公投第１１案,新竹市,香山區,牛埔里,256,1862,615,328,943,19,962
公投第１１案,新竹市,香山區,埔前里,257,1067,387,203,590,14,604
公投第１１案,新竹市,香山區,埔前里,258,863,315,176,491,39,530
公投第１１案,新竹市,香山區,埔前里,259,1198,468,227,695,46,741
公投第１１案,新竹市,香山區,樹下里,260,1138,423,226,649,44,693
公投第１１案,新竹市,香山區,樹下里,261,957,424,190,614,35,649
公投第１１案,新竹市,香山區,浸水里,262,1348,530,223,753,51,804
公投第１１案,新竹市,香山區,浸水里,263,1023,425,213,638,51,689
公投第１１案,新竹市,香山區,虎林里,264,970,408,132,540,17,557
公投第１１案,新竹市,香山區,虎林里,265,1318,505,256,761,27,788
公投第１１案,新竹市,香山區,虎山里,266,1088,360,206,566,42,608
公投第１１案,新竹市,香山區,虎山里,267,903,309,135,444,17,461
公投第１１案,新竹市,香山區,虎山里,268,1012,381,184,565,32,597
公投第１１案,新竹市,香山區,虎山里,269,1014,394,149,543,30,573
公投第１１案,新竹市,香山區,虎山里,270,1238,492,219,711,25,736
公投第１１案,新竹市,香山區,港南里,271,1182,413,199,612,39,651
公投第１１案,新竹市,香山區,港南里,272,1331,580,222,802,52,854
公投第１１案,新竹市,香山區,東香里,273,976,386,229,615,17,632
公投第１１案,新竹市,香山區,東香里,274,834,287,157,444,19,463
公投第１１案,新竹市,香山區,東香里,275,919,353,148,501,32,533
公投第１１案,新竹市,香山區,東香里,276,1188,423,262,685,19,704
公投第１１案,新竹市,香山區,香村里,277,1086,409,198,607,32,639
公投第１１案,新竹市,香山區,香村里,278,1144,465,227,692,24,716
公投第１１案,新竹市,香山區,香村里,279,1112,437,199,636,26,662
公投第１１案,新竹市,香山區,香山里,280,1476,551,268,819,35,854
公投第１１案,新竹市,香山區,香山里,281,1291,479,235,714,22,736
公投第１１案,新竹市,香山區,香山里,282,1464,596,272,868,38,906
公投第１１案,新竹市,香山區,大庄里,283,1427,569,228,797,48,845
公投第１１案,新竹市,香山區,大庄里,284,1336,492,231,723,29,752
公投第１１案,新竹市,香山區,美山里,285,1131,347,179,526,33,559
公投第１１案,新竹市,香山區,朝山里,286,1070,415,203,618,33,651
公投第１１案,新竹市,香山區,朝山里,287,1006,346,233,579,39,618
公投第１１案,新竹市,香山區,海山里,288,1223,406,139,545,46,591
公投第１１案,新竹市,香山區,海山里,289,1119,388,203,591,36,627
公投第１１案,新竹市,香山區,鹽水里,290,1400,490,208,698,30,728
公投第１１案,新竹市,香山區,內湖里,291,1627,498,243,741,36,777
公投第１１案,新竹市,香山區,內湖里,292,1289,416,204,620,33,653
公投第１１案,新竹市,香山區,內湖里,293,1409,462,220,682,33,715
公投第１１案,新竹市,香山區,南港里,294,814,272,125,397,30,427
公投第１１案,新竹市,香山區,中隘里,295,719,244,135,379,24,403
公投第１１案,新竹市,香山區,中隘里,296,1065,334,170,504,16,520
公投第１１案,新竹市,香山區,南隘里,297,776,271,136,407,29,436
公投第１１案,新竹市,香山區,大湖里,298,890,319,160,479,32,511
公投第１１案,新竹市,香山區,茄苳里,299,896,294,146,440,23,463
公投第１１案,嘉義市,東區,短竹里,1,1025,381,197,578,16,594
公投第１１案,嘉義市,東區,短竹里,2,1276,462,214,676,21,697
公投第１１案,嘉義市,東區,蘭潭里,3,974,339,143,482,20,502
公投第１１案,嘉義市,東區,蘭潭里,4,1175,479,227,706,18,724
公投第１１案,嘉義市,東區,東川里,5,702,280,146,426,14,440
公投第１１案,嘉義市,東區,東川里,6,1092,302,285,587,22,609
公投第１１案,嘉義市,東區,鹿寮里,7,1023,317,162,479,16,495
公投第１１案,嘉義市,東區,盧厝里,8,1816,636,277,913,30,943
公投第１１案,嘉義市,東區,文雅里,9,1936,676,362,1038,33,1071
公投第１１案,嘉義市,東區,文雅里,10,1698,569,376,945,14,959
公投第１１案,嘉義市,東區,王田里,11,1221,480,243,723,12,735
公投第１１案,嘉義市,東區,王田里,12,1113,411,214,625,14,639
公投第１１案,嘉義市,東區,長竹里,13,1452,536,272,808,25,833
公投第１１案,嘉義市,東區,長竹里,14,1395,554,280,834,22,856
公投第１１案,嘉義市,東區,後庄里,15,1453,477,257,734,32,766
公投第１１案,嘉義市,東區,後庄里,16,1094,419,159,578,12,590
公投第１１案,嘉義市,東區,後庄里,17,1420,545,250,795,18,813
公投第１１案,嘉義市,東區,新店里,18,1552,597,290,887,28,915
公投第１１案,嘉義市,東區,新店里,19,1558,556,299,855,36,891
公投第１１案,嘉義市,東區,新店里,20,1062,434,179,613,19,632
公投第１１案,嘉義市,東區,圳頭里,21,1199,442,188,630,24,654
公投第１１案,嘉義市,東區,圳頭里,22,1236,503,175,678,20,698
公投第１１案,嘉義市,東區,圳頭里,23,890,335,155,490,13,503
公投第１１案,嘉義市,東區,圳頭里,24,880,353,159,512,25,537
公投第１１案,嘉義市,東區,中山里,25,1189,436,222,658,18,676
公投第１１案,嘉義市,東區,中山里,26,669,248,134,382,14,396
公投第１１案,嘉義市,東區,太平里,27,1435,503,263,766,23,789
公投第１１案,嘉義市,東區,太平里,28,1349,522,271,793,25,818
公投第１１案,嘉義市,東區,太平里,29,1455,410,338,748,27,775
公投第１１案,嘉義市,東區,東興里,30,915,335,175,510,24,534
公投第１１案,嘉義市,東區,東興里,31,952,352,188,540,15,555
公投第１１案,嘉義市,東區,華南里,32,941,341,170,511,21,532
公投第１１案,嘉義市,東區,華南里,33,1080,370,208,578,17,595
公投第１１案,嘉義市,東區,中央里,34,1157,423,170,593,22,615
公投第１１案,嘉義市,東區,中央里,35,1053,402,202,604,20,624
公投第１１案,嘉義市,東區,朝陽里,36,967,332,153,485,13,498
公投第１１案,嘉義市,東區,朝陽里,37,1091,379,190,569,19,588
公投第１１案,嘉義市,東區,民族里,38,961,381,170,551,32,583
公投第１１案,嘉義市,東區,民族里,39,863,233,116,349,13,362
公投第１１案,嘉義市,東區,過溝里,40,1023,389,190,579,37,616
公投第１１案,嘉義市,東區,過溝里,41,1078,420,189,609,39,648
公投第１１案,嘉義市,東區,新開里,42,938,350,165,515,9,524
公投第１１案,嘉義市,東區,新開里,43,1049,392,183,575,19,594
公投第１１案,嘉義市,東區,宣信里,44,1360,476,204,680,34,714
公投第１１案,嘉義市,東區,興南里,45,1615,546,234,780,39,819
公投第１１案,嘉義市,東區,豐年里,46,1267,447,209,656,26,682
公投第１１案,嘉義市,東區,芳草里,47,1579,513,222,735,37,772
公投第１１案,嘉義市,東區,芳草里,48,1831,596,303,899,44,943
公投第１１案,嘉義市,東區,芳安里,49,977,390,157,547,20,567
公投第１１案,嘉義市,東區,芳安里,50,1169,397,215,612,24,636
公投第１１案,嘉義市,東區,頂寮里,51,1238,452,245,697,47,744
公投第１１案,嘉義市,東區,頂寮里,52,1266,482,230,712,14,726
公投第１１案,嘉義市,東區,安寮里,53,1429,496,171,667,23,690
公投第１１案,嘉義市,東區,安寮里,54,1288,452,245,697,13,710
公投第１１案,嘉義市,東區,安業里,55,980,326,190,516,28,544
公投第１１案,嘉義市,東區,安業里,56,922,326,144,470,15,485
公投第１１案,嘉義市,東區,興村里,57,1133,437,198,635,33,668
公投第１１案,嘉義市,東區,興村里,58,1235,459,212,671,30,701
公投第１１案,嘉義市,東區,興村里,59,1525,524,294,818,15,833
公投第１１案,嘉義市,東區,興安里,60,1170,377,215,592,22,614
公投第１１案,嘉義市,東區,興安里,61,1177,469,243,712,29,741
公投第１１案,嘉義市,東區,興仁里,62,1207,465,201,666,22,688
公投第１１案,嘉義市,東區,興仁里,63,1272,477,208,685,32,717
公投第１１案,嘉義市,東區,興仁里,64,1188,418,203,621,56,677
公投第１１案,嘉義市,東區,北門里,65,1172,396,191,587,12,599
公投第１１案,嘉義市,東區,北門里,66,1020,384,199,583,20,603
公投第１１案,嘉義市,東區,林森里,67,1332,497,244,741,23,764
公投第１１案,嘉義市,東區,林森里,68,1011,414,191,605,20,625
公投第１１案,嘉義市,東區,中庄里,69,1682,580,263,843,42,885
公投第１１案,嘉義市,東區,中庄里,70,1567,600,232,832,33,865
公投第１１案,嘉義市,東區,頂庄里,71,1207,449,224,673,14,687
公投第１１案,嘉義市,東區,頂庄里,72,981,424,171,595,21,616
公投第１１案,嘉義市,東區,義教里,73,1395,493,246,739,17,756
公投第１１案,嘉義市,東區,義教里,74,1434,456,223,679,19,698
公投第１１案,嘉義市,東區,仁義里,75,1404,414,218,632,15,647
公投第１１案,嘉義市,東區,仁義里,76,1428,569,244,813,14,827
公投第１１案,嘉義市,東區,後湖里,77,1823,537,254,791,10,801
公投第１１案,嘉義市,東區,後湖里,78,1570,505,247,752,31,783
公投第１１案,嘉義市,東區,荖藤里,79,1282,473,218,691,27,718
公投第１１案,嘉義市,東區,荖藤里,80,1571,630,271,901,29,930
公投第１１案,嘉義市,東區,荖藤里,81,1533,519,256,775,21,796
公投第１１案,嘉義市,西區,書院里,82,885,339,142,481,15,496
公投第１１案,嘉義市,西區,書院里,83,1109,381,190,571,34,605
公投第１１案,嘉義市,西區,永和里,84,1020,369,162,531,21,552
公投第１１案,嘉義市,西區,永和里,85,925,395,160,555,27,582
公投第１１案,嘉義市,西區,新富里,86,1671,534,260,794,16,810
公投第１１案,嘉義市,西區,文化里,87,1215,483,198,681,19,700
公投第１１案,嘉義市,西區,文化里,88,1036,406,165,571,20,591
公投第１１案,嘉義市,西區,西榮里,89,1129,400,184,584,21,605
公投第１１案,嘉義市,西區,西榮里,90,1127,436,163,599,27,626
公投第１１案,嘉義市,西區,番社里,91,1415,551,247,798,24,822
公投第１１案,嘉義市,西區,國華里,92,1366,512,194,706,19,725
公投第１１案,嘉義市,西區,大溪里,93,1053,439,175,614,33,647
公投第１１案,嘉義市,西區,大溪里,94,1067,449,152,601,14,615
公投第１１案,嘉義市,西區,磚磘里,95,1575,505,243,748,31,779
公投第１１案,嘉義市,西區,磚磘里,96,1865,620,332,952,32,984
公投第１１案,嘉義市,西區,福全里,97,1196,404,198,602,31,633
公投第１１案,嘉義市,西區,福全里,98,1280,422,220,642,18,660
公投第１１案,嘉義市,西區,福全里,99,1629,566,277,843,34,877
公投第１１案,嘉義市,西區,福安里,100,1393,514,252,766,47,813
公投第１１案,嘉義市,西區,福安里,101,1077,421,206,627,30,657
公投第１１案,嘉義市,西區,福安里,102,1694,487,302,789,13,802
公投第１１案,嘉義市,西區,新西里,103,841,308,171,479,47,526
公投第１１案,嘉義市,西區,新西里,104,1183,409,189,598,4,602
公投第１１案,嘉義市,西區,港坪里,105,1000,405,201,606,23,629
公投第１１案,嘉義市,西區,港坪里,106,1095,466,197,663,17,680
公投第１１案,嘉義市,西區,港坪里,107,1256,471,268,739,34,773
公投第１１案,嘉義市,西區,頭港里,108,962,376,157,533,30,563
公投第１１案,嘉義市,西區,頭港里,109,865,357,194,551,12,563
公投第１１案,嘉義市,西區,西平里,110,1396,449,233,682,39,721
公投第１１案,嘉義市,西區,西平里,111,1799,519,427,946,45,991
公投第１１案,嘉義市,西區,劉厝里,112,1505,524,233,757,13,770
公投第１１案,嘉義市,西區,劉厝里,113,1698,625,257,882,41,923
公投第１１案,嘉義市,西區,劉厝里,114,1854,710,292,1002,18,1020
公投第１１案,嘉義市,西區,劉厝里,115,1537,462,229,691,8,699
公投第１１案,嘉義市,西區,自強里,116,1604,542,257,799,26,825
公投第１１案,嘉義市,西區,美源里,117,944,397,173,570,36,606
公投第１１案,嘉義市,西區,美源里,118,1627,644,255,899,37,936
公投第１１案,嘉義市,西區,美源里,119,1144,437,222,659,25,684
公投第１１案,嘉義市,西區,湖內里,120,1362,489,222,711,39,750
公投第１１案,嘉義市,西區,湖內里,121,1279,494,244,738,22,760
公投第１１案,嘉義市,西區,湖內里,122,1702,622,278,900,46,946
公投第１１案,嘉義市,西區,獅子里,123,1358,512,265,777,25,802
公投第１１案,嘉義市,西區,獅子里,124,1360,541,252,793,39,832
公投第１１案,嘉義市,西區,紅瓦里,125,1589,609,253,862,37,899
公投第１１案,嘉義市,西區,光路里,126,1280,513,227,740,32,772
公投第１１案,嘉義市,西區,光路里,127,1220,401,197,598,31,629
公投第１１案,嘉義市,西區,光路里,128,1172,475,210,685,16,701
公投第１１案,嘉義市,西區,光路里,129,1320,498,218,716,37,753
公投第１１案,嘉義市,西區,福民里,130,1185,516,234,750,27,777
公投第１１案,嘉義市,西區,福民里,131,1278,494,264,758,33,791
公投第１１案,嘉義市,西區,福民里,132,1394,400,219,619,13,632
公投第１１案,嘉義市,西區,福民里,133,1540,562,285,847,42,889
公投第１１案,嘉義市,西區,車店里,134,1548,577,266,843,32,875
公投第１１案,嘉義市,西區,車店里,135,1295,346,335,681,25,706
公投第１１案,嘉義市,西區,車店里,136,1318,521,239,760,39,799
公投第１１案,嘉義市,西區,車店里,137,1545,565,267,832,31,863
公投第１１案,嘉義市,西區,垂楊里,138,736,257,128,385,15,400
公投第１１案,嘉義市,西區,垂楊里,139,1168,423,181,604,20,624
公投第１１案,嘉義市,西區,培元里,140,756,344,144,488,12,500
公投第１１案,嘉義市,西區,培元里,141,869,374,118,492,13,505
公投第１１案,嘉義市,西區,育英里,142,983,364,185,549,37,586
公投第１１案,嘉義市,西區,育英里,143,828,339,125,464,16,480
公投第１１案,嘉義市,西區,致遠里,144,1775,646,300,946,32,978
公投第１１案,嘉義市,西區,翠岱里,145,1419,574,181,755,17,772
公投第１１案,嘉義市,西區,導明里,146,779,287,132,419,22,441
公投第１１案,嘉義市,西區,導明里,147,855,338,114,452,10,462
公投第１１案,嘉義市,西區,北榮里,148,1146,437,200,637,36,673
公投第１１案,嘉義市,西區,北榮里,149,1111,451,178,629,22,651
公投第１１案,嘉義市,西區,慶安里,150,767,340,138,478,19,497
公投第１１案,嘉義市,西區,慶安里,151,817,272,136,408,10,418
公投第１１案,嘉義市,西區,香湖里,152,770,284,154,438,15,453
公投第１１案,嘉義市,西區,重興里,153,1135,325,202,527,11,538
公投第１１案,嘉義市,西區,重興里,154,835,260,148,408,47,455
公投第１１案,嘉義市,西區,後驛里,155,1182,410,180,590,22,612
公投第１１案,嘉義市,西區,後驛里,156,944,342,132,474,25,499
公投第１１案,嘉義市,西區,湖邊里,157,997,349,166,515,21,536
公投第１１案,嘉義市,西區,湖邊里,158,1074,382,210,592,19,611
公投第１１案,嘉義市,西區,竹圍里,159,1460,405,236,641,23,664
公投第１１案,嘉義市,西區,竹圍里,160,1352,495,195,690,26,716
公投第１１案,嘉義市,西區,竹圍里,161,1499,505,285,790,24,814
公投第１１案,嘉義市,西區,保生里,162,1262,455,208,663,47,710
公投第１１案,嘉義市,西區,保生里,163,1299,468,217,685,28,713
公投第１１案,嘉義市,西區,保生里,164,1734,635,263,898,29,927
公投第１１案,嘉義市,西區,保安里,165,1674,574,234,808,29,837
公投第１１案,嘉義市,西區,保安里,166,1540,508,300,808,17,825
公投第１１案,嘉義市,西區,北新里,167,1056,428,209,637,9,646
公投第１１案,嘉義市,西區,新厝里,168,1467,561,260,821,44,865
公投第１１案,嘉義市,西區,新厝里,169,1431,484,227,711,39,750
公投第１１案,嘉義市,西區,新厝里,170,1234,512,221,733,43,776
公投第１１案,嘉義市,西區,保福里,171,1266,433,243,676,16,692
公投第１１案,嘉義市,西區,保福里,172,1211,478,222,700,14,714
公投第１１案,嘉義市,西區,保福里,173,1121,425,218,643,8,651
公投第１１案,嘉義市,西區,竹村里,174,1155,392,189,581,10,591
公投第１１案,嘉義市,西區,北湖里,175,1546,534,311,845,57,902
公投第１１案,嘉義市,西區,北湖里,176,1322,516,209,725,20,745
公投第１１案,嘉義市,西區,下埤里,177,1549,575,250,825,59,884
公投第１１案,臺北市,北投區,建民里,1,1313,483,273,756,48,804
公投第１１案,臺北市,北投區,建民里,2,1403,499,337,836,35,871
公投第１１案,臺北市,北投區,建民里,3,1081,375,259,634,29,663
公投第１１案,臺北市,北投區,文林里,4,1209,402,285,687,43,730
公投第１１案,臺北市,北投區,文林里,5,1326,449,320,769,25,794
公投第１１案,臺北市,北投區,文林里,6,1263,449,291,740,29,769
公投第１１案,臺北市,北投區,石牌里,7,1580,568,366,934,38,972
公投第１１案,臺北市,北投區,石牌里,8,1577,578,323,901,37,938
公投第１１案,臺北市,北投區,石牌里,9,1483,530,322,852,42,894
公投第１１案,臺北市,北投區,福興里,10,1461,505,293,798,32,830
公投第１１案,臺北市,北投區,福興里,11,1466,495,310,805,32,837
公投第１１案,臺北市,北投區,福興里,12,1620,639,302,941,30,971
公投第１１案,臺北市,北投區,福興里,13,1543,546,261,807,32,839
公投第１１案,臺北市,北投區,榮光里,14,1513,512,279,791,54,845
公投第１１案,臺北市,北投區,榮光里,15,1534,564,307,871,31,902
公投第１１案,臺北市,北投區,榮光里,16,1650,602,331,933,51,984
公投第１１案,臺北市,北投區,榮光里,17,1533,558,318,876,28,904
公投第１１案,臺北市,北投區,榮華里,18,1702,561,356,917,27,944
公投第１１案,臺北市,北投區,榮華里,19,1721,541,400,941,33,974
公投第１１案,臺北市,北投區,榮華里,20,1575,539,385,924,40,964
公投第１１案,臺北市,北投區,榮華里,21,1530,501,344,845,56,901
公投第１１案,臺北市,北投區,裕民里,22,1728,602,360,962,48,1010
公投第１１案,臺北市,北投區,裕民里,23,1702,602,326,928,42,970
公投第１１案,臺北市,北投區,裕民里,24,1696,552,363,915,44,959
公投第１１案,臺北市,北投區,裕民里,25,1684,518,260,778,23,801
公投第１１案,臺北市,北投區,振華里,26,1717,634,364,998,36,1034
公投第１１案,臺北市,北投區,振華里,27,1605,588,338,926,22,948
公投第１１案,臺北市,北投區,振華里,28,1723,644,311,955,37,992
公投第１１案,臺北市,北投區,振華里,29,1597,605,356,961,25,986
公投第１１案,臺北市,北投區,永和里,30,1700,606,349,955,23,978
公投第１１案,臺北市,北投區,永和里,31,1544,443,338,781,32,813
公投第１１案,臺北市,北投區,永和里,32,1635,536,321,857,24,881
公投第１１案,臺北市,北投區,永和里,33,1495,529,320,849,27,876
公投第１１案,臺北市,北投區,永和里,34,1619,569,345,914,33,947
公投第１１案,臺北市,北投區,永欣里,35,1683,522,401,923,32,955
公投第１１案,臺北市,北投區,永欣里,36,1662,559,301,860,36,896
公投第１１案,臺北市,北投區,永欣里,37,1850,574,323,897,22,919
公投第１１案,臺北市,北投區,永欣里,38,1674,487,358,845,24,869
公投第１１案,臺北市,北投區,永明里,39,1511,589,291,880,41,921
公投第１１案,臺北市,北投區,永明里,40,1393,497,284,781,12,793
公投第１１案,臺北市,北投區,永明里,41,1279,512,265,777,35,812
公投第１１案,臺北市,北投區,東華里,42,1122,368,238,606,33,639
公投第１１案,臺北市,北投區,東華里,43,1238,510,315,825,49,874
公投第１１案,臺北市,北投區,東華里,44,1477,557,316,873,45,918
公投第１１案,臺北市,北投區,吉利里,45,1495,560,313,873,37,910
公投第１１案,臺北市,北投區,吉利里,46,1469,577,330,907,29,936
公投第１１案,臺北市,北投區,吉利里,47,1462,589,252,841,24,865
公投第１１案,臺北市,北投區,吉利里,48,1431,530,277,807,37,844
公投第１１案,臺北市,北投區,吉慶里,49,1486,507,340,847,27,874
公投第１１案,臺北市,北投區,吉慶里,50,1449,544,303,847,39,886
公投第１１案,臺北市,北投區,吉慶里,51,1456,491,340,831,26,857
公投第１１案,臺北市,北投區,尊賢里,52,1311,487,257,744,25,769
公投第１１案,臺北市,北投區,尊賢里,53,1356,481,298,779,34,813
公投第１１案,臺北市,北投區,尊賢里,54,1338,481,267,748,38,786
公投第１１案,臺北市,北投區,立賢里,55,1525,546,311,857,26,883
公投第１１案,臺北市,北投區,立賢里,56,1620,527,337,864,28,892
公投第１１案,臺北市,北投區,立賢里,57,1499,527,269,796,16,812
公投第１１案,臺北市,北投區,立農里,58,1497,605,284,889,24,913
公投第１１案,臺北市,北投區,立農里,59,1624,557,332,889,33,922
公投第１１案,臺北市,北投區,立農里,60,1536,488,305,793,51,844
公投第１１案,臺北市,北投區,立農里,61,1469,545,310,855,44,899
公投第１１案,臺北市,北投區,立農里,62,1598,544,314,858,31,889
公投第１１案,臺北市,北投區,八仙里,63,1690,553,350,903,35,938
公投第１１案,臺北市,北投區,八仙里,64,1599,528,319,847,66,913
公投第１１案,臺北市,北投區,八仙里,65,1634,529,370,899,34,933
公投第１１案,臺北市,北投區,洲美里,66,1660,522,321,843,44,887
公投第１１案,臺北市,北投區,奇岩里,67,1900,595,365,960,44,1004
公投第１１案,臺北市,北投區,奇岩里,68,1797,597,380,977,52,1029
公投第１１案,臺北市,北投區,奇岩里,69,1832,601,420,1021,46,1067
公投第１１案,臺北市,北投區,奇岩里,70,1784,631,366,997,51,1048
公投第１１案,臺北市,北投區,奇岩里,71,1732,601,273,874,38,912
公投第１１案,臺北市,北投區,清江里,72,2035,319,200,519,40,559
公投第１１案,臺北市,北投區,清江里,73,1504,511,299,810,38,848
公投第１１案,臺北市,北投區,清江里,74,1683,617,325,942,55,997
公投第１１案,臺北市,北投區,清江里,75,1635,532,323,855,55,910
公投第１１案,臺北市,北投區,清江里,76,1613,554,314,868,45,913
公投第１１案,臺北市,北投區,中央里,77,1483,526,267,793,33,826
公投第１１案,臺北市,北投區,中央里,78,1500,527,300,827,32,859
公投第１１案,臺北市,北投區,中央里,79,1483,499,330,829,37,866
公投第１１案,臺北市,北投區,中央里,80,1544,514,321,835,43,878
公投第１１案,臺北市,北投區,中央里,81,1532,448,278,726,42,768
公投第１１案,臺北市,北投區,長安里,82,1819,603,366,969,52,1021
公投第１１案,臺北市,北投區,長安里,83,1863,553,385,938,38,976
公投第１１案,臺北市,北投區,長安里,84,1872,554,360,914,19,933
公投第１１案,臺北市,北投區,大同里,85,1627,557,304,861,44,905
公投第１１案,臺北市,北投區,大同里,86,1696,556,326,882,27,909
公投第１１案,臺北市,北投區,大同里,87,1841,582,399,981,43,1024
公投第１１案,臺北市,北投區,溫泉里,88,1324,449,278,727,35,762
公投第１１案,臺北市,北投區,溫泉里,89,1504,506,288,794,30,824
公投第１１案,臺北市,北投區,溫泉里,90,1511,517,310,827,36,863
公投第１１案,臺北市,北投區,溫泉里,91,1615,549,380,929,26,955
公投第１１案,臺北市,北投區,林泉里,92,1270,408,235,643,32,675
公投第１１案,臺北市,北投區,林泉里,93,1492,433,289,722,25,747
公投第１１案,臺北市,北投區,中心里,94,1429,437,309,746,21,767
公投第１１案,臺北市,北投區,中心里,95,1567,489,320,809,16,825
公投第１１案,臺北市,北投區,中心里,96,1388,480,286,766,29,795
公投第１１案,臺北市,北投區,中心里,97,1448,460,284,744,16,760
公投第１１案,臺北市,北投區,中庸里,98,1356,454,250,704,31,735
公投第１１案,臺北市,北投區,中庸里,99,1308,476,237,713,19,732
公投第１１案,臺北市,北投區,中庸里,100,1165,424,260,684,29,713
公投第１１案,臺北市,北投區,開明里,101,1429,553,266,819,45,864
公投第１１案,臺北市,北投區,開明里,102,1472,526,262,788,21,809
公投第１１案,臺北市,北投區,開明里,103,1508,555,353,908,38,946
公投第１１案,臺北市,北投區,開明里,104,1480,534,278,812,37,849
公投第１１案,臺北市,北投區,中和里,105,1142,363,238,601,27,628
公投第１１案,臺北市,北投區,中和里,106,1554,521,287,808,24,832
公投第１１案,臺北市,北投區,中和里,107,1669,601,331,932,55,987
公投第１１案,臺北市,北投區,智仁里,108,1823,664,308,972,49,1021
公投第１１案,臺北市,北投區,智仁里,109,1739,564,341,905,51,956
公投第１１案,臺北市,北投區,智仁里,110,1771,609,333,942,42,984
公投第１１案,臺北市,北投區,秀山里,111,1468,494,235,729,40,769
公投第１１案,臺北市,北投區,秀山里,112,1469,510,303,813,27,840
公投第１１案,臺北市,北投區,文化里,113,1094,464,228,692,21,713
公投第１１案,臺北市,北投區,文化里,114,1101,484,193,677,25,702
公投第１１案,臺北市,北投區,文化里,115,1422,537,298,835,34,869
公投第１１案,臺北市,北投區,豐年里,116,1390,520,232,752,29,781
公投第１１案,臺北市,北投區,豐年里,117,1307,501,249,750,35,785
公投第１１案,臺北市,北投區,豐年里,118,1215,442,284,726,46,772
公投第１１案,臺北市,北投區,稻香里,119,1642,552,315,867,27,894
公投第１１案,臺北市,北投區,稻香里,120,1623,551,281,832,36,868
公投第１１案,臺北市,北投區,稻香里,121,1621,565,285,850,44,894
公投第１１案,臺北市,北投區,桃源里,122,1367,454,302,756,17,773
公投第１１案,臺北市,北投區,桃源里,123,1309,420,275,695,34,729
公投第１１案,臺北市,北投區,桃源里,124,1356,477,310,787,29,816
公投第１１案,臺北市,北投區,桃源里,125,1365,461,280,741,37,778
公投第１１案,臺北市,北投區,一德里,126,1613,504,353,857,29,886
公投第１１案,臺北市,北投區,一德里,127,1590,483,297,780,30,810
公投第１１案,臺北市,北投區,一德里,128,1662,594,329,923,44,967
公投第１１案,臺北市,北投區,一德里,129,1622,545,358,903,34,937
公投第１１案,臺北市,北投區,關渡里,130,1820,573,401,974,33,1007
公投第１１案,臺北市,北投區,關渡里,131,1615,583,317,900,50,950
公投第１１案,臺北市,北投區,關渡里,132,1612,487,232,719,40,759
公投第１１案,臺北市,北投區,關渡里,133,1652,538,336,874,53,927
公投第１１案,臺北市,北投區,關渡里,134,1666,592,346,938,17,955
公投第１１案,臺北市,北投區,關渡里,135,1641,559,307,866,37,903
公投第１１案,臺北市,北投區,泉源里,136,528,179,131,310,14,324
公投第１１案,臺北市,北投區,泉源里,137,1642,442,291,733,54,787
公投第１１案,臺北市,北投區,湖山里,138,829,300,143,443,28,471
公投第１１案,臺北市,北投區,湖山里,139,690,244,110,354,25,379
公投第１１案,臺北市,北投區,大屯里,140,1067,369,186,555,33,588
公投第１１案,臺北市,北投區,湖田里,141,892,291,161,452,55,507
公投第１１案,臺北市,士林區,仁勇里,142,1695,573,338,911,55,966
公投第１１案,臺北市,士林區,仁勇里,143,1720,628,352,980,55,1035
公投第１１案,臺北市,士林區,義信里,144,1288,444,263,707,43,750
公投第１１案,臺北市,士林區,義信里,145,1546,526,322,848,34,882
公投第１１案,臺北市,士林區,福林里,146,652,247,147,394,21,415
公投第１１案,臺北市,士林區,福林里,147,870,277,180,457,24,481
公投第１１案,臺北市,士林區,福林里,148,1137,411,267,678,34,712
公投第１１案,臺北市,士林區,福德里,149,1050,417,219,636,30,666
公投第１１案,臺北市,士林區,福德里,150,1031,396,215,611,33,644
公投第１１案,臺北市,士林區,福德里,151,1075,388,237,625,22,647
公投第１１案,臺北市,士林區,福德里,152,2175,302,193,495,29,524
公投第１１案,臺北市,士林區,福志里,153,1775,564,337,901,48,949
公投第１１案,臺北市,士林區,福志里,154,1669,616,345,961,25,986
公投第１１案,臺北市,士林區,福志里,155,1665,591,383,974,42,1016
公投第１１案,臺北市,士林區,福志里,156,1648,601,379,980,45,1025
公投第１１案,臺北市,士林區,舊佳里,157,1246,487,229,716,19,735
公投第１１案,臺北市,士林區,舊佳里,158,1419,485,293,778,42,820
公投第１１案,臺北市,士林區,舊佳里,159,1327,444,284,728,46,774
公投第１１案,臺北市,士林區,舊佳里,160,1573,565,376,941,41,982
公投第１１案,臺北市,士林區,福佳里,161,1470,544,280,824,50,874
公投第１１案,臺北市,士林區,福佳里,162,1775,655,358,1013,32,1045
公投第１１案,臺北市,士林區,福佳里,163,1692,588,383,971,31,1002
公投第１１案,臺北市,士林區,福佳里,164,1842,670,369,1039,45,1084
公投第１１案,臺北市,士林區,後港里,165,1166,467,224,691,28,719
公投第１１案,臺北市,士林區,後港里,166,1687,535,302,837,40,877
公投第１１案,臺北市,士林區,後港里,167,1624,565,333,898,38,936
公投第１１案,臺北市,士林區,後港里,168,1477,547,330,877,51,928
公投第１１案,臺北市,士林區,後港里,169,1250,478,274,752,28,780
公投第１１案,臺北市,士林區,福中里,170,1434,480,340,820,40,860
公投第１１案,臺北市,士林區,福中里,171,1452,514,327,841,36,877
公投第１１案,臺北市,士林區,福中里,172,1533,586,330,916,40,956
公投第１１案,臺北市,士林區,福中里,173,1515,573,316,889,45,934
公投第１１案,臺北市,士林區,前港里,174,1203,425,283,708,26,734
公投第１１案,臺北市,士林區,前港里,175,1487,552,327,879,49,928
公投第１１案,臺北市,士林區,前港里,176,1252,479,251,730,19,749
公投第１１案,臺北市,士林區,百齡里,177,1536,544,303,847,40,887
公投第１１案,臺北市,士林區,百齡里,178,1556,600,319,919,33,952
公投第１１案,臺北市,士林區,百齡里,179,1511,529,349,878,28,906
公投第１１案,臺北市,士林區,百齡里,180,1572,564,368,932,37,969
公投第１１案,臺北市,士林區,承德里,181,1668,592,325,917,56,973
公投第１１案,臺北市,士林區,承德里,182,1685,588,326,914,55,969
公投第１１案,臺北市,士林區,承德里,183,1568,515,350,865,38,903
公投第１１案,臺北市,士林區,福華里,184,1327,460,248,708,26,734
公投第１１案,臺北市,士林區,福華里,185,1338,461,257,718,30,748
公投第１１案,臺北市,士林區,福華里,186,1515,483,278,761,43,804
公投第１１案,臺北市,士林區,福華里,187,1452,511,294,805,45,850
公投第１１案,臺北市,士林區,明勝里,188,1448,505,320,825,27,852
公投第１１案,臺北市,士林區,明勝里,189,1521,548,331,879,38,917
公投第１１案,臺北市,士林區,明勝里,190,1461,538,303,841,18,859
公投第１１案,臺北市,士林區,福順里,191,1541,466,307,773,67,840
公投第１１案,臺北市,士林區,福順里,192,1611,448,290,738,31,769
公投第１１案,臺北市,士林區,福順里,193,1595,508,301,809,49,858
公投第１１案,臺北市,士林區,富光里,194,1685,565,290,855,30,885
公投第１１案,臺北市,士林區,富光里,195,1816,594,347,941,48,989
公投第１１案,臺北市,士林區,富光里,196,1687,582,334,916,42,958
公投第１１案,臺北市,士林區,葫蘆里,197,1646,581,308,889,47,936
公投第１１案,臺北市,士林區,葫蘆里,198,1643,537,321,858,33,891
公投第１１案,臺北市,士林區,葫蘆里,199,1687,606,351,957,29,986
公投第１１案,臺北市,士林區,葫蘆里,200,1655,667,226,893,45,938
公投第１１案,臺北市,士林區,葫東里,201,1779,543,377,920,25,945
公投第１１案,臺北市,士林區,葫東里,202,1855,633,412,1045,43,1088
公投第１１案,臺北市,士林區,社子里,203,1350,463,290,753,35,788
公投第１１案,臺北市,士林區,社子里,204,1455,500,241,741,24,765
公投第１１案,臺北市,士林區,社子里,205,1497,398,283,681,40,721
公投第１１案,臺北市,士林區,社子里,206,1398,400,245,645,26,671
公投第１１案,臺北市,士林區,社新里,207,1747,620,362,982,50,1032
公投第１１案,臺北市,士林區,社新里,208,1465,490,249,739,45,784
公投第１１案,臺北市,士林區,社新里,209,1530,502,304,806,42,848
公投第１１案,臺北市,士林區,社新里,210,1855,587,344,931,46,977
公投第１１案,臺北市,士林區,社新里,211,1444,491,298,789,44,833
公投第１１案,臺北市,士林區,社園里,212,1563,501,294,795,37,832
公投第１１案,臺北市,士林區,社園里,213,1482,538,276,814,44,858
公投第１１案,臺北市,士林區,社園里,214,1552,504,303,807,59,866
公投第１１案,臺北市,士林區,社園里,215,1790,631,342,973,42,1015
公投第１１案,臺北市,士林區,永倫里,216,1628,522,280,802,55,857
公投第１１案,臺北市,士林區,永倫里,217,1337,450,266,716,45,761
公投第１１案,臺北市,士林區,永倫里,218,1750,614,339,953,40,993
公投第１１案,臺北市,士林區,永倫里,219,1668,532,313,845,65,910
公投第１１案,臺北市,士林區,福安里,220,1403,392,232,624,53,677
公投第１１案,臺北市,士林區,福安里,221,1468,393,277,670,34,704
公投第１１案,臺北市,士林區,福安里,222,1471,461,242,703,33,736
公投第１１案,臺北市,士林區,富洲里,223,1666,538,279,817,56,873
公投第１１案,臺北市,士林區,富洲里,224,1587,493,297,790,4,794
公投第１１案,臺北市,士林區,富洲里,225,1987,563,339,902,57,959
公投第１１案,臺北市,士林區,岩山里,226,1271,418,226,644,20,664
公投第１１案,臺北市,士林區,岩山里,227,1728,610,392,1002,39,1041
公投第１１案,臺北市,士林區,名山里,228,1630,613,321,934,47,981
公投第１１案,臺北市,士林區,名山里,229,1619,573,360,933,34,967
公投第１１案,臺北市,士林區,名山里,230,1425,499,305,804,34,838
公投第１１案,臺北市,士林區,名山里,231,1623,588,377,965,36,1001
公投第１１案,臺北市,士林區,聖山里,232,1564,544,340,884,39,923
公投第１１案,臺北市,士林區,聖山里,233,1376,509,350,859,34,893
公投第１１案,臺北市,士林區,聖山里,234,1517,592,321,913,26,939
公投第１１案,臺北市,士林區,芝山里,235,1729,565,331,896,27,923
公投第１１案,臺北市,士林區,芝山里,236,1511,563,323,886,44,930
公投第１１案,臺北市,士林區,芝山里,237,1811,715,345,1060,26,1086
公投第１１案,臺北市,士林區,芝山里,238,1533,537,351,888,19,907
公投第１１案,臺北市,士林區,東山里,239,1657,649,387,1036,41,1077
公投第１１案,臺北市,士林區,東山里,240,1499,517,316,833,28,861
公投第１１案,臺北市,士林區,東山里,241,1402,535,233,768,43,811
公投第１１案,臺北市,士林區,德行里,242,1273,456,323,779,51,830
公投第１１案,臺北市,士林區,德行里,243,1273,453,289,742,28,770
公投第１１案,臺北市,士林區,德行里,244,1316,459,293,752,26,778
公投第１１案,臺北市,士林區,德華里,245,1659,565,350,915,51,966
公投第１１案,臺北市,士林區,德華里,246,1749,553,398,951,40,991
公投第１１案,臺北市,士林區,德華里,247,1552,516,321,837,47,884
公投第１１案,臺北市,士林區,忠誠里,248,1529,593,281,874,37,911
公投第１１案,臺北市,士林區,忠誠里,249,1644,590,299,889,28,917
公投第１１案,臺北市,士林區,忠誠里,250,1779,626,350,976,38,1014
公投第１１案,臺北市,士林區,蘭雅里,251,1597,545,342,887,26,913
公投第１１案,臺北市,士林區,蘭雅里,252,1454,480,323,803,35,838
公投第１１案,臺北市,士林區,蘭雅里,253,1582,516,410,926,52,978
公投第１１案,臺北市,士林區,蘭雅里,254,1518,540,339,879,37,916
公投第１１案,臺北市,士林區,蘭雅里,255,1501,462,324,786,27,813
公投第１１案,臺北市,士林區,蘭興里,256,1420,515,314,829,32,861
公投第１１案,臺北市,士林區,蘭興里,257,1494,511,328,839,39,878
公投第１１案,臺北市,士林區,蘭興里,258,1568,581,376,957,32,989
公投第１１案,臺北市,士林區,蘭興里,259,1208,417,307,724,42,766
公投第１１案,臺北市,士林區,三玉里,260,1826,636,369,1005,31,1036
公投第１１案,臺北市,士林區,三玉里,261,1647,534,381,915,36,951
公投第１１案,臺北市,士林區,三玉里,262,1654,547,355,902,44,946
公投第１１案,臺北市,士林區,天福里,263,1550,541,357,898,41,939
公投第１１案,臺北市,士林區,天福里,264,1298,454,340,794,30,824
公投第１１案,臺北市,士林區,天福里,265,1297,490,300,790,31,821
公投第１１案,臺北市,士林區,天福里,266,1352,440,291,731,36,767
公投第１１案,臺北市,士林區,天祿里,267,1522,517,327,844,36,880
公投第１１案,臺北市,士林區,天祿里,268,1602,483,384,867,56,923
公投第１１案,臺北市,士林區,天祿里,269,1441,483,326,809,32,841
公投第１１案,臺北市,士林區,天壽里,270,1325,417,294,711,12,723
公投第１１案,臺北市,士林區,天壽里,271,1567,532,334,866,41,907
公投第１１案,臺北市,士林區,天壽里,272,1518,505,320,825,25,850
公投第１１案,臺北市,士林區,天和里,273,1549,542,370,912,37,949
公投第１１案,臺北市,士林區,天和里,274,1652,533,396,929,26,955
公投第１１案,臺北市,士林區,天和里,275,1766,622,383,1005,51,1056
公投第１１案,臺北市,士林區,天和里,276,1638,526,369,895,20,915
公投第１１案,臺北市,士林區,天山里,277,1491,564,305,869,27,896
公投第１１案,臺北市,士林區,天山里,278,1521,530,339,869,27,896
公投第１１案,臺北市,士林區,天山里,279,1351,504,288,792,35,827
公投第１１案,臺北市,士林區,天山里,280,1742,548,372,920,20,940
公投第１１案,臺北市,士林區,天玉里,281,1585,524,355,879,34,913
公投第１１案,臺北市,士林區,天玉里,282,1521,565,295,860,34,894
公投第１１案,臺北市,士林區,天玉里,283,1543,494,351,845,19,864
公投第１１案,臺北市,士林區,天玉里,284,1404,515,306,821,21,842
公投第１１案,臺北市,士林區,天玉里,285,1541,536,325,861,33,894
公投第１１案,臺北市,士林區,天母里,286,1584,546,299,845,40,885
公投第１１案,臺北市,士林區,天母里,287,1519,519,351,870,41,911
公投第１１案,臺北市,士林區,天母里,288,1482,470,296,766,17,783
公投第１１案,臺北市,士林區,天母里,289,1243,407,272,679,37,716
公投第１１案,臺北市,士林區,永福里,290,1156,424,206,630,34,664
公投第１１案,臺北市,士林區,公館里,291,1262,384,254,638,47,685
公投第１１案,臺北市,士林區,新安里,292,889,314,187,501,32,533
公投第１１案,臺北市,士林區,新安里,293,858,291,207,498,32,530
公投第１１案,臺北市,士林區,陽明里,294,945,293,200,493,46,539
公投第１１案,臺北市,士林區,陽明里,295,960,295,199,494,42,536
公投第１１案,臺北市,士林區,陽明里,296,876,299,161,460,37,497
公投第１１案,臺北市,士林區,菁山里,297,556,200,137,337,30,367
公投第１１案,臺北市,士林區,菁山里,298,919,344,190,534,41,575
公投第１１案,臺北市,士林區,平等里,299,1360,543,298,841,63,904
公投第１１案,臺北市,士林區,溪山里,300,1355,517,273,790,45,835
公投第１１案,臺北市,士林區,翠山里,301,1252,450,272,722,24,746
公投第１１案,臺北市,士林區,翠山里,302,1182,473,232,705,38,743
公投第１１案,臺北市,士林區,臨溪里,303,1431,232,446,678,27,705
公投第１１案,臺北市,士林區,臨溪里,304,1240,409,236,645,37,682
公投第１１案,臺北市,內湖區,西湖里,305,1661,550,315,865,18,883
公投第１１案,臺北市,內湖區,西湖里,306,1602,525,334,859,38,897
公投第１１案,臺北市,內湖區,西湖里,307,1655,633,342,975,40,1015
公投第１１案,臺北市,內湖區,西湖里,308,1582,550,382,932,35,967
公投第１１案,臺北市,內湖區,西康里,309,1688,543,370,913,31,944
公投第１１案,臺北市,內湖區,西康里,310,1737,569,389,958,46,1004
公投第１１案,臺北市,內湖區,西康里,311,1809,634,401,1035,31,1066
公投第１１案,臺北市,內湖區,西康里,312,1376,482,283,765,23,788
公投第１１案,臺北市,內湖區,西康里,313,1747,643,364,1007,59,1066
公投第１１案,臺北市,內湖區,西安里,314,1389,516,322,838,18,856
公投第１１案,臺北市,內湖區,西安里,315,1454,542,337,879,35,914
公投第１１案,臺北市,內湖區,西安里,316,1468,529,378,907,31,938
公投第１１案,臺北市,內湖區,西安里,317,1603,625,352,977,33,1010
公投第１１案,臺北市,內湖區,港墘里,318,1795,618,379,997,21,1018
公投第１１案,臺北市,內湖區,港墘里,319,1737,655,403,1058,36,1094
公投第１１案,臺北市,內湖區,港墘里,320,1744,634,379,1013,38,1051
公投第１１案,臺北市,內湖區,港都里,321,1661,598,346,944,38,982
公投第１１案,臺北市,內湖區,港都里,322,1577,513,362,875,34,909
公投第１１案,臺北市,內湖區,港都里,323,1494,580,325,905,17,922
公投第１１案,臺北市,內湖區,港富里,324,1626,589,341,930,29,959
公投第１１案,臺北市,內湖區,港富里,325,1641,584,353,937,39,976
公投第１１案,臺北市,內湖區,港富里,326,1554,545,342,887,32,919
公投第１１案,臺北市,內湖區,港富里,327,1728,710,318,1028,40,1068
公投第１１案,臺北市,內湖區,港富里,328,1736,614,339,953,31,984
公投第１１案,臺北市,內湖區,港華里,329,1461,559,346,905,35,940
公投第１１案,臺北市,內湖區,港華里,330,1509,574,297,871,26,897
公投第１１案,臺北市,內湖區,港華里,331,1358,462,306,768,15,783
公投第１１案,臺北市,內湖區,港華里,332,1761,607,377,984,24,1008
公投第１１案,臺北市,內湖區,港華里,333,1651,573,360,933,34,967
公投第１１案,臺北市,內湖區,內湖里,334,1809,644,387,1031,49,1080
公投第１１案,臺北市,內湖區,內湖里,335,1773,609,380,989,42,1031
公投第１１案,臺北市,內湖區,內湖里,336,1890,670,359,1029,39,1068
公投第１１案,臺北市,內湖區,湖濱里,337,1760,647,438,1085,39,1124
公投第１１案,臺北市,內湖區,湖濱里,338,1645,605,350,955,27,982
公投第１１案,臺北市,內湖區,湖濱里,339,1324,507,309,816,18,834
公投第１１案,臺北市,內湖區,湖濱里,340,1072,438,204,642,22,664
公投第１１案,臺北市,內湖區,湖濱里,341,1509,520,313,833,30,863
公投第１１案,臺北市,內湖區,紫星里,342,1715,610,370,980,31,1011
公投第１１案,臺北市,內湖區,紫星里,343,1774,655,270,925,34,959
公投第１１案,臺北市,內湖區,紫星里,344,1796,710,387,1097,31,1128
公投第１１案,臺北市,內湖區,紫星里,345,1784,641,355,996,31,1027
公投第１１案,臺北市,內湖區,大湖里,346,1417,494,343,837,50,887
公投第１１案,臺北市,內湖區,大湖里,347,1699,529,431,960,20,980
公投第１１案,臺北市,內湖區,大湖里,348,1719,633,421,1054,29,1083
公投第１１案,臺北市,內湖區,金龍里,349,1715,603,393,996,21,1017
公投第１１案,臺北市,內湖區,金龍里,350,1634,510,344,854,24,878
公投第１１案,臺北市,內湖區,金龍里,351,1435,528,253,781,37,818
公投第１１案,臺北市,內湖區,金瑞里,352,1440,525,292,817,19,836
公投第１１案,臺北市,內湖區,金瑞里,353,1446,534,337,871,28,899
公投第１１案,臺北市,內湖區,金瑞里,354,1657,541,320,861,42,903
公投第１１案,臺北市,內湖區,金瑞里,355,1261,457,285,742,39,781
公投第１１案,臺北市,內湖區,碧山里,356,456,144,78,222,17,239
公投第１１案,臺北市,內湖區,碧山里,357,1433,559,361,920,25,945
公投第１１案,臺北市,內湖區,碧山里,358,1485,525,348,873,26,899
公投第１１案,臺北市,內湖區,碧山里,359,1590,567,329,896,24,920
公投第１１案,臺北市,內湖區,碧山里,360,1219,477,276,753,43,796
公投第１１案,臺北市,內湖區,紫雲里,361,1732,608,317,925,44,969
公投第１１案,臺北市,內湖區,紫雲里,362,1727,659,334,993,29,1022
公投第１１案,臺北市,內湖區,紫雲里,363,1637,604,331,935,34,969
公投第１１案,臺北市,內湖區,清白里,364,1453,500,312,812,31,843
公投第１１案,臺北市,內湖區,清白里,365,1617,584,321,905,19,924
公投第１１案,臺北市,內湖區,清白里,366,1604,546,338,884,21,905
公投第１１案,臺北市,內湖區,清白里,367,1406,535,346,881,19,900
公投第１１案,臺北市,內湖區,清白里,368,1353,479,323,802,27,829
公投第１１案,臺北市,內湖區,葫洲里,369,1724,647,371,1018,28,1046
公投第１１案,臺北市,內湖區,葫洲里,370,1378,493,328,821,20,841
公投第１１案,臺北市,內湖區,葫洲里,371,1403,536,311,847,20,867
公投第１１案,臺北市,內湖區,葫洲里,372,1547,522,333,855,25,880
公投第１１案,臺北市,內湖區,紫陽里,373,1718,606,412,1018,27,1045
公投第１１案,臺北市,內湖區,紫陽里,374,1813,606,403,1009,34,1043
公投第１１案,臺北市,內湖區,紫陽里,375,1791,692,367,1059,43,1102
公投第１１案,臺北市,內湖區,紫陽里,376,1855,667,432,1099,38,1137
公投第１１案,臺北市,內湖區,瑞陽里,377,1731,668,345,1013,18,1031
公投第１１案,臺北市,內湖區,瑞陽里,378,1593,610,381,991,32,1023
公投第１１案,臺北市,內湖區,瑞陽里,379,1869,647,329,976,41,1017
公投第１１案,臺北市,內湖區,瑞陽里,380,1687,623,358,981,41,1022
公投第１１案,臺北市,內湖區,瑞光里,381,1530,567,340,907,18,925
公投第１１案,臺北市,內湖區,瑞光里,382,1300,496,278,774,29,803
公投第１１案,臺北市,內湖區,瑞光里,383,1314,541,267,808,38,846
公投第１１案,臺北市,內湖區,五分里,384,1433,458,291,749,20,769
公投第１１案,臺北市,內湖區,五分里,385,1450,478,298,776,23,799
公投第１１案,臺北市,內湖區,五分里,386,1608,525,359,884,47,931
公投第１１案,臺北市,內湖區,五分里,387,1414,484,325,809,37,846
公投第１１案,臺北市,內湖區,五分里,388,1492,520,348,868,23,891
公投第１１案,臺北市,內湖區,五分里,389,1528,511,342,853,19,872
公投第１１案,臺北市,內湖區,東湖里,390,1692,587,362,949,35,984
公投第１１案,臺北市,內湖區,東湖里,391,1556,538,331,869,51,920
公投第１１案,臺北市,內湖區,東湖里,392,1637,547,354,901,22,923
公投第１１案,臺北市,內湖區,東湖里,393,1749,652,287,939,29,968
公投第１１案,臺北市,內湖區,樂康里,394,1220,422,240,662,19,681
公投第１１案,臺北市,內湖區,樂康里,395,1600,560,329,889,43,932
公投第１１案,臺北市,內湖區,樂康里,396,1473,506,324,830,25,855
公投第１１案,臺北市,內湖區,樂康里,397,1498,482,333,815,47,862
公投第１１案,臺北市,內湖區,樂康里,398,1557,530,340,870,29,899
公投第１１案,臺北市,內湖區,內溝里,399,1674,528,332,860,38,898
公投第１１案,臺北市,內湖區,內溝里,400,1728,623,375,998,41,1039
公投第１１案,臺北市,內湖區,內溝里,401,788,234,143,377,26,403
公投第１１案,臺北市,內湖區,週美里,402,1542,490,340,830,38,868
公投第１１案,臺北市,內湖區,週美里,403,1676,460,334,794,51,845
公投第１１案,臺北市,內湖區,週美里,404,1360,435,277,712,18,730
公投第１１案,臺北市,內湖區,週美里,405,1259,501,279,780,21,801
公投第１１案,臺北市,內湖區,週美里,406,1301,479,237,716,14,730
公投第１１案,臺北市,內湖區,行善里,407,1251,381,239,620,28,648
公投第１１案,臺北市,內湖區,行善里,408,1502,515,299,814,44,858
公投第１１案,臺北市,內湖區,行善里,409,1596,572,304,876,30,906
公投第１１案,臺北市,內湖區,行善里,410,1649,586,346,932,18,950
公投第１１案,臺北市,內湖區,石潭里,411,1774,598,347,945,37,982
公投第１１案,臺北市,內湖區,石潭里,412,1746,596,340,936,26,962
公投第１１案,臺北市,內湖區,湖興里,413,1473,498,313,811,19,830
公投第１１案,臺北市,內湖區,湖興里,414,2824,560,377,937,34,971
公投第１１案,臺北市,內湖區,湖興里,415,1849,547,404,951,24,975
公投第１１案,臺北市,內湖區,湖興里,416,1530,499,320,819,40,859
公投第１１案,臺北市,內湖區,湖元里,417,1656,561,402,963,31,994
公投第１１案,臺北市,內湖區,湖元里,418,1457,503,339,842,25,867
公投第１１案,臺北市,內湖區,湖元里,419,1695,641,350,991,28,1019
公投第１１案,臺北市,內湖區,安湖里,420,1663,600,355,955,29,984
公投第１１案,臺北市,內湖區,安湖里,421,1654,602,320,922,30,952
公投第１１案,臺北市,內湖區,安湖里,422,1642,566,393,959,28,987
公投第１１案,臺北市,內湖區,安湖里,423,1685,570,395,965,18,983
公投第１１案,臺北市,內湖區,秀湖里,424,1862,666,365,1031,30,1061
公投第１１案,臺北市,內湖區,秀湖里,425,1900,672,431,1103,43,1146
公投第１１案,臺北市,內湖區,秀湖里,426,1790,706,399,1105,36,1141
公投第１１案,臺北市,內湖區,安泰里,427,1417,465,317,782,27,809
公投第１１案,臺北市,內湖區,安泰里,428,1694,486,446,932,37,969
公投第１１案,臺北市,內湖區,安泰里,429,1676,562,320,882,40,922
公投第１１案,臺北市,內湖區,金湖里,430,1643,542,378,920,14,934
公投第１１案,臺北市,內湖區,金湖里,431,1588,539,369,908,25,933
公投第１１案,臺北市,內湖區,金湖里,432,1603,565,341,906,53,959
公投第１１案,臺北市,內湖區,金湖里,433,1629,574,364,938,17,955
公投第１１案,臺北市,內湖區,金湖里,434,1646,607,378,985,33,1018
公投第１１案,臺北市,內湖區,康寧里,435,1883,660,363,1023,22,1045
公投第１１案,臺北市,內湖區,康寧里,436,1434,499,309,808,26,834
公投第１１案,臺北市,內湖區,康寧里,437,1418,500,307,807,17,824
公投第１１案,臺北市,內湖區,康寧里,438,1373,502,293,795,33,828
公投第１１案,臺北市,內湖區,康寧里,439,1349,505,285,790,29,819
公投第１１案,臺北市,內湖區,明湖里,440,1511,570,332,902,30,932
公投第１１案,臺北市,內湖區,明湖里,441,1563,601,344,945,27,972
公投第１１案,臺北市,內湖區,明湖里,442,1550,538,342,880,28,908
公投第１１案,臺北市,內湖區,蘆洲里,443,1157,387,239,626,32,658
公投第１１案,臺北市,內湖區,麗山里,444,1768,583,428,1011,34,1045
公投第１１案,臺北市,內湖區,麗山里,445,1664,594,340,934,39,973
公投第１１案,臺北市,內湖區,麗山里,446,1743,578,419,997,31,1028
公投第１１案,臺北市,內湖區,寶湖里,447,1480,444,331,775,13,788
公投第１１案,臺北市,內湖區,寶湖里,448,1589,578,373,951,36,987
公投第１１案,臺北市,內湖區,寶湖里,449,1371,481,288,769,24,793
公投第１１案,臺北市,內湖區,寶湖里,450,1575,604,358,962,18,980
公投第１１案,臺北市,內湖區,寶湖里,451,1377,488,306,794,14,808
公投第１１案,臺北市,內湖區,南湖里,452,1469,538,385,923,44,967
公投第１１案,臺北市,內湖區,南湖里,453,1529,575,379,954,11,965
公投第１１案,臺北市,內湖區,南湖里,454,1649,567,403,970,37,1007
公投第１１案,臺北市,南港區,南港里,455,1280,441,257,698,21,719
公投第１１案,臺北市,南港區,南港里,456,1351,485,278,763,21,784
公投第１１案,臺北市,南港區,南港里,457,1345,485,283,768,34,802
公投第１１案,臺北市,南港區,南港里,458,1679,448,264,712,33,745
公投第１１案,臺北市,南港區,中南里,459,1680,499,349,848,32,880
公投第１１案,臺北市,南港區,中南里,460,1635,517,301,818,38,856
公投第１１案,臺北市,南港區,三重里,461,1459,491,281,772,26,798
公投第１１案,臺北市,南港區,三重里,462,1706,610,360,970,20,990
公投第１１案,臺北市,南港區,三重里,463,1674,554,328,882,37,919
公投第１１案,臺北市,南港區,三重里,464,1491,513,310,823,14,837
公投第１１案,臺北市,南港區,新富里,465,1086,429,245,674,24,698
公投第１１案,臺北市,南港區,新富里,466,1202,460,278,738,41,779
公投第１１案,臺北市,南港區,新富里,467,1198,422,269,691,39,730
公投第１１案,臺北市,南港區,中研里,468,1430,456,314,770,22,792
公投第１１案,臺北市,南港區,中研里,469,1275,434,324,758,34,792
公投第１１案,臺北市,南港區,中研里,470,1344,450,376,826,42,868
公投第１１案,臺北市,南港區,中研里,471,1391,469,353,822,16,838
公投第１１案,臺北市,南港區,中研里,472,1342,474,327,801,20,821
公投第１１案,臺北市,南港區,中研里,473,1389,449,286,735,28,763
公投第１１案,臺北市,南港區,九如里,474,1426,509,329,838,33,871
公投第１１案,臺北市,南港區,九如里,475,1359,533,252,785,21,806
公投第１１案,臺北市,南港區,九如里,476,1366,490,281,771,27,798
公投第１１案,臺北市,南港區,九如里,477,1441,532,297,829,24,853
公投第１１案,臺北市,南港區,舊莊里,478,1529,505,292,797,43,840
公投第１１案,臺北市,南港區,舊莊里,479,1618,492,335,827,43,870
公投第１１案,臺北市,南港區,舊莊里,480,1545,447,272,719,41,760
公投第１１案,臺北市,南港區,舊莊里,481,1569,581,288,869,33,902
公投第１１案,臺北市,南港區,舊莊里,482,1661,505,319,824,36,860
公投第１１案,臺北市,南港區,東新里,483,1518,466,300,766,37,803
公投第１１案,臺北市,南港區,東新里,484,1552,579,346,925,34,959
公投第１１案,臺北市,南港區,東新里,485,1658,559,329,888,17,905
公投第１１案,臺北市,南港區,東新里,486,1608,548,346,894,43,937
公投第１１案,臺北市,南港區,重陽里,487,1475,473,319,792,35,827
公投第１１案,臺北市,南港區,重陽里,488,1722,646,392,1038,29,1067
公投第１１案,臺北市,南港區,重陽里,489,1383,561,323,884,24,908
公投第１１案,臺北市,南港區,東明里,490,1397,487,312,799,27,826
公投第１１案,臺北市,南港區,東明里,491,1352,502,284,786,28,814
公投第１１案,臺北市,南港區,東明里,492,1344,500,291,791,20,811
公投第１１案,臺北市,南港區,西新里,493,1385,438,301,739,26,765
公投第１１案,臺北市,南港區,西新里,494,1399,474,296,770,34,804
公投第１１案,臺北市,南港區,西新里,495,1381,456,285,741,24,765
公投第１１案,臺北市,南港區,玉成里,496,1548,514,299,813,42,855
公投第１１案,臺北市,南港區,玉成里,497,1190,377,263,640,24,664
公投第１１案,臺北市,南港區,玉成里,498,1490,528,333,861,28,889
公投第１１案,臺北市,南港區,合成里,499,1096,428,235,663,19,682
公投第１１案,臺北市,南港區,合成里,500,1238,458,292,750,21,771
公投第１１案,臺北市,南港區,合成里,501,1271,485,281,766,29,795
公投第１１案,臺北市,南港區,合成里,502,1146,423,222,645,25,670
公投第１１案,臺北市,南港區,合成里,503,1232,419,267,686,32,718
公投第１１案,臺北市,南港區,新光里,504,1649,505,309,814,25,839
公投第１１案,臺北市,南港區,新光里,505,1688,620,345,965,37,1002
公投第１１案,臺北市,南港區,聯成里,506,1503,552,328,880,34,914
公投第１１案,臺北市,南港區,聯成里,507,1542,557,328,885,22,907
公投第１１案,臺北市,南港區,聯成里,508,1463,544,287,831,37,868
公投第１１案,臺北市,南港區,萬福里,509,1195,446,271,717,40,757
公投第１１案,臺北市,南港區,萬福里,510,1254,440,303,743,7,750
公投第１１案,臺北市,南港區,萬福里,511,1356,495,283,778,34,812
公投第１１案,臺北市,南港區,鴻福里,512,1363,478,295,773,66,839
公投第１１案,臺北市,南港區,鴻福里,513,1317,400,396,796,24,820
公投第１１案,臺北市,南港區,鴻福里,514,1331,469,305,774,17,791
公投第１１案,臺北市,南港區,百福里,515,1610,543,361,904,36,940
公投第１１案,臺北市,南港區,百福里,516,1542,593,263,856,21,877
公投第１１案,臺北市,南港區,百福里,517,1581,577,328,905,36,941
公投第１１案,臺北市,南港區,成福里,518,1225,489,258,747,28,775
公投第１１案,臺北市,南港區,成福里,519,1264,578,283,861,11,872
公投第１１案,臺北市,南港區,成福里,520,1649,590,375,965,57,1022
公投第１１案,臺北市,南港區,成福里,521,1267,460,287,747,21,768
公投第１１案,臺北市,南港區,成福里,522,1336,502,265,767,28,795
公投第１１案,臺北市,南港區,仁福里,523,1162,455,252,707,26,733
公投第１１案,臺北市,南港區,仁福里,524,1045,354,255,609,25,634
公投第１１案,臺北市,南港區,仁福里,525,1351,569,305,874,33,907
公投第１１案,臺北市,南港區,仁福里,526,1358,521,266,787,20,807
公投第１１案,臺北市,松山區,莊敬里,527,1583,594,340,934,27,961
公投第１１案,臺北市,松山區,莊敬里,528,1691,586,356,942,40,982
公投第１１案,臺北市,松山區,莊敬里,529,1386,505,260,765,28,793
公投第１１案,臺北市,松山區,東榮里,530,1362,494,292,786,39,825
公投第１１案,臺北市,松山區,東榮里,531,1399,522,292,814,32,846
公投第１１案,臺北市,松山區,東榮里,532,1324,466,306,772,41,813
公投第１１案,臺北市,松山區,東榮里,533,1296,492,306,798,33,831
公投第１１案,臺北市,松山區,東榮里,534,1386,514,303,817,37,854
公投第１１案,臺北市,松山區,三民里,535,1529,551,372,923,48,971
公投第１１案,臺北市,松山區,三民里,536,1416,509,286,795,35,830
公投第１１案,臺北市,松山區,三民里,537,1619,648,194,842,64,906
公投第１１案,臺北市,松山區,三民里,538,1386,484,317,801,27,828
公投第１１案,臺北市,松山區,新益里,539,1380,506,356,862,30,892
公投第１１案,臺北市,松山區,新益里,540,1357,488,309,797,32,829
公投第１１案,臺北市,松山區,新益里,541,1296,505,294,799,19,818
公投第１１案,臺北市,松山區,富錦里,542,1632,595,364,959,51,1010
公投第１１案,臺北市,松山區,富錦里,543,1414,486,308,794,37,831
公投第１１案,臺北市,松山區,富錦里,544,1404,533,297,830,25,855
公投第１１案,臺北市,松山區,新東里,545,1365,548,270,818,38,856
公投第１１案,臺北市,松山區,新東里,546,1431,517,303,820,46,866
公投第１１案,臺北市,松山區,新東里,547,1483,530,338,868,44,912
公投第１１案,臺北市,松山區,富泰里,548,1293,489,300,789,29,818
公投第１１案,臺北市,松山區,富泰里,549,1410,482,296,778,28,806
公投第１１案,臺北市,松山區,富泰里,550,1307,503,249,752,43,795
公投第１１案,臺北市,松山區,介壽里,551,1242,454,304,758,34,792
公投第１１案,臺北市,松山區,介壽里,552,1192,475,242,717,21,738
公投第１１案,臺北市,松山區,介壽里,553,1276,486,279,765,36,801
公投第１１案,臺北市,松山區,精忠里,554,1201,446,243,689,20,709
公投第１１案,臺北市,松山區,精忠里,555,1318,483,284,767,27,794
公投第１１案,臺北市,松山區,精忠里,556,1157,453,247,700,28,728
公投第１１案,臺北市,松山區,東光里,557,1157,400,260,660,20,680
公投第１１案,臺北市,松山區,東光里,558,1357,535,266,801,34,835
公投第１１案,臺北市,松山區,東光里,559,1215,419,236,655,22,677
公投第１１案,臺北市,松山區,東光里,560,1345,474,282,756,32,788
公投第１１案,臺北市,松山區,東光里,561,1237,437,266,703,40,743
公投第１１案,臺北市,松山區,龍田里,562,1393,599,245,844,32,876
公投第１１案,臺北市,松山區,龍田里,563,1331,504,335,839,21,860
公投第１１案,臺北市,松山區,龍田里,564,1550,562,363,925,45,970
公投第１１案,臺北市,松山區,龍田里,565,1308,523,206,729,16,745
公投第１１案,臺北市,松山區,龍田里,566,1490,560,280,840,39,879
公投第１１案,臺北市,松山區,龍田里,567,1406,573,297,870,31,901
公投第１１案,臺北市,松山區,東昌里,568,1191,429,314,743,29,772
公投第１１案,臺北市,松山區,東昌里,569,1095,398,252,650,28,678
公投第１１案,臺北市,松山區,東勢里,570,1198,454,231,685,28,713
公投第１１案,臺北市,松山區,東勢里,571,1265,469,247,716,31,747
公投第１１案,臺北市,松山區,東勢里,572,1225,426,276,702,23,725
公投第１１案,臺北市,松山區,中華里,573,1698,624,385,1009,43,1052
公投第１１案,臺北市,松山區,中華里,574,1819,686,325,1011,35,1046
公投第１１案,臺北市,松山區,中華里,575,1754,649,367,1016,37,1053
公投第１１案,臺北市,松山區,民有里,576,1361,471,335,806,42,848
公投第１１案,臺北市,松山區,民有里,577,1189,458,267,725,20,745
公投第１１案,臺北市,松山區,民有里,578,1214,455,265,720,28,748
公投第１１案,臺北市,松山區,民有里,579,1284,430,312,742,28,770
公投第１１案,臺北市,松山區,民有里,580,1297,470,298,768,36,804
公投第１１案,臺北市,松山區,民有里,581,1330,468,290,758,26,784
公投第１１案,臺北市,松山區,民福里,582,1396,545,284,829,38,867
公投第１１案,臺北市,松山區,民福里,583,1480,560,279,839,16,855
公投第１１案,臺北市,松山區,民福里,584,1419,561,283,844,22,866
公投第１１案,臺北市,松山區,民福里,585,1390,513,314,827,24,851
公投第１１案,臺北市,松山區,松基里,586,1525,525,361,886,33,919
公投第１１案,臺北市,松山區,松基里,587,1633,540,350,890,35,925
公投第１１案,臺北市,松山區,慈祐里,588,2677,508,355,863,33,896
公投第１１案,臺北市,松山區,慈祐里,589,1281,448,293,741,32,773
公投第１１案,臺北市,松山區,慈祐里,590,1469,414,275,689,34,723
公投第１１案,臺北市,松山區,慈祐里,591,1700,560,339,899,64,963
公投第１１案,臺北市,松山區,安平里,592,1503,487,318,805,34,839
公投第１１案,臺北市,松山區,安平里,593,1309,449,303,752,24,776
公投第１１案,臺北市,松山區,安平里,594,1376,505,285,790,47,837
公投第１１案,臺北市,松山區,安平里,595,1654,587,343,930,31,961
公投第１１案,臺北市,松山區,安平里,596,1601,523,323,846,53,899
公投第１１案,臺北市,松山區,鵬程里,597,1496,626,229,855,29,884
公投第１１案,臺北市,松山區,鵬程里,598,1598,578,381,959,55,1014
公投第１１案,臺北市,松山區,鵬程里,599,1751,632,373,1005,44,1049
公投第１１案,臺北市,松山區,自強里,600,1557,610,323,933,36,969
公投第１１案,臺北市,松山區,自強里,601,1686,733,340,1073,41,1114
公投第１１案,臺北市,松山區,自強里,602,1707,727,279,1006,41,1047
公投第１１案,臺北市,松山區,自強里,603,1854,781,367,1148,54,1202
公投第１１案,臺北市,松山區,自強里,604,1740,587,363,950,31,981
公投第１１案,臺北市,松山區,吉祥里,605,1494,535,299,834,49,883
公投第１１案,臺北市,松山區,吉祥里,606,1453,533,318,851,30,881
公投第１１案,臺北市,松山區,吉祥里,607,1458,530,306,836,39,875
公投第１１案,臺北市,松山區,吉祥里,608,1536,419,453,872,23,895
公投第１１案,臺北市,松山區,吉祥里,609,1463,550,304,854,25,879
公投第１１案,臺北市,松山區,新聚里,610,1790,579,355,934,25,959
公投第１１案,臺北市,松山區,新聚里,611,1679,593,386,979,35,1014
公投第１１案,臺北市,松山區,新聚里,612,1785,552,343,895,40,935
公投第１１案,臺北市,松山區,新聚里,613,1793,574,393,967,52,1019
公投第１１案,臺北市,松山區,復盛里,614,1381,547,233,780,43,823
公投第１１案,臺北市,松山區,復盛里,615,1279,478,273,751,25,776
公投第１１案,臺北市,松山區,復盛里,616,1681,602,348,950,65,1015
公投第１１案,臺北市,松山區,復盛里,617,1232,457,279,736,43,779
公投第１１案,臺北市,松山區,中正里,618,1533,542,328,870,27,897
公投第１１案,臺北市,松山區,中正里,619,1540,551,366,917,35,952
公投第１１案,臺北市,松山區,中正里,620,1716,590,361,951,32,983
公投第１１案,臺北市,松山區,中正里,621,1664,529,370,899,42,941
公投第１１案,臺北市,松山區,中正里,622,1350,467,287,754,26,780
公投第１１案,臺北市,松山區,中崙里,623,1837,624,387,1011,39,1050
公投第１１案,臺北市,松山區,中崙里,624,1558,503,305,808,48,856
公投第１１案,臺北市,松山區,美仁里,625,1420,540,298,838,34,872
公投第１１案,臺北市,松山區,美仁里,626,1474,500,300,800,30,830
公投第１１案,臺北市,松山區,吉仁里,627,1591,545,324,869,49,918
公投第１１案,臺北市,松山區,吉仁里,628,1726,611,350,961,39,1000
公投第１１案,臺北市,松山區,敦化里,629,1452,486,337,823,29,852
公投第１１案,臺北市,松山區,敦化里,630,1482,502,320,822,25,847
公投第１１案,臺北市,松山區,敦化里,631,1460,514,329,843,36,879
公投第１１案,臺北市,松山區,敦化里,632,1398,436,336,772,35,807
公投第１１案,臺北市,松山區,復源里,633,1423,514,320,834,36,870
公投第１１案,臺北市,松山區,復源里,634,1226,474,253,727,20,747
公投第１１案,臺北市,松山區,復建里,635,1158,418,244,662,35,697
公投第１１案,臺北市,松山區,復建里,636,1426,481,321,802,23,825
公投第１１案,臺北市,松山區,復建里,637,1177,464,235,699,10,709
公投第１１案,臺北市,松山區,復勢里,638,1363,468,304,772,25,797
公投第１１案,臺北市,松山區,復勢里,639,1240,478,256,734,37,771
公投第１１案,臺北市,松山區,復勢里,640,1375,539,283,822,34,856
公投第１１案,臺北市,松山區,復勢里,641,1377,496,306,802,24,826
公投第１１案,臺北市,松山區,福成里,642,1225,427,229,656,16,672
公投第１１案,臺北市,松山區,福成里,643,1017,374,258,632,22,654
公投第１１案,臺北市,信義區,西村里,644,2476,522,274,796,21,817
公投第１１案,臺北市,信義區,西村里,645,1381,593,273,866,16,882
公投第１１案,臺北市,信義區,西村里,646,1294,527,253,780,39,819
公投第１１案,臺北市,信義區,正和里,647,1351,487,284,771,31,802
公投第１１案,臺北市,信義區,正和里,648,1296,489,262,751,24,775
公投第１１案,臺北市,信義區,正和里,649,1302,504,282,786,26,812
公投第１１案,臺北市,信義區,興隆里,650,1025,350,196,546,46,592
公投第１１案,臺北市,信義區,興隆里,651,1421,467,294,761,27,788
公投第１１案,臺北市,信義區,中興里,652,1501,530,298,828,28,856
公投第１１案,臺北市,信義區,中興里,653,1575,480,317,797,27,824
公投第１１案,臺北市,信義區,新仁里,654,1516,572,294,866,21,887
公投第１１案,臺北市,信義區,新仁里,655,1382,489,322,811,27,838
公投第１１案,臺北市,信義區,興雅里,656,1128,411,220,631,30,661
公投第１１案,臺北市,信義區,興雅里,657,1397,498,271,769,30,799
公投第１１案,臺北市,信義區,興雅里,658,1161,433,250,683,40,723
公投第１１案,臺北市,信義區,興雅里,659,1368,471,300,771,32,803
公投第１１案,臺北市,信義區,敦厚里,660,1049,416,207,623,17,640
公投第１１案,臺北市,信義區,敦厚里,661,1308,498,258,756,31,787
公投第１１案,臺北市,信義區,敦厚里,662,1154,423,275,698,33,731
公投第１１案,臺北市,信義區,敦厚里,663,1078,353,291,644,19,663
公投第１１案,臺北市,信義區,廣居里,664,1375,492,287,779,30,809
公投第１１案,臺北市,信義區,廣居里,665,1448,544,273,817,40,857
公投第１１案,臺北市,信義區,廣居里,666,1250,483,269,752,17,769
公投第１１案,臺北市,信義區,廣居里,667,1381,470,343,813,14,827
公投第１１案,臺北市,信義區,廣居里,668,1213,460,259,719,30,749
公投第１１案,臺北市,信義區,安康里,669,1373,526,300,826,25,851
公投第１１案,臺北市,信義區,安康里,670,1226,453,269,722,33,755
公投第１１案,臺北市,信義區,安康里,671,1117,429,243,672,9,681
公投第１１案,臺北市,信義區,安康里,672,1123,438,233,671,27,698
公投第１１案,臺北市,信義區,安康里,673,1200,450,247,697,31,728
公投第１１案,臺北市,信義區,安康里,674,1335,437,252,689,21,710
公投第１１案,臺北市,信義區,安康里,675,1332,470,245,715,22,737
公投第１１案,臺北市,信義區,六藝里,676,1648,609,322,931,54,985
公投第１１案,臺北市,信義區,六藝里,677,1542,519,304,823,53,876
公投第１１案,臺北市,信義區,雅祥里,678,1228,429,263,692,42,734
公投第１１案,臺北市,信義區,雅祥里,679,1731,564,376,940,39,979
公投第１１案,臺北市,信義區,雅祥里,680,1403,497,317,814,30,844
公投第１１案,臺北市,信義區,五常里,681,1929,647,344,991,74,1065
公投第１１案,臺北市,信義區,五常里,682,1300,469,298,767,32,799
公投第１１案,臺北市,信義區,五全里,683,1486,467,311,778,23,801
公投第１１案,臺北市,信義區,五全里,684,1532,469,287,756,33,789
公投第１１案,臺北市,信義區,五全里,685,1387,543,291,834,35,869
公投第１１案,臺北市,信義區,永吉里,686,1195,402,223,625,35,660
公投第１１案,臺北市,信義區,永吉里,687,1068,357,229,586,28,614
公投第１１案,臺北市,信義區,永吉里,688,1273,439,236,675,28,703
公投第１１案,臺北市,信義區,長春里,689,1329,495,301,796,47,843
公投第１１案,臺北市,信義區,長春里,690,1311,453,263,716,30,746
公投第１１案,臺北市,信義區,長春里,691,1258,441,231,672,44,716
公投第１１案,臺北市,信義區,四育里,692,1277,445,289,734,40,774
公投第１１案,臺北市,信義區,四育里,693,1285,484,298,782,36,818
公投第１１案,臺北市,信義區,四育里,694,1161,421,283,704,38,742
公投第１１案,臺北市,信義區,四育里,695,1299,424,310,734,30,764
公投第１１案,臺北市,信義區,四維里,696,1243,442,247,689,29,718
公投第１１案,臺北市,信義區,四維里,697,1197,395,273,668,29,697
公投第１１案,臺北市,信義區,四維里,698,1224,474,283,757,26,783
公投第１１案,臺北市,信義區,四維里,699,1147,388,236,624,32,656
公投第１１案,臺北市,信義區,永春里,700,1045,369,245,614,16,630
公投第１１案,臺北市,信義區,永春里,701,1096,439,229,668,29,697
公投第１１案,臺北市,信義區,永春里,702,1115,380,252,632,15,647
公投第１１案,臺北市,信義區,永春里,703,1117,407,206,613,35,648
公投第１１案,臺北市,信義區,富台里,704,1019,297,218,515,23,538
公投第１１案,臺北市,信義區,富台里,705,1346,469,292,761,38,799
公投第１１案,臺北市,信義區,富台里,706,1405,490,281,771,32,803
公投第１１案,臺北市,信義區,國業里,707,1356,482,292,774,24,798
公投第１１案,臺北市,信義區,國業里,708,1250,474,301,775,31,806
公投第１１案,臺北市,信義區,國業里,709,1254,491,258,749,24,773
公投第１１案,臺北市,信義區,國業里,710,1317,461,295,756,24,780
公投第１１案,臺北市,信義區,國業里,711,1271,483,276,759,39,798
公投第１１案,臺北市,信義區,松隆里,712,979,326,214,540,27,567
公投第１１案,臺北市,信義區,松隆里,713,1025,330,207,537,40,577
公投第１１案,臺北市,信義區,松友里,714,1512,480,267,747,26,773
公投第１１案,臺北市,信義區,松友里,715,1483,546,329,875,24,899
公投第１１案,臺北市,信義區,松友里,716,1359,511,298,809,28,837
公投第１１案,臺北市,信義區,松友里,717,1387,536,284,820,23,843
公投第１１案,臺北市,信義區,松光里,718,1455,487,291,778,25,803
公投第１１案,臺北市,信義區,松光里,719,1461,512,321,833,22,855
公投第１１案,臺北市,信義區,松光里,720,1532,541,342,883,34,917
公投第１１案,臺北市,信義區,中坡里,721,1043,364,270,634,29,663
公投第１１案,臺北市,信義區,中坡里,722,875,323,209,532,27,559
公投第１１案,臺北市,信義區,中坡里,723,927,330,185,515,24,539
公投第１１案,臺北市,信義區,中坡里,724,1119,424,222,646,41,687
公投第１１案,臺北市,信義區,中行里,725,1463,514,307,821,38,859
公投第１１案,臺北市,信義區,中行里,726,1293,480,312,792,38,830
公投第１１案,臺北市,信義區,中行里,727,1553,540,303,843,38,881
公投第１１案,臺北市,信義區,中行里,728,1360,454,320,774,19,793
公投第１１案,臺北市,信義區,中行里,729,1392,483,311,794,42,836
公投第１１案,臺北市,信義區,大道里,730,1377,493,303,796,21,817
公投第１１案,臺北市,信義區,大道里,731,1377,484,315,799,12,811
公投第１１案,臺北市,信義區,大道里,732,1269,428,241,669,26,695
公投第１１案,臺北市,信義區,大道里,733,1407,518,278,796,45,841
公投第１１案,臺北市,信義區,大仁里,734,1172,416,243,659,31,690
公投第１１案,臺北市,信義區,大仁里,735,1182,412,254,666,28,694
公投第１１案,臺北市,信義區,大仁里,736,1255,449,273,722,39,761
公投第１１案,臺北市,信義區,景新里,737,1689,564,319,883,28,911
公投第１１案,臺北市,信義區,景新里,738,1605,553,306,859,26,885
公投第１１案,臺北市,信義區,景新里,739,1143,429,207,636,21,657
公投第１１案,臺北市,信義區,惠安里,740,1440,487,277,764,28,792
公投第１１案,臺北市,信義區,惠安里,741,1495,542,290,832,29,861
公投第１１案,臺北市,信義區,惠安里,742,1514,539,342,881,48,929
公投第１１案,臺北市,信義區,惠安里,743,1449,524,272,796,29,825
公投第１１案,臺北市,信義區,三張里,744,1401,526,296,822,39,861
公投第１１案,臺北市,信義區,三張里,745,1181,417,224,641,16,657
公投第１１案,臺北市,信義區,三張里,746,1376,560,303,863,20,883
公投第１１案,臺北市,信義區,三張里,747,1422,578,259,837,39,876
公投第１１案,臺北市,信義區,三張里,748,1267,475,249,724,14,738
公投第１１案,臺北市,信義區,三張里,749,1220,375,286,661,18,679
公投第１１案,臺北市,信義區,三犁里,750,1562,528,270,798,31,829
公投第１１案,臺北市,信義區,三犁里,751,1455,487,316,803,23,826
公投第１１案,臺北市,信義區,三犁里,752,1605,547,311,858,35,893
公投第１１案,臺北市,信義區,六合里,753,1626,647,327,974,30,1004
公投第１１案,臺北市,信義區,六合里,754,1561,548,349,897,44,941
公投第１１案,臺北市,信義區,六合里,755,1547,469,283,752,26,778
公投第１１案,臺北市,信義區,六合里,756,1336,447,300,747,19,766
公投第１１案,臺北市,信義區,泰和里,757,1314,424,241,665,26,691
公投第１１案,臺北市,信義區,泰和里,758,1297,454,241,695,33,728
公投第１１案,臺北市,信義區,泰和里,759,1366,471,262,733,32,765
公投第１１案,臺北市,信義區,泰和里,760,1472,499,306,805,34,839
公投第１１案,臺北市,信義區,泰和里,761,1450,511,290,801,31,832
公投第１１案,臺北市,信義區,景聯里,762,1328,477,270,747,26,773
公投第１１案,臺北市,信義區,景聯里,763,1399,517,306,823,33,856
公投第１１案,臺北市,信義區,景聯里,764,1373,504,284,788,55,843
公投第１１案,臺北市,信義區,景勤里,765,1099,413,193,606,21,627
公投第１１案,臺北市,信義區,景勤里,766,1226,427,251,678,32,710
公投第１１案,臺北市,信義區,景勤里,767,1267,440,246,686,17,703
公投第１１案,臺北市,信義區,雙和里,768,1531,571,297,868,38,906
公投第１１案,臺北市,信義區,雙和里,769,1438,546,289,835,32,867
公投第１１案,臺北市,信義區,雙和里,770,1657,557,338,895,21,916
公投第１１案,臺北市,信義區,雙和里,771,1621,597,341,938,31,969
公投第１１案,臺北市,信義區,嘉興里,772,1508,545,342,887,23,910
公投第１１案,臺北市,信義區,嘉興里,773,1334,486,295,781,33,814
公投第１１案,臺北市,信義區,黎順里,774,1246,368,201,569,30,599
公投第１１案,臺北市,信義區,黎順里,775,1196,448,291,739,12,751
公投第１１案,臺北市,信義區,黎順里,776,1220,454,262,716,25,741
公投第１１案,臺北市,信義區,黎平里,777,1538,538,312,850,26,876
公投第１１案,臺北市,信義區,黎平里,778,1565,583,310,893,51,944
公投第１１案,臺北市,信義區,黎平里,779,1621,499,332,831,57,888
公投第１１案,臺北市,信義區,黎平里,780,1486,504,296,800,47,847
公投第１１案,臺北市,信義區,黎忠里,781,1507,496,294,790,37,827
公投第１１案,臺北市,信義區,黎忠里,782,1516,550,313,863,39,902
公投第１１案,臺北市,信義區,黎忠里,783,1287,527,240,767,42,809
公投第１１案,臺北市,信義區,黎安里,784,1050,331,185,516,49,565
公投第１１案,臺北市,信義區,黎安里,785,801,323,133,456,43,499
公投第１１案,臺北市,中山區,正守里,786,1522,508,333,841,27,868
公投第１１案,臺北市,中山區,正守里,787,1332,467,272,739,21,760
公投第１１案,臺北市,中山區,正義里,788,1656,483,321,804,33,837
公投第１１案,臺北市,中山區,正義里,789,1367,416,256,672,39,711
公投第１１案,臺北市,中山區,正義里,790,1732,515,346,861,29,890
公投第１１案,臺北市,中山區,正得里,791,1634,543,352,895,42,937
公投第１１案,臺北市,中山區,正得里,792,1650,533,336,869,30,899
公投第１１案,臺北市,中山區,民安里,793,1392,481,301,782,42,824
公投第１１案,臺北市,中山區,民安里,794,1177,417,292,709,19,728
公投第１１案,臺北市,中山區,民安里,795,1477,528,335,863,31,894
公投第１１案,臺北市,中山區,康樂里,796,1063,325,218,543,38,581
公投第１１案,臺北市,中山區,康樂里,797,1296,457,228,685,31,716
公投第１１案,臺北市,中山區,中山里,798,1330,410,276,686,22,708
公投第１１案,臺北市,中山區,中山里,799,1483,461,301,762,36,798
公投第１１案,臺北市,中山區,中山里,800,1542,492,310,802,28,830
公投第１１案,臺北市,中山區,中山里,801,1710,511,333,844,43,887
公投第１１案,臺北市,中山區,聚盛里,802,1315,422,238,660,16,676
公投第１１案,臺北市,中山區,聚盛里,803,1245,439,233,672,33,705
公投第１１案,臺北市,中山區,聚盛里,804,1262,418,237,655,32,687
公投第１１案,臺北市,中山區,集英里,805,1518,496,347,843,38,881
公投第１１案,臺北市,中山區,集英里,806,1522,531,305,836,45,881
公投第１１案,臺北市,中山區,集英里,807,1580,490,315,805,26,831
公投第１１案,臺北市,中山區,集英里,808,1529,491,339,830,31,861
公投第１１案,臺北市,中山區,聚葉里,809,1221,507,260,767,27,794
公投第１１案,臺北市,中山區,聚葉里,810,1221,410,285,695,33,728
公投第１１案,臺北市,中山區,聚葉里,811,1139,341,209,550,30,580
公投第１１案,臺北市,中山區,恆安里,812,1407,472,284,756,52,808
公投第１１案,臺北市,中山區,恆安里,813,1321,419,307,726,35,761
公投第１１案,臺北市,中山區,恆安里,814,1578,501,267,768,26,794
公投第１１案,臺北市,中山區,晴光里,815,1739,524,336,860,40,900
公投第１１案,臺北市,中山區,晴光里,816,1637,503,321,824,32,856
公投第１１案,臺北市,中山區,晴光里,817,1541,473,323,796,43,839
公投第１１案,臺北市,中山區,圓山里,818,1210,421,261,682,31,713
公投第１１案,臺北市,中山區,圓山里,819,1331,441,274,715,30,745
公投第１１案,臺北市,中山區,圓山里,820,1224,350,265,615,39,654
公投第１１案,臺北市,中山區,新庄里,821,1585,567,312,879,35,914
公投第１１案,臺北市,中山區,新庄里,822,1523,564,343,907,41,948
公投第１１案,臺北市,中山區,新庄里,823,1368,529,284,813,32,845
公投第１１案,臺北市,中山區,劍潭里,824,1805,711,253,964,36,1000
公投第１１案,臺北市,中山區,劍潭里,825,1404,587,229,816,17,833
公投第１１案,臺北市,中山區,大直里,826,1708,593,421,1014,45,1059
公投第１１案,臺北市,中山區,大直里,827,1451,554,343,897,26,923
公投第１１案,臺北市,中山區,大直里,828,1684,603,403,1006,38,1044
公投第１１案,臺北市,中山區,大直里,829,1585,593,294,887,21,908
公投第１１案,臺北市,中山區,大直里,830,1391,500,289,789,47,836
公投第１１案,臺北市,中山區,成功里,831,1375,553,313,866,49,915
公投第１１案,臺北市,中山區,成功里,832,1472,554,341,895,11,906
公投第１１案,臺北市,中山區,成功里,833,1327,432,283,715,23,738
公投第１１案,臺北市,中山區,成功里,834,1401,511,297,808,18,826
公投第１１案,臺北市,中山區,永安里,835,1423,527,294,821,28,849
公投第１１案,臺北市,中山區,永安里,836,1569,561,355,916,24,940
公投第１１案,臺北市,中山區,永安里,837,1651,556,346,902,19,921
公投第１１案,臺北市,中山區,永安里,838,1624,527,372,899,17,916
公投第１１案,臺北市,中山區,永安里,839,1713,596,413,1009,34,1043
公投第１１案,臺北市,中山區,金泰里,840,1647,610,358,968,27,995
公投第１１案,臺北市,中山區,金泰里,841,1762,556,359,915,36,951
公投第１１案,臺北市,中山區,金泰里,842,1399,554,299,853,21,874
公投第１１案,臺北市,中山區,金泰里,843,1489,591,317,908,23,931
公投第１１案,臺北市,中山區,北安里,844,1269,484,270,754,22,776
公投第１１案,臺北市,中山區,北安里,845,998,411,194,605,28,633
公投第１１案,臺北市,中山區,新喜里,846,1472,477,324,801,28,829
公投第１１案,臺北市,中山區,新喜里,847,1517,467,328,795,40,835
公投第１１案,臺北市,中山區,新喜里,848,1704,624,371,995,37,1032
公投第１１案,臺北市,中山區,新福里,849,1603,548,367,915,33,948
公投第１１案,臺北市,中山區,新福里,850,1432,474,264,738,57,795
公投第１１案,臺北市,中山區,新福里,851,1500,502,350,852,50,902
公投第１１案,臺北市,中山區,松江里,852,1332,505,286,791,29,820
公投第１１案,臺北市,中山區,松江里,853,1450,523,330,853,35,888
公投第１１案,臺北市,中山區,松江里,854,1434,522,329,851,31,882
公投第１１案,臺北市,中山區,松江里,855,1419,503,259,762,42,804
公投第１１案,臺北市,中山區,新生里,856,1292,439,266,705,32,737
公投第１１案,臺北市,中山區,新生里,857,1526,471,351,822,27,849
公投第１１案,臺北市,中山區,新生里,858,1582,437,300,737,30,767
公投第１１案,臺北市,中山區,中庄里,859,1588,473,319,792,46,838
公投第１１案,臺北市,中山區,中庄里,860,1463,504,298,802,45,847
公投第１１案,臺北市,中山區,中庄里,861,1533,467,311,778,33,811
公投第１１案,臺北市,中山區,大佳里,862,944,333,187,520,30,550
公投第１１案,臺北市,中山區,行政里,863,1745,683,372,1055,35,1090
公投第１１案,臺北市,中山區,行政里,864,1679,473,341,814,29,843
公投第１１案,臺北市,中山區,行政里,865,3419,454,333,787,38,825
公投第１１案,臺北市,中山區,行仁里,866,1387,489,311,800,36,836
公投第１１案,臺北市,中山區,行仁里,867,1672,596,356,952,40,992
公投第１１案,臺北市,中山區,行仁里,868,1319,484,262,746,30,776
公投第１１案,臺北市,中山區,行仁里,869,1364,460,274,734,31,765
公投第１１案,臺北市,中山區,行仁里,870,1461,470,317,787,36,823
公投第１１案,臺北市,中山區,行孝里,871,1173,421,255,676,29,705
公投第１１案,臺北市,中山區,行孝里,872,1171,386,233,619,41,660
公投第１１案,臺北市,中山區,行孝里,873,1310,435,303,738,20,758
公投第１１案,臺北市,中山區,下埤里,874,1373,507,305,812,26,838
公投第１１案,臺北市,中山區,下埤里,875,1290,489,284,773,29,802
公投第１１案,臺北市,中山區,下埤里,876,1346,498,302,800,35,835
公投第１１案,臺北市,中山區,下埤里,877,1468,484,371,855,31,886
公投第１１案,臺北市,中山區,下埤里,878,1178,452,243,695,18,713
公投第１１案,臺北市,中山區,江寧里,879,1654,570,377,947,40,987
公投第１１案,臺北市,中山區,江寧里,880,1464,497,324,821,40,861
公投第１１案,臺北市,中山區,江寧里,881,1450,504,288,792,27,819
公投第１１案,臺北市,中山區,江寧里,882,1534,504,330,834,38,872
公投第１１案,臺北市,中山區,江山里,883,1703,580,364,944,31,975
公投第１１案,臺北市,中山區,江山里,884,1610,559,349,908,47,955
公投第１１案,臺北市,中山區,江山里,885,1653,524,57,581,50,631
公投第１１案,臺北市,中山區,江山里,886,1694,595,392,987,54,1041
公投第１１案,臺北市,中山區,中吉里,887,1623,537,341,878,35,913
公投第１１案,臺北市,中山區,中吉里,888,1618,538,366,904,43,947
公投第１１案,臺北市,中山區,中吉里,889,1583,519,342,861,42,903
公投第１１案,臺北市,中山區,中原里,890,1605,519,401,920,52,972
公投第１１案,臺北市,中山區,中原里,891,1398,488,361,849,43,892
公投第１１案,臺北市,中山區,中原里,892,1526,587,359,946,40,986
公投第１１案,臺北市,中山區,興亞里,893,1555,492,358,850,51,901
公投第１１案,臺北市,中山區,興亞里,894,1597,535,332,867,23,890
公投第１１案,臺北市,中山區,興亞里,895,1587,543,349,892,48,940
公投第１１案,臺北市,中山區,中央里,896,1587,559,390,949,28,977
公投第１１案,臺北市,中山區,中央里,897,1546,547,358,905,47,952
公投第１１案,臺北市,中山區,朱馥里,898,1322,481,237,718,39,757
公投第１１案,臺北市,中山區,朱馥里,899,1267,453,263,716,27,743
公投第１１案,臺北市,中山區,朱馥里,900,1210,410,263,673,24,697
公投第１１案,臺北市,中山區,朱馥里,901,1295,460,255,715,31,746
公投第１１案,臺北市,中山區,龍洲里,902,1467,515,336,851,36,887
公投第１１案,臺北市,中山區,龍洲里,903,1491,613,285,898,34,932
公投第１１案,臺北市,中山區,龍洲里,904,1516,637,308,945,41,986
公投第１１案,臺北市,中山區,朱園里,905,1384,428,302,730,22,752
公投第１１案,臺北市,中山區,朱園里,906,1138,398,292,690,33,723
公投第１１案,臺北市,中山區,朱園里,907,1513,455,326,781,33,814
公投第１１案,臺北市,中山區,埤頭里,908,1559,532,355,887,42,929
公投第１１案,臺北市,中山區,埤頭里,909,1429,522,318,840,49,889
公投第１１案,臺北市,中山區,朱崙里,910,1245,464,283,747,21,768
公投第１１案,臺北市,中山區,朱崙里,911,1214,454,277,731,36,767
公投第１１案,臺北市,中山區,力行里,912,1394,477,332,809,23,832
公投第１１案,臺北市,中山區,力行里,913,1336,430,276,706,13,719
公投第１１案,臺北市,中山區,力行里,914,1227,426,252,678,23,701
公投第１１案,臺北市,中山區,力行里,915,1382,511,279,790,28,818
公投第１１案,臺北市,中山區,復華里,916,1436,508,282,790,39,829
公投第１１案,臺北市,中山區,復華里,917,1405,419,286,705,33,738
公投第１１案,臺北市,中山區,復華里,918,1259,447,272,719,24,743
公投第１１案,臺北市,大同區,玉泉里,919,1261,422,289,711,44,755
公投第１１案,臺北市,大同區,玉泉里,920,1352,470,325,795,42,837
公投第１１案,臺北市,大同區,建明里,921,1462,514,302,816,37,853
公投第１１案,臺北市,大同區,建明里,922,1510,526,305,831,48,879
公投第１１案,臺北市,大同區,建功里,923,1496,466,316,782,25,807
公投第１１案,臺北市,大同區,建功里,924,1329,434,277,711,43,754
公投第１１案,臺北市,大同區,建功里,925,1307,452,263,715,53,768
公投第１１案,臺北市,大同區,建泰里,926,1065,374,229,603,31,634
公投第１１案,臺北市,大同區,建泰里,927,1085,347,269,616,26,642
公投第１１案,臺北市,大同區,建泰里,928,1047,373,285,658,40,698
公投第１１案,臺北市,大同區,永樂里,929,1215,342,285,627,32,659
公投第１１案,臺北市,大同區,永樂里,930,1117,401,273,674,28,702
公投第１１案,臺北市,大同區,永樂里,931,1186,418,282,700,31,731
公投第１１案,臺北市,大同區,永樂里,932,1185,431,263,694,35,729
公投第１１案,臺北市,大同區,朝陽里,933,1359,462,287,749,37,786
公投第１１案,臺北市,大同區,朝陽里,934,1273,440,288,728,16,744
公投第１１案,臺北市,大同區,朝陽里,935,1291,331,339,670,31,701
公投第１１案,臺北市,大同區,星明里,936,1288,422,269,691,23,714
公投第１１案,臺北市,大同區,星明里,937,1245,482,277,759,25,784
公投第１１案,臺北市,大同區,星明里,938,1261,440,318,758,36,794
公投第１１案,臺北市,大同區,星明里,939,1348,453,288,741,17,758
公投第１１案,臺北市,大同區,光能里,940,1676,566,360,926,61,987
公投第１１案,臺北市,大同區,光能里,941,1311,489,286,775,34,809
公投第１１案,臺北市,大同區,光能里,942,1316,450,302,752,44,796
公投第１１案,臺北市,大同區,大有里,943,1409,456,326,782,51,833
公投第１１案,臺北市,大同區,大有里,944,1436,485,329,814,55,869
公投第１１案,臺北市,大同區,大有里,945,1408,488,311,799,38,837
公投第１１案,臺北市,大同區,延平里,946,1276,428,273,701,33,734
公投第１１案,臺北市,大同區,延平里,947,1110,384,238,622,16,638
公投第１１案,臺北市,大同區,延平里,948,1324,436,317,753,24,777
公投第１１案,臺北市,大同區,雙連里,949,1016,356,220,576,23,599
公投第１１案,臺北市,大同區,雙連里,950,1028,399,220,619,26,645
公投第１１案,臺北市,大同區,雙連里,951,1158,465,211,676,31,707
公投第１１案,臺北市,大同區,雙連里,952,1138,435,240,675,30,705
公投第１１案,臺北市,大同區,雙連里,953,1214,442,260,702,32,734
公投第１１案,臺北市,大同區,雙連里,954,1090,388,300,688,22,710
公投第１１案,臺北市,大同區,雙連里,955,1305,501,299,800,34,834
公投第１１案,臺北市,大同區,南芳里,956,1167,405,230,635,25,660
公投第１１案,臺北市,大同區,南芳里,957,1148,392,254,646,26,672
公投第１１案,臺北市,大同區,南芳里,958,1203,439,282,721,27,748
公投第１１案,臺北市,大同區,民權里,959,1441,482,312,794,28,822
公投第１１案,臺北市,大同區,民權里,960,1315,489,276,765,43,808
公投第１１案,臺北市,大同區,民權里,961,1393,429,337,766,40,806
公投第１１案,臺北市,大同區,民權里,962,1278,439,300,739,31,770
公投第１１案,臺北市,大同區,景星里,963,1246,401,254,655,26,681
公投第１１案,臺北市,大同區,景星里,964,1142,396,235,631,41,672
公投第１１案,臺北市,大同區,隆和里,965,1336,488,305,793,34,827
公投第１１案,臺北市,大同區,隆和里,966,1363,482,303,785,51,836
公投第１１案,臺北市,大同區,蓬萊里,967,1476,545,306,851,23,874
公投第１１案,臺北市,大同區,蓬萊里,968,1418,459,343,802,41,843
公投第１１案,臺北市,大同區,蓬萊里,969,1460,507,284,791,28,819
公投第１１案,臺北市,大同區,國順里,970,1222,365,131,496,39,535
公投第１１案,臺北市,大同區,國順里,971,1246,357,228,585,57,642
公投第１１案,臺北市,大同區,國慶里,972,1256,471,279,750,35,785
公投第１１案,臺北市,大同區,國慶里,973,1289,452,291,743,18,761
公投第１１案,臺北市,大同區,國慶里,974,1340,442,295,737,12,749
公投第１１案,臺北市,大同區,揚雅里,975,1555,468,332,800,34,834
公投第１１案,臺北市,大同區,揚雅里,976,2459,521,263,784,53,837
公投第１１案,臺北市,大同區,斯文里,977,1108,316,187,503,41,544
公投第１１案,臺北市,大同區,斯文里,978,867,308,142,450,37,487
公投第１１案,臺北市,大同區,斯文里,979,1329,482,309,791,41,832
公投第１１案,臺北市,大同區,斯文里,980,1162,387,268,655,24,679
公投第１１案,臺北市,大同區,鄰江里,981,1434,476,269,745,48,793
公投第１１案,臺北市,大同區,鄰江里,982,1351,444,300,744,49,793
公投第１１案,臺北市,大同區,鄰江里,983,1531,478,308,786,47,833
公投第１１案,臺北市,大同區,鄰江里,984,1507,439,295,734,32,766
公投第１１案,臺北市,大同區,至聖里,985,1488,467,334,801,39,840
公投第１１案,臺北市,大同區,至聖里,986,1384,506,309,815,40,855
公投第１１案,臺北市,大同區,至聖里,987,1460,555,261,816,38,854
公投第１１案,臺北市,大同區,至聖里,988,1371,529,262,791,30,821
公投第１１案,臺北市,大同區,至聖里,989,1439,471,319,790,16,806
公投第１１案,臺北市,大同區,老師里,990,1376,452,337,789,46,835
公投第１１案,臺北市,大同區,老師里,991,1366,475,265,740,42,782
公投第１１案,臺北市,大同區,老師里,992,1218,459,286,745,41,786
公投第１１案,臺北市,大同區,老師里,993,1235,417,261,678,41,719
公投第１１案,臺北市,大同區,重慶里,994,1364,599,140,739,16,755
公投第１１案,臺北市,大同區,重慶里,995,1408,498,350,848,52,900
公投第１１案,臺北市,大同區,重慶里,996,1450,495,328,823,37,860
公投第１１案,臺北市,大同區,重慶里,997,1429,532,318,850,47,897
公投第１１案,臺北市,大同區,保安里,998,1170,435,248,683,37,720
公投第１１案,臺北市,大同區,保安里,999,1245,411,291,702,39,741
公投第１１案,臺北市,大同區,保安里,1000,1215,458,290,748,44,792
公投第１１案,臺北市,中正區,水源里,1001,1308,478,288,766,24,790
公投第１１案,臺北市,中正區,水源里,1002,1317,433,278,711,29,740
公投第１１案,臺北市,中正區,富水里,1003,1069,419,219,638,25,663
公投第１１案,臺北市,中正區,富水里,1004,1128,393,207,600,36,636
公投第１１案,臺北市,中正區,文盛里,1005,1053,385,230,615,32,647
公投第１１案,臺北市,中正區,文盛里,1006,1048,400,222,622,11,633
公投第１１案,臺北市,中正區,林興里,1007,1297,479,222,701,38,739
公投第１１案,臺北市,中正區,林興里,1008,1193,461,248,709,15,724
公投第１１案,臺北市,中正區,林興里,1009,1500,583,359,942,28,970
公投第１１案,臺北市,中正區,河堤里,1010,1346,462,277,739,20,759
公投第１１案,臺北市,中正區,河堤里,1011,1283,437,269,706,22,728
公投第１１案,臺北市,中正區,河堤里,1012,1450,456,340,796,34,830
公投第１１案,臺北市,中正區,頂東里,1013,1433,492,324,816,31,847
公投第１１案,臺北市,中正區,頂東里,1014,1309,494,336,830,31,861
公投第１１案,臺北市,中正區,頂東里,1015,1386,523,292,815,19,834
公投第１１案,臺北市,中正區,頂東里,1016,1201,443,262,705,34,739
公投第１１案,臺北市,中正區,網溪里,1017,1336,498,292,790,35,825
公投第１１案,臺北市,中正區,網溪里,1018,1358,495,307,802,35,837
公投第１１案,臺北市,中正區,網溪里,1019,1177,424,263,687,32,719
公投第１１案,臺北市,中正區,網溪里,1020,1236,506,266,772,18,790
公投第１１案,臺北市,中正區,板溪里,1021,1478,531,292,823,40,863
公投第１１案,臺北市,中正區,板溪里,1022,1474,526,324,850,27,877
公投第１１案,臺北市,中正區,螢圃里,1023,1172,404,258,662,30,692
公投第１１案,臺北市,中正區,螢圃里,1024,1310,455,279,734,40,774
公投第１１案,臺北市,中正區,螢圃里,1025,1263,470,251,721,36,757
公投第１１案,臺北市,中正區,螢圃里,1026,1169,436,246,682,23,705
公投第１１案,臺北市,中正區,螢雪里,1027,1391,469,273,742,29,771
公投第１１案,臺北市,中正區,螢雪里,1028,1201,448,246,694,16,710
公投第１１案,臺北市,中正區,螢雪里,1029,1324,466,279,745,37,782
公投第１１案,臺北市,中正區,永功里,1030,1216,488,162,650,44,694
公投第１１案,臺北市,中正區,永功里,1031,1183,389,264,653,37,690
公投第１１案,臺北市,中正區,永功里,1032,1469,532,313,845,53,898
公投第１１案,臺北市,中正區,永功里,1033,1411,480,323,803,28,831
公投第１１案,臺北市,中正區,永昌里,1034,1398,487,303,790,59,849
公投第１１案,臺北市,中正區,永昌里,1035,1479,508,288,796,47,843
公投第１１案,臺北市,中正區,永昌里,1036,1620,580,304,884,36,920
公投第１１案,臺北市,中正區,龍興里,1037,1041,388,221,609,16,625
公投第１１案,臺北市,中正區,龍興里,1038,1056,367,238,605,17,622
公投第１１案,臺北市,中正區,龍興里,1039,1063,422,242,664,25,689
公投第１１案,臺北市,中正區,忠勤里,1040,1591,451,266,717,33,750
公投第１１案,臺北市,中正區,忠勤里,1041,1502,438,218,656,55,711
公投第１１案,臺北市,中正區,忠勤里,1042,1331,432,245,677,38,715
公投第１１案,臺北市,中正區,忠勤里,1043,1441,523,258,781,42,823
公投第１１案,臺北市,中正區,廈安里,1044,1273,488,288,776,29,805
公投第１１案,臺北市,中正區,廈安里,1045,1133,415,252,667,26,693
公投第１１案,臺北市,中正區,廈安里,1046,1156,449,235,684,22,706
公投第１１案,臺北市,中正區,愛國里,1047,1377,473,300,773,32,805
公投第１１案,臺北市,中正區,愛國里,1048,1266,482,263,745,37,782
公投第１１案,臺北市,中正區,南門里,1049,1111,457,224,681,29,710
公投第１１案,臺北市,中正區,南門里,1050,1124,392,268,660,24,684
公投第１１案,臺北市,中正區,龍光里,1051,1373,422,301,723,31,754
公投第１１案,臺北市,中正區,龍光里,1052,1351,540,267,807,26,833
公投第１１案,臺北市,中正區,南福里,1053,1495,557,330,887,20,907
公投第１１案,臺北市,中正區,南福里,1054,1436,563,334,897,25,922
公投第１１案,臺北市,中正區,南福里,1055,1516,555,311,866,14,880
公投第１１案,臺北市,中正區,南福里,1056,1374,492,294,786,22,808
公投第１１案,臺北市,中正區,南福里,1057,1522,533,300,833,17,850
公投第１１案,臺北市,中正區,南福里,1058,1336,496,281,777,23,800
公投第１１案,臺北市,中正區,龍福里,1059,1551,551,342,893,24,917
公投第１１案,臺北市,中正區,龍福里,1060,1594,561,353,914,47,961
公投第１１案,臺北市,中正區,龍福里,1061,1503,529,320,849,28,877
公投第１１案,臺北市,中正區,新營里,1062,1455,557,289,846,20,866
公投第１１案,臺北市,中正區,新營里,1063,1439,546,308,854,16,870
公投第１１案,臺北市,中正區,新營里,1064,1469,520,315,835,36,871
公投第１１案,臺北市,中正區,新營里,1065,1430,594,253,847,32,879
公投第１１案,臺北市,中正區,新營里,1066,1444,542,324,866,28,894
公投第１１案,臺北市,中正區,建國里,1067,1254,458,262,720,14,734
公投第１１案,臺北市,中正區,光復里,1068,932,333,208,541,32,573
公投第１１案,臺北市,中正區,光復里,1069,1055,364,245,609,36,645
公投第１１案,臺北市,中正區,光復里,1070,1226,460,244,704,20,724
公投第１１案,臺北市,中正區,黎明里,1071,1390,476,231,707,37,744
公投第１１案,臺北市,中正區,黎明里,1072,1336,463,295,758,27,785
公投第１１案,臺北市,中正區,梅花里,1073,1419,452,279,731,35,766
公投第１１案,臺北市,中正區,梅花里,1074,1361,508,299,807,42,849
公投第１１案,臺北市,中正區,幸福里,1075,2520,566,314,880,37,917
公投第１１案,臺北市,中正區,幸福里,1076,1224,476,233,709,14,723
公投第１１案,臺北市,中正區,幸福里,1077,1272,422,250,672,3,675
公投第１１案,臺北市,中正區,幸市里,1078,1400,453,334,787,32,819
公投第１１案,臺北市,中正區,幸市里,1079,1319,446,280,726,22,748
公投第１１案,臺北市,中正區,幸市里,1080,1232,472,263,735,33,768
公投第１１案,臺北市,中正區,東門里,1081,1265,482,290,772,34,806
公投第１１案,臺北市,中正區,東門里,1082,1055,397,251,648,26,674
公投第１１案,臺北市,中正區,東門里,1083,954,340,203,543,25,568
公投第１１案,臺北市,中正區,文北里,1084,1018,385,213,598,23,621
公投第１１案,臺北市,中正區,文北里,1085,1431,494,297,791,25,816
公投第１１案,臺北市,中正區,文北里,1086,1271,369,270,639,40,679
公投第１１案,臺北市,中正區,文北里,1087,983,362,226,588,27,615
公投第１１案,臺北市,中正區,文祥里,1088,1594,547,337,884,33,917
公投第１１案,臺北市,中正區,文祥里,1089,1565,644,333,977,33,1010
公投第１１案,臺北市,中正區,文祥里,1090,1650,554,329,883,31,914
公投第１１案,臺北市,中正區,文祥里,1091,1600,530,330,860,28,888
公投第１１案,臺北市,中正區,三愛里,1092,1391,468,311,779,18,797
公投第１１案,臺北市,中正區,三愛里,1093,1769,607,363,970,34,1004
公投第１１案,臺北市,中正區,三愛里,1094,1487,517,347,864,18,882
公投第１１案,臺北市,中正區,三愛里,1095,1291,481,277,758,25,783
公投第１１案,臺北市,中正區,三愛里,1096,1289,467,287,754,28,782
公投第１１案,臺北市,萬華區,福星里,1097,1305,445,291,736,45,781
公投第１１案,臺北市,萬華區,福星里,1098,1183,354,191,545,57,602
公投第１１案,臺北市,萬華區,福星里,1099,1176,405,239,644,25,669
公投第１１案,臺北市,萬華區,福星里,1100,1169,347,242,589,24,613
公投第１１案,臺北市,萬華區,萬壽里,1101,1457,490,256,746,30,776
公投第１１案,臺北市,萬華區,萬壽里,1102,1563,421,282,703,48,751
公投第１１案,臺北市,萬華區,西門里,1103,1771,510,332,842,28,870
公投第１１案,臺北市,萬華區,西門里,1104,1615,480,328,808,36,844
公投第１１案,臺北市,萬華區,新起里,1105,1478,492,281,773,57,830
公投第１１案,臺北市,萬華區,新起里,1106,1462,474,312,786,29,815
公投第１１案,臺北市,萬華區,新起里,1107,1507,457,236,693,45,738
公投第１１案,臺北市,萬華區,新起里,1108,1347,469,285,754,41,795
公投第１１案,臺北市,萬華區,菜園里,1109,1367,423,268,691,39,730
公投第１１案,臺北市,萬華區,菜園里,1110,1277,452,292,744,39,783
公投第１１案,臺北市,萬華區,菜園里,1111,1395,477,327,804,42,846
公投第１１案,臺北市,萬華區,菜園里,1112,1450,437,311,748,46,794
公投第１１案,臺北市,萬華區,青山里,1113,1340,400,257,657,41,698
公投第１１案,臺北市,萬華區,青山里,1114,1242,378,248,626,39,665
公投第１１案,臺北市,萬華區,青山里,1115,1286,412,241,653,66,719
公投第１１案,臺北市,萬華區,青山里,1116,1324,455,229,684,41,725
公投第１１案,臺北市,萬華區,富民里,1117,1619,496,311,807,52,859
公投第１１案,臺北市,萬華區,富民里,1118,1352,418,228,646,35,681
公投第１１案,臺北市,萬華區,富民里,1119,1440,485,261,746,37,783
公投第１１案,臺北市,萬華區,福音里,1120,1194,398,282,680,44,724
公投第１１案,臺北市,萬華區,福音里,1121,1083,430,218,648,46,694
公投第１１案,臺北市,萬華區,福音里,1122,1237,401,231,632,50,682
公投第１１案,臺北市,萬華區,仁德里,1123,1625,499,359,858,31,889
公投第１１案,臺北市,萬華區,仁德里,1124,1324,463,298,761,42,803
公投第１１案,臺北市,萬華區,仁德里,1125,1352,459,309,768,35,803
公投第１１案,臺北市,萬華區,富福里,1126,2630,451,268,719,38,757
公投第１１案,臺北市,萬華區,富福里,1127,1504,532,341,873,39,912
公投第１１案,臺北市,萬華區,富福里,1128,1425,455,307,762,29,791
公投第１１案,臺北市,萬華區,柳鄉里,1129,1591,477,316,793,42,835
公投第１１案,臺北市,萬華區,柳鄉里,1130,1474,490,283,773,42,815
公投第１１案,臺北市,萬華區,柳鄉里,1131,1612,480,312,792,60,852
公投第１１案,臺北市,萬華區,華江里,1132,1447,453,307,760,52,812
公投第１１案,臺北市,萬華區,華江里,1133,1491,527,298,825,41,866
公投第１１案,臺北市,萬華區,華江里,1134,1500,542,323,865,33,898
公投第１１案,臺北市,萬華區,華江里,1135,1582,557,337,894,41,935
公投第１１案,臺北市,萬華區,華江里,1136,1623,510,304,814,45,859
公投第１１案,臺北市,萬華區,糖廍里,1137,1228,404,252,656,25,681
公投第１１案,臺北市,萬華區,糖廍里,1138,1268,439,242,681,41,722
公投第１１案,臺北市,萬華區,糖廍里,1139,1207,435,252,687,47,734
公投第１１案,臺北市,萬華區,糖廍里,1140,1188,401,281,682,35,717
公投第１１案,臺北市,萬華區,綠堤里,1141,1474,475,282,757,35,792
公投第１１案,臺北市,萬華區,綠堤里,1142,1304,416,201,617,21,638
公投第１１案,臺北市,萬華區,綠堤里,1143,1082,284,147,431,48,479
公投第１１案,臺北市,萬華區,頂碩里,1144,1052,340,207,547,32,579
公投第１１案,臺北市,萬華區,頂碩里,1145,1135,360,253,613,31,644
公投第１１案,臺北市,萬華區,頂碩里,1146,1225,390,246,636,47,683
公投第１１案,臺北市,萬華區,頂碩里,1147,1583,486,314,800,29,829
公投第１１案,臺北市,萬華區,頂碩里,1148,1403,429,311,740,41,781
公投第１１案,臺北市,萬華區,雙園里,1149,1406,473,295,768,48,816
公投第１１案,臺北市,萬華區,雙園里,1150,1401,494,281,775,41,816
公投第１１案,臺北市,萬華區,雙園里,1151,1188,396,282,678,43,721
公投第１１案,臺北市,萬華區,和平里,1152,1597,486,307,793,75,868
公投第１１案,臺北市,萬華區,和平里,1153,1290,490,267,757,44,801
公投第１１案,臺北市,萬華區,和平里,1154,1746,508,346,854,25,879
公投第１１案,臺北市,萬華區,和平里,1155,1595,458,283,741,24,765
公投第１１案,臺北市,萬華區,和德里,1156,1701,534,341,875,63,938
公投第１１案,臺北市,萬華區,和德里,1157,1339,354,251,605,59,664
公投第１１案,臺北市,萬華區,和德里,1158,1484,452,228,680,56,736
公投第１１案,臺北市,萬華區,和德里,1159,1604,557,307,864,48,912
公投第１１案,臺北市,萬華區,全德里,1160,1197,416,262,678,32,710
公投第１１案,臺北市,萬華區,全德里,1161,1347,395,290,685,58,743
公投第１１案,臺北市,萬華區,全德里,1162,1223,455,299,754,30,784
公投第１１案,臺北市,萬華區,日善里,1163,1036,375,232,607,25,632
公投第１１案,臺北市,萬華區,日善里,1164,1035,400,247,647,21,668
公投第１１案,臺北市,萬華區,日善里,1165,1141,447,247,694,28,722
公投第１１案,臺北市,萬華區,忠德里,1166,1271,457,268,725,31,756
公投第１１案,臺北市,萬華區,忠德里,1167,1328,451,300,751,62,813
公投第１１案,臺北市,萬華區,忠德里,1168,1286,477,259,736,29,765
公投第１１案,臺北市,萬華區,錦德里,1169,1679,576,361,937,49,986
公投第１１案,臺北市,萬華區,錦德里,1170,1619,549,332,881,37,918
公投第１１案,臺北市,萬華區,錦德里,1171,1625,515,282,797,28,825
公投第１１案,臺北市,萬華區,孝德里,1172,1623,596,322,918,42,960
公投第１１案,臺北市,萬華區,孝德里,1173,1280,434,247,681,40,721
公投第１１案,臺北市,萬華區,壽德里,1174,1608,533,326,859,39,898
公投第１１案,臺北市,萬華區,壽德里,1175,1453,507,298,805,46,851
公投第１１案,臺北市,萬華區,壽德里,1176,1472,561,319,880,33,913
公投第１１案,臺北市,萬華區,銘德里,1177,1373,459,305,764,33,797
公投第１１案,臺北市,萬華區,銘德里,1178,1394,463,278,741,38,779
公投第１１案,臺北市,萬華區,銘德里,1179,1427,486,264,750,23,773
公投第１１案,臺北市,萬華區,保德里,1180,1342,466,320,786,35,821
公投第１１案,臺北市,萬華區,保德里,1181,1569,560,302,862,56,918
公投第１１案,臺北市,萬華區,榮德里,1182,1514,487,241,728,41,769
公投第１１案,臺北市,萬華區,榮德里,1183,1720,524,308,832,34,866
公投第１１案,臺北市,萬華區,華中里,1184,1461,537,329,866,50,916
公投第１１案,臺北市,萬華區,華中里,1185,1264,448,241,689,27,716
公投第１１案,臺北市,萬華區,華中里,1186,1334,475,303,778,47,825
公投第１１案,臺北市,萬華區,華中里,1187,1446,517,304,821,33,854
公投第１１案,臺北市,萬華區,興德里,1188,1307,419,221,640,46,686
公投第１１案,臺北市,萬華區,興德里,1189,1420,507,278,785,50,835
公投第１１案,臺北市,萬華區,興德里,1190,1427,436,294,730,33,763
公投第１１案,臺北市,萬華區,日祥里,1191,956,344,174,518,29,547
公投第１１案,臺北市,萬華區,日祥里,1192,1352,487,268,755,37,792
公投第１１案,臺北市,萬華區,日祥里,1193,1370,512,217,729,47,776
公投第１１案,臺北市,萬華區,日祥里,1194,1222,491,214,705,29,734
公投第１１案,臺北市,萬華區,忠貞里,1195,1375,607,203,810,31,841
公投第１１案,臺北市,萬華區,忠貞里,1196,1463,546,269,815,46,861
公投第１１案,臺北市,萬華區,忠貞里,1197,1527,522,277,799,31,830
公投第１１案,臺北市,萬華區,新忠里,1198,1485,542,226,768,38,806
公投第１１案,臺北市,萬華區,新忠里,1199,1591,691,259,950,33,983
公投第１１案,臺北市,萬華區,新和里,1200,1394,598,280,878,30,908
公投第１１案,臺北市,萬華區,新和里,1201,1522,557,98,655,28,683
公投第１１案,臺北市,萬華區,新和里,1202,1661,669,314,983,26,1009
公投第１１案,臺北市,萬華區,新和里,1203,1561,654,289,943,25,968
公投第１１案,臺北市,萬華區,新和里,1204,1406,601,273,874,32,906
公投第１１案,臺北市,萬華區,新安里,1205,1498,446,244,690,33,723
公投第１１案,臺北市,萬華區,新安里,1206,1478,436,227,663,45,708
公投第１１案,臺北市,萬華區,新安里,1207,1170,388,227,615,49,664
公投第１１案,臺北市,萬華區,新安里,1208,1376,545,239,784,32,816
公投第１１案,臺北市,萬華區,凌霄里,1209,1093,398,224,622,16,638
公投第１１案,臺北市,萬華區,凌霄里,1210,1084,452,205,657,30,687
公投第１１案,臺北市,萬華區,凌霄里,1211,1119,429,210,639,40,679
公投第１１案,臺北市,萬華區,騰雲里,1212,1381,573,265,838,23,861
公投第１１案,臺北市,萬華區,騰雲里,1213,1396,531,290,821,25,846
公投第１１案,臺北市,大安區,德安里,1214,1184,408,221,629,25,654
公投第１１案,臺北市,大安區,德安里,1215,1197,407,219,626,34,660
公投第１１案,臺北市,大安區,德安里,1216,1221,414,270,684,27,711
公投第１１案,臺北市,大安區,德安里,1217,1246,476,248,724,25,749
公投第１１案,臺北市,大安區,仁慈里,1218,1478,526,350,876,27,903
公投第１１案,臺北市,大安區,仁慈里,1219,1314,410,314,724,35,759
公投第１１案,臺北市,大安區,仁慈里,1220,1594,562,355,917,43,960
公投第１１案,臺北市,大安區,和安里,1221,1429,500,332,832,26,858
公投第１１案,臺北市,大安區,和安里,1222,1452,564,306,870,22,892
公投第１１案,臺北市,大安區,和安里,1223,1551,521,354,875,28,903
公投第１１案,臺北市,大安區,和安里,1224,1335,502,275,777,33,810
公投第１１案,臺北市,大安區,民炤里,1225,1196,399,250,649,19,668
公投第１１案,臺北市,大安區,民炤里,1226,1339,427,280,707,30,737
公投第１１案,臺北市,大安區,民炤里,1227,1448,467,342,809,25,834
公投第１１案,臺北市,大安區,民炤里,1228,1373,488,279,767,31,798
公投第１１案,臺北市,大安區,民炤里,1229,1439,493,305,798,42,840
公投第１１案,臺北市,大安區,仁愛里,1230,1174,394,239,633,5,638
公投第１１案,臺北市,大安區,仁愛里,1231,1144,384,213,597,19,616
公投第１１案,臺北市,大安區,仁愛里,1232,1119,421,160,581,20,601
公投第１１案,臺北市,大安區,仁愛里,1233,1024,325,164,489,16,505
公投第１１案,臺北市,大安區,義村里,1234,1032,413,202,615,13,628
公投第１１案,臺北市,大安區,義村里,1235,1319,550,215,765,24,789
公投第１１案,臺北市,大安區,義村里,1236,1369,507,305,812,28,840
公投第１１案,臺北市,大安區,義村里,1237,1347,447,324,771,28,799
公投第１１案,臺北市,大安區,民輝里,1238,1655,491,346,837,28,865
公投第１１案,臺北市,大安區,民輝里,1239,1595,524,273,797,21,818
公投第１１案,臺北市,大安區,民輝里,1240,1429,469,295,764,31,795
公投第１１案,臺北市,大安區,民輝里,1241,1309,435,251,686,17,703
公投第１１案,臺北市,大安區,昌隆里,1242,1508,519,283,802,26,828
公投第１１案,臺北市,大安區,昌隆里,1243,1310,428,281,709,34,743
公投第１１案,臺北市,大安區,誠安里,1244,1233,412,231,643,23,666
公投第１１案,臺北市,大安區,誠安里,1245,1287,411,253,664,34,698
公投第１１案,臺北市,大安區,誠安里,1246,1147,359,235,594,19,613
公投第１１案,臺北市,大安區,光武里,1247,1260,404,245,649,27,676
公投第１１案,臺北市,大安區,光武里,1248,1377,475,250,725,33,758
公投第１１案,臺北市,大安區,光武里,1249,1284,408,260,668,52,720
公投第１１案,臺北市,大安區,光武里,1250,1314,424,241,665,23,688
公投第１１案,臺北市,大安區,光武里,1251,1273,403,250,653,26,679
公投第１１案,臺北市,大安區,龍坡里,1252,1146,367,286,653,22,675
公投第１１案,臺北市,大安區,龍坡里,1253,1285,458,294,752,18,770
公投第１１案,臺北市,大安區,龍坡里,1254,1297,445,330,775,17,792
公投第１１案,臺北市,大安區,龍坡里,1255,1101,405,254,659,22,681
公投第１１案,臺北市,大安區,龍泉里,1256,1310,422,296,718,42,760
公投第１１案,臺北市,大安區,龍泉里,1257,1365,471,340,811,35,846
公投第１１案,臺北市,大安區,龍泉里,1258,1372,483,292,775,24,799
公投第１１案,臺北市,大安區,古風里,1259,1189,434,275,709,22,731
公投第１１案,臺北市,大安區,古風里,1260,1256,457,288,745,18,763
公投第１１案,臺北市,大安區,古風里,1261,1151,398,262,660,31,691
公投第１１案,臺北市,大安區,古莊里,1262,1501,537,379,916,25,941
公投第１１案,臺北市,大安區,古莊里,1263,1520,587,322,909,25,934
公投第１１案,臺北市,大安區,古莊里,1264,1529,578,342,920,34,954
公投第１１案,臺北市,大安區,古莊里,1265,1579,565,369,934,26,960
公投第１１案,臺北市,大安區,龍安里,1266,2619,407,257,664,14,678
公投第１１案,臺北市,大安區,龍安里,1267,1290,575,162,737,17,754
公投第１１案,臺北市,大安區,龍安里,1268,1307,479,319,798,26,824
公投第１１案,臺北市,大安區,龍安里,1269,1489,528,365,893,25,918
公投第１１案,臺北市,大安區,錦安里,1270,1097,424,238,662,24,686
公投第１１案,臺北市,大安區,錦安里,1271,1328,460,313,773,20,793
公投第１１案,臺北市,大安區,錦安里,1272,1189,416,246,662,18,680
公投第１１案,臺北市,大安區,錦安里,1273,1270,444,288,732,20,752
公投第１１案,臺北市,大安區,福住里,1274,1349,423,337,760,15,775
公投第１１案,臺北市,大安區,福住里,1275,1292,434,276,710,21,731
公投第１１案,臺北市,大安區,福住里,1276,1314,498,288,786,28,814
公投第１１案,臺北市,大安區,福住里,1277,1200,425,282,707,23,730
公投第１１案,臺北市,大安區,永康里,1278,1558,547,327,874,28,902
公投第１１案,臺北市,大安區,永康里,1279,1561,525,343,868,25,893
公投第１１案,臺北市,大安區,光明里,1280,1446,529,308,837,32,869
公投第１１案,臺北市,大安區,光明里,1281,1499,531,335,866,18,884
公投第１１案,臺北市,大安區,錦泰里,1282,1467,554,299,853,21,874
公投第１１案,臺北市,大安區,錦泰里,1283,1511,522,287,809,25,834
公投第１１案,臺北市,大安區,錦華里,1284,1600,582,346,928,38,966
公投第１１案,臺北市,大安區,錦華里,1285,1573,556,353,909,30,939
公投第１１案,臺北市,大安區,錦華里,1286,1467,562,330,892,28,920
公投第１１案,臺北市,大安區,龍圖里,1287,1358,509,273,782,23,805
公投第１１案,臺北市,大安區,龍圖里,1288,1568,553,332,885,23,908
公投第１１案,臺北市,大安區,龍圖里,1289,1411,516,303,819,33,852
公投第１１案,臺北市,大安區,龍圖里,1290,1554,556,301,857,16,873
公投第１１案,臺北市,大安區,新龍里,1291,1345,501,297,798,28,826
公投第１１案,臺北市,大安區,新龍里,1292,1435,584,253,837,11,848
公投第１１案,臺北市,大安區,新龍里,1293,1481,590,328,918,16,934
公投第１１案,臺北市,大安區,新龍里,1294,1451,624,297,921,24,945
公投第１１案,臺北市,大安區,龍陣里,1295,1566,539,242,781,52,833
公投第１１案,臺北市,大安區,龍陣里,1296,1525,543,336,879,21,900
公投第１１案,臺北市,大安區,龍雲里,1297,1336,461,276,737,26,763
公投第１１案,臺北市,大安區,龍雲里,1298,1483,546,317,863,32,895
公投第１１案,臺北市,大安區,龍雲里,1299,1396,445,280,725,18,743
公投第１１案,臺北市,大安區,龍生里,1300,1406,514,320,834,34,868
公投第１１案,臺北市,大安區,龍生里,1301,1434,539,301,840,22,862
公投第１１案,臺北市,大安區,龍生里,1302,1288,447,287,734,25,759
公投第１１案,臺北市,大安區,龍生里,1303,1407,524,298,822,24,846
公投第１１案,臺北市,大安區,住安里,1304,1514,507,315,822,24,846
公投第１１案,臺北市,大安區,住安里,1305,1550,484,257,741,39,780
公投第１１案,臺北市,大安區,住安里,1306,1490,540,299,839,30,869
公投第１１案,臺北市,大安區,義安里,1307,1284,414,292,706,27,733
公投第１１案,臺北市,大安區,義安里,1308,1129,407,255,662,21,683
公投第１１案,臺北市,大安區,義安里,1309,1193,412,275,687,20,707
公投第１１案,臺北市,大安區,義安里,1310,1057,367,211,578,32,610
公投第１１案,臺北市,大安區,通化里,1311,1361,460,295,755,33,788
公投第１１案,臺北市,大安區,通化里,1312,1412,498,267,765,39,804
公投第１１案,臺北市,大安區,通化里,1313,1423,400,267,667,17,684
公投第１１案,臺北市,大安區,通化里,1314,1257,411,264,675,62,737
公投第１１案,臺北市,大安區,通安里,1315,1133,457,228,685,21,706
公投第１１案,臺北市,大安區,通安里,1316,1077,367,247,614,18,632
公投第１１案,臺北市,大安區,通安里,1317,1300,481,268,749,36,785
公投第１１案,臺北市,大安區,通安里,1318,1319,514,267,781,44,825
公投第１１案,臺北市,大安區,臨江里,1319,1265,465,251,716,41,757
公投第１１案,臺北市,大安區,臨江里,1320,1265,445,229,674,28,702
公投第１１案,臺北市,大安區,臨江里,1321,1103,403,226,629,36,665
公投第１１案,臺北市,大安區,法治里,1322,1341,486,288,774,26,800
公投第１１案,臺北市,大安區,法治里,1323,1357,510,286,796,30,826
公投第１１案,臺北市,大安區,法治里,1324,1260,428,286,714,32,746
公投第１１案,臺北市,大安區,全安里,1325,1295,447,290,737,34,771
公投第１１案,臺北市,大安區,全安里,1326,1399,451,294,745,18,763
公投第１１案,臺北市,大安區,全安里,1327,1150,401,228,629,30,659
公投第１１案,臺北市,大安區,群賢里,1328,1351,427,272,699,15,714
公投第１１案,臺北市,大安區,群賢里,1329,1341,463,295,758,36,794
公投第１１案,臺北市,大安區,群賢里,1330,1129,400,213,613,17,630
公投第１１案,臺北市,大安區,群賢里,1331,1328,485,253,738,24,762
公投第１１案,臺北市,大安區,群英里,1332,1557,671,290,961,29,990
公投第１１案,臺北市,大安區,群英里,1333,1461,587,310,897,34,931
公投第１１案,臺北市,大安區,群英里,1334,1589,513,288,801,22,823
公投第１１案,臺北市,大安區,群英里,1335,1473,539,274,813,20,833
公投第１１案,臺北市,大安區,虎嘯里,1336,1479,470,343,813,28,841
公投第１１案,臺北市,大安區,虎嘯里,1337,833,338,157,495,29,524
公投第１１案,臺北市,大安區,虎嘯里,1338,999,340,209,549,26,575
公投第１１案,臺北市,大安區,臥龍里,1339,1757,643,370,1013,25,1038
公投第１１案,臺北市,大安區,龍淵里,1340,1573,571,329,900,26,926
公投第１１案,臺北市,大安區,龍淵里,1341,1587,576,384,960,22,982
公投第１１案,臺北市,大安區,龍淵里,1342,1496,533,341,874,40,914
公投第１１案,臺北市,大安區,龍淵里,1343,1440,481,367,848,20,868
公投第１１案,臺北市,大安區,龍淵里,1344,1578,587,343,930,36,966
公投第１１案,臺北市,大安區,龍門里,1345,1223,412,297,709,19,728
公投第１１案,臺北市,大安區,龍門里,1346,1119,370,268,638,13,651
公投第１１案,臺北市,大安區,龍門里,1347,1252,466,296,762,11,773
公投第１１案,臺北市,大安區,大學里,1348,1576,553,367,920,37,957
公投第１１案,臺北市,大安區,大學里,1349,1425,496,307,803,31,834
公投第１１案,臺北市,大安區,大學里,1350,1450,486,298,784,19,803
公投第１１案,臺北市,大安區,大學里,1351,1444,699,201,900,22,922
公投第１１案,臺北市,大安區,大學里,1352,1337,496,327,823,30,853
公投第１１案,臺北市,大安區,芳和里,1353,1417,482,288,770,17,787
公投第１１案,臺北市,大安區,芳和里,1354,1250,466,262,728,23,751
公投第１１案,臺北市,大安區,芳和里,1355,1176,410,238,648,37,685
公投第１１案,臺北市,大安區,芳和里,1356,1257,500,263,763,24,787
公投第１１案,臺北市,大安區,黎元里,1357,1257,451,264,715,36,751
公投第１１案,臺北市,大安區,黎元里,1358,1148,406,256,662,28,690
公投第１１案,臺北市,大安區,黎元里,1359,1418,483,316,799,27,826
公投第１１案,臺北市,大安區,黎元里,1360,1028,345,230,575,23,598
公投第１１案,臺北市,大安區,黎孝里,1361,1445,508,338,846,26,872
公投第１１案,臺北市,大安區,黎孝里,1362,1361,486,297,783,34,817
公投第１１案,臺北市,大安區,黎孝里,1363,1343,556,262,818,26,844
公投第１１案,臺北市,大安區,黎孝里,1364,1267,456,271,727,30,757
公投第１１案,臺北市,大安區,黎孝里,1365,1380,436,288,724,23,747
公投第１１案,臺北市,大安區,黎和里,1366,1524,502,326,828,45,873
公投第１１案,臺北市,大安區,黎和里,1367,1470,564,291,855,24,879
公投第１１案,臺北市,大安區,黎和里,1368,1318,418,230,648,32,680
公投第１１案,臺北市,大安區,建安里,1369,1430,482,275,757,26,783
公投第１１案,臺北市,大安區,建安里,1370,1386,510,261,771,28,799
公投第１１案,臺北市,大安區,建安里,1371,1438,493,265,758,19,777
公投第１１案,臺北市,大安區,建倫里,1372,1270,410,237,647,17,664
公投第１１案,臺北市,大安區,建倫里,1373,1395,480,263,743,37,780
公投第１１案,臺北市,大安區,建倫里,1374,1292,465,243,708,31,739
公投第１１案,臺北市,大安區,建倫里,1375,1310,419,289,708,25,733
公投第１１案,臺北市,大安區,敦安里,1376,1319,448,281,729,27,756
公投第１１案,臺北市,大安區,敦安里,1377,1355,474,309,783,19,802
公投第１１案,臺北市,大安區,敦安里,1378,1312,428,247,675,17,692
公投第１１案,臺北市,大安區,敦安里,1379,1335,472,277,749,21,770
公投第１１案,臺北市,大安區,正聲里,1380,1489,481,292,773,25,798
公投第１１案,臺北市,大安區,正聲里,1381,1307,473,279,752,19,771
公投第１１案,臺北市,大安區,正聲里,1382,1328,418,270,688,17,705
公投第１１案,臺北市,大安區,敦煌里,1383,1277,440,258,698,7,705
公投第１１案,臺北市,大安區,敦煌里,1384,1314,443,289,732,30,762
公投第１１案,臺北市,大安區,敦煌里,1385,1270,459,278,737,30,767
公投第１１案,臺北市,大安區,敦煌里,1386,1308,416,303,719,40,759
公投第１１案,臺北市,大安區,華聲里,1387,1138,419,250,669,15,684
公投第１１案,臺北市,大安區,華聲里,1388,1333,464,254,718,26,744
公投第１１案,臺北市,大安區,華聲里,1389,1176,406,254,660,32,692
公投第１１案,臺北市,大安區,車層里,1390,1311,459,259,718,30,748
公投第１１案,臺北市,大安區,車層里,1391,1295,466,246,712,18,730
公投第１１案,臺北市,大安區,車層里,1392,1421,527,279,806,34,840
公投第１１案,臺北市,大安區,車層里,1393,1409,477,275,752,28,780
公投第１１案,臺北市,大安區,光信里,1394,1434,492,325,817,30,847
公投第１１案,臺北市,大安區,光信里,1395,1449,464,279,743,46,789
公投第１１案,臺北市,大安區,光信里,1396,1284,445,291,736,26,762
公投第１１案,臺北市,大安區,光信里,1397,1248,441,250,691,21,712
公投第１１案,臺北市,大安區,光信里,1398,1119,442,277,719,18,737
公投第１１案,臺北市,大安區,學府里,1399,883,319,189,508,27,535
公投第１１案,臺北市,大安區,學府里,1400,630,214,102,316,44,360
公投第１１案,臺北市,大安區,學府里,1401,814,277,174,451,34,485
公投第１１案,臺北市,文山區,景行里,1402,1539,525,315,840,28,868
公投第１１案,臺北市,文山區,景行里,1403,1548,550,277,827,23,850
公投第１１案,臺北市,文山區,景行里,1404,1493,555,300,855,48,903
公投第１１案,臺北市,文山區,景行里,1405,1648,601,362,963,37,1000
公投第１１案,臺北市,文山區,景東里,1406,1544,546,324,870,23,893
公投第１１案,臺北市,文山區,景東里,1407,1557,577,297,874,35,909
公投第１１案,臺北市,文山區,景東里,1408,1514,514,304,818,35,853
公投第１１案,臺北市,文山區,景東里,1409,1540,615,341,956,29,985
公投第１１案,臺北市,文山區,景美里,1410,1466,570,309,879,25,904
公投第１１案,臺北市,文山區,景美里,1411,1444,582,279,861,34,895
公投第１１案,臺北市,文山區,景美里,1412,1455,553,293,846,40,886
公投第１１案,臺北市,文山區,景慶里,1413,1440,524,269,793,20,813
公投第１１案,臺北市,文山區,景慶里,1414,1398,620,297,917,32,949
公投第１１案,臺北市,文山區,景慶里,1415,1412,494,295,789,20,809
公投第１１案,臺北市,文山區,景慶里,1416,1426,527,280,807,28,835
公投第１１案,臺北市,文山區,景仁里,1417,1437,520,308,828,29,857
公投第１１案,臺北市,文山區,景仁里,1418,1340,507,270,777,28,805
公投第１１案,臺北市,文山區,景仁里,1419,1568,555,334,889,24,913
公投第１１案,臺北市,文山區,景華里,1420,1372,537,260,797,20,817
公投第１１案,臺北市,文山區,景華里,1421,1046,373,224,597,19,616
公投第１１案,臺北市,文山區,景華里,1422,1274,429,281,710,42,752
公投第１１案,臺北市,文山區,景華里,1423,1324,512,249,761,26,787
公投第１１案,臺北市,文山區,萬有里,1424,1722,609,344,953,33,986
公投第１１案,臺北市,文山區,萬有里,1425,1737,665,332,997,42,1039
公投第１１案,臺北市,文山區,萬有里,1426,1370,527,324,851,15,866
公投第１１案,臺北市,文山區,萬祥里,1427,1495,537,305,842,39,881
公投第１１案,臺北市,文山區,萬祥里,1428,1328,482,295,777,34,811
公投第１１案,臺北市,文山區,萬祥里,1429,1138,443,237,680,29,709
公投第１１案,臺北市,文山區,萬隆里,1430,1471,572,307,879,22,901
公投第１１案,臺北市,文山區,萬隆里,1431,1144,453,242,695,20,715
公投第１１案,臺北市,文山區,萬隆里,1432,1176,467,260,727,33,760
公投第１１案,臺北市,文山區,萬隆里,1433,1212,489,255,744,28,772
公投第１１案,臺北市,文山區,萬隆里,1434,1214,509,268,777,18,795
公投第１１案,臺北市,文山區,萬年里,1435,1170,392,253,645,29,674
公投第１１案,臺北市,文山區,萬年里,1436,1308,489,288,777,33,810
公投第１１案,臺北市,文山區,萬年里,1437,1190,553,158,711,22,733
公投第１１案,臺北市,文山區,萬年里,1438,1110,414,231,645,26,671
公投第１１案,臺北市,文山區,萬和里,1439,1512,564,298,862,36,898
公投第１１案,臺北市,文山區,萬和里,1440,1387,564,256,820,38,858
公投第１１案,臺北市,文山區,萬盛里,1441,1355,499,281,780,37,817
公投第１１案,臺北市,文山區,萬盛里,1442,1370,464,320,784,42,826
公投第１１案,臺北市,文山區,萬盛里,1443,1484,544,308,852,39,891
公投第１１案,臺北市,文山區,興豐里,1444,1786,635,363,998,49,1047
公投第１１案,臺北市,文山區,興豐里,1445,1260,480,246,726,44,770
公投第１１案,臺北市,文山區,興豐里,1446,1194,466,296,762,21,783
公投第１１案,臺北市,文山區,興邦里,1447,1444,520,308,828,33,861
公投第１１案,臺北市,文山區,興邦里,1448,1495,579,292,871,32,903
公投第１１案,臺北市,文山區,興邦里,1449,1446,584,281,865,26,891
公投第１１案,臺北市,文山區,興光里,1450,1450,532,271,803,47,850
公投第１１案,臺北市,文山區,興光里,1451,1486,558,322,880,36,916
公投第１１案,臺北市,文山區,興家里,1452,1259,484,265,749,24,773
公投第１１案,臺北市,文山區,興家里,1453,1317,534,266,800,18,818
公投第１１案,臺北市,文山區,興家里,1454,1321,478,323,801,24,825
公投第１１案,臺北市,文山區,興家里,1455,1475,513,325,838,28,866
公投第１１案,臺北市,文山區,興家里,1456,1271,446,257,703,32,735
公投第１１案,臺北市,文山區,興得里,1457,1609,629,312,941,32,973
公投第１１案,臺北市,文山區,興得里,1458,1501,536,279,815,29,844
公投第１１案,臺北市,文山區,興得里,1459,997,337,194,531,21,552
公投第１１案,臺北市,文山區,興得里,1460,1052,394,259,653,30,683
公投第１１案,臺北市,文山區,興業里,1461,1247,481,253,734,31,765
公投第１１案,臺北市,文山區,興業里,1462,1167,448,250,698,39,737
公投第１１案,臺北市,文山區,興業里,1463,1280,499,274,773,18,791
公投第１１案,臺北市,文山區,興業里,1464,1153,461,237,698,23,721
公投第１１案,臺北市,文山區,興安里,1465,1557,587,337,924,33,957
公投第１１案,臺北市,文山區,興安里,1466,1444,566,253,819,42,861
公投第１１案,臺北市,文山區,興安里,1467,1459,575,325,900,33,933
公投第１１案,臺北市,文山區,興安里,1468,1357,571,268,839,24,863
公投第１１案,臺北市,文山區,興福里,1469,1194,520,256,776,23,799
公投第１１案,臺北市,文山區,興福里,1470,1184,462,264,726,38,764
公投第１１案,臺北市,文山區,興福里,1471,1119,442,248,690,22,712
公投第１１案,臺北市,文山區,興福里,1472,1350,516,307,823,34,857
公投第１１案,臺北市,文山區,興旺里,1473,1502,566,257,823,24,847
公投第１１案,臺北市,文山區,興旺里,1474,1511,630,276,906,38,944
公投第１１案,臺北市,文山區,興旺里,1475,1481,583,334,917,25,942
公投第１１案,臺北市,文山區,興旺里,1476,1477,605,299,904,27,931
公投第１１案,臺北市,文山區,興旺里,1477,1294,504,275,779,21,800
公投第１１案,臺北市,文山區,興泰里,1478,1040,447,235,682,26,708
公投第１１案,臺北市,文山區,興泰里,1479,1323,533,274,807,28,835
公投第１１案,臺北市,文山區,興泰里,1480,1153,439,252,691,22,713
公投第１１案,臺北市,文山區,興昌里,1481,1525,559,289,848,31,879
公投第１１案,臺北市,文山區,興昌里,1482,1412,514,250,764,33,797
公投第１１案,臺北市,文山區,興昌里,1483,1473,520,374,894,39,933
公投第１１案,臺北市,文山區,興昌里,1484,1486,502,376,878,27,905
公投第１１案,臺北市,文山區,試院里,1485,1616,651,336,987,31,1018
公投第１１案,臺北市,文山區,試院里,1486,1489,605,304,909,37,946
公投第１１案,臺北市,文山區,試院里,1487,1414,555,260,815,27,842
公投第１１案,臺北市,文山區,試院里,1488,1494,575,360,935,29,964
公投第１１案,臺北市,文山區,華興里,1489,1547,601,320,921,41,962
公投第１１案,臺北市,文山區,華興里,1490,1587,614,317,931,37,968
公投第１１案,臺北市,文山區,華興里,1491,1515,577,351,928,26,954
公投第１１案,臺北市,文山區,華興里,1492,1573,611,342,953,39,992
公投第１１案,臺北市,文山區,華興里,1493,1542,582,358,940,25,965
公投第１１案,臺北市,文山區,明義里,1494,1465,494,277,771,39,810
公投第１１案,臺北市,文山區,明義里,1495,699,201,117,318,29,347
公投第１１案,臺北市,文山區,明義里,1496,1372,434,253,687,25,712
公投第１１案,臺北市,文山區,明興里,1497,1448,451,250,701,45,746
公投第１１案,臺北市,文山區,明興里,1498,1548,592,293,885,31,916
公投第１１案,臺北市,文山區,明興里,1499,1501,553,323,876,27,903
公投第１１案,臺北市,文山區,明興里,1500,1560,583,354,937,31,968
公投第１１案,臺北市,文山區,木柵里,1501,1567,578,326,904,27,931
公投第１１案,臺北市,文山區,木柵里,1502,1554,552,350,902,21,923
公投第１１案,臺北市,文山區,木柵里,1503,1544,566,317,883,35,918
公投第１１案,臺北市,文山區,木柵里,1504,1528,578,332,910,27,937
公投第１１案,臺北市,文山區,木柵里,1505,1543,621,320,941,26,967
公投第１１案,臺北市,文山區,木新里,1506,2754,562,344,906,45,951
公投第１１案,臺北市,文山區,木新里,1507,1709,541,305,846,48,894
公投第１１案,臺北市,文山區,木新里,1508,1515,551,264,815,56,871
公投第１１案,臺北市,文山區,木新里,1509,1571,520,300,820,42,862
公投第１１案,臺北市,文山區,木新里,1510,1578,515,356,871,39,910
公投第１１案,臺北市,文山區,順興里,1511,1454,516,284,800,26,826
公投第１１案,臺北市,文山區,順興里,1512,1436,526,285,811,44,855
公投第１１案,臺北市,文山區,順興里,1513,1402,569,289,858,34,892
公投第１１案,臺北市,文山區,順興里,1514,1117,428,244,672,28,700
公投第１１案,臺北市,文山區,順興里,1515,1094,389,224,613,44,657
公投第１１案,臺北市,文山區,忠順里,1516,1070,445,214,659,30,689
公投第１１案,臺北市,文山區,忠順里,1517,1319,549,271,820,33,853
公投第１１案,臺北市,文山區,忠順里,1518,1226,506,259,765,26,791
公投第１１案,臺北市,文山區,樟林里,1519,1385,492,263,755,30,785
公投第１１案,臺北市,文山區,樟林里,1520,1416,492,315,807,39,846
公投第１１案,臺北市,文山區,樟林里,1521,1412,577,296,873,34,907
公投第１１案,臺北市,文山區,樟林里,1522,1535,545,302,847,46,893
公投第１１案,臺北市,文山區,樟林里,1523,1654,656,344,1000,44,1044
公投第１１案,臺北市,文山區,樟新里,1524,1156,446,260,706,25,731
公投第１１案,臺北市,文山區,樟新里,1525,1231,465,292,757,28,785
公投第１１案,臺北市,文山區,樟新里,1526,1218,523,173,696,38,734
公投第１１案,臺北市,文山區,樟新里,1527,1176,455,276,731,27,758
公投第１１案,臺北市,文山區,樟文里,1528,1392,534,327,861,4,865
公投第１１案,臺北市,文山區,樟文里,1529,1323,459,268,727,57,784
公投第１１案,臺北市,文山區,樟文里,1530,1297,482,257,739,24,763
公投第１１案,臺北市,文山區,樟文里,1531,1296,500,287,787,31,818
公投第１１案,臺北市,文山區,樟腳里,1532,1613,573,322,895,37,932
公投第１１案,臺北市,文山區,樟腳里,1533,1697,620,351,971,63,1034
公投第１１案,臺北市,文山區,樟腳里,1534,1579,556,335,891,53,944
公投第１１案,臺北市,文山區,樟樹里,1535,1320,513,285,798,39,837
公投第１１案,臺北市,文山區,樟樹里,1536,1438,553,300,853,21,874
公投第１１案,臺北市,文山區,樟樹里,1537,1465,539,257,796,18,814
公投第１１案,臺北市,文山區,萬芳里,1538,1646,571,389,960,36,996
公投第１１案,臺北市,文山區,萬芳里,1539,1286,480,269,749,39,788
公投第１１案,臺北市,文山區,萬芳里,1540,1219,443,276,719,17,736
公投第１１案,臺北市,文山區,萬芳里,1541,1292,493,288,781,32,813
公投第１１案,臺北市,文山區,萬芳里,1542,1489,543,279,822,40,862
公投第１１案,臺北市,文山區,萬美里,1543,1611,550,403,953,36,989
公投第１１案,臺北市,文山區,萬美里,1544,1549,490,290,780,36,816
公投第１１案,臺北市,文山區,萬美里,1545,1678,601,310,911,41,952
公投第１１案,臺北市,文山區,萬美里,1546,1660,592,311,903,46,949
公投第１１案,臺北市,文山區,博嘉里,1547,1816,544,338,882,28,910
公投第１１案,臺北市,文山區,博嘉里,1548,985,342,231,573,23,596
公投第１１案,臺北市,文山區,博嘉里,1549,1314,497,297,794,17,811
公投第１１案,臺北市,文山區,博嘉里,1550,1018,366,228,594,24,618
公投第１１案,臺北市,文山區,萬興里,1551,1578,548,364,912,29,941
公投第１１案,臺北市,文山區,萬興里,1552,1457,505,317,822,36,858
公投第１１案,臺北市,文山區,萬興里,1553,1326,521,273,794,28,822
公投第１１案,臺北市,文山區,萬興里,1554,1393,515,321,836,26,862
公投第１１案,臺北市,文山區,萬興里,1555,1377,467,290,757,39,796
公投第１１案,臺北市,文山區,政大里,1556,1448,487,359,846,25,871
公投第１１案,臺北市,文山區,政大里,1557,1447,533,351,884,34,918
公投第１１案,臺北市,文山區,政大里,1558,1739,645,459,1104,33,1137
公投第１１案,臺北市,文山區,政大里,1559,1457,507,355,862,21,883
公投第１１案,臺北市,文山區,指南里,1560,1288,465,293,758,37,795
公投第１１案,臺北市,文山區,指南里,1561,1301,410,269,679,37,716
公投第１１案,臺北市,文山區,指南里,1562,865,263,168,431,47,478
公投第１１案,臺北市,文山區,老泉里,1563,789,263,153,416,27,443
公投第１１案,高雄市,桃源區,梅山里,1,264,80,44,124,0,124
公投第１１案,高雄市,桃源區,拉芙蘭里,2,233,120,46,166,6,172
公投第１１案,高雄市,桃源區,復興里,3,279,144,36,180,6,186
公投第１１案,高雄市,桃源區,勤和里,4,223,128,34,162,2,164
公投第１１案,高雄市,桃源區,桃源里,5,783,368,110,478,12,490
公投第１１案,高雄市,桃源區,高中里,6,632,299,96,395,5,400
公投第１１案,高雄市,桃源區,建山里,7,612,301,113,414,6,420
公投第１１案,高雄市,桃源區,寶山里,8,472,175,68,243,24,267
公投第１１案,高雄市,那瑪夏區,達卡努瓦里,9,741,346,129,475,31,506
公投第１１案,高雄市,那瑪夏區,達卡努瓦里,10,585,291,104,395,32,427
公投第１１案,高雄市,那瑪夏區,瑪雅里,11,609,371,82,453,21,474
公投第１１案,高雄市,那瑪夏區,南沙魯里,12,489,303,43,346,9,355
公投第１１案,高雄市,甲仙區,東安里,13,472,132,51,183,9,192
公投第１１案,高雄市,甲仙區,西安里,14,882,381,132,513,49,562
公投第１１案,高雄市,甲仙區,和安里,15,668,246,84,330,31,361
公投第１１案,高雄市,甲仙區,大田里,16,1581,472,230,702,93,795
公投第１１案,高雄市,甲仙區,寶隆里,17,673,162,86,248,14,262
公投第１１案,高雄市,甲仙區,關山里,18,607,181,71,252,44,296
公投第１１案,高雄市,甲仙區,小林里,19,534,166,82,248,28,276
公投第１１案,高雄市,六龜區,新威里,20,760,266,110,376,31,407
公投第１１案,高雄市,六龜區,新興里,21,666,188,85,273,36,309
公投第１１案,高雄市,六龜區,新寮里,22,704,273,98,371,42,413
公投第１１案,高雄市,六龜區,新發里,23,1003,325,138,463,51,514
公投第１１案,高雄市,六龜區,荖濃里,24,1382,416,161,577,87,664
公投第１１案,高雄市,六龜區,六龜里,25,986,259,110,369,48,417
公投第１１案,高雄市,六龜區,義寶里,26,1046,323,169,492,48,540
公投第１１案,高雄市,六龜區,興龍里,27,812,250,104,354,29,383
公投第１１案,高雄市,六龜區,中興里,28,1431,424,177,601,63,664
公投第１１案,高雄市,六龜區,寶來里,29,912,334,93,427,61,488
公投第１１案,高雄市,六龜區,文武里,30,1472,383,183,566,43,609
公投第１１案,高雄市,六龜區,大津里,31,327,94,36,130,15,145
公投第１１案,高雄市,杉林區,杉林里,32,640,185,85,270,48,318
公投第１１案,高雄市,杉林區,木梓里,33,696,229,84,313,27,340
公投第１１案,高雄市,杉林區,集來里,34,1284,333,129,462,30,492
公投第１１案,高雄市,杉林區,新庄里,35,1027,312,123,435,26,461
公投第１１案,高雄市,杉林區,新庄里,36,482,171,52,223,22,245
公投第１１案,高雄市,杉林區,上平里,37,1627,570,256,826,85,911
公投第１１案,高雄市,杉林區,月眉里,38,1630,533,194,727,33,760
公投第１１案,高雄市,杉林區,大愛里,39,973,254,125,379,20,399
公投第１１案,高雄市,杉林區,大愛里,40,987,309,116,425,14,439
公投第１１案,高雄市,杉林區,月美里,41,1261,440,159,599,67,666
公投第１１案,高雄市,內門區,溝坪里,42,969,328,112,440,45,485
公投第１１案,高雄市,內門區,金竹里,43,652,208,85,293,16,309
公投第１１案,高雄市,內門區,永富里,44,961,329,136,465,51,516
公投第１１案,高雄市,內門區,永吉里,45,426,166,42,208,8,216
公投第１１案,高雄市,內門區,永興里,46,398,138,39,177,11,188
公投第１１案,高雄市,內門區,石坑里,47,508,153,75,228,12,240
公投第１１案,高雄市,內門區,內門里,48,980,398,147,545,35,580
公投第１１案,高雄市,內門區,內豊里,49,1225,362,144,506,34,540
公投第１１案,高雄市,內門區,觀亭里,50,1722,581,285,866,107,973
公投第１１案,高雄市,內門區,中埔里,51,560,170,81,251,24,275
公投第１１案,高雄市,內門區,內東里,52,801,255,96,351,13,364
公投第１１案,高雄市,內門區,內南里,53,423,145,65,210,12,222
公投第１１案,高雄市,內門區,東埔里,54,497,156,63,219,20,239
公投第１１案,高雄市,內門區,三平里,55,677,244,88,332,12,344
公投第１１案,高雄市,內門區,木柵里,56,593,191,58,249,6,255
公投第１１案,高雄市,內門區,內興里,57,597,210,56,266,23,289
公投第１１案,高雄市,內門區,瑞山里,58,343,114,37,151,3,154
公投第１１案,高雄市,內門區,光興里,59,670,232,108,340,29,369
公投第１１案,高雄市,旗山區,太平里,60,1060,410,190,600,39,639
公投第１１案,高雄市,旗山區,太平里,61,1125,419,149,568,29,597
公投第１１案,高雄市,旗山區,大德里,62,1100,456,202,658,22,680
公投第１１案,高雄市,旗山區,大德里,63,1238,533,213,746,21,767
公投第１１案,高雄市,旗山區,湄洲里,64,933,374,142,516,23,539
公投第１１案,高雄市,旗山區,湄洲里,65,727,255,123,378,15,393
公投第１１案,高雄市,旗山區,圓富里,66,1071,412,162,574,36,610
公投第１１案,高雄市,旗山區,圓富里,67,744,259,118,377,26,403
公投第１１案,高雄市,旗山區,中正里,68,1100,377,173,550,26,576
公投第１１案,高雄市,旗山區,中正里,69,369,144,44,188,11,199
公投第１１案,高雄市,旗山區,大林里,70,888,310,109,419,6,425
公投第１１案,高雄市,旗山區,大林里,71,510,164,64,228,18,246
公投第１１案,高雄市,旗山區,上洲里,72,1042,422,148,570,79,649
公投第１１案,高雄市,旗山區,新光里,73,791,295,104,399,40,439
公投第１１案,高雄市,旗山區,南勝里,74,939,342,178,520,50,570
公投第１１案,高雄市,旗山區,南勝里,75,1218,422,176,598,37,635
公投第１１案,高雄市,旗山區,中寮里,76,178,58,26,84,15,99
公投第１１案,高雄市,旗山區,東平里,77,946,391,151,542,48,590
公投第１１案,高雄市,旗山區,東平里,78,1025,372,184,556,28,584
公投第１１案,高雄市,旗山區,東昌里,79,1040,428,168,596,104,700
公投第１１案,高雄市,旗山區,竹峰里,80,900,377,166,543,44,587
公投第１１案,高雄市,旗山區,竹峰里,81,663,233,103,336,22,358
公投第１１案,高雄市,旗山區,瑞吉里,82,954,340,173,513,30,543
公投第１１案,高雄市,旗山區,瑞吉里,83,1060,415,163,578,25,603
公投第１１案,高雄市,旗山區,永和里,84,1110,430,205,635,42,677
公投第１１案,高雄市,旗山區,永和里,85,1062,366,219,585,46,631
公投第１１案,高雄市,旗山區,永和里,86,1151,451,186,637,29,666
公投第１１案,高雄市,旗山區,三協里,87,266,109,42,151,15,166
公投第１１案,高雄市,旗山區,三協里,88,633,249,112,361,29,390
公投第１１案,高雄市,旗山區,三協里,89,1307,446,190,636,29,665
公投第１１案,高雄市,旗山區,鯤洲里,90,754,251,138,389,46,435
公投第１１案,高雄市,旗山區,大山里,91,1296,435,222,657,92,749
公投第１１案,高雄市,旗山區,中洲里,92,839,250,121,371,17,388
公投第１１案,高雄市,旗山區,南洲里,93,1329,501,225,726,44,770
公投第１１案,高雄市,旗山區,廣福里,94,628,254,103,357,16,373
公投第１１案,高雄市,美濃區,福安里,95,1175,443,177,620,75,695
公投第１１案,高雄市,美濃區,福安里,96,1438,509,201,710,24,734
公投第１１案,高雄市,美濃區,合和里,97,989,359,118,477,36,513
公投第１１案,高雄市,美濃區,合和里,98,1427,564,107,671,51,722
公投第１１案,高雄市,美濃區,祿興里,99,1309,474,205,679,60,739
公投第１１案,高雄市,美濃區,祿興里,100,1263,507,203,710,55,765
公投第１１案,高雄市,美濃區,中壇里,101,997,426,141,567,41,608
公投第１１案,高雄市,美濃區,中壇里,102,1064,448,155,603,46,649
公投第１１案,高雄市,美濃區,德興里,103,1498,544,220,764,75,839
公投第１１案,高雄市,美濃區,龍山里,104,1119,428,167,595,63,658
公投第１１案,高雄市,美濃區,龍山里,105,1031,424,127,551,56,607
公投第１１案,高雄市,美濃區,獅山里,106,1437,497,201,698,69,767
公投第１１案,高雄市,美濃區,獅山里,107,1071,408,152,560,47,607
公投第１１案,高雄市,美濃區,龍肚里,108,687,285,89,374,20,394
公投第１１案,高雄市,美濃區,龍肚里,109,775,247,95,342,23,365
公投第１１案,高雄市,美濃區,廣德里,110,1353,494,159,653,45,698
公投第１１案,高雄市,美濃區,興隆里,111,1191,421,159,580,28,608
公投第１１案,高雄市,美濃區,中圳里,112,906,313,119,432,29,461
公投第１１案,高雄市,美濃區,中圳里,113,1178,493,169,662,33,695
公投第１１案,高雄市,美濃區,東門里,114,1252,446,160,606,33,639
公投第１１案,高雄市,美濃區,泰安里,115,1549,641,202,843,44,887
公投第１１案,高雄市,美濃區,瀰濃里,116,1088,415,135,550,26,576
公投第１１案,高雄市,美濃區,瀰濃里,117,1116,443,150,593,44,637
公投第１１案,高雄市,美濃區,清水里,118,977,365,144,509,19,528
公投第１１案,高雄市,美濃區,清水里,119,816,314,138,452,60,512
公投第１１案,高雄市,美濃區,吉洋里,120,955,313,101,414,32,446
公投第１１案,高雄市,美濃區,吉洋里,121,943,351,134,485,68,553
公投第１１案,高雄市,美濃區,吉和里,122,1371,520,171,691,49,740
公投第１１案,高雄市,美濃區,吉東里,123,919,309,33,342,163,505
公投第１１案,高雄市,美濃區,吉東里,124,915,362,160,522,45,567
公投第１１案,高雄市,美濃區,廣林里,125,828,280,108,388,69,457
公投第１１案,高雄市,美濃區,廣林里,126,674,179,96,275,45,320
公投第１１案,高雄市,茂林區,多納里,127,507,235,97,332,24,356
公投第１１案,高雄市,茂林區,萬山里,128,382,208,66,274,13,287
公投第１１案,高雄市,茂林區,茂林里,129,726,369,100,469,16,485
公投第１１案,高雄市,茄萣區,福德里,130,976,341,143,484,17,501
公投第１１案,高雄市,茄萣區,萬福里,131,887,304,131,435,53,488
公投第１１案,高雄市,茄萣區,白雲里,132,1710,640,233,873,38,911
公投第１１案,高雄市,茄萣區,嘉賜里,133,1280,398,182,580,35,615
公投第１１案,高雄市,茄萣區,嘉賜里,134,1314,543,230,773,25,798
公投第１１案,高雄市,茄萣區,嘉賜里,135,1157,493,207,700,31,731
公投第１１案,高雄市,茄萣區,嘉安里,136,1785,650,274,924,68,992
公投第１１案,高雄市,茄萣區,嘉樂里,137,838,318,134,452,38,490
公投第１１案,高雄市,茄萣區,嘉樂里,138,1249,554,220,774,50,824
公投第１１案,高雄市,茄萣區,嘉泰里,139,1116,405,170,575,44,619
公投第１１案,高雄市,茄萣區,嘉福里,140,978,324,167,491,35,526
公投第１１案,高雄市,茄萣區,和協里,141,1125,393,131,524,27,551
公投第１１案,高雄市,茄萣區,嘉定里,142,1139,389,187,576,49,625
公投第１１案,高雄市,茄萣區,保定里,143,1363,486,215,701,75,776
公投第１１案,高雄市,茄萣區,保定里,144,1598,641,258,899,64,963
公投第１１案,高雄市,茄萣區,大定里,145,1111,391,166,557,40,597
公投第１１案,高雄市,茄萣區,光定里,146,925,305,117,422,23,445
公投第１１案,高雄市,茄萣區,吉定里,147,1148,409,174,583,43,626
公投第１１案,高雄市,茄萣區,崎漏里,148,1353,516,158,674,29,703
公投第１１案,高雄市,茄萣區,崎漏里,149,1331,495,199,694,41,735
公投第１１案,高雄市,茄萣區,崎漏里,150,1829,598,262,860,45,905
公投第１１案,高雄市,湖內區,海山里,151,1112,435,145,580,39,619
公投第１１案,高雄市,湖內區,劉家里,152,1017,385,163,548,45,593
公投第１１案,高雄市,湖內區,太爺里,153,796,270,152,422,14,436
公投第１１案,高雄市,湖內區,公舘里,154,1079,452,204,656,22,678
公投第１１案,高雄市,湖內區,公舘里,155,1115,433,210,643,23,666
公投第１１案,高雄市,湖內區,葉厝里,156,1311,469,205,674,37,711
公投第１１案,高雄市,湖內區,葉厝里,157,1319,493,191,684,24,708
公投第１１案,高雄市,湖內區,大湖里,158,1244,513,230,743,47,790
公投第１１案,高雄市,湖內區,大湖里,159,1227,520,224,744,34,778
公投第１１案,高雄市,湖內區,大湖里,160,1163,468,193,661,45,706
公投第１１案,高雄市,湖內區,田尾里,161,981,399,169,568,29,597
公投第１１案,高雄市,湖內區,湖內里,162,780,289,131,420,15,435
公投第１１案,高雄市,湖內區,湖內里,163,832,333,119,452,35,487
公投第１１案,高雄市,湖內區,湖內里,164,1017,421,195,616,26,642
公投第１１案,高雄市,湖內區,湖內里,165,1051,410,196,606,17,623
公投第１１案,高雄市,湖內區,海埔里,166,941,370,146,516,23,539
公投第１１案,高雄市,湖內區,海埔里,167,863,329,125,454,36,490
公投第１１案,高雄市,湖內區,文賢里,168,1160,381,215,596,35,631
公投第１１案,高雄市,湖內區,中賢里,169,1090,321,148,469,26,495
公投第１１案,高雄市,湖內區,中賢里,170,1122,397,207,604,50,654
公投第１１案,高雄市,湖內區,逸賢里,171,1123,374,170,544,19,563
公投第１１案,高雄市,湖內區,忠興里,172,684,262,96,358,32,390
公投第１１案,高雄市,湖內區,湖東里,173,1249,429,187,616,20,636
公投第１１案,高雄市,湖內區,湖東里,174,1453,483,209,692,30,722
公投第１１案,高雄市,路竹區,竹滬里,175,1026,376,162,538,26,564
公投第１１案,高雄市,路竹區,竹滬里,176,1069,391,192,583,51,634
公投第１１案,高雄市,路竹區,竹滬里,177,1127,431,203,634,57,691
公投第１１案,高雄市,路竹區,頂寮里,178,1179,476,171,647,35,682
公投第１１案,高雄市,路竹區,新達里,179,1237,448,201,649,53,702
公投第１１案,高雄市,路竹區,後鄉里,180,1096,410,208,618,40,658
公投第１１案,高雄市,路竹區,北嶺里,181,1272,555,208,763,49,812
公投第１１案,高雄市,路竹區,社西里,182,1182,469,200,669,35,704
公投第１１案,高雄市,路竹區,社西里,183,1127,434,186,620,36,656
公投第１１案,高雄市,路竹區,甲北里,184,956,372,169,541,35,576
公投第１１案,高雄市,路竹區,甲北里,185,1132,406,218,624,44,668
公投第１１案,高雄市,路竹區,甲南里,186,1025,405,190,595,63,658
公投第１１案,高雄市,路竹區,甲南里,187,1007,367,182,549,23,572
公投第１１案,高雄市,路竹區,甲南里,188,1301,461,205,666,34,700
公投第１１案,高雄市,路竹區,下坑里,189,885,364,137,501,29,530
公投第１１案,高雄市,路竹區,下坑里,190,837,271,140,411,16,427
公投第１１案,高雄市,路竹區,下坑里,191,930,354,184,538,29,567
公投第１１案,高雄市,路竹區,竹園里,192,781,266,123,389,32,421
公投第１１案,高雄市,路竹區,竹園里,193,1023,389,182,571,43,614
公投第１１案,高雄市,路竹區,竹東里,194,1763,784,233,1017,48,1065
公投第１１案,高雄市,路竹區,竹東里,195,1637,616,286,902,42,944
公投第１１案,高雄市,路竹區,竹西里,196,1070,421,178,599,36,635
公投第１１案,高雄市,路竹區,竹西里,197,1177,477,208,685,42,727
公投第１１案,高雄市,路竹區,文北里,198,1007,371,192,563,37,600
公投第１１案,高雄市,路竹區,文北里,199,1026,376,194,570,31,601
公投第１１案,高雄市,路竹區,文北里,200,1017,380,182,562,39,601
公投第１１案,高雄市,路竹區,文南里,201,1264,446,256,702,36,738
公投第１１案,高雄市,路竹區,文南里,202,1089,442,193,635,39,674
公投第１１案,高雄市,路竹區,三爺里,203,851,326,147,473,28,501
公投第１１案,高雄市,路竹區,鴨寮里,204,1011,412,188,600,40,640
公投第１１案,高雄市,路竹區,鴨寮里,205,937,404,186,590,26,616
公投第１１案,高雄市,路竹區,社東里,206,820,293,114,407,20,427
公投第１１案,高雄市,路竹區,社東里,207,910,363,210,573,23,596
公投第１１案,高雄市,路竹區,社中里,208,867,301,150,451,43,494
公投第１１案,高雄市,路竹區,竹南里,209,937,380,161,541,26,567
公投第１１案,高雄市,路竹區,竹南里,210,900,336,174,510,22,532
公投第１１案,高雄市,路竹區,竹南里,211,900,377,149,526,34,560
公投第１１案,高雄市,路竹區,社南里,212,918,388,154,542,27,569
公投第１１案,高雄市,路竹區,社南里,213,870,363,170,533,34,567
公投第１１案,高雄市,路竹區,社南里,214,1150,471,237,708,20,728
公投第１１案,高雄市,路竹區,社南里,215,1537,691,255,946,42,988
公投第１１案,高雄市,阿蓮區,石安里,216,1299,403,210,613,32,645
公投第１１案,高雄市,阿蓮區,中路里,217,1107,450,159,609,26,635
公投第１１案,高雄市,阿蓮區,中路里,218,898,350,126,476,8,484
公投第１１案,高雄市,阿蓮區,峯山里,219,1259,444,194,638,56,694
公投第１１案,高雄市,阿蓮區,港後里,220,1579,546,271,817,33,850
公投第１１案,高雄市,阿蓮區,港後里,221,564,219,100,319,10,329
公投第１１案,高雄市,阿蓮區,崗山里,222,768,301,151,452,44,496
公投第１１案,高雄市,阿蓮區,阿蓮里,223,1092,416,187,603,34,637
公投第１１案,高雄市,阿蓮區,阿蓮里,224,1099,412,174,586,44,630
公投第１１案,高雄市,阿蓮區,阿蓮里,225,1134,430,193,623,18,641
公投第１１案,高雄市,阿蓮區,阿蓮里,226,1561,517,279,796,22,818
公投第１１案,高雄市,阿蓮區,清蓮里,227,1533,642,202,844,61,905
公投第１１案,高雄市,阿蓮區,清蓮里,228,1116,361,187,548,29,577
公投第１１案,高雄市,阿蓮區,和蓮里,229,1054,403,177,580,19,599
公投第１１案,高雄市,阿蓮區,和蓮里,230,1260,461,201,662,31,693
公投第１１案,高雄市,阿蓮區,青旗里,231,1504,505,241,746,53,799
公投第１１案,高雄市,阿蓮區,復安里,232,848,276,139,415,15,430
公投第１１案,高雄市,阿蓮區,復安里,233,823,322,115,437,20,457
公投第１１案,高雄市,阿蓮區,玉庫里,234,1021,428,145,573,29,602
公投第１１案,高雄市,阿蓮區,南蓮里,235,1715,554,282,836,43,879
公投第１１案,高雄市,阿蓮區,南蓮里,236,1300,473,193,666,40,706
公投第１１案,高雄市,田寮區,鹿埔里,237,369,109,50,159,6,165
公投第１１案,高雄市,田寮區,南安里,238,656,180,88,268,17,285
公投第１１案,高雄市,田寮區,南安里,239,406,78,43,121,9,130
公投第１１案,高雄市,田寮區,大同里,240,380,125,53,178,19,197
公投第１１案,高雄市,田寮區,田寮里,241,379,147,56,203,15,218
公投第１１案,高雄市,田寮區,七星里,242,625,239,75,314,46,360
公投第１１案,高雄市,田寮區,崇德里,243,946,308,156,464,18,482
公投第１１案,高雄市,田寮區,西德里,244,794,253,97,350,34,384
公投第１１案,高雄市,田寮區,三和里,245,382,113,33,146,23,169
公投第１１案,高雄市,田寮區,古亭里,246,513,107,59,166,39,205
公投第１１案,高雄市,田寮區,新興里,247,601,224,86,310,17,327
公投第１１案,高雄市,田寮區,新興里,248,620,237,99,336,38,374
公投第１１案,高雄市,永安區,永安里,249,756,355,124,479,26,505
公投第１１案,高雄市,永安區,永安里,250,818,333,152,485,40,525
公投第１１案,高雄市,永安區,永華里,251,866,415,160,575,26,601
公投第１１案,高雄市,永安區,永華里,252,951,400,164,564,50,614
公投第１１案,高雄市,永安區,新港里,253,992,416,173,589,49,638
公投第１１案,高雄市,永安區,新港里,254,682,207,116,323,17,340
公投第１１案,高雄市,永安區,新港里,255,665,276,115,391,16,407
公投第１１案,高雄市,永安區,鹽田里,256,371,106,96,202,10,212
公投第１１案,高雄市,永安區,保寧里,257,1114,476,222,698,40,738
公投第１１案,高雄市,永安區,保寧里,258,1418,622,236,858,30,888
公投第１１案,高雄市,永安區,維新里,259,1477,654,256,910,62,972
公投第１１案,高雄市,永安區,維新里,260,1891,764,370,1134,59,1193
公投第１１案,高雄市,岡山區,岡山里,261,1345,603,264,867,27,894
公投第１１案,高雄市,岡山區,岡山里,262,1045,344,156,500,13,513
公投第１１案,高雄市,岡山區,岡山里,263,1051,435,184,619,26,645
公投第１１案,高雄市,岡山區,岡山里,264,917,376,188,564,12,576
公投第１１案,高雄市,岡山區,壽天里,265,934,396,206,602,18,620
公投第１１案,高雄市,岡山區,壽天里,266,1097,502,161,663,31,694
公投第１１案,高雄市,岡山區,壽天里,267,1208,668,116,784,23,807
公投第１１案,高雄市,岡山區,平安里,268,1159,524,211,735,41,776
公投第１１案,高雄市,岡山區,維仁里,269,1018,405,191,596,30,626
公投第１１案,高雄市,岡山區,大遼里,270,1316,491,212,703,25,728
公投第１１案,高雄市,岡山區,程香里,271,1345,542,233,775,31,806
公投第１１案,高雄市,岡山區,程香里,272,1295,544,229,773,36,809
公投第１１案,高雄市,岡山區,程香里,273,1425,568,252,820,28,848
公投第１１案,高雄市,岡山區,後紅里,274,1328,542,226,768,24,792
公投第１１案,高雄市,岡山區,後紅里,275,1382,600,245,845,14,859
公投第１１案,高雄市,岡山區,後紅里,276,1381,597,241,838,15,853
公投第１１案,高雄市,岡山區,碧紅里,277,1282,507,229,736,44,780
公投第１１案,高雄市,岡山區,碧紅里,278,1240,494,217,711,20,731
公投第１１案,高雄市,岡山區,碧紅里,279,1327,535,240,775,32,807
公投第１１案,高雄市,岡山區,竹圍里,280,1736,598,333,931,35,966
公投第１１案,高雄市,岡山區,竹圍里,281,1566,622,286,908,42,950
公投第１１案,高雄市,岡山區,竹圍里,282,1779,625,276,901,33,934
公投第１１案,高雄市,岡山區,竹圍里,283,1593,638,271,909,56,965
公投第１１案,高雄市,岡山區,台上里,284,1480,618,266,884,45,929
公投第１１案,高雄市,岡山區,台上里,285,1364,598,208,806,30,836
公投第１１案,高雄市,岡山區,台上里,286,1410,602,241,843,29,872
公投第１１案,高雄市,岡山區,台上里,287,1148,566,196,762,31,793
公投第１１案,高雄市,岡山區,為隨里,288,625,257,126,383,35,418
公投第１１案,高雄市,岡山區,灣裡里,289,969,390,186,576,27,603
公投第１１案,高雄市,岡山區,灣裡里,290,861,380,164,544,14,558
公投第１１案,高雄市,岡山區,本洲里,291,823,316,136,452,19,471
公投第１１案,高雄市,岡山區,本洲里,292,889,394,165,559,44,603
公投第１１案,高雄市,岡山區,前峰里,293,1283,517,220,737,41,778
公投第１１案,高雄市,岡山區,前峰里,294,1512,597,246,843,29,872
公投第１１案,高雄市,岡山區,壽峰里,295,983,431,205,636,36,672
公投第１１案,高雄市,岡山區,壽峰里,296,1262,503,221,724,36,760
公投第１１案,高雄市,岡山區,仁壽里,297,1096,458,199,657,31,688
公投第１１案,高雄市,岡山區,仁壽里,298,1066,421,200,621,28,649
公投第１１案,高雄市,岡山區,仁壽里,299,1188,447,193,640,29,669
公投第１１案,高雄市,岡山區,後協里,300,1360,571,261,832,29,861
公投第１１案,高雄市,岡山區,後協里,301,1363,603,254,857,27,884
公投第１１案,高雄市,岡山區,後協里,302,1352,575,255,830,47,877
公投第１１案,高雄市,岡山區,後協里,303,1460,594,239,833,40,873
公投第１１案,高雄市,岡山區,協和里,304,1272,496,260,756,32,788
公投第１１案,高雄市,岡山區,協和里,305,1080,459,218,677,22,699
公投第１１案,高雄市,岡山區,協和里,306,1255,497,236,733,48,781
公投第１１案,高雄市,岡山區,協榮里,307,938,430,159,589,40,629
公投第１１案,高雄市,岡山區,協榮里,308,1237,553,205,758,36,794
公投第１１案,高雄市,岡山區,劉厝里,309,1413,570,208,778,23,801
公投第１１案,高雄市,岡山區,白米里,310,765,326,142,468,11,479
公投第１１案,高雄市,岡山區,白米里,311,1043,473,204,677,18,695
公投第１１案,高雄市,岡山區,石潭里,312,844,354,113,467,40,507
公投第１１案,高雄市,岡山區,石潭里,313,993,488,218,706,29,735
公投第１１案,高雄市,岡山區,福興里,314,1038,423,199,622,51,673
公投第１１案,高雄市,岡山區,嘉興里,315,1070,428,179,607,57,664
公投第１１案,高雄市,岡山區,嘉興里,316,1023,457,192,649,49,698
公投第１１案,高雄市,岡山區,嘉興里,317,1349,561,231,792,28,820
公投第１１案,高雄市,岡山區,嘉峰里,318,1452,644,115,759,44,803
公投第１１案,高雄市,岡山區,嘉峰里,319,301,117,73,190,16,206
公投第１１案,高雄市,岡山區,潭底里,320,756,309,142,451,66,517
公投第１１案,高雄市,岡山區,華崗里,321,733,272,123,395,11,406
公投第１１案,高雄市,岡山區,華崗里,322,854,381,159,540,60,600
公投第１１案,高雄市,岡山區,三和里,323,866,306,123,429,20,449
公投第１１案,高雄市,岡山區,大莊里,324,978,389,151,540,32,572
公投第１１案,高雄市,岡山區,忠孝里,325,1336,601,195,796,26,822
公投第１１案,高雄市,岡山區,忠孝里,326,1218,612,160,772,11,783
公投第１１案,高雄市,岡山區,忠孝里,327,341,158,92,250,8,258
公投第１１案,高雄市,岡山區,仁義里,328,955,560,129,689,26,715
公投第１１案,高雄市,岡山區,仁義里,329,940,513,125,638,17,655
公投第１１案,高雄市,岡山區,信義里,330,851,390,164,554,22,576
公投第１１案,高雄市,岡山區,信義里,331,762,387,138,525,13,538
公投第１１案,高雄市,岡山區,和平里,332,318,158,77,235,6,241
公投第１１案,高雄市,燕巢區,尖山里,333,1152,429,166,595,63,658
公投第１１案,高雄市,燕巢區,瓊林里,334,1120,461,191,652,20,672
公投第１１案,高雄市,燕巢區,瓊林里,335,974,433,181,614,38,652
公投第１１案,高雄市,燕巢區,安招里,336,1019,405,167,572,16,588
公投第１１案,高雄市,燕巢區,安招里,337,1058,403,169,572,39,611
公投第１１案,高雄市,燕巢區,安招里,338,1017,346,146,492,30,522
公投第１１案,高雄市,燕巢區,安招里,339,259,34,8,42,4,46
公投第１１案,高雄市,燕巢區,角宿里,340,926,427,151,578,40,618
公投第１１案,高雄市,燕巢區,角宿里,341,624,235,96,331,13,344
公投第１１案,高雄市,燕巢區,角宿里,342,1102,512,184,696,30,726
公投第１１案,高雄市,燕巢區,鳳雄里,343,1072,392,158,550,31,581
公投第１１案,高雄市,燕巢區,鳳雄里,344,1361,476,262,738,58,796
公投第１１案,高雄市,燕巢區,金山里,345,472,190,72,262,27,289
公投第１１案,高雄市,燕巢區,東燕里,346,1197,417,197,614,31,645
公投第１１案,高雄市,燕巢區,東燕里,347,1134,468,217,685,54,739
公投第１１案,高雄市,燕巢區,南燕里,348,1148,438,190,628,34,662
公投第１１案,高雄市,燕巢區,南燕里,349,1207,427,172,599,57,656
公投第１１案,高雄市,燕巢區,南燕里,350,1402,590,274,864,37,901
公投第１１案,高雄市,燕巢區,西燕里,351,1000,377,196,573,37,610
公投第１１案,高雄市,燕巢區,西燕里,352,1110,422,218,640,47,687
公投第１１案,高雄市,燕巢區,西燕里,353,1291,484,226,710,37,747
公投第１１案,高雄市,燕巢區,橫山里,354,797,313,128,441,48,489
公投第１１案,高雄市,燕巢區,橫山里,355,1098,389,149,538,38,576
公投第１１案,高雄市,燕巢區,深水里,356,1393,482,218,700,51,751
公投第１１案,高雄市,燕巢區,深水里,357,1079,368,116,484,27,511
公投第１１案,高雄市,彌陀區,光和里,358,1246,495,224,719,37,756
公投第１１案,高雄市,彌陀區,彌靖里,359,885,374,158,532,24,556
公投第１１案,高雄市,彌陀區,彌靖里,360,955,435,178,613,44,657
公投第１１案,高雄市,彌陀區,彌仁里,361,534,182,112,294,27,321
公投第１１案,高雄市,彌陀區,彌壽里,362,738,314,109,423,31,454
公投第１１案,高雄市,彌陀區,彌陀里,363,855,415,143,558,28,586
公投第１１案,高雄市,彌陀區,彌陀里,364,877,388,154,542,27,569
公投第１１案,高雄市,彌陀區,舊港里,365,781,345,119,464,49,513
公投第１１案,高雄市,彌陀區,舊港里,366,808,325,141,466,31,497
公投第１１案,高雄市,彌陀區,文安里,367,904,320,131,451,19,470
公投第１１案,高雄市,彌陀區,文安里,368,825,314,146,460,44,504
公投第１１案,高雄市,彌陀區,過港里,369,941,354,140,494,40,534
公投第１１案,高雄市,彌陀區,鹽埕里,370,1013,386,184,570,32,602
公投第１１案,高雄市,彌陀區,鹽埕里,371,1024,444,181,625,47,672
公投第１１案,高雄市,彌陀區,海尾里,372,861,250,111,361,13,374
公投第１１案,高雄市,彌陀區,漯底里,373,1163,479,203,682,53,735
公投第１１案,高雄市,彌陀區,南寮里,374,1216,598,175,773,36,809
公投第１１案,高雄市,彌陀區,南寮里,375,861,439,140,579,49,628
公投第１１案,高雄市,梓官區,梓信里,376,1061,505,141,646,39,685
公投第１１案,高雄市,梓官區,梓信里,377,1063,429,178,607,33,640
公投第１１案,高雄市,梓官區,梓義里,378,969,393,179,572,33,605
公投第１１案,高雄市,梓官區,梓義里,379,1078,368,159,527,26,553
公投第１１案,高雄市,梓官區,梓和里,380,838,331,157,488,39,527
公投第１１案,高雄市,梓官區,梓和里,381,611,282,111,393,18,411
公投第１１案,高雄市,梓官區,梓和里,382,782,344,141,485,18,503
公投第１１案,高雄市,梓官區,梓平里,383,1451,630,263,893,52,945
公投第１１案,高雄市,梓官區,中崙里,384,1144,458,200,658,19,677
公投第１１案,高雄市,梓官區,同安里,385,975,391,137,528,15,543
公投第１１案,高雄市,梓官區,大舍里,386,1317,553,218,771,31,802
公投第１１案,高雄市,梓官區,大舍里,387,1218,504,214,718,51,769
公投第１１案,高雄市,梓官區,大舍里,388,1073,440,184,624,35,659
公投第１１案,高雄市,梓官區,赤崁里,389,1112,435,157,592,25,617
公投第１１案,高雄市,梓官區,赤崁里,390,715,280,112,392,21,413
公投第１１案,高雄市,梓官區,赤東里,391,1311,539,191,730,26,756
公投第１１案,高雄市,梓官區,赤東里,392,939,390,159,549,23,572
公投第１１案,高雄市,梓官區,赤西里,393,824,359,127,486,35,521
公投第１１案,高雄市,梓官區,禮蚵里,394,1052,506,155,661,50,711
公投第１１案,高雄市,梓官區,禮蚵里,395,1020,448,157,605,51,656
公投第１１案,高雄市,梓官區,智蚵里,396,1260,511,202,713,25,738
公投第１１案,高雄市,梓官區,智蚵里,397,1595,646,228,874,17,891
公投第１１案,高雄市,梓官區,信蚵里,398,829,356,123,479,26,505
公投第１１案,高雄市,梓官區,信蚵里,399,1532,641,224,865,24,889
公投第１１案,高雄市,梓官區,茄苳里,400,1195,549,205,754,35,789
公投第１１案,高雄市,梓官區,茄苳里,401,1143,488,168,656,52,708
公投第１１案,高雄市,梓官區,典寶里,402,1186,508,192,700,42,742
公投第１１案,高雄市,梓官區,典寶里,403,1732,624,230,854,21,875
公投第１１案,高雄市,橋頭區,橋頭里,404,1005,411,215,626,52,678
公投第１１案,高雄市,橋頭區,橋頭里,405,1073,435,212,647,38,685
公投第１１案,高雄市,橋頭區,橋南里,406,1129,500,217,717,22,739
公投第１１案,高雄市,橋頭區,仕隆里,407,1244,514,241,755,48,803
公投第１１案,高雄市,橋頭區,仕隆里,408,1091,441,200,641,23,664
公投第１１案,高雄市,橋頭區,仕豐里,409,1329,599,247,846,37,883
公投第１１案,高雄市,橋頭區,仕豐里,410,1140,471,220,691,26,717
公投第１１案,高雄市,橋頭區,芋寮里,411,1220,484,225,709,61,770
公投第１１案,高雄市,橋頭區,東林里,412,1047,465,211,676,39,715
公投第１１案,高雄市,橋頭區,東林里,413,1315,490,246,736,64,800
公投第１１案,高雄市,橋頭區,西林里,414,691,290,122,412,23,435
公投第１１案,高雄市,橋頭區,西林里,415,720,330,117,447,40,487
公投第１１案,高雄市,橋頭區,白樹里,416,1192,474,215,689,57,746
公投第１１案,高雄市,橋頭區,白樹里,417,1318,561,253,814,39,853
公投第１１案,高雄市,橋頭區,白樹里,418,761,330,136,466,32,498
公投第１１案,高雄市,橋頭區,筆秀里,419,973,410,177,587,19,606
公投第１１案,高雄市,橋頭區,筆秀里,420,587,211,128,339,27,366
公投第１１案,高雄市,橋頭區,新莊里,421,812,341,159,500,33,533
公投第１１案,高雄市,橋頭區,新莊里,422,343,136,81,217,6,223
公投第１１案,高雄市,橋頭區,新莊里,423,1266,518,285,803,18,821
公投第１１案,高雄市,橋頭區,甲北里,424,1128,500,184,684,64,748
公投第１１案,高雄市,橋頭區,甲北里,425,884,394,150,544,26,570
公投第１１案,高雄市,橋頭區,甲南里,426,1187,459,198,657,38,695
公投第１１案,高雄市,橋頭區,甲南里,427,1259,566,185,751,32,783
公投第１１案,高雄市,橋頭區,頂鹽里,428,1361,615,105,720,39,759
公投第１１案,高雄市,橋頭區,中崎里,429,671,279,96,375,17,392
公投第１１案,高雄市,橋頭區,仕和里,430,1215,512,229,741,42,783
公投第１１案,高雄市,橋頭區,仕和里,431,1255,551,222,773,42,815
公投第１１案,高雄市,橋頭區,仕和里,432,1219,515,248,763,26,789
公投第１１案,高雄市,橋頭區,德松里,433,1372,552,252,804,26,830
公投第１１案,高雄市,橋頭區,三德里,434,758,342,135,477,10,487
公投第１１案,高雄市,楠梓區,清豐里,435,1309,593,225,818,22,840
公投第１１案,高雄市,楠梓區,清豐里,436,1408,565,278,843,28,871
公投第１１案,高雄市,楠梓區,清豐里,437,1851,759,319,1078,43,1121
公投第１１案,高雄市,楠梓區,清豐里,438,1578,644,300,944,33,977
公投第１１案,高雄市,楠梓區,清豐里,439,1715,596,326,922,25,947
公投第１１案,高雄市,楠梓區,清豐里,440,1611,606,298,904,17,921
公投第１１案,高雄市,楠梓區,清豐里,441,2024,763,322,1085,30,1115
公投第１１案,高雄市,楠梓區,清豐里,442,1890,668,338,1006,19,1025
公投第１１案,高雄市,楠梓區,清豐里,443,1762,599,312,911,19,930
公投第１１案,高雄市,楠梓區,清豐里,444,1888,695,337,1032,30,1062
公投第１１案,高雄市,楠梓區,清豐里,445,1822,691,320,1011,37,1048
公投第１１案,高雄市,楠梓區,清豐里,446,1846,675,348,1023,23,1046
公投第１１案,高雄市,楠梓區,東寧里,447,1268,517,234,751,46,797
公投第１１案,高雄市,楠梓區,東寧里,448,1240,524,255,779,32,811
公投第１１案,高雄市,楠梓區,東寧里,449,1432,669,207,876,18,894
公投第１１案,高雄市,楠梓區,五常里,450,1490,549,335,884,40,924
公投第１１案,高雄市,楠梓區,五常里,451,1464,651,251,902,26,928
公投第１１案,高雄市,楠梓區,五常里,452,1435,532,238,770,50,820
公投第１１案,高雄市,楠梓區,五常里,453,1602,602,262,864,36,900
公投第１１案,高雄市,楠梓區,享平里,454,1500,577,263,840,32,872
公投第１１案,高雄市,楠梓區,享平里,455,1591,592,263,855,47,902
公投第１１案,高雄市,楠梓區,惠楠里,456,1669,431,206,637,29,666
公投第１１案,高雄市,楠梓區,惠楠里,457,1469,593,287,880,26,906
公投第１１案,高雄市,楠梓區,中陽里,458,1559,570,274,844,55,899
公投第１１案,高雄市,楠梓區,中陽里,459,1638,586,300,886,57,943
公投第１１案,高雄市,楠梓區,惠民里,460,1960,777,352,1129,56,1185
公投第１１案,高雄市,楠梓區,惠民里,461,1912,707,385,1092,60,1152
公投第１１案,高雄市,楠梓區,惠豐里,462,1559,641,238,879,30,909
公投第１１案,高雄市,楠梓區,惠豐里,463,1423,524,257,781,31,812
公投第１１案,高雄市,楠梓區,惠豐里,464,1696,660,315,975,24,999
公投第１１案,高雄市,楠梓區,錦屏里,465,1493,562,250,812,73,885
公投第１１案,高雄市,楠梓區,錦屏里,466,1527,599,276,875,55,930
公投第１１案,高雄市,楠梓區,玉屏里,467,1020,411,204,615,40,655
公投第１１案,高雄市,楠梓區,玉屏里,468,1197,443,221,664,68,732
公投第１１案,高雄市,楠梓區,金田里,469,1528,534,276,810,40,850
公投第１１案,高雄市,楠梓區,金田里,470,1918,670,278,948,48,996
公投第１１案,高雄市,楠梓區,稔田里,471,1458,575,253,828,47,875
公投第１１案,高雄市,楠梓區,瑞屏里,472,1790,750,320,1070,44,1114
公投第１１案,高雄市,楠梓區,瑞屏里,473,1845,769,329,1098,52,1150
公投第１１案,高雄市,楠梓區,翠屏里,474,2037,799,395,1194,52,1246
公投第１１案,高雄市,楠梓區,翠屏里,475,1964,737,335,1072,36,1108
公投第１１案,高雄市,楠梓區,翠屏里,476,2006,776,364,1140,28,1168
公投第１１案,高雄市,楠梓區,翠屏里,477,1951,726,347,1073,38,1111
公投第１１案,高雄市,楠梓區,翠屏里,478,1951,709,353,1062,49,1111
公投第１１案,高雄市,楠梓區,翠屏里,479,2008,823,350,1173,36,1209
公投第１１案,高雄市,楠梓區,翠屏里,480,1923,789,304,1093,57,1150
公投第１１案,高雄市,楠梓區,翠屏里,481,1921,759,359,1118,34,1152
公投第１１案,高雄市,楠梓區,宏南里,482,832,399,152,551,27,578
公投第１１案,高雄市,楠梓區,宏毅里,483,1156,454,205,659,31,690
公投第１１案,高雄市,楠梓區,宏毅里,484,1125,460,220,680,43,723
公投第１１案,高雄市,楠梓區,宏榮里,485,1060,346,203,549,40,589
公投第１１案,高雄市,楠梓區,宏榮里,486,1502,634,252,886,43,929
公投第１１案,高雄市,楠梓區,廣昌里,487,1404,556,244,800,58,858
公投第１１案,高雄市,楠梓區,廣昌里,488,1552,529,252,781,48,829
公投第１１案,高雄市,楠梓區,久昌里,489,1460,550,252,802,35,837
公投第１１案,高雄市,楠梓區,久昌里,490,1315,525,168,693,37,730
公投第１１案,高雄市,楠梓區,大昌里,491,1062,442,194,636,35,671
公投第１１案,高雄市,楠梓區,大昌里,492,1078,435,88,523,40,563
公投第１１案,高雄市,楠梓區,福昌里,493,914,408,157,565,50,615
公投第１１案,高雄市,楠梓區,福昌里,494,1064,483,190,673,40,713
公投第１１案,高雄市,楠梓區,盛昌里,495,1705,758,305,1063,38,1101
公投第１１案,高雄市,楠梓區,盛昌里,496,1728,751,271,1022,29,1051
公投第１１案,高雄市,楠梓區,盛昌里,497,1917,792,334,1126,34,1160
公投第１１案,高雄市,楠梓區,泰昌里,498,1439,620,183,803,35,838
公投第１１案,高雄市,楠梓區,興昌里,499,1287,555,120,675,44,719
公投第１１案,高雄市,楠梓區,興昌里,500,1504,671,262,933,37,970
公投第１１案,高雄市,楠梓區,興昌里,501,1405,638,261,899,31,930
公投第１１案,高雄市,楠梓區,建昌里,502,1287,532,220,752,42,794
公投第１１案,高雄市,楠梓區,建昌里,503,1295,543,236,779,27,806
公投第１１案,高雄市,楠梓區,宏昌里,504,1483,622,279,901,31,932
公投第１１案,高雄市,楠梓區,宏昌里,505,1649,758,314,1072,28,1100
公投第１１案,高雄市,楠梓區,和昌里,506,998,404,211,615,34,649
公投第１１案,高雄市,楠梓區,和昌里,507,1025,434,189,623,35,658
公投第１１案,高雄市,楠梓區,慶昌里,508,1671,749,315,1064,44,1108
公投第１１案,高雄市,楠梓區,慶昌里,509,1453,652,252,904,52,956
公投第１１案,高雄市,楠梓區,隆昌里,510,1673,685,292,977,48,1025
公投第１１案,高雄市,楠梓區,隆昌里,511,1653,675,277,952,39,991
公投第１１案,高雄市,楠梓區,秀昌里,512,1034,421,195,616,26,642
公投第１１案,高雄市,楠梓區,秀昌里,513,1127,492,254,746,31,777
公投第１１案,高雄市,楠梓區,裕昌里,514,1575,602,284,886,34,920
公投第１１案,高雄市,楠梓區,裕昌里,515,1559,552,380,932,33,965
公投第１１案,高雄市,楠梓區,裕昌里,516,1378,545,240,785,24,809
公投第１１案,高雄市,楠梓區,國昌里,517,1714,736,287,1023,26,1049
公投第１１案,高雄市,楠梓區,國昌里,518,1721,722,283,1005,48,1053
公投第１１案,高雄市,楠梓區,加昌里,519,1628,692,265,957,36,993
公投第１１案,高雄市,楠梓區,加昌里,520,1590,715,311,1026,46,1072
公投第１１案,高雄市,楠梓區,加昌里,521,1628,684,263,947,51,998
公投第１１案,高雄市,楠梓區,加昌里,522,1739,768,333,1101,37,1138
公投第１１案,高雄市,楠梓區,加昌里,523,1642,716,308,1024,39,1063
公投第１１案,高雄市,楠梓區,仁昌里,524,1766,659,293,952,42,994
公投第１１案,高雄市,楠梓區,仁昌里,525,1482,576,252,828,28,856
公投第１１案,高雄市,楠梓區,仁昌里,526,1749,648,258,906,18,924
公投第１１案,高雄市,楠梓區,藍田里,527,1591,617,322,939,27,966
公投第１１案,高雄市,楠梓區,藍田里,528,1545,662,319,981,21,1002
公投第１１案,高雄市,楠梓區,藍田里,529,1651,723,331,1054,21,1075
公投第１１案,高雄市,楠梓區,藍田里,530,1646,682,321,1003,37,1040
公投第１１案,高雄市,楠梓區,中興里,531,1496,730,191,921,51,972
公投第１１案,高雄市,楠梓區,中和里,532,1403,575,221,796,55,851
公投第１１案,高雄市,楠梓區,中和里,533,1624,582,328,910,27,937
公投第１１案,高雄市,左營區,進學里,534,2604,626,253,879,39,918
公投第１１案,高雄市,左營區,尾西里,535,1037,426,183,609,38,647
公投第１１案,高雄市,左營區,頂北里,536,542,233,97,330,31,361
公投第１１案,高雄市,左營區,中北里,537,635,269,98,367,32,399
公投第１１案,高雄市,左營區,中南里,538,518,184,77,261,14,275
公投第１１案,高雄市,左營區,廟東里,539,813,351,122,473,34,507
公投第１１案,高雄市,左營區,廟北里,540,889,349,144,493,62,555
公投第１１案,高雄市,左營區,尾南里,541,731,283,133,416,55,471
公投第１１案,高雄市,左營區,尾北里,542,1592,605,227,832,41,873
公投第１１案,高雄市,左營區,尾北里,543,1709,665,337,1002,40,1042
公投第１１案,高雄市,左營區,屏山里,544,1588,691,189,880,46,926
公投第１１案,高雄市,左營區,祥和里,545,358,167,38,205,7,212
公投第１１案,高雄市,左營區,永清里,546,666,371,74,445,12,457
公投第１１案,高雄市,左營區,莒光里,547,1748,729,265,994,44,1038
公投第１１案,高雄市,左營區,光輝里,548,1196,526,199,725,42,767
公投第１１案,高雄市,左營區,光輝里,549,1240,558,216,774,29,803
公投第１１案,高雄市,左營區,合群里,550,1402,690,150,840,30,870
公投第１１案,高雄市,左營區,合群里,551,1173,604,125,729,22,751
公投第１１案,高雄市,左營區,明建里,552,641,344,106,450,12,462
公投第１１案,高雄市,左營區,頂西里,553,951,386,170,556,29,585
公投第１１案,高雄市,左營區,聖后里,554,732,280,139,419,25,444
公投第１１案,高雄市,左營區,聖西里,555,339,135,51,186,11,197
公投第１１案,高雄市,左營區,聖南里,556,519,229,89,318,12,330
公投第１１案,高雄市,左營區,城南里,557,514,203,107,310,32,342
公投第１１案,高雄市,左營區,路東里,558,720,330,104,434,38,472
公投第１１案,高雄市,左營區,廍北里,559,411,179,69,248,21,269
公投第１１案,高雄市,左營區,廍南里,560,603,116,254,370,30,400
公投第１１案,高雄市,左營區,埤西里,561,904,393,141,534,38,572
公投第１１案,高雄市,左營區,埤北里,562,1318,527,179,706,21,727
公投第１１案,高雄市,左營區,埤東里,563,966,348,169,517,30,547
公投第１１案,高雄市,左營區,海勝里,564,1440,595,229,824,31,855
公投第１１案,高雄市,左營區,海勝里,565,1990,836,241,1077,32,1109
公投第１１案,高雄市,左營區,海勝里,566,1090,538,145,683,27,710
公投第１１案,高雄市,左營區,海勝里,567,1272,607,153,760,42,802
公投第１１案,高雄市,左營區,崇實里,568,1558,667,318,985,22,1007
公投第１１案,高雄市,左營區,崇實里,569,1501,628,324,952,15,967
公投第１１案,高雄市,左營區,自助里,570,360,171,71,242,7,249
公投第１１案,高雄市,左營區,果貿里,571,1335,618,127,745,45,790
公投第１１案,高雄市,左營區,果貿里,572,1359,612,181,793,20,813
公投第１１案,高雄市,左營區,果惠里,573,1487,664,243,907,33,940
公投第１１案,高雄市,左營區,果峰里,574,1637,727,187,914,56,970
公投第１１案,高雄市,左營區,新下里,575,1553,681,291,972,25,997
公投第１１案,高雄市,左營區,新下里,576,1564,635,350,985,34,1019
公投第１１案,高雄市,左營區,新下里,577,1788,771,370,1141,33,1174
公投第１１案,高雄市,左營區,新下里,578,2028,802,395,1197,54,1251
公投第１１案,高雄市,左營區,新下里,579,2037,793,412,1205,46,1251
公投第１１案,高雄市,左營區,新下里,580,2101,865,402,1267,28,1295
公投第１１案,高雄市,左營區,新下里,581,2018,844,388,1232,42,1274
公投第１１案,高雄市,左營區,新上里,582,1925,816,455,1271,38,1309
公投第１１案,高雄市,左營區,新上里,583,1989,770,377,1147,31,1178
公投第１１案,高雄市,左營區,新上里,584,1780,673,279,952,25,977
公投第１１案,高雄市,左營區,新上里,585,1778,721,342,1063,19,1082
公投第１１案,高雄市,左營區,新上里,586,1496,599,305,904,19,923
公投第１１案,高雄市,左營區,新上里,587,1538,620,314,934,32,966
公投第１１案,高雄市,左營區,新上里,588,2058,819,425,1244,30,1274
公投第１１案,高雄市,左營區,新上里,589,1992,803,406,1209,30,1239
公投第１１案,高雄市,左營區,新上里,590,2058,800,451,1251,32,1283
公投第１１案,高雄市,左營區,新上里,591,2090,824,430,1254,29,1283
公投第１１案,高雄市,左營區,新上里,592,2157,831,442,1273,39,1312
公投第１１案,高雄市,左營區,新上里,593,2096,869,418,1287,27,1314
公投第１１案,高雄市,左營區,新上里,594,2101,849,424,1273,45,1318
公投第１１案,高雄市,左營區,新中里,595,1649,655,310,965,40,1005
公投第１１案,高雄市,左營區,新中里,596,1516,615,267,882,37,919
公投第１１案,高雄市,左營區,新中里,597,1678,734,307,1041,37,1078
公投第１１案,高雄市,左營區,新光里,598,1898,759,350,1109,36,1145
公投第１１案,高雄市,左營區,新光里,599,1837,782,329,1111,30,1141
公投第１１案,高雄市,左營區,新光里,600,1922,749,334,1083,34,1117
公投第１１案,高雄市,左營區,新光里,601,1785,739,360,1099,32,1131
公投第１１案,高雄市,左營區,新光里,602,1886,770,334,1104,26,1130
公投第１１案,高雄市,左營區,新光里,603,1895,770,385,1155,29,1184
公投第１１案,高雄市,左營區,新光里,604,1831,769,329,1098,28,1126
公投第１１案,高雄市,左營區,菜公里,605,2050,874,347,1221,40,1261
公投第１１案,高雄市,左營區,菜公里,606,2251,978,494,1472,33,1505
公投第１１案,高雄市,左營區,菜公里,607,2126,918,457,1375,17,1392
公投第１１案,高雄市,左營區,菜公里,608,1928,783,337,1120,20,1140
公投第１１案,高雄市,左營區,菜公里,609,2166,821,430,1251,29,1280
公投第１１案,高雄市,左營區,菜公里,610,2031,841,341,1182,32,1214
公投第１１案,高雄市,左營區,菜公里,611,1987,845,368,1213,23,1236
公投第１１案,高雄市,左營區,菜公里,612,2166,946,408,1354,24,1378
公投第１１案,高雄市,左營區,菜公里,613,1856,741,381,1122,42,1164
公投第１１案,高雄市,左營區,菜公里,614,2289,951,463,1414,27,1441
公投第１１案,高雄市,左營區,菜公里,615,1973,827,350,1177,32,1209
公投第１１案,高雄市,左營區,菜公里,616,1818,762,334,1096,32,1128
公投第１１案,高雄市,左營區,菜公里,617,1565,610,323,933,12,945
公投第１１案,高雄市,左營區,菜公里,618,1608,724,312,1036,28,1064
公投第１１案,高雄市,左營區,福山里,619,1812,753,379,1132,33,1165
公投第１１案,高雄市,左營區,福山里,620,1821,726,316,1042,20,1062
公投第１１案,高雄市,左營區,福山里,621,1907,786,368,1154,29,1183
公投第１１案,高雄市,左營區,福山里,622,1812,765,310,1075,23,1098
公投第１１案,高雄市,左營區,福山里,623,1833,806,347,1153,24,1177
公投第１１案,高雄市,左營區,福山里,624,1850,751,371,1122,33,1155
公投第１１案,高雄市,左營區,福山里,625,1738,695,316,1011,28,1039
公投第１１案,高雄市,左營區,福山里,626,1864,827,366,1193,30,1223
公投第１１案,高雄市,左營區,福山里,627,1887,811,366,1177,26,1203
公投第１１案,高雄市,左營區,福山里,628,1870,731,319,1050,27,1077
公投第１１案,高雄市,左營區,福山里,629,1866,771,348,1119,25,1144
公投第１１案,高雄市,左營區,福山里,630,1862,757,347,1104,15,1119
公投第１１案,高雄市,左營區,福山里,631,1816,767,349,1116,19,1135
公投第１１案,高雄市,左營區,福山里,632,1833,931,214,1145,29,1174
公投第１１案,高雄市,左營區,福山里,633,1676,711,324,1035,29,1064
公投第１１案,高雄市,左營區,福山里,634,1843,793,311,1104,36,1140
公投第１１案,高雄市,左營區,福山里,635,1872,793,370,1163,20,1183
公投第１１案,高雄市,左營區,福山里,636,2259,959,367,1326,27,1353
公投第１１案,高雄市,大社區,嘉誠里,637,950,346,143,489,54,543
公投第１１案,高雄市,大社區,保社里,638,1306,491,219,710,17,727
公投第１１案,高雄市,大社區,保社里,639,1856,566,263,829,24,853
公投第１１案,高雄市,大社區,大社里,640,986,411,201,612,33,645
公投第１１案,高雄市,大社區,大社里,641,1116,359,184,543,30,573
公投第１１案,高雄市,大社區,大社里,642,1253,501,280,781,34,815
公投第１１案,高雄市,大社區,大社里,643,1613,558,383,941,39,980
公投第１１案,高雄市,大社區,保安里,644,1455,498,257,755,30,785
公投第１１案,高雄市,大社區,保安里,645,1674,675,327,1002,38,1040
公投第１１案,高雄市,大社區,三奶里,646,1004,416,169,585,37,622
公投第１１案,高雄市,大社區,三奶里,647,879,367,146,513,28,541
公投第１１案,高雄市,大社區,三奶里,648,778,293,159,452,0,452
公投第１１案,高雄市,大社區,觀音里,649,1110,428,215,643,37,680
公投第１１案,高雄市,大社區,觀音里,650,1432,486,276,762,5,767
公投第１１案,高雄市,大社區,觀音里,651,1466,605,280,885,29,914
公投第１１案,高雄市,大社區,觀音里,652,1383,564,297,861,49,910
公投第１１案,高雄市,大社區,神農里,653,1645,618,307,925,67,992
公投第１１案,高雄市,大社區,神農里,654,1555,467,283,750,32,782
公投第１１案,高雄市,大社區,神農里,655,1750,628,354,982,46,1028
公投第１１案,高雄市,大社區,中里里,656,1111,408,217,625,42,667
公投第１１案,高雄市,大社區,中里里,657,1133,431,211,642,48,690
公投第１１案,高雄市,大社區,中里里,658,912,347,174,521,35,556
公投第１１案,高雄市,大社區,翠屏里,659,745,236,118,354,14,368
公投第１１案,高雄市,大社區,翠屏里,660,934,361,193,554,21,575
公投第１１案,高雄市,仁武區,大灣里,661,1777,844,324,1168,27,1195
公投第１１案,高雄市,仁武區,大灣里,662,2273,942,417,1359,46,1405
公投第１１案,高雄市,仁武區,灣內里,663,1384,611,274,885,40,925
公投第１１案,高雄市,仁武區,灣內里,664,1170,456,208,664,33,697
公投第１１案,高雄市,仁武區,灣內里,665,1216,533,253,786,36,822
公投第１１案,高雄市,仁武區,灣內里,666,1598,641,266,907,11,918
公投第１１案,高雄市,仁武區,灣內里,667,2143,949,376,1325,15,1340
公投第１１案,高雄市,仁武區,考潭里,668,1300,496,219,715,33,748
公投第１１案,高雄市,仁武區,考潭里,669,1338,540,243,783,43,826
公投第１１案,高雄市,仁武區,烏林里,670,1217,447,221,668,20,688
公投第１１案,高雄市,仁武區,烏林里,671,1202,424,163,587,36,623
公投第１１案,高雄市,仁武區,烏林里,672,1404,508,243,751,35,786
公投第１１案,高雄市,仁武區,仁福里,673,830,315,137,452,29,481
公投第１１案,高雄市,仁武區,仁武里,674,1802,585,219,804,32,836
公投第１１案,高雄市,仁武區,仁武里,675,1877,668,310,978,41,1019
公投第１１案,高雄市,仁武區,仁武里,676,1738,566,267,833,26,859
公投第１１案,高雄市,仁武區,文武里,677,1549,591,281,872,35,907
公投第１１案,高雄市,仁武區,文武里,678,1579,629,280,909,38,947
公投第１１案,高雄市,仁武區,文武里,679,1406,573,208,781,32,813
公投第１１案,高雄市,仁武區,文武里,680,1461,612,250,862,24,886
公投第１１案,高雄市,仁武區,文武里,681,1311,545,251,796,25,821
公投第１１案,高雄市,仁武區,文武里,682,1373,555,232,787,18,805
公投第１１案,高雄市,仁武區,竹後里,683,1035,376,203,579,20,599
公投第１１案,高雄市,仁武區,竹後里,684,1181,470,205,675,18,693
公投第１１案,高雄市,仁武區,八卦里,685,1670,605,307,912,35,947
公投第１１案,高雄市,仁武區,八卦里,686,1576,626,270,896,14,910
公投第１１案,高雄市,仁武區,八卦里,687,1576,667,284,951,32,983
公投第１１案,高雄市,仁武區,八卦里,688,1915,839,337,1176,25,1201
公投第１１案,高雄市,仁武區,八卦里,689,1758,703,282,985,25,1010
公投第１１案,高雄市,仁武區,八卦里,690,1892,833,321,1154,42,1196
公投第１１案,高雄市,仁武區,八卦里,691,2025,808,369,1177,51,1228
公投第１１案,高雄市,仁武區,八卦里,692,2014,837,388,1225,32,1257
公投第１１案,高雄市,仁武區,八卦里,693,1473,662,300,962,33,995
公投第１１案,高雄市,仁武區,高楠里,694,979,395,172,567,22,589
公投第１１案,高雄市,仁武區,高楠里,695,944,422,145,567,18,585
公投第１１案,高雄市,仁武區,後安里,696,1153,472,188,660,51,711
公投第１１案,高雄市,仁武區,後安里,697,1328,507,223,730,31,761
公投第１１案,高雄市,仁武區,中華里,698,1657,661,292,953,48,1001
公投第１１案,高雄市,仁武區,五和里,699,1545,557,244,801,32,833
公投第１１案,高雄市,仁武區,五和里,700,1417,612,239,851,40,891
公投第１１案,高雄市,仁武區,五和里,701,1602,708,302,1010,26,1036
公投第１１案,高雄市,仁武區,仁和里,702,1823,827,313,1140,48,1188
公投第１１案,高雄市,仁武區,仁和里,703,1914,730,356,1086,35,1121
公投第１１案,高雄市,仁武區,赤山里,704,1992,823,339,1162,39,1201
公投第１１案,高雄市,仁武區,赤山里,705,2045,739,315,1054,20,1074
公投第１１案,高雄市,仁武區,赤山里,706,1982,804,388,1192,35,1227
公投第１１案,高雄市,仁武區,仁慈里,707,2167,814,346,1160,28,1188
公投第１１案,高雄市,鳥松區,鳥松里,708,1678,641,312,953,47,1000
公投第１１案,高雄市,鳥松區,鳥松里,709,1682,607,260,867,69,936
公投第１１案,高雄市,鳥松區,鳥松里,710,1225,505,257,762,33,795
公投第１１案,高雄市,鳥松區,鳥松里,711,1322,463,238,701,34,735
公投第１１案,高雄市,鳥松區,鳥松里,712,1215,494,225,719,21,740
公投第１１案,高雄市,鳥松區,鳥松里,713,1779,661,322,983,27,1010
公投第１１案,高雄市,鳥松區,鳥松里,714,1129,369,361,730,16,746
公投第１１案,高雄市,鳥松區,夢裡里,715,1374,574,255,829,40,869
公投第１１案,高雄市,鳥松區,夢裡里,716,1089,417,217,634,36,670
公投第１１案,高雄市,鳥松區,夢裡里,717,2219,961,361,1322,49,1371
公投第１１案,高雄市,鳥松區,大華里,718,1634,655,309,964,25,989
公投第１１案,高雄市,鳥松區,大華里,719,1553,661,283,944,50,994
公投第１１案,高雄市,鳥松區,大華里,720,1572,641,321,962,39,1001
公投第１１案,高雄市,鳥松區,大華里,721,1688,669,370,1039,33,1072
公投第１１案,高雄市,鳥松區,大華里,722,1626,666,345,1011,28,1039
公投第１１案,高雄市,鳥松區,大華里,723,1744,692,380,1072,49,1121
公投第１１案,高雄市,鳥松區,坔埔里,724,1230,490,179,669,33,702
公投第１１案,高雄市,鳥松區,坔埔里,725,1201,482,243,725,54,779
公投第１１案,高雄市,鳥松區,坔埔里,726,1117,523,187,710,29,739
公投第１１案,高雄市,鳥松區,仁美里,727,1255,542,176,718,39,757
公投第１１案,高雄市,鳥松區,仁美里,728,1432,541,244,785,1,786
公投第１１案,高雄市,鳥松區,仁美里,729,1370,533,199,732,22,754
公投第１１案,高雄市,鳥松區,仁美里,730,1364,572,229,801,54,855
公投第１１案,高雄市,鳥松區,仁美里,731,1041,481,162,643,40,683
公投第１１案,高雄市,鳥松區,大竹里,732,702,344,138,482,30,512
公投第１１案,高雄市,鳥松區,華美里,733,1212,476,226,702,43,745
公投第１１案,高雄市,鳥松區,華美里,734,1289,518,198,716,39,755
公投第１１案,高雄市,鳥松區,華美里,735,1449,608,303,911,31,942
公投第１１案,高雄市,大樹區,竹寮里,736,1386,515,252,767,29,796
公投第１１案,高雄市,大樹區,竹寮里,737,1315,613,220,833,31,864
公投第１１案,高雄市,大樹區,九曲里,738,2461,930,371,1301,50,1351
公投第１１案,高雄市,大樹區,九曲里,739,1274,503,203,706,33,739
公投第１１案,高雄市,大樹區,九曲里,740,1265,468,199,667,41,708
公投第１１案,高雄市,大樹區,久堂里,741,1504,570,230,800,51,851
公投第１１案,高雄市,大樹區,久堂里,742,1049,371,190,561,17,578
公投第１１案,高雄市,大樹區,久堂里,743,1573,562,275,837,43,880
公投第１１案,高雄市,大樹區,水安里,744,1121,389,163,552,25,577
公投第１１案,高雄市,大樹區,水安里,745,1207,535,178,713,33,746
公投第１１案,高雄市,大樹區,水寮里,746,1134,445,128,573,22,595
公投第１１案,高雄市,大樹區,水寮里,747,1124,463,204,667,36,703
公投第１１案,高雄市,大樹區,檨腳里,748,1259,450,203,653,73,726
公投第１１案,高雄市,大樹區,檨腳里,749,1105,410,233,643,53,696
公投第１１案,高雄市,大樹區,檨腳里,750,1128,403,205,608,44,652
公投第１１案,高雄市,大樹區,興山里,751,1079,357,168,525,78,603
公投第１１案,高雄市,大樹區,和山里,752,1025,357,142,499,43,542
公投第１１案,高雄市,大樹區,姑山里,753,950,323,161,484,47,531
公投第１１案,高雄市,大樹區,大坑里,754,1433,495,236,731,83,814
公投第１１案,高雄市,大樹區,井腳里,755,794,284,129,413,17,430
公投第１１案,高雄市,大樹區,井腳里,756,781,247,111,358,9,367
公投第１１案,高雄市,大樹區,小坪里,757,1318,449,189,638,23,661
公投第１１案,高雄市,大樹區,龍目里,758,736,259,117,376,41,417
公投第１１案,高雄市,大樹區,龍目里,759,1047,328,180,508,11,519
公投第１１案,高雄市,大樹區,大樹里,760,1271,533,164,697,53,750
公投第１１案,高雄市,大樹區,大樹里,761,1186,410,90,500,21,521
公投第１１案,高雄市,大樹區,三和里,762,1007,391,149,540,46,586
公投第１１案,高雄市,大樹區,溪埔里,763,859,336,147,483,37,520
公投第１１案,高雄市,大樹區,溪埔里,764,735,262,106,368,14,382
公投第１１案,高雄市,大樹區,興田里,765,1046,413,178,591,58,649
公投第１１案,高雄市,大樹區,興田里,766,880,517,102,619,33,652
公投第１１案,高雄市,大樹區,統嶺里,767,720,295,81,376,21,397
公投第１１案,高雄市,鼓山區,鼓峰里,768,959,373,155,528,15,543
公投第１１案,高雄市,鼓山區,鼓峰里,769,1000,443,199,642,29,671
公投第１１案,高雄市,鼓山區,雄峰里,770,910,403,142,545,16,561
公投第１１案,高雄市,鼓山區,雄峰里,771,1085,497,188,685,33,718
公投第１１案,高雄市,鼓山區,前峰里,772,1484,534,197,731,27,758
公投第１１案,高雄市,鼓山區,前峰里,773,1393,609,226,835,22,857
公投第１１案,高雄市,鼓山區,前峰里,774,1270,573,152,725,36,761
公投第１１案,高雄市,鼓山區,光榮里,775,1055,440,188,628,23,651
公投第１１案,高雄市,鼓山區,光榮里,776,1172,476,208,684,21,705
公投第１１案,高雄市,鼓山區,光榮里,777,1175,526,215,741,27,768
公投第１１案,高雄市,鼓山區,民族里,778,1274,553,227,780,36,816
公投第１１案,高雄市,鼓山區,內惟里,779,1085,397,170,567,23,590
公投第１１案,高雄市,鼓山區,建國里,780,1470,575,254,829,36,865
公投第１１案,高雄市,鼓山區,建國里,781,974,413,212,625,25,650
公投第１１案,高雄市,鼓山區,忠正里,782,1275,526,134,660,46,706
公投第１１案,高雄市,鼓山區,忠正里,783,1206,478,224,702,40,742
公投第１１案,高雄市,鼓山區,忠正里,784,1238,521,227,748,18,766
公投第１１案,高雄市,鼓山區,自強里,785,721,382,101,483,16,499
公投第１１案,高雄市,鼓山區,龍井里,786,1220,472,208,680,26,706
公投第１１案,高雄市,鼓山區,正德里,787,1966,691,304,995,42,1037
公投第１１案,高雄市,鼓山區,平和里,788,1722,671,277,948,45,993
公投第１１案,高雄市,鼓山區,平和里,789,1720,650,300,950,36,986
公投第１１案,高雄市,鼓山區,民強里,790,1287,553,230,783,53,836
公投第１１案,高雄市,鼓山區,民強里,791,1369,421,201,622,16,638
公投第１１案,高雄市,鼓山區,厚生里,792,1222,536,227,763,26,789
公投第１１案,高雄市,鼓山區,厚生里,793,1770,722,301,1023,35,1058
公投第１１案,高雄市,鼓山區,龍子里,794,1860,699,351,1050,35,1085
公投第１１案,高雄市,鼓山區,龍子里,795,1857,718,339,1057,28,1085
公投第１１案,高雄市,鼓山區,龍子里,796,1841,728,367,1095,26,1121
公投第１１案,高雄市,鼓山區,龍子里,797,1830,727,378,1105,33,1138
公投第１１案,高雄市,鼓山區,龍子里,798,1809,708,352,1060,28,1088
公投第１１案,高雄市,鼓山區,龍子里,799,1894,754,383,1137,35,1172
公投第１１案,高雄市,鼓山區,龍子里,800,1882,766,376,1142,22,1164
公投第１１案,高雄市,鼓山區,龍子里,801,1894,774,409,1183,34,1217
公投第１１案,高雄市,鼓山區,龍水里,802,1745,692,287,979,33,1012
公投第１１案,高雄市,鼓山區,龍水里,803,1887,689,375,1064,14,1078
公投第１１案,高雄市,鼓山區,龍水里,804,1891,794,413,1207,31,1238
公投第１１案,高雄市,鼓山區,龍水里,805,1903,766,386,1152,28,1180
公投第１１案,高雄市,鼓山區,龍水里,806,1998,752,449,1201,21,1222
公投第１１案,高雄市,鼓山區,龍水里,807,1912,779,376,1155,28,1183
公投第１１案,高雄市,鼓山區,龍水里,808,1923,772,395,1167,38,1205
公投第１１案,高雄市,鼓山區,龍水里,809,1888,754,411,1165,22,1187
公投第１１案,高雄市,鼓山區,龍水里,810,1873,783,367,1150,20,1170
公投第１１案,高雄市,鼓山區,龍水里,811,1959,989,312,1301,23,1324
公投第１１案,高雄市,鼓山區,龍水里,812,1897,817,392,1209,33,1242
公投第１１案,高雄市,鼓山區,明誠里,813,2362,927,485,1412,30,1442
公投第１１案,高雄市,鼓山區,明誠里,814,1850,776,345,1121,35,1156
公投第１１案,高雄市,鼓山區,明誠里,815,1928,784,405,1189,21,1210
公投第１１案,高雄市,鼓山區,明誠里,816,1937,759,347,1106,19,1125
公投第１１案,高雄市,鼓山區,明誠里,817,2123,862,377,1239,38,1277
公投第１１案,高雄市,鼓山區,明誠里,818,1861,802,402,1204,14,1218
公投第１１案,高雄市,鼓山區,明誠里,819,1892,751,360,1111,25,1136
公投第１１案,高雄市,鼓山區,明誠里,820,2147,813,458,1271,32,1303
公投第１１案,高雄市,鼓山區,華豐里,821,1897,802,362,1164,25,1189
公投第１１案,高雄市,鼓山區,華豐里,822,2041,805,397,1202,29,1231
公投第１１案,高雄市,鼓山區,裕興里,823,1309,532,226,758,36,794
公投第１１案,高雄市,鼓山區,裕興里,824,1867,756,352,1108,33,1141
公投第１１案,高雄市,鼓山區,裕豐里,825,1152,524,239,763,21,784
公投第１１案,高雄市,鼓山區,裕豐里,826,1404,599,269,868,43,911
公投第１１案,高雄市,鼓山區,鼓岩里,827,1210,405,151,556,21,577
公投第１１案,高雄市,鼓山區,樹德里,828,1135,476,207,683,28,711
公投第１１案,高雄市,鼓山區,寶樹里,829,1831,457,182,639,44,683
公投第１１案,高雄市,鼓山區,興宗里,830,1288,544,101,645,37,682
公投第１１案,高雄市,鼓山區,光化里,831,1241,506,192,698,19,717
公投第１１案,高雄市,鼓山區,山下里,832,1342,536,263,799,29,828
公投第１１案,高雄市,鼓山區,河邊里,833,1422,644,180,824,72,896
公投第１１案,高雄市,鼓山區,綠川里,834,1453,627,246,873,55,928
公投第１１案,高雄市,鼓山區,登山里,835,616,272,114,386,21,407
公投第１１案,高雄市,鼓山區,峰南里,836,834,347,136,483,34,517
公投第１１案,高雄市,鼓山區,麗興里,837,969,401,158,559,21,580
公投第１１案,高雄市,鼓山區,新民里,838,978,418,159,577,26,603
公投第１１案,高雄市,鼓山區,延平里,839,760,310,161,471,34,505
公投第１１案,高雄市,鼓山區,維生里,840,1248,518,198,716,44,760
公投第１１案,高雄市,鼓山區,惠安里,841,1143,441,192,633,21,654
公投第１１案,高雄市,鼓山區,壽山里,842,1358,486,216,702,39,741
公投第１１案,高雄市,鼓山區,哨船頭里,843,1036,388,159,547,15,562
公投第１１案,高雄市,鼓山區,桃源里,844,580,223,113,336,11,347
公投第１１案,高雄市,鹽埕區,藍橋里,845,1304,526,273,799,38,837
公投第１１案,高雄市,鹽埕區,慈愛里,846,357,163,61,224,7,231
公投第１１案,高雄市,鹽埕區,博愛里,847,651,263,134,397,15,412
公投第１１案,高雄市,鹽埕區,壽星里,848,1322,477,211,688,21,709
公投第１１案,高雄市,鹽埕區,中山里,849,1056,419,210,629,18,647
公投第１１案,高雄市,鹽埕區,教仁里,850,904,369,198,567,17,584
公投第１１案,高雄市,鹽埕區,教仁里,851,1130,456,195,651,24,675
公投第１１案,高雄市,鹽埕區,新樂里,852,840,367,151,518,19,537
公投第１１案,高雄市,鹽埕區,中原里,853,616,272,151,423,18,441
公投第１１案,高雄市,鹽埕區,光明里,854,1397,466,266,732,27,759
公投第１１案,高雄市,鹽埕區,育仁里,855,766,290,165,455,11,466
公投第１１案,高雄市,鹽埕區,河濱里,856,839,317,167,484,27,511
公投第１１案,高雄市,鹽埕區,河濱里,857,805,343,159,502,12,514
公投第１１案,高雄市,鹽埕區,沙地里,858,750,285,138,423,12,435
公投第１１案,高雄市,鹽埕區,南端里,859,986,371,192,563,21,584
公投第１１案,高雄市,鹽埕區,港都里,860,1068,420,176,596,7,603
公投第１１案,高雄市,鹽埕區,江西里,861,1060,388,218,606,22,628
公投第１１案,高雄市,鹽埕區,新豐里,862,805,281,154,435,29,464
公投第１１案,高雄市,鹽埕區,府北里,863,1073,376,191,567,19,586
公投第１１案,高雄市,鹽埕區,府北里,864,921,313,162,475,24,499
公投第１１案,高雄市,鹽埕區,陸橋里,865,1171,449,200,649,27,676
公投第１１案,高雄市,鹽埕區,瀨南里,866,594,215,136,351,9,360
公投第１１案,高雄市,鹽埕區,新化里,867,592,252,116,368,14,382
公投第１１案,高雄市,鹽埕區,江南里,868,610,213,109,322,19,341
公投第１１案,高雄市,旗津區,旗下里,869,1177,489,217,706,49,755
公投第１１案,高雄市,旗津區,永安里,870,1109,439,149,588,31,619
公投第１１案,高雄市,旗津區,振興里,871,1642,543,271,814,17,831
公投第１１案,高雄市,旗津區,慈愛里,872,1209,436,174,610,65,675
公投第１１案,高雄市,旗津區,慈愛里,873,1112,395,170,565,29,594
公投第１１案,高雄市,旗津區,復興里,874,1483,605,232,837,42,879
公投第１１案,高雄市,旗津區,復興里,875,1460,507,197,704,28,732
公投第１１案,高雄市,旗津區,中華里,876,1572,611,306,917,81,998
公投第１１案,高雄市,旗津區,實踐里,877,1384,493,181,674,32,706
公投第１１案,高雄市,旗津區,北汕里,878,1390,510,205,715,12,727
公投第１１案,高雄市,旗津區,北汕里,879,1239,410,190,600,30,630
公投第１１案,高雄市,旗津區,南汕里,880,2045,760,321,1081,56,1137
公投第１１案,高雄市,旗津區,上竹里,881,893,328,127,455,24,479
公投第１１案,高雄市,旗津區,上竹里,882,1866,635,302,937,57,994
公投第１１案,高雄市,旗津區,中洲里,883,1874,608,251,859,24,883
公投第１１案,高雄市,旗津區,安順里,884,893,306,119,425,39,464
公投第１１案,高雄市,旗津區,中興里,885,1215,477,237,714,25,739
公投第１１案,高雄市,旗津區,中興里,886,1297,461,205,666,22,688
公投第１１案,高雄市,三民區,鼎金里,887,1893,730,338,1068,48,1116
公投第１１案,高雄市,三民區,鼎金里,888,1982,734,294,1028,58,1086
公投第１１案,高雄市,三民區,鼎盛里,889,1661,644,293,937,39,976
公投第１１案,高雄市,三民區,鼎盛里,890,1894,686,384,1070,17,1087
公投第１１案,高雄市,三民區,鼎盛里,891,1839,696,328,1024,31,1055
公投第１１案,高雄市,三民區,鼎盛里,892,2014,747,362,1109,42,1151
公投第１１案,高雄市,三民區,鼎強里,893,1897,779,305,1084,59,1143
公投第１１案,高雄市,三民區,鼎強里,894,2016,694,367,1061,34,1095
公投第１１案,高雄市,三民區,鼎力里,895,1924,735,316,1051,26,1077
公投第１１案,高雄市,三民區,鼎力里,896,1749,701,300,1001,35,1036
公投第１１案,高雄市,三民區,鼎西里,897,1845,817,357,1174,38,1212
公投第１１案,高雄市,三民區,鼎西里,898,1724,668,307,975,26,1001
公投第１１案,高雄市,三民區,鼎西里,899,1889,741,348,1089,26,1115
公投第１１案,高雄市,三民區,鼎西里,900,1622,611,316,927,24,951
公投第１１案,高雄市,三民區,鼎中里,901,1870,742,387,1129,33,1162
公投第１１案,高雄市,三民區,鼎中里,902,1523,632,302,934,38,972
公投第１１案,高雄市,三民區,鼎泰里,903,2006,741,339,1080,34,1114
公投第１１案,高雄市,三民區,鼎泰里,904,2076,807,470,1277,37,1314
公投第１１案,高雄市,三民區,鼎泰里,905,2073,758,426,1184,11,1195
公投第１１案,高雄市,三民區,鼎泰里,906,2045,810,371,1181,33,1214
公投第１１案,高雄市,三民區,鼎泰里,907,2070,698,342,1040,37,1077
公投第１１案,高雄市,三民區,鼎泰里,908,2035,753,363,1116,30,1146
公投第１１案,高雄市,三民區,鼎泰里,909,2075,773,488,1261,37,1298
公投第１１案,高雄市,三民區,鼎泰里,910,2053,825,390,1215,21,1236
公投第１１案,高雄市,三民區,鼎泰里,911,2063,839,442,1281,21,1302
公投第１１案,高雄市,三民區,鼎泰里,912,2143,899,414,1313,29,1342
公投第１１案,高雄市,三民區,本館里,913,1746,714,346,1060,46,1106
公投第１１案,高雄市,三民區,本館里,914,1735,623,289,912,29,941
公投第１１案,高雄市,三民區,本館里,915,1655,582,311,893,37,930
公投第１１案,高雄市,三民區,本館里,916,1583,590,315,905,41,946
公投第１１案,高雄市,三民區,本館里,917,1800,651,353,1004,26,1030
公投第１１案,高雄市,三民區,本和里,918,1730,740,305,1045,18,1063
公投第１１案,高雄市,三民區,本和里,919,1715,701,305,1006,19,1025
公投第１１案,高雄市,三民區,本和里,920,1691,666,324,990,33,1023
公投第１１案,高雄市,三民區,本和里,921,1865,827,260,1087,27,1114
公投第１１案,高雄市,三民區,本文里,922,1073,468,215,683,22,705
公投第１１案,高雄市,三民區,本文里,923,917,440,175,615,34,649
公投第１１案,高雄市,三民區,本武里,924,1647,679,283,962,30,992
公投第１１案,高雄市,三民區,本元里,925,1654,647,320,967,44,1011
公投第１１案,高雄市,三民區,本元里,926,1639,681,307,988,42,1030
公投第１１案,高雄市,三民區,本元里,927,1833,720,367,1087,27,1114
公投第１１案,高雄市,三民區,本安里,928,1362,560,308,868,25,893
公投第１１案,高雄市,三民區,本安里,929,1557,644,305,949,42,991
公投第１１案,高雄市,三民區,本安里,930,1482,649,83,732,16,748
公投第１１案,高雄市,三民區,本上里,931,1563,645,325,970,25,995
公投第１１案,高雄市,三民區,本上里,932,1497,594,317,911,30,941
公投第１１案,高雄市,三民區,本上里,933,1523,637,338,975,22,997
公投第１１案,高雄市,三民區,本揚里,934,1293,584,267,851,19,870
公投第１１案,高雄市,三民區,本揚里,935,1662,663,365,1028,28,1056
公投第１１案,高雄市,三民區,本揚里,936,1441,588,262,850,24,874
公投第１１案,高雄市,三民區,本揚里,937,1326,611,273,884,23,907
公投第１１案,高雄市,三民區,本揚里,938,1476,654,303,957,24,981
公投第１１案,高雄市,三民區,寶獅里,939,1968,722,354,1076,23,1099
公投第１１案,高雄市,三民區,寶獅里,940,1618,599,293,892,17,909
公投第１１案,高雄市,三民區,寶德里,941,1873,672,396,1068,30,1098
公投第１１案,高雄市,三民區,寶德里,942,1487,585,288,873,32,905
公投第１１案,高雄市,三民區,寶德里,943,1640,658,308,966,20,986
公投第１１案,高雄市,三民區,寶泰里,944,1889,728,343,1071,21,1092
公投第１１案,高雄市,三民區,寶泰里,945,1969,749,357,1106,24,1130
公投第１１案,高雄市,三民區,寶興里,946,1466,596,292,888,40,928
公投第１１案,高雄市,三民區,寶興里,947,1697,921,301,1222,34,1256
公投第１１案,高雄市,三民區,寶興里,948,1663,700,291,991,35,1026
公投第１１案,高雄市,三民區,寶興里,949,1649,619,334,953,31,984
公投第１１案,高雄市,三民區,寶中里,950,1486,610,268,878,24,902
公投第１１案,高雄市,三民區,寶中里,951,1495,557,291,848,21,869
公投第１１案,高雄市,三民區,寶華里,952,1548,675,317,992,17,1009
公投第１１案,高雄市,三民區,寶華里,953,1493,584,293,877,25,902
公投第１１案,高雄市,三民區,寶國里,954,1445,624,288,912,12,924
公投第１１案,高雄市,三民區,寶國里,955,1529,587,304,891,21,912
公投第１１案,高雄市,三民區,寶國里,956,1506,613,282,895,22,917
公投第１１案,高雄市,三民區,寶國里,957,1549,636,318,954,32,986
公投第１１案,高雄市,三民區,寶國里,958,1620,642,351,993,38,1031
公投第１１案,高雄市,三民區,寶民里,959,1550,649,308,957,39,996
公投第１１案,高雄市,三民區,寶民里,960,1488,621,291,912,35,947
公投第１１案,高雄市,三民區,寶慶里,961,1335,527,282,809,34,843
公投第１１案,高雄市,三民區,寶慶里,962,1332,573,223,796,26,822
公投第１１案,高雄市,三民區,寶業里,963,1764,700,342,1042,47,1089
公投第１１案,高雄市,三民區,寶業里,964,1811,728,339,1067,28,1095
公投第１１案,高雄市,三民區,寶業里,965,1693,692,359,1051,34,1085
公投第１１案,高雄市,三民區,寶盛里,966,1684,722,335,1057,49,1106
公投第１１案,高雄市,三民區,寶盛里,967,1464,586,263,849,33,882
公投第１１案,高雄市,三民區,寶盛里,968,1719,727,375,1102,26,1128
公投第１１案,高雄市,三民區,寶安里,969,1749,685,352,1037,19,1056
公投第１１案,高雄市,三民區,寶安里,970,1908,712,365,1077,21,1098
公投第１１案,高雄市,三民區,寶安里,971,1573,638,291,929,47,976
公投第１１案,高雄市,三民區,寶安里,972,1628,636,292,928,26,954
公投第１１案,高雄市,三民區,寶龍里,973,1377,508,236,744,34,778
公投第１１案,高雄市,三民區,寶龍里,974,1530,644,308,952,20,972
公投第１１案,高雄市,三民區,寶龍里,975,1188,489,210,699,32,731
公投第１１案,高雄市,三民區,寶珠里,976,2791,598,258,856,21,877
公投第１１案,高雄市,三民區,寶珠里,977,1840,619,335,954,40,994
公投第１１案,高雄市,三民區,寶珠里,978,1671,660,337,997,48,1045
公投第１１案,高雄市,三民區,寶玉里,979,1624,633,326,959,26,985
公投第１１案,高雄市,三民區,寶玉里,980,1555,678,359,1037,27,1064
公投第１１案,高雄市,三民區,寶玉里,981,1489,646,311,957,20,977
公投第１１案,高雄市,三民區,寶玉里,982,1662,675,331,1006,34,1040
公投第１１案,高雄市,三民區,寶玉里,983,1639,662,292,954,20,974
公投第１１案,高雄市,三民區,灣子里,984,1872,739,326,1065,40,1105
公投第１１案,高雄市,三民區,灣子里,985,1968,745,363,1108,35,1143
公投第１１案,高雄市,三民區,灣愛里,986,1471,536,200,736,50,786
公投第１１案,高雄市,三民區,灣愛里,987,1534,604,259,863,36,899
公投第１１案,高雄市,三民區,灣中里,988,1659,605,262,867,52,919
公投第１１案,高雄市,三民區,灣中里,989,1815,652,279,931,28,959
公投第１１案,高雄市,三民區,灣中里,990,1808,660,336,996,29,1025
公投第１１案,高雄市,三民區,灣華里,991,1224,461,204,665,29,694
公投第１１案,高雄市,三民區,灣華里,992,1406,555,254,809,21,830
公投第１１案,高雄市,三民區,灣勝里,993,945,380,166,546,27,573
公投第１１案,高雄市,三民區,灣勝里,994,944,419,183,602,23,625
公投第１１案,高雄市,三民區,灣利里,995,1669,647,315,962,61,1023
公投第１１案,高雄市,三民區,灣利里,996,1473,651,255,906,39,945
公投第１１案,高雄市,三民區,灣復里,997,1876,599,328,927,30,957
公投第１１案,高雄市,三民區,灣復里,998,1682,459,200,659,18,677
公投第１１案,高雄市,三民區,正興里,999,1791,595,363,958,15,973
公投第１１案,高雄市,三民區,正興里,1000,1808,715,352,1067,35,1102
公投第１１案,高雄市,三民區,正興里,1001,1798,667,320,987,29,1016
公投第１１案,高雄市,三民區,正興里,1002,2030,746,430,1176,28,1204
公投第１１案,高雄市,三民區,正興里,1003,2034,768,396,1164,18,1182
公投第１１案,高雄市,三民區,正興里,1004,1998,781,379,1160,23,1183
公投第１１案,高雄市,三民區,正順里,1005,1914,727,330,1057,27,1084
公投第１１案,高雄市,三民區,正順里,1006,1965,664,449,1113,30,1143
公投第１１案,高雄市,三民區,灣興里,1007,1885,679,376,1055,46,1101
公投第１１案,高雄市,三民區,灣成里,1008,1220,532,242,774,11,785
公投第１１案,高雄市,三民區,灣成里,1009,1057,444,169,613,36,649
公投第１１案,高雄市,三民區,安康里,1010,1434,473,236,709,22,731
公投第１１案,高雄市,三民區,安康里,1011,1350,494,199,693,35,728
公投第１１案,高雄市,三民區,安寧里,1012,872,351,127,478,13,491
公投第１１案,高雄市,三民區,安寧里,1013,954,352,167,519,19,538
公投第１１案,高雄市,三民區,安吉里,1014,1689,799,328,1127,16,1143
公投第１１案,高雄市,三民區,安吉里,1015,1390,560,263,823,13,836
公投第１１案,高雄市,三民區,安吉里,1016,1336,540,265,805,29,834
公投第１１案,高雄市,三民區,安發里,1017,1437,620,316,936,31,967
公投第１１案,高雄市,三民區,安發里,1018,1452,589,284,873,23,896
公投第１１案,高雄市,三民區,安發里,1019,1513,585,318,903,41,944
公投第１１案,高雄市,三民區,安東里,1020,1467,623,297,920,53,973
公投第１１案,高雄市,三民區,安東里,1021,1381,627,271,898,52,950
公投第１１案,高雄市,三民區,安和里,1022,1117,444,203,647,41,688
公投第１１案,高雄市,三民區,安和里,1023,1327,557,295,852,21,873
公投第１１案,高雄市,三民區,達德里,1024,1304,547,275,822,26,848
公投第１１案,高雄市,三民區,達明里,1025,1483,570,270,840,26,866
公投第１１案,高雄市,三民區,達仁里,1026,1473,640,286,926,21,947
公投第１１案,高雄市,三民區,達勇里,1027,980,365,202,567,32,599
公投第１１案,高雄市,三民區,同德里,1028,1409,612,251,863,23,886
公投第１１案,高雄市,三民區,同德里,1029,1230,518,240,758,18,776
公投第１１案,高雄市,三民區,德智里,1030,1024,453,214,667,20,687
公投第１１案,高雄市,三民區,德智里,1031,1130,456,221,677,36,713
公投第１１案,高雄市,三民區,德仁里,1032,1889,670,341,1011,27,1038
公投第１１案,高雄市,三民區,安生里,1033,1427,626,234,860,22,882
公投第１１案,高雄市,三民區,德東里,1034,791,397,117,514,23,537
公投第１１案,高雄市,三民區,德行里,1035,1079,535,209,744,32,776
公投第１１案,高雄市,三民區,精華里,1036,1492,603,271,874,34,908
公投第１１案,高雄市,三民區,民享里,1037,1020,426,209,635,31,666
公投第１１案,高雄市,三民區,民享里,1038,1001,423,221,644,8,652
公投第１１案,高雄市,三民區,安宜里,1039,1581,691,288,979,26,1005
公投第１１案,高雄市,三民區,安宜里,1040,1471,596,274,870,28,898
公投第１１案,高雄市,三民區,安泰里,1041,1151,514,229,743,15,758
公投第１１案,高雄市,三民區,安泰里,1042,1334,593,250,843,32,875
公投第１１案,高雄市,三民區,安泰里,1043,1275,545,213,758,25,783
公投第１１案,高雄市,三民區,安邦里,1044,1688,498,262,760,25,785
公投第１１案,高雄市,三民區,安邦里,1045,1214,502,234,736,24,760
公投第１１案,高雄市,三民區,安邦里,1046,1149,489,257,746,25,771
公投第１１案,高雄市,三民區,十全里,1047,1667,659,310,969,62,1031
公投第１１案,高雄市,三民區,十美里,1048,1786,652,335,987,25,1012
公投第１１案,高雄市,三民區,德北里,1049,896,373,171,544,16,560
公投第１１案,高雄市,三民區,德北里,1050,925,396,162,558,26,584
公投第１１案,高雄市,三民區,立誠里,1051,684,299,146,445,29,474
公投第１１案,高雄市,三民區,立業里,1052,981,410,212,622,35,657
公投第１１案,高雄市,三民區,港東里,1053,1383,517,216,733,40,773
公投第１１案,高雄市,三民區,港新里,1054,1382,564,263,827,24,851
公投第１１案,高雄市,三民區,港西里,1055,808,316,143,459,25,484
公投第１１案,高雄市,三民區,博愛里,1056,1197,449,253,702,32,734
公投第１１案,高雄市,三民區,博惠里,1057,1344,641,195,836,28,864
公投第１１案,高雄市,三民區,博惠里,1058,1344,562,262,824,44,868
公投第１１案,高雄市,三民區,博惠里,1059,1359,572,262,834,18,852
公投第１１案,高雄市,三民區,長明里,1060,1073,434,219,653,37,690
公投第１１案,高雄市,三民區,建東里,1061,1186,432,219,651,32,683
公投第１１案,高雄市,三民區,興德里,1062,1749,662,324,986,47,1033
公投第１１案,高雄市,三民區,鳳南里,1063,877,399,147,546,11,557
公投第１１案,高雄市,三民區,鳳北里,1064,1402,627,255,882,47,929
公投第１１案,高雄市,三民區,德西里,1065,769,341,160,501,22,523
公投第１１案,高雄市,三民區,豐裕里,1066,1207,514,230,744,33,777
公投第１１案,高雄市,三民區,豐裕里,1067,1270,469,214,683,31,714
公投第１１案,高雄市,三民區,川東里,1068,1248,479,241,720,33,753
公投第１１案,高雄市,三民區,裕民里,1069,1263,524,232,756,36,792
公投第１１案,高雄市,三民區,力行里,1070,1101,490,186,676,32,708
公投第１１案,高雄市,三民區,千歲里,1071,1116,497,229,726,18,744
公投第１１案,高雄市,三民區,立德里,1072,1152,498,211,709,26,735
公投第１１案,高雄市,三民區,千北里,1073,1057,443,206,649,26,675
公投第１１案,高雄市,三民區,千秋里,1074,971,393,160,553,26,579
公投第１１案,高雄市,三民區,千秋里,1075,1062,434,193,627,15,642
公投第１１案,高雄市,前金區,三川里,1076,673,277,122,399,22,421
公投第１１案,高雄市,前金區,草江里,1077,1022,423,208,631,22,653
公投第１１案,高雄市,前金區,長城里,1078,1324,544,224,768,28,796
公投第１１案,高雄市,前金區,北金里,1079,839,327,169,496,25,521
公投第１１案,高雄市,前金區,東金里,1080,975,381,191,572,26,598
公投第１１案,高雄市,前金區,新生里,1081,1806,708,325,1033,46,1079
公投第１１案,高雄市,前金區,新生里,1082,1781,719,323,1042,35,1077
公投第１１案,高雄市,前金區,後金里,1083,717,300,135,435,21,456
公投第１１案,高雄市,前金區,長興里,1084,1097,453,204,657,6,663
公投第１１案,高雄市,前金區,青山里,1085,1633,646,314,960,25,985
公投第１１案,高雄市,前金區,民生里,1086,759,332,173,505,14,519
公投第１１案,高雄市,前金區,復元里,1087,948,403,202,605,25,630
公投第１１案,高雄市,前金區,林投里,1088,1009,369,164,533,37,570
公投第１１案,高雄市,前金區,國民里,1089,945,395,174,569,25,594
公投第１１案,高雄市,前金區,社東里,1090,772,319,164,483,14,497
公投第１１案,高雄市,前金區,社東里,1091,757,316,159,475,16,491
公投第１１案,高雄市,前金區,社西里,1092,1047,453,198,651,31,682
公投第１１案,高雄市,前金區,博孝里,1093,985,419,190,609,23,632
公投第１１案,高雄市,前金區,長生里,1094,1674,643,307,950,16,966
公投第１１案,高雄市,前金區,榮復里,1095,1088,434,198,632,26,658
公投第１１案,高雄市,前金區,文西里,1096,893,376,186,562,47,609
公投第１１案,高雄市,前金區,文東里,1097,1184,474,217,691,23,714
公投第１１案,高雄市,新興區,浩然里,1098,828,323,161,484,23,507
公投第１１案,高雄市,新興區,浩然里,1099,963,410,197,607,32,639
公投第１１案,高雄市,新興區,振成里,1100,1075,394,210,604,20,624
公投第１１案,高雄市,新興區,德生里,1101,1488,564,321,885,15,900
公投第１１案,高雄市,新興區,德生里,1102,1438,448,313,761,24,785
公投第１１案,高雄市,新興區,振華里,1103,1049,402,225,627,24,651
公投第１１案,高雄市,新興區,正氣里,1104,1378,588,283,871,52,923
公投第１１案,高雄市,新興區,德政里,1105,666,300,123,423,24,447
公投第１１案,高雄市,新興區,仁聲里,1106,981,370,233,603,9,612
公投第１１案,高雄市,新興區,德望里,1107,933,405,188,593,26,619
公投第１１案,高雄市,新興區,德望里,1108,987,410,166,576,13,589
公投第１１案,高雄市,新興區,華聲里,1109,988,422,189,611,21,632
公投第１１案,高雄市,新興區,蕉園里,1110,735,324,147,471,24,495
公投第１１案,高雄市,新興區,永寧里,1111,1317,522,261,783,28,811
公投第１１案,高雄市,新興區,玉衡里,1112,800,315,160,475,12,487
公投第１１案,高雄市,新興區,順昌里,1113,968,423,184,607,23,630
公投第１１案,高雄市,新興區,順昌里,1114,913,406,152,558,15,573
公投第１１案,高雄市,新興區,文昌里,1115,1389,559,329,888,19,907
公投第１１案,高雄市,新興區,文昌里,1116,1228,512,296,808,27,835
公投第１１案,高雄市,新興區,光耀里,1117,1211,508,245,753,25,778
公投第１１案,高雄市,新興區,光耀里,1118,1101,486,201,687,18,705
公投第１１案,高雄市,新興區,興昌里,1119,752,312,152,464,23,487
公投第１１案,高雄市,新興區,興昌里,1120,873,393,202,595,27,622
公投第１１案,高雄市,新興區,開平里,1121,1609,672,325,997,24,1021
公投第１１案,高雄市,新興區,開平里,1122,1736,710,368,1078,31,1109
公投第１１案,高雄市,新興區,成功里,1123,1258,514,231,745,14,759
公投第１１案,高雄市,新興區,新江里,1124,1105,457,216,673,23,696
公投第１１案,高雄市,新興區,黎明里,1125,851,334,171,505,34,539
公投第１１案,高雄市,新興區,愛平里,1126,1011,422,202,624,26,650
公投第１１案,高雄市,新興區,南港里,1127,888,402,190,592,39,631
公投第１１案,高雄市,新興區,南港里,1128,1005,408,200,608,20,628
公投第１１案,高雄市,新興區,中東里,1129,1375,412,219,631,14,645
公投第１１案,高雄市,新興區,中東里,1130,1388,526,299,825,29,854
公投第１１案,高雄市,新興區,明莊里,1131,719,292,130,422,22,444
公投第１１案,高雄市,新興區,大明里,1132,1077,368,205,573,38,611
公投第１１案,高雄市,新興區,秋山里,1133,875,313,144,457,17,474
公投第１１案,高雄市,新興區,長驛里,1134,936,380,158,538,15,553
公投第１１案,高雄市,新興區,建興里,1135,944,384,157,541,30,571
公投第１１案,高雄市,新興區,建華里,1136,833,317,149,466,18,484
公投第１１案,高雄市,新興區,漢民里,1137,708,305,143,448,11,459
公投第１１案,高雄市,新興區,榮治里,1138,741,285,144,429,12,441
公投第１１案,高雄市,新興區,東坡里,1139,1235,485,217,702,17,719
公投第１１案,高雄市,苓雅區,博仁里,1140,718,291,156,447,15,462
公投第１１案,高雄市,苓雅區,苓洲里,1141,1492,601,247,848,31,879
公投第１１案,高雄市,苓雅區,苓昇里,1142,1210,513,222,735,31,766
公投第１１案,高雄市,苓雅區,苓中里,1143,1617,622,267,889,29,918
公投第１１案,高雄市,苓雅區,苓雅里,1144,1428,583,273,856,46,902
公投第１１案,高雄市,苓雅區,苓東里,1145,1444,547,243,790,31,821
公投第１１案,高雄市,苓雅區,城北里,1146,1452,569,266,835,34,869
公投第１１案,高雄市,苓雅區,城西里,1147,554,252,95,347,14,361
公投第１１案,高雄市,苓雅區,城東里,1148,950,373,180,553,13,566
公投第１１案,高雄市,苓雅區,城東里,1149,978,404,159,563,18,581
公投第１１案,高雄市,苓雅區,意誠里,1150,1673,627,287,914,20,934
公投第１１案,高雄市,苓雅區,意誠里,1151,2045,699,411,1110,38,1148
公投第１１案,高雄市,苓雅區,鼓中里,1152,939,406,161,567,39,606
公投第１１案,高雄市,苓雅區,田西里,1153,1284,459,243,702,20,722
公投第１１案,高雄市,苓雅區,人和里,1154,908,392,164,556,18,574
公投第１１案,高雄市,苓雅區,人和里,1155,838,312,164,476,13,489
公投第１１案,高雄市,苓雅區,仁政里,1156,1267,532,242,774,22,796
公投第１１案,高雄市,苓雅區,廣澤里,1157,994,467,180,647,26,673
公投第１１案,高雄市,苓雅區,廣澤里,1158,774,336,137,473,16,489
公投第１１案,高雄市,苓雅區,美田里,1159,1121,457,218,675,24,699
公投第１１案,高雄市,苓雅區,華堂里,1160,1474,564,313,877,27,904
公投第１１案,高雄市,苓雅區,華堂里,1161,1525,623,272,895,67,962
公投第１１案,高雄市,苓雅區,日中里,1162,1147,489,215,704,25,729
公投第１１案,高雄市,苓雅區,日中里,1163,1014,410,238,648,30,678
公投第１１案,高雄市,苓雅區,普照里,1164,1496,579,304,883,37,920
公投第１１案,高雄市,苓雅區,普照里,1165,1499,643,278,921,40,961
公投第１１案,高雄市,苓雅區,和煦里,1166,1138,482,228,710,29,739
公投第１１案,高雄市,苓雅區,和煦里,1167,839,397,169,566,21,587
公投第１１案,高雄市,苓雅區,晴朗里,1168,2088,501,230,731,25,756
公投第１１案,高雄市,苓雅區,普天里,1169,1648,659,347,1006,25,1031
公投第１１案,高雄市,苓雅區,普天里,1170,1623,645,276,921,35,956
公投第１１案,高雄市,苓雅區,林富里,1171,1932,818,419,1237,35,1272
公投第１１案,高雄市,苓雅區,林圍里,1172,1127,529,241,770,18,788
公投第１１案,高雄市,苓雅區,林圍里,1173,1156,551,258,809,16,825
公投第１１案,高雄市,苓雅區,林安里,1174,1465,652,287,939,24,963
公投第１１案,高雄市,苓雅區,光華里,1175,690,285,101,386,22,408
公投第１１案,高雄市,苓雅區,林興里,1176,1283,540,222,762,42,804
公投第１１案,高雄市,苓雅區,林華里,1177,1432,578,258,836,45,881
公投第１１案,高雄市,苓雅區,林華里,1178,1313,573,233,806,18,824
公投第１１案,高雄市,苓雅區,林西里,1179,1579,617,288,905,26,931
公投第１１案,高雄市,苓雅區,林中里,1180,1385,577,268,845,38,883
公投第１１案,高雄市,苓雅區,林中里,1181,1449,632,261,893,30,923
公投第１１案,高雄市,苓雅區,林泉里,1182,1834,753,383,1136,33,1169
公投第１１案,高雄市,苓雅區,林南里,1183,1436,623,275,898,28,926
公投第１１案,高雄市,苓雅區,林南里,1184,1431,632,273,905,28,933
公投第１１案,高雄市,苓雅區,中正里,1185,1248,537,267,804,24,828
公投第１１案,高雄市,苓雅區,中正里,1186,1470,592,311,903,39,942
公投第１１案,高雄市,苓雅區,尚義里,1187,1540,683,300,983,41,1024
公投第１１案,高雄市,苓雅區,同慶里,1188,1374,602,283,885,19,904
公投第１１案,高雄市,苓雅區,同慶里,1189,839,367,185,552,15,567
公投第１１案,高雄市,苓雅區,凱旋里,1190,1022,442,241,683,16,699
公投第１１案,高雄市,苓雅區,凱旋里,1191,1062,487,195,682,17,699
公投第１１案,高雄市,苓雅區,安祥里,1192,1078,430,243,673,21,694
公投第１１案,高雄市,苓雅區,安祥里,1193,1117,511,217,728,17,745
公投第１１案,高雄市,苓雅區,奏捷里,1194,1516,671,270,941,42,983
公投第１１案,高雄市,苓雅區,福壽里,1195,1440,556,274,830,68,898
公投第１１案,高雄市,苓雅區,福南里,1196,839,342,172,514,22,536
公投第１１案,高雄市,苓雅區,福南里,1197,888,384,139,523,15,538
公投第１１案,高雄市,苓雅區,五權里,1198,1101,459,247,706,25,731
公投第１１案,高雄市,苓雅區,五權里,1199,1004,464,229,693,30,723
公投第１１案,高雄市,苓雅區,民主里,1200,1427,613,254,867,32,899
公投第１１案,高雄市,苓雅區,民主里,1201,1168,485,225,710,28,738
公投第１１案,高雄市,苓雅區,民主里,1202,1184,492,266,758,41,799
公投第１１案,高雄市,苓雅區,林德里,1203,974,415,202,617,19,636
公投第１１案,高雄市,苓雅區,林德里,1204,849,331,146,477,12,489
公投第１１案,高雄市,苓雅區,林貴里,1205,1821,783,326,1109,28,1137
公投第１１案,高雄市,苓雅區,林榮里,1206,1306,537,263,800,33,833
公投第１１案,高雄市,苓雅區,林榮里,1207,1185,510,248,758,14,772
公投第１１案,高雄市,苓雅區,林榮里,1208,1415,558,283,841,26,867
公投第１１案,高雄市,苓雅區,英明里,1209,962,421,209,630,22,652
公投第１１案,高雄市,苓雅區,英明里,1210,964,388,184,572,29,601
公投第１１案,高雄市,苓雅區,林靖里,1211,1524,629,305,934,17,951
公投第１１案,高雄市,苓雅區,朝陽里,1212,1455,609,292,901,27,928
公投第１１案,高雄市,苓雅區,福隆里,1213,1272,506,207,713,20,733
公投第１１案,高雄市,苓雅區,福隆里,1214,1256,493,249,742,19,761
公投第１１案,高雄市,苓雅區,福祥里,1215,1203,523,192,715,23,738
公投第１１案,高雄市,苓雅區,福海里,1216,1062,489,180,669,25,694
公投第１１案,高雄市,苓雅區,福康里,1217,850,366,168,534,43,577
公投第１１案,高雄市,苓雅區,福康里,1218,1010,422,224,646,51,697
公投第１１案,高雄市,苓雅區,福人里,1219,1118,444,204,648,24,672
公投第１１案,高雄市,苓雅區,福人里,1220,937,406,179,585,30,615
公投第１１案,高雄市,苓雅區,福地里,1221,1493,586,245,831,20,851
公投第１１案,高雄市,苓雅區,福地里,1222,1183,493,250,743,25,768
公投第１１案,高雄市,苓雅區,福居里,1223,1318,514,231,745,23,768
公投第１１案,高雄市,苓雅區,福居里,1224,1362,555,250,805,35,840
公投第１１案,高雄市,苓雅區,福東里,1225,1102,448,206,654,36,690
公投第１１案,高雄市,苓雅區,福東里,1226,1481,600,277,877,24,901
公投第１１案,高雄市,苓雅區,福西里,1227,878,387,163,550,29,579
公投第１１案,高雄市,苓雅區,福西里,1228,908,371,147,518,15,533
公投第１１案,高雄市,苓雅區,永康里,1229,1056,457,215,672,23,695
公投第１１案,高雄市,苓雅區,永康里,1230,1091,454,181,635,22,657
公投第１１案,高雄市,苓雅區,正文里,1231,976,414,198,612,21,633
公投第１１案,高雄市,苓雅區,正文里,1232,1063,462,236,698,25,723
公投第１１案,高雄市,苓雅區,正言里,1233,1484,610,286,896,42,938
公投第１１案,高雄市,苓雅區,正言里,1234,1290,522,270,792,26,818
公投第１１案,高雄市,苓雅區,正大里,1235,1740,704,334,1038,44,1082
公投第１１案,高雄市,苓雅區,正大里,1236,1594,659,283,942,30,972
公投第１１案,高雄市,苓雅區,正大里,1237,1648,650,309,959,27,986
公投第１１案,高雄市,苓雅區,五福里,1238,1236,556,226,782,29,811
公投第１１案,高雄市,苓雅區,五福里,1239,1211,504,234,738,28,766
公投第１１案,高雄市,苓雅區,五福里,1240,1283,572,214,786,19,805
公投第１１案,高雄市,苓雅區,正心里,1241,1804,769,340,1109,49,1158
公投第１１案,高雄市,苓雅區,正心里,1242,1718,718,327,1045,42,1087
公投第１１案,高雄市,苓雅區,正道里,1243,1297,534,255,789,33,822
公投第１１案,高雄市,苓雅區,正道里,1244,1449,580,266,846,51,897
公投第１１案,高雄市,苓雅區,正道里,1245,1307,537,245,782,16,798
公投第１１案,高雄市,苓雅區,正義里,1246,1184,508,221,729,29,758
公投第１１案,高雄市,苓雅區,正義里,1247,1250,539,269,808,34,842
公投第１１案,高雄市,苓雅區,正仁里,1248,1248,489,230,719,28,747
公投第１１案,高雄市,苓雅區,正仁里,1249,1283,570,223,793,24,817
公投第１１案,高雄市,苓雅區,文昌里,1250,1121,540,196,736,22,758
公投第１１案,高雄市,苓雅區,文昌里,1251,1258,537,245,782,23,805
公投第１１案,高雄市,苓雅區,文昌里,1252,1339,574,246,820,15,835
公投第１１案,高雄市,苓雅區,建軍里,1253,1986,781,350,1131,50,1181
公投第１１案,高雄市,苓雅區,衛武里,1254,1028,466,161,627,20,647
公投第１１案,高雄市,苓雅區,衛武里,1255,948,383,207,590,19,609
公投第１１案,高雄市,鳳山區,鳳崗里,1256,1080,463,232,695,27,722
公投第１１案,高雄市,鳳山區,縣衙里,1257,819,341,151,492,30,522
公投第１１案,高雄市,鳳山區,曹公里,1258,851,365,134,499,36,535
公投第１１案,高雄市,鳳山區,曹公里,1259,1075,433,232,665,18,683
公投第１１案,高雄市,鳳山區,鎮西里,1260,1223,537,216,753,28,781
公投第１１案,高雄市,鳳山區,鎮西里,1261,1207,511,219,730,23,753
公投第１１案,高雄市,鳳山區,鎮西里,1262,1339,494,232,726,24,750
公投第１１案,高雄市,鳳山區,鎮西里,1263,1188,418,211,629,19,648
公投第１１案,高雄市,鳳山區,北門里,1264,1055,412,214,626,21,647
公投第１１案,高雄市,鳳山區,北門里,1265,1109,454,169,623,32,655
公投第１１案,高雄市,鳳山區,北門里,1266,756,355,144,499,18,517
公投第１１案,高雄市,鳳山區,北門里,1267,1182,454,203,657,31,688
公投第１１案,高雄市,鳳山區,鎮北里,1268,1496,600,261,861,42,903
公投第１１案,高雄市,鳳山區,鎮北里,1269,2094,675,347,1022,33,1055
公投第１１案,高雄市,鳳山區,鎮北里,1270,1672,662,292,954,21,975
公投第１１案,高雄市,鳳山區,鎮北里,1271,1761,643,319,962,16,978
公投第１１案,高雄市,鳳山區,鎮北里,1272,1450,579,260,839,38,877
公投第１１案,高雄市,鳳山區,武松里,1273,1455,502,241,743,21,764
公投第１１案,高雄市,鳳山區,武松里,1274,1234,507,206,713,29,742
公投第１１案,高雄市,鳳山區,忠誠里,1275,1713,679,358,1037,45,1082
公投第１１案,高雄市,鳳山區,忠誠里,1276,1698,674,262,936,34,970
公投第１１案,高雄市,鳳山區,文英里,1277,1247,492,256,748,30,778
公投第１１案,高雄市,鳳山區,文英里,1278,1087,441,216,657,21,678
公投第１１案,高雄市,鳳山區,文英里,1279,1199,497,227,724,23,747
公投第１１案,高雄市,鳳山區,文華里,1280,1559,642,227,869,34,903
公投第１１案,高雄市,鳳山區,文華里,1281,1233,521,251,772,27,799
公投第１１案,高雄市,鳳山區,文華里,1282,1277,516,254,770,27,797
公投第１１案,高雄市,鳳山區,文華里,1283,1481,636,246,882,13,895
公投第１１案,高雄市,鳳山區,文華里,1284,1154,509,239,748,14,762
公投第１１案,高雄市,鳳山區,文華里,1285,1475,612,104,716,15,731
公投第１１案,高雄市,鳳山區,文山里,1286,1247,477,205,682,16,698
公投第１１案,高雄市,鳳山區,文山里,1287,1538,580,250,830,32,862
公投第１１案,高雄市,鳳山區,文山里,1288,1097,436,203,639,20,659
公投第１１案,高雄市,鳳山區,文山里,1289,1221,442,213,655,18,673
公投第１１案,高雄市,鳳山區,文山里,1290,1075,461,246,707,25,732
公投第１１案,高雄市,鳳山區,文德里,1291,1751,727,318,1045,32,1077
公投第１１案,高雄市,鳳山區,文德里,1292,1758,721,336,1057,28,1085
公投第１１案,高雄市,鳳山區,文德里,1293,1749,705,294,999,45,1044
公投第１１案,高雄市,鳳山區,文德里,1294,1746,680,246,926,13,939
公投第１１案,高雄市,鳳山區,文德里,1295,1712,673,300,973,31,1004
公投第１１案,高雄市,鳳山區,文衡里,1296,1247,499,245,744,22,766
公投第１１案,高雄市,鳳山區,文衡里,1297,1409,558,270,828,42,870
公投第１１案,高雄市,鳳山區,文衡里,1298,1347,508,283,791,23,814
公投第１１案,高雄市,鳳山區,文福里,1299,1771,699,316,1015,19,1034
公投第１１案,高雄市,鳳山區,文福里,1300,1537,589,313,902,10,912
公投第１１案,高雄市,鳳山區,文福里,1301,1605,667,295,962,23,985
公投第１１案,高雄市,鳳山區,文福里,1302,1375,588,228,816,24,840
公投第１１案,高雄市,鳳山區,文福里,1303,1393,582,266,848,34,882
公投第１１案,高雄市,鳳山區,文福里,1304,1584,570,304,874,17,891
公投第１１案,高雄市,鳳山區,成功里,1305,618,244,130,374,15,389
公投第１１案,高雄市,鳳山區,縣口里,1306,423,192,77,269,8,277
公投第１１案,高雄市,鳳山區,光明里,1307,1312,545,224,769,33,802
公投第１１案,高雄市,鳳山區,和德里,1308,769,296,159,455,22,477
公投第１１案,高雄市,鳳山區,和德里,1309,1213,520,264,784,18,802
公投第１１案,高雄市,鳳山區,和興里,1310,1107,549,187,736,14,750
公投第１１案,高雄市,鳳山區,和興里,1311,1188,507,217,724,22,746
公投第１１案,高雄市,鳳山區,和興里,1312,1183,475,254,729,26,755
公投第１１案,高雄市,鳳山區,和興里,1313,1264,507,251,758,28,786
公投第１１案,高雄市,鳳山區,南興里,1314,882,396,141,537,20,557
公投第１１案,高雄市,鳳山區,三民里,1315,1007,469,213,682,26,708
公投第１１案,高雄市,鳳山區,新興里,1316,853,364,139,503,37,540
公投第１１案,高雄市,鳳山區,新興里,1317,1660,294,151,445,34,479
公投第１１案,高雄市,鳳山區,興仁里,1318,1124,471,211,682,25,707
公投第１１案,高雄市,鳳山區,興仁里,1319,1112,449,212,661,38,699
公投第１１案,高雄市,鳳山區,興仁里,1320,1182,464,193,657,25,682
公投第１１案,高雄市,鳳山區,興中里,1321,875,402,198,600,30,630
公投第１１案,高雄市,鳳山區,協和里,1322,1040,403,226,629,26,655
公投第１１案,高雄市,鳳山區,協和里,1323,1094,466,242,708,16,724
公投第１１案,高雄市,鳳山區,協和里,1324,1217,492,241,733,32,765
公投第１１案,高雄市,鳳山區,忠義里,1325,974,429,214,643,22,665
公投第１１案,高雄市,鳳山區,忠義里,1326,987,407,196,603,18,621
公投第１１案,高雄市,鳳山區,忠義里,1327,1210,554,235,789,13,802
公投第１１案,高雄市,鳳山區,忠義里,1328,1391,531,282,813,28,841
公投第１１案,高雄市,鳳山區,忠孝里,1329,1241,415,222,637,18,655
公投第１１案,高雄市,鳳山區,忠孝里,1330,1000,423,207,630,26,656
公投第１１案,高雄市,鳳山區,忠孝里,1331,1092,470,200,670,16,686
公投第１１案,高雄市,鳳山區,忠孝里,1332,1308,566,237,803,31,834
公投第１１案,高雄市,鳳山區,忠孝里,1333,1031,451,170,621,28,649
公投第１１案,高雄市,鳳山區,中和里,1334,1159,483,240,723,41,764
公投第１１案,高雄市,鳳山區,中和里,1335,1127,462,182,644,31,675
公投第１１案,高雄市,鳳山區,中和里,1336,1109,533,239,772,25,797
公投第１１案,高雄市,鳳山區,誠義里,1337,1879,841,328,1169,29,1198
公投第１１案,高雄市,鳳山區,誠義里,1338,1803,803,357,1160,33,1193
公投第１１案,高雄市,鳳山區,生明里,1339,2045,762,310,1072,54,1126
公投第１１案,高雄市,鳳山區,鎮東里,1340,1432,577,214,791,27,818
公投第１１案,高雄市,鳳山區,鎮東里,1341,1033,457,148,605,22,627
公投第１１案,高雄市,鳳山區,瑞竹里,1342,1253,561,198,759,43,802
公投第１１案,高雄市,鳳山區,瑞竹里,1343,1217,501,232,733,18,751
公投第１１案,高雄市,鳳山區,瑞竹里,1344,1267,576,216,792,34,826
公投第１１案,高雄市,鳳山區,瑞竹里,1345,1251,511,211,722,32,754
公投第１１案,高雄市,鳳山區,瑞興里,1346,1563,658,266,924,43,967
公投第１１案,高雄市,鳳山區,瑞興里,1347,1888,784,344,1128,35,1163
公投第１１案,高雄市,鳳山區,瑞興里,1348,1368,549,265,814,22,836
公投第１１案,高雄市,鳳山區,東門里,1349,1588,572,277,849,35,884
公投第１１案,高雄市,鳳山區,東門里,1350,1255,597,172,769,33,802
公投第１１案,高雄市,鳳山區,東門里,1351,1264,515,215,730,36,766
公投第１１案,高雄市,鳳山區,東門里,1352,1291,537,219,756,36,792
公投第１１案,高雄市,鳳山區,誠德里,1353,1224,546,188,734,17,751
公投第１１案,高雄市,鳳山區,誠德里,1354,1296,547,196,743,18,761
公投第１１案,高雄市,鳳山區,誠信里,1355,826,366,162,528,30,558
公投第１１案,高雄市,鳳山區,誠信里,1356,1229,550,180,730,26,756
公投第１１案,高雄市,鳳山區,誠智里,1357,1467,602,269,871,27,898
公投第１１案,高雄市,鳳山區,誠智里,1358,1218,510,211,721,30,751
公投第１１案,高雄市,鳳山區,鳳東里,1359,2173,864,353,1217,34,1251
公投第１１案,高雄市,鳳山區,鳳東里,1360,2255,930,355,1285,38,1323
公投第１１案,高雄市,鳳山區,鳳東里,1361,1556,681,276,957,26,983
公投第１１案,高雄市,鳳山區,埤頂里,1362,1521,586,257,843,21,864
公投第１１案,高雄市,鳳山區,埤頂里,1363,1407,537,192,729,26,755
公投第１１案,高雄市,鳳山區,埤頂里,1364,1542,640,260,900,38,938
公投第１１案,高雄市,鳳山區,埤頂里,1365,1502,577,231,808,14,822
公投第１１案,高雄市,鳳山區,中正里,1366,1320,551,239,790,32,822
公投第１１案,高雄市,鳳山區,中正里,1367,1507,662,143,805,34,839
公投第１１案,高雄市,鳳山區,中正里,1368,1284,627,169,796,34,830
公投第１１案,高雄市,鳳山區,海光里,1369,1441,553,244,797,23,820
公投第１１案,高雄市,鳳山區,海光里,1370,1485,654,223,877,49,926
公投第１１案,高雄市,鳳山區,國泰里,1371,1205,512,182,694,38,732
公投第１１案,高雄市,鳳山區,國泰里,1372,1284,511,205,716,19,735
公投第１１案,高雄市,鳳山區,國泰里,1373,1326,541,263,804,35,839
公投第１１案,高雄市,鳳山區,國光里,1374,1096,465,201,666,20,686
公投第１１案,高雄市,鳳山區,國光里,1375,1182,503,231,734,35,769
公投第１１案,高雄市,鳳山區,國光里,1376,1017,473,193,666,38,704
公投第１１案,高雄市,鳳山區,國隆里,1377,1198,465,225,690,35,725
公投第１１案,高雄市,鳳山區,國隆里,1378,1281,476,234,710,24,734
公投第１１案,高雄市,鳳山區,國富里,1379,1358,566,292,858,27,885
公投第１１案,高雄市,鳳山區,國富里,1380,1226,536,270,806,22,828
公投第１１案,高雄市,鳳山區,武慶里,1381,1098,482,214,696,24,720
公投第１１案,高雄市,鳳山區,武慶里,1382,1200,493,234,727,27,754
公投第１１案,高雄市,鳳山區,武漢里,1383,942,373,190,563,30,593
公投第１１案,高雄市,鳳山區,武漢里,1384,1206,510,200,710,25,735
公投第１１案,高雄市,鳳山區,武漢里,1385,1159,482,213,695,20,715
公投第１１案,高雄市,鳳山區,武漢里,1386,1401,584,279,863,25,888
公投第１１案,高雄市,鳳山區,新甲里,1387,1525,599,266,865,15,880
公投第１１案,高雄市,鳳山區,新甲里,1388,1345,541,240,781,26,807
公投第１１案,高雄市,鳳山區,新武里,1389,1180,530,121,651,23,674
公投第１１案,高雄市,鳳山區,新武里,1390,1106,446,181,627,17,644
公投第１１案,高雄市,鳳山區,新泰里,1391,1442,604,284,888,41,929
公投第１１案,高雄市,鳳山區,新泰里,1392,1376,565,262,827,33,860
公投第１１案,高雄市,鳳山區,新泰里,1393,1243,533,224,757,19,776
公投第１１案,高雄市,鳳山區,新樂里,1394,1361,561,267,828,19,847
公投第１１案,高雄市,鳳山區,新樂里,1395,1416,569,304,873,18,891
公投第１１案,高雄市,鳳山區,新樂里,1396,1536,638,348,986,25,1011
公投第１１案,高雄市,鳳山區,新強里,1397,1388,532,240,772,20,792
公投第１１案,高雄市,鳳山區,新強里,1398,1241,533,203,736,43,779
公投第１１案,高雄市,鳳山區,新強里,1399,1394,586,276,862,22,884
公投第１１案,高雄市,鳳山區,新強里,1400,1188,535,248,783,11,794
公投第１１案,高雄市,鳳山區,海洋里,1401,1112,511,206,717,17,734
公投第１１案,高雄市,鳳山區,海洋里,1402,1198,532,257,789,11,800
公投第１１案,高雄市,鳳山區,海洋里,1403,1475,551,296,847,15,862
公投第１１案,高雄市,鳳山區,新富里,1404,1216,492,188,680,26,706
公投第１１案,高雄市,鳳山區,新富里,1405,1318,500,230,730,27,757
公投第１１案,高雄市,鳳山區,新富里,1406,1465,573,272,845,30,875
公投第１１案,高雄市,鳳山區,老爺里,1407,1314,491,218,709,21,730
公投第１１案,高雄市,鳳山區,老爺里,1408,1649,592,261,853,16,869
公投第１１案,高雄市,鳳山區,老爺里,1409,1601,590,254,844,77,921
公投第１１案,高雄市,鳳山區,老爺里,1410,1155,436,228,664,22,686
公投第１１案,高雄市,鳳山區,老爺里,1411,1050,419,182,601,51,652
公投第１１案,高雄市,鳳山區,中民里,1412,1417,543,226,769,24,793
公投第１１案,高雄市,鳳山區,中民里,1413,1525,618,244,862,37,899
公投第１１案,高雄市,鳳山區,中民里,1414,1514,638,263,901,30,931
公投第１１案,高雄市,鳳山區,中崙里,1415,1190,456,230,686,29,715
公投第１１案,高雄市,鳳山區,中崙里,1416,1325,505,229,734,19,753
公投第１１案,高雄市,鳳山區,中榮里,1417,1049,455,172,627,39,666
公投第１１案,高雄市,鳳山區,中榮里,1418,1026,468,177,645,14,659
公投第１１案,高雄市,鳳山區,中榮里,1419,1152,471,222,693,37,730
公投第１１案,高雄市,鳳山區,中榮里,1420,1254,367,308,675,20,695
公投第１１案,高雄市,鳳山區,過埤里,1421,1688,647,261,908,23,931
公投第１１案,高雄市,鳳山區,過埤里,1422,1657,696,249,945,36,981
公投第１１案,高雄市,鳳山區,過埤里,1423,1729,616,276,892,35,927
公投第１１案,高雄市,鳳山區,過埤里,1424,1628,669,309,978,14,992
公投第１１案,高雄市,鳳山區,過埤里,1425,1891,686,285,971,12,983
公投第１１案,高雄市,鳳山區,過埤里,1426,1594,709,265,974,23,997
公投第１１案,高雄市,鳳山區,過埤里,1427,1342,617,246,863,10,873
公投第１１案,高雄市,鳳山區,過埤里,1428,1448,643,281,924,26,950
公投第１１案,高雄市,鳳山區,正義里,1429,1405,575,272,847,35,882
公投第１１案,高雄市,鳳山區,正義里,1430,1097,525,164,689,37,726
公投第１１案,高雄市,鳳山區,正義里,1431,1248,536,245,781,42,823
公投第１１案,高雄市,鳳山區,正義里,1432,1225,514,220,734,31,765
公投第１１案,高雄市,鳳山區,正義里,1433,1214,533,207,740,17,757
公投第１１案,高雄市,鳳山區,保安里,1434,2032,860,344,1204,52,1256
公投第１１案,高雄市,鳳山區,保安里,1435,1927,812,299,1111,45,1156
公投第１１案,高雄市,鳳山區,保安里,1436,2097,810,345,1155,41,1196
公投第１１案,高雄市,鳳山區,一甲里,1437,968,405,149,554,24,578
公投第１１案,高雄市,鳳山區,一甲里,1438,1200,449,208,657,36,693
公投第１１案,高雄市,鳳山區,一甲里,1439,1101,434,207,641,35,676
公投第１１案,高雄市,鳳山區,二甲里,1440,1369,527,220,747,30,777
公投第１１案,高雄市,鳳山區,二甲里,1441,1542,633,262,895,40,935
公投第１１案,高雄市,鳳山區,二甲里,1442,1536,709,260,969,39,1008
公投第１１案,高雄市,鳳山區,龍成里,1443,1382,517,256,773,18,791
公投第１１案,高雄市,鳳山區,龍成里,1444,1452,580,263,843,51,894
公投第１１案,高雄市,鳳山區,鎮南里,1445,1058,428,182,610,33,643
公投第１１案,高雄市,鳳山區,鎮南里,1446,976,436,172,608,28,636
公投第１１案,高雄市,鳳山區,鎮南里,1447,1545,573,241,814,20,834
公投第１１案,高雄市,鳳山區,鎮南里,1448,1143,445,211,656,26,682
公投第１１案,高雄市,鳳山區,富甲里,1449,1301,251,113,364,11,375
公投第１１案,高雄市,鳳山區,富甲里,1450,1250,477,198,675,30,705
公投第１１案,高雄市,鳳山區,善美里,1451,1208,472,216,688,31,719
公投第１１案,高雄市,鳳山區,善美里,1452,1202,499,195,694,49,743
公投第１１案,高雄市,鳳山區,善美里,1453,1499,538,288,826,44,870
公投第１１案,高雄市,鳳山區,善美里,1454,1522,549,294,843,18,861
公投第１１案,高雄市,鳳山區,富榮里,1455,1125,477,231,708,32,740
公投第１１案,高雄市,鳳山區,富榮里,1456,1307,545,240,785,19,804
公投第１１案,高雄市,鳳山區,南和里,1457,1405,570,268,838,36,874
公投第１１案,高雄市,鳳山區,南和里,1458,1252,517,220,737,35,772
公投第１１案,高雄市,鳳山區,南成里,1459,1291,571,236,807,15,822
公投第１１案,高雄市,鳳山區,南成里,1460,938,399,169,568,39,607
公投第１１案,高雄市,鳳山區,南成里,1461,1783,739,309,1048,29,1077
公投第１１案,高雄市,鳳山區,南成里,1462,1105,474,211,685,24,709
公投第１１案,高雄市,鳳山區,南成里,1463,1392,561,227,788,48,836
公投第１１案,高雄市,鳳山區,南成里,1464,1244,577,227,804,31,835
公投第１１案,高雄市,鳳山區,天興里,1465,1154,434,211,645,30,675
公投第１１案,高雄市,鳳山區,天興里,1466,1153,471,231,702,33,735
公投第１１案,高雄市,鳳山區,天興里,1467,1148,448,175,623,17,640
公投第１１案,高雄市,鳳山區,大德里,1468,1432,560,212,772,55,827
公投第１１案,高雄市,鳳山區,大德里,1469,1429,415,221,636,20,656
公投第１１案,高雄市,鳳山區,大德里,1470,1479,584,240,824,26,850
公投第１１案,高雄市,鳳山區,五福里,1471,1026,472,231,703,14,717
公投第１１案,高雄市,鳳山區,五福里,1472,993,451,184,635,49,684
公投第１１案,高雄市,鳳山區,五福里,1473,947,419,162,581,38,619
公投第１１案,高雄市,鳳山區,福興里,1474,1042,437,179,616,33,649
公投第１１案,高雄市,鳳山區,福興里,1475,1098,452,185,637,34,671
公投第１１案,高雄市,鳳山區,福興里,1476,1284,461,214,675,13,688
公投第１１案,高雄市,鳳山區,福興里,1477,1242,451,225,676,30,706
公投第１１案,高雄市,鳳山區,福興里,1478,1093,443,214,657,43,700
公投第１１案,高雄市,鳳山區,福祥里,1479,1353,506,242,748,35,783
公投第１１案,高雄市,鳳山區,福祥里,1480,1353,529,231,760,15,775
公投第１１案,高雄市,鳳山區,福誠里,1481,1309,535,239,774,30,804
公投第１１案,高雄市,鳳山區,福誠里,1482,1627,605,327,932,47,979
公投第１１案,高雄市,鳳山區,福誠里,1483,1372,566,243,809,45,854
公投第１１案,高雄市,前鎮區,草衙里,1484,1809,649,277,926,76,1002
公投第１１案,高雄市,前鎮區,草衙里,1485,1835,676,289,965,46,1011
公投第１１案,高雄市,前鎮區,草衙里,1486,1890,530,268,798,47,845
公投第１１案,高雄市,前鎮區,草衙里,1487,2013,659,328,987,49,1036
公投第１１案,高雄市,前鎮區,草衙里,1488,1776,618,300,918,45,963
公投第１１案,高雄市,前鎮區,明孝里,1489,1705,500,278,778,49,827
公投第１１案,高雄市,前鎮區,明孝里,1490,672,251,122,373,48,421
公投第１１案,高雄市,前鎮區,明正里,1491,1726,559,264,823,49,872
公投第１１案,高雄市,前鎮區,明正里,1492,1597,614,302,916,24,940
公投第１１案,高雄市,前鎮區,明正里,1493,1690,640,315,955,51,1006
公投第１１案,高雄市,前鎮區,明義里,1494,1080,468,178,646,50,696
公投第１１案,高雄市,前鎮區,明義里,1495,1159,500,224,724,48,772
公投第１１案,高雄市,前鎮區,仁愛里,1496,1314,522,200,722,46,768
公投第１１案,高雄市,前鎮區,德昌里,1497,896,386,165,551,23,574
公投第１１案,高雄市,前鎮區,德昌里,1498,1002,395,175,570,34,604
公投第１１案,高雄市,前鎮區,平等里,1499,2765,724,317,1041,63,1104
公投第１１案,高雄市,前鎮區,平昌里,1500,600,258,95,353,35,388
公投第１１案,高雄市,前鎮區,明禮里,1501,1466,409,159,568,30,598
公投第１１案,高雄市,前鎮區,信義里,1502,1449,602,236,838,39,877
公投第１１案,高雄市,前鎮區,信德里,1503,991,388,146,534,34,568
公投第１１案,高雄市,前鎮區,信德里,1504,1248,531,194,725,45,770
公投第１１案,高雄市,前鎮區,明道里,1505,1066,449,185,634,59,693
公投第１１案,高雄市,前鎮區,興化里,1506,706,288,109,397,27,424
公投第１１案,高雄市,前鎮區,興仁里,1507,713,277,114,391,23,414
公投第１１案,高雄市,前鎮區,前鎮里,1508,1344,454,281,735,38,773
公投第１１案,高雄市,前鎮區,鎮東里,1509,856,351,160,511,32,543
公投第１１案,高雄市,前鎮區,鎮東里,1510,873,336,155,491,21,512
公投第１１案,高雄市,前鎮區,鎮榮里,1511,1114,444,179,623,30,653
公投第１１案,高雄市,前鎮區,鎮榮里,1512,1112,420,189,609,15,624
公投第１１案,高雄市,前鎮區,鎮昌里,1513,1044,390,187,577,43,620
公投第１１案,高雄市,前鎮區,鎮昌里,1514,940,326,174,500,28,528
公投第１１案,高雄市,前鎮區,鎮海里,1515,1342,467,218,685,40,725
公投第１１案,高雄市,前鎮區,鎮海里,1516,1402,592,295,887,46,933
公投第１１案,高雄市,前鎮區,鎮海里,1517,1320,506,283,789,30,819
公投第１１案,高雄市,前鎮區,鎮陽里,1518,958,388,164,552,27,579
公投第１１案,高雄市,前鎮區,興邦里,1519,1276,594,255,849,32,881
公投第１１案,高雄市,前鎮區,興邦里,1520,1459,619,260,879,40,919
公投第１１案,高雄市,前鎮區,鎮中里,1521,761,281,105,386,23,409
公投第１１案,高雄市,前鎮區,鎮北里,1522,1093,420,194,614,18,632
公投第１１案,高雄市,前鎮區,忠純里,1523,1521,715,217,932,35,967
公投第１１案,高雄市,前鎮區,忠純里,1524,1557,706,232,938,39,977
公投第１１案,高雄市,前鎮區,忠純里,1525,1821,685,283,968,23,991
公投第１１案,高雄市,前鎮區,忠誠里,1526,1066,568,150,718,19,737
公投第１１案,高雄市,前鎮區,忠誠里,1527,1046,496,168,664,17,681
公投第１１案,高雄市,前鎮區,西山里,1528,1709,645,321,966,47,1013
公投第１１案,高雄市,前鎮區,西山里,1529,1723,713,302,1015,49,1064
公投第１１案,高雄市,前鎮區,民權里,1530,1202,508,265,773,21,794
公投第１１案,高雄市,前鎮區,民權里,1531,1279,572,274,846,34,880
公投第１１案,高雄市,前鎮區,民權里,1532,1513,638,313,951,29,980
公投第１１案,高雄市,前鎮區,建隆里,1533,1260,506,234,740,21,761
公投第１１案,高雄市,前鎮區,振興里,1534,1139,493,231,724,40,764
公投第１１案,高雄市,前鎮區,振興里,1535,1140,495,238,733,34,767
公投第１１案,高雄市,前鎮區,良和里,1536,1462,605,281,886,44,930
公投第１１案,高雄市,前鎮區,良和里,1537,1359,574,253,827,26,853
公投第１１案,高雄市,前鎮區,西甲里,1538,2037,715,321,1036,54,1090
公投第１１案,高雄市,前鎮區,盛興里,1539,1410,534,257,791,31,822
公投第１１案,高雄市,前鎮區,盛興里,1540,1307,512,236,748,23,771
公投第１１案,高雄市,前鎮區,盛豐里,1541,1512,560,265,825,56,881
公投第１１案,高雄市,前鎮區,盛豐里,1542,1491,564,300,864,52,916
公投第１１案,高雄市,前鎮區,興中里,1543,1621,665,254,919,38,957
公投第１１案,高雄市,前鎮區,興中里,1544,1522,546,240,786,32,818
公投第１１案,高雄市,前鎮區,興東里,1545,1593,617,307,924,45,969
公投第１１案,高雄市,前鎮區,興東里,1546,1885,770,353,1123,48,1171
公投第１１案,高雄市,前鎮區,興東里,1547,1870,724,376,1100,66,1166
公投第１１案,高雄市,前鎮區,忠孝里,1548,1388,572,258,830,31,861
公投第１１案,高雄市,前鎮區,忠孝里,1549,1348,552,253,805,38,843
公投第１１案,高雄市,前鎮區,復國里,1550,1341,528,189,717,61,778
公投第１１案,高雄市,前鎮區,復國里,1551,1364,597,268,865,29,894
公投第１１案,高雄市,前鎮區,竹內里,1552,1367,546,253,799,41,840
公投第１１案,高雄市,前鎮區,竹內里,1553,1326,526,234,760,41,801
公投第１１案,高雄市,前鎮區,竹東里,1554,1059,435,173,608,30,638
公投第１１案,高雄市,前鎮區,竹東里,1555,1119,458,227,685,16,701
公投第１１案,高雄市,前鎮區,竹南里,1556,1565,564,312,876,32,908
公投第１１案,高雄市,前鎮區,竹南里,1557,1549,638,253,891,37,928
公投第１１案,高雄市,前鎮區,竹南里,1558,1691,718,362,1080,20,1100
公投第１１案,高雄市,前鎮區,竹南里,1559,1837,711,350,1061,16,1077
公投第１１案,高雄市,前鎮區,竹北里,1560,1092,493,203,696,16,712
公投第１１案,高雄市,前鎮區,竹北里,1561,1126,470,203,673,37,710
公投第１１案,高雄市,前鎮區,竹西里,1562,1215,452,213,665,48,713
公投第１１案,高雄市,前鎮區,竹西里,1563,1443,586,292,878,21,899
公投第１１案,高雄市,前鎮區,竹西里,1564,1448,669,315,984,19,1003
公投第１１案,高雄市,前鎮區,竹中里,1565,1648,656,317,973,43,1016
公投第１１案,高雄市,前鎮區,竹中里,1566,1603,593,284,877,39,916
公投第１１案,高雄市,前鎮區,瑞竹里,1567,1596,551,262,813,22,835
公投第１１案,高雄市,前鎮區,瑞南里,1568,1450,564,215,779,33,812
公投第１１案,高雄市,前鎮區,瑞南里,1569,1510,556,263,819,42,861
公投第１１案,高雄市,前鎮區,瑞南里,1570,1647,690,314,1004,43,1047
公投第１１案,高雄市,前鎮區,瑞豐里,1571,1342,552,206,758,35,793
公投第１１案,高雄市,前鎮區,瑞豐里,1572,1384,536,228,764,28,792
公投第１１案,高雄市,前鎮區,瑞祥里,1573,1479,601,231,832,39,871
公投第１１案,高雄市,前鎮區,瑞祥里,1574,1546,645,273,918,20,938
公投第１１案,高雄市,前鎮區,瑞祥里,1575,1595,598,349,947,30,977
公投第１１案,高雄市,前鎮區,瑞東里,1576,1201,507,206,713,38,751
公投第１１案,高雄市,前鎮區,瑞東里,1577,1082,448,141,589,33,622
公投第１１案,高雄市,前鎮區,瑞和里,1578,996,384,156,540,33,573
公投第１１案,高雄市,前鎮區,瑞和里,1579,932,410,159,569,25,594
公投第１１案,高雄市,前鎮區,瑞平里,1580,1146,453,207,660,38,698
公投第１１案,高雄市,前鎮區,瑞平里,1581,1096,461,199,660,22,682
公投第１１案,高雄市,前鎮區,瑞平里,1582,1332,582,285,867,15,882
公投第１１案,高雄市,前鎮區,瑞隆里,1583,1175,467,233,700,21,721
公投第１１案,高雄市,前鎮區,瑞隆里,1584,986,389,172,561,45,606
公投第１１案,高雄市,前鎮區,瑞隆里,1585,1316,542,235,777,49,826
公投第１１案,高雄市,前鎮區,瑞北里,1586,1559,532,275,807,46,853
公投第１１案,高雄市,前鎮區,瑞北里,1587,1622,671,293,964,40,1004
公投第１１案,高雄市,前鎮區,瑞西里,1588,1310,516,212,728,26,754
公投第１１案,高雄市,前鎮區,瑞西里,1589,1299,571,224,795,36,831
公投第１１案,高雄市,前鎮區,瑞崗里,1590,1191,542,225,767,36,803
公投第１１案,高雄市,前鎮區,瑞崗里,1591,1375,566,217,783,24,807
公投第１１案,高雄市,前鎮區,瑞興里,1592,1338,566,218,784,28,812
公投第１１案,高雄市,前鎮區,瑞興里,1593,1175,445,226,671,24,695
公投第１１案,高雄市,前鎮區,瑞誠里,1594,1357,520,252,772,18,790
公投第１１案,高雄市,前鎮區,瑞誠里,1595,1187,508,237,745,49,794
公投第１１案,高雄市,前鎮區,瑞文里,1596,1164,504,180,684,30,714
公投第１１案,高雄市,前鎮區,瑞文里,1597,1219,510,224,734,48,782
公投第１１案,高雄市,前鎮區,瑞華里,1598,1428,564,251,815,14,829
公投第１１案,高雄市,前鎮區,瑞華里,1599,1495,557,282,839,53,892
公投第１１案,高雄市,前鎮區,瑞華里,1600,1531,584,357,941,32,973
公投第１１案,高雄市,前鎮區,瑞昌里,1601,1509,587,278,865,37,902
公投第１１案,高雄市,前鎮區,瑞昌里,1602,1591,622,265,887,44,931
公投第１１案,高雄市,小港區,小港里,1603,1108,485,221,706,22,728
公投第１１案,高雄市,小港區,小港里,1604,1171,506,186,692,46,738
公投第１１案,高雄市,小港區,港口里,1605,1557,600,361,961,22,983
公投第１１案,高雄市,小港區,港口里,1606,1668,613,284,897,24,921
公投第１１案,高雄市,小港區,港正里,1607,1183,557,193,750,27,777
公投第１１案,高雄市,小港區,港正里,1608,1372,553,243,796,34,830
公投第１１案,高雄市,小港區,港墘里,1609,1737,712,312,1024,48,1072
公投第１１案,高雄市,小港區,港明里,1610,1586,484,277,761,42,803
公投第１１案,高雄市,小港區,港明里,1611,1558,597,224,821,35,856
公投第１１案,高雄市,小港區,港后里,1612,1284,586,243,829,33,862
公投第１１案,高雄市,小港區,港后里,1613,1249,514,229,743,38,781
公投第１１案,高雄市,小港區,港南里,1614,2400,747,346,1093,44,1137
公投第１１案,高雄市,小港區,港興里,1615,1181,541,208,749,25,774
公投第１１案,高雄市,小港區,港興里,1616,1079,472,180,652,27,679
公投第１１案,高雄市,小港區,鳳宮里,1617,1335,483,286,769,25,794
公投第１１案,高雄市,小港區,鳳宮里,1618,1241,491,230,721,47,768
公投第１１案,高雄市,小港區,店鎮里,1619,1513,572,265,837,46,883
公投第１１案,高雄市,小港區,店鎮里,1620,1349,561,256,817,36,853
公投第１１案,高雄市,小港區,店鎮里,1621,1483,565,266,831,37,868
公投第１１案,高雄市,小港區,店鎮里,1622,1451,580,277,857,21,878
公投第１１案,高雄市,小港區,大苓里,1623,1241,465,219,684,19,703
公投第１１案,高雄市,小港區,大苓里,1624,1262,551,257,808,42,850
公投第１１案,高雄市,小港區,二苓里,1625,1813,765,303,1068,42,1110
公投第１１案,高雄市,小港區,二苓里,1626,1877,688,303,991,27,1018
公投第１１案,高雄市,小港區,三苓里,1627,1391,533,271,804,17,821
公投第１１案,高雄市,小港區,三苓里,1628,1453,517,384,901,21,922
公投第１１案,高雄市,小港區,正苓里,1629,1374,552,244,796,22,818
公投第１１案,高雄市,小港區,正苓里,1630,1348,553,231,784,25,809
公投第１１案,高雄市,小港區,正苓里,1631,1334,562,246,808,33,841
公投第１１案,高雄市,小港區,順苓里,1632,1433,542,292,834,19,853
公投第１１案,高雄市,小港區,順苓里,1633,1448,524,267,791,23,814
公投第１１案,高雄市,小港區,順苓里,1634,1488,606,306,912,51,963
公投第１１案,高雄市,小港區,六苓里,1635,1278,535,228,763,36,799
公投第１１案,高雄市,小港區,六苓里,1636,1306,561,313,874,30,904
公投第１１案,高雄市,小港區,宏亮里,1637,1625,636,301,937,53,990
公投第１１案,高雄市,小港區,宏亮里,1638,1640,683,324,1007,45,1052
公投第１１案,高雄市,小港區,山東里,1639,1506,604,248,852,38,890
公投第１１案,高雄市,小港區,山東里,1640,1438,531,236,767,41,808
公投第１１案,高雄市,小港區,青島里,1641,1105,519,188,707,40,747
公投第１１案,高雄市,小港區,青島里,1642,1167,474,185,659,14,673
公投第１１案,高雄市,小港區,濟南里,1643,1420,610,258,868,27,895
公投第１１案,高雄市,小港區,濟南里,1644,1380,567,299,866,45,911
公投第１１案,高雄市,小港區,濟南里,1645,1239,507,210,717,23,740
公投第１１案,高雄市,小港區,泰山里,1646,1563,640,293,933,42,975
公投第１１案,高雄市,小港區,泰山里,1647,1644,655,296,951,41,992
公投第１１案,高雄市,小港區,山明里,1648,1895,756,297,1053,54,1107
公投第１１案,高雄市,小港區,山明里,1649,1748,657,295,952,61,1013
公投第１１案,高雄市,小港區,山明里,1650,1579,625,296,921,54,975
公投第１１案,高雄市,小港區,山明里,1651,2135,808,366,1174,26,1200
公投第１１案,高雄市,小港區,山明里,1652,1728,685,300,985,40,1025
公投第１１案,高雄市,小港區,山明里,1653,2022,722,343,1065,48,1113
公投第１１案,高雄市,小港區,高松里,1654,1329,495,183,678,19,697
公投第１１案,高雄市,小港區,高松里,1655,1320,563,219,782,21,803
公投第１１案,高雄市,小港區,高松里,1656,1267,520,218,738,50,788
公投第１１案,高雄市,小港區,松金里,1657,1298,544,239,783,47,830
公投第１１案,高雄市,小港區,松金里,1658,1289,548,271,819,13,832
公投第１１案,高雄市,小港區,松山里,1659,1534,660,280,940,31,971
公投第１１案,高雄市,小港區,松山里,1660,1494,642,255,897,25,922
公投第１１案,高雄市,小港區,大坪里,1661,1377,584,219,803,52,855
公投第１１案,高雄市,小港區,大坪里,1662,1344,570,267,837,33,870
公投第１１案,高雄市,小港區,坪頂里,1663,1508,596,265,861,42,903
公投第１１案,高雄市,小港區,坪頂里,1664,1400,527,249,776,21,797
公投第１１案,高雄市,小港區,坪頂里,1665,1457,597,262,859,42,901
公投第１１案,高雄市,小港區,坪頂里,1666,1392,545,214,759,28,787
公投第１１案,高雄市,小港區,孔宅里,1667,1983,729,340,1069,41,1110
公投第１１案,高雄市,小港區,孔宅里,1668,1204,485,224,709,15,724
公投第１１案,高雄市,小港區,孔宅里,1669,1300,691,49,740,27,767
公投第１１案,高雄市,小港區,廈莊里,1670,1857,786,318,1104,61,1165
公投第１１案,高雄市,小港區,廈莊里,1671,1566,610,272,882,29,911
公投第１１案,高雄市,小港區,合作里,1672,1343,678,165,843,43,886
公投第１１案,高雄市,小港區,合作里,1673,1236,535,227,762,58,820
公投第１１案,高雄市,小港區,桂林里,1674,1564,666,285,951,53,1004
公投第１１案,高雄市,小港區,桂林里,1675,1484,570,397,967,26,993
公投第１１案,高雄市,小港區,桂林里,1676,1477,608,268,876,17,893
公投第１１案,高雄市,小港區,桂林里,1677,1482,561,333,894,34,928
公投第１１案,高雄市,小港區,桂林里,1678,1708,633,291,924,26,950
公投第１１案,高雄市,小港區,中厝里,1679,1867,590,337,927,49,976
公投第１１案,高雄市,小港區,中厝里,1680,1709,645,300,945,31,976
公投第１１案,高雄市,小港區,鳳鳴里,1681,1425,517,222,739,47,786
公投第１１案,高雄市,小港區,鳳鳴里,1682,1696,565,238,803,38,841
公投第１１案,高雄市,小港區,龍鳳里,1683,1522,498,253,751,36,787
公投第１１案,高雄市,小港區,龍鳳里,1684,1531,582,255,837,67,904
公投第１１案,高雄市,小港區,鳳森里,1685,2215,811,355,1166,73,1239
公投第１１案,高雄市,小港區,鳳林里,1686,1515,645,248,893,25,918
公投第１１案,高雄市,小港區,鳳林里,1687,1535,572,268,840,24,864
公投第１１案,高雄市,小港區,鳳興里,1688,1276,484,222,706,25,731
公投第１１案,高雄市,小港區,鳳興里,1689,1217,512,108,620,39,659
公投第１１案,高雄市,小港區,鳳源里,1690,1707,574,243,817,58,875
公投第１１案,高雄市,小港區,鳳源里,1691,1920,681,293,974,61,1035
公投第１１案,高雄市,大寮區,拷潭里,1692,727,253,121,374,18,392
公投第１１案,高雄市,大寮區,拷潭里,1693,718,238,121,359,13,372
公投第１１案,高雄市,大寮區,內坑里,1694,1340,494,199,693,38,731
公投第１１案,高雄市,大寮區,內坑里,1695,1575,498,226,724,32,756
公投第１１案,高雄市,大寮區,內坑里,1696,444,174,75,249,16,265
公投第１１案,高雄市,大寮區,內坑里,1697,2374,833,188,1021,188,1209
公投第１１案,高雄市,大寮區,大寮里,1698,1291,478,211,689,54,743
公投第１１案,高雄市,大寮區,大寮里,1699,1400,534,221,755,66,821
公投第１１案,高雄市,大寮區,大寮里,1700,1390,533,230,763,27,790
公投第１１案,高雄市,大寮區,大寮里,1701,1401,495,225,720,65,785
公投第１１案,高雄市,大寮區,大寮里,1702,1199,425,175,600,37,637
公投第１１案,高雄市,大寮區,上寮里,1703,1210,402,209,611,23,634
公投第１１案,高雄市,大寮區,上寮里,1704,1195,439,198,637,38,675
公投第１１案,高雄市,大寮區,三隆里,1705,1166,450,218,668,23,691
公投第１１案,高雄市,大寮區,三隆里,1706,1353,536,224,760,27,787
公投第１１案,高雄市,大寮區,三隆里,1707,1052,402,197,599,50,649
公投第１１案,高雄市,大寮區,三隆里,1708,1024,347,159,506,21,527
公投第１１案,高雄市,大寮區,琉球里,1709,1189,516,183,699,20,719
公投第１１案,高雄市,大寮區,琉球里,1710,1512,613,252,865,51,916
公投第１１案,高雄市,大寮區,琉球里,1711,1633,583,247,830,53,883
公投第１１案,高雄市,大寮區,翁園里,1712,1214,532,205,737,39,776
公投第１１案,高雄市,大寮區,翁園里,1713,1258,561,233,794,48,842
公投第１１案,高雄市,大寮區,翁園里,1714,1323,602,235,837,23,860
公投第１１案,高雄市,大寮區,前庄里,1715,1253,550,205,755,27,782
公投第１１案,高雄市,大寮區,前庄里,1716,1035,437,177,614,47,661
公投第１１案,高雄市,大寮區,中庄里,1717,1106,460,168,628,25,653
公投第１１案,高雄市,大寮區,中庄里,1718,1195,483,182,665,24,689
公投第１１案,高雄市,大寮區,中庄里,1719,1051,469,185,654,20,674
公投第１１案,高雄市,大寮區,中庄里,1720,1425,543,252,795,65,860
公投第１１案,高雄市,大寮區,中庄里,1721,1635,616,259,875,43,918
公投第１１案,高雄市,大寮區,中庄里,1722,1359,551,223,774,40,814
公投第１１案,高雄市,大寮區,中庄里,1723,1361,552,216,768,47,815
公投第１１案,高雄市,大寮區,中庄里,1724,1629,642,269,911,29,940
公投第１１案,高雄市,大寮區,後庄里,1725,1518,648,209,857,32,889
公投第１１案,高雄市,大寮區,後庄里,1726,1620,626,227,853,41,894
公投第１１案,高雄市,大寮區,後庄里,1727,1648,636,253,889,16,905
公投第１１案,高雄市,大寮區,後庄里,1728,1385,562,231,793,40,833
公投第１１案,高雄市,大寮區,後庄里,1729,1435,540,239,779,26,805
公投第１１案,高雄市,大寮區,義仁里,1730,1046,430,163,593,23,616
公投第１１案,高雄市,大寮區,義仁里,1731,789,291,112,403,26,429
公投第１１案,高雄市,大寮區,新厝里,1732,909,310,162,472,21,493
公投第１１案,高雄市,大寮區,新厝里,1733,733,268,146,414,28,442
公投第１１案,高雄市,大寮區,過溪里,1734,1553,564,272,836,45,881
公投第１１案,高雄市,大寮區,過溪里,1735,922,346,155,501,27,528
公投第１１案,高雄市,大寮區,潮寮里,1736,1012,403,152,555,41,596
公投第１１案,高雄市,大寮區,潮寮里,1737,968,365,153,518,32,550
公投第１１案,高雄市,大寮區,潮寮里,1738,1021,454,155,609,19,628
公投第１１案,高雄市,大寮區,會結里,1739,1554,520,195,715,57,772
公投第１１案,高雄市,大寮區,會社里,1740,1120,458,200,658,41,699
公投第１１案,高雄市,大寮區,會社里,1741,1225,505,225,730,31,761
公投第１１案,高雄市,大寮區,會社里,1742,1320,353,143,496,19,515
公投第１１案,高雄市,大寮區,會社里,1743,1317,480,243,723,43,766
公投第１１案,高雄市,大寮區,會社里,1744,1119,404,209,613,21,634
公投第１１案,高雄市,大寮區,山頂里,1745,1190,480,219,699,31,730
公投第１１案,高雄市,大寮區,山頂里,1746,1229,511,221,732,27,759
公投第１１案,高雄市,大寮區,山頂里,1747,1178,523,206,729,28,757
公投第１１案,高雄市,大寮區,山頂里,1748,1272,515,253,768,30,798
公投第１１案,高雄市,大寮區,山頂里,1749,1413,542,240,782,27,809
公投第１１案,高雄市,大寮區,山頂里,1750,1185,514,183,697,44,741
公投第１１案,高雄市,大寮區,忠義里,1751,553,247,77,324,6,330
公投第１１案,高雄市,大寮區,永芳里,1752,1121,397,183,580,51,631
公投第１１案,高雄市,大寮區,永芳里,1753,1227,460,235,695,35,730
公投第１１案,高雄市,大寮區,永芳里,1754,1058,467,217,684,37,721
公投第１１案,高雄市,大寮區,永芳里,1755,1209,459,218,677,19,696
公投第１１案,高雄市,大寮區,永芳里,1756,1100,475,187,662,21,683
公投第１１案,高雄市,大寮區,永芳里,1757,1122,419,192,611,20,631
公投第１１案,高雄市,大寮區,義和里,1758,983,422,181,603,43,646
公投第１１案,高雄市,大寮區,義和里,1759,1192,476,155,631,13,644
公投第１１案,高雄市,大寮區,溪寮里,1760,719,320,120,440,22,462
公投第１１案,高雄市,大寮區,溪寮里,1761,829,335,161,496,29,525
公投第１１案,高雄市,大寮區,江山里,1762,771,383,118,501,32,533
公投第１１案,高雄市,大寮區,江山里,1763,1075,451,202,653,33,686
公投第１１案,高雄市,大寮區,昭明里,1764,1280,532,199,731,68,799
公投第１１案,高雄市,大寮區,昭明里,1765,1179,460,192,652,49,701
公投第１１案,高雄市,大寮區,昭明里,1766,1210,474,199,673,27,700
公投第１１案,高雄市,大寮區,光武里,1767,189,91,24,115,5,120
公投第１１案,高雄市,大寮區,中興里,1768,1228,517,197,714,42,756
公投第１１案,高雄市,大寮區,中興里,1769,1170,498,165,663,26,689
公投第１１案,高雄市,大寮區,中興里,1770,1416,623,228,851,31,882
公投第１１案,高雄市,大寮區,中興里,1771,1482,619,265,884,23,907
公投第１１案,高雄市,大寮區,中興里,1772,1478,553,233,786,37,823
公投第１１案,高雄市,林園區,東林里,1773,1262,508,221,729,46,775
公投第１１案,高雄市,林園區,東林里,1774,1562,544,261,805,50,855
公投第１１案,高雄市,林園區,林園里,1775,1078,430,188,618,24,642
公投第１１案,高雄市,林園區,林園里,1776,979,394,193,587,42,629
公投第１１案,高雄市,林園區,林園里,1777,1195,467,90,557,34,591
公投第１１案,高雄市,林園區,溪州里,1778,1380,506,209,715,43,758
公投第１１案,高雄市,林園區,溪州里,1779,1280,570,115,685,47,732
公投第１１案,高雄市,林園區,溪州里,1780,1269,467,212,679,26,705
公投第１１案,高雄市,林園區,潭頭里,1781,1568,456,232,688,20,708
公投第１１案,高雄市,林園區,潭頭里,1782,1226,450,244,694,43,737
公投第１１案,高雄市,林園區,中厝里,1783,1480,560,229,789,35,824
公投第１１案,高雄市,林園區,中厝里,1784,1459,586,232,818,45,863
公投第１１案,高雄市,林園區,中門里,1785,1593,606,261,867,37,904
公投第１１案,高雄市,林園區,中門里,1786,895,320,150,470,78,548
公投第１１案,高雄市,林園區,頂厝里,1787,1110,400,158,558,20,578
公投第１１案,高雄市,林園區,頂厝里,1788,1348,461,226,687,45,732
公投第１１案,高雄市,林園區,頂厝里,1789,912,348,159,507,43,550
公投第１１案,高雄市,林園區,頂厝里,1790,1085,366,298,664,40,704
公投第１１案,高雄市,林園區,港埔里,1791,955,382,153,535,25,560
公投第１１案,高雄市,林園區,港埔里,1792,879,379,136,515,39,554
公投第１１案,高雄市,林園區,西溪里,1793,1103,395,190,585,65,650
公投第１１案,高雄市,林園區,西溪里,1794,1054,452,186,638,48,686
公投第１１案,高雄市,林園區,西溪里,1795,1292,446,205,651,18,669
公投第１１案,高雄市,林園區,港嘴里,1796,1683,557,264,821,17,838
公投第１１案,高雄市,林園區,北汕里,1797,607,246,84,330,24,354
公投第１１案,高雄市,林園區,北汕里,1798,1012,384,157,541,55,596
公投第１１案,高雄市,林園區,林內里,1799,1046,402,186,588,31,619
公投第１１案,高雄市,林園區,林內里,1800,914,314,115,429,20,449
公投第１１案,高雄市,林園區,王公里,1801,1405,542,263,805,32,837
公投第１１案,高雄市,林園區,王公里,1802,1299,503,258,761,37,798
公投第１１案,高雄市,林園區,王公里,1803,1170,69,190,259,27,286
公投第１１案,高雄市,林園區,林家里,1804,1299,398,219,617,21,638
公投第１１案,高雄市,林園區,龔厝里,1805,1031,395,181,576,23,599
公投第１１案,高雄市,林園區,龔厝里,1806,849,328,123,451,22,473
公投第１１案,高雄市,林園區,鳳芸里,1807,838,304,139,443,50,493
公投第１１案,高雄市,林園區,鳳芸里,1808,938,376,173,549,16,565
公投第１１案,高雄市,林園區,中芸里,1809,1051,411,149,560,19,579
公投第１１案,高雄市,林園區,中芸里,1810,786,308,145,453,31,484
公投第１１案,高雄市,林園區,東汕里,1811,894,371,144,515,48,563
公投第１１案,高雄市,林園區,西汕里,1812,749,229,99,328,14,342
公投第１１案,高雄市,林園區,仁愛里,1813,1485,606,268,874,25,899
公投第１１案,高雄市,林園區,仁愛里,1814,1478,600,261,861,55,916
公投第１１案,高雄市,林園區,文賢里,1815,1345,521,295,816,38,854
公投第１１案,高雄市,林園區,文賢里,1816,1038,364,184,548,31,579
公投第１１案,高雄市,林園區,廣應里,1817,1203,461,218,679,22,701
公投第１１案,高雄市,林園區,廣應里,1818,1138,348,296,644,18,662
公投第１１案,高雄市,林園區,廣應里,1819,1025,385,128,513,17,530
公投第１１案,高雄市,林園區,五福里,1820,1341,507,219,726,62,788
公投第１１案,高雄市,林園區,五福里,1821,1218,404,173,577,16,593
公投第１１案,高雄市,林園區,中汕里,1822,1147,405,140,545,12,557
公投第１１案,高雄市,林園區,中汕里,1823,1176,419,143,562,32,594
公投第１１案,新北市,石門區,德茂里,1,1121,334,211,545,38,583
公投第１１案,新北市,石門區,富基里,2,1389,412,217,629,41,670
公投第１１案,新北市,石門區,老梅里,3,933,318,138,456,39,495
公投第１１案,新北市,石門區,老梅里,4,1244,389,183,572,48,620
公投第１１案,新北市,石門區,山溪里,5,883,285,160,445,43,488
公投第１１案,新北市,石門區,石門里,6,1564,541,257,798,50,848
公投第１１案,新北市,石門區,尖鹿里,7,1500,497,263,760,39,799
公投第１１案,新北市,石門區,乾華里,8,328,100,44,144,7,151
公投第１１案,新北市,石門區,茂林里,9,651,260,107,367,35,402
公投第１１案,新北市,石門區,草里里,10,915,257,121,378,34,412
公投第１１案,新北市,三芝區,八賢里,11,312,98,44,142,9,151
公投第１１案,新北市,三芝區,埔頭里,12,1421,453,221,674,37,711
公投第１１案,新北市,三芝區,埔頭里,13,1557,488,276,764,38,802
公投第１１案,新北市,三芝區,埔頭里,14,1828,578,312,890,51,941
公投第１１案,新北市,三芝區,古庄里,15,1060,320,178,498,38,536
公投第１１案,新北市,三芝區,新庄里,16,819,219,106,325,33,358
公投第１１案,新北市,三芝區,埔坪里,17,1701,454,246,700,26,726
公投第１１案,新北市,三芝區,埔坪里,18,1740,520,271,791,49,840
公投第１１案,新北市,三芝區,埔坪里,19,1451,425,233,658,25,683
公投第１１案,新北市,三芝區,埔坪里,20,1248,355,180,535,41,576
公投第１１案,新北市,三芝區,茂長里,21,629,202,115,317,16,333
公投第１１案,新北市,三芝區,橫山里,22,504,159,60,219,15,234
公投第１１案,新北市,三芝區,錫板里,23,698,221,92,313,15,328
公投第１１案,新北市,三芝區,後厝里,24,2069,632,304,936,42,978
公投第１１案,新北市,三芝區,福德里,25,784,229,158,387,30,417
公投第１１案,新北市,三芝區,圓山里,26,522,151,90,241,22,263
公投第１１案,新北市,三芝區,店子里,27,587,186,90,276,33,309
公投第１１案,新北市,三芝區,興華里,28,1189,322,247,569,52,621
公投第１１案,新北市,淡水區,中和里,29,544,176,91,267,25,292
公投第１１案,新北市,淡水區,屯山里,30,1044,371,177,548,35,583
公投第１１案,新北市,淡水區,賢孝里,31,1462,484,208,692,45,737
公投第１１案,新北市,淡水區,興仁里,32,1525,486,254,740,58,798
公投第１１案,新北市,淡水區,蕃薯里,33,986,320,131,451,29,480
公投第１１案,新北市,淡水區,忠山里,34,806,304,136,440,20,460
公投第１１案,新北市,淡水區,義山里,35,1173,419,165,584,72,656
公投第１１案,新北市,淡水區,義山里,36,1343,442,177,619,31,650
公投第１１案,新北市,淡水區,水源里,37,1153,319,193,512,13,525
公投第１１案,新北市,淡水區,水源里,38,874,293,129,422,29,451
公投第１１案,新北市,淡水區,忠寮里,39,1063,381,155,536,55,591
公投第１１案,新北市,淡水區,樹興里,40,1309,455,188,643,22,665
公投第１１案,新北市,淡水區,坪頂里,41,1290,426,231,657,36,693
公投第１１案,新北市,淡水區,福德里,42,1675,631,304,935,20,955
公投第１１案,新北市,淡水區,福德里,43,1589,549,298,847,34,881
公投第１１案,新北市,淡水區,福德里,44,1624,571,342,913,27,940
公投第１１案,新北市,淡水區,福德里,45,1241,380,252,632,32,664
公投第１１案,新北市,淡水區,竹圍里,46,1317,466,215,681,34,715
公投第１１案,新北市,淡水區,竹圍里,47,1225,476,226,702,18,720
公投第１１案,新北市,淡水區,竹圍里,48,1426,463,273,736,42,778
公投第１１案,新北市,淡水區,竹圍里,49,1610,561,332,893,29,922
公投第１１案,新北市,淡水區,民權里,50,1982,666,407,1073,33,1106
公投第１１案,新北市,淡水區,民權里,51,1924,565,313,878,28,906
公投第１１案,新北市,淡水區,民生里,52,1822,563,324,887,26,913
公投第１１案,新北市,淡水區,民生里,53,1232,419,272,691,45,736
公投第１１案,新北市,淡水區,民生里,54,1588,593,277,870,39,909
公投第１１案,新北市,淡水區,民生里,55,1784,573,302,875,27,902
公投第１１案,新北市,淡水區,八勢里,56,1762,536,338,874,54,928
公投第１１案,新北市,淡水區,八勢里,57,1546,484,320,804,28,832
公投第１１案,新北市,淡水區,八勢里,58,1897,601,382,983,25,1008
公投第１１案,新北市,淡水區,竿蓁里,59,1489,484,287,771,27,798
公投第１１案,新北市,淡水區,竿蓁里,60,1679,552,294,846,23,869
公投第１１案,新北市,淡水區,竿蓁里,61,1693,515,304,819,29,848
公投第１１案,新北市,淡水區,竿蓁里,62,1674,591,245,836,14,850
公投第１１案,新北市,淡水區,竿蓁里,63,1330,468,246,714,13,727
公投第１１案,新北市,淡水區,竿蓁里,64,1467,475,267,742,24,766
公投第１１案,新北市,淡水區,崁頂里,65,1837,654,296,950,29,979
公投第１１案,新北市,淡水區,崁頂里,66,1924,396,241,637,14,651
公投第１１案,新北市,淡水區,崁頂里,67,2340,756,395,1151,26,1177
公投第１１案,新北市,淡水區,崁頂里,68,1704,545,226,771,29,800
公投第１１案,新北市,淡水區,崁頂里,69,1363,436,254,690,31,721
公投第１１案,新北市,淡水區,崁頂里,70,3068,908,483,1391,26,1417
公投第１１案,新北市,淡水區,埤島里,71,1528,500,234,734,34,768
公投第１１案,新北市,淡水區,水碓里,72,1600,524,283,807,31,838
公投第１１案,新北市,淡水區,水碓里,73,1874,678,331,1009,46,1055
公投第１１案,新北市,淡水區,水碓里,74,1567,519,279,798,37,835
公投第１１案,新北市,淡水區,北新里,75,1245,398,275,673,31,704
公投第１１案,新北市,淡水區,北新里,76,1211,381,240,621,16,637
公投第１１案,新北市,淡水區,正德里,77,1992,706,383,1089,25,1114
公投第１１案,新北市,淡水區,正德里,78,2028,740,372,1112,20,1132
公投第１１案,新北市,淡水區,新興里,79,1373,517,223,740,41,781
公投第１１案,新北市,淡水區,新興里,80,1732,576,345,921,19,940
公投第１１案,新北市,淡水區,新興里,81,1519,455,285,740,29,769
公投第１１案,新北市,淡水區,新興里,82,1727,542,283,825,18,843
公投第１１案,新北市,淡水區,新義里,83,1297,477,237,714,21,735
公投第１１案,新北市,淡水區,新義里,84,1066,358,177,535,39,574
公投第１１案,新北市,淡水區,新義里,85,1387,512,237,749,37,786
公投第１１案,新北市,淡水區,新春里,86,1909,680,327,1007,37,1044
公投第１１案,新北市,淡水區,新春里,87,1770,588,336,924,33,957
公投第１１案,新北市,淡水區,新春里,88,2049,645,324,969,28,997
公投第１１案,新北市,淡水區,新春里,89,1680,554,326,880,28,908
公投第１１案,新北市,淡水區,新民里,90,1433,506,301,807,42,849
公投第１１案,新北市,淡水區,新民里,91,1365,443,267,710,24,734
公投第１１案,新北市,淡水區,新民里,92,1452,619,144,763,39,802
公投第１１案,新北市,淡水區,北投里,93,1804,616,307,923,37,960
公投第１１案,新北市,淡水區,北投里,94,1322,460,236,696,31,727
公投第１１案,新北市,淡水區,北投里,95,2019,663,393,1056,27,1083
公投第１１案,新北市,淡水區,北投里,96,1696,706,335,1041,31,1072
公投第１１案,新北市,淡水區,北投里,97,1576,558,299,857,23,880
公投第１１案,新北市,淡水區,鄧公里,98,1781,615,364,979,29,1008
公投第１１案,新北市,淡水區,鄧公里,99,1665,580,350,930,44,974
公投第１１案,新北市,淡水區,鄧公里,100,2013,688,350,1038,39,1077
公投第１１案,新北市,淡水區,幸福里,101,1108,349,217,566,31,597
公投第１１案,新北市,淡水區,幸福里,102,1305,461,235,696,31,727
公投第１１案,新北市,淡水區,幸福里,103,1199,439,202,641,25,666
公投第１１案,新北市,淡水區,學府里,104,2017,675,364,1039,26,1065
公投第１１案,新北市,淡水區,學府里,105,2125,631,379,1010,35,1045
公投第１１案,新北市,淡水區,中興里,106,1289,385,213,598,16,614
公投第１１案,新北市,淡水區,中興里,107,1319,511,239,750,37,787
公投第１１案,新北市,淡水區,中興里,108,1051,411,186,597,22,619
公投第１１案,新北市,淡水區,長庚里,109,1348,485,241,726,17,743
公投第１１案,新北市,淡水區,清文里,110,1106,378,182,560,27,587
公投第１１案,新北市,淡水區,草東里,111,717,270,130,400,21,421
公投第１１案,新北市,淡水區,協元里,112,1385,444,285,729,21,750
公投第１１案,新北市,淡水區,永吉里,113,841,304,175,479,28,507
公投第１１案,新北市,淡水區,民安里,114,665,252,117,369,17,386
公投第１１案,新北市,淡水區,新生里,115,419,152,90,242,12,254
公投第１１案,新北市,淡水區,文化里,116,1599,591,283,874,27,901
公投第１１案,新北市,淡水區,油車里,117,1670,532,301,833,52,885
公投第１１案,新北市,淡水區,油車里,118,1683,592,328,920,36,956
公投第１１案,新北市,淡水區,油車里,119,1577,524,264,788,32,820
公投第１１案,新北市,淡水區,沙崙里,120,1618,528,256,784,33,817
公投第１１案,新北市,淡水區,沙崙里,121,2214,690,327,1017,33,1050
公投第１１案,新北市,淡水區,大庄里,122,1832,608,317,925,33,958
公投第１１案,新北市,淡水區,大庄里,123,2123,714,377,1091,33,1124
公投第１１案,新北市,淡水區,大庄里,124,2998,915,356,1271,23,1294
公投第１１案,新北市,八里區,龍源里,125,1498,450,241,691,55,746
公投第１１案,新北市,八里區,龍源里,126,1939,559,313,872,27,899
公投第１１案,新北市,八里區,龍源里,127,1516,541,238,779,29,808
公投第１１案,新北市,八里區,龍源里,128,1642,567,330,897,43,940
公投第１１案,新北市,八里區,米倉里,129,1927,544,340,884,60,944
公投第１１案,新北市,八里區,米倉里,130,1276,418,235,653,39,692
公投第１１案,新北市,八里區,大崁里,131,1349,518,239,757,35,792
公投第１１案,新北市,八里區,大崁里,132,1403,512,245,757,32,789
公投第１１案,新北市,八里區,埤頭里,133,1644,552,293,845,44,889
公投第１１案,新北市,八里區,埤頭里,134,1853,632,327,959,43,1002
公投第１１案,新北市,八里區,頂罟里,135,1793,676,317,993,53,1046
公投第１１案,新北市,八里區,舊城里,136,1644,573,282,855,30,885
公投第１１案,新北市,八里區,舊城里,137,1846,706,218,924,42,966
公投第１１案,新北市,八里區,舊城里,138,1346,416,263,679,43,722
公投第１１案,新北市,八里區,舊城里,139,1621,536,295,831,43,874
公投第１１案,新北市,八里區,訊塘里,140,2110,619,279,898,47,945
公投第１１案,新北市,八里區,訊塘里,141,1967,707,249,956,53,1009
公投第１１案,新北市,八里區,荖阡里,142,1626,553,289,842,53,895
公投第１１案,新北市,八里區,長坑里,143,1514,528,243,771,63,834
公投第１１案,新北市,八里區,下罟里,144,1456,510,270,780,56,836
公投第１１案,新北市,林口區,東林里,145,1268,414,225,639,47,686
公投第１１案,新北市,林口區,東林里,146,1171,342,234,576,31,607
公投第１１案,新北市,林口區,東林里,147,1218,433,230,663,33,696
公投第１１案,新北市,林口區,林口里,148,1788,570,310,880,34,914
公投第１１案,新北市,林口區,林口里,149,1625,501,288,789,49,838
公投第１１案,新北市,林口區,林口里,150,1448,421,280,701,58,759
公投第１１案,新北市,林口區,西林里,151,1328,446,194,640,48,688
公投第１１案,新北市,林口區,西林里,152,1523,447,221,668,41,709
公投第１１案,新北市,林口區,西林里,153,1245,435,220,655,30,685
公投第１１案,新北市,林口區,西林里,154,1329,523,280,803,29,832
公投第１１案,新北市,林口區,西林里,155,1465,539,296,835,23,858
公投第１１案,新北市,林口區,西林里,156,1369,479,306,785,22,807
公投第１１案,新北市,林口區,菁湖里,157,1346,486,268,754,35,789
公投第１１案,新北市,林口區,菁湖里,158,1181,403,201,604,45,649
公投第１１案,新北市,林口區,菁湖里,159,1291,543,225,768,32,800
公投第１１案,新北市,林口區,中湖里,160,1213,418,211,629,46,675
公投第１１案,新北市,林口區,中湖里,161,1256,468,240,708,27,735
公投第１１案,新北市,林口區,中湖里,162,1185,381,235,616,36,652
公投第１１案,新北市,林口區,湖北里,163,1361,485,239,724,43,767
公投第１１案,新北市,林口區,湖南里,164,1756,585,288,873,27,900
公投第１１案,新北市,林口區,湖南里,165,1676,565,278,843,20,863
公投第１１案,新北市,林口區,湖南里,166,1540,587,267,854,18,872
公投第１１案,新北市,林口區,湖南里,167,1569,529,287,816,35,851
公投第１１案,新北市,林口區,湖南里,168,1514,557,258,815,23,838
公投第１１案,新北市,林口區,湖南里,169,1193,399,282,681,11,692
公投第１１案,新北市,林口區,湖南里,170,1610,596,303,899,18,917
公投第１１案,新北市,林口區,湖南里,171,1338,468,289,757,22,779
公投第１１案,新北市,林口區,湖南里,172,1141,439,205,644,21,665
公投第１１案,新北市,林口區,湖南里,173,1307,459,252,711,29,740
公投第１１案,新北市,林口區,湖南里,174,1327,492,252,744,21,765
公投第１１案,新北市,林口區,湖南里,175,1285,468,258,726,19,745
公投第１１案,新北市,林口區,南勢里,176,1481,478,321,799,42,841
公投第１１案,新北市,林口區,南勢里,177,1510,532,328,860,13,873
公投第１１案,新北市,林口區,南勢里,178,1785,592,319,911,39,950
公投第１１案,新北市,林口區,南勢里,179,1792,592,355,947,19,966
公投第１１案,新北市,林口區,南勢里,180,1517,548,287,835,25,860
公投第１１案,新北市,林口區,南勢里,181,1564,579,298,877,20,897
公投第１１案,新北市,林口區,南勢里,182,1560,605,268,873,20,893
公投第１１案,新北市,林口區,南勢里,183,1544,494,317,811,28,839
公投第１１案,新北市,林口區,南勢里,184,1593,532,304,836,24,860
公投第１１案,新北市,林口區,南勢里,185,1431,492,290,782,23,805
公投第１１案,新北市,林口區,仁愛里,186,1571,505,310,815,30,845
公投第１１案,新北市,林口區,仁愛里,187,1439,499,317,816,19,835
公投第１１案,新北市,林口區,仁愛里,188,1451,518,301,819,23,842
公投第１１案,新北市,林口區,仁愛里,189,1391,497,319,816,26,842
公投第１１案,新北市,林口區,麗林里,190,1461,521,271,792,23,815
公投第１１案,新北市,林口區,麗林里,191,1691,552,347,899,19,918
公投第１１案,新北市,林口區,麗林里,192,1524,564,234,798,43,841
公投第１１案,新北市,林口區,麗林里,193,1343,530,282,812,28,840
公投第１１案,新北市,林口區,麗林里,194,1398,528,296,824,20,844
公投第１１案,新北市,林口區,東勢里,195,1380,506,287,793,24,817
公投第１１案,新北市,林口區,東勢里,196,1367,465,263,728,44,772
公投第１１案,新北市,林口區,東勢里,197,1350,475,270,745,33,778
公投第１１案,新北市,林口區,東勢里,198,1194,428,244,672,32,704
公投第１１案,新北市,林口區,麗園里,199,1344,450,247,697,40,737
公投第１１案,新北市,林口區,麗園里,200,1154,413,214,627,27,654
公投第１１案,新北市,林口區,麗園里,201,1119,445,231,676,22,698
公投第１１案,新北市,林口區,頂福里,202,1026,301,173,474,31,505
公投第１１案,新北市,林口區,下福里,203,1210,389,242,631,51,682
公投第１１案,新北市,林口區,嘉寶里,204,912,296,175,471,46,517
公投第１１案,新北市,林口區,瑞平里,205,824,267,189,456,26,482
公投第１１案,新北市,林口區,太平里,206,1411,489,282,771,63,834
公投第１１案,新北市,五股區,興珍里,207,1456,459,279,738,61,799
公投第１１案,新北市,五股區,興珍里,208,1482,490,268,758,29,787
公投第１１案,新北市,五股區,興珍里,209,1287,413,267,680,47,727
公投第１１案,新北市,五股區,更寮里,210,1106,355,212,567,20,587
公投第１１案,新北市,五股區,觀音里,211,1283,420,203,623,57,680
公投第１１案,新北市,五股區,集福里,212,1833,623,330,953,30,983
公投第１１案,新北市,五股區,集福里,213,1141,393,232,625,32,657
公投第１１案,新北市,五股區,集福里,214,463,170,91,261,25,286
公投第１１案,新北市,五股區,集賢里,215,1786,626,303,929,48,977
公投第１１案,新北市,五股區,集賢里,216,1660,533,310,843,29,872
公投第１１案,新北市,五股區,成德里,217,1534,507,274,781,66,847
公投第１１案,新北市,五股區,成德里,218,1285,474,211,685,59,744
公投第１１案,新北市,五股區,成州里,219,1832,593,315,908,75,983
公投第１１案,新北市,五股區,成州里,220,1542,517,284,801,28,829
公投第１１案,新北市,五股區,成州里,221,1897,586,293,879,43,922
公投第１１案,新北市,五股區,成功里,222,1964,398,503,901,62,963
公投第１１案,新北市,五股區,成功里,223,1779,546,291,837,48,885
公投第１１案,新北市,五股區,成功里,224,1735,586,288,874,39,913
公投第１１案,新北市,五股區,成泰里,225,2299,655,421,1076,35,1111
公投第１１案,新北市,五股區,成泰里,226,1755,584,252,836,33,869
公投第１１案,新北市,五股區,成泰里,227,1674,600,285,885,48,933
公投第１１案,新北市,五股區,成泰里,228,1661,588,280,868,52,920
公投第１１案,新北市,五股區,五龍里,229,1281,378,243,621,24,645
公投第１１案,新北市,五股區,五福里,230,1566,557,268,825,27,852
公投第１１案,新北市,五股區,五福里,231,1560,535,234,769,18,787
公投第１１案,新北市,五股區,六福里,232,1622,724,131,855,31,886
公投第１１案,新北市,五股區,六福里,233,1779,646,291,937,24,961
公投第１１案,新北市,五股區,民義里,234,1487,514,222,736,44,780
公投第１１案,新北市,五股區,民義里,235,1567,510,310,820,41,861
公投第１１案,新北市,五股區,五股里,236,1333,305,205,510,28,538
公投第１１案,新北市,五股區,五股里,237,1263,476,251,727,34,761
公投第１１案,新北市,五股區,五股里,238,1314,485,232,717,36,753
公投第１１案,新北市,五股區,德音里,239,1513,488,277,765,26,791
公投第１１案,新北市,五股區,德音里,240,1517,578,259,837,24,861
公投第１１案,新北市,五股區,德音里,241,1613,553,280,833,44,877
公投第１１案,新北市,五股區,水碓里,242,1616,559,275,834,39,873
公投第１１案,新北市,五股區,水碓里,243,1616,495,323,818,46,864
公投第１１案,新北市,五股區,水碓里,244,1689,591,281,872,47,919
公投第１１案,新北市,五股區,水碓里,245,1894,605,358,963,22,985
公投第１１案,新北市,五股區,福德里,246,1210,501,237,738,25,763
公投第１１案,新北市,五股區,福德里,247,1643,556,271,827,22,849
公投第１１案,新北市,五股區,德泰里,248,1441,494,258,752,21,773
公投第１１案,新北市,五股區,德泰里,249,1305,513,223,736,16,752
公投第１１案,新北市,五股區,德泰里,250,1170,458,233,691,32,723
公投第１１案,新北市,五股區,貿商里,251,1397,562,238,800,54,854
公投第１１案,新北市,五股區,貿商里,252,1312,563,205,768,39,807
公投第１１案,新北市,五股區,陸一里,253,1127,301,247,548,27,575
公投第１１案,新北市,五股區,陸一里,254,1154,437,140,577,25,602
公投第１１案,新北市,泰山區,大科里,255,643,199,102,301,23,324
公投第１１案,新北市,泰山區,大科里,256,186,75,38,113,2,115
公投第１１案,新北市,泰山區,黎明里,257,1457,498,224,722,22,744
公投第１１案,新北市,泰山區,黎明里,258,1594,560,291,851,40,891
公投第１１案,新北市,泰山區,山腳里,259,1598,507,265,772,30,802
公投第１１案,新北市,泰山區,山腳里,260,1503,483,271,754,22,776
公投第１１案,新北市,泰山區,山腳里,261,1436,477,229,706,42,748
公投第１１案,新北市,泰山區,山腳里,262,1384,487,253,740,28,768
公投第１１案,新北市,泰山區,福泰里,263,1231,471,204,675,29,704
公投第１１案,新北市,泰山區,福泰里,264,1295,449,209,658,26,684
公投第１１案,新北市,泰山區,福興里,265,1563,557,302,859,41,900
公投第１１案,新北市,泰山區,福興里,266,1610,616,272,888,45,933
公投第１１案,新北市,泰山區,楓樹里,267,1253,445,199,644,31,675
公投第１１案,新北市,泰山區,楓樹里,268,1294,439,196,635,32,667
公投第１１案,新北市,泰山區,楓樹里,269,1354,474,275,749,41,790
公投第１１案,新北市,泰山區,同榮里,270,1259,442,232,674,21,695
公投第１１案,新北市,泰山區,同榮里,271,1252,431,260,691,23,714
公投第１１案,新北市,泰山區,同榮里,272,1094,384,189,573,20,593
公投第１１案,新北市,泰山區,同興里,273,1590,576,297,873,22,895
公投第１１案,新北市,泰山區,同興里,274,1634,588,282,870,45,915
公投第１１案,新北市,泰山區,全興里,275,1536,464,237,701,26,727
公投第１１案,新北市,泰山區,全興里,276,1534,583,293,876,12,888
公投第１１案,新北市,泰山區,全興里,277,1545,670,261,931,24,955
公投第１１案,新北市,泰山區,全興里,278,1399,522,233,755,28,783
公投第１１案,新北市,泰山區,全興里,279,1315,459,232,691,23,714
公投第１１案,新北市,泰山區,義學里,280,1201,435,268,703,34,737
公投第１１案,新北市,泰山區,義學里,281,1182,400,228,628,38,666
公投第１１案,新北市,泰山區,義學里,282,1665,551,286,837,50,887
公投第１１案,新北市,泰山區,義仁里,283,1855,635,331,966,42,1008
公投第１１案,新北市,泰山區,義仁里,284,1866,649,326,975,56,1031
公投第１１案,新北市,泰山區,義仁里,285,1935,650,343,993,38,1031
公投第１１案,新北市,泰山區,義仁里,286,1589,529,275,804,15,819
公投第１１案,新北市,泰山區,明志里,287,1152,404,181,585,25,610
公投第１１案,新北市,泰山區,明志里,288,1114,359,239,598,30,628
公投第１１案,新北市,泰山區,明志里,289,1040,406,215,621,28,649
公投第１１案,新北市,泰山區,泰友里,290,1003,383,190,573,29,602
公投第１１案,新北市,泰山區,泰友里,291,975,355,223,578,16,594
公投第１１案,新北市,泰山區,新明里,292,1440,487,259,746,41,787
公投第１１案,新北市,泰山區,新明里,293,1480,528,253,781,19,800
公投第１１案,新北市,泰山區,貴子里,294,1211,444,220,664,22,686
公投第１１案,新北市,泰山區,貴子里,295,1237,463,219,682,22,704
公投第１１案,新北市,泰山區,貴子里,296,1069,409,172,581,25,606
公投第１１案,新北市,泰山區,貴賢里,297,1680,623,327,950,49,999
公投第１１案,新北市,泰山區,貴賢里,298,1651,602,315,917,25,942
公投第１１案,新北市,泰山區,貴和里,299,1420,488,237,725,23,748
公投第１１案,新北市,泰山區,貴和里,300,1337,497,260,757,32,789
公投第１１案,新北市,泰山區,貴和里,301,1591,585,296,881,32,913
公投第１１案,新北市,新莊區,海山里,302,1123,391,231,622,42,664
公投第１１案,新北市,新莊區,海山里,303,1278,482,260,742,36,778
公投第１１案,新北市,新莊區,海山里,304,1163,499,207,706,34,740
公投第１１案,新北市,新莊區,海山里,305,1228,474,257,731,28,759
公投第１１案,新北市,新莊區,全安里,306,1211,431,243,674,40,714
公投第１１案,新北市,新莊區,全安里,307,1176,442,225,667,34,701
公投第１１案,新北市,新莊區,全安里,308,1536,617,304,921,35,956
公投第１１案,新北市,新莊區,全泰里,309,1486,566,307,873,52,925
公投第１１案,新北市,新莊區,全泰里,310,1513,586,334,920,52,972
公投第１１案,新北市,新莊區,全泰里,311,1395,530,312,842,49,891
公投第１１案,新北市,新莊區,忠孝里,312,1353,479,242,721,50,771
公投第１１案,新北市,新莊區,忠孝里,313,1409,562,260,822,51,873
公投第１１案,新北市,新莊區,忠孝里,314,1478,541,261,802,25,827
公投第１１案,新北市,新莊區,文衡里,315,921,363,183,546,29,575
公投第１１案,新北市,新莊區,文衡里,316,971,374,204,578,31,609
公投第１１案,新北市,新莊區,文聖里,317,1534,616,299,915,51,966
公投第１１案,新北市,新莊區,文聖里,318,1516,560,249,809,43,852
公投第１１案,新北市,新莊區,興漢里,319,697,246,143,389,21,410
公投第１１案,新北市,新莊區,興漢里,320,1235,452,247,699,22,721
公投第１１案,新北市,新莊區,興漢里,321,1138,413,228,641,25,666
公投第１１案,新北市,新莊區,榮和里,322,1063,367,193,560,15,575
公投第１１案,新北市,新莊區,榮和里,323,3399,507,304,811,35,846
公投第１１案,新北市,新莊區,文德里,324,1575,568,315,883,54,937
公投第１１案,新北市,新莊區,文明里,325,1615,557,386,943,49,992
公投第１１案,新北市,新莊區,化成里,326,1612,517,285,802,46,848
公投第１１案,新北市,新莊區,化成里,327,1514,540,269,809,38,847
公投第１１案,新北市,新莊區,頭前里,328,1382,441,254,695,25,720
公投第１１案,新北市,新莊區,頭前里,329,1475,481,309,790,40,830
公投第１１案,新北市,新莊區,頭前里,330,1462,514,314,828,19,847
公投第１１案,新北市,新莊區,頭前里,331,1426,473,288,761,30,791
公投第１１案,新北市,新莊區,頭前里,332,1421,458,296,754,36,790
公投第１１案,新北市,新莊區,福基里,333,1536,532,306,838,27,865
公投第１１案,新北市,新莊區,福基里,334,1587,521,372,893,27,920
公投第１１案,新北市,新莊區,福基里,335,749,250,141,391,14,405
公投第１１案,新北市,新莊區,福興里,336,1276,492,242,734,33,767
公投第１１案,新北市,新莊區,福興里,337,1303,453,249,702,25,727
公投第１１案,新北市,新莊區,福興里,338,1259,502,230,732,41,773
公投第１１案,新北市,新莊區,福興里,339,1291,477,263,740,41,781
公投第１１案,新北市,新莊區,昌平里,340,1493,519,311,830,18,848
公投第１１案,新北市,新莊區,昌平里,341,1507,534,308,842,38,880
公投第１１案,新北市,新莊區,昌平里,342,1456,534,280,814,11,825
公投第１１案,新北市,新莊區,昌平里,343,1396,501,283,784,21,805
公投第１１案,新北市,新莊區,和平里,344,1351,455,235,690,38,728
公投第１１案,新北市,新莊區,和平里,345,1403,491,276,767,38,805
公投第１１案,新北市,新莊區,和平里,346,1497,523,270,793,45,838
公投第１１案,新北市,新莊區,幸福里,347,1272,479,242,721,53,774
公投第１１案,新北市,新莊區,幸福里,348,1269,428,202,630,26,656
公投第１１案,新北市,新莊區,幸福里,349,1335,478,263,741,57,798
公投第１１案,新北市,新莊區,昌隆里,350,1300,465,310,775,24,799
公投第１１案,新北市,新莊區,昌隆里,351,1286,492,253,745,36,781
公投第１１案,新北市,新莊區,昌隆里,352,1255,534,261,795,36,831
公投第１１案,新北市,新莊區,信義里,353,1558,584,259,843,56,899
公投第１１案,新北市,新莊區,信義里,354,1567,531,275,806,47,853
公投第１１案,新北市,新莊區,信義里,355,1603,619,284,903,47,950
公投第１１案,新北市,新莊區,昌信里,356,1538,519,324,843,30,873
公投第１１案,新北市,新莊區,昌信里,357,1671,574,352,926,41,967
公投第１１案,新北市,新莊區,昌明里,358,1698,531,320,851,35,886
公投第１１案,新北市,新莊區,昌明里,359,1545,552,350,902,41,943
公投第１１案,新北市,新莊區,仁義里,360,1696,636,316,952,78,1030
公投第１１案,新北市,新莊區,仁義里,361,1626,585,235,820,57,877
公投第１１案,新北市,新莊區,仁愛里,362,1170,395,281,676,44,720
公投第１１案,新北市,新莊區,仁愛里,363,1236,451,217,668,57,725
公投第１１案,新北市,新莊區,自信里,364,1071,380,182,562,40,602
公投第１１案,新北市,新莊區,自信里,365,1129,402,210,612,37,649
公投第１１案,新北市,新莊區,自立里,366,1586,610,329,939,27,966
公投第１１案,新北市,新莊區,自立里,367,1597,555,247,802,31,833
公投第１１案,新北市,新莊區,自立里,368,1573,518,250,768,59,827
公投第１１案,新北市,新莊區,自強里,369,1225,479,199,678,31,709
公投第１１案,新北市,新莊區,自強里,370,1217,446,180,626,22,648
公投第１１案,新北市,新莊區,思源里,371,1571,549,289,838,44,882
公投第１１案,新北市,新莊區,思源里,372,1594,529,291,820,41,861
公投第１１案,新北市,新莊區,思源里,373,1583,557,274,831,42,873
公投第１１案,新北市,新莊區,思賢里,374,1245,510,230,740,43,783
公投第１１案,新北市,新莊區,思賢里,375,1203,469,240,709,26,735
公投第１１案,新北市,新莊區,思賢里,376,1265,506,260,766,26,792
公投第１１案,新北市,新莊區,中華里,377,1255,489,226,715,46,761
公投第１１案,新北市,新莊區,中華里,378,1287,478,250,728,28,756
公投第１１案,新北市,新莊區,中美里,379,1167,428,253,681,52,733
公投第１１案,新北市,新莊區,中美里,380,1299,463,224,687,40,727
公投第１１案,新北市,新莊區,中美里,381,1207,432,237,669,37,706
公投第１１案,新北市,新莊區,中美里,382,1415,542,264,806,25,831
公投第１１案,新北市,新莊區,恆安里,383,1342,483,259,742,43,785
公投第１１案,新北市,新莊區,恆安里,384,1341,452,267,719,55,774
公投第１１案,新北市,新莊區,恆安里,385,1247,415,253,668,46,714
公投第１１案,新北市,新莊區,立人里,386,984,463,179,642,15,657
公投第１１案,新北市,新莊區,立人里,387,1043,383,232,615,33,648
公投第１１案,新北市,新莊區,立德里,388,1135,480,243,723,27,750
公投第１１案,新北市,新莊區,立德里,389,1185,411,258,669,35,704
公投第１１案,新北市,新莊區,中和里,390,1346,470,288,758,24,782
公投第１１案,新北市,新莊區,中和里,391,1372,528,239,767,52,819
公投第１１案,新北市,新莊區,中和里,392,1350,542,250,792,44,836
公投第１１案,新北市,新莊區,中泰里,393,1307,445,247,692,38,730
公投第１１案,新北市,新莊區,中泰里,394,1353,497,239,736,47,783
公投第１１案,新北市,新莊區,中泰里,395,1287,500,120,620,47,667
公投第１１案,新北市,新莊區,中宏里,396,1567,492,245,737,30,767
公投第１１案,新北市,新莊區,中宏里,397,1709,616,353,969,46,1015
公投第１１案,新北市,新莊區,中全里,398,1616,560,265,825,32,857
公投第１１案,新北市,新莊區,中全里,399,1628,487,325,812,47,859
公投第１１案,新北市,新莊區,立志里,400,1148,451,214,665,46,711
公投第１１案,新北市,新莊區,立志里,401,1201,465,218,683,8,691
公投第１１案,新北市,新莊區,立志里,402,1135,465,233,698,33,731
公投第１１案,新北市,新莊區,立廷里,403,1495,539,341,880,46,926
公投第１１案,新北市,新莊區,立廷里,404,1486,568,301,869,45,914
公投第１１案,新北市,新莊區,立廷里,405,1483,576,313,889,29,918
公投第１１案,新北市,新莊區,立廷里,406,1553,552,275,827,33,860
公投第１１案,新北市,新莊區,立廷里,407,1625,617,350,967,21,988
公投第１１案,新北市,新莊區,立廷里,408,1671,798,136,934,22,956
公投第１１案,新北市,新莊區,立基里,409,1389,541,277,818,52,870
公投第１１案,新北市,新莊區,立基里,410,1272,492,227,719,29,748
公投第１１案,新北市,新莊區,立基里,411,1409,545,308,853,28,881
公投第１１案,新北市,新莊區,立基里,412,1372,521,300,821,33,854
公投第１１案,新北市,新莊區,中誠里,413,955,349,177,526,35,561
公投第１１案,新北市,新莊區,中誠里,414,952,338,158,496,40,536
公投第１１案,新北市,新莊區,中港里,415,1412,520,281,801,20,821
公投第１１案,新北市,新莊區,中港里,416,1415,545,245,790,37,827
公投第１１案,新北市,新莊區,中港里,417,1421,554,263,817,46,863
公投第１１案,新北市,新莊區,中港里,418,1293,515,268,783,29,812
公投第１１案,新北市,新莊區,中信里,419,1475,490,290,780,22,802
公投第１１案,新北市,新莊區,中信里,420,1429,496,277,773,48,821
公投第１１案,新北市,新莊區,中信里,421,1481,492,315,807,41,848
公投第１１案,新北市,新莊區,中信里,422,1472,566,272,838,55,893
公投第１１案,新北市,新莊區,中信里,423,1474,524,330,854,21,875
公投第１１案,新北市,新莊區,中平里,424,1462,548,316,864,17,881
公投第１１案,新北市,新莊區,中平里,425,1484,531,333,864,20,884
公投第１１案,新北市,新莊區,中平里,426,1461,541,269,810,31,841
公投第１１案,新北市,新莊區,中平里,427,1444,525,314,839,20,859
公投第１１案,新北市,新莊區,中平里,428,1437,534,301,835,20,855
公投第１１案,新北市,新莊區,中原里,429,1641,501,302,803,34,837
公投第１１案,新北市,新莊區,中原里,430,1633,534,321,855,24,879
公投第１１案,新北市,新莊區,中原里,431,1531,557,316,873,10,883
公投第１１案,新北市,新莊區,中原里,432,1517,565,306,871,34,905
公投第１１案,新北市,新莊區,中原里,433,1487,515,277,792,32,824
公投第１１案,新北市,新莊區,中原里,434,1560,553,303,856,33,889
公投第１１案,新北市,新莊區,中隆里,435,1584,535,308,843,53,896
公投第１１案,新北市,新莊區,中隆里,436,1602,583,278,861,23,884
公投第１１案,新北市,新莊區,中隆里,437,818,290,156,446,39,485
公投第１１案,新北市,新莊區,立功里,438,1633,535,244,779,44,823
公投第１１案,新北市,新莊區,立功里,439,1652,587,276,863,31,894
公投第１１案,新北市,新莊區,立泰里,440,1498,519,274,793,41,834
公投第１１案,新北市,新莊區,立泰里,441,1379,477,253,730,39,769
公投第１１案,新北市,新莊區,立泰里,442,1381,531,254,785,37,822
公投第１１案,新北市,新莊區,立言里,443,1535,566,292,858,47,905
公投第１１案,新北市,新莊區,立言里,444,1492,599,299,898,49,947
公投第１１案,新北市,新莊區,立言里,445,1450,571,296,867,50,917
公投第１１案,新北市,新莊區,豐年里,446,1107,397,227,624,32,656
公投第１１案,新北市,新莊區,豐年里,447,1063,426,220,646,18,664
公投第１１案,新北市,新莊區,豐年里,448,1143,435,225,660,32,692
公投第１１案,新北市,新莊區,國泰里,449,1341,454,253,707,48,755
公投第１１案,新北市,新莊區,泰豐里,450,1063,404,186,590,26,616
公投第１１案,新北市,新莊區,泰豐里,451,1096,424,211,635,27,662
公投第１１案,新北市,新莊區,瓊林里,452,1309,470,248,718,30,748
公投第１１案,新北市,新莊區,瓊林里,453,1216,468,236,704,29,733
公投第１１案,新北市,新莊區,瓊林里,454,1278,450,212,662,32,694
公投第１１案,新北市,新莊區,瓊林里,455,1352,457,272,729,49,778
公投第１１案,新北市,新莊區,福營里,456,1298,406,231,637,44,681
公投第１１案,新北市,新莊區,福營里,457,1042,375,196,571,39,610
公投第１１案,新北市,新莊區,營盤里,458,881,283,164,447,24,471
公投第１１案,新北市,新莊區,營盤里,459,1109,442,234,676,44,720
公投第１１案,新北市,新莊區,丹鳳里,460,1291,448,231,679,43,722
公投第１１案,新北市,新莊區,丹鳳里,461,1293,434,248,682,23,705
公投第１１案,新北市,新莊區,丹鳳里,462,1336,488,269,757,32,789
公投第１１案,新北市,新莊區,丹鳳里,463,1384,472,244,716,30,746
公投第１１案,新北市,新莊區,丹鳳里,464,1231,426,200,626,2,628
公投第１１案,新北市,新莊區,丹鳳里,465,940,340,177,517,31,548
公投第１１案,新北市,新莊區,合鳳里,466,1369,429,280,709,60,769
公投第１１案,新北市,新莊區,合鳳里,467,1384,500,219,719,50,769
公投第１１案,新北市,新莊區,合鳳里,468,1272,437,274,711,45,756
公投第１１案,新北市,新莊區,祥鳳里,469,1073,399,208,607,30,637
公投第１１案,新北市,新莊區,祥鳳里,470,1058,351,227,578,30,608
公投第１１案,新北市,新莊區,雙鳳里,471,1528,545,304,849,18,867
公投第１１案,新北市,新莊區,雙鳳里,472,1244,465,186,651,30,681
公投第１１案,新北市,新莊區,雙鳳里,473,1356,509,191,700,23,723
公投第１１案,新北市,新莊區,雙鳳里,474,1164,436,159,595,15,610
公投第１１案,新北市,新莊區,雙鳳里,475,1423,511,282,793,47,840
公投第１１案,新北市,新莊區,雙鳳里,476,1250,488,260,748,29,777
公投第１１案,新北市,新莊區,雙鳳里,477,1252,413,255,668,23,691
公投第１１案,新北市,新莊區,龍福里,478,1022,369,181,550,12,562
公投第１１案,新北市,新莊區,龍福里,479,959,348,187,535,35,570
公投第１１案,新北市,新莊區,龍鳳里,480,1646,555,373,928,32,960
公投第１１案,新北市,新莊區,龍鳳里,481,1551,487,331,818,47,865
公投第１１案,新北市,新莊區,龍鳳里,482,1526,566,311,877,33,910
公投第１１案,新北市,新莊區,龍鳳里,483,1518,530,324,854,14,868
公投第１１案,新北市,新莊區,龍鳳里,484,1547,526,343,869,32,901
公投第１１案,新北市,新莊區,裕民里,485,1505,527,254,781,46,827
公投第１１案,新北市,新莊區,裕民里,486,1527,529,258,787,41,828
公投第１１案,新北市,新莊區,裕民里,487,1482,475,263,738,42,780
公投第１１案,新北市,新莊區,裕民里,488,1586,514,268,782,46,828
公投第１１案,新北市,新莊區,龍安里,489,1065,377,191,568,56,624
公投第１１案,新北市,新莊區,龍安里,490,1040,427,209,636,40,676
公投第１１案,新北市,新莊區,富國里,491,1090,359,218,577,37,614
公投第１１案,新北市,新莊區,富國里,492,1071,398,218,616,30,646
公投第１１案,新北市,新莊區,富民里,493,1704,538,330,868,32,900
公投第１１案,新北市,新莊區,富民里,494,1698,515,313,828,31,859
公投第１１案,新北市,新莊區,後德里,495,1362,507,307,814,39,853
公投第１１案,新北市,新莊區,後德里,496,1350,481,301,782,28,810
公投第１１案,新北市,新莊區,萬安里,497,1689,590,317,907,61,968
公投第１１案,新北市,新莊區,萬安里,498,1612,555,324,879,58,937
公投第１１案,新北市,新莊區,建福里,499,1130,451,196,647,39,686
公投第１１案,新北市,新莊區,建福里,500,1111,426,231,657,42,699
公投第１１案,新北市,新莊區,後港里,501,1539,509,299,808,31,839
公投第１１案,新北市,新莊區,後港里,502,1586,549,318,867,24,891
公投第１１案,新北市,新莊區,後港里,503,1631,595,312,907,30,937
公投第１１案,新北市,新莊區,後港里,504,1540,419,325,744,25,769
公投第１１案,新北市,新莊區,四維里,505,1388,440,223,663,38,701
公投第１１案,新北市,新莊區,四維里,506,1388,406,236,642,76,718
公投第１１案,新北市,新莊區,四維里,507,1387,431,229,660,37,697
公投第１１案,新北市,新莊區,南港里,508,1181,402,218,620,27,647
公投第１１案,新北市,新莊區,南港里,509,1135,388,230,618,42,660
公投第１１案,新北市,新莊區,南港里,510,1173,400,244,644,32,676
公投第１１案,新北市,新莊區,南港里,511,1215,385,293,678,26,704
公投第１１案,新北市,新莊區,建安里,512,1488,531,283,814,47,861
公投第１１案,新北市,新莊區,建安里,513,1444,492,298,790,36,826
公投第１１案,新北市,新莊區,建安里,514,1499,505,279,784,27,811
公投第１１案,新北市,新莊區,建安里,515,1449,488,284,772,29,801
公投第１１案,新北市,新莊區,民全里,516,1640,559,312,871,51,922
公投第１１案,新北市,新莊區,民全里,517,1648,536,319,855,45,900
公投第１１案,新北市,新莊區,八德里,518,1371,430,243,673,49,722
公投第１１案,新北市,新莊區,八德里,519,1400,478,252,730,43,773
公投第１１案,新北市,新莊區,成德里,520,1457,487,274,761,62,823
公投第１１案,新北市,新莊區,成德里,521,1502,494,282,776,50,826
公投第１１案,新北市,新莊區,成德里,522,1412,456,275,731,56,787
公投第１１案,新北市,新莊區,民安里,523,1318,442,232,674,62,736
公投第１１案,新北市,新莊區,民安里,524,1411,500,303,803,32,835
公投第１１案,新北市,新莊區,民安里,525,1262,439,271,710,30,740
公投第１１案,新北市,新莊區,民安里,526,1228,470,245,715,29,744
公投第１１案,新北市,新莊區,民有里,527,1748,579,405,984,41,1025
公投第１１案,新北市,新莊區,民有里,528,1761,625,340,965,60,1025
公投第１１案,新北市,新莊區,民本里,529,1326,438,235,673,32,705
公投第１１案,新北市,新莊區,民本里,530,1344,442,206,648,23,671
公投第１１案,新北市,新莊區,光明里,531,1355,505,228,733,38,771
公投第１１案,新北市,新莊區,光明里,532,1306,480,241,721,39,760
公投第１１案,新北市,新莊區,光明里,533,1349,497,281,778,31,809
公投第１１案,新北市,新莊區,光正里,534,1265,461,251,712,28,740
公投第１１案,新北市,新莊區,光正里,535,1282,491,253,744,35,779
公投第１１案,新北市,新莊區,光正里,536,1237,492,224,716,28,744
公投第１１案,新北市,新莊區,光榮里,537,1301,489,218,707,24,731
公投第１１案,新北市,新莊區,光榮里,538,1262,459,236,695,32,727
公投第１１案,新北市,新莊區,光榮里,539,1270,471,219,690,37,727
公投第１１案,新北市,新莊區,光和里,540,1245,447,250,697,38,735
公投第１１案,新北市,新莊區,光和里,541,1220,455,194,649,36,685
公投第１１案,新北市,新莊區,光華里,542,1245,398,229,627,42,669
公投第１１案,新北市,新莊區,光華里,543,1212,412,219,631,37,668
公投第１１案,新北市,新莊區,光華里,544,1253,414,223,637,47,684
公投第１１案,新北市,新莊區,光華里,545,1272,422,219,641,39,680
公投第１１案,新北市,新莊區,光華里,546,1227,480,238,718,15,733
公投第１１案,新北市,新莊區,西盛里,547,1126,437,223,660,18,678
公投第１１案,新北市,新莊區,西盛里,548,1240,461,248,709,21,730
公投第１１案,新北市,新莊區,西盛里,549,1460,509,280,789,40,829
公投第１１案,新北市,新莊區,西盛里,550,1072,374,194,568,32,600
公投第１１案,新北市,新莊區,西盛里,551,1127,358,206,564,28,592
公投第１１案,新北市,新莊區,西盛里,552,1332,522,237,759,21,780
公投第１１案,新北市,新莊區,西盛里,553,1341,411,276,687,16,703
公投第１１案,新北市,新莊區,西盛里,554,1140,328,175,503,19,522
公投第１１案,新北市,蘆洲區,光華里,555,1600,537,332,869,63,932
公投第１１案,新北市,蘆洲區,光華里,556,1549,542,281,823,41,864
公投第１１案,新北市,蘆洲區,光華里,557,1516,533,306,839,53,892
公投第１１案,新北市,蘆洲區,光明里,558,1404,506,224,730,45,775
公投第１１案,新北市,蘆洲區,光明里,559,1381,462,242,704,57,761
公投第１１案,新北市,蘆洲區,光明里,560,1485,527,278,805,36,841
公投第１１案,新北市,蘆洲區,中路里,561,1779,449,206,655,34,689
公投第１１案,新北市,蘆洲區,中路里,562,1797,611,318,929,35,964
公投第１１案,新北市,蘆洲區,永安里,563,1364,472,274,746,44,790
公投第１１案,新北市,蘆洲區,永安里,564,1635,554,324,878,46,924
公投第１１案,新北市,蘆洲區,永安里,565,1567,500,244,744,23,767
公投第１１案,新北市,蘆洲區,九芎里,566,1524,520,255,775,36,811
公投第１１案,新北市,蘆洲區,九芎里,567,1612,528,265,793,41,834
公投第１１案,新北市,蘆洲區,九芎里,568,1674,532,312,844,34,878
公投第１１案,新北市,蘆洲區,延平里,569,1838,547,318,865,41,906
公投第１１案,新北市,蘆洲區,延平里,570,1814,510,288,798,26,824
公投第１１案,新北市,蘆洲區,中華里,571,1473,484,315,799,37,836
公投第１１案,新北市,蘆洲區,中華里,572,1465,492,257,749,44,793
公投第１１案,新北市,蘆洲區,中原里,573,1652,567,342,909,37,946
公投第１１案,新北市,蘆洲區,中原里,574,1650,539,315,854,62,916
公投第１１案,新北市,蘆洲區,中原里,575,1656,595,286,881,34,915
公投第１１案,新北市,蘆洲區,長安里,576,1571,517,267,784,36,820
公投第１１案,新北市,蘆洲區,長安里,577,1523,474,300,774,43,817
公投第１１案,新北市,蘆洲區,長安里,578,1475,497,271,768,35,803
公投第１１案,新北市,蘆洲區,忠義里,579,1367,427,260,687,43,730
公投第１１案,新北市,蘆洲區,忠義里,580,1514,535,296,831,32,863
公投第１１案,新北市,蘆洲區,正義里,581,1791,651,380,1031,25,1056
公投第１１案,新北市,蘆洲區,正義里,582,1714,646,363,1009,35,1044
公投第１１案,新北市,蘆洲區,正義里,583,1780,530,456,986,19,1005
公投第１１案,新北市,蘆洲區,正義里,584,1713,586,346,932,38,970
公投第１１案,新北市,蘆洲區,正義里,585,1720,636,317,953,30,983
公投第１１案,新北市,蘆洲區,正義里,586,1766,629,323,952,27,979
公投第１１案,新北市,蘆洲區,南港里,587,1623,554,299,853,35,888
公投第１１案,新北市,蘆洲區,南港里,588,1740,551,370,921,36,957
公投第１１案,新北市,蘆洲區,南港里,589,1759,629,345,974,43,1017
公投第１１案,新北市,蘆洲區,永樂里,590,1775,629,358,987,47,1034
公投第１１案,新北市,蘆洲區,永樂里,591,1909,660,391,1051,42,1093
公投第１１案,新北市,蘆洲區,永樂里,592,1805,618,379,997,53,1050
公投第１１案,新北市,蘆洲區,成功里,593,1642,542,308,850,27,877
公投第１１案,新北市,蘆洲區,成功里,594,1713,550,323,873,43,916
公投第１１案,新北市,蘆洲區,成功里,595,1746,517,319,836,57,893
公投第１１案,新北市,蘆洲區,成功里,596,1596,538,302,840,38,878
公投第１１案,新北市,蘆洲區,永康里,597,1434,478,252,730,37,767
公投第１１案,新北市,蘆洲區,永康里,598,1450,496,282,778,34,812
公投第１１案,新北市,蘆洲區,永康里,599,1543,475,303,778,19,797
公投第１１案,新北市,蘆洲區,永康里,600,1525,509,289,798,29,827
公投第１１案,新北市,蘆洲區,永德里,601,1419,426,266,692,45,737
公投第１１案,新北市,蘆洲區,永德里,602,1298,438,279,717,23,740
公投第１１案,新北市,蘆洲區,永德里,603,1304,430,236,666,46,712
公投第１１案,新北市,蘆洲區,樓厝里,604,1806,562,370,932,35,967
公投第１１案,新北市,蘆洲區,樓厝里,605,1910,616,318,934,61,995
公投第１１案,新北市,蘆洲區,樓厝里,606,1873,540,192,732,31,763
公投第１１案,新北市,蘆洲區,信義里,607,1785,548,299,847,25,872
公投第１１案,新北市,蘆洲區,信義里,608,1760,534,306,840,49,889
公投第１１案,新北市,蘆洲區,玉清里,609,1841,621,349,970,54,1024
公投第１１案,新北市,蘆洲區,玉清里,610,1855,577,329,906,31,937
公投第１１案,新北市,蘆洲區,玉清里,611,1450,435,251,686,47,733
公投第１１案,新北市,蘆洲區,復興里,612,1585,487,299,786,48,834
公投第１１案,新北市,蘆洲區,復興里,613,1541,478,250,728,62,790
公投第１１案,新北市,蘆洲區,福安里,614,1626,519,299,818,40,858
公投第１１案,新北市,蘆洲區,福安里,615,1241,400,281,681,39,720
公投第１１案,新北市,蘆洲區,鷺江里,616,1634,543,311,854,37,891
公投第１１案,新北市,蘆洲區,鷺江里,617,1573,550,283,833,38,871
公投第１１案,新北市,蘆洲區,鷺江里,618,1619,532,348,880,35,915
公投第１１案,新北市,蘆洲區,恆德里,619,1878,623,332,955,65,1020
公投第１１案,新北市,蘆洲區,恆德里,620,1797,597,311,908,60,968
公投第１１案,新北市,蘆洲區,恆德里,621,1816,635,345,980,41,1021
公投第１１案,新北市,蘆洲區,溪墘里,622,1344,483,267,750,53,803
公投第１１案,新北市,蘆洲區,溪墘里,623,1492,544,389,933,49,982
公投第１１案,新北市,蘆洲區,仁復里,624,1959,686,304,990,71,1061
公投第１１案,新北市,蘆洲區,仁德里,625,1611,546,280,826,58,884
公投第１１案,新北市,蘆洲區,仁德里,626,1574,562,307,869,36,905
公投第１１案,新北市,蘆洲區,仁德里,627,1653,584,304,888,38,926
公投第１１案,新北市,蘆洲區,仁義里,628,3085,653,363,1016,41,1057
公投第１１案,新北市,蘆洲區,仁義里,629,1812,569,350,919,50,969
公投第１１案,新北市,蘆洲區,得勝里,630,1332,436,256,692,45,737
公投第１１案,新北市,蘆洲區,得勝里,631,1648,488,276,764,48,812
公投第１１案,新北市,蘆洲區,得仁里,632,1355,338,351,689,26,715
公投第１１案,新北市,蘆洲區,得仁里,633,1371,466,237,703,30,733
公投第１１案,新北市,蘆洲區,保和里,634,1111,382,208,590,40,630
公投第１１案,新北市,蘆洲區,保和里,635,1176,418,229,647,52,699
公投第１１案,新北市,蘆洲區,樹德里,636,1602,637,328,965,36,1001
公投第１１案,新北市,蘆洲區,樹德里,637,1361,404,246,650,44,694
公投第１１案,新北市,蘆洲區,民和里,638,1530,532,262,794,41,835
公投第１１案,新北市,蘆洲區,民和里,639,925,314,161,475,53,528
公投第１１案,新北市,蘆洲區,水湳里,640,1851,617,342,959,43,1002
公投第１１案,新北市,蘆洲區,水湳里,641,1791,538,301,839,40,879
公投第１１案,新北市,蘆洲區,水湳里,642,1853,558,327,885,42,927
公投第１１案,新北市,蘆洲區,水湳里,643,1758,516,310,826,39,865
公投第１１案,新北市,蘆洲區,水湳里,644,1798,572,348,920,48,968
公投第１１案,新北市,蘆洲區,水河里,645,1645,573,300,873,33,906
公投第１１案,新北市,蘆洲區,水河里,646,1612,461,300,761,33,794
公投第１１案,新北市,蘆洲區,水河里,647,1784,519,312,831,39,870
公投第１１案,新北市,蘆洲區,水河里,648,1701,481,275,756,37,793
公投第１１案,新北市,蘆洲區,水河里,649,1581,530,268,798,30,828
公投第１１案,新北市,蘆洲區,仁愛里,650,1534,470,337,807,39,846
公投第１１案,新北市,蘆洲區,仁愛里,651,1620,544,338,882,56,938
公投第１１案,新北市,蘆洲區,仁愛里,652,1494,556,290,846,44,890
公投第１１案,新北市,蘆洲區,忠孝里,653,1183,363,270,633,30,663
公投第１１案,新北市,蘆洲區,忠孝里,654,985,336,195,531,36,567
公投第１１案,新北市,蘆洲區,保佑里,655,1673,535,283,818,57,875
公投第１１案,新北市,蘆洲區,保佑里,656,1688,536,353,889,59,948
公投第１１案,新北市,蘆洲區,保新里,657,1249,426,223,649,34,683
公投第１１案,新北市,蘆洲區,保新里,658,1476,460,267,727,44,771
公投第１１案,新北市,三重區,大有里,659,1509,479,302,781,29,810
公投第１１案,新北市,三重區,大有里,660,1591,572,304,876,42,918
公投第１１案,新北市,三重區,大有里,661,1653,568,335,903,58,961
公投第１１案,新北市,三重區,博愛里,662,1392,516,266,782,50,832
公投第１１案,新北市,三重區,博愛里,663,1451,558,287,845,40,885
公投第１１案,新北市,三重區,博愛里,664,1329,477,250,727,49,776
公投第１１案,新北市,三重區,二重里,665,1459,513,297,810,34,844
公投第１１案,新北市,三重區,頂崁里,666,1024,381,211,592,45,637
公投第１１案,新北市,三重區,頂崁里,667,1066,397,206,603,34,637
公投第１１案,新北市,三重區,谷王里,668,856,341,186,527,42,569
公投第１１案,新北市,三重區,五谷里,669,764,253,154,407,30,437
公投第１１案,新北市,三重區,五谷里,670,821,315,177,492,28,520
公投第１１案,新北市,三重區,中興里,671,1887,579,370,949,48,997
公投第１１案,新北市,三重區,中興里,672,1646,540,315,855,33,888
公投第１１案,新北市,三重區,德厚里,673,358,135,80,215,13,228
公投第１１案,新北市,三重區,成功里,674,1039,366,219,585,39,624
公投第１１案,新北市,三重區,成功里,675,1114,388,265,653,26,679
公投第１１案,新北市,三重區,成功里,676,1588,568,345,913,31,944
公投第１１案,新北市,三重區,成功里,677,1702,590,291,881,28,909
公投第１１案,新北市,三重區,福祉里,678,1288,573,278,851,40,891
公投第１１案,新北市,三重區,福祉里,679,1629,608,339,947,37,984
公投第１１案,新北市,三重區,福祉里,680,1861,652,344,996,48,1044
公投第１１案,新北市,三重區,福德里,681,1727,581,390,971,34,1005
公投第１１案,新北市,三重區,福德里,682,1813,730,245,975,40,1015
公投第１１案,新北市,三重區,福民里,683,1595,560,286,846,46,892
公投第１１案,新北市,三重區,福民里,684,1513,555,296,851,45,896
公投第１１案,新北市,三重區,過田里,685,4433,483,308,791,34,825
公投第１１案,新北市,三重區,過田里,686,1283,490,227,717,32,749
公投第１１案,新北市,三重區,過田里,687,1430,546,286,832,41,873
公投第１１案,新北市,三重區,過田里,688,1357,509,280,789,24,813
公投第１１案,新北市,三重區,錦田里,689,963,357,193,550,24,574
公投第１１案,新北市,三重區,錦田里,690,883,293,200,493,33,526
公投第１１案,新北市,三重區,重明里,691,1494,544,259,803,54,857
公投第１１案,新北市,三重區,重明里,692,1616,569,310,879,59,938
公投第１１案,新北市,三重區,光田里,693,1329,455,279,734,28,762
公投第１１案,新北市,三重區,光田里,694,1289,483,287,770,34,804
公投第１１案,新北市,三重區,光田里,695,1380,496,268,764,38,802
公投第１１案,新北市,三重區,光陽里,696,1668,574,359,933,31,964
公投第１１案,新北市,三重區,光陽里,697,1226,475,251,726,50,776
公投第１１案,新北市,三重區,光陽里,698,1421,531,289,820,33,853
公投第１１案,新北市,三重區,光陽里,699,1364,515,265,780,34,814
公投第１１案,新北市,三重區,田心里,700,1232,452,238,690,44,734
公投第１１案,新北市,三重區,田心里,701,1248,445,295,740,42,782
公投第１１案,新北市,三重區,田心里,702,1256,445,388,833,45,878
公投第１１案,新北市,三重區,福田里,703,1506,573,331,904,29,933
公投第１１案,新北市,三重區,福田里,704,1669,613,351,964,38,1002
公投第１１案,新北市,三重區,田中里,705,1308,479,229,708,51,759
公投第１１案,新北市,三重區,田中里,706,1263,535,270,805,28,833
公投第１１案,新北市,三重區,田中里,707,1471,486,290,776,53,829
公投第１１案,新北市,三重區,田中里,708,1447,526,297,823,52,875
公投第１１案,新北市,三重區,田安里,709,1693,462,327,789,45,834
公投第１１案,新北市,三重區,田安里,710,2015,644,416,1060,35,1095
公投第１１案,新北市,三重區,田安里,711,1812,627,278,905,53,958
公投第１１案,新北市,三重區,三民里,712,1509,479,301,780,26,806
公投第１１案,新北市,三重區,三民里,713,1439,490,289,779,40,819
公投第１１案,新北市,三重區,光明里,714,1437,500,286,786,42,828
公投第１１案,新北市,三重區,光明里,715,1697,506,357,863,57,920
公投第１１案,新北市,三重區,光明里,716,1793,583,320,903,26,929
公投第１１案,新北市,三重區,光明里,717,1603,603,347,950,22,972
公投第１１案,新北市,三重區,光正里,718,1166,401,218,619,16,635
公投第１１案,新北市,三重區,光正里,719,1126,410,225,635,31,666
公投第１１案,新北市,三重區,同安里,720,1291,408,206,614,38,652
公投第１１案,新北市,三重區,同慶里,721,1597,518,328,846,58,904
公投第１１案,新北市,三重區,菜寮里,722,1081,392,222,614,51,665
公投第１１案,新北市,三重區,菜寮里,723,911,354,200,554,34,588
公投第１１案,新北市,三重區,永春里,724,1719,518,312,830,30,860
公投第１１案,新北市,三重區,中正里,725,1289,436,242,678,48,726
公投第１１案,新北市,三重區,吉利里,726,1318,501,247,748,56,804
公投第１１案,新北市,三重區,大同里,727,1822,592,322,914,47,961
公投第１１案,新北市,三重區,中民里,728,1185,419,209,628,69,697
公投第１１案,新北市,三重區,平和里,729,1369,419,249,668,54,722
公投第１１案,新北市,三重區,大安里,730,1507,535,279,814,52,866
公投第１１案,新北市,三重區,仁德里,731,926,331,179,510,45,555
公投第１１案,新北市,三重區,仁德里,732,950,331,164,495,16,511
公投第１１案,新北市,三重區,忠孝里,733,1678,520,322,842,51,893
公投第１１案,新北市,三重區,仁義里,734,1117,366,210,576,62,638
公投第１１案,新北市,三重區,光榮里,735,1318,430,230,660,44,704
公投第１１案,新北市,三重區,光輝里,736,1388,463,305,768,34,802
公投第１１案,新北市,三重區,福星里,737,1026,331,227,558,42,600
公投第１１案,新北市,三重區,福利里,738,1096,392,243,635,45,680
公投第１１案,新北市,三重區,福利里,739,967,357,188,545,28,573
公投第１１案,新北市,三重區,清和里,740,1871,595,355,950,40,990
公投第１１案,新北市,三重區,清和里,741,1663,554,322,876,61,937
公投第１１案,新北市,三重區,永興里,742,1208,449,210,659,25,684
公投第１１案,新北市,三重區,中山里,743,1398,417,288,705,39,744
公投第１１案,新北市,三重區,中山里,744,1078,363,209,572,19,591
公投第１１案,新北市,三重區,大園里,745,1102,383,189,572,41,613
公投第１１案,新北市,三重區,大園里,746,1393,415,296,711,56,767
公投第１１案,新北市,三重區,國隆里,747,1251,448,250,698,45,743
公投第１１案,新北市,三重區,國隆里,748,1234,500,252,752,38,790
公投第１１案,新北市,三重區,重陽里,749,1661,583,337,920,39,959
公投第１１案,新北市,三重區,重陽里,750,1590,565,301,866,45,911
公投第１１案,新北市,三重區,民生里,751,1182,426,241,667,39,706
公投第１１案,新北市,三重區,民生里,752,1369,493,277,770,48,818
公投第１１案,新北市,三重區,民生里,753,1222,456,257,713,45,758
公投第１１案,新北市,三重區,重新里,754,1304,483,242,725,64,789
公投第１１案,新北市,三重區,正德里,755,1054,363,177,540,31,571
公投第１１案,新北市,三重區,正義里,756,1635,565,297,862,63,925
公投第１１案,新北市,三重區,正安里,757,1779,583,315,898,39,937
公投第１１案,新北市,三重區,自強里,758,1633,555,327,882,53,935
公投第１１案,新北市,三重區,文化里,759,1107,403,216,619,27,646
公投第１１案,新北市,三重區,文化里,760,1021,414,198,612,34,646
公投第１１案,新北市,三重區,中央里,761,1649,502,286,788,67,855
公投第１１案,新北市,三重區,雙園里,762,874,313,155,468,30,498
公投第１１案,新北市,三重區,錦通里,763,1402,484,269,753,68,821
公投第１１案,新北市,三重區,錦安里,764,1713,539,280,819,54,873
公投第１１案,新北市,三重區,長安里,765,973,301,165,466,25,491
公投第１１案,新北市,三重區,長安里,766,1038,369,211,580,36,616
公投第１１案,新北市,三重區,光華里,767,1833,556,302,858,91,949
公投第１１案,新北市,三重區,長生里,768,817,255,182,437,28,465
公投第１１案,新北市,三重區,開元里,769,1387,504,276,780,45,825
公投第１１案,新北市,三重區,大德里,770,784,292,168,460,26,486
公投第１１案,新北市,三重區,長元里,771,1096,363,200,563,35,598
公投第１１案,新北市,三重區,長元里,772,1163,409,225,634,54,688
公投第１１案,新北市,三重區,長江里,773,1868,607,331,938,46,984
公投第１１案,新北市,三重區,長泰里,774,1117,379,187,566,50,616
公投第１１案,新北市,三重區,長泰里,775,934,305,164,469,28,497
公投第１１案,新北市,三重區,長福里,776,1412,448,252,700,45,745
公投第１１案,新北市,三重區,介壽里,777,1062,418,226,644,33,677
公投第１１案,新北市,三重區,萬壽里,778,891,312,148,460,51,511
公投第１１案,新北市,三重區,萬壽里,779,936,370,209,579,69,648
公投第１１案,新北市,三重區,錦江里,780,1085,383,168,551,52,603
公投第１１案,新北市,三重區,錦江里,781,1065,307,214,521,22,543
公投第１１案,新北市,三重區,龍濱里,782,1398,485,272,757,45,802
公投第１１案,新北市,三重區,龍濱里,783,1550,570,273,843,35,878
公投第１１案,新北市,三重區,龍門里,784,1674,554,300,854,56,910
公投第１１案,新北市,三重區,秀江里,785,1215,549,212,761,50,811
公投第１１案,新北市,三重區,奕壽里,786,1606,529,309,838,47,885
公投第１１案,新北市,三重區,三安里,787,1182,399,230,629,41,670
公投第１１案,新北市,三重區,三安里,788,1238,421,252,673,60,733
公投第１１案,新北市,三重區,福安里,789,1342,451,293,744,54,798
公投第１１案,新北市,三重區,福安里,790,1408,500,281,781,41,822
公投第１１案,新北市,三重區,信安里,791,1770,596,329,925,70,995
公投第１１案,新北市,三重區,安慶里,792,940,299,204,503,49,552
公投第１１案,新北市,三重區,安慶里,793,975,329,193,522,22,544
公投第１１案,新北市,三重區,幸福里,794,1507,489,283,772,33,805
公投第１１案,新北市,三重區,幸福里,795,1419,482,280,762,51,813
公投第１１案,新北市,三重區,幸福里,796,1257,447,229,676,42,718
公投第１１案,新北市,三重區,六合里,797,1619,568,302,870,46,916
公投第１１案,新北市,三重區,六合里,798,1745,610,287,897,52,949
公投第１１案,新北市,三重區,六福里,799,1519,509,290,799,59,858
公投第１１案,新北市,三重區,六福里,800,1682,543,294,837,52,889
公投第１１案,新北市,三重區,六福里,801,1697,618,332,950,50,1000
公投第１１案,新北市,三重區,順德里,802,1073,353,189,542,38,580
公投第１１案,新北市,三重區,順德里,803,924,322,158,480,30,510
公投第１１案,新北市,三重區,承德里,804,1613,519,249,768,38,806
公投第１１案,新北市,三重區,瑞德里,805,1034,358,166,524,28,552
公投第１１案,新北市,三重區,瑞德里,806,1118,412,198,610,45,655
公投第１１案,新北市,三重區,崇德里,807,1269,451,231,682,49,731
公投第１１案,新北市,三重區,崇德里,808,990,344,171,515,40,555
公投第１１案,新北市,三重區,崇德里,809,1336,491,228,719,45,764
公投第１１案,新北市,三重區,厚德里,810,1601,584,285,869,37,906
公投第１１案,新北市,三重區,厚德里,811,1581,622,296,918,43,961
公投第１１案,新北市,三重區,維德里,812,1345,474,264,738,42,780
公投第１１案,新北市,三重區,維德里,813,1226,457,254,711,41,752
公投第１１案,新北市,三重區,尚德里,814,1650,524,274,798,67,865
公投第１１案,新北市,三重區,尚德里,815,1140,413,209,622,36,658
公投第１１案,新北市,三重區,培德里,816,1639,533,279,812,40,852
公投第１１案,新北市,三重區,培德里,817,1699,600,307,907,47,954
公投第１１案,新北市,三重區,立德里,818,1501,611,331,942,52,994
公投第１１案,新北市,三重區,立德里,819,1538,550,285,835,35,870
公投第１１案,新北市,三重區,永德里,820,1540,503,287,790,57,847
公投第１１案,新北市,三重區,永德里,821,1276,454,220,674,43,717
公投第１１案,新北市,三重區,永德里,822,1539,497,278,775,52,827
公投第１１案,新北市,三重區,永煇里,823,1170,422,253,675,29,704
公投第１１案,新北市,三重區,永煇里,824,1120,367,238,605,33,638
公投第１１案,新北市,三重區,永發里,825,1789,605,357,962,51,1013
公投第１１案,新北市,三重區,永發里,826,1520,360,400,760,55,815
公投第１１案,新北市,三重區,永發里,827,1821,614,346,960,57,1017
公投第１１案,新北市,三重區,永盛里,828,1407,453,292,745,54,799
公投第１１案,新北市,三重區,永盛里,829,1491,505,279,784,48,832
公投第１１案,新北市,三重區,永吉里,830,1381,503,282,785,48,833
公投第１１案,新北市,三重區,永吉里,831,1222,430,238,668,45,713
公投第１１案,新北市,三重區,永安里,832,1938,638,356,994,41,1035
公投第１１案,新北市,三重區,永安里,833,1639,600,285,885,31,916
公投第１１案,新北市,三重區,永豐里,834,1614,534,319,853,59,912
公投第１１案,新北市,三重區,永豐里,835,1709,589,305,894,47,941
公投第１１案,新北市,三重區,永豐里,836,1753,586,281,867,60,927
公投第１１案,新北市,三重區,永福里,837,1398,494,274,768,52,820
公投第１１案,新北市,三重區,永福里,838,1706,549,333,882,46,928
公投第１１案,新北市,三重區,永福里,839,1614,558,320,878,47,925
公投第１１案,新北市,三重區,永清里,840,1591,540,310,850,60,910
公投第１１案,新北市,三重區,永清里,841,1627,558,325,883,41,924
公投第１１案,新北市,三重區,永清里,842,1505,515,288,803,65,868
公投第１１案,新北市,三重區,永順里,843,1331,456,263,719,42,761
公投第１１案,新北市,三重區,永順里,844,1678,515,286,801,41,842
公投第１１案,新北市,三重區,永順里,845,1498,495,318,813,34,847
公投第１１案,新北市,三重區,溪美里,846,1800,632,384,1016,43,1059
公投第１１案,新北市,三重區,溪美里,847,1703,514,295,809,34,843
公投第１１案,新北市,三重區,溪美里,848,1975,605,342,947,40,987
公投第１１案,新北市,三重區,溪美里,849,1894,632,313,945,38,983
公投第１１案,新北市,三重區,福隆里,850,1405,503,282,785,38,823
公投第１１案,新北市,三重區,福隆里,851,1293,468,255,723,29,752
公投第１１案,新北市,三重區,福隆里,852,1259,422,273,695,32,727
公投第１１案,新北市,三重區,五常里,853,1144,440,226,666,45,711
公投第１１案,新北市,三重區,五常里,854,1254,448,269,717,48,765
公投第１１案,新北市,三重區,五常里,855,1313,452,264,716,35,751
公投第１１案,新北市,三重區,五福里,856,1594,491,326,817,56,873
公投第１１案,新北市,三重區,五福里,857,1775,601,317,918,51,969
公投第１１案,新北市,三重區,仁忠里,858,1516,524,259,783,66,849
公投第１１案,新北市,三重區,仁忠里,859,1315,506,270,776,58,834
公投第１１案,新北市,三重區,慈福里,860,843,295,178,473,48,521
公投第１１案,新北市,三重區,慈福里,861,1160,380,187,567,42,609
公投第１１案,新北市,三重區,慈生里,862,1052,408,173,581,39,620
公投第１１案,新北市,三重區,慈生里,863,1054,406,225,631,32,663
公投第１１案,新北市,三重區,慈惠里,864,997,359,197,556,43,599
公投第１１案,新北市,三重區,慈惠里,865,936,304,178,482,32,514
公投第１１案,新北市,三重區,慈愛里,866,1658,565,293,858,53,911
公投第１１案,新北市,三重區,慈愛里,867,1496,495,284,779,41,820
公投第１１案,新北市,三重區,慈化里,868,1064,405,223,628,31,659
公投第１１案,新北市,三重區,慈化里,869,1152,450,216,666,38,704
公投第１１案,新北市,三重區,慈祐里,870,1532,495,274,769,44,813
公投第１１案,新北市,三重區,慈祐里,871,1338,439,201,640,31,671
公投第１１案,新北市,三重區,慈祐里,872,1303,457,249,706,46,752
公投第１１案,新北市,三重區,富華里,873,1369,505,258,763,54,817
公投第１１案,新北市,三重區,富華里,874,1491,525,263,788,46,834
公投第１１案,新北市,三重區,富貴里,875,1821,585,305,890,58,948
公投第１１案,新北市,三重區,富貴里,876,1906,616,309,925,39,964
公投第１１案,新北市,三重區,富貴里,877,1842,656,350,1006,36,1042
公投第１１案,新北市,三重區,富福里,878,878,289,152,441,35,476
公投第１１案,新北市,三重區,富福里,879,963,360,218,578,42,620
公投第１１案,新北市,三重區,五華里,880,1381,425,246,671,26,697
公投第１１案,新北市,三重區,五華里,881,1681,494,279,773,67,840
公投第１１案,新北市,三重區,五華里,882,1548,479,302,781,34,815
公投第１１案,新北市,三重區,碧華里,883,1542,505,346,851,43,894
公投第１１案,新北市,三重區,碧華里,884,1557,510,311,821,49,870
公投第１１案,新北市,三重區,碧華里,885,1661,552,311,863,39,902
公投第１１案,新北市,三重區,碧華里,886,2024,696,373,1069,18,1087
公投第１１案,新北市,三重區,福樂里,887,1588,470,289,759,41,800
公投第１１案,新北市,三重區,福樂里,888,1706,547,303,850,69,919
公投第１１案,新北市,三重區,仁華里,889,1341,485,268,753,36,789
公投第１１案,新北市,三重區,仁華里,890,1025,371,170,541,40,581
公投第１１案,新北市,三重區,仁華里,891,1339,465,254,719,43,762
公投第１１案,新北市,三重區,五順里,892,1725,585,294,879,69,948
公投第１１案,新北市,三重區,五順里,893,1826,582,345,927,65,992
公投第１１案,新北市,板橋區,留侯里,894,1388,449,281,730,47,777
公投第１１案,新北市,板橋區,流芳里,895,1294,439,289,728,31,759
公投第１１案,新北市,板橋區,赤松里,896,667,235,167,402,13,415
公投第１１案,新北市,板橋區,黃石里,897,898,313,156,469,30,499
公投第１１案,新北市,板橋區,挹秀里,898,829,312,164,476,31,507
公投第１１案,新北市,板橋區,挹秀里,899,739,306,136,442,21,463
公投第１１案,新北市,板橋區,湳興里,900,1035,385,215,600,35,635
公投第１１案,新北市,板橋區,湳興里,901,1713,476,308,784,17,801
公投第１１案,新北市,板橋區,湳興里,902,658,228,105,333,15,348
公投第１１案,新北市,板橋區,湳興里,903,1312,452,225,677,60,737
公投第１１案,新北市,板橋區,新興里,904,1492,486,253,739,45,784
公投第１１案,新北市,板橋區,新興里,905,1393,455,234,689,35,724
公投第１１案,新北市,板橋區,社後里,906,4742,535,306,841,29,870
公投第１１案,新北市,板橋區,社後里,907,1439,518,263,781,22,803
公投第１１案,新北市,板橋區,社後里,908,1187,458,227,685,42,727
公投第１１案,新北市,板橋區,社後里,909,1122,409,204,613,30,643
公投第１１案,新北市,板橋區,香社里,910,1363,522,239,761,47,808
公投第１１案,新北市,板橋區,香社里,911,1093,400,221,621,29,650
公投第１１案,新北市,板橋區,香社里,912,1331,477,278,755,40,795
公投第１１案,新北市,板橋區,香雅里,913,1026,394,223,617,24,641
公投第１１案,新北市,板橋區,香雅里,914,1244,447,235,682,48,730
公投第１１案,新北市,板橋區,中正里,915,1268,432,216,648,47,695
公投第１１案,新北市,板橋區,中正里,916,1313,452,233,685,26,711
公投第１１案,新北市,板橋區,中正里,917,1196,431,271,702,32,734
公投第１１案,新北市,板橋區,自強里,918,1137,480,270,750,34,784
公投第１１案,新北市,板橋區,自強里,919,1269,479,303,782,29,811
公投第１１案,新北市,板橋區,自強里,920,1117,420,248,668,28,696
公投第１１案,新北市,板橋區,自強里,921,1042,434,200,634,29,663
公投第１１案,新北市,板橋區,自立里,922,1257,487,220,707,49,756
公投第１１案,新北市,板橋區,自立里,923,1216,462,233,695,30,725
公投第１１案,新北市,板橋區,光華里,924,1126,383,240,623,32,655
公投第１１案,新北市,板橋區,光華里,925,1290,526,273,799,40,839
公投第１１案,新北市,板橋區,光榮里,926,1215,398,228,626,22,648
公投第１１案,新北市,板橋區,光榮里,927,1099,407,201,608,17,625
公投第１１案,新北市,板橋區,國光里,928,1329,570,254,824,23,847
公投第１１案,新北市,板橋區,國光里,929,996,425,166,591,17,608
公投第１１案,新北市,板橋區,國光里,930,1047,390,212,602,29,631
公投第１１案,新北市,板橋區,港尾里,931,1272,506,225,731,39,770
公投第１１案,新北市,板橋區,港尾里,932,1252,483,265,748,2,750
公投第１１案,新北市,板橋區,新生里,933,1238,485,212,697,35,732
公投第１１案,新北市,板橋區,新生里,934,1389,540,295,835,48,883
公投第１１案,新北市,板橋區,新生里,935,1194,467,302,769,33,802
公投第１１案,新北市,板橋區,金華里,936,1093,371,204,575,36,611
公投第１１案,新北市,板橋區,金華里,937,1148,428,198,626,45,671
公投第１１案,新北市,板橋區,金華里,938,1268,482,262,744,34,778
公投第１１案,新北市,板橋區,港德里,939,1230,443,238,681,37,718
公投第１１案,新北市,板橋區,港德里,940,1012,375,172,547,30,577
公投第１１案,新北市,板橋區,港德里,941,811,315,149,464,28,492
公投第１１案,新北市,板橋區,港德里,942,1197,467,252,719,43,762
公投第１１案,新北市,板橋區,民權里,943,1142,442,198,640,18,658
公投第１１案,新北市,板橋區,民權里,944,1222,463,239,702,23,725
公投第１１案,新北市,板橋區,民安里,945,796,327,149,476,34,510
公投第１１案,新北市,板橋區,民安里,946,997,385,211,596,51,647
公投第１１案,新北市,板橋區,建國里,947,1011,370,219,589,32,621
公投第１１案,新北市,板橋區,建國里,948,1157,432,230,662,42,704
公投第１１案,新北市,板橋區,建國里,949,1040,402,200,602,38,640
公投第１１案,新北市,板橋區,漢生里,950,1173,458,237,695,18,713
公投第１１案,新北市,板橋區,漢生里,951,1193,427,221,648,24,672
公投第１１案,新北市,板橋區,漢生里,952,1255,484,251,735,22,757
公投第１１案,新北市,板橋區,公舘里,953,1306,470,282,752,27,779
公投第１１案,新北市,板橋區,公舘里,954,1050,427,189,616,16,632
公投第１１案,新北市,板橋區,公舘里,955,942,362,192,554,14,568
公投第１１案,新北市,板橋區,新民里,956,1133,474,211,685,26,711
公投第１１案,新北市,板橋區,新民里,957,1251,455,256,711,32,743
公投第１１案,新北市,板橋區,新民里,958,1293,504,254,758,27,785
公投第１１案,新北市,板橋區,幸福里,959,1208,418,204,622,43,665
公投第１１案,新北市,板橋區,幸福里,960,1223,437,238,675,43,718
公投第１１案,新北市,板橋區,幸福里,961,1061,360,197,557,47,604
公投第１１案,新北市,板橋區,文德里,962,1515,554,297,851,34,885
公投第１１案,新北市,板橋區,文德里,963,1225,493,233,726,29,755
公投第１１案,新北市,板橋區,忠誠里,964,1120,480,219,699,21,720
公投第１１案,新北市,板橋區,忠誠里,965,1091,437,224,661,32,693
公投第１１案,新北市,板橋區,忠誠里,966,1385,598,232,830,23,853
公投第１１案,新北市,板橋區,陽明里,967,1283,512,244,756,40,796
公投第１１案,新北市,板橋區,陽明里,968,1204,451,231,682,41,723
公投第１１案,新北市,板橋區,百壽里,969,1191,493,241,734,30,764
公投第１１案,新北市,板橋區,百壽里,970,1078,443,207,650,39,689
公投第１１案,新北市,板橋區,介壽里,971,1351,534,241,775,31,806
公投第１１案,新北市,板橋區,介壽里,972,1322,503,247,750,32,782
公投第１１案,新北市,板橋區,新埔里,973,868,330,169,499,27,526
公投第１１案,新北市,板橋區,新埔里,974,1029,436,221,657,34,691
公投第１１案,新北市,板橋區,華江里,975,1602,588,339,927,27,954
公投第１１案,新北市,板橋區,華江里,976,1362,535,241,776,35,811
公投第１１案,新北市,板橋區,華江里,977,1698,588,330,918,43,961
公投第１１案,新北市,板橋區,華江里,978,1495,523,309,832,21,853
公投第１１案,新北市,板橋區,江翠里,979,1522,519,290,809,40,849
公投第１１案,新北市,板橋區,江翠里,980,1279,251,464,715,41,756
公投第１１案,新北市,板橋區,江翠里,981,1559,481,266,747,27,774
公投第１１案,新北市,板橋區,純翠里,982,1537,498,281,779,50,829
公投第１１案,新北市,板橋區,純翠里,983,1531,481,283,764,43,807
公投第１１案,新北市,板橋區,純翠里,984,1720,566,243,809,24,833
公投第１１案,新北市,板橋區,溪頭里,985,1165,415,212,627,24,651
公投第１１案,新北市,板橋區,溪頭里,986,1857,657,379,1036,38,1074
公投第１１案,新北市,板橋區,溪頭里,987,1078,385,201,586,37,623
公投第１１案,新北市,板橋區,溪頭里,988,1177,414,212,626,20,646
公投第１１案,新北市,板橋區,聯翠里,989,1798,657,354,1011,39,1050
公投第１１案,新北市,板橋區,聯翠里,990,1455,545,286,831,51,882
公投第１１案,新北市,板橋區,文化里,991,1245,476,251,727,41,768
公投第１１案,新北市,板橋區,文化里,992,1704,549,350,899,41,940
公投第１１案,新北市,板橋區,宏翠里,993,1600,537,354,891,21,912
公投第１１案,新北市,板橋區,宏翠里,994,1409,525,324,849,8,857
公投第１１案,新北市,板橋區,宏翠里,995,1286,478,232,710,33,743
公投第１１案,新北市,板橋區,仁翠里,996,1359,408,187,595,77,672
公投第１１案,新北市,板橋區,仁翠里,997,1188,381,220,601,30,631
公投第１１案,新北市,板橋區,新翠里,998,1627,574,289,863,39,902
公投第１１案,新北市,板橋區,新翠里,999,1633,525,300,825,29,854
公投第１１案,新北市,板橋區,新翠里,1000,1814,642,405,1047,35,1082
公投第１１案,新北市,板橋區,新翠里,1001,1810,703,341,1044,41,1085
公投第１１案,新北市,板橋區,朝陽里,1002,1133,419,210,629,37,666
公投第１１案,新北市,板橋區,朝陽里,1003,841,349,150,499,16,515
公投第１１案,新北市,板橋區,朝陽里,1004,1050,432,201,633,26,659
公投第１１案,新北市,板橋區,吉翠里,1005,1130,407,209,616,33,649
公投第１１案,新北市,板橋區,吉翠里,1006,1056,402,225,627,34,661
公投第１１案,新北市,板橋區,吉翠里,1007,1129,395,200,595,28,623
公投第１１案,新北市,板橋區,德翠里,1008,1713,664,294,958,44,1002
公投第１１案,新北市,板橋區,德翠里,1009,1622,595,321,916,38,954
公投第１１案,新北市,板橋區,德翠里,1010,1427,544,315,859,39,898
公投第１１案,新北市,板橋區,德翠里,1011,1471,598,311,909,17,926
公投第１１案,新北市,板橋區,新海里,1012,1076,363,220,583,15,598
公投第１１案,新北市,板橋區,新海里,1013,979,352,165,517,11,528
公投第１１案,新北市,板橋區,新海里,1014,1079,471,206,677,18,695
公投第１１案,新北市,板橋區,滿翠里,1015,828,315,149,464,13,477
公投第１１案,新北市,板橋區,滿翠里,1016,820,317,164,481,38,519
公投第１１案,新北市,板橋區,滿翠里,1017,989,402,199,601,23,624
公投第１１案,新北市,板橋區,明翠里,1018,1023,362,200,562,39,601
公投第１１案,新北市,板橋區,明翠里,1019,1044,388,193,581,26,607
公投第１１案,新北市,板橋區,明翠里,1020,968,380,167,547,30,577
公投第１１案,新北市,板橋區,明翠里,1021,1222,445,257,702,22,724
公投第１１案,新北市,板橋區,松翠里,1022,1385,484,264,748,35,783
公投第１１案,新北市,板橋區,松翠里,1023,1585,550,300,850,44,894
公投第１１案,新北市,板橋區,柏翠里,1024,1840,647,340,987,50,1037
公投第１１案,新北市,板橋區,柏翠里,1025,1806,737,350,1087,44,1131
公投第１１案,新北市,板橋區,龍翠里,1026,1506,535,276,811,52,863
公投第１１案,新北市,板橋區,龍翠里,1027,1476,526,257,783,44,827
公投第１１案,新北市,板橋區,龍翠里,1028,1500,537,302,839,44,883
公投第１１案,新北市,板橋區,松柏里,1029,1096,429,222,651,43,694
公投第１１案,新北市,板橋區,松柏里,1030,963,390,179,569,35,604
公投第１１案,新北市,板橋區,華翠里,1031,1601,582,299,881,31,912
公投第１１案,新北市,板橋區,華翠里,1032,1507,583,325,908,48,956
公投第１１案,新北市,板橋區,莒光里,1033,1315,502,262,764,54,818
公投第１１案,新北市,板橋區,莒光里,1034,1178,437,223,660,27,687
公投第１１案,新北市,板橋區,忠翠里,1035,1822,689,358,1047,51,1098
公投第１１案,新北市,板橋區,忠翠里,1036,1605,626,334,960,38,998
公投第１１案,新北市,板橋區,忠翠里,1037,1549,582,309,891,26,917
公投第１１案,新北市,板橋區,忠翠里,1038,1948,717,426,1143,19,1162
公投第１１案,新北市,板橋區,忠翠里,1039,1935,693,384,1077,22,1099
公投第１１案,新北市,板橋區,嵐翠里,1040,1097,397,175,572,41,613
公投第１１案,新北市,板橋區,嵐翠里,1041,1095,388,199,587,20,607
公投第１１案,新北市,板橋區,文聖里,1042,1678,530,287,817,60,877
公投第１１案,新北市,板橋區,文聖里,1043,1750,626,295,921,45,966
公投第１１案,新北市,板橋區,文翠里,1044,1187,415,215,630,35,665
公投第１１案,新北市,板橋區,文翠里,1045,1154,429,241,670,24,694
公投第１１案,新北市,板橋區,文翠里,1046,1262,487,275,762,20,782
公投第１１案,新北市,板橋區,青翠里,1047,1271,463,212,675,45,720
公投第１１案,新北市,板橋區,青翠里,1048,1410,502,257,759,45,804
公投第１１案,新北市,板橋區,懷翠里,1049,1745,562,305,867,58,925
公投第１１案,新北市,板橋區,懷翠里,1050,1867,663,332,995,66,1061
公投第１１案,新北市,板橋區,懷翠里,1051,1753,680,301,981,57,1038
公投第１１案,新北市,板橋區,福翠里,1052,1204,418,254,672,52,724
公投第１１案,新北市,板橋區,港嘴里,1053,1614,571,324,895,44,939
公投第１１案,新北市,板橋區,港嘴里,1054,1237,452,258,710,32,742
公投第１１案,新北市,板橋區,港嘴里,1055,1361,481,294,775,39,814
公投第１１案,新北市,板橋區,港嘴里,1056,1243,422,280,702,26,728
公投第１１案,新北市,板橋區,振興里,1057,1515,492,280,772,31,803
公投第１１案,新北市,板橋區,振興里,1058,1515,314,546,860,51,911
公投第１１案,新北市,板橋區,振興里,1059,949,386,159,545,41,586
公投第１１案,新北市,板橋區,振義里,1060,1629,562,295,857,43,900
公投第１１案,新北市,板橋區,振義里,1061,1238,437,250,687,31,718
公投第１１案,新北市,板橋區,振義里,1062,901,260,118,378,15,393
公投第１１案,新北市,板橋區,光復里,1063,1475,498,290,788,79,867
公投第１１案,新北市,板橋區,光復里,1064,1481,522,265,787,50,837
公投第１１案,新北市,板橋區,埔墘里,1065,1800,566,317,883,79,962
公投第１１案,新北市,板橋區,埔墘里,1066,1630,583,281,864,48,912
公投第１１案,新北市,板橋區,埔墘里,1067,1298,495,265,760,17,777
公投第１１案,新北市,板橋區,埔墘里,1068,874,315,187,502,26,528
公投第１１案,新北市,板橋區,富貴里,1069,992,370,199,569,17,586
公投第１１案,新北市,板橋區,富貴里,1070,1034,432,231,663,19,682
公投第１１案,新北市,板橋區,長壽里,1071,1451,506,304,810,44,854
公投第１１案,新北市,板橋區,長壽里,1072,1130,418,251,669,33,702
公投第１１案,新北市,板橋區,福壽里,1073,1440,554,270,824,23,847
公投第１１案,新北市,板橋區,福壽里,1074,1531,560,292,852,56,908
公投第１１案,新北市,板橋區,居仁里,1075,1349,531,299,830,41,871
公投第１１案,新北市,板橋區,居仁里,1076,1593,536,285,821,48,869
公投第１１案,新北市,板橋區,海山里,1077,1174,451,223,674,20,694
公投第１１案,新北市,板橋區,海山里,1078,1228,497,201,698,28,726
公投第１１案,新北市,板橋區,海山里,1079,1187,441,255,696,26,722
公投第１１案,新北市,板橋區,海山里,1080,870,337,167,504,34,538
公投第１１案,新北市,板橋區,海山里,1081,2033,750,450,1200,28,1228
公投第１１案,新北市,板橋區,九如里,1082,1418,470,264,734,37,771
公投第１１案,新北市,板橋區,九如里,1083,1075,425,197,622,30,652
公投第１１案,新北市,板橋區,正泰里,1084,1515,500,300,800,37,837
公投第１１案,新北市,板橋區,正泰里,1085,1182,516,227,743,28,771
公投第１１案,新北市,板橋區,玉光里,1086,1893,625,374,999,56,1055
公投第１１案,新北市,板橋區,玉光里,1087,1302,459,241,700,31,731
公投第１１案,新北市,板橋區,玉光里,1088,1366,452,241,693,29,722
公投第１１案,新北市,板橋區,光仁里,1089,1318,516,265,781,43,824
公投第１１案,新北市,板橋區,光仁里,1090,1200,419,239,658,29,687
公投第１１案,新北市,板橋區,埤墘里,1091,2028,672,443,1115,27,1142
公投第１１案,新北市,板橋區,埤墘里,1092,1746,660,320,980,46,1026
公投第１１案,新北市,板橋區,莊敬里,1093,1954,625,353,978,25,1003
公投第１１案,新北市,板橋區,莊敬里,1094,1474,505,295,800,32,832
公投第１１案,新北市,板橋區,永安里,1095,1418,545,248,793,31,824
公投第１１案,新北市,板橋區,永安里,1096,1563,611,334,945,40,985
公投第１１案,新北市,板橋區,雙玉里,1097,1780,642,293,935,54,989
公投第１１案,新北市,板橋區,雙玉里,1098,1707,572,352,924,38,962
公投第１１案,新北市,板橋區,廣新里,1099,906,252,122,374,10,384
公投第１１案,新北市,板橋區,廣新里,1100,1030,358,207,565,33,598
公投第１１案,新北市,板橋區,廣新里,1101,1115,383,225,608,37,645
公投第１１案,新北市,板橋區,深丘里,1102,1836,662,328,990,25,1015
公投第１１案,新北市,板橋區,深丘里,1103,1881,644,347,991,56,1047
公投第１１案,新北市,板橋區,深丘里,1104,1688,565,338,903,59,962
公投第１１案,新北市,板橋區,深丘里,1105,1760,645,369,1014,23,1037
公投第１１案,新北市,板橋區,香丘里,1106,1044,409,211,620,35,655
公投第１１案,新北市,板橋區,香丘里,1107,1043,420,213,633,28,661
公投第１１案,新北市,板橋區,香丘里,1108,1099,433,216,649,46,695
公投第１１案,新北市,板橋區,西安里,1109,1260,452,240,692,39,731
公投第１１案,新北市,板橋區,西安里,1110,1131,434,201,635,28,663
公投第１１案,新北市,板橋區,東丘里,1111,1225,462,223,685,36,721
公投第１１案,新北市,板橋區,東丘里,1112,1455,579,305,884,37,921
公投第１１案,新北市,板橋區,東丘里,1113,1267,485,219,704,24,728
公投第１１案,新北市,板橋區,民生里,1114,972,371,192,563,28,591
公投第１１案,新北市,板橋區,民生里,1115,994,381,198,579,26,605
公投第１１案,新北市,板橋區,長安里,1116,1111,421,222,643,10,653
公投第１１案,新北市,板橋區,長安里,1117,1177,509,232,741,39,780
公投第１１案,新北市,板橋區,長安里,1118,1544,538,286,824,35,859
公投第１１案,新北市,板橋區,東安里,1119,1021,378,176,554,47,601
公投第１１案,新北市,板橋區,東安里,1120,1040,388,168,556,40,596
公投第１１案,新北市,板橋區,福丘里,1121,1504,505,297,802,23,825
公投第１１案,新北市,板橋區,福丘里,1122,1373,463,253,716,29,745
公投第１１案,新北市,板橋區,福丘里,1123,1210,449,260,709,16,725
公投第１１案,新北市,板橋區,福祿里,1124,1809,605,322,927,38,965
公投第１１案,新北市,板橋區,福祿里,1125,1551,592,262,854,63,917
公投第１１案,新北市,板橋區,民族里,1126,1408,520,277,797,24,821
公投第１１案,新北市,板橋區,民族里,1127,1285,502,265,767,18,785
公投第１１案,新北市,板橋區,民族里,1128,1102,471,225,696,21,717
公投第１１案,新北市,板橋區,國泰里,1129,1399,496,239,735,17,752
公投第１１案,新北市,板橋區,國泰里,1130,1692,624,283,907,57,964
公投第１１案,新北市,板橋區,後埔里,1131,1625,630,341,971,30,1001
公投第１１案,新北市,板橋區,後埔里,1132,1712,617,459,1076,47,1123
公投第１１案,新北市,板橋區,福德里,1133,1246,460,238,698,30,728
公投第１１案,新北市,板橋區,福德里,1134,1471,560,285,845,34,879
公投第１１案,新北市,板橋區,福德里,1135,1761,709,284,993,44,1037
公投第１１案,新北市,板橋區,景星里,1136,1499,537,297,834,33,867
公投第１１案,新北市,板橋區,景星里,1137,1528,489,284,773,37,810
公投第１１案,新北市,板橋區,福星里,1138,1536,566,307,873,44,917
公投第１１案,新北市,板橋區,福星里,1139,1550,569,310,879,30,909
公投第１１案,新北市,板橋區,鄉雲里,1140,2050,708,404,1112,69,1181
公投第１１案,新北市,板橋區,鄉雲里,1141,1300,486,249,735,37,772
公投第１１案,新北市,板橋區,廣德里,1142,1537,565,233,798,35,833
公投第１１案,新北市,板橋區,廣德里,1143,1341,475,237,712,24,736
公投第１１案,新北市,板橋區,廣德里,1144,1606,551,345,896,22,918
公投第１１案,新北市,板橋區,廣德里,1145,1433,496,247,743,28,771
公投第１１案,新北市,板橋區,大豐里,1146,1685,590,290,880,29,909
公投第１１案,新北市,板橋區,大豐里,1147,1248,486,244,730,44,774
公投第１１案,新北市,板橋區,大豐里,1148,1172,434,198,632,28,660
公投第１１案,新北市,板橋區,重慶里,1149,1640,504,298,802,26,828
公投第１１案,新北市,板橋區,重慶里,1150,1428,543,261,804,26,830
公投第１１案,新北市,板橋區,重慶里,1151,1527,527,312,839,42,881
公投第１１案,新北市,板橋區,重慶里,1152,1350,503,260,763,32,795
公投第１１案,新北市,板橋區,重慶里,1153,1582,574,275,849,45,894
公投第１１案,新北市,板橋區,仁愛里,1154,919,391,185,576,28,604
公投第１１案,新北市,板橋區,仁愛里,1155,930,379,167,546,22,568
公投第１１案,新北市,板橋區,仁愛里,1156,974,427,183,610,20,630
公投第１１案,新北市,板橋區,和平里,1157,1732,657,314,971,32,1003
公投第１１案,新北市,板橋區,和平里,1158,1438,499,261,760,35,795
公投第１１案,新北市,板橋區,廣福里,1159,1777,587,334,921,54,975
公投第１１案,新北市,板橋區,廣福里,1160,1764,578,278,856,28,884
公投第１１案,新北市,板橋區,五權里,1161,1289,483,246,729,20,749
公投第１１案,新北市,板橋區,五權里,1162,1182,463,209,672,32,704
公投第１１案,新北市,板橋區,五權里,1163,1174,455,224,679,28,707
公投第１１案,新北市,板橋區,華興里,1164,1870,622,329,951,60,1011
公投第１１案,新北市,板橋區,華興里,1165,1842,666,377,1043,36,1079
公投第１１案,新北市,板橋區,華貴里,1166,1094,399,212,611,35,646
公投第１１案,新北市,板橋區,華貴里,1167,1228,431,217,648,31,679
公投第１１案,新北市,板橋區,華福里,1168,998,438,212,650,24,674
公投第１１案,新北市,板橋區,華福里,1169,862,359,197,556,15,571
公投第１１案,新北市,板橋區,華德里,1170,1622,520,294,814,34,848
公投第１１案,新北市,板橋區,華德里,1171,1205,496,206,702,24,726
公投第１１案,新北市,板橋區,華德里,1172,1787,575,305,880,41,921
公投第１１案,新北市,板橋區,華德里,1173,1610,565,331,896,28,924
公投第１１案,新北市,板橋區,華東里,1174,2216,803,483,1286,32,1318
公投第１１案,新北市,板橋區,華東里,1175,2294,759,467,1226,44,1270
公投第１１案,新北市,板橋區,華東里,1176,2090,744,347,1091,50,1141
公投第１１案,新北市,板橋區,信義里,1177,1356,437,221,658,17,675
公投第１１案,新北市,板橋區,信義里,1178,1067,402,213,615,29,644
公投第１１案,新北市,板橋區,信義里,1179,1319,481,245,726,28,754
公投第１１案,新北市,板橋區,浮洲里,1180,1316,476,240,716,31,747
公投第１１案,新北市,板橋區,浮洲里,1181,1195,427,186,613,40,653
公投第１１案,新北市,板橋區,浮洲里,1182,857,312,174,486,15,501
公投第１１案,新北市,板橋區,華中里,1183,1417,473,257,730,44,774
公投第１１案,新北市,板橋區,華中里,1184,1560,549,302,851,60,911
公投第１１案,新北市,板橋區,華中里,1185,1747,599,350,949,59,1008
公投第１１案,新北市,板橋區,僑中里,1186,1176,485,237,722,40,762
公投第１１案,新北市,板橋區,僑中里,1187,1101,397,238,635,19,654
公投第１１案,新北市,板橋區,僑中里,1188,1458,555,287,842,21,863
公投第１１案,新北市,板橋區,大觀里,1189,1630,533,264,797,34,831
公投第１１案,新北市,板橋區,大觀里,1190,1611,537,285,822,66,888
公投第１１案,新北市,板橋區,歡園里,1191,1139,407,197,604,27,631
公投第１１案,新北市,板橋區,中山里,1192,1120,406,202,608,21,629
公投第１１案,新北市,板橋區,中山里,1193,1022,391,197,588,66,654
公投第１１案,新北市,板橋區,中山里,1194,1049,381,210,591,53,644
公投第１１案,新北市,板橋區,中山里,1195,1007,385,178,563,19,582
公投第１１案,新北市,板橋區,中山里,1196,1393,521,242,763,31,794
公投第１１案,新北市,板橋區,復興里,1197,474,100,57,157,42,199
公投第１１案,新北市,板橋區,復興里,1198,500,162,116,278,24,302
公投第１１案,新北市,板橋區,大安里,1199,1177,417,233,650,34,684
公投第１１案,新北市,板橋區,大安里,1200,1186,466,198,664,30,694
公投第１１案,新北市,板橋區,大安里,1201,1139,435,236,671,35,706
公投第１１案,新北市,板橋區,福安里,1202,1750,634,297,931,38,969
公投第１１案,新北市,板橋區,福安里,1203,3451,787,387,1174,33,1207
公投第１１案,新北市,板橋區,聚安里,1204,1620,569,263,832,46,878
公投第１１案,新北市,板橋區,聚安里,1205,903,300,156,456,17,473
公投第１１案,新北市,板橋區,聚安里,1206,1232,459,232,691,31,722
公投第１１案,新北市,板橋區,聚安里,1207,975,311,178,489,15,504
公投第１１案,新北市,板橋區,龍安里,1208,1224,471,187,658,33,691
公投第１１案,新北市,板橋區,龍安里,1209,1291,484,229,713,32,745
公投第１１案,新北市,板橋區,崑崙里,1210,1828,669,322,991,40,1031
公投第１１案,新北市,板橋區,崑崙里,1211,1725,537,316,853,34,887
公投第１１案,新北市,板橋區,崑崙里,1212,1085,346,193,539,17,556
公投第１１案,新北市,板橋區,崑崙里,1213,2357,761,421,1182,52,1234
公投第１１案,新北市,板橋區,崑崙里,1214,1560,525,89,614,28,642
公投第１１案,新北市,板橋區,成和里,1215,2201,623,333,956,32,988
公投第１１案,新北市,板橋區,成和里,1216,1626,569,275,844,28,872
公投第１１案,新北市,板橋區,成和里,1217,1786,542,257,799,24,823
公投第１１案,新北市,板橋區,溪洲里,1218,1763,625,305,930,36,966
公投第１１案,新北市,板橋區,溪洲里,1219,1744,491,311,802,24,826
公投第１１案,新北市,板橋區,溪洲里,1220,1645,563,291,854,38,892
公投第１１案,新北市,板橋區,溪福里,1221,1861,604,315,919,18,937
公投第１１案,新北市,板橋區,溪福里,1222,1596,496,251,747,33,780
公投第１１案,新北市,板橋區,溪福里,1223,1871,627,335,962,50,1012
公投第１１案,新北市,板橋區,溪福里,1224,1938,673,342,1015,45,1060
公投第１１案,新北市,板橋區,溪福里,1225,1827,641,340,981,30,1011
公投第１１案,新北市,板橋區,溪福里,1226,1359,471,235,706,17,723
公投第１１案,新北市,板橋區,溪福里,1227,1613,571,287,858,36,894
公投第１１案,新北市,板橋區,溪北里,1228,1566,690,267,957,34,991
公投第１１案,新北市,板橋區,溪北里,1229,1552,602,327,929,31,960
公投第１１案,新北市,板橋區,堂春里,1230,1885,627,360,987,20,1007
公投第１１案,新北市,板橋區,堂春里,1231,1893,611,362,973,34,1007
公投第１１案,新北市,中和區,中原里,1232,1630,506,294,800,44,844
公投第１１案,新北市,中和區,中原里,1233,1775,607,340,947,44,991
公投第１１案,新北市,中和區,中原里,1234,1844,603,314,917,23,940
公投第１１案,新北市,中和區,連和里,1235,1019,398,229,627,15,642
公投第１１案,新北市,中和區,連和里,1236,1138,461,208,669,23,692
公投第１１案,新北市,中和區,連城里,1237,1878,638,300,938,34,972
公投第１１案,新北市,中和區,連城里,1238,1980,825,273,1098,33,1131
公投第１１案,新北市,中和區,連城里,1239,1844,652,333,985,44,1029
公投第１１案,新北市,中和區,力行里,1240,2085,734,395,1129,14,1143
公投第１１案,新北市,中和區,力行里,1241,1498,561,236,797,36,833
公投第１１案,新北市,中和區,力行里,1242,1761,605,333,938,28,966
公投第１１案,新北市,中和區,正行里,1243,1254,418,240,658,28,686
公投第１１案,新北市,中和區,正行里,1244,1343,505,259,764,27,791
公投第１１案,新北市,中和區,德行里,1245,1789,609,365,974,26,1000
公投第１１案,新北市,中和區,德行里,1246,2000,658,428,1086,31,1117
公投第１１案,新北市,中和區,德行里,1247,1953,557,382,939,37,976
公投第１１案,新北市,中和區,枋寮里,1248,1712,584,331,915,47,962
公投第１１案,新北市,中和區,枋寮里,1249,1582,615,254,869,41,910
公投第１１案,新北市,中和區,漳和里,1250,1742,615,306,921,47,968
公投第１１案,新北市,中和區,漳和里,1251,1493,578,304,882,42,924
公投第１１案,新北市,中和區,廟美里,1252,1352,451,234,685,27,712
公投第１１案,新北市,中和區,廟美里,1253,1244,505,208,713,27,740
公投第１１案,新北市,中和區,廟美里,1254,1394,511,255,766,47,813
公投第１１案,新北市,中和區,福真里,1255,1917,527,326,853,24,877
公投第１１案,新北市,中和區,福真里,1256,1830,601,315,916,48,964
公投第１１案,新北市,中和區,福善里,1257,1124,409,226,635,28,663
公投第１１案,新北市,中和區,福善里,1258,1412,448,245,693,34,727
公投第１１案,新北市,中和區,福善里,1259,1356,473,243,716,36,752
公投第１１案,新北市,中和區,福美里,1260,1425,496,236,732,19,751
公投第１１案,新北市,中和區,福美里,1261,1259,485,241,726,34,760
公投第１１案,新北市,中和區,福美里,1262,1256,454,241,695,41,736
公投第１１案,新北市,中和區,福祥里,1263,1423,526,250,776,25,801
公投第１１案,新北市,中和區,福祥里,1264,1221,459,228,687,35,722
公投第１１案,新北市,中和區,福祥里,1265,1858,574,333,907,43,950
公投第１１案,新北市,中和區,瓦磘里,1266,1804,581,338,919,33,952
公投第１１案,新北市,中和區,瓦磘里,1267,1669,590,353,943,23,966
公投第１１案,新北市,中和區,瓦磘里,1268,1485,546,267,813,26,839
公投第１１案,新北市,中和區,福和里,1269,1005,389,189,578,32,610
公投第１１案,新北市,中和區,福和里,1270,1175,437,267,704,41,745
公投第１１案,新北市,中和區,福和里,1271,1171,441,223,664,28,692
公投第１１案,新北市,中和區,佳和里,1272,1746,568,286,854,36,890
公投第１１案,新北市,中和區,佳和里,1273,1555,479,273,752,24,776
公投第１１案,新北市,中和區,佳和里,1274,1112,385,209,594,40,634
公投第１１案,新北市,中和區,新南里,1275,1780,658,364,1022,38,1060
公投第１１案,新北市,中和區,新南里,1276,1918,664,375,1039,23,1062
公投第１１案,新北市,中和區,新南里,1277,1689,479,259,738,27,765
公投第１１案,新北市,中和區,新南里,1278,1781,629,360,989,22,1011
公投第１１案,新北市,中和區,南山里,1279,1419,506,269,775,28,803
公投第１１案,新北市,中和區,南山里,1280,1344,469,236,705,27,732
公投第１１案,新北市,中和區,南山里,1281,1804,709,369,1078,49,1127
公投第１１案,新北市,中和區,平河里,1282,1788,572,333,905,56,961
公投第１１案,新北市,中和區,平河里,1283,1793,637,341,978,29,1007
公投第１１案,新北市,中和區,平河里,1284,1352,485,258,743,36,779
公投第１１案,新北市,中和區,平河里,1285,1813,649,353,1002,39,1041
公投第１１案,新北市,中和區,平河里,1286,1288,525,268,793,21,814
公投第１１案,新北市,中和區,信和里,1287,1186,415,229,644,41,685
公投第１１案,新北市,中和區,信和里,1288,1237,469,199,668,13,681
公投第１１案,新北市,中和區,信和里,1289,1406,519,246,765,35,800
公投第１１案,新北市,中和區,仁和里,1290,1442,499,272,771,36,807
公投第１１案,新北市,中和區,仁和里,1291,1040,385,230,615,30,645
公投第１１案,新北市,中和區,仁和里,1292,1292,515,233,748,36,784
公投第１１案,新北市,中和區,中正里,1293,1811,653,304,957,37,994
公投第１１案,新北市,中和區,中正里,1294,1789,696,309,1005,50,1055
公投第１１案,新北市,中和區,建和里,1295,859,378,154,532,27,559
公投第１１案,新北市,中和區,建和里,1296,972,437,166,603,23,626
公投第１１案,新北市,中和區,建和里,1297,1346,497,256,753,22,775
公投第１１案,新北市,中和區,中山里,1298,1034,385,212,597,27,624
公投第１１案,新北市,中和區,中山里,1299,1387,512,259,771,35,806
公投第１１案,新北市,中和區,碧河里,1300,2067,750,367,1117,64,1181
公投第１１案,新北市,中和區,碧河里,1301,1670,494,285,779,26,805
公投第１１案,新北市,中和區,正南里,1302,1166,459,177,636,27,663
公投第１１案,新北市,中和區,正南里,1303,963,371,175,546,28,574
公投第１１案,新北市,中和區,正南里,1304,1070,384,164,548,33,581
公投第１１案,新北市,中和區,頂南里,1305,1319,465,214,679,29,708
公投第１１案,新北市,中和區,頂南里,1306,1438,566,272,838,40,878
公投第１１案,新北市,中和區,華新里,1307,1808,632,288,920,18,938
公投第１１案,新北市,中和區,華新里,1308,1191,451,173,624,15,639
公投第１１案,新北市,中和區,華新里,1309,1632,617,250,867,41,908
公投第１１案,新北市,中和區,華新里,1310,1765,599,278,877,28,905
公投第１１案,新北市,中和區,東南里,1311,1168,487,188,675,26,701
公投第１１案,新北市,中和區,東南里,1312,1176,460,175,635,24,659
公投第１１案,新北市,中和區,東南里,1313,1565,674,279,953,40,993
公投第１１案,新北市,中和區,華南里,1314,1578,538,228,766,42,808
公投第１１案,新北市,中和區,華南里,1315,2029,701,379,1080,29,1109
公投第１１案,新北市,中和區,華南里,1316,905,327,169,496,29,525
公投第１１案,新北市,中和區,忠孝里,1317,839,303,116,419,24,443
公投第１１案,新北市,中和區,忠孝里,1318,762,296,142,438,16,454
公投第１１案,新北市,中和區,忠孝里,1319,1420,536,230,766,38,804
公投第１１案,新北市,中和區,忠孝里,1320,1272,453,203,656,42,698
公投第１１案,新北市,中和區,崇南里,1321,1976,674,312,986,51,1037
公投第１１案,新北市,中和區,崇南里,1322,1779,636,298,934,29,963
公投第１１案,新北市,中和區,興南里,1323,1454,439,228,667,21,688
公投第１１案,新北市,中和區,興南里,1324,1374,505,198,703,31,734
公投第１１案,新北市,中和區,景南里,1325,1369,455,220,675,23,698
公投第１１案,新北市,中和區,景南里,1326,1501,536,267,803,29,832
公投第１１案,新北市,中和區,景本里,1327,920,407,170,577,26,603
公投第１１案,新北市,中和區,景本里,1328,1050,439,183,622,34,656
公投第１１案,新北市,中和區,橫路里,1329,321,128,51,179,18,197
公投第１１案,新北市,中和區,內南里,1330,1474,513,225,738,50,788
公投第１１案,新北市,中和區,內南里,1331,1461,531,251,782,57,839
公投第１１案,新北市,中和區,內南里,1332,1621,568,276,844,39,883
公投第１１案,新北市,中和區,壽南里,1333,1327,532,247,779,44,823
公投第１１案,新北市,中和區,壽南里,1334,775,314,121,435,18,453
公投第１１案,新北市,中和區,福南里,1335,1916,610,335,945,23,968
公投第１１案,新北市,中和區,福南里,1336,1901,602,303,905,54,959
公投第１１案,新北市,中和區,外南里,1337,4411,515,254,769,30,799
公投第１１案,新北市,中和區,外南里,1338,1212,450,200,650,30,680
公投第１１案,新北市,中和區,外南里,1339,1126,428,205,633,14,647
公投第１１案,新北市,中和區,中興里,1340,1507,548,257,805,24,829
公投第１１案,新北市,中和區,中興里,1341,1519,546,288,834,19,853
公投第１１案,新北市,中和區,中興里,1342,1467,534,283,817,27,844
公投第１１案,新北市,中和區,中興里,1343,1453,574,269,843,45,888
公投第１１案,新北市,中和區,吉興里,1344,1364,532,264,796,30,826
公投第１１案,新北市,中和區,吉興里,1345,1302,472,237,709,29,738
公投第１１案,新北市,中和區,復興里,1346,1627,491,229,720,28,748
公投第１１案,新北市,中和區,復興里,1347,1503,530,255,785,27,812
公投第１１案,新北市,中和區,復興里,1348,1392,517,226,743,18,761
公投第１１案,新北市,中和區,和興里,1349,1067,409,205,614,24,638
公投第１１案,新北市,中和區,和興里,1350,1623,561,273,834,28,862
公投第１１案,新北市,中和區,和興里,1351,1208,435,257,692,14,706
公投第１１案,新北市,中和區,景平里,1352,1991,588,278,866,26,892
公投第１１案,新北市,中和區,景平里,1353,1932,596,288,884,23,907
公投第１１案,新北市,中和區,景平里,1354,947,385,220,605,11,616
公投第１１案,新北市,中和區,景新里,1355,1660,626,298,924,36,960
公投第１１案,新北市,中和區,景新里,1356,1574,530,228,758,28,786
公投第１１案,新北市,中和區,景福里,1357,2136,797,250,1047,39,1086
公投第１１案,新北市,中和區,景福里,1358,1462,495,242,737,50,787
公投第１１案,新北市,中和區,景福里,1359,1548,549,229,778,40,818
公投第１１案,新北市,中和區,景安里,1360,692,303,137,440,17,457
公投第１１案,新北市,中和區,景安里,1361,1221,485,248,733,35,768
公投第１１案,新北市,中和區,景安里,1362,1331,477,274,751,37,788
公投第１１案,新北市,中和區,景安里,1363,984,413,193,606,24,630
公投第１１案,新北市,中和區,景文里,1364,1871,607,310,917,29,946
公投第１１案,新北市,中和區,景文里,1365,1279,483,224,707,3,710
公投第１１案,新北市,中和區,錦和里,1366,1629,585,314,899,27,926
公投第１１案,新北市,中和區,錦和里,1367,1482,519,307,826,24,850
公投第１１案,新北市,中和區,錦和里,1368,1715,655,304,959,42,1001
公投第１１案,新北市,中和區,錦昌里,1369,1952,753,296,1049,48,1097
公投第１１案,新北市,中和區,灰磘里,1370,686,228,152,380,23,403
公投第１１案,新北市,中和區,積穗里,1371,1577,457,303,760,23,783
公投第１１案,新北市,中和區,積穗里,1372,1158,433,232,665,24,689
公投第１１案,新北市,中和區,積穗里,1373,1195,481,254,735,19,754
公投第１１案,新北市,中和區,積穗里,1374,1054,441,214,655,20,675
公投第１１案,新北市,中和區,積穗里,1375,612,255,126,381,18,399
公投第１１案,新北市,中和區,積穗里,1376,1668,632,313,945,20,965
公投第１１案,新北市,中和區,民享里,1377,1071,443,208,651,35,686
公投第１１案,新北市,中和區,民享里,1378,1169,521,257,778,24,802
公投第１１案,新北市,中和區,員山里,1379,1370,505,229,734,26,760
公投第１１案,新北市,中和區,員山里,1380,1574,608,304,912,40,952
公投第１１案,新北市,中和區,員山里,1381,2614,987,174,1161,20,1181
公投第１１案,新北市,中和區,嘉穗里,1382,1477,571,282,853,22,875
公投第１１案,新北市,中和區,嘉穗里,1383,1041,363,210,573,38,611
公投第１１案,新北市,中和區,文元里,1384,1538,522,252,774,49,823
公投第１１案,新北市,中和區,文元里,1385,1599,585,278,863,31,894
公投第１１案,新北市,中和區,文元里,1386,1586,605,283,888,39,927
公投第１１案,新北市,中和區,嘉新里,1387,1726,658,345,1003,41,1044
公投第１１案,新北市,中和區,嘉新里,1388,1854,680,416,1096,41,1137
公投第１１案,新北市,中和區,民安里,1389,1472,589,273,862,38,900
公投第１１案,新北市,中和區,民安里,1390,1430,574,263,837,37,874
公投第１１案,新北市,中和區,民安里,1391,1488,539,309,848,44,892
公投第１１案,新北市,中和區,安穗里,1392,1251,434,251,685,26,711
公投第１１案,新北市,中和區,安穗里,1393,1487,572,259,831,32,863
公投第１１案,新北市,中和區,安穗里,1394,1328,452,240,692,52,744
公投第１１案,新北市,中和區,瑞穗里,1395,1128,435,237,672,26,698
公投第１１案,新北市,中和區,瑞穗里,1396,1008,459,184,643,25,668
公投第１１案,新北市,中和區,明穗里,1397,1786,659,342,1001,30,1031
公投第１１案,新北市,中和區,明穗里,1398,2219,751,412,1163,38,1201
公投第１１案,新北市,中和區,清穗里,1399,1322,475,215,690,31,721
公投第１１案,新北市,中和區,清穗里,1400,1495,606,265,871,12,883
公投第１１案,新北市,中和區,自強里,1401,1414,513,237,750,41,791
公投第１１案,新北市,中和區,自強里,1402,1681,655,275,930,50,980
公投第１１案,新北市,中和區,自強里,1403,1361,471,267,738,44,782
公投第１１案,新北市,中和區,德穗里,1404,1442,522,256,778,31,809
公投第１１案,新北市,中和區,德穗里,1405,1383,409,319,728,24,752
公投第１１案,新北市,中和區,德穗里,1406,1264,451,213,664,30,694
公投第１１案,新北市,中和區,民生里,1407,1810,715,321,1036,53,1089
公投第１１案,新北市,中和區,民生里,1408,1951,508,321,829,29,858
公投第１１案,新北市,中和區,國光里,1409,1582,549,244,793,29,822
公投第１１案,新北市,中和區,國光里,1410,1945,742,363,1105,47,1152
公投第１１案,新北市,中和區,壽德里,1411,1390,525,248,773,41,814
公投第１１案,新北市,中和區,壽德里,1412,1161,424,232,656,17,673
公投第１１案,新北市,中和區,壽德里,1413,1399,578,185,763,27,790
公投第１１案,新北市,中和區,明德里,1414,1070,403,188,591,21,612
公投第１１案,新北市,中和區,明德里,1415,1169,448,201,649,25,674
公投第１１案,新北市,中和區,明德里,1416,1214,508,223,731,39,770
公投第１１案,新北市,中和區,錦中里,1417,1398,525,262,787,39,826
公投第１１案,新北市,中和區,錦中里,1418,1049,387,209,596,19,615
公投第１１案,新北市,中和區,錦中里,1419,1324,534,259,793,38,831
公投第１１案,新北市,中和區,錦盛里,1420,1765,542,303,845,25,870
公投第１１案,新北市,中和區,錦盛里,1421,1709,553,304,857,41,898
公投第１１案,新北市,中和區,民有里,1422,1186,446,210,656,40,696
公投第１１案,新北市,中和區,民有里,1423,1318,535,229,764,27,791
公投第１１案,新北市,中和區,員富里,1424,1430,493,323,816,26,842
公投第１１案,新北市,中和區,員富里,1425,1637,446,252,698,32,730
公投第１１案,新北市,中和區,嘉慶里,1426,1283,460,251,711,37,748
公投第１１案,新北市,中和區,嘉慶里,1427,1310,475,249,724,37,761
公投第１１案,新北市,中和區,嘉慶里,1428,1301,488,248,736,32,768
公投第１１案,新北市,中和區,冠穗里,1429,1681,600,311,911,36,947
公投第１１案,新北市,中和區,冠穗里,1430,1384,523,270,793,24,817
公投第１１案,新北市,中和區,國華里,1431,1187,428,232,660,26,686
公投第１１案,新北市,中和區,國華里,1432,1779,529,272,801,6,807
公投第１１案,新北市,中和區,宜安里,1433,1712,655,290,945,31,976
公投第１１案,新北市,中和區,安樂里,1434,1462,481,276,757,39,796
公投第１１案,新北市,中和區,安樂里,1435,1824,607,340,947,23,970
公投第１１案,新北市,中和區,安和里,1436,1389,455,287,742,36,778
公投第１１案,新北市,中和區,安和里,1437,1434,550,275,825,30,855
公投第１１案,新北市,中和區,安順里,1438,1953,705,308,1013,43,1056
公投第１１案,新北市,中和區,安順里,1439,2002,679,396,1075,50,1125
公投第１１案,新北市,中和區,安平里,1440,1858,688,289,977,29,1006
公投第１１案,新北市,中和區,安平里,1441,1801,640,313,953,23,976
公投第１１案,新北市,中和區,安平里,1442,1691,643,300,943,35,978
公投第１１案,新北市,中和區,中安里,1443,1363,515,274,789,27,816
公投第１１案,新北市,中和區,中安里,1444,1220,522,235,757,20,777
公投第１１案,新北市,中和區,中安里,1445,1365,578,275,853,18,871
公投第１１案,新北市,中和區,泰安里,1446,1178,455,216,671,20,691
公投第１１案,新北市,中和區,泰安里,1447,830,342,152,494,16,510
公投第１１案,新北市,中和區,泰安里,1448,1197,403,198,601,29,630
公投第１１案,新北市,中和區,秀山里,1449,1369,537,225,762,44,806
公投第１１案,新北市,中和區,秀山里,1450,1336,535,244,779,25,804
公投第１１案,新北市,中和區,秀山里,1451,1377,572,257,829,37,866
公投第１１案,新北市,中和區,秀成里,1452,1499,580,267,847,36,883
公投第１１案,新北市,中和區,秀成里,1453,1689,661,312,973,33,1006
公投第１１案,新北市,中和區,秀義里,1454,1323,491,277,768,37,805
公投第１１案,新北市,中和區,秀義里,1455,1079,426,216,642,34,676
公投第１１案,新北市,中和區,秀福里,1456,1545,577,296,873,30,903
公投第１１案,新北市,中和區,秀福里,1457,1326,444,274,718,32,750
公投第１１案,新北市,中和區,秀福里,1458,1443,478,283,761,36,797
公投第１１案,新北市,中和區,秀景里,1459,1712,641,290,931,29,960
公投第１１案,新北市,中和區,秀景里,1460,1916,680,329,1009,37,1046
公投第１１案,新北市,中和區,秀景里,1461,863,356,163,519,22,541
公投第１１案,新北市,中和區,秀景里,1462,1203,479,258,737,7,744
公投第１１案,新北市,中和區,秀明里,1463,1483,525,256,781,25,806
公投第１１案,新北市,中和區,秀明里,1464,1575,578,242,820,29,849
公投第１１案,新北市,中和區,秀明里,1465,1432,496,190,686,35,721
公投第１１案,新北市,中和區,秀峰里,1466,1441,526,245,771,42,813
公投第１１案,新北市,中和區,秀峰里,1467,1269,486,231,717,38,755
公投第１１案,新北市,中和區,秀峰里,1468,1363,533,255,788,23,811
公投第１１案,新北市,中和區,秀士里,1469,1089,453,169,622,17,639
公投第１１案,新北市,中和區,秀士里,1470,1171,391,226,617,19,636
公投第１１案,新北市,中和區,秀水里,1471,1150,473,185,658,34,692
公投第１１案,新北市,中和區,秀水里,1472,1154,472,329,801,43,844
公投第１１案,新北市,中和區,秀水里,1473,1067,479,164,643,21,664
公投第１１案,新北市,中和區,秀仁里,1474,1526,544,258,802,25,827
公投第１１案,新北市,中和區,秀仁里,1475,1447,544,286,830,20,850
公投第１１案,新北市,永和區,光復里,1476,1554,540,334,874,49,923
公投第１１案,新北市,永和區,網溪里,1477,1065,422,189,611,26,637
公投第１１案,新北市,永和區,復興里,1478,854,357,160,517,28,545
公投第１１案,新北市,永和區,復興里,1479,1253,484,234,718,42,760
公投第１１案,新北市,永和區,竹林里,1480,1733,608,356,964,27,991
公投第１１案,新北市,永和區,竹林里,1481,1581,575,287,862,37,899
公投第１１案,新北市,永和區,桂林里,1482,1735,685,246,931,39,970
公投第１１案,新北市,永和區,桂林里,1483,1563,565,259,824,21,845
公投第１１案,新北市,永和區,上林里,1484,1650,610,340,950,39,989
公投第１１案,新北市,永和區,上林里,1485,1454,524,276,800,30,830
公投第１１案,新北市,永和區,福林里,1486,1568,512,308,820,29,849
公投第１１案,新北市,永和區,福林里,1487,1444,520,248,768,34,802
公投第１１案,新北市,永和區,勵行里,1488,1140,380,233,613,33,646
公投第１１案,新北市,永和區,中興里,1489,1188,498,209,707,30,737
公投第１１案,新北市,永和區,中興里,1490,1516,531,260,791,44,835
公投第１１案,新北市,永和區,永興里,1491,1397,499,244,743,36,779
公投第１１案,新北市,永和區,永興里,1492,1438,516,268,784,32,816
公投第１１案,新北市,永和區,正興里,1493,1084,435,203,638,16,654
公投第１１案,新北市,永和區,正興里,1494,941,358,172,530,20,550
公投第１１案,新北市,永和區,豫溪里,1495,1598,565,289,854,22,876
公投第１１案,新北市,永和區,豫溪里,1496,2842,548,300,848,25,873
公投第１１案,新北市,永和區,光明里,1497,1261,485,280,765,28,793
公投第１１案,新北市,永和區,光明里,1498,1449,586,308,894,35,929
公投第１１案,新北市,永和區,福和里,1499,1511,503,355,858,28,886
公投第１１案,新北市,永和區,福和里,1500,1470,605,295,900,27,927
公投第１１案,新北市,永和區,福和里,1501,1580,579,300,879,32,911
公投第１１案,新北市,永和區,得和里,1502,1438,600,276,876,28,904
公投第１１案,新北市,永和區,得和里,1503,1305,552,255,807,20,827
公投第１１案,新北市,永和區,得和里,1504,1046,449,194,643,20,663
公投第１１案,新北市,永和區,永貞里,1505,1566,601,306,907,20,927
公投第１１案,新北市,永和區,永貞里,1506,1468,535,303,838,29,867
公投第１１案,新北市,永和區,永福里,1507,1305,531,288,819,37,856
公投第１１案,新北市,永和區,永福里,1508,1181,450,256,706,25,731
公投第１１案,新北市,永和區,河濱里,1509,1720,587,341,928,35,963
公投第１１案,新北市,永和區,河濱里,1510,1103,439,242,681,23,704
公投第１１案,新北市,永和區,秀和里,1511,1649,462,326,788,172,960
公投第１１案,新北市,永和區,秀和里,1512,1206,437,305,742,28,770
公投第１１案,新北市,永和區,秀和里,1513,1506,542,350,892,27,919
公投第１１案,新北市,永和區,永元里,1514,1488,534,287,821,32,853
公投第１１案,新北市,永和區,永元里,1515,1288,479,283,762,44,806
公投第１１案,新北市,永和區,永元里,1516,1413,467,261,728,28,756
公投第１１案,新北市,永和區,民權里,1517,1329,517,225,742,35,777
公投第１１案,新北市,永和區,民權里,1518,1436,585,287,872,15,887
公投第１１案,新北市,永和區,民權里,1519,1112,418,210,628,35,663
公投第１１案,新北市,永和區,民族里,1520,1100,494,221,715,32,747
公投第１１案,新北市,永和區,民族里,1521,1545,639,290,929,29,958
公投第１１案,新北市,永和區,民族里,1522,1436,563,248,811,10,821
公投第１１案,新北市,永和區,秀朗里,1523,1731,712,338,1050,36,1086
公投第１１案,新北市,永和區,秀朗里,1524,1762,670,362,1032,62,1094
公投第１１案,新北市,永和區,秀成里,1525,1320,455,265,720,29,749
公投第１１案,新北市,永和區,秀成里,1526,1297,423,214,637,15,652
公投第１１案,新北市,永和區,秀林里,1527,1798,606,359,965,40,1005
公投第１１案,新北市,永和區,秀林里,1528,1491,559,320,879,34,913
公投第１１案,新北市,永和區,秀得里,1529,1223,456,234,690,15,705
公投第１１案,新北市,永和區,秀得里,1530,1108,425,214,639,27,666
公投第１１案,新北市,永和區,秀元里,1531,1408,542,288,830,31,861
公投第１１案,新北市,永和區,秀元里,1532,1265,483,249,732,38,770
公投第１１案,新北市,永和區,民生里,1533,1115,402,217,619,16,635
公投第１１案,新北市,永和區,民生里,1534,1133,485,212,697,31,728
公投第１１案,新北市,永和區,民生里,1535,1217,465,239,704,32,736
公投第１１案,新北市,永和區,民本里,1536,1713,608,320,928,38,966
公投第１１案,新北市,永和區,民本里,1537,1721,595,313,908,38,946
公投第１１案,新北市,永和區,民富里,1538,1327,493,221,714,37,751
公投第１１案,新北市,永和區,民富里,1539,1257,509,258,767,19,786
公投第１１案,新北市,永和區,民樂里,1540,1348,537,281,818,34,852
公投第１１案,新北市,永和區,民樂里,1541,1461,598,296,894,27,921
公投第１１案,新北市,永和區,民樂里,1542,1368,529,248,777,42,819
公投第１１案,新北市,永和區,民治里,1543,1234,454,219,673,51,724
公投第１１案,新北市,永和區,民治里,1544,1303,450,260,710,31,741
公投第１１案,新北市,永和區,智光里,1545,1516,575,251,826,32,858
公投第１１案,新北市,永和區,智光里,1546,1422,578,249,827,48,875
公投第１１案,新北市,永和區,潭安里,1547,991,411,196,607,21,628
公投第１１案,新北市,永和區,潭安里,1548,1016,430,191,621,21,642
公投第１１案,新北市,永和區,潭安里,1549,1146,438,228,666,27,693
公投第１１案,新北市,永和區,潭安里,1550,1043,449,170,619,16,635
公投第１１案,新北市,永和區,潭墘里,1551,1210,470,262,732,18,750
公投第１１案,新北市,永和區,潭墘里,1552,1630,628,305,933,25,958
公投第１１案,新北市,永和區,潭墘里,1553,1092,448,208,656,21,677
公投第１１案,新北市,永和區,店街里,1554,1872,708,367,1075,37,1112
公投第１１案,新北市,永和區,店街里,1555,1781,647,333,980,28,1008
公投第１１案,新北市,永和區,大新里,1556,1049,421,201,622,30,652
公投第１１案,新北市,永和區,大新里,1557,1285,531,267,798,21,819
公投第１１案,新北市,永和區,永安里,1558,1209,465,258,723,29,752
公投第１１案,新北市,永和區,永安里,1559,1132,449,242,691,23,714
公投第１１案,新北市,永和區,永安里,1560,1287,537,265,802,28,830
公投第１１案,新北市,永和區,永樂里,1561,1068,415,213,628,43,671
公投第１１案,新北市,永和區,永樂里,1562,1098,405,253,658,37,695
公投第１１案,新北市,永和區,水源里,1563,1222,517,211,728,41,769
公投第１１案,新北市,永和區,水源里,1564,1157,459,220,679,31,710
公投第１１案,新北市,永和區,水源里,1565,1168,466,264,730,36,766
公投第１１案,新北市,永和區,協和里,1566,1283,457,257,714,39,753
公投第１１案,新北市,永和區,協和里,1567,1372,523,254,777,28,805
公投第１１案,新北市,永和區,雙和里,1568,1876,723,373,1096,38,1134
公投第１１案,新北市,永和區,雙和里,1569,1576,669,291,960,44,1004
公投第１１案,新北市,永和區,安和里,1570,1661,640,332,972,30,1002
公投第１１案,新北市,永和區,安和里,1571,1808,694,325,1019,18,1037
公投第１１案,新北市,永和區,前溪里,1572,1898,687,361,1048,41,1089
公投第１１案,新北市,永和區,和平里,1573,1508,582,314,896,33,929
公投第１１案,新北市,永和區,和平里,1574,1341,509,281,790,41,831
公投第１１案,新北市,永和區,和平里,1575,1422,526,271,797,38,835
公投第１１案,新北市,永和區,保平里,1576,1177,441,224,665,28,693
公投第１１案,新北市,永和區,保平里,1577,1557,587,303,890,40,930
公投第１１案,新北市,永和區,保平里,1578,1491,520,280,800,29,829
公投第１１案,新北市,永和區,中溪里,1579,1586,554,318,872,40,912
公投第１１案,新北市,永和區,中溪里,1580,1313,471,241,712,16,728
公投第１１案,新北市,永和區,中溪里,1581,1636,569,336,905,37,942
公投第１１案,新北市,永和區,保安里,1582,1598,562,333,895,35,930
公投第１１案,新北市,永和區,保安里,1583,1609,587,353,940,31,971
公投第１１案,新北市,永和區,保安里,1584,1375,507,304,811,40,851
公投第１１案,新北市,永和區,保安里,1585,1648,651,354,1005,34,1039
公投第１１案,新北市,永和區,保順里,1586,1077,402,232,634,22,656
公投第１１案,新北市,永和區,保順里,1587,1157,447,232,679,25,704
公投第１１案,新北市,永和區,保順里,1588,1339,541,295,836,19,855
公投第１１案,新北市,永和區,保順里,1589,1306,507,285,792,19,811
公投第１１案,新北市,永和區,保順里,1590,1236,502,267,769,7,776
公投第１１案,新北市,永和區,保順里,1591,1133,457,228,685,19,704
公投第１１案,新北市,永和區,保順里,1592,1425,567,280,847,20,867
公投第１１案,新北市,永和區,下溪里,1593,1938,700,365,1065,52,1117
公投第１１案,新北市,永和區,下溪里,1594,1607,602,324,926,36,962
公投第１１案,新北市,永和區,大同里,1595,853,366,140,506,25,531
公投第１１案,新北市,永和區,新生里,1596,768,279,118,397,31,428
公投第１１案,新北市,永和區,永成里,1597,893,309,106,415,27,442
公投第１１案,新北市,永和區,忠義里,1598,743,288,132,420,17,437
公投第１１案,新北市,永和區,仁愛里,1599,1155,461,244,705,44,749
公投第１１案,新北市,永和區,仁愛里,1600,1263,506,258,764,25,789
公投第１１案,新北市,永和區,文化里,1601,1189,466,256,722,16,738
公投第１１案,新北市,永和區,文化里,1602,1346,490,244,734,29,763
公投第１１案,新北市,永和區,信義里,1603,1368,478,275,753,27,780
公投第１１案,新北市,永和區,信義里,1604,1043,397,209,606,18,624
公投第１１案,新北市,永和區,後溪里,1605,1709,647,362,1009,32,1041
公投第１１案,新北市,永和區,上溪里,1606,879,302,165,467,16,483
公投第１１案,新北市,永和區,上溪里,1607,904,331,189,520,21,541
公投第１１案,新北市,永和區,頂溪里,1608,1221,494,247,741,33,774
公投第１１案,新北市,永和區,頂溪里,1609,1018,399,204,603,34,637
公投第１１案,新北市,永和區,河堤里,1610,1551,542,318,860,24,884
公投第１１案,新北市,永和區,河堤里,1611,1428,539,291,830,31,861
公投第１１案,新北市,永和區,新廍里,1612,1044,393,206,599,45,644
公投第１１案,新北市,永和區,新廍里,1613,967,378,203,581,27,608
公投第１１案,新北市,樹林區,三興里,1614,1408,462,234,696,47,743
公投第１１案,新北市,樹林區,三興里,1615,1310,455,231,686,25,711
公投第１１案,新北市,樹林區,三興里,1616,1534,483,234,717,44,761
公投第１１案,新北市,樹林區,三福里,1617,1211,424,203,627,50,677
公投第１１案,新北市,樹林區,三福里,1618,1125,406,213,619,38,657
公投第１１案,新北市,樹林區,三福里,1619,1134,457,209,666,23,689
公投第１１案,新北市,樹林區,三多里,1620,1897,510,320,830,60,890
公投第１１案,新北市,樹林區,三多里,1621,1716,523,344,867,50,917
公投第１１案,新北市,樹林區,三龍里,1622,736,273,163,436,23,459
公投第１１案,新北市,樹林區,三龍里,1623,1137,429,251,680,15,695
公投第１１案,新北市,樹林區,獇寮里,1624,1542,482,299,781,27,808
公投第１１案,新北市,樹林區,獇寮里,1625,1470,482,288,770,43,813
公投第１１案,新北市,樹林區,獇寮里,1626,1456,443,256,699,18,717
公投第１１案,新北市,樹林區,光興里,1627,1124,418,210,628,22,650
公投第１１案,新北市,樹林區,光興里,1628,1235,401,230,631,25,656
公投第１１案,新北市,樹林區,光興里,1629,1212,416,261,677,21,698
公投第１１案,新北市,樹林區,金寮里,1630,1223,410,194,604,30,634
公投第１１案,新北市,樹林區,金寮里,1631,1335,447,230,677,56,733
公投第１１案,新北市,樹林區,金寮里,1632,1206,393,240,633,32,665
公投第１１案,新北市,樹林區,潭底里,1633,1927,422,236,658,53,711
公投第１１案,新北市,樹林區,潭底里,1634,914,318,152,470,46,516
公投第１１案,新北市,樹林區,潭底里,1635,1456,533,273,806,38,844
公投第１１案,新北市,樹林區,文林里,1636,1409,481,245,726,44,770
公投第１１案,新北市,樹林區,文林里,1637,1500,567,285,852,49,901
公投第１１案,新北市,樹林區,文林里,1638,1545,519,312,831,38,869
公投第１１案,新北市,樹林區,保安里,1639,1483,482,282,764,22,786
公投第１１案,新北市,樹林區,保安里,1640,1524,541,282,823,22,845
公投第１１案,新北市,樹林區,保安里,1641,1431,499,266,765,40,805
公投第１１案,新北市,樹林區,保安里,1642,1181,425,199,624,32,656
公投第１１案,新北市,樹林區,圳安里,1643,1116,388,219,607,44,651
公投第１１案,新北市,樹林區,圳安里,1644,1077,344,202,546,20,566
公投第１１案,新北市,樹林區,圳安里,1645,1103,334,219,553,21,574
公投第１１案,新北市,樹林區,圳福里,1646,1385,469,267,736,35,771
公投第１１案,新北市,樹林區,圳福里,1647,1266,423,230,653,24,677
公投第１１案,新北市,樹林區,圳福里,1648,1195,374,250,624,30,654
公投第１１案,新北市,樹林區,圳民里,1649,1254,412,241,653,32,685
公投第１１案,新北市,樹林區,圳民里,1650,1263,445,251,696,34,730
公投第１１案,新北市,樹林區,圳生里,1651,1473,531,319,850,53,903
公投第１１案,新北市,樹林區,樹德里,1652,870,328,157,485,18,503
公投第１１案,新北市,樹林區,樹德里,1653,1338,520,258,778,42,820
公投第１１案,新北市,樹林區,樹德里,1654,1010,359,173,532,30,562
公投第１１案,新北市,樹林區,樹福里,1655,1658,563,370,933,45,978
公投第１１案,新北市,樹林區,樹福里,1656,1538,571,364,935,36,971
公投第１１案,新北市,樹林區,樹西里,1657,1405,542,288,830,55,885
公投第１１案,新北市,樹林區,樹西里,1658,1587,533,323,856,33,889
公投第１１案,新北市,樹林區,樹西里,1659,1566,553,308,861,28,889
公投第１１案,新北市,樹林區,樹興里,1660,997,351,174,525,14,539
公投第１１案,新北市,樹林區,樹興里,1661,1187,415,233,648,39,687
公投第１１案,新北市,樹林區,樹興里,1662,1061,353,199,552,29,581
公投第１１案,新北市,樹林區,樹人里,1663,1701,650,307,957,24,981
公投第１１案,新北市,樹林區,樹人里,1664,1278,470,219,689,36,725
公投第１１案,新北市,樹林區,育英里,1665,1433,555,280,835,39,874
公投第１１案,新北市,樹林區,育英里,1666,1306,503,256,759,44,803
公投第１１案,新北市,樹林區,樹南里,1667,1268,473,255,728,46,774
公投第１１案,新北市,樹林區,樹南里,1668,1281,469,280,749,28,777
公投第１１案,新北市,樹林區,樹南里,1669,1200,427,256,683,33,716
公投第１１案,新北市,樹林區,坡內里,1670,1491,524,245,769,32,801
公投第１１案,新北市,樹林區,樹東里,1671,1066,371,185,556,21,577
公投第１１案,新北市,樹林區,樹北里,1672,877,347,170,517,42,559
公投第１１案,新北市,樹林區,彭福里,1673,1616,575,255,830,47,877
公投第１１案,新北市,樹林區,彭福里,1674,1589,500,225,725,32,757
公投第１１案,新北市,樹林區,彭福里,1675,1367,505,253,758,35,793
公投第１１案,新北市,樹林區,和平里,1676,1144,435,225,660,30,690
公投第１１案,新北市,樹林區,和平里,1677,1059,395,160,555,19,574
公投第１１案,新北市,樹林區,和平里,1678,1224,402,232,634,44,678
公投第１１案,新北市,樹林區,彭興里,1679,1141,345,210,555,25,580
公投第１１案,新北市,樹林區,彭興里,1680,1396,417,226,643,17,660
公投第１１案,新北市,樹林區,彭興里,1681,1157,353,252,605,32,637
公投第１１案,新北市,樹林區,彭興里,1682,1498,448,271,719,50,769
公投第１１案,新北市,樹林區,彭厝里,1683,1514,492,281,773,58,831
公投第１１案,新北市,樹林區,彭厝里,1684,1546,498,259,757,26,783
公投第１１案,新北市,樹林區,彭厝里,1685,1392,481,273,754,30,784
公投第１１案,新北市,樹林區,大同里,1686,1566,577,282,859,28,887
公投第１１案,新北市,樹林區,大同里,1687,1566,545,297,842,19,861
公投第１１案,新北市,樹林區,中華里,1688,1517,504,284,788,39,827
公投第１１案,新北市,樹林區,中華里,1689,1481,504,285,789,28,817
公投第１１案,新北市,樹林區,太順里,1690,1261,439,216,655,32,687
公投第１１案,新北市,樹林區,太順里,1691,1163,389,209,598,20,618
公投第１１案,新北市,樹林區,東昇里,1692,1661,618,333,951,49,1000
公投第１１案,新北市,樹林區,東昇里,1693,1585,540,325,865,35,900
公投第１１案,新北市,樹林區,東昇里,1694,1018,411,171,582,34,616
公投第１１案,新北市,樹林區,東陽里,1695,1247,435,204,639,59,698
公投第１１案,新北市,樹林區,東陽里,1696,1390,489,213,702,53,755
公投第１１案,新北市,樹林區,東陽里,1697,1293,450,263,713,33,746
公投第１１案,新北市,樹林區,東陽里,1698,1301,424,245,669,20,689
公投第１１案,新北市,樹林區,東山里,1699,1606,514,299,813,40,853
公投第１１案,新北市,樹林區,東山里,1700,1277,426,218,644,57,701
公投第１１案,新北市,樹林區,山佳里,1701,1219,413,247,660,37,697
公投第１１案,新北市,樹林區,山佳里,1702,1454,498,244,742,30,772
公投第１１案,新北市,樹林區,山佳里,1703,1314,469,210,679,23,702
公投第１１案,新北市,樹林區,山佳里,1704,1008,409,210,619,19,638
公投第１１案,新北市,樹林區,中山里,1705,1574,517,276,793,56,849
公投第１１案,新北市,樹林區,中山里,1706,1364,517,256,773,23,796
公投第１１案,新北市,樹林區,中山里,1707,1677,562,254,816,44,860
公投第１１案,新北市,樹林區,樂山里,1708,1683,511,255,766,19,785
公投第１１案,新北市,樹林區,柑園里,1709,1452,536,263,799,47,846
公投第１１案,新北市,樹林區,柑園里,1710,1592,581,329,910,17,927
公投第１１案,新北市,樹林區,柑園里,1711,1619,610,309,919,23,942
公投第１１案,新北市,樹林區,柑園里,1712,1642,668,308,976,25,1001
公投第１１案,新北市,樹林區,柑園里,1713,1357,477,270,747,14,761
公投第１１案,新北市,樹林區,西園里,1714,1638,582,311,893,52,945
公投第１１案,新北市,樹林區,南園里,1715,1592,528,321,849,29,878
公投第１１案,新北市,樹林區,南園里,1716,1521,599,256,855,30,885
公投第１１案,新北市,樹林區,南園里,1717,1707,659,343,1002,33,1035
公投第１１案,新北市,樹林區,南園里,1718,1741,636,345,981,31,1012
公投第１１案,新北市,樹林區,南園里,1719,1655,589,314,903,26,929
公投第１１案,新北市,樹林區,南園里,1720,1775,575,302,877,36,913
公投第１１案,新北市,樹林區,南園里,1721,1781,673,282,955,32,987
公投第１１案,新北市,樹林區,東園里,1722,1565,470,257,727,31,758
公投第１１案,新北市,樹林區,北園里,1723,936,294,179,473,30,503
公投第１１案,新北市,樹林區,北園里,1724,1030,374,204,578,19,597
公投第１１案,新北市,鶯歌區,建德里,1725,515,198,93,291,9,300
公投第１１案,新北市,鶯歌區,東鶯里,1726,965,351,204,555,30,585
公投第１１案,新北市,鶯歌區,北鶯里,1727,1931,650,357,1007,58,1065
公投第１１案,新北市,鶯歌區,北鶯里,1728,1797,560,306,866,30,896
公投第１１案,新北市,鶯歌區,西鶯里,1729,1057,373,190,563,37,600
公投第１１案,新北市,鶯歌區,西鶯里,1730,962,312,177,489,14,503
公投第１１案,新北市,鶯歌區,中鶯里,1731,934,378,194,572,14,586
公投第１１案,新北市,鶯歌區,南鶯里,1732,1742,671,352,1023,35,1058
公投第１１案,新北市,鶯歌區,南鶯里,1733,1634,546,301,847,29,876
公投第１１案,新北市,鶯歌區,南鶯里,1734,1676,542,296,838,18,856
公投第１１案,新北市,鶯歌區,建國里,1735,2052,679,411,1090,49,1139
公投第１１案,新北市,鶯歌區,建國里,1736,1977,587,334,921,25,946
公投第１１案,新北市,鶯歌區,建國里,1737,1957,669,377,1046,18,1064
公投第１１案,新北市,鶯歌區,二甲里,1738,850,296,131,427,16,443
公投第１１案,新北市,鶯歌區,二橋里,1739,1782,584,289,873,41,914
公投第１１案,新北市,鶯歌區,二橋里,1740,1496,494,270,764,37,801
公投第１１案,新北市,鶯歌區,二橋里,1741,2071,673,325,998,31,1029
公投第１１案,新北市,鶯歌區,二橋里,1742,1753,487,266,753,36,789
公投第１１案,新北市,鶯歌區,尖山里,1743,1737,601,277,878,28,906
公投第１１案,新北市,鶯歌區,尖山里,1744,1669,541,274,815,33,848
公投第１１案,新北市,鶯歌區,尖山里,1745,1842,512,296,808,42,850
公投第１１案,新北市,鶯歌區,尖山里,1746,1454,472,253,725,23,748
公投第１１案,新北市,鶯歌區,南靖里,1747,942,300,185,485,24,509
公投第１１案,新北市,鶯歌區,南靖里,1748,1317,402,252,654,49,703
公投第１１案,新北市,鶯歌區,南靖里,1749,949,307,147,454,18,472
公投第１１案,新北市,鶯歌區,同慶里,1750,1440,542,272,814,36,850
公投第１１案,新北市,鶯歌區,永昌里,1751,1809,617,324,941,50,991
公投第１１案,新北市,鶯歌區,永昌里,1752,1758,619,328,947,41,988
公投第１１案,新北市,鶯歌區,永昌里,1753,1589,565,267,832,35,867
公投第１１案,新北市,鶯歌區,永昌里,1754,1067,392,215,607,33,640
公投第１１案,新北市,鶯歌區,永昌里,1755,1092,407,212,619,27,646
公投第１１案,新北市,鶯歌區,永吉里,1756,1730,645,283,928,39,967
公投第１１案,新北市,鶯歌區,永吉里,1757,1281,498,194,692,22,714
公投第１１案,新北市,鶯歌區,永吉里,1758,1238,488,253,741,31,772
公投第１１案,新北市,鶯歌區,鳳祥里,1759,1568,524,293,817,52,869
公投第１１案,新北市,鶯歌區,鳳祥里,1760,1271,438,218,656,29,685
公投第１１案,新北市,鶯歌區,鳳祥里,1761,1183,351,166,517,17,534
公投第１１案,新北市,鶯歌區,鳳鳴里,1762,1026,331,170,501,17,518
公投第１１案,新北市,鶯歌區,鳳鳴里,1763,1721,535,298,833,31,864
公投第１１案,新北市,鶯歌區,鳳鳴里,1764,1317,419,217,636,50,686
公投第１１案,新北市,鶯歌區,鳳福里,1765,1046,373,219,592,36,628
公投第１１案,新北市,鶯歌區,鳳福里,1766,1144,404,247,651,40,691
公投第１１案,新北市,鶯歌區,鳳福里,1767,1336,432,218,650,50,700
公投第１１案,新北市,鶯歌區,大湖里,1768,1479,466,215,681,34,715
公投第１１案,新北市,鶯歌區,大湖里,1769,1736,549,296,845,56,901
公投第１１案,新北市,鶯歌區,大湖里,1770,1389,498,363,861,47,908
公投第１１案,新北市,鶯歌區,中湖里,1771,1956,641,323,964,65,1029
公投第１１案,新北市,鶯歌區,中湖里,1772,1371,440,282,722,42,764
公投第１１案,新北市,鶯歌區,中湖里,1773,1810,475,232,707,26,733
公投第１１案,新北市,鶯歌區,東湖里,1774,227,92,35,127,2,129
公投第１１案,新北市,土城區,祖田里,1775,1505,490,271,761,45,806
公投第１１案,新北市,土城區,頂新里,1776,1242,462,251,713,28,741
公投第１１案,新北市,土城區,頂新里,1777,1206,462,231,693,23,716
公投第１１案,新北市,土城區,頂福里,1778,1474,494,270,764,50,814
公投第１１案,新北市,土城區,頂福里,1779,1489,495,248,743,29,772
公投第１１案,新北市,土城區,頂福里,1780,1675,545,276,821,40,861
公投第１１案,新北市,土城區,頂埔里,1781,1499,478,308,786,37,823
公投第１１案,新北市,土城區,頂埔里,1782,1495,497,260,757,22,779
公投第１１案,新北市,土城區,頂埔里,1783,1411,470,235,705,55,760
公投第１１案,新北市,土城區,沛陂里,1784,1378,459,216,675,33,708
公投第１１案,新北市,土城區,沛陂里,1785,1256,388,253,641,29,670
公投第１１案,新北市,土城區,沛陂里,1786,1379,480,266,746,45,791
公投第１１案,新北市,土城區,永寧里,1787,1424,476,230,706,41,747
公投第１１案,新北市,土城區,永寧里,1788,1455,482,270,752,35,787
公投第１１案,新北市,土城區,永寧里,1789,1419,465,241,706,32,738
公投第１１案,新北市,土城區,永寧里,1790,1357,517,268,785,24,809
公投第１１案,新北市,土城區,永寧里,1791,1501,498,278,776,28,804
公投第１１案,新北市,土城區,大安里,1792,1206,433,223,656,48,704
公投第１１案,新北市,土城區,大安里,1793,1255,443,259,702,28,730
公投第１１案,新北市,土城區,大安里,1794,1869,628,296,924,45,969
公投第１１案,新北市,土城區,員仁里,1795,1292,383,324,707,20,727
公投第１１案,新北市,土城區,員仁里,1796,1324,444,241,685,23,708
公投第１１案,新北市,土城區,員仁里,1797,1155,381,196,577,41,618
公投第１１案,新北市,土城區,員仁里,1798,1183,399,225,624,31,655
公投第１１案,新北市,土城區,埤塘里,1799,2518,314,204,518,34,552
公投第１１案,新北市,土城區,埤塘里,1800,1218,410,221,631,30,661
公投第１１案,新北市,土城區,埤塘里,1801,1133,429,188,617,35,652
公投第１１案,新北市,土城區,土城里,1802,894,317,172,489,19,508
公投第１１案,新北市,土城區,土城里,1803,931,330,181,511,38,549
公投第１１案,新北市,土城區,長風里,1804,1820,772,308,1080,58,1138
公投第１１案,新北市,土城區,員信里,1805,1320,482,220,702,23,725
公投第１１案,新北市,土城區,員信里,1806,1241,421,219,640,22,662
公投第１１案,新北市,土城區,員信里,1807,1414,465,272,737,42,779
公投第１１案,新北市,土城區,員林里,1808,1378,453,295,748,35,783
公投第１１案,新北市,土城區,員林里,1809,1421,480,306,786,43,829
公投第１１案,新北市,土城區,員林里,1810,1340,474,226,700,35,735
公投第１１案,新北市,土城區,員林里,1811,1144,414,237,651,29,680
公投第１１案,新北市,土城區,員福里,1812,1268,441,224,665,48,713
公投第１１案,新北市,土城區,員福里,1813,1196,428,211,639,48,687
公投第１１案,新北市,土城區,員福里,1814,1308,471,286,757,23,780
公投第１１案,新北市,土城區,員福里,1815,1175,448,199,647,28,675
公投第１１案,新北市,土城區,日和里,1816,1230,430,230,660,45,705
公投第１１案,新北市,土城區,日和里,1817,1342,472,261,733,29,762
公投第１１案,新北市,土城區,日和里,1818,1268,433,268,701,35,736
公投第１１案,新北市,土城區,日和里,1819,1227,469,254,723,49,772
公投第１１案,新北市,土城區,日新里,1820,1356,492,236,728,51,779
公投第１１案,新北市,土城區,日新里,1821,1496,539,256,795,46,841
公投第１１案,新北市,土城區,日新里,1822,1309,486,212,698,47,745
公投第１１案,新北市,土城區,裕生里,1823,1175,431,243,674,31,705
公投第１１案,新北市,土城區,裕生里,1824,1237,440,227,667,41,708
公投第１１案,新北市,土城區,裕生里,1825,1256,468,225,693,32,725
公投第１１案,新北市,土城區,裕生里,1826,1228,420,226,646,22,668
公投第１１案,新北市,土城區,貨饒里,1827,1182,420,204,624,50,674
公投第１１案,新北市,土城區,貨饒里,1828,1558,539,307,846,28,874
公投第１１案,新北市,土城區,貨饒里,1829,1160,409,240,649,21,670
公投第１１案,新北市,土城區,瑞興里,1830,1357,478,268,746,26,772
公投第１１案,新北市,土城區,瑞興里,1831,1464,497,267,764,44,808
公投第１１案,新北市,土城區,復興里,1832,1335,441,222,663,29,692
公投第１１案,新北市,土城區,復興里,1833,1346,464,239,703,50,753
公投第１１案,新北市,土城區,復興里,1834,1435,557,321,878,25,903
公投第１１案,新北市,土城區,廣福里,1835,1639,550,315,865,38,903
公投第１１案,新北市,土城區,廣福里,1836,1728,599,353,952,35,987
公投第１１案,新北市,土城區,廣福里,1837,1665,468,285,753,8,761
公投第１１案,新北市,土城區,學成里,1838,1333,527,252,779,38,817
公投第１１案,新北市,土城區,學成里,1839,1567,550,349,899,36,935
公投第１１案,新北市,土城區,埤林里,1840,1576,540,279,819,46,865
公投第１１案,新北市,土城區,埤林里,1841,1458,531,275,806,28,834
公投第１１案,新北市,土城區,埤林里,1842,1517,547,278,825,46,871
公投第１１案,新北市,土城區,埤林里,1843,1489,557,300,857,25,882
公投第１１案,新北市,土城區,埤林里,1844,1463,537,314,851,19,870
公投第１１案,新北市,土城區,廣興里,1845,1584,586,300,886,18,904
公投第１１案,新北市,土城區,廣興里,1846,1464,488,273,761,30,791
公投第１１案,新北市,土城區,樂利里,1847,1598,559,301,860,38,898
公投第１１案,新北市,土城區,樂利里,1848,1500,461,304,765,36,801
公投第１１案,新北市,土城區,樂利里,1849,1542,523,292,815,31,846
公投第１１案,新北市,土城區,學府里,1850,1619,564,348,912,46,958
公投第１１案,新北市,土城區,學府里,1851,1521,492,268,760,34,794
公投第１１案,新北市,土城區,明德里,1852,1691,534,374,908,19,927
公投第１１案,新北市,土城區,明德里,1853,1657,524,330,854,36,890
公投第１１案,新北市,土城區,明德里,1854,1772,610,400,1010,22,1032
公投第１１案,新北市,土城區,學士里,1855,1423,517,268,785,24,809
公投第１１案,新北市,土城區,學士里,1856,1321,480,297,777,34,811
公投第１１案,新北市,土城區,學士里,1857,1429,528,298,826,41,867
公投第１１案,新北市,土城區,柑林里,1858,1445,489,259,748,31,779
公投第１１案,新北市,土城區,柑林里,1859,1520,578,285,863,28,891
公投第１１案,新北市,土城區,中正里,1860,1484,436,255,691,13,704
公投第１１案,新北市,土城區,中正里,1861,1362,447,262,709,19,728
公投第１１案,新北市,土城區,青雲里,1862,1262,446,232,678,22,700
公投第１１案,新北市,土城區,青雲里,1863,1343,477,268,745,32,777
公投第１１案,新北市,土城區,清和里,1864,1337,378,252,630,27,657
公投第１１案,新北市,土城區,清和里,1865,1325,360,204,564,29,593
公投第１１案,新北市,土城區,清和里,1866,1390,440,236,676,33,709
公投第１１案,新北市,土城區,清和里,1867,1534,496,303,799,33,832
公投第１１案,新北市,土城區,清化里,1868,1484,470,268,738,52,790
公投第１１案,新北市,土城區,清溪里,1869,1532,440,265,705,93,798
公投第１１案,新北市,土城區,清溪里,1870,1507,538,301,839,36,875
公投第１１案,新北市,土城區,清溪里,1871,1550,558,280,838,32,870
公投第１１案,新北市,土城區,清溪里,1872,1567,587,255,842,28,870
公投第１１案,新北市,土城區,青山里,1873,1367,487,264,751,33,784
公投第１１案,新北市,土城區,青山里,1874,1293,433,223,656,35,691
公投第１１案,新北市,土城區,清水里,1875,1402,472,285,757,33,790
公投第１１案,新北市,土城區,清水里,1876,1379,462,267,729,32,761
公投第１１案,新北市,土城區,清水里,1877,1471,490,256,746,35,781
公投第１１案,新北市,土城區,清水里,1878,1410,500,223,723,24,747
公投第１１案,新北市,土城區,清水里,1879,1542,488,309,797,37,834
公投第１１案,新北市,土城區,永豐里,1880,1238,408,239,647,36,683
公投第１１案,新北市,土城區,永豐里,1881,1301,445,219,664,37,701
公投第１１案,新北市,土城區,永豐里,1882,1311,537,281,818,24,842
公投第１１案,新北市,土城區,永富里,1883,1511,481,263,744,18,762
公投第１１案,新北市,土城區,永富里,1884,1531,510,265,775,41,816
公投第１１案,新北市,土城區,永富里,1885,1638,502,319,821,45,866
公投第１１案,新北市,土城區,廷寮里,1886,1335,497,257,754,33,787
公投第１１案,新北市,土城區,廷寮里,1887,1459,535,244,779,29,808
公投第１１案,新北市,土城區,廷寮里,1888,1489,493,289,782,21,803
公投第１１案,新北市,土城區,金城里,1889,1774,581,351,932,27,959
公投第１１案,新北市,土城區,金城里,1890,1792,599,344,943,37,980
公投第１１案,新北市,土城區,金城里,1891,1798,651,392,1043,46,1089
公投第１１案,新北市,土城區,峯廷里,1892,1312,453,101,554,52,606
公投第１１案,新北市,土城區,峯廷里,1893,1301,427,216,643,36,679
公投第１１案,新北市,土城區,峯廷里,1894,1254,399,221,620,44,664
公投第１１案,新北市,土城區,峯廷里,1895,1215,414,224,638,18,656
公投第１１案,新北市,土城區,峯廷里,1896,1448,494,255,749,33,782
公投第１１案,新北市,土城區,延吉里,1897,1321,444,209,653,56,709
公投第１１案,新北市,土城區,延吉里,1898,1150,370,194,564,40,604
公投第１１案,新北市,土城區,延吉里,1899,1425,411,260,671,35,706
公投第１１案,新北市,土城區,延壽里,1900,1366,505,255,760,56,816
公投第１１案,新北市,土城區,延壽里,1901,1292,444,264,708,45,753
公投第１１案,新北市,土城區,延壽里,1902,1317,474,209,683,36,719
公投第１１案,新北市,土城區,延祿里,1903,1324,490,228,718,36,754
公投第１１案,新北市,土城區,延祿里,1904,1189,383,225,608,39,647
公投第１１案,新北市,土城區,延祿里,1905,1223,437,222,659,57,716
公投第１１案,新北市,土城區,平和里,1906,1550,499,307,806,31,837
公投第１１案,新北市,土城區,平和里,1907,1606,557,329,886,38,924
公投第１１案,新北市,土城區,平和里,1908,1509,526,289,815,29,844
公投第１１案,新北市,土城區,平和里,1909,1529,513,279,792,40,832
公投第１１案,新北市,土城區,安和里,1910,1458,481,244,725,49,774
公投第１１案,新北市,土城區,安和里,1911,1468,503,298,801,46,847
公投第１１案,新北市,土城區,安和里,1912,1495,473,300,773,26,799
公投第１１案,新北市,土城區,延和里,1913,1303,469,236,705,46,751
公投第１１案,新北市,土城區,延和里,1914,1365,482,266,748,28,776
公投第１１案,新北市,土城區,延和里,1915,1476,465,302,767,53,820
公投第１１案,新北市,土城區,延和里,1916,1519,531,289,820,26,846
公投第１１案,新北市,三峽區,三峽里,1917,274,118,48,166,21,187
公投第１１案,新北市,三峽區,秀川里,1918,583,213,93,306,17,323
公投第１１案,新北市,三峽區,八張里,1919,1765,521,281,802,20,822
公投第１１案,新北市,三峽區,八張里,1920,1714,570,302,872,34,906
公投第１１案,新北市,三峽區,中埔里,1921,1355,470,219,689,22,711
公投第１１案,新北市,三峽區,中埔里,1922,1329,479,245,724,31,755
公投第１１案,新北市,三峽區,弘道里,1923,1059,348,181,529,34,563
公投第１１案,新北市,三峽區,永舘里,1924,1364,483,271,754,31,785
公投第１１案,新北市,三峽區,永舘里,1925,1098,414,208,622,24,646
公投第１１案,新北市,三峽區,永舘里,1926,1296,440,248,688,28,716
公投第１１案,新北市,三峽區,永舘里,1927,1240,390,245,635,32,667
公投第１１案,新北市,三峽區,永舘里,1928,1531,486,301,787,27,814
公投第１１案,新北市,三峽區,鳶山里,1929,1444,470,236,706,18,724
公投第１１案,新北市,三峽區,鳶山里,1930,1347,449,237,686,49,735
公投第１１案,新北市,三峽區,鳶山里,1931,1455,500,252,752,40,792
公投第１１案,新北市,三峽區,鳶山里,1932,1556,457,250,707,27,734
公投第１１案,新北市,三峽區,鳶山里,1933,1390,385,217,602,23,625
公投第１１案,新北市,三峽區,鳶山里,1934,1532,514,277,791,27,818
公投第１１案,新北市,三峽區,龍埔里,1935,1377,433,197,630,43,673
公投第１１案,新北市,三峽區,龍埔里,1936,1731,588,281,869,30,899
公投第１１案,新北市,三峽區,龍埔里,1937,1705,543,305,848,17,865
公投第１１案,新北市,三峽區,龍埔里,1938,1590,543,310,853,28,881
公投第１１案,新北市,三峽區,龍埔里,1939,1650,612,313,925,24,949
公投第１１案,新北市,三峽區,龍恩里,1940,1441,504,272,776,21,797
公投第１１案,新北市,三峽區,龍恩里,1941,1404,540,258,798,17,815
公投第１１案,新北市,三峽區,龍恩里,1942,1295,476,274,750,22,772
公投第１１案,新北市,三峽區,龍恩里,1943,1348,441,211,652,23,675
公投第１１案,新北市,三峽區,龍學里,1944,1579,574,291,865,12,877
公投第１１案,新北市,三峽區,龍學里,1945,1435,509,238,747,22,769
公投第１１案,新北市,三峽區,龍學里,1946,1659,645,290,935,32,967
公投第１１案,新北市,三峽區,龍學里,1947,1512,581,317,898,19,917
公投第１１案,新北市,三峽區,龍學里,1948,1463,569,267,836,20,856
公投第１１案,新北市,三峽區,龍學里,1949,1465,545,291,836,21,857
公投第１１案,新北市,三峽區,龍學里,1950,1463,580,270,850,11,861
公投第１１案,新北市,三峽區,龍學里,1951,1443,551,257,808,26,834
公投第１１案,新北市,三峽區,礁溪里,1952,1634,520,282,802,29,831
公投第１１案,新北市,三峽區,礁溪里,1953,1716,622,298,920,31,951
公投第１１案,新北市,三峽區,礁溪里,1954,1675,567,284,851,23,874
公投第１１案,新北市,三峽區,安溪里,1955,1649,475,242,717,31,748
公投第１１案,新北市,三峽區,安溪里,1956,1489,503,249,752,37,789
公投第１１案,新北市,三峽區,安溪里,1957,1771,537,303,840,29,869
公投第１１案,新北市,三峽區,安溪里,1958,1726,570,353,923,22,945
公投第１１案,新北市,三峽區,介壽里,1959,1363,456,239,695,35,730
公投第１１案,新北市,三峽區,介壽里,1960,1624,566,304,870,20,890
公投第１１案,新北市,三峽區,介壽里,1961,1352,470,262,732,28,760
公投第１１案,新北市,三峽區,介壽里,1962,1608,413,252,665,12,677
公投第１１案,新北市,三峽區,中正里,1963,1458,481,273,754,28,782
公投第１１案,新北市,三峽區,中正里,1964,1641,499,271,770,38,808
公投第１１案,新北市,三峽區,中正里,1965,1530,487,245,732,73,805
公投第１１案,新北市,三峽區,大埔里,1966,1389,392,201,593,29,622
公投第１１案,新北市,三峽區,大埔里,1967,1315,397,218,615,49,664
公投第１１案,新北市,三峽區,大埔里,1968,934,407,137,544,26,570
公投第１１案,新北市,三峽區,嘉添里,1969,1270,403,204,607,24,631
公投第１１案,新北市,三峽區,嘉添里,1970,929,276,141,417,42,459
公投第１１案,新北市,三峽區,添福里,1971,1035,371,161,532,12,544
公投第１１案,新北市,三峽區,金圳里,1972,502,170,71,241,10,251
公投第１１案,新北市,三峽區,五寮里,1973,836,258,122,380,35,415
公投第１１案,新北市,三峽區,插角里,1974,669,190,95,285,45,330
公投第１１案,新北市,三峽區,有木里,1975,733,254,116,370,72,442
公投第１１案,新北市,三峽區,二鬮里,1976,1560,645,251,896,38,934
公投第１１案,新北市,三峽區,二鬮里,1977,1638,544,264,808,41,849
公投第１１案,新北市,三峽區,溪南里,1978,1394,508,188,696,26,722
公投第１１案,新北市,三峽區,溪北里,1979,771,257,167,424,22,446
公投第１１案,新北市,三峽區,溪北里,1980,1367,456,232,688,21,709
公投第１１案,新北市,三峽區,溪東里,1981,1241,401,197,598,49,647
公投第１１案,新北市,三峽區,溪東里,1982,1520,492,238,730,21,751
公投第１１案,新北市,三峽區,成福里,1983,873,374,153,527,32,559
公投第１１案,新北市,三峽區,竹崙里,1984,768,202,111,313,60,373
公投第１１案,新北市,三峽區,竹崙里,1985,1097,341,161,502,11,513
公投第１１案,新北市,三峽區,安坑里,1986,1322,372,183,555,38,593
公投第１１案,新北市,新店區,新店里,1987,1603,564,299,863,34,897
公投第１１案,新北市,新店區,張南里,1988,1921,700,364,1064,35,1099
公投第１１案,新北市,新店區,國校里,1989,1082,382,192,574,24,598
公投第１１案,新北市,新店區,國校里,1990,1235,437,257,694,28,722
公投第１１案,新北市,新店區,文中里,1991,1568,635,264,899,19,918
公投第１１案,新北市,新店區,廣明里,1992,771,285,152,437,29,466
公投第１１案,新北市,新店區,文明里,1993,1256,431,265,696,25,721
公投第１１案,新北市,新店區,文明里,1994,1008,377,199,576,28,604
公投第１１案,新北市,新店區,中興里,1995,1515,612,255,867,31,898
公投第１１案,新北市,新店區,中興里,1996,1637,688,296,984,30,1014
公投第１１案,新北市,新店區,中興里,1997,1549,547,333,880,23,903
公投第１１案,新北市,新店區,新生里,1998,2011,805,414,1219,40,1259
公投第１１案,新北市,新店區,新生里,1999,1554,568,287,855,53,908
公投第１１案,新北市,新店區,新生里,2000,1770,607,339,946,45,991
公投第１１案,新北市,新店區,新德里,2001,1316,490,255,745,37,782
公投第１１案,新北市,新店區,新德里,2002,1126,434,179,613,30,643
公投第１１案,新北市,新店區,張北里,2003,1460,521,261,782,26,808
公投第１１案,新北市,新店區,張北里,2004,1584,607,304,911,36,947
公投第１１案,新北市,新店區,張北里,2005,1449,533,268,801,31,832
公投第１１案,新北市,新店區,張北里,2006,1520,640,299,939,24,963
公投第１１案,新北市,新店區,張北里,2007,1821,716,335,1051,22,1073
公投第１１案,新北市,新店區,五峯里,2008,1956,692,401,1093,26,1119
公投第１１案,新北市,新店區,五峯里,2009,1665,619,320,939,42,981
公投第１１案,新北市,新店區,五峯里,2010,1588,612,335,947,23,970
公投第１１案,新北市,新店區,五峯里,2011,1519,508,305,813,41,854
公投第１１案,新北市,新店區,長春里,2012,1185,460,271,731,23,754
公投第１１案,新北市,新店區,長春里,2013,1095,424,264,688,16,704
公投第１１案,新北市,新店區,新安里,2014,1106,447,215,662,34,696
公投第１１案,新北市,新店區,新安里,2015,2700,236,159,395,18,413
公投第１１案,新北市,新店區,新安里,2016,995,416,176,592,15,607
公投第１１案,新北市,新店區,新安里,2017,1168,451,209,660,35,695
公投第１１案,新北市,新店區,忠誠里,2018,1123,510,219,729,35,764
公投第１１案,新北市,新店區,忠誠里,2019,1085,399,285,684,26,710
公投第１１案,新北市,新店區,中正里,2020,1412,554,291,845,42,887
公投第１１案,新北市,新店區,中正里,2021,1659,642,300,942,32,974
公投第１１案,新北市,新店區,中正里,2022,1198,497,233,730,35,765
公投第１１案,新北市,新店區,中正里,2023,1376,500,220,720,28,748
公投第１１案,新北市,新店區,中華里,2024,1300,490,212,702,25,727
公投第１１案,新北市,新店區,中華里,2025,1238,468,235,703,24,727
公投第１１案,新北市,新店區,中華里,2026,1388,495,248,743,20,763
公投第１１案,新北市,新店區,仁愛里,2027,933,370,195,565,29,594
公投第１１案,新北市,新店區,仁愛里,2028,908,391,174,565,19,584
公投第１１案,新北市,新店區,建國里,2029,1582,589,281,870,42,912
公投第１１案,新北市,新店區,建國里,2030,1247,520,229,749,32,781
公投第１１案,新北市,新店區,百忍里,2031,971,371,206,577,27,604
公投第１１案,新北市,新店區,百忍里,2032,1145,453,223,676,34,710
公投第１１案,新北市,新店區,百忍里,2033,1392,546,259,805,33,838
公投第１１案,新北市,新店區,百和里,2034,1452,615,265,880,39,919
公投第１１案,新北市,新店區,百和里,2035,1440,531,270,801,37,838
公投第１１案,新北市,新店區,福德里,2036,1786,630,324,954,51,1005
公投第１１案,新北市,新店區,福德里,2037,1825,688,335,1023,39,1062
公投第１１案,新北市,新店區,百福里,2038,1477,599,291,890,17,907
公投第１１案,新北市,新店區,百福里,2039,1750,661,343,1004,31,1035
公投第１１案,新北市,新店區,福民里,2040,1792,796,293,1089,32,1121
公投第１１案,新北市,新店區,福民里,2041,1979,765,325,1090,34,1124
公投第１１案,新北市,新店區,中山里,2042,826,334,158,492,13,505
公投第１１案,新北市,新店區,中山里,2043,1924,797,310,1107,35,1142
公投第１１案,新北市,新店區,中山里,2044,1383,584,261,845,26,871
公投第１１案,新北市,新店區,和平里,2045,830,286,132,418,24,442
公投第１１案,新北市,新店區,中央里,2046,1759,703,334,1037,34,1071
公投第１１案,新北市,新店區,中央里,2047,1957,771,367,1138,44,1182
公投第１１案,新北市,新店區,中央里,2048,1481,592,303,895,10,905
公投第１１案,新北市,新店區,國豐里,2049,1552,582,303,885,37,922
公投第１１案,新北市,新店區,國豐里,2050,1467,522,277,799,51,850
公投第１１案,新北市,新店區,明德里,2051,1371,516,241,757,33,790
公投第１１案,新北市,新店區,明德里,2052,991,376,206,582,25,607
公投第１１案,新北市,新店區,明德里,2053,1231,467,265,732,22,754
公投第１１案,新北市,新店區,大豐里,2054,1701,616,346,962,36,998
公投第１１案,新北市,新店區,大豐里,2055,1707,628,324,952,48,1000
公投第１１案,新北市,新店區,大同里,2056,1773,677,314,991,24,1015
公投第１１案,新北市,新店區,大同里,2057,1866,641,319,960,33,993
公投第１１案,新北市,新店區,江陵里,2058,1735,656,343,999,36,1035
公投第１１案,新北市,新店區,江陵里,2059,1632,660,350,1010,31,1041
公投第１１案,新北市,新店區,江陵里,2060,1591,585,319,904,42,946
公投第１１案,新北市,新店區,復興里,2061,1495,526,247,773,46,819
公投第１１案,新北市,新店區,復興里,2062,1511,535,238,773,28,801
公投第１１案,新北市,新店區,寶興里,2063,1260,488,218,706,33,739
公投第１１案,新北市,新店區,寶興里,2064,1948,780,349,1129,39,1168
公投第１１案,新北市,新店區,寶興里,2065,1582,618,332,950,41,991
公投第１１案,新北市,新店區,寶福里,2066,1315,482,257,739,29,768
公投第１１案,新北市,新店區,寶福里,2067,1562,547,284,831,46,877
公投第１１案,新北市,新店區,寶福里,2068,1982,787,375,1162,25,1187
公投第１１案,新北市,新店區,寶福里,2069,1518,581,291,872,36,908
公投第１１案,新北市,新店區,寶安里,2070,1735,633,334,967,27,994
公投第１１案,新北市,新店區,寶安里,2071,1716,631,298,929,44,973
公投第１１案,新北市,新店區,寶安里,2072,1580,594,290,884,46,930
公投第１１案,新北市,新店區,信義里,2073,1358,548,269,817,31,848
公投第１１案,新北市,新店區,信義里,2074,1610,634,323,957,45,1002
公投第１１案,新北市,新店區,信義里,2075,1383,492,262,754,20,774
公投第１１案,新北市,新店區,信義里,2076,1596,612,301,913,31,944
公投第１１案,新北市,新店區,忠孝里,2077,1360,483,211,694,34,728
公投第１１案,新北市,新店區,忠孝里,2078,1160,430,174,604,14,618
公投第１１案,新北市,新店區,大鵬里,2079,1236,606,195,801,7,808
公投第１１案,新北市,新店區,大鵬里,2080,1234,537,237,774,24,798
公投第１１案,新北市,新店區,太平里,2081,1579,558,316,874,44,918
公投第１１案,新北市,新店區,太平里,2082,1241,479,203,682,28,710
公投第１１案,新北市,新店區,美城里,2083,1275,484,229,713,20,733
公投第１１案,新北市,新店區,美城里,2084,1214,414,200,614,32,646
公投第１１案,新北市,新店區,頂城里,2085,1578,488,255,743,51,794
公投第１１案,新北市,新店區,下城里,2086,1442,481,270,751,36,787
公投第１１案,新北市,新店區,下城里,2087,1475,466,236,702,64,766
公投第１１案,新北市,新店區,柴埕里,2088,1580,579,307,886,45,931
公投第１１案,新北市,新店區,柴埕里,2089,1585,584,275,859,26,885
公投第１１案,新北市,新店區,柴埕里,2090,1586,553,294,847,45,892
公投第１１案,新北市,新店區,柴埕里,2091,1931,678,345,1023,45,1068
公投第１１案,新北市,新店區,柴埕里,2092,1239,443,219,662,23,685
公投第１１案,新北市,新店區,安和里,2093,1892,700,314,1014,39,1053
公投第１１案,新北市,新店區,安和里,2094,1529,545,235,780,35,815
公投第１１案,新北市,新店區,安和里,2095,1358,544,220,764,30,794
公投第１１案,新北市,新店區,安和里,2096,1905,643,319,962,32,994
公投第１１案,新北市,新店區,永安里,2097,1885,655,312,967,52,1019
公投第１１案,新北市,新店區,永安里,2098,1345,485,206,691,49,740
公投第１１案,新北市,新店區,永安里,2099,1387,530,235,765,42,807
公投第１１案,新北市,新店區,新和里,2100,1960,699,348,1047,36,1083
公投第１１案,新北市,新店區,新和里,2101,1837,633,334,967,62,1029
公投第１１案,新北市,新店區,永平里,2102,1662,617,307,924,28,952
公投第１１案,新北市,新店區,永平里,2103,1617,622,326,948,47,995
公投第１１案,新北市,新店區,永平里,2104,1704,635,334,969,22,991
公投第１１案,新北市,新店區,公崙里,2105,1835,631,317,948,44,992
公投第１１案,新北市,新店區,公崙里,2106,2009,691,344,1035,55,1090
公投第１１案,新北市,新店區,公崙里,2107,1450,507,266,773,39,812
公投第１１案,新北市,新店區,公崙里,2108,1726,616,314,930,31,961
公投第１１案,新北市,新店區,公崙里,2109,1797,600,408,1008,31,1039
公投第１１案,新北市,新店區,公崙里,2110,1739,611,320,931,40,971
公投第１１案,新北市,新店區,安昌里,2111,1523,597,228,825,30,855
公投第１１案,新北市,新店區,安昌里,2112,1642,592,296,888,21,909
公投第１１案,新北市,新店區,安昌里,2113,1644,591,332,923,20,943
公投第１１案,新北市,新店區,德安里,2114,1662,556,278,834,30,864
公投第１１案,新北市,新店區,德安里,2115,2067,746,396,1142,42,1184
公投第１１案,新北市,新店區,德安里,2116,1870,544,308,852,31,883
公投第１１案,新北市,新店區,達觀里,2117,1982,685,358,1043,42,1085
公投第１１案,新北市,新店區,達觀里,2118,1546,545,277,822,37,859
公投第１１案,新北市,新店區,明城里,2119,1712,695,315,1010,28,1038
公投第１１案,新北市,新店區,明城里,2120,1423,562,291,853,30,883
公投第１１案,新北市,新店區,小城里,2121,1666,648,320,968,44,1012
公投第１１案,新北市,新店區,小城里,2122,1769,725,325,1050,40,1090
公投第１１案,新北市,新店區,雙城里,2123,1079,338,179,517,30,547
公投第１１案,新北市,新店區,雙城里,2124,1140,397,220,617,23,640
公投第１１案,新北市,新店區,雙城里,2125,1825,643,318,961,44,1005
公投第１１案,新北市,新店區,雙城里,2126,1178,436,237,673,42,715
公投第１１案,新北市,新店區,香坡里,2127,1463,499,264,763,37,800
公投第１１案,新北市,新店區,香坡里,2128,1152,430,212,642,23,665
公投第１１案,新北市,新店區,香坡里,2129,2008,619,303,922,24,946
公投第１１案,新北市,新店區,香坡里,2130,2120,644,310,954,25,979
公投第１１案,新北市,新店區,香坡里,2131,1153,460,223,683,16,699
公投第１１案,新北市,新店區,香坡里,2132,1573,529,272,801,21,822
公投第１１案,新北市,新店區,日興里,2133,1992,612,288,900,47,947
公投第１１案,新北市,新店區,日興里,2134,1668,519,267,786,40,826
公投第１１案,新北市,新店區,日興里,2135,1617,540,222,762,34,796
公投第１１案,新北市,新店區,玫瑰里,2136,2013,673,324,997,79,1076
公投第１１案,新北市,新店區,玫瑰里,2137,1791,696,328,1024,20,1044
公投第１１案,新北市,新店區,玫瑰里,2138,1624,596,308,904,25,929
公投第１１案,新北市,新店區,吉祥里,2139,1178,473,211,684,33,717
公投第１１案,新北市,新店區,吉祥里,2140,1277,493,239,732,23,755
公投第１１案,新北市,新店區,吉祥里,2141,1879,675,357,1032,37,1069
公投第１１案,新北市,新店區,塗潭里,2142,939,302,146,448,23,471
公投第１１案,新北市,新店區,華城里,2143,960,319,207,526,21,547
公投第１１案,新北市,新店區,華城里,2144,1434,563,293,856,31,887
公投第１１案,新北市,新店區,青潭里,2145,1838,589,336,925,39,964
公投第１１案,新北市,新店區,青潭里,2146,1453,515,267,782,33,815
公投第１１案,新北市,新店區,青潭里,2147,1549,627,125,752,77,829
公投第１１案,新北市,新店區,美潭里,2148,1860,698,367,1065,26,1091
公投第１１案,新北市,新店區,美潭里,2149,1743,623,268,891,32,923
公投第１１案,新北市,新店區,美潭里,2150,1122,468,240,708,30,738
公投第１１案,新北市,新店區,員潭里,2151,1468,566,216,782,34,816
公投第１１案,新北市,新店區,員潭里,2152,1763,618,315,933,32,965
公投第１１案,新北市,新店區,員潭里,2153,1344,457,235,692,28,720
公投第１１案,新北市,新店區,雙坑里,2154,753,266,116,382,25,407
公投第１１案,新北市,新店區,粗坑里,2155,602,209,121,330,9,339
公投第１１案,新北市,新店區,粗坑里,2156,2237,695,433,1128,48,1176
公投第１１案,新北市,新店區,屈尺里,2157,1096,417,182,599,19,618
公投第１１案,新北市,新店區,屈尺里,2158,1143,341,166,507,31,538
公投第１１案,新北市,新店區,龜山里,2159,1569,519,255,774,54,828
公投第１１案,新北市,新店區,廣興里,2160,1284,439,220,659,54,713
公投第１１案,新北市,新店區,直潭里,2161,439,91,50,141,19,160
公投第１１案,新北市,新店區,直潭里,2162,750,244,164,408,28,436
公投第１１案,新北市,深坑區,萬順里,2163,1142,380,202,582,25,607
公投第１１案,新北市,深坑區,萬順里,2164,1139,412,222,634,42,676
公投第１１案,新北市,深坑區,萬福里,2165,1065,342,203,545,31,576
公投第１１案,新北市,深坑區,萬福里,2166,1400,448,236,684,37,721
公投第１１案,新北市,深坑區,土庫里,2167,1330,421,226,647,42,689
公投第１１案,新北市,深坑區,土庫里,2168,1380,430,237,667,29,696
公投第１１案,新北市,深坑區,深坑里,2169,1496,450,261,711,11,722
公投第１１案,新北市,深坑區,深坑里,2170,1508,548,280,828,33,861
公投第１１案,新北市,深坑區,埔新里,2171,1624,590,309,899,30,929
公投第１１案,新北市,深坑區,埔新里,2172,2165,737,389,1126,41,1167
公投第１１案,新北市,深坑區,埔新里,2173,1790,662,368,1030,31,1061
公投第１１案,新北市,深坑區,昇高里,2174,782,266,127,393,18,411
公投第１１案,新北市,深坑區,昇高里,2175,1164,431,236,667,17,684
公投第１１案,新北市,深坑區,賴仲里,2176,1344,506,257,763,43,806
公投第１１案,新北市,深坑區,賴仲里,2177,739,282,146,428,25,453
公投第１１案,新北市,深坑區,阿柔里,2178,556,206,115,321,20,341
公投第１１案,新北市,石碇區,石碇里,2179,391,146,84,230,13,243
公投第１１案,新北市,石碇區,潭邊里,2180,789,254,117,371,32,403
公投第１１案,新北市,石碇區,烏塗里,2181,662,174,76,250,26,276
公投第１１案,新北市,石碇區,彭山里,2182,310,104,45,149,12,161
公投第１１案,新北市,石碇區,豐田里,2183,280,99,43,142,8,150
公投第１１案,新北市,石碇區,豐田里,2184,93,25,8,33,5,38
公投第１１案,新北市,石碇區,隆盛里,2185,683,183,97,280,27,307
公投第１１案,新北市,石碇區,豐林里,2186,323,122,79,201,8,209
公投第１１案,新北市,石碇區,中民里,2187,726,202,77,279,12,291
公投第１１案,新北市,石碇區,永定里,2188,591,186,105,291,24,315
公投第１１案,新北市,石碇區,光明里,2189,282,119,57,176,15,191
公投第１１案,新北市,石碇區,永安里,2190,788,249,122,371,11,382
公投第１１案,新北市,石碇區,格頭里,2191,943,333,184,517,33,550
公投第１１案,新北市,坪林區,坪林里,2192,1248,438,190,628,42,670
公投第１１案,新北市,坪林區,水德里,2193,612,179,84,263,29,292
公投第１１案,新北市,坪林區,大林里,2194,1141,405,184,589,62,651
公投第１１案,新北市,坪林區,石𥕢里,2195,417,109,63,172,9,181
公投第１１案,新北市,坪林區,粗窟里,2196,595,215,81,296,36,332
公投第１１案,新北市,坪林區,粗窟里,2197,248,98,38,136,18,154
公投第１１案,新北市,坪林區,上德里,2198,338,118,38,156,12,168
公投第１１案,新北市,坪林區,上德里,2199,478,125,68,193,19,212
公投第１１案,新北市,坪林區,漁光里,2200,390,99,48,147,12,159
公投第１１案,新北市,坪林區,漁光里,2201,424,143,57,200,8,208
公投第１１案,新北市,烏來區,忠治里,2202,1568,645,276,921,29,950
公投第１１案,新北市,烏來區,烏來里,2203,1198,409,183,592,14,606
公投第１１案,新北市,烏來區,烏來里,2204,1169,428,163,591,14,605
公投第１１案,新北市,烏來區,孝義里,2205,228,92,33,125,1,126
公投第１１案,新北市,烏來區,信賢里,2206,486,198,68,266,15,281
公投第１１案,新北市,烏來區,福山里,2207,615,229,84,313,13,326
公投第１１案,新北市,平溪區,薯榔里,2208,384,130,43,173,22,195
公投第１１案,新北市,平溪區,菁桐里,2209,232,68,34,102,2,104
公投第１１案,新北市,平溪區,白石里,2210,249,86,45,131,11,142
公投第１１案,新北市,平溪區,石底里,2211,458,157,75,232,23,255
公投第１１案,新北市,平溪區,平溪里,2212,232,78,34,112,16,128
公投第１１案,新北市,平溪區,嶺腳里,2213,635,177,75,252,15,267
公投第１１案,新北市,平溪區,東勢里,2214,427,155,61,216,33,249
公投第１１案,新北市,平溪區,十分里,2215,862,252,105,357,29,386
公投第１１案,新北市,平溪區,望古里,2216,147,42,30,72,2,74
公投第１１案,新北市,平溪區,南山里,2217,365,105,28,133,11,144
公投第１１案,新北市,平溪區,新寮里,2218,153,43,19,62,8,70
公投第１１案,新北市,平溪區,平湖里,2219,177,82,18,100,9,109
公投第１１案,新北市,瑞芳區,龍潭里,2220,725,279,113,392,30,422
公投第１１案,新北市,瑞芳區,龍興里,2221,1074,365,210,575,35,610
公投第１１案,新北市,瑞芳區,龍興里,2222,825,285,124,409,21,430
公投第１１案,新北市,瑞芳區,龍鎮里,2223,1242,408,227,635,37,672
公投第１１案,新北市,瑞芳區,龍安里,2224,598,201,97,298,27,325
公投第１１案,新北市,瑞芳區,龍川里,2225,872,299,147,446,21,467
公投第１１案,新北市,瑞芳區,龍川里,2226,760,218,123,341,28,369
公投第１１案,新北市,瑞芳區,龍山里,2227,1330,367,236,603,32,635
公投第１１案,新北市,瑞芳區,爪峯里,2228,1683,490,259,749,38,787
公投第１１案,新北市,瑞芳區,爪峯里,2229,980,327,151,478,40,518
公投第１１案,新北市,瑞芳區,爪峯里,2230,946,323,149,472,32,504
公投第１１案,新北市,瑞芳區,新峰里,2231,1375,437,162,599,28,627
公投第１１案,新北市,瑞芳區,新峰里,2232,1671,523,270,793,30,823
公投第１１案,新北市,瑞芳區,東和里,2233,978,299,123,422,23,445
公投第１１案,新北市,瑞芳區,東和里,2234,645,92,195,287,27,314
公投第１１案,新北市,瑞芳區,柑坪里,2235,1089,327,178,505,52,557
公投第１１案,新北市,瑞芳區,弓橋里,2236,286,75,39,114,9,123
公投第１１案,新北市,瑞芳區,猴硐里,2237,461,138,81,219,20,239
公投第１１案,新北市,瑞芳區,光復里,2238,274,83,37,120,18,138
公投第１１案,新北市,瑞芳區,碩仁里,2239,155,61,26,87,9,96
公投第１１案,新北市,瑞芳區,吉慶里,2240,817,264,155,419,29,448
公投第１１案,新北市,瑞芳區,吉慶里,2241,884,273,158,431,39,470
公投第１１案,新北市,瑞芳區,吉安里,2242,1333,377,204,581,35,616
公投第１１案,新北市,瑞芳區,吉安里,2243,607,172,84,256,7,263
公投第１１案,新北市,瑞芳區,吉安里,2244,1045,354,161,515,39,554
公投第１１案,新北市,瑞芳區,上天里,2245,673,227,105,332,36,368
公投第１１案,新北市,瑞芳區,上天里,2246,618,166,79,245,11,256
公投第１１案,新北市,瑞芳區,傑魚里,2247,1063,412,168,580,16,596
公投第１１案,新北市,瑞芳區,傑魚里,2248,860,281,152,433,36,469
公投第１１案,新北市,瑞芳區,基山里,2249,432,78,53,131,6,137
公投第１１案,新北市,瑞芳區,永慶里,2250,445,131,39,170,9,179
公投第１１案,新北市,瑞芳區,崇文里,2251,318,97,33,130,8,138
公投第１１案,新北市,瑞芳區,福住里,2252,159,55,17,72,5,77
公投第１１案,新北市,瑞芳區,頌德里,2253,337,98,39,137,10,147
公投第１１案,新北市,瑞芳區,瓜山里,2254,180,61,32,93,6,99
公投第１１案,新北市,瑞芳區,銅山里,2255,187,50,21,71,11,82
公投第１１案,新北市,瑞芳區,新山里,2256,369,134,47,181,10,191
公投第１１案,新北市,瑞芳區,石山里,2257,335,121,48,169,19,188
公投第１１案,新北市,瑞芳區,濓洞里,2258,470,122,70,192,15,207
公投第１１案,新北市,瑞芳區,濓新里,2259,297,80,29,109,6,115
公投第１１案,新北市,瑞芳區,南雅里,2260,267,127,47,174,6,180
公投第１１案,新北市,瑞芳區,鼻頭里,2261,876,188,62,250,10,260
公投第１１案,新北市,瑞芳區,海濱里,2262,1241,314,142,456,24,480
公投第１１案,新北市,瑞芳區,瑞濱里,2263,998,328,160,488,46,534
公投第１１案,新北市,瑞芳區,瑞濱里,2264,948,320,146,466,37,503
公投第１１案,新北市,瑞芳區,深澳里,2265,1308,362,134,496,27,523
公投第１１案,新北市,雙溪區,雙溪里,2266,455,149,53,202,15,217
公投第１１案,新北市,雙溪區,新基里,2267,286,100,39,139,10,149
公投第１１案,新北市,雙溪區,新基里,2268,496,193,64,257,19,276
公投第１１案,新北市,雙溪區,三港里,2269,383,117,41,158,10,168
公投第１１案,新北市,雙溪區,牡丹里,2270,887,254,98,352,32,384
公投第１１案,新北市,雙溪區,牡丹里,2271,652,172,79,251,29,280
公投第１１案,新北市,雙溪區,三貂里,2272,333,106,52,158,11,169
公投第１１案,新北市,雙溪區,平林里,2273,642,200,96,296,25,321
公投第１１案,新北市,雙溪區,平林里,2274,282,72,55,127,9,136
公投第１１案,新北市,雙溪區,上林里,2275,621,169,80,249,24,273
公投第１１案,新北市,雙溪區,外柑里,2276,422,104,51,155,16,171
公投第１１案,新北市,雙溪區,長源里,2277,369,80,34,114,22,136
公投第１１案,新北市,雙溪區,共和里,2278,120,40,20,60,5,65
公投第１１案,新北市,雙溪區,共和里,2279,271,80,42,122,12,134
公投第１１案,新北市,雙溪區,魚行里,2280,362,126,64,190,23,213
公投第１１案,新北市,雙溪區,魚行里,2281,371,117,50,167,26,193
公投第１１案,新北市,雙溪區,泰平里,2282,1047,420,157,577,40,617
公投第１１案,新北市,貢寮區,貢寮里,2283,876,265,122,387,48,435
公投第１１案,新北市,貢寮區,龍崗里,2284,433,128,70,198,21,219
公投第１１案,新北市,貢寮區,吉林里,2285,516,148,65,213,11,224
公投第１１案,新北市,貢寮區,雙玉里,2286,373,84,45,129,24,153
公投第１１案,新北市,貢寮區,雙玉里,2287,313,84,45,129,21,150
公投第１１案,新北市,貢寮區,福連里,2288,485,164,67,231,10,241
公投第１１案,新北市,貢寮區,福連里,2289,415,114,70,184,28,212
公投第１１案,新北市,貢寮區,福隆里,2290,812,235,100,335,20,355
公投第１１案,新北市,貢寮區,福隆里,2291,861,251,134,385,32,417
公投第１１案,新北市,貢寮區,龍門里,2292,676,162,81,243,33,276
公投第１１案,新北市,貢寮區,真理里,2293,1091,267,137,404,19,423
公投第１１案,新北市,貢寮區,真理里,2294,955,241,104,345,41,386
公投第１１案,新北市,貢寮區,仁里里,2295,769,213,103,316,6,322
公投第１１案,新北市,貢寮區,仁里里,2296,962,265,171,436,34,470
公投第１１案,新北市,貢寮區,美豐里,2297,390,143,56,199,7,206
公投第１１案,新北市,貢寮區,美豐里,2298,349,106,46,152,9,161
公投第１１案,新北市,貢寮區,和美里,2299,508,135,52,187,26,213
公投第１１案,新北市,貢寮區,和美里,2300,495,106,50,156,11,167
公投第１１案,新北市,金山區,和平里,2301,481,172,67,239,23,262
公投第１１案,新北市,金山區,大同里,2302,715,233,116,349,31,380
公投第１１案,新北市,金山區,豐漁里,2303,481,147,47,194,20,214
公投第１１案,新北市,金山區,磺港里,2304,1792,573,204,777,65,842
公投第１１案,新北市,金山區,美田里,2305,1781,589,272,861,55,916
公投第１１案,新北市,金山區,美田里,2306,2010,656,365,1021,56,1077
公投第１１案,新北市,金山區,金美里,2307,1572,482,236,718,53,771
公投第１１案,新北市,金山區,金美里,2308,1777,539,315,854,51,905
公投第１１案,新北市,金山區,金美里,2309,1631,470,256,726,54,780
公投第１１案,新北市,金山區,五湖里,2310,828,272,135,407,30,437
公投第１１案,新北市,金山區,五湖里,2311,888,299,155,454,20,474
公投第１１案,新北市,金山區,重和里,2312,1211,376,182,558,54,612
公投第１１案,新北市,金山區,兩湖里,2313,416,160,70,230,9,239
公投第１１案,新北市,金山區,六股里,2314,682,250,117,367,32,399
公投第１１案,新北市,金山區,三界里,2315,644,219,94,313,36,349
公投第１１案,新北市,金山區,清泉里,2316,830,275,104,379,32,411
公投第１１案,新北市,金山區,西湖里,2317,188,59,32,91,9,100
公投第１１案,新北市,金山區,萬壽里,2318,469,151,83,234,29,263
公投第１１案,新北市,金山區,永興里,2319,582,139,50,189,29,218
公投第１１案,新北市,萬里區,萬里里,2320,1286,470,192,662,37,699
公投第１１案,新北市,萬里區,萬里里,2321,1576,538,279,817,44,861
公投第１１案,新北市,萬里區,萬里里,2322,1447,441,234,675,27,702
公投第１１案,新北市,萬里區,北基里,2323,1466,447,171,618,52,670
公投第１１案,新北市,萬里區,北基里,2324,1369,388,161,549,40,589
公投第１１案,新北市,萬里區,龜吼里,2325,1215,298,135,433,44,477
公投第１１案,新北市,萬里區,龜吼里,2326,1317,481,170,651,41,692
公投第１１案,新北市,萬里區,野柳里,2327,1676,531,187,718,37,755
公投第１１案,新北市,萬里區,野柳里,2328,1550,479,198,677,64,741
公投第１１案,新北市,萬里區,大鵬里,2329,945,377,167,544,43,587
公投第１１案,新北市,萬里區,大鵬里,2330,1760,615,282,897,62,959
公投第１１案,新北市,萬里區,磺潭里,2331,570,192,79,271,18,289
公投第１１案,新北市,萬里區,雙興里,2332,952,295,153,448,30,478
公投第１１案,新北市,萬里區,溪底里,2333,674,260,94,354,42,396
公投第１１案,新北市,萬里區,崁脚里,2334,405,130,65,195,19,214
公投第１１案,新北市,萬里區,中幅里,2335,1089,366,138,504,45,549
公投第１１案,新北市,汐止區,仁德里,2336,1595,545,274,819,57,876
公投第１１案,新北市,汐止區,義民里,2337,1262,448,222,670,38,708
公投第１１案,新北市,汐止區,禮門里,2338,917,283,211,494,47,541
公投第１１案,新北市,汐止區,智慧里,2339,1929,667,376,1043,33,1076
公投第１１案,新北市,汐止區,智慧里,2340,2227,703,440,1143,42,1185
公投第１１案,新北市,汐止區,大同里,2341,1143,357,223,580,46,626
公投第１１案,新北市,汐止區,大同里,2342,1367,483,257,740,25,765
公投第１１案,新北市,汐止區,信望里,2343,322,91,72,163,14,177
公投第１１案,新北市,汐止區,新昌里,2344,1460,497,307,804,6,810
公投第１１案,新北市,汐止區,新昌里,2345,1719,528,331,859,25,884
公投第１１案,新北市,汐止區,新昌里,2346,1661,583,265,848,35,883
公投第１１案,新北市,汐止區,福安里,2347,1590,558,309,867,34,901
公投第１１案,新北市,汐止區,福安里,2348,1599,561,289,850,33,883
公投第１１案,新北市,汐止區,福安里,2349,1749,604,334,938,34,972
公投第１１案,新北市,汐止區,秀峰里,2350,1809,208,130,338,18,356
公投第１１案,新北市,汐止區,秀峰里,2351,1601,470,284,754,26,780
公投第１１案,新北市,汐止區,秀峰里,2352,1387,470,226,696,43,739
公投第１１案,新北市,汐止區,秀山里,2353,1779,564,378,942,54,996
公投第１１案,新北市,汐止區,秀山里,2354,2074,737,376,1113,44,1157
公投第１１案,新北市,汐止區,復興里,2355,2072,684,405,1089,30,1119
公投第１１案,新北市,汐止區,復興里,2356,2120,762,423,1185,54,1239
公投第１１案,新北市,汐止區,復興里,2357,1952,670,375,1045,25,1070
公投第１１案,新北市,汐止區,自強里,2358,1654,546,287,833,49,882
公投第１１案,新北市,汐止區,自強里,2359,1444,473,254,727,39,766
公投第１１案,新北市,汐止區,自強里,2360,1627,597,341,938,27,965
公投第１１案,新北市,汐止區,文化里,2361,1751,574,297,871,47,918
公投第１１案,新北市,汐止區,文化里,2362,2066,648,399,1047,34,1081
公投第１１案,新北市,汐止區,白雲里,2363,1941,545,295,840,38,878
公投第１１案,新北市,汐止區,白雲里,2364,1906,534,356,890,28,918
公投第１１案,新北市,汐止區,茄苳里,2365,1363,432,240,672,46,718
公投第１１案,新北市,汐止區,茄苳里,2366,1368,438,235,673,31,704
公投第１１案,新北市,汐止區,茄苳里,2367,1233,369,210,579,35,614
公投第１１案,新北市,汐止區,崇德里,2368,1554,517,281,798,25,823
公投第１１案,新北市,汐止區,崇德里,2369,1700,551,343,894,33,927
公投第１１案,新北市,汐止區,崇德里,2370,1124,379,232,611,20,631
公投第１１案,新北市,汐止區,城中里,2371,1900,643,409,1052,36,1088
公投第１１案,新北市,汐止區,城中里,2372,2050,687,367,1054,42,1096
公投第１１案,新北市,汐止區,橋東里,2373,1244,370,259,629,41,670
公投第１１案,新北市,汐止區,橋東里,2374,1320,434,215,649,25,674
公投第１１案,新北市,汐止區,建成里,2375,1473,509,284,793,39,832
公投第１１案,新北市,汐止區,建成里,2376,1802,643,312,955,39,994
公投第１１案,新北市,汐止區,建成里,2377,1266,490,230,720,22,742
公投第１１案,新北市,汐止區,長安里,2378,1481,443,244,687,51,738
公投第１１案,新北市,汐止區,保安里,2379,1497,448,285,733,45,778
公投第１１案,新北市,汐止區,東山里,2380,556,200,101,301,18,319
公投第１１案,新北市,汐止區,保長里,2381,1913,596,322,918,45,963
公投第１１案,新北市,汐止區,保長里,2382,2027,612,369,981,35,1016
公投第１１案,新北市,汐止區,保新里,2383,1927,566,347,913,34,947
公投第１１案,新北市,汐止區,保新里,2384,696,226,130,356,31,387
公投第１１案,新北市,汐止區,鄉長里,2385,2127,618,386,1004,51,1055
公投第１１案,新北市,汐止區,江北里,2386,1642,467,273,740,38,778
公投第１１案,新北市,汐止區,江北里,2387,1912,623,316,939,62,1001
公投第１１案,新北市,汐止區,江北里,2388,1893,526,314,840,40,880
公投第１１案,新北市,汐止區,拱北里,2389,1466,443,236,679,38,717
公投第１１案,新北市,汐止區,拱北里,2390,1538,517,222,739,51,790
公投第１１案,新北市,汐止區,拱北里,2391,1550,474,285,759,25,784
公投第１１案,新北市,汐止區,烘內里,2392,1456,472,235,707,45,752
公投第１１案,新北市,汐止區,八連里,2393,947,265,274,539,37,576
公投第１１案,新北市,汐止區,長青里,2394,923,314,192,506,19,525
公投第１１案,新北市,汐止區,北峰里,2395,2043,638,328,966,64,1030
公投第１１案,新北市,汐止區,北峰里,2396,2012,593,312,905,63,968
公投第１１案,新北市,汐止區,金龍里,2397,1471,462,215,677,26,703
公投第１１案,新北市,汐止區,金龍里,2398,1603,496,288,784,31,815
公投第１１案,新北市,汐止區,金龍里,2399,1530,503,273,776,48,824
公投第１１案,新北市,汐止區,樟樹里,2400,1988,579,275,854,33,887
公投第１１案,新北市,汐止區,忠孝里,2401,2198,667,392,1059,35,1094
公投第１１案,新北市,汐止區,忠孝里,2402,1712,556,279,835,29,864
公投第１１案,新北市,汐止區,忠孝里,2403,1806,621,350,971,38,1009
公投第１１案,新北市,汐止區,忠孝里,2404,1576,534,252,786,57,843
公投第１１案,新北市,汐止區,厚德里,2405,1511,475,258,733,31,764
公投第１１案,新北市,汐止區,厚德里,2406,1691,526,285,811,25,836
公投第１１案,新北市,汐止區,厚德里,2407,1636,572,267,839,34,873
公投第１１案,新北市,汐止區,厚德里,2408,1676,548,293,841,26,867
公投第１１案,新北市,汐止區,山光里,2409,1264,435,209,644,19,663
公投第１１案,新北市,汐止區,山光里,2410,1165,421,179,600,17,617
公投第１１案,新北市,汐止區,中興里,2411,1765,557,294,851,43,894
公投第１１案,新北市,汐止區,中興里,2412,1815,537,259,796,23,819
公投第１１案,新北市,汐止區,中興里,2413,1778,544,289,833,53,886
公投第１１案,新北市,汐止區,中興里,2414,1580,547,288,835,36,871
公投第１１案,新北市,汐止區,福德里,2415,1516,481,289,770,35,805
公投第１１案,新北市,汐止區,福德里,2416,1425,462,219,681,25,706
公投第１１案,新北市,汐止區,興福里,2417,1388,481,244,725,39,764
公投第１１案,新北市,汐止區,興福里,2418,1436,488,259,747,42,789
公投第１１案,新北市,汐止區,康福里,2419,1591,482,328,810,29,839
公投第１１案,新北市,汐止區,康福里,2420,1639,492,296,788,26,814
公投第１１案,新北市,汐止區,康福里,2421,1394,439,250,689,14,703
公投第１１案,新北市,汐止區,湖光里,2422,2035,591,380,971,27,998
公投第１１案,新北市,汐止區,湖光里,2423,1895,641,323,964,30,994
公投第１１案,新北市,汐止區,湖光里,2424,1374,491,278,769,14,783
公投第１１案,新北市,汐止區,湖蓮里,2425,1061,369,238,607,19,626
公投第１１案,新北市,汐止區,湖蓮里,2426,1312,523,288,811,21,832
公投第１１案,新北市,汐止區,湖興里,2427,1548,538,285,823,30,853
公投第１１案,新北市,汐止區,湖興里,2428,1350,481,273,754,17,771
公投第１１案,新北市,汐止區,湖興里,2429,1499,487,305,792,25,817
公投第１１案,新北市,汐止區,湖興里,2430,1366,494,263,757,34,791
公投第１１案,新北市,汐止區,北山里,2431,1335,477,247,724,42,766
公投第１１案,新北市,汐止區,北山里,2432,1324,513,264,777,34,811
公投第１１案,新北市,汐止區,北山里,2433,1286,488,259,747,39,786
公投第１１案,新北市,汐止區,北山里,2434,1155,376,229,605,33,638
公投第１１案,新北市,汐止區,忠山里,2435,1682,675,339,1014,32,1046
公投第１１案,新北市,汐止區,忠山里,2436,1494,592,286,878,44,922
公投第１１案,新北市,汐止區,環河里,2437,1166,412,236,648,60,708
公投第１１案,新北市,汐止區,橫科里,2438,2184,728,415,1143,70,1213
公投第１１案,新北市,汐止區,橫科里,2439,2031,716,357,1073,51,1124
公投第１１案,新北市,汐止區,福山里,2440,1759,614,314,928,50,978
公投第１１案,新北市,汐止區,福山里,2441,1577,566,305,871,33,904
公投第１１案,新北市,汐止區,宜興里,2442,1364,489,238,727,19,746
公投第１１案,新北市,汐止區,宜興里,2443,1401,520,262,782,44,826
公投第１１案,新北市,汐止區,東勢里,2444,1173,409,259,668,31,699
公投第１１案,新北市,汐止區,東勢里,2445,993,376,197,573,10,583
公投第１１案,新北市,汐止區,東勢里,2446,1587,536,285,821,23,844
公投第１１案,臺中市,大甲區,朝陽里,1,1356,532,224,756,60,816
公投第１１案,臺中市,大甲區,大甲里,2,1059,434,199,633,33,666
公投第１１案,臺中市,大甲區,順天里,3,694,274,147,421,23,444
公投第１１案,臺中市,大甲區,順天里,4,874,352,173,525,14,539
公投第１１案,臺中市,大甲區,孔門里,5,763,285,128,413,16,429
公投第１１案,臺中市,大甲區,平安里,6,856,358,166,524,28,552
公投第１１案,臺中市,大甲區,平安里,7,1249,510,201,711,33,744
公投第１１案,臺中市,大甲區,庄美里,8,922,359,147,506,27,533
公投第１１案,臺中市,大甲區,庄美里,9,1189,458,221,679,32,711
公投第１１案,臺中市,大甲區,新美里,10,1065,439,192,631,47,678
公投第１１案,臺中市,大甲區,新美里,11,1252,545,209,754,54,808
公投第１１案,臺中市,大甲區,新美里,12,1057,396,185,581,46,627
公投第１１案,臺中市,大甲區,岷山里,13,1031,433,162,595,32,627
公投第１１案,臺中市,大甲區,岷山里,14,1060,446,195,641,25,666
公投第１１案,臺中市,大甲區,中山里,15,1311,505,223,728,40,768
公投第１１案,臺中市,大甲區,中山里,16,1424,561,224,785,35,820
公投第１１案,臺中市,大甲區,中山里,17,1670,639,292,931,50,981
公投第１１案,臺中市,大甲區,南陽里,18,812,333,126,459,28,487
公投第１１案,臺中市,大甲區,薰風里,19,863,395,140,535,29,564
公投第１１案,臺中市,大甲區,義和里,20,1598,648,268,916,35,951
公投第１１案,臺中市,大甲區,義和里,21,1588,638,230,868,33,901
公投第１１案,臺中市,大甲區,武陵里,22,1197,446,216,662,50,712
公投第１１案,臺中市,大甲區,文曲里,23,1106,253,179,432,56,488
公投第１１案,臺中市,大甲區,武曲里,24,903,364,168,532,38,570
公投第１１案,臺中市,大甲區,武曲里,25,869,364,142,506,34,540
公投第１１案,臺中市,大甲區,文武里,26,1350,547,242,789,29,818
公投第１１案,臺中市,大甲區,文武里,27,1144,435,180,615,75,690
公投第１１案,臺中市,大甲區,文武里,28,1208,526,189,715,31,746
公投第１１案,臺中市,大甲區,文武里,29,1567,586,315,901,38,939
公投第１１案,臺中市,大甲區,奉化里,30,1246,570,207,777,28,805
公投第１１案,臺中市,大甲區,奉化里,31,767,321,129,450,21,471
公投第１１案,臺中市,大甲區,德化里,32,790,326,137,463,24,487
公投第１１案,臺中市,大甲區,德化里,33,972,424,145,569,40,609
公投第１１案,臺中市,大甲區,江南里,34,1388,501,227,728,35,763
公投第１１案,臺中市,大甲區,頂店里,35,1331,468,226,694,25,719
公投第１１案,臺中市,大甲區,頂店里,36,1167,494,203,697,31,728
公投第１１案,臺中市,大甲區,頂店里,37,1934,800,310,1110,30,1140
公投第１１案,臺中市,大甲區,太白里,38,1263,419,202,621,40,661
公投第１１案,臺中市,大甲區,孟春里,39,1390,558,216,774,32,806
公投第１１案,臺中市,大甲區,孟春里,40,1186,407,171,578,32,610
公投第１１案,臺中市,大甲區,孟春里,41,1397,544,228,772,30,802
公投第１１案,臺中市,大甲區,幸福里,42,1173,382,157,539,21,560
公投第１１案,臺中市,大甲區,幸福里,43,1398,482,228,710,63,773
公投第１１案,臺中市,大甲區,日南里,44,1228,395,207,602,39,641
公投第１１案,臺中市,大甲區,日南里,45,1258,443,208,651,31,682
公投第１１案,臺中市,大甲區,日南里,46,1435,497,241,738,42,780
公投第１１案,臺中市,大甲區,日南里,47,1532,542,265,807,38,845
公投第１１案,臺中市,大甲區,龍泉里,48,652,238,113,351,31,382
公投第１１案,臺中市,大甲區,龍泉里,49,870,267,146,413,32,445
公投第１１案,臺中市,大甲區,西岐里,50,891,313,137,450,29,479
公投第１１案,臺中市,大甲區,西岐里,51,784,318,119,437,31,468
公投第１１案,臺中市,大甲區,銅安里,52,1368,486,190,676,73,749
公投第１１案,臺中市,大甲區,福德里,53,1126,355,193,548,55,603
公投第１１案,臺中市,大甲區,建興里,54,1486,440,244,684,53,737
公投第１１案,臺中市,大安區,南埔里,55,1068,368,150,518,52,570
公投第１１案,臺中市,大安區,南庄里,56,1050,390,180,570,47,617
公投第１１案,臺中市,大安區,中庄里,57,1246,469,226,695,58,753
公投第１１案,臺中市,大安區,中庄里,58,1397,527,204,731,55,786
公投第１１案,臺中市,大安區,東安里,59,1227,496,216,712,54,766
公投第１１案,臺中市,大安區,福興里,60,1170,445,191,636,60,696
公投第１１案,臺中市,大安區,龜壳里,61,914,375,176,551,45,596
公投第１１案,臺中市,大安區,龜壳里,62,667,196,117,313,34,347
公投第１１案,臺中市,大安區,頂安里,63,890,296,136,432,54,486
公投第１１案,臺中市,大安區,永安里,64,1289,487,193,680,56,736
公投第１１案,臺中市,大安區,永安里,65,455,151,70,221,21,242
公投第１１案,臺中市,大安區,福住里,66,1028,402,161,563,36,599
公投第１１案,臺中市,大安區,海墘里,67,1446,563,244,807,64,871
公投第１１案,臺中市,大安區,西安里,68,688,304,113,417,28,445
公投第１１案,臺中市,大安區,西安里,69,1062,432,172,604,44,648
公投第１１案,臺中市,大安區,松雅里,70,923,372,204,576,40,616
公投第１１案,臺中市,外埔區,永豐里,71,1059,372,181,553,47,600
公投第１１案,臺中市,外埔區,六分里,72,1013,410,177,587,22,609
公投第１１案,臺中市,外埔區,六分里,73,1150,478,191,669,49,718
公投第１１案,臺中市,外埔區,大同里,74,1855,817,317,1134,47,1181
公投第１１案,臺中市,外埔區,大同里,75,1327,547,220,767,35,802
公投第１１案,臺中市,外埔區,大同里,76,1453,512,322,834,52,886
公投第１１案,臺中市,外埔區,大東里,77,1653,639,237,876,62,938
公投第１１案,臺中市,外埔區,大東里,78,1615,612,233,845,32,877
公投第１１案,臺中市,外埔區,大東里,79,1470,555,234,789,27,816
公投第１１案,臺中市,外埔區,大東里,80,1559,630,261,891,50,941
公投第１１案,臺中市,外埔區,三崁里,81,1902,709,297,1006,65,1071
公投第１１案,臺中市,外埔區,水美里,82,1138,498,201,699,34,733
公投第１１案,臺中市,外埔區,水美里,83,1065,457,172,629,53,682
公投第１１案,臺中市,外埔區,水美里,84,1243,524,229,753,29,782
公投第１１案,臺中市,外埔區,鐵山里,85,962,314,173,487,43,530
公投第１１案,臺中市,外埔區,鐵山里,86,1169,424,196,620,41,661
公投第１１案,臺中市,外埔區,中山里,87,1216,553,211,764,34,798
公投第１１案,臺中市,外埔區,馬鳴里,88,1391,548,192,740,51,791
公投第１１案,臺中市,外埔區,土城里,89,1616,613,240,853,62,915
公投第１１案,臺中市,外埔區,廍子里,90,1203,374,177,551,43,594
公投第１１案,臺中市,清水區,鰲峰里,91,1076,367,192,559,29,588
公投第１１案,臺中市,清水區,靈泉里,92,953,392,188,580,45,625
公投第１１案,臺中市,清水區,清水里,93,914,344,184,528,46,574
公投第１１案,臺中市,清水區,清水里,94,1143,476,208,684,46,730
公投第１１案,臺中市,清水區,文昌里,95,680,255,146,401,24,425
公投第１１案,臺中市,清水區,南寧里,96,904,371,159,530,35,565
公投第１１案,臺中市,清水區,南寧里,97,893,361,179,540,42,582
公投第１１案,臺中市,清水區,西寧里,98,1577,590,289,879,39,918
公投第１１案,臺中市,清水區,北寧里,99,690,275,110,385,31,416
公投第１１案,臺中市,清水區,中興里,100,403,198,33,231,19,250
公投第１１案,臺中市,清水區,西社里,101,1413,533,268,801,52,853
公投第１１案,臺中市,清水區,西社里,102,777,279,146,425,35,460
公投第１１案,臺中市,清水區,南社里,103,1313,545,221,766,36,802
公投第１１案,臺中市,清水區,南社里,104,1439,589,256,845,48,893
公投第１１案,臺中市,清水區,南社里,105,1265,461,217,678,23,701
公投第１１案,臺中市,清水區,南社里,106,1277,532,234,766,34,800
公投第１１案,臺中市,清水區,南社里,107,1276,526,213,739,35,774
公投第１１案,臺中市,清水區,南社里,108,1376,558,277,835,25,860
公投第１１案,臺中市,清水區,南社里,109,1291,539,264,803,19,822
公投第１１案,臺中市,清水區,裕嘉里,110,1510,590,291,881,43,924
公投第１１案,臺中市,清水區,臨江里,111,1524,577,267,844,61,905
公投第１１案,臺中市,清水區,秀水里,112,1474,520,248,768,34,802
公投第１１案,臺中市,清水區,秀水里,113,1507,582,230,812,46,858
公投第１１案,臺中市,清水區,秀水里,114,1321,545,260,805,56,861
公投第１１案,臺中市,清水區,武鹿里,115,1157,408,168,576,36,612
公投第１１案,臺中市,清水區,武鹿里,116,1255,437,262,699,40,739
公投第１１案,臺中市,清水區,武鹿里,117,881,335,150,485,24,509
公投第１１案,臺中市,清水區,海濱里,118,1083,420,201,621,45,666
公投第１１案,臺中市,清水區,海濱里,119,951,384,174,558,31,589
公投第１１案,臺中市,清水區,槺榔里,120,1424,499,247,746,41,787
公投第１１案,臺中市,清水區,槺榔里,121,1233,416,205,621,57,678
公投第１１案,臺中市,清水區,槺榔里,122,1288,374,214,588,47,635
公投第１１案,臺中市,清水區,槺榔里,123,1200,462,216,678,43,721
公投第１１案,臺中市,清水區,中社里,124,1609,723,209,932,36,968
公投第１１案,臺中市,清水區,中社里,125,1136,471,237,708,16,724
公投第１１案,臺中市,清水區,高西里,126,1302,479,188,667,73,740
公投第１１案,臺中市,清水區,高南里,127,1373,485,217,702,80,782
公投第１１案,臺中市,清水區,高東里,128,1257,390,203,593,63,656
公投第１１案,臺中市,清水區,高北里,129,1184,394,187,581,47,628
公投第１１案,臺中市,清水區,高美里,130,1322,497,192,689,59,748
公投第１１案,臺中市,清水區,國姓里,131,1193,395,198,593,48,641
公投第１１案,臺中市,清水區,國姓里,132,927,327,157,484,66,550
公投第１１案,臺中市,清水區,菁埔里,133,1073,402,216,618,50,668
公投第１１案,臺中市,清水區,菁埔里,134,1163,457,217,674,55,729
公投第１１案,臺中市,清水區,頂湳里,135,855,289,138,427,51,478
公投第１１案,臺中市,清水區,頂湳里,136,902,317,140,457,43,500
公投第１１案,臺中市,清水區,田寮里,137,1415,505,268,773,47,820
公投第１１案,臺中市,清水區,田寮里,138,1066,370,179,549,37,586
公投第１１案,臺中市,清水區,橋頭里,139,1391,495,239,734,57,791
公投第１１案,臺中市,清水區,橋頭里,140,1449,533,198,731,33,764
公投第１１案,臺中市,清水區,橋頭里,141,1377,545,238,783,52,835
公投第１１案,臺中市,清水區,橋頭里,142,1423,545,263,808,42,850
公投第１１案,臺中市,清水區,橋頭里,143,1624,615,281,896,45,941
公投第１１案,臺中市,清水區,下湳里,144,1358,457,232,689,61,750
公投第１１案,臺中市,清水區,下湳里,145,1464,546,248,794,62,856
公投第１１案,臺中市,清水區,東山里,146,1211,447,244,691,52,743
公投第１１案,臺中市,清水區,吳厝里,147,1456,550,214,764,26,790
公投第１１案,臺中市,清水區,楊厝里,148,1162,503,168,671,58,729
公投第１１案,臺中市,清水區,海風里,149,1368,625,201,826,43,869
公投第１１案,臺中市,梧棲區,頂寮里,150,1541,551,276,827,52,879
公投第１１案,臺中市,梧棲區,頂寮里,151,1581,570,274,844,42,886
公投第１１案,臺中市,梧棲區,下寮里,152,1083,387,211,598,43,641
公投第１１案,臺中市,梧棲區,下寮里,153,876,340,162,502,27,529
公投第１１案,臺中市,梧棲區,中正里,154,1043,380,188,568,47,615
公投第１１案,臺中市,梧棲區,中正里,155,1502,512,237,749,35,784
公投第１１案,臺中市,梧棲區,中正里,156,1384,515,248,763,45,808
公投第１１案,臺中市,梧棲區,中和里,157,517,212,109,321,30,351
公投第１１案,臺中市,梧棲區,文化里,158,1169,481,207,688,62,750
公投第１１案,臺中市,梧棲區,安仁里,159,863,314,183,497,27,524
公投第１１案,臺中市,梧棲區,草湳里,160,1277,424,196,620,24,644
公投第１１案,臺中市,梧棲區,草湳里,161,1742,613,299,912,35,947
公投第１１案,臺中市,梧棲區,草湳里,162,1342,461,280,741,51,792
公投第１１案,臺中市,梧棲區,草湳里,163,1767,649,334,983,47,1030
公投第１１案,臺中市,梧棲區,南簡里,164,1542,478,257,735,51,786
公投第１１案,臺中市,梧棲區,南簡里,165,1636,535,329,864,33,897
公投第１１案,臺中市,梧棲區,南簡里,166,1796,617,342,959,1,960
公投第１１案,臺中市,梧棲區,福德里,167,1450,484,263,747,56,803
公投第１１案,臺中市,梧棲區,福德里,168,1548,528,247,775,80,855
公投第１１案,臺中市,梧棲區,福德里,169,1366,520,256,776,31,807
公投第１１案,臺中市,梧棲區,大庄里,170,955,407,188,595,27,622
公投第１１案,臺中市,梧棲區,大庄里,171,1305,489,181,670,48,718
公投第１１案,臺中市,梧棲區,大庄里,172,1239,470,235,705,32,737
公投第１１案,臺中市,梧棲區,大庄里,173,1079,455,170,625,44,669
公投第１１案,臺中市,梧棲區,大庄里,174,1220,442,210,652,36,688
公投第１１案,臺中市,梧棲區,大庄里,175,1544,603,273,876,59,935
公投第１１案,臺中市,梧棲區,大村里,176,1460,541,303,844,39,883
公投第１１案,臺中市,梧棲區,大村里,177,1292,492,245,737,53,790
公投第１１案,臺中市,梧棲區,大村里,178,1300,474,228,702,39,741
公投第１１案,臺中市,梧棲區,大村里,179,1555,538,267,805,34,839
公投第１１案,臺中市,梧棲區,興農里,180,1031,366,175,541,38,579
公投第１１案,臺中市,梧棲區,興農里,181,1277,443,265,708,57,765
公投第１１案,臺中市,梧棲區,永寧里,182,1037,353,197,550,32,582
公投第１１案,臺中市,梧棲區,永寧里,183,1187,445,218,663,52,715
公投第１１案,臺中市,梧棲區,永安里,184,1399,498,223,721,54,775
公投第１１案,臺中市,梧棲區,永安里,185,1135,424,192,616,31,647
公投第１１案,臺中市,沙鹿區,居仁里,186,1380,459,251,710,36,746
公投第１１案,臺中市,沙鹿區,洛泉里,187,852,338,146,484,38,522
公投第１１案,臺中市,沙鹿區,洛泉里,188,1176,500,198,698,33,731
公投第１１案,臺中市,沙鹿區,沙鹿里,189,958,377,220,597,48,645
公投第１１案,臺中市,沙鹿區,美仁里,190,488,228,85,313,22,335
公投第１１案,臺中市,沙鹿區,興仁里,191,1177,405,247,652,41,693
公投第１１案,臺中市,沙鹿區,興仁里,192,1285,478,218,696,47,743
公投第１１案,臺中市,沙鹿區,興安里,193,1736,597,288,885,61,946
公投第１１案,臺中市,沙鹿區,興安里,194,1628,628,308,936,55,991
公投第１１案,臺中市,沙鹿區,斗抵里,195,1469,513,253,766,32,798
公投第１１案,臺中市,沙鹿區,斗抵里,196,1423,564,265,829,44,873
公投第１１案,臺中市,沙鹿區,斗抵里,197,1444,565,228,793,70,863
公投第１１案,臺中市,沙鹿區,鹿峰里,198,1469,546,265,811,51,862
公投第１１案,臺中市,沙鹿區,鹿峰里,199,1902,684,370,1054,49,1103
公投第１１案,臺中市,沙鹿區,鹿峰里,200,1675,640,325,965,28,993
公投第１１案,臺中市,沙鹿區,鹿寮里,201,1098,393,195,588,49,637
公投第１１案,臺中市,沙鹿區,鹿寮里,202,1539,598,294,892,48,940
公投第１１案,臺中市,沙鹿區,鹿寮里,203,1329,540,250,790,21,811
公投第１１案,臺中市,沙鹿區,鹿寮里,204,1255,461,214,675,39,714
公投第１１案,臺中市,沙鹿區,鹿寮里,205,1507,570,289,859,50,909
公投第１１案,臺中市,沙鹿區,竹林里,206,1463,555,258,813,55,868
公投第１１案,臺中市,沙鹿區,竹林里,207,1279,456,192,648,61,709
公投第１１案,臺中市,沙鹿區,竹林里,208,1024,356,162,518,29,547
公投第１１案,臺中市,沙鹿區,竹林里,209,1388,497,209,706,52,758
公投第１１案,臺中市,沙鹿區,竹林里,210,1074,414,209,623,26,649
公投第１１案,臺中市,沙鹿區,竹林里,211,1072,325,203,528,26,554
公投第１１案,臺中市,沙鹿區,犁分里,212,1107,460,187,647,42,689
公投第１１案,臺中市,沙鹿區,福興里,213,1947,658,290,948,44,992
公投第１１案,臺中市,沙鹿區,福興里,214,1682,600,271,871,45,916
公投第１１案,臺中市,沙鹿區,北勢里,215,1633,516,403,919,38,957
公投第１１案,臺中市,沙鹿區,北勢里,216,1533,559,226,785,42,827
公投第１１案,臺中市,沙鹿區,北勢里,217,1605,547,226,773,29,802
公投第１１案,臺中市,沙鹿區,晉江里,218,1694,602,268,870,31,901
公投第１１案,臺中市,沙鹿區,六路里,219,1628,550,275,825,52,877
公投第１１案,臺中市,沙鹿區,六路里,220,1665,644,308,952,21,973
公投第１１案,臺中市,沙鹿區,六路里,221,1651,588,292,880,30,910
公投第１１案,臺中市,沙鹿區,南勢里,222,1108,506,176,682,20,702
公投第１１案,臺中市,沙鹿區,南勢里,223,1142,485,194,679,26,705
公投第１１案,臺中市,沙鹿區,南勢里,224,1039,403,170,573,32,605
公投第１１案,臺中市,沙鹿區,埔子里,225,1840,666,306,972,44,1016
公投第１１案,臺中市,沙鹿區,埔子里,226,1872,682,317,999,40,1039
公投第１１案,臺中市,沙鹿區,埔子里,227,1558,535,264,799,38,837
公投第１１案,臺中市,沙鹿區,三鹿里,228,1739,607,266,873,33,906
公投第１１案,臺中市,沙鹿區,三鹿里,229,1672,537,270,807,37,844
公投第１１案,臺中市,沙鹿區,三鹿里,230,1634,633,250,883,28,911
公投第１１案,臺中市,沙鹿區,三鹿里,231,1616,540,243,783,46,829
公投第１１案,臺中市,沙鹿區,公明里,232,1593,588,293,881,29,910
公投第１１案,臺中市,沙鹿區,公明里,233,981,373,144,517,23,540
公投第１１案,臺中市,沙鹿區,公明里,234,1740,720,283,1003,43,1046
公投第１１案,臺中市,沙鹿區,清泉里,235,1247,496,226,722,45,767
公投第１１案,臺中市,沙鹿區,清泉里,236,1047,457,155,612,18,630
公投第１１案,臺中市,沙鹿區,西勢里,237,1119,414,185,599,65,664
公投第１１案,臺中市,沙鹿區,西勢里,238,1025,396,162,558,14,572
公投第１１案,臺中市,龍井區,竹坑里,239,1758,589,401,990,64,1054
公投第１１案,臺中市,龍井區,竹坑里,240,1275,502,191,693,40,733
公投第１１案,臺中市,龍井區,龍東里,241,1379,462,206,668,29,697
公投第１１案,臺中市,龍井區,龍東里,242,1403,696,23,719,34,753
公投第１１案,臺中市,龍井區,龍西里,243,974,371,167,538,34,572
公投第１１案,臺中市,龍井區,龍西里,244,901,366,181,547,33,580
公投第１１案,臺中市,龍井區,田中里,245,1779,614,314,928,66,994
公投第１１案,臺中市,龍井區,田中里,246,1609,580,331,911,47,958
公投第１１案,臺中市,龍井區,福田里,247,1038,373,154,527,21,548
公投第１１案,臺中市,龍井區,麗水里,248,1328,509,236,745,61,806
公投第１１案,臺中市,龍井區,麗水里,249,921,360,176,536,36,572
公投第１１案,臺中市,龍井區,龍津里,250,1609,535,255,790,55,845
公投第１１案,臺中市,龍井區,龍津里,251,1227,388,192,580,33,613
公投第１１案,臺中市,龍井區,龍津里,252,1278,473,192,665,64,729
公投第１１案,臺中市,龍井區,龍津里,253,914,263,147,410,16,426
公投第１１案,臺中市,龍井區,三德里,254,1678,523,261,784,37,821
公投第１１案,臺中市,龍井區,三德里,255,1233,394,211,605,34,639
公投第１１案,臺中市,龍井區,忠和里,256,1520,548,260,808,52,860
公投第１１案,臺中市,龍井區,忠和里,257,1905,674,282,956,47,1003
公投第１１案,臺中市,龍井區,忠和里,258,1520,741,115,856,56,912
公投第１１案,臺中市,龍井區,山腳里,259,1385,496,197,693,57,750
公投第１１案,臺中市,龍井區,山腳里,260,1212,411,232,643,32,675
公投第１１案,臺中市,龍井區,山腳里,261,1432,567,237,804,23,827
公投第１１案,臺中市,龍井區,山腳里,262,1663,615,258,873,34,907
公投第１１案,臺中市,龍井區,龍泉里,263,1422,498,231,729,36,765
公投第１１案,臺中市,龍井區,龍泉里,264,1616,520,200,720,96,816
公投第１１案,臺中市,龍井區,龍泉里,265,1422,554,244,798,50,848
公投第１１案,臺中市,龍井區,龍泉里,266,1165,461,210,671,26,697
公投第１１案,臺中市,龍井區,龍泉里,267,1624,571,317,888,12,900
公投第１１案,臺中市,龍井區,龍崗里,268,1613,612,260,872,37,909
公投第１１案,臺中市,龍井區,龍崗里,269,943,399,163,562,31,593
公投第１１案,臺中市,龍井區,新庄里,270,1595,566,239,805,61,866
公投第１１案,臺中市,龍井區,新庄里,271,1508,574,265,839,50,889
公投第１１案,臺中市,龍井區,新庄里,272,1479,528,255,783,27,810
公投第１１案,臺中市,龍井區,新庄里,273,1509,585,266,851,31,882
公投第１１案,臺中市,龍井區,南寮里,274,1582,662,277,939,45,984
公投第１１案,臺中市,龍井區,東海里,275,1725,641,299,940,40,980
公投第１１案,臺中市,龍井區,東海里,276,1616,649,253,902,37,939
公投第１１案,臺中市,龍井區,東海里,277,1657,645,313,958,36,994
公投第１１案,臺中市,龍井區,東海里,278,1774,620,378,998,33,1031
公投第１１案,臺中市,龍井區,東海里,279,1701,621,368,989,46,1035
公投第１１案,臺中市,龍井區,新東里,280,1121,412,221,633,32,665
公投第１１案,臺中市,龍井區,新東里,281,987,395,198,593,28,621
公投第１１案,臺中市,龍井區,新東里,282,1206,443,231,674,38,712
公投第１１案,臺中市,龍井區,新東里,283,1378,549,266,815,33,848
公投第１１案,臺中市,大肚區,王田里,284,1415,535,222,757,52,809
公投第１１案,臺中市,大肚區,王田里,285,1392,472,233,705,43,748
公投第１１案,臺中市,大肚區,王田里,286,1520,605,265,870,52,922
公投第１１案,臺中市,大肚區,中和里,287,862,371,166,537,47,584
公投第１１案,臺中市,大肚區,福山里,288,1256,532,201,733,47,780
公投第１１案,臺中市,大肚區,福山里,289,1292,486,213,699,49,748
公投第１１案,臺中市,大肚區,福山里,290,1010,401,179,580,39,619
公投第１１案,臺中市,大肚區,營埔里,291,1485,576,274,850,68,918
公投第１１案,臺中市,大肚區,社腳里,292,1190,514,201,715,53,768
公投第１１案,臺中市,大肚區,社腳里,293,1250,461,225,686,60,746
公投第１１案,臺中市,大肚區,新興里,294,1310,499,220,719,61,780
公投第１１案,臺中市,大肚區,新興里,295,1294,466,217,683,55,738
公投第１１案,臺中市,大肚區,大東里,296,1734,745,304,1049,49,1098
公投第１１案,臺中市,大肚區,大東里,297,1316,484,220,704,50,754
公投第１１案,臺中市,大肚區,大肚里,298,854,299,179,478,32,510
公投第１１案,臺中市,大肚區,大肚里,299,1273,516,268,784,36,820
公投第１１案,臺中市,大肚區,永和里,300,851,361,143,504,33,537
公投第１１案,臺中市,大肚區,磺溪里,301,1629,633,239,872,41,913
公投第１１案,臺中市,大肚區,永順里,302,1709,625,266,891,73,964
公投第１１案,臺中市,大肚區,成功里,303,953,338,147,485,38,523
公投第１１案,臺中市,大肚區,山陽里,304,1336,548,226,774,38,812
公投第１１案,臺中市,大肚區,頂街里,305,2113,710,371,1081,64,1145
公投第１１案,臺中市,大肚區,頂街里,306,1730,651,299,950,73,1023
公投第１１案,臺中市,大肚區,頂街里,307,1692,634,297,931,23,954
公投第１１案,臺中市,大肚區,頂街里,308,1747,639,328,967,47,1014
公投第１１案,臺中市,大肚區,瑞井里,309,1672,634,269,903,58,961
公投第１１案,臺中市,大肚區,瑞井里,310,1675,594,289,883,40,923
公投第１１案,臺中市,大肚區,瑞井里,311,1673,654,265,919,43,962
公投第１１案,臺中市,大肚區,蔗廍里,312,1636,649,297,946,35,981
公投第１１案,臺中市,大肚區,蔗廍里,313,1753,627,269,896,63,959
公投第１１案,臺中市,大肚區,蔗廍里,314,1343,483,214,697,23,720
公投第１１案,臺中市,大肚區,自強里,315,1822,682,301,983,49,1032
公投第１１案,臺中市,大肚區,自強里,316,1670,694,256,950,82,1032
公投第１１案,臺中市,烏日區,烏日里,317,1480,584,306,890,37,927
公投第１１案,臺中市,烏日區,烏日里,318,1841,720,358,1078,56,1134
公投第１１案,臺中市,烏日區,烏日里,319,1751,644,321,965,42,1007
公投第１１案,臺中市,烏日區,烏日里,320,1547,612,285,897,60,957
公投第１１案,臺中市,烏日區,烏日里,321,1836,739,307,1046,28,1074
公投第１１案,臺中市,烏日區,湖日里,322,1239,489,268,757,75,832
公投第１１案,臺中市,烏日區,湖日里,323,1295,468,224,692,51,743
公投第１１案,臺中市,烏日區,三和里,324,1263,442,238,680,38,718
公投第１１案,臺中市,烏日區,三和里,325,1622,547,337,884,32,916
公投第１１案,臺中市,烏日區,三和里,326,1822,668,304,972,58,1030
公投第１１案,臺中市,烏日區,榮泉里,327,1966,688,365,1053,49,1102
公投第１１案,臺中市,烏日區,榮泉里,328,1615,636,282,918,33,951
公投第１１案,臺中市,烏日區,榮泉里,329,1232,478,250,728,21,749
公投第１１案,臺中市,烏日區,學田里,330,1347,496,218,714,34,748
公投第１１案,臺中市,烏日區,學田里,331,1165,420,184,604,23,627
公投第１１案,臺中市,烏日區,九德里,332,1664,682,294,976,35,1011
公投第１１案,臺中市,烏日區,九德里,333,1230,499,230,729,39,768
公投第１１案,臺中市,烏日區,九德里,334,1574,656,286,942,56,998
公投第１１案,臺中市,烏日區,九德里,335,1452,621,276,897,25,922
公投第１１案,臺中市,烏日區,九德里,336,1879,711,282,993,35,1028
公投第１１案,臺中市,烏日區,九德里,337,1601,620,277,897,35,932
公投第１１案,臺中市,烏日區,九德里,338,1546,634,297,931,26,957
公投第１１案,臺中市,烏日區,九德里,339,1866,697,279,976,38,1014
公投第１１案,臺中市,烏日區,仁德里,340,1938,767,347,1114,43,1157
公投第１１案,臺中市,烏日區,仁德里,341,1759,650,324,974,37,1011
公投第１１案,臺中市,烏日區,仁德里,342,2061,735,358,1093,59,1152
公投第１１案,臺中市,烏日區,仁德里,343,1691,681,290,971,32,1003
公投第１１案,臺中市,烏日區,前竹里,344,1039,451,199,650,32,682
公投第１１案,臺中市,烏日區,前竹里,345,1221,525,208,733,33,766
公投第１１案,臺中市,烏日區,五光里,346,1650,634,324,958,52,1010
公投第１１案,臺中市,烏日區,光明里,347,937,354,175,529,33,562
公投第１１案,臺中市,烏日區,光明里,348,1220,461,239,700,29,729
公投第１１案,臺中市,烏日區,東園里,349,2139,734,324,1058,92,1150
公投第１１案,臺中市,烏日區,溪埧里,350,1371,677,170,847,44,891
公投第１１案,臺中市,烏日區,溪埧里,351,1277,483,221,704,46,750
公投第１１案,臺中市,烏日區,溪埧里,352,1708,594,308,902,48,950
公投第１１案,臺中市,烏日區,螺潭里,353,2048,779,312,1091,55,1146
公投第１１案,臺中市,烏日區,北里里,354,1632,558,301,859,55,914
公投第１１案,臺中市,烏日區,南里里,355,1327,517,235,752,57,809
公投第１１案,臺中市,烏日區,溪尾里,356,854,300,148,448,39,487
公投第１１案,臺中市,后里區,廣福里,357,852,354,143,497,47,544
公投第１１案,臺中市,后里區,廣福里,358,1135,420,185,605,45,650
公投第１１案,臺中市,后里區,仁里里,359,1079,383,160,543,40,583
公投第１１案,臺中市,后里區,義里里,360,1539,589,271,860,55,915
公投第１１案,臺中市,后里區,義里里,361,1591,560,314,874,53,927
公投第１１案,臺中市,后里區,義德里,362,1376,474,215,689,28,717
公投第１１案,臺中市,后里區,義德里,363,1298,500,220,720,21,741
公投第１１案,臺中市,后里區,后里里,364,1428,541,245,786,64,850
公投第１１案,臺中市,后里區,后里里,365,1178,499,244,743,41,784
公投第１１案,臺中市,后里區,后里里,366,1095,418,200,618,39,657
公投第１１案,臺中市,后里區,厚里里,367,963,347,175,522,29,551
公投第１１案,臺中市,后里區,厚里里,368,1163,429,210,639,36,675
公投第１１案,臺中市,后里區,墩東里,369,1018,401,187,588,32,620
公投第１１案,臺中市,后里區,墩東里,370,854,366,161,527,27,554
公投第１１案,臺中市,后里區,墩東里,371,1485,529,242,771,45,816
公投第１１案,臺中市,后里區,墩東里,372,1355,578,243,821,41,862
公投第１１案,臺中市,后里區,墩西里,373,840,284,152,436,32,468
公投第１１案,臺中市,后里區,墩西里,374,1146,463,185,648,38,686
公投第１１案,臺中市,后里區,墩南里,375,1669,670,299,969,57,1026
公投第１１案,臺中市,后里區,墩南里,376,1673,656,321,977,63,1040
公投第１１案,臺中市,后里區,墩北里,377,1493,559,281,840,32,872
公投第１１案,臺中市,后里區,墩北里,378,1052,411,196,607,50,657
公投第１１案,臺中市,后里區,墩北里,379,909,324,166,490,18,508
公投第１１案,臺中市,后里區,中和里,380,1091,427,187,614,58,672
公投第１１案,臺中市,后里區,中和里,381,1342,513,241,754,76,830
公投第１１案,臺中市,后里區,舊社里,382,1138,394,207,601,46,647
公投第１１案,臺中市,后里區,舊社里,383,977,377,184,561,30,591
公投第１１案,臺中市,后里區,聯合里,384,1584,529,207,736,37,773
公投第１１案,臺中市,后里區,太平里,385,915,340,159,499,29,528
公投第１１案,臺中市,后里區,太平里,386,1225,466,222,688,54,742
公投第１１案,臺中市,后里區,眉山里,387,1552,581,261,842,28,870
公投第１１案,臺中市,后里區,眉山里,388,1600,604,260,864,22,886
公投第１１案,臺中市,后里區,月眉里,389,942,341,160,501,26,527
公投第１１案,臺中市,后里區,月眉里,390,943,336,162,498,30,528
公投第１１案,臺中市,后里區,公館里,391,1055,370,160,530,32,562
公投第１１案,臺中市,后里區,公館里,392,1067,406,174,580,53,633
公投第１１案,臺中市,后里區,泰安里,393,1340,477,202,679,37,716
公投第１１案,臺中市,豐原區,豐原里,394,983,369,162,531,32,563
公投第１１案,臺中市,豐原區,豐原里,395,1309,548,242,790,34,824
公投第１１案,臺中市,豐原區,豐榮里,396,1116,441,224,665,30,695
公投第１１案,臺中市,豐原區,頂街里,397,945,394,178,572,39,611
公投第１１案,臺中市,豐原區,中山里,398,850,309,195,504,51,555
公投第１１案,臺中市,豐原區,下街里,399,760,309,166,475,23,498
公投第１１案,臺中市,豐原區,中陽里,400,1617,645,264,909,10,919
公投第１１案,臺中市,豐原區,中陽里,401,1677,591,250,841,48,889
公投第１１案,臺中市,豐原區,中陽里,402,1771,736,345,1081,48,1129
公投第１１案,臺中市,豐原區,大湳里,403,1145,447,175,622,50,672
公投第１１案,臺中市,豐原區,大湳里,404,1362,498,255,753,39,792
公投第１１案,臺中市,豐原區,北湳里,405,1389,578,235,813,32,845
公投第１１案,臺中市,豐原區,北湳里,406,1530,620,271,891,49,940
公投第１１案,臺中市,豐原區,東湳里,407,1471,547,267,814,70,884
公投第１１案,臺中市,豐原區,東湳里,408,1410,571,239,810,62,872
公投第１１案,臺中市,豐原區,東湳里,409,1162,448,190,638,34,672
公投第１１案,臺中市,豐原區,西湳里,410,1656,660,270,930,27,957
公投第１１案,臺中市,豐原區,西湳里,411,1838,706,296,1002,41,1043
公投第１１案,臺中市,豐原區,西湳里,412,1666,612,280,892,66,958
公投第１１案,臺中市,豐原區,西湳里,413,1821,690,316,1006,87,1093
公投第１１案,臺中市,豐原區,西湳里,414,1821,812,342,1154,64,1218
公投第１１案,臺中市,豐原區,豐西里,415,1647,596,309,905,38,943
公投第１１案,臺中市,豐原區,圳寮里,416,1256,525,271,796,51,847
公投第１１案,臺中市,豐原區,豐圳里,417,1552,657,284,941,46,987
公投第１１案,臺中市,豐原區,豐圳里,418,1793,689,322,1011,48,1059
公投第１１案,臺中市,豐原區,富春里,419,759,353,150,503,41,544
公投第１１案,臺中市,豐原區,葫蘆里,420,642,268,133,401,24,425
公投第１１案,臺中市,豐原區,西安里,421,1528,628,287,915,34,949
公投第１１案,臺中市,豐原區,西安里,422,1788,768,308,1076,65,1141
公投第１１案,臺中市,豐原區,西安里,423,1663,711,322,1033,54,1087
公投第１１案,臺中市,豐原區,西勢里,424,1260,591,241,832,44,876
公投第１１案,臺中市,豐原區,西勢里,425,902,347,156,503,33,536
公投第１１案,臺中市,豐原區,中興里,426,1357,547,181,728,32,760
公投第１１案,臺中市,豐原區,中興里,427,1592,658,291,949,35,984
公投第１１案,臺中市,豐原區,社皮里,428,1873,748,309,1057,47,1104
公投第１１案,臺中市,豐原區,社皮里,429,1867,707,335,1042,58,1100
公投第１１案,臺中市,豐原區,社皮里,430,1823,698,298,996,60,1056
公投第１１案,臺中市,豐原區,社皮里,431,1962,703,292,995,51,1046
公投第１１案,臺中市,豐原區,社皮里,432,2313,919,449,1368,52,1420
公投第１１案,臺中市,豐原區,三村里,433,1510,627,264,891,50,941
公投第１１案,臺中市,豐原區,三村里,434,1824,740,317,1057,43,1100
公投第１１案,臺中市,豐原區,三村里,435,1363,543,242,785,42,827
公投第１１案,臺中市,豐原區,三村里,436,1535,646,288,934,43,977
公投第１１案,臺中市,豐原區,東勢里,437,1457,573,304,877,40,917
公投第１１案,臺中市,豐原區,民生里,438,1184,479,227,706,29,735
公投第１１案,臺中市,豐原區,田心里,439,2299,706,370,1076,48,1124
公投第１１案,臺中市,豐原區,田心里,440,1940,720,351,1071,81,1152
公投第１１案,臺中市,豐原區,田心里,441,2067,763,374,1137,43,1180
公投第１１案,臺中市,豐原區,豐田里,442,2038,747,340,1087,66,1153
公投第１１案,臺中市,豐原區,豐田里,443,1835,545,482,1027,38,1065
公投第１１案,臺中市,豐原區,豐田里,444,1979,741,340,1081,65,1146
公投第１１案,臺中市,豐原區,豐田里,445,2014,735,330,1065,77,1142
公投第１１案,臺中市,豐原區,豐田里,446,2257,856,388,1244,83,1327
公投第１１案,臺中市,豐原區,鎌村里,447,1406,577,271,848,46,894
公投第１１案,臺中市,豐原區,鎌村里,448,1418,553,279,832,37,869
公投第１１案,臺中市,豐原區,鎌村里,449,1772,767,316,1083,41,1124
公投第１１案,臺中市,豐原區,陽明里,450,1202,518,245,763,20,783
公投第１１案,臺中市,豐原區,陽明里,451,1447,601,272,873,25,898
公投第１１案,臺中市,豐原區,南陽里,452,1758,722,304,1026,60,1086
公投第１１案,臺中市,豐原區,南陽里,453,1546,652,308,960,44,1004
公投第１１案,臺中市,豐原區,南陽里,454,1815,784,314,1098,36,1134
公投第１１案,臺中市,豐原區,南陽里,455,1932,732,389,1121,45,1166
公投第１１案,臺中市,豐原區,南陽里,456,1770,754,349,1103,40,1143
公投第１１案,臺中市,豐原區,南陽里,457,1560,598,244,842,24,866
公投第１１案,臺中市,豐原區,北陽里,458,1810,697,323,1020,46,1066
公投第１１案,臺中市,豐原區,北陽里,459,1653,677,345,1022,33,1055
公投第１１案,臺中市,豐原區,北陽里,460,1444,579,239,818,47,865
公投第１１案,臺中市,豐原區,北陽里,461,1318,532,281,813,28,841
公投第１１案,臺中市,豐原區,北陽里,462,1566,551,340,891,65,956
公投第１１案,臺中市,豐原區,北陽里,463,1748,615,359,974,46,1020
公投第１１案,臺中市,豐原區,北陽里,464,1772,603,299,902,59,961
公投第１１案,臺中市,豐原區,北陽里,465,1721,691,270,961,51,1012
公投第１１案,臺中市,豐原區,東陽里,466,1578,745,173,918,33,951
公投第１１案,臺中市,豐原區,南村里,467,1859,677,357,1034,57,1091
公投第１１案,臺中市,豐原區,南村里,468,1479,575,277,852,32,884
公投第１１案,臺中市,豐原區,南村里,469,1889,753,329,1082,47,1129
公投第１１案,臺中市,豐原區,南田里,470,1803,681,319,1000,40,1040
公投第１１案,臺中市,豐原區,南田里,471,1421,514,273,787,40,827
公投第１１案,臺中市,豐原區,南嵩里,472,1585,638,316,954,52,1006
公投第１１案,臺中市,豐原區,南嵩里,473,1774,759,310,1069,50,1119
公投第１１案,臺中市,豐原區,翁明里,474,2132,827,368,1195,68,1263
公投第１１案,臺中市,豐原區,翁子里,475,1515,624,241,865,39,904
公投第１１案,臺中市,豐原區,翁子里,476,1359,532,212,744,19,763
公投第１１案,臺中市,豐原區,翁社里,477,948,362,207,569,34,603
公投第１１案,臺中市,豐原區,翁社里,478,1134,438,234,672,40,712
公投第１１案,臺中市,豐原區,朴子里,479,1114,472,217,689,62,751
公投第１１案,臺中市,豐原區,朴子里,480,1050,415,192,607,37,644
公投第１１案,臺中市,豐原區,朴子里,481,1182,484,252,736,39,775
公投第１１案,臺中市,神岡區,神岡里,482,1684,672,309,981,44,1025
公投第１１案,臺中市,神岡區,神岡里,483,1559,627,259,886,40,926
公投第１１案,臺中市,神岡區,庄前里,484,1095,427,186,613,31,644
公投第１１案,臺中市,神岡區,庄前里,485,1044,455,215,670,39,709
公投第１１案,臺中市,神岡區,北庄里,486,1310,583,228,811,46,857
公投第１１案,臺中市,神岡區,北庄里,487,1294,519,257,776,52,828
公投第１１案,臺中市,神岡區,庄後里,488,1143,446,203,649,48,697
公投第１１案,臺中市,神岡區,庄後里,489,1022,416,179,595,43,638
公投第１１案,臺中市,神岡區,圳前里,490,1269,457,227,684,42,726
公投第１１案,臺中市,神岡區,圳前里,491,1085,379,138,517,25,542
公投第１１案,臺中市,神岡區,圳堵里,492,942,374,187,561,35,596
公投第１１案,臺中市,神岡區,圳堵里,493,1154,420,227,647,36,683
公投第１１案,臺中市,神岡區,新庄里,494,1390,512,224,736,57,793
公投第１１案,臺中市,神岡區,新庄里,495,1372,564,244,808,61,869
公投第１１案,臺中市,神岡區,新庄里,496,1328,465,241,706,32,738
公投第１１案,臺中市,神岡區,山皮里,497,1038,399,181,580,25,605
公投第１１案,臺中市,神岡區,社口里,498,1452,557,238,795,33,828
公投第１１案,臺中市,神岡區,社口里,499,1551,635,287,922,41,963
公投第１１案,臺中市,神岡區,社口里,500,1567,543,266,809,57,866
公投第１１案,臺中市,神岡區,社口里,501,1449,556,263,819,25,844
公投第１１案,臺中市,神岡區,社口里,502,1246,463,180,643,22,665
公投第１１案,臺中市,神岡區,社南里,503,1431,570,243,813,41,854
公投第１１案,臺中市,神岡區,社南里,504,1163,462,217,679,56,735
公投第１１案,臺中市,神岡區,社南里,505,1402,576,285,861,47,908
公投第１１案,臺中市,神岡區,社南里,506,1271,505,240,745,28,773
公投第１１案,臺中市,神岡區,三角里,507,1198,479,216,695,52,747
公投第１１案,臺中市,神岡區,三角里,508,1312,559,216,775,39,814
公投第１１案,臺中市,神岡區,大社里,509,1590,595,263,858,60,918
公投第１１案,臺中市,神岡區,大社里,510,1324,491,214,705,36,741
公投第１１案,臺中市,神岡區,大社里,511,1415,495,256,751,43,794
公投第１１案,臺中市,神岡區,岸裡里,512,1483,669,270,939,21,960
公投第１１案,臺中市,神岡區,岸裡里,513,1402,538,204,742,28,770
公投第１１案,臺中市,神岡區,豐洲里,514,1275,460,229,689,28,717
公投第１１案,臺中市,神岡區,豐洲里,515,1288,462,201,663,44,707
公投第１１案,臺中市,神岡區,豐洲里,516,1080,391,166,557,61,618
公投第１１案,臺中市,神岡區,豐洲里,517,1344,513,231,744,21,765
公投第１１案,臺中市,神岡區,豐洲里,518,1061,412,226,638,32,670
公投第１１案,臺中市,神岡區,豐洲里,519,1176,458,249,707,43,750
公投第１１案,臺中市,神岡區,神洲里,520,1244,499,233,732,49,781
公投第１１案,臺中市,神岡區,神洲里,521,1318,581,231,812,44,856
公投第１１案,臺中市,神岡區,溪洲里,522,1471,561,230,791,51,842
公投第１１案,臺中市,神岡區,溪洲里,523,1323,559,255,814,62,876
公投第１１案,臺中市,大雅區,上雅里,524,2027,777,347,1124,47,1171
公投第１１案,臺中市,大雅區,上雅里,525,1967,669,331,1000,47,1047
公投第１１案,臺中市,大雅區,上雅里,526,1912,704,304,1008,38,1046
公投第１１案,臺中市,大雅區,大雅里,527,1537,613,299,912,32,944
公投第１１案,臺中市,大雅區,大雅里,528,1439,597,269,866,32,898
公投第１１案,臺中市,大雅區,大雅里,529,1402,529,280,809,30,839
公投第１１案,臺中市,大雅區,文雅里,530,2013,686,381,1067,51,1118
公投第１１案,臺中市,大雅區,文雅里,531,1917,734,351,1085,42,1127
公投第１１案,臺中市,大雅區,文雅里,532,2011,708,370,1078,49,1127
公投第１１案,臺中市,大雅區,三和里,533,1887,774,302,1076,40,1116
公投第１１案,臺中市,大雅區,三和里,534,1480,582,280,862,44,906
公投第１１案,臺中市,大雅區,三和里,535,1816,691,314,1005,46,1051
公投第１１案,臺中市,大雅區,二和里,536,1898,628,313,941,53,994
公投第１１案,臺中市,大雅區,二和里,537,2008,775,314,1089,60,1149
公投第１１案,臺中市,大雅區,二和里,538,1976,770,346,1116,40,1156
公投第１１案,臺中市,大雅區,四德里,539,1673,639,313,952,29,981
公投第１１案,臺中市,大雅區,四德里,540,1409,571,280,851,33,884
公投第１１案,臺中市,大雅區,四德里,541,1382,544,271,815,17,832
公投第１１案,臺中市,大雅區,西寶里,542,1635,637,249,886,48,934
公投第１１案,臺中市,大雅區,西寶里,543,1565,623,276,899,44,943
公投第１１案,臺中市,大雅區,西寶里,544,1528,589,226,815,32,847
公投第１１案,臺中市,大雅區,上楓里,545,1963,727,313,1040,37,1077
公投第１１案,臺中市,大雅區,上楓里,546,2073,744,342,1086,21,1107
公投第１１案,臺中市,大雅區,上楓里,547,1984,716,327,1043,56,1099
公投第１１案,臺中市,大雅區,大楓里,548,1688,617,280,897,35,932
公投第１１案,臺中市,大雅區,大楓里,549,1387,545,238,783,29,812
公投第１１案,臺中市,大雅區,大楓里,550,1701,670,297,967,71,1038
公投第１１案,臺中市,大雅區,雅楓里,551,1721,635,275,910,65,975
公投第１１案,臺中市,大雅區,雅楓里,552,1879,628,246,874,36,910
公投第１１案,臺中市,大雅區,員林里,553,1568,687,293,980,36,1016
公投第１１案,臺中市,大雅區,員林里,554,1761,631,358,989,53,1042
公投第１１案,臺中市,大雅區,員林里,555,1752,697,303,1000,73,1073
公投第１１案,臺中市,大雅區,員林里,556,1264,496,242,738,32,770
公投第１１案,臺中市,大雅區,員林里,557,1302,554,223,777,39,816
公投第１１案,臺中市,大雅區,員林里,558,1449,541,247,788,43,831
公投第１１案,臺中市,大雅區,六寶里,559,1621,645,299,944,59,1003
公投第１１案,臺中市,大雅區,六寶里,560,1647,637,240,877,58,935
公投第１１案,臺中市,大雅區,六寶里,561,1441,537,259,796,28,824
公投第１１案,臺中市,大雅區,六寶里,562,1460,555,258,813,26,839
公投第１１案,臺中市,大雅區,秀山里,563,1832,740,335,1075,51,1126
公投第１１案,臺中市,大雅區,秀山里,564,1371,547,261,808,54,862
公投第１１案,臺中市,大雅區,橫山里,565,1418,515,235,750,16,766
公投第１１案,臺中市,大雅區,橫山里,566,1473,596,272,868,35,903
公投第１１案,臺中市,大雅區,橫山里,567,1335,511,236,747,43,790
公投第１１案,臺中市,大雅區,忠義里,568,1733,726,216,942,55,997
公投第１１案,臺中市,大雅區,忠義里,569,1884,651,259,910,49,959
公投第１１案,臺中市,潭子區,潭秀里,570,1306,536,226,762,44,806
公投第１１案,臺中市,潭子區,潭北里,571,1128,431,229,660,39,699
公投第１１案,臺中市,潭子區,潭北里,572,1159,457,247,704,43,747
公投第１１案,臺中市,潭子區,潭陽里,573,1630,635,300,935,61,996
公投第１１案,臺中市,潭子區,潭陽里,574,1532,605,249,854,38,892
公投第１１案,臺中市,潭子區,潭陽里,575,1677,593,277,870,26,896
公投第１１案,臺中市,潭子區,潭陽里,576,1744,598,274,872,43,915
公投第１１案,臺中市,潭子區,潭陽里,577,1795,661,337,998,42,1040
公投第１１案,臺中市,潭子區,潭陽里,578,1171,452,192,644,39,683
公投第１１案,臺中市,潭子區,潭陽里,579,1427,546,245,791,27,818
公投第１１案,臺中市,潭子區,福仁里,580,1709,674,292,966,45,1011
公投第１１案,臺中市,潭子區,福仁里,581,1723,656,300,956,36,992
公投第１１案,臺中市,潭子區,福仁里,582,1782,653,284,937,44,981
公投第１１案,臺中市,潭子區,福仁里,583,1407,509,229,738,30,768
公投第１１案,臺中市,潭子區,福仁里,584,1771,685,343,1028,28,1056
公投第１１案,臺中市,潭子區,福仁里,585,1795,743,291,1034,54,1088
公投第１１案,臺中市,潭子區,頭家里,586,1612,677,285,962,44,1006
公投第１１案,臺中市,潭子區,頭家里,587,1894,710,331,1041,36,1077
公投第１１案,臺中市,潭子區,頭家里,588,1689,611,327,938,32,970
公投第１１案,臺中市,潭子區,頭家東里,589,1525,553,256,809,27,836
公投第１１案,臺中市,潭子區,頭家東里,590,1622,614,282,896,33,929
公投第１１案,臺中市,潭子區,頭家東里,591,1200,474,210,684,37,721
公投第１１案,臺中市,潭子區,家興里,592,1355,509,222,731,17,748
公投第１１案,臺中市,潭子區,家興里,593,1777,640,325,965,22,987
公投第１１案,臺中市,潭子區,家興里,594,1923,756,299,1055,39,1094
公投第１１案,臺中市,潭子區,家興里,595,1674,630,248,878,42,920
公投第１１案,臺中市,潭子區,家福里,596,1451,608,259,867,48,915
公投第１１案,臺中市,潭子區,家福里,597,1486,556,280,836,41,877
公投第１１案,臺中市,潭子區,家福里,598,1511,589,281,870,42,912
公投第１１案,臺中市,潭子區,甘蔗里,599,1666,655,302,957,42,999
公投第１１案,臺中市,潭子區,甘蔗里,600,1750,649,303,952,39,991
公投第１１案,臺中市,潭子區,甘蔗里,601,1437,562,232,794,25,819
公投第１１案,臺中市,潭子區,甘蔗里,602,1735,668,287,955,32,987
公投第１１案,臺中市,潭子區,甘蔗里,603,1612,622,265,887,29,916
公投第１１案,臺中市,潭子區,甘蔗里,604,1143,452,232,684,21,705
公投第１１案,臺中市,潭子區,東寶里,605,2096,801,338,1139,32,1171
公投第１１案,臺中市,潭子區,東寶里,606,1549,613,291,904,39,943
公投第１１案,臺中市,潭子區,東寶里,607,1573,642,278,920,35,955
公投第１１案,臺中市,潭子區,東寶里,608,1585,616,238,854,25,879
公投第１１案,臺中市,潭子區,東寶里,609,1572,581,245,826,30,856
公投第１１案,臺中市,潭子區,東寶里,610,1738,714,309,1023,36,1059
公投第１１案,臺中市,潭子區,東寶里,611,1883,684,315,999,52,1051
公投第１１案,臺中市,潭子區,大富里,612,1401,593,257,850,25,875
公投第１１案,臺中市,潭子區,大富里,613,1352,559,238,797,39,836
公投第１１案,臺中市,潭子區,大豐里,614,2085,827,347,1174,67,1241
公投第１１案,臺中市,潭子區,大豐里,615,2047,811,369,1180,62,1242
公投第１１案,臺中市,潭子區,大豐里,616,1673,610,301,911,27,938
公投第１１案,臺中市,潭子區,栗林里,617,1874,682,367,1049,68,1117
公投第１１案,臺中市,潭子區,栗林里,618,1051,393,204,597,42,639
公投第１１案,臺中市,潭子區,栗林里,619,1674,573,303,876,22,898
公投第１１案,臺中市,潭子區,嘉仁里,620,1831,692,329,1021,62,1083
公投第１１案,臺中市,潭子區,嘉仁里,621,2003,713,344,1057,56,1113
公投第１１案,臺中市,潭子區,新田里,622,1535,631,255,886,33,919
公投第１１案,臺中市,潭子區,聚興里,623,2286,781,305,1086,91,1177
公投第１１案,臺中市,潭子區,聚興里,624,1861,673,271,944,52,996
公投第１１案,臺中市,西屯區,西安里,625,1638,648,298,946,31,977
公投第１１案,臺中市,西屯區,西安里,626,1335,442,284,726,23,749
公投第１１案,臺中市,西屯區,西安里,627,1776,682,340,1022,28,1050
公投第１１案,臺中市,西屯區,至善里,628,1351,477,281,758,34,792
公投第１１案,臺中市,西屯區,至善里,629,1338,507,282,789,30,819
公投第１１案,臺中市,西屯區,至善里,630,1582,683,176,859,44,903
公投第１１案,臺中市,西屯區,西平里,631,1710,636,259,895,33,928
公投第１１案,臺中市,西屯區,西平里,632,1595,535,277,812,34,846
公投第１１案,臺中市,西屯區,西平里,633,1585,619,256,875,45,920
公投第１１案,臺中市,西屯區,西墩里,634,1749,637,303,940,45,985
公投第１１案,臺中市,西屯區,西墩里,635,1877,729,329,1058,33,1091
公投第１１案,臺中市,西屯區,西墩里,636,1697,577,322,899,26,925
公投第１１案,臺中市,西屯區,潮洋里,637,1480,584,291,875,36,911
公投第１１案,臺中市,西屯區,潮洋里,638,1483,594,327,921,52,973
公投第１１案,臺中市,西屯區,潮洋里,639,2484,576,301,877,27,904
公投第１１案,臺中市,西屯區,龍潭里,640,781,376,130,506,24,530
公投第１１案,臺中市,西屯區,惠來里,641,1477,569,293,862,36,898
公投第１１案,臺中市,西屯區,惠來里,642,1784,649,322,971,30,1001
公投第１１案,臺中市,西屯區,惠來里,643,1686,641,293,934,27,961
公投第１１案,臺中市,西屯區,惠來里,644,1692,605,328,933,27,960
公投第１１案,臺中市,西屯區,惠來里,645,1659,591,281,872,33,905
公投第１１案,臺中市,西屯區,惠來里,646,1648,611,321,932,48,980
公投第１１案,臺中市,西屯區,惠來里,647,1536,579,334,913,29,942
公投第１１案,臺中市,西屯區,惠來里,648,1666,616,330,946,32,978
公投第１１案,臺中市,西屯區,上石里,649,1428,510,308,818,32,850
公投第１１案,臺中市,西屯區,上石里,650,1810,632,316,948,37,985
公投第１１案,臺中市,西屯區,上石里,651,1574,577,298,875,19,894
公投第１１案,臺中市,西屯區,上安里,652,1650,630,302,932,21,953
公投第１１案,臺中市,西屯區,上安里,653,1681,569,348,917,58,975
公投第１１案,臺中市,西屯區,上安里,654,1656,567,326,893,39,932
公投第１１案,臺中市,西屯區,上德里,655,1243,528,200,728,36,764
公投第１１案,臺中市,西屯區,上德里,656,1471,600,301,901,39,940
公投第１１案,臺中市,西屯區,上德里,657,1431,552,314,866,25,891
公投第１１案,臺中市,西屯區,逢甲里,658,1714,634,311,945,35,980
公投第１１案,臺中市,西屯區,逢甲里,659,1424,560,238,798,28,826
公投第１１案,臺中市,西屯區,逢甲里,660,1176,458,208,666,31,697
公投第１１案,臺中市,西屯區,逢福里,661,1456,545,290,835,41,876
公投第１１案,臺中市,西屯區,逢福里,662,1451,567,306,873,36,909
公投第１１案,臺中市,西屯區,逢福里,663,1063,468,219,687,14,701
公投第１１案,臺中市,西屯區,逢福里,664,1357,530,229,759,39,798
公投第１１案,臺中市,西屯區,鵬程里,665,1355,589,200,789,56,845
公投第１１案,臺中市,西屯區,鵬程里,666,1384,603,217,820,36,856
公投第１１案,臺中市,西屯區,何厝里,667,1613,629,302,931,39,970
公投第１１案,臺中市,西屯區,何厝里,668,1562,590,279,869,42,911
公投第１１案,臺中市,西屯區,何明里,669,1219,503,265,768,37,805
公投第１１案,臺中市,西屯區,何明里,670,1235,433,273,706,36,742
公投第１１案,臺中市,西屯區,何明里,671,1131,413,233,646,38,684
公投第１１案,臺中市,西屯區,何南里,672,1494,601,306,907,25,932
公投第１１案,臺中市,西屯區,何南里,673,1325,485,286,771,17,788
公投第１１案,臺中市,西屯區,何南里,674,1386,499,287,786,43,829
公投第１１案,臺中市,西屯區,何成里,675,1816,668,368,1036,37,1073
公投第１１案,臺中市,西屯區,何成里,676,1734,603,324,927,28,955
公投第１１案,臺中市,西屯區,何成里,677,1777,657,375,1032,40,1072
公投第１１案,臺中市,西屯區,何成里,678,1818,604,357,961,43,1004
公投第１１案,臺中市,西屯區,何安里,679,1699,598,317,915,54,969
公投第１１案,臺中市,西屯區,何安里,680,1715,581,302,883,30,913
公投第１１案,臺中市,西屯區,何安里,681,1654,530,339,869,34,903
公投第１１案,臺中市,西屯區,何仁里,682,1636,596,304,900,18,918
公投第１１案,臺中市,西屯區,何仁里,683,1298,459,255,714,24,738
公投第１１案,臺中市,西屯區,何仁里,684,1391,531,277,808,37,845
公投第１１案,臺中市,西屯區,何仁里,685,1853,695,376,1071,29,1100
公投第１１案,臺中市,西屯區,何德里,686,1820,658,313,971,41,1012
公投第１１案,臺中市,西屯區,何德里,687,1809,677,336,1013,46,1059
公投第１１案,臺中市,西屯區,何福里,688,1352,533,274,807,34,841
公投第１１案,臺中市,西屯區,何福里,689,1521,558,294,852,40,892
公投第１１案,臺中市,西屯區,何福里,690,1486,598,287,885,27,912
公投第１１案,臺中市,西屯區,何源里,691,1674,635,309,944,42,986
公投第１１案,臺中市,西屯區,何源里,692,1610,615,343,958,51,1009
公投第１１案,臺中市,西屯區,何源里,693,1695,632,319,951,37,988
公投第１１案,臺中市,西屯區,何源里,694,1684,571,334,905,37,942
公投第１１案,臺中市,西屯區,大河里,695,1221,505,229,734,23,757
公投第１１案,臺中市,西屯區,大河里,696,1252,567,244,811,43,854
公投第１１案,臺中市,西屯區,大河里,697,1301,526,261,787,29,816
公投第１１案,臺中市,西屯區,大石里,698,1049,492,144,636,37,673
公投第１１案,臺中市,西屯區,大石里,699,1113,502,149,651,32,683
公投第１１案,臺中市,西屯區,大福里,700,1557,587,225,812,34,846
公投第１１案,臺中市,西屯區,大福里,701,1640,611,269,880,35,915
公投第１１案,臺中市,西屯區,大鵬里,702,1402,617,256,873,61,934
公投第１１案,臺中市,西屯區,大鵬里,703,1717,595,260,855,45,900
公投第１１案,臺中市,西屯區,大鵬里,704,1688,623,291,914,43,957
公投第１１案,臺中市,西屯區,港尾里,705,1168,433,207,640,84,724
公投第１１案,臺中市,西屯區,港尾里,706,1729,632,273,905,45,950
公投第１１案,臺中市,西屯區,港尾里,707,2007,713,342,1055,27,1082
公投第１１案,臺中市,西屯區,廣福里,708,1296,492,259,751,55,806
公投第１１案,臺中市,西屯區,廣福里,709,1068,367,170,537,19,556
公投第１１案,臺中市,西屯區,林厝里,710,1707,698,278,976,57,1033
公投第１１案,臺中市,西屯區,林厝里,711,1636,613,323,936,31,967
公投第１１案,臺中市,西屯區,永安里,712,1761,581,184,765,34,799
公投第１１案,臺中市,西屯區,永安里,713,1314,470,284,754,36,790
公投第１１案,臺中市,西屯區,永安里,714,1233,493,270,763,32,795
公投第１１案,臺中市,西屯區,永安里,715,1549,564,251,815,43,858
公投第１１案,臺中市,西屯區,永安里,716,1639,589,277,866,32,898
公投第１１案,臺中市,西屯區,永安里,717,1486,570,210,780,35,815
公投第１１案,臺中市,西屯區,永安里,718,1806,607,350,957,29,986
公投第１１案,臺中市,西屯區,永安里,719,1451,500,273,773,21,794
公投第１１案,臺中市,西屯區,福安里,720,1302,540,222,762,21,783
公投第１１案,臺中市,西屯區,福安里,721,1353,521,283,804,34,838
公投第１１案,臺中市,西屯區,福雅里,722,2162,808,409,1217,43,1260
公投第１１案,臺中市,西屯區,福雅里,723,1520,530,301,831,26,857
公投第１１案,臺中市,西屯區,福雅里,724,1935,726,321,1047,30,1077
公投第１１案,臺中市,西屯區,福林里,725,1847,658,361,1019,32,1051
公投第１１案,臺中市,西屯區,福林里,726,1738,623,366,989,27,1016
公投第１１案,臺中市,西屯區,福林里,727,1640,650,324,974,34,1008
公投第１１案,臺中市,西屯區,福林里,728,1908,668,399,1067,37,1104
公投第１１案,臺中市,西屯區,福瑞里,729,1402,512,278,790,27,817
公投第１１案,臺中市,西屯區,福瑞里,730,1515,512,279,791,30,821
公投第１１案,臺中市,西屯區,福聯里,731,1541,500,229,729,31,760
公投第１１案,臺中市,西屯區,福聯里,732,1502,503,309,812,23,835
公投第１１案,臺中市,西屯區,福和里,733,1526,552,316,868,46,914
公投第１１案,臺中市,西屯區,福和里,734,1425,521,306,827,47,874
公投第１１案,臺中市,西屯區,福和里,735,1334,534,273,807,23,830
公投第１１案,臺中市,西屯區,福中里,736,1649,653,333,986,27,1013
公投第１１案,臺中市,西屯區,福中里,737,1566,596,306,902,29,931
公投第１１案,臺中市,西屯區,福恩里,738,1629,646,316,962,31,993
公投第１１案,臺中市,西屯區,福恩里,739,1628,595,324,919,37,956
公投第１１案,臺中市,西屯區,福恩里,740,1442,554,313,867,24,891
公投第１１案,臺中市,西屯區,協和里,741,1206,413,226,639,30,669
公投第１１案,臺中市,西屯區,協和里,742,1086,445,206,651,37,688
公投第１１案,臺中市,西屯區,協和里,743,1088,456,195,651,36,687
公投第１１案,臺中市,西屯區,協和里,744,1140,421,241,662,28,690
公投第１１案,臺中市,南屯區,南屯里,745,1321,614,172,786,36,822
公投第１１案,臺中市,南屯區,南屯里,746,1346,508,304,812,35,847
公投第１１案,臺中市,南屯區,南屯里,747,1428,591,275,866,19,885
公投第１１案,臺中市,南屯區,南屯里,748,1442,558,268,826,25,851
公投第１１案,臺中市,南屯區,南屯里,749,1408,602,282,884,24,908
公投第１１案,臺中市,南屯區,南屯里,750,1404,572,277,849,15,864
公投第１１案,臺中市,南屯區,豐樂里,751,1354,565,272,837,29,866
公投第１１案,臺中市,南屯區,豐樂里,752,1332,523,278,801,40,841
公投第１１案,臺中市,南屯區,豐樂里,753,1463,435,438,873,29,902
公投第１１案,臺中市,南屯區,豐樂里,754,1413,521,302,823,35,858
公投第１１案,臺中市,南屯區,豐樂里,755,1218,493,280,773,27,800
公投第１１案,臺中市,南屯區,豐樂里,756,1308,529,250,779,26,805
公投第１１案,臺中市,南屯區,豐樂里,757,1527,615,321,936,25,961
公投第１１案,臺中市,南屯區,豐樂里,758,1294,501,284,785,31,816
公投第１１案,臺中市,南屯區,楓樹里,759,1516,514,260,774,42,816
公投第１１案,臺中市,南屯區,楓樹里,760,1529,581,321,902,49,951
公投第１１案,臺中市,南屯區,楓樹里,761,1397,564,270,834,36,870
公投第１１案,臺中市,南屯區,楓樹里,762,1406,550,223,773,24,797
公投第１１案,臺中市,南屯區,中和里,763,1497,564,250,814,31,845
公投第１１案,臺中市,南屯區,中和里,764,1424,538,241,779,46,825
公投第１１案,臺中市,南屯區,中和里,765,1488,469,266,735,38,773
公投第１１案,臺中市,南屯區,鎮平里,766,608,245,130,375,33,408
公投第１１案,臺中市,南屯區,鎮平里,767,813,329,155,484,52,536
公投第１１案,臺中市,南屯區,春社里,768,1190,476,215,691,48,739
公投第１１案,臺中市,南屯區,春社里,769,1174,482,182,664,21,685
公投第１１案,臺中市,南屯區,春社里,770,1224,496,223,719,12,731
公投第１１案,臺中市,南屯區,春社里,771,1466,512,204,716,36,752
公投第１１案,臺中市,南屯區,春社里,772,1333,403,146,549,24,573
公投第１１案,臺中市,南屯區,春安里,773,814,336,157,493,28,521
公投第１１案,臺中市,南屯區,文山里,774,1436,549,207,756,42,798
公投第１１案,臺中市,南屯區,文山里,775,1515,566,316,882,28,910
公投第１１案,臺中市,南屯區,文山里,776,1545,508,253,761,39,800
公投第１１案,臺中市,南屯區,文山里,777,1383,531,264,795,25,820
公投第１１案,臺中市,南屯區,文山里,778,1433,577,266,843,23,866
公投第１１案,臺中市,南屯區,文山里,779,1134,383,217,600,27,627
公投第１１案,臺中市,南屯區,文山里,780,1216,481,249,730,32,762
公投第１１案,臺中市,南屯區,寶山里,781,1271,451,227,678,57,735
公投第１１案,臺中市,南屯區,寶山里,782,1203,429,225,654,20,674
公投第１１案,臺中市,南屯區,寶山里,783,1268,492,234,726,24,750
公投第１１案,臺中市,南屯區,寶山里,784,1390,580,227,807,29,836
公投第１１案,臺中市,南屯區,新生里,785,1397,527,247,774,43,817
公投第１１案,臺中市,南屯區,永定里,786,1607,571,297,868,56,924
公投第１１案,臺中市,南屯區,永定里,787,1582,633,289,922,31,953
公投第１１案,臺中市,南屯區,永定里,788,1611,658,276,934,36,970
公投第１１案,臺中市,南屯區,三厝里,789,1322,519,291,810,28,838
公投第１１案,臺中市,南屯區,三厝里,790,1321,590,242,832,26,858
公投第１１案,臺中市,南屯區,三厝里,791,1360,563,257,820,32,852
公投第１１案,臺中市,南屯區,三厝里,792,1361,520,307,827,21,848
公投第１１案,臺中市,南屯區,三厝里,793,1257,494,275,769,25,794
公投第１１案,臺中市,南屯區,三義里,794,1207,515,255,770,16,786
公投第１１案,臺中市,南屯區,三義里,795,1282,507,288,795,26,821
公投第１１案,臺中市,南屯區,三義里,796,1248,517,272,789,29,818
公投第１１案,臺中市,南屯區,三義里,797,1304,522,294,816,34,850
公投第１１案,臺中市,南屯區,三義里,798,1214,471,254,725,20,745
公投第１１案,臺中市,南屯區,三和里,799,1102,427,255,682,29,711
公投第１１案,臺中市,南屯區,三和里,800,1630,688,325,1013,87,1100
公投第１１案,臺中市,南屯區,三和里,801,1333,496,308,804,28,832
公投第１１案,臺中市,南屯區,三和里,802,1292,412,355,767,23,790
公投第１１案,臺中市,南屯區,三和里,803,1272,490,271,761,25,786
公投第１１案,臺中市,南屯區,三和里,804,1345,538,251,789,15,804
公投第１１案,臺中市,南屯區,黎明里,805,981,444,214,658,34,692
公投第１１案,臺中市,南屯區,黎明里,806,1097,448,211,659,44,703
公投第１１案,臺中市,南屯區,黎明里,807,991,448,185,633,16,649
公投第１１案,臺中市,南屯區,黎明里,808,1170,476,223,699,21,720
公投第１１案,臺中市,南屯區,溝墘里,809,1171,462,274,736,17,753
公投第１１案,臺中市,南屯區,溝墘里,810,1349,485,277,762,45,807
公投第１１案,臺中市,南屯區,溝墘里,811,1368,545,303,848,21,869
公投第１１案,臺中市,南屯區,溝墘里,812,1263,525,270,795,27,822
公投第１１案,臺中市,南屯區,大業里,813,1547,603,331,934,33,967
公投第１１案,臺中市,南屯區,大業里,814,1649,609,337,946,39,985
公投第１１案,臺中市,南屯區,大業里,815,1629,601,312,913,13,926
公投第１１案,臺中市,南屯區,大業里,816,1580,503,320,823,33,856
公投第１１案,臺中市,南屯區,惠中里,817,1444,607,313,920,22,942
公投第１１案,臺中市,南屯區,惠中里,818,1413,557,267,824,21,845
公投第１１案,臺中市,南屯區,惠中里,819,1377,540,244,784,28,812
公投第１１案,臺中市,南屯區,惠中里,820,1527,547,367,914,23,937
公投第１１案,臺中市,南屯區,惠中里,821,1335,542,272,814,29,843
公投第１１案,臺中市,南屯區,田心里,822,1544,653,366,1019,21,1040
公投第１１案,臺中市,南屯區,田心里,823,1482,615,332,947,25,972
公投第１１案,臺中市,南屯區,田心里,824,1488,609,281,890,42,932
公投第１１案,臺中市,南屯區,田心里,825,1538,510,273,783,29,812
公投第１１案,臺中市,南屯區,向心里,826,1674,674,337,1011,49,1060
公投第１１案,臺中市,南屯區,向心里,827,1996,529,303,832,31,863
公投第１１案,臺中市,南屯區,向心里,828,1514,598,281,879,40,919
公投第１１案,臺中市,南屯區,文心里,829,1217,525,225,750,33,783
公投第１１案,臺中市,南屯區,文心里,830,1347,507,270,777,29,806
公投第１１案,臺中市,南屯區,文心里,831,1109,472,207,679,24,703
公投第１１案,臺中市,南屯區,同心里,832,1546,564,315,879,26,905
公投第１１案,臺中市,南屯區,同心里,833,1408,583,286,869,36,905
公投第１１案,臺中市,南屯區,同心里,834,1057,439,158,597,23,620
公投第１１案,臺中市,南屯區,同心里,835,1133,431,223,654,42,696
公投第１１案,臺中市,南屯區,大同里,836,1278,501,261,762,28,790
公投第１１案,臺中市,南屯區,大同里,837,1144,496,225,721,35,756
公投第１１案,臺中市,南屯區,大同里,838,1140,425,246,671,34,705
公投第１１案,臺中市,南屯區,大同里,839,1171,426,295,721,26,747
公投第１１案,臺中市,南屯區,大興里,840,1303,523,284,807,33,840
公投第１１案,臺中市,南屯區,大興里,841,1402,502,272,774,33,807
公投第１１案,臺中市,南屯區,大興里,842,1571,601,272,873,40,913
公投第１１案,臺中市,南屯區,大誠里,843,1139,475,241,716,22,738
公投第１１案,臺中市,南屯區,大誠里,844,1216,506,249,755,31,786
公投第１１案,臺中市,南屯區,大誠里,845,1162,493,220,713,28,741
公投第１１案,臺中市,北屯區,北屯里,846,1670,660,345,1005,39,1044
公投第１１案,臺中市,北屯區,北屯里,847,1706,626,286,912,42,954
公投第１１案,臺中市,北屯區,北京里,848,1507,550,259,809,56,865
公投第１１案,臺中市,北屯區,北京里,849,1652,608,340,948,40,988
公投第１１案,臺中市,北屯區,北興里,850,1107,419,187,606,19,625
公投第１１案,臺中市,北屯區,北興里,851,2151,772,337,1109,57,1166
公投第１１案,臺中市,北屯區,三光里,852,1612,667,293,960,26,986
公投第１１案,臺中市,北屯區,三光里,853,1743,648,314,962,36,998
公投第１１案,臺中市,北屯區,三光里,854,2099,710,373,1083,27,1110
公投第１１案,臺中市,北屯區,三光里,855,1595,619,283,902,31,933
公投第１１案,臺中市,北屯區,三和里,856,1923,744,333,1077,39,1116
公投第１１案,臺中市,北屯區,三和里,857,1641,618,245,863,45,908
公投第１１案,臺中市,北屯區,三和里,858,1157,499,239,738,24,762
公投第１１案,臺中市,北屯區,三和里,859,1041,420,215,635,30,665
公投第１１案,臺中市,北屯區,東光里,860,1563,559,262,821,25,846
公投第１１案,臺中市,北屯區,東光里,861,1559,583,227,810,38,848
公投第１１案,臺中市,北屯區,東光里,862,1411,540,186,726,14,740
公投第１１案,臺中市,北屯區,水景里,863,1761,667,339,1006,37,1043
公投第１１案,臺中市,北屯區,水景里,864,1361,552,260,812,49,861
公投第１１案,臺中市,北屯區,水景里,865,1852,721,304,1025,41,1066
公投第１１案,臺中市,北屯區,水景里,866,1928,759,352,1111,32,1143
公投第１１案,臺中市,北屯區,水景里,867,1492,645,288,933,33,966
公投第１１案,臺中市,北屯區,水景里,868,1998,718,335,1053,52,1105
公投第１１案,臺中市,北屯區,水景里,869,1272,558,237,795,30,825
公投第１１案,臺中市,北屯區,水景里,870,1317,541,270,811,30,841
公投第１１案,臺中市,北屯區,軍功里,871,1327,469,196,665,58,723
公投第１１案,臺中市,北屯區,軍功里,872,1280,464,214,678,27,705
公投第１１案,臺中市,北屯區,軍功里,873,1865,648,300,948,43,991
公投第１１案,臺中市,北屯區,軍功里,874,1230,532,223,755,35,790
公投第１１案,臺中市,北屯區,軍功里,875,1356,486,234,720,32,752
公投第１１案,臺中市,北屯區,軍功里,876,1732,655,291,946,45,991
公投第１１案,臺中市,北屯區,軍功里,877,1586,605,321,926,38,964
公投第１１案,臺中市,北屯區,軍功里,878,1441,528,270,798,20,818
公投第１１案,臺中市,北屯區,和平里,879,2045,691,361,1052,66,1118
公投第１１案,臺中市,北屯區,和平里,880,1914,648,312,960,45,1005
公投第１１案,臺中市,北屯區,和平里,881,1918,779,297,1076,29,1105
公投第１１案,臺中市,北屯區,和平里,882,2079,731,326,1057,27,1084
公投第１１案,臺中市,北屯區,和平里,883,2040,749,371,1120,30,1150
公投第１１案,臺中市,北屯區,廍子里,884,2027,636,330,966,43,1009
公投第１１案,臺中市,北屯區,廍子里,885,1402,521,231,752,45,797
公投第１１案,臺中市,北屯區,廍子里,886,1826,678,366,1044,42,1086
公投第１１案,臺中市,北屯區,廍子里,887,2162,722,339,1061,36,1097
公投第１１案,臺中市,北屯區,廍子里,888,2332,703,395,1098,24,1122
公投第１１案,臺中市,北屯區,民政里,889,985,398,146,544,38,582
公投第１１案,臺中市,北屯區,東山里,890,2037,738,296,1034,32,1066
公投第１１案,臺中市,北屯區,大坑里,891,1032,409,164,573,40,613
公投第１１案,臺中市,北屯區,大坑里,892,1062,401,197,598,27,625
公投第１１案,臺中市,北屯區,民德里,893,909,359,137,496,29,525
公投第１１案,臺中市,北屯區,舊社里,894,1445,551,312,863,39,902
公投第１１案,臺中市,北屯區,舊社里,895,1842,654,292,946,39,985
公投第１１案,臺中市,北屯區,舊社里,896,1187,466,230,696,25,721
公投第１１案,臺中市,北屯區,舊社里,897,1456,589,258,847,28,875
公投第１１案,臺中市,北屯區,松茂里,898,1866,600,443,1043,14,1057
公投第１１案,臺中市,北屯區,松茂里,899,1667,584,279,863,41,904
公投第１１案,臺中市,北屯區,松茂里,900,1683,653,327,980,20,1000
公投第１１案,臺中市,北屯區,松強里,901,1642,615,285,900,29,929
公投第１１案,臺中市,北屯區,松強里,902,1475,615,268,883,19,902
公投第１１案,臺中市,北屯區,松強里,903,1644,618,285,903,18,921
公投第１１案,臺中市,北屯區,松強里,904,1603,625,323,948,29,977
公投第１１案,臺中市,北屯區,松勇里,905,1949,757,354,1111,51,1162
公投第１１案,臺中市,北屯區,松勇里,906,1790,741,362,1103,37,1140
公投第１１案,臺中市,北屯區,松勇里,907,1440,515,312,827,30,857
公投第１１案,臺中市,北屯區,松安里,908,1601,632,325,957,36,993
公投第１１案,臺中市,北屯區,松安里,909,1527,600,233,833,37,870
公投第１１案,臺中市,北屯區,松安里,910,1675,561,297,858,37,895
公投第１１案,臺中市,北屯區,松和里,911,1579,553,215,768,40,808
公投第１１案,臺中市,北屯區,松和里,912,1524,574,259,833,47,880
公投第１１案,臺中市,北屯區,松和里,913,1677,610,289,899,29,928
公投第１１案,臺中市,北屯區,松和里,914,1599,582,297,879,27,906
公投第１１案,臺中市,北屯區,松竹里,915,1458,531,310,841,47,888
公投第１１案,臺中市,北屯區,松竹里,916,1571,605,327,932,27,959
公投第１１案,臺中市,北屯區,松竹里,917,1579,598,309,907,39,946
公投第１１案,臺中市,北屯區,松竹里,918,1849,692,362,1054,37,1091
公投第１１案,臺中市,北屯區,松竹里,919,1682,624,322,946,25,971
公投第１１案,臺中市,北屯區,平興里,920,1760,644,303,947,24,971
公投第１１案,臺中市,北屯區,平興里,921,1699,630,323,953,41,994
公投第１１案,臺中市,北屯區,平興里,922,1626,652,323,975,49,1024
公投第１１案,臺中市,北屯區,平興里,923,1491,573,330,903,7,910
公投第１１案,臺中市,北屯區,平田里,924,1640,598,314,912,34,946
公投第１１案,臺中市,北屯區,平田里,925,2052,715,371,1086,47,1133
公投第１１案,臺中市,北屯區,平田里,926,1875,697,311,1008,33,1041
公投第１１案,臺中市,北屯區,平昌里,927,1559,593,267,860,25,885
公投第１１案,臺中市,北屯區,平昌里,928,1480,565,288,853,29,882
公投第１１案,臺中市,北屯區,平昌里,929,1397,544,258,802,39,841
公投第１１案,臺中市,北屯區,平安里,930,1889,692,363,1055,47,1102
公投第１１案,臺中市,北屯區,平安里,931,1728,610,316,926,44,970
公投第１１案,臺中市,北屯區,平安里,932,1592,577,280,857,35,892
公投第１１案,臺中市,北屯區,平順里,933,1656,577,299,876,46,922
公投第１１案,臺中市,北屯區,平順里,934,1524,545,255,800,34,834
公投第１１案,臺中市,北屯區,平心里,935,1502,570,297,867,17,884
公投第１１案,臺中市,北屯區,平心里,936,1772,655,309,964,31,995
公投第１１案,臺中市,北屯區,平心里,937,1461,546,286,832,42,874
公投第１１案,臺中市,北屯區,平福里,938,1769,595,291,886,34,920
公投第１１案,臺中市,北屯區,平福里,939,1894,666,415,1081,48,1129
公投第１１案,臺中市,北屯區,平德里,940,2033,698,343,1041,36,1077
公投第１１案,臺中市,北屯區,平德里,941,1947,686,341,1027,41,1068
公投第１１案,臺中市,北屯區,平德里,942,2188,785,440,1225,38,1263
公投第１１案,臺中市,北屯區,平和里,943,1661,634,338,972,37,1009
公投第１１案,臺中市,北屯區,平和里,944,1667,627,309,936,37,973
公投第１１案,臺中市,北屯區,平和里,945,1728,637,315,952,31,983
公投第１１案,臺中市,北屯區,平陽里,946,1688,617,309,926,20,946
公投第１１案,臺中市,北屯區,平陽里,947,1475,528,296,824,25,849
公投第１１案,臺中市,北屯區,平陽里,948,1681,676,365,1041,24,1065
公投第１１案,臺中市,北屯區,仁和里,949,2078,808,404,1212,26,1238
公投第１１案,臺中市,北屯區,仁和里,950,2059,755,370,1125,39,1164
公投第１１案,臺中市,北屯區,仁和里,951,1792,655,372,1027,34,1061
公投第１１案,臺中市,北屯區,仁和里,952,2974,678,352,1030,28,1058
公投第１１案,臺中市,北屯區,仁愛里,953,1072,432,173,605,27,632
公投第１１案,臺中市,北屯區,仁美里,954,2099,845,387,1232,44,1276
公投第１１案,臺中市,北屯區,仁美里,955,1823,745,389,1134,44,1178
公投第１１案,臺中市,北屯區,仁美里,956,2022,825,354,1179,64,1243
公投第１１案,臺中市,北屯區,仁美里,957,1992,746,370,1116,36,1152
公投第１１案,臺中市,北屯區,四民里,958,1585,633,309,942,46,988
公投第１１案,臺中市,北屯區,同榮里,959,1565,610,322,932,30,962
公投第１１案,臺中市,北屯區,同榮里,960,1780,652,257,909,43,952
公投第１１案,臺中市,北屯區,同榮里,961,1874,745,366,1111,51,1162
公投第１１案,臺中市,北屯區,后庄里,962,1755,759,286,1045,33,1078
公投第１１案,臺中市,北屯區,后庄里,963,1497,664,336,1000,18,1018
公投第１１案,臺中市,北屯區,后庄里,964,1567,636,300,936,48,984
公投第１１案,臺中市,北屯區,后庄里,965,1624,643,246,889,26,915
公投第１１案,臺中市,北屯區,后庄里,966,1614,664,298,962,32,994
公投第１１案,臺中市,北屯區,后庄里,967,1595,595,289,884,31,915
公投第１１案,臺中市,北屯區,新平里,968,1782,671,240,911,44,955
公投第１１案,臺中市,北屯區,新平里,969,1357,465,215,680,27,707
公投第１１案,臺中市,北屯區,新平里,970,1071,422,170,592,34,626
公投第１１案,臺中市,北屯區,陳平里,971,1372,515,218,733,39,772
公投第１１案,臺中市,北屯區,陳平里,972,1415,584,230,814,40,854
公投第１１案,臺中市,北屯區,陳平里,973,1789,691,355,1046,46,1092
公投第１１案,臺中市,北屯區,忠平里,974,1907,825,312,1137,53,1190
公投第１１案,臺中市,北屯區,忠平里,975,2008,807,348,1155,38,1193
公投第１１案,臺中市,北屯區,大德里,976,1541,604,238,842,44,886
公投第１１案,臺中市,北屯區,大德里,977,1669,699,278,977,33,1010
公投第１１案,臺中市,北屯區,大德里,978,1685,660,299,959,33,992
公投第１１案,臺中市,北屯區,水湳里,979,1785,692,312,1004,59,1063
公投第１１案,臺中市,北屯區,水湳里,980,1596,676,266,942,43,985
公投第１１案,臺中市,北屯區,水湳里,981,1731,657,344,1001,45,1046
公投第１１案,臺中市,北屯區,水湳里,982,1496,558,240,798,53,851
公投第１１案,臺中市,北區,中正里,983,1437,526,242,768,27,795
公投第１１案,臺中市,北區,六合里,984,1708,586,274,860,52,912
公投第１１案,臺中市,北區,光大里,985,1051,483,36,519,39,558
公投第１１案,臺中市,北區,光大里,986,996,386,175,561,29,590
公投第１１案,臺中市,北區,文莊里,987,1504,629,220,849,30,879
公投第１１案,臺中市,北區,文莊里,988,975,363,204,567,41,608
公投第１１案,臺中市,北區,文莊里,989,886,323,180,503,28,531
公投第１１案,臺中市,北區,大湖里,990,1276,363,215,578,33,611
公投第１１案,臺中市,北區,大湖里,991,938,319,174,493,24,517
公投第１１案,臺中市,北區,五常里,992,1404,494,253,747,32,779
公投第１１案,臺中市,北區,錦平里,993,996,369,186,555,16,571
公投第１１案,臺中市,北區,錦平里,994,869,297,167,464,40,504
公投第１１案,臺中市,北區,新北里,995,704,286,150,436,17,453
公投第１１案,臺中市,北區,新北里,996,979,355,159,514,21,535
公投第１１案,臺中市,北區,新興里,997,773,276,124,400,14,414
公投第１１案,臺中市,北區,新興里,998,759,314,143,457,14,471
公投第１１案,臺中市,北區,樂英里,999,1438,605,197,802,40,842
公投第１１案,臺中市,北區,樂英里,1000,1212,456,169,625,26,651
公投第１１案,臺中市,北區,錦村里,1001,1731,643,323,966,37,1003
公投第１１案,臺中市,北區,錦村里,1002,1445,647,250,897,25,922
公投第１１案,臺中市,北區,建成里,1003,1855,676,347,1023,35,1058
公投第１１案,臺中市,北區,建成里,1004,1728,597,259,856,31,887
公投第１１案,臺中市,北區,建成里,1005,1878,619,317,936,37,973
公投第１１案,臺中市,北區,建德里,1006,1793,612,272,884,60,944
公投第１１案,臺中市,北區,建德里,1007,1555,589,267,856,53,909
公投第１１案,臺中市,北區,錦洲里,1008,1761,553,298,851,34,885
公投第１１案,臺中市,北區,錦洲里,1009,1579,610,236,846,34,880
公投第１１案,臺中市,北區,錦祥里,1010,2192,785,361,1146,54,1200
公投第１１案,臺中市,北區,錦祥里,1011,1560,582,318,900,40,940
公投第１１案,臺中市,北區,金華里,1012,1476,554,268,822,32,854
公投第１１案,臺中市,北區,金華里,1013,1006,411,192,603,23,626
公投第１１案,臺中市,北區,金龍里,1014,1403,547,239,786,32,818
公投第１１案,臺中市,北區,金龍里,1015,1446,526,236,762,12,774
公投第１１案,臺中市,北區,金龍里,1016,1460,528,272,800,24,824
公投第１１案,臺中市,北區,邱厝里,1017,1233,465,252,717,24,741
公投第１１案,臺中市,北區,邱厝里,1018,1027,427,231,658,21,679
公投第１１案,臺中市,北區,建興里,1019,1207,453,242,695,11,706
公投第１１案,臺中市,北區,建興里,1020,1167,453,240,693,28,721
公投第１１案,臺中市,北區,建興里,1021,1150,419,226,645,25,670
公投第１１案,臺中市,北區,建興里,1022,1061,390,203,593,36,629
公投第１１案,臺中市,北區,建興里,1023,1005,388,214,602,18,620
公投第１１案,臺中市,北區,頂厝里,1024,1250,433,265,698,25,723
公投第１１案,臺中市,北區,頂厝里,1025,1448,561,286,847,33,880
公投第１１案,臺中市,北區,頂厝里,1026,1379,508,281,789,39,828
公投第１１案,臺中市,北區,崇德里,1027,1652,591,328,919,45,964
公投第１１案,臺中市,北區,崇德里,1028,1867,619,365,984,31,1015
公投第１１案,臺中市,北區,賴厝里,1029,2078,389,190,579,14,593
公投第１１案,臺中市,北區,賴厝里,1030,1562,667,267,934,28,962
公投第１１案,臺中市,北區,賴厝里,1031,1430,541,269,810,22,832
公投第１１案,臺中市,北區,賴福里,1032,2018,777,376,1153,32,1185
公投第１１案,臺中市,北區,賴福里,1033,1710,574,273,847,25,872
公投第１１案,臺中市,北區,賴興里,1034,1432,549,226,775,28,803
公投第１１案,臺中市,北區,賴興里,1035,1157,465,211,676,33,709
公投第１１案,臺中市,北區,賴興里,1036,1188,457,233,690,21,711
公投第１１案,臺中市,北區,賴旺里,1037,1419,535,250,785,26,811
公投第１１案,臺中市,北區,賴旺里,1038,1653,591,298,889,16,905
公投第１１案,臺中市,北區,賴旺里,1039,1233,436,258,694,35,729
公投第１１案,臺中市,北區,賴明里,1040,1243,444,265,709,23,732
公投第１１案,臺中市,北區,賴明里,1041,1219,425,213,638,15,653
公投第１１案,臺中市,北區,賴明里,1042,1272,481,244,725,36,761
公投第１１案,臺中市,北區,梅川里,1043,1285,484,273,757,13,770
公投第１１案,臺中市,北區,梅川里,1044,1780,653,360,1013,34,1047
公投第１１案,臺中市,北區,賴村里,1045,1461,502,252,754,28,782
公投第１１案,臺中市,北區,賴村里,1046,1310,552,217,769,30,799
公投第１１案,臺中市,北區,賴村里,1047,1669,570,331,901,25,926
公投第１１案,臺中市,北區,育德里,1048,1932,714,380,1094,30,1124
公投第１１案,臺中市,北區,育德里,1049,1682,621,307,928,28,956
公投第１１案,臺中市,北區,淡溝里,1050,1891,645,365,1010,17,1027
公投第１１案,臺中市,北區,淡溝里,1051,1882,663,343,1006,57,1063
公投第１１案,臺中市,北區,淡溝里,1052,1159,442,207,649,25,674
公投第１１案,臺中市,北區,健行里,1053,1553,600,272,872,36,908
公投第１１案,臺中市,北區,健行里,1054,1607,528,321,849,34,883
公投第１１案,臺中市,北區,健行里,1055,1773,607,352,959,34,993
公投第１１案,臺中市,北區,健行里,1056,1524,554,286,840,34,874
公投第１１案,臺中市,北區,明德里,1057,1613,664,308,972,38,1010
公投第１１案,臺中市,北區,明德里,1058,1877,719,350,1069,39,1108
公投第１１案,臺中市,北區,明德里,1059,1792,655,335,990,41,1031
公投第１１案,臺中市,北區,明新里,1060,1392,555,247,802,32,834
公投第１１案,臺中市,北區,明新里,1061,1297,477,238,715,25,740
公投第１１案,臺中市,北區,長青里,1062,1556,596,330,926,30,956
公投第１１案,臺中市,北區,長青里,1063,1497,531,285,816,24,840
公投第１１案,臺中市,北區,長青里,1064,1550,579,259,838,31,869
公投第１１案,臺中市,北區,長青里,1065,1434,491,281,772,26,798
公投第１１案,臺中市,北區,立人里,1066,1793,616,373,989,56,1045
公投第１１案,臺中市,北區,立人里,1067,1866,649,376,1025,29,1054
公投第１１案,臺中市,北區,中達里,1068,1346,521,246,767,38,805
公投第１１案,臺中市,北區,中達里,1069,1267,488,236,724,22,746
公投第１１案,臺中市,中區,綠川里,1070,1652,653,316,969,60,1029
公投第１１案,臺中市,中區,繼光里,1071,1531,537,280,817,32,849
公投第１１案,臺中市,中區,公園里,1072,1431,576,223,799,21,820
公投第１１案,臺中市,中區,光復里,1073,1060,401,182,583,34,617
公投第１１案,臺中市,中區,光復里,1074,982,338,179,517,33,550
公投第１１案,臺中市,中區,大墩里,1075,1191,439,115,554,37,591
公投第１１案,臺中市,中區,大墩里,1076,855,309,152,461,33,494
公投第１１案,臺中市,中區,柳川里,1077,1135,376,151,527,20,547
公投第１１案,臺中市,中區,柳川里,1078,705,310,112,422,14,436
公投第１１案,臺中市,中區,大誠里,1079,1009,431,169,600,21,621
公投第１１案,臺中市,中區,大誠里,1080,1304,455,226,681,49,730
公投第１１案,臺中市,中區,中華里,1081,1841,636,268,904,29,933
公投第１１案,臺中市,西區,三民里,1082,1400,342,144,486,24,510
公投第１１案,臺中市,西區,三民里,1083,861,358,192,550,11,561
公投第１１案,臺中市,西區,利民里,1084,1416,560,262,822,32,854
公投第１１案,臺中市,西區,民生里,1085,1020,396,212,608,35,643
公投第１１案,臺中市,西區,民生里,1086,778,325,172,497,17,514
公投第１１案,臺中市,西區,廣民里,1087,1465,559,257,816,32,848
公投第１１案,臺中市,西區,平和里,1088,1017,415,189,604,15,619
公投第１１案,臺中市,西區,平和里,1089,868,323,192,515,17,532
公投第１１案,臺中市,西區,東昇里,1090,1251,509,270,779,34,813
公投第１１案,臺中市,西區,東昇里,1091,1044,429,238,667,22,689
公投第１１案,臺中市,西區,公民里,1092,1487,529,309,838,36,874
公投第１１案,臺中市,西區,公民里,1093,1573,577,324,901,34,935
公投第１１案,臺中市,西區,公民里,1094,1731,652,358,1010,40,1050
公投第１１案,臺中市,西區,藍興里,1095,1209,493,221,714,31,745
公投第１１案,臺中市,西區,藍興里,1096,1564,573,297,870,30,900
公投第１１案,臺中市,西區,藍興里,1097,1175,451,256,707,28,735
公投第１１案,臺中市,西區,公舘里,1098,1505,540,314,854,20,874
公投第１１案,臺中市,西區,公舘里,1099,1418,530,309,839,29,868
公投第１１案,臺中市,西區,公舘里,1100,1497,474,218,692,16,708
公投第１１案,臺中市,西區,公舘里,1101,1260,510,249,759,21,780
公投第１１案,臺中市,西區,安龍里,1102,1399,516,294,810,45,855
公投第１１案,臺中市,西區,安龍里,1103,1447,510,250,760,42,802
公投第１１案,臺中市,西區,吉龍里,1104,1683,618,320,938,45,983
公投第１１案,臺中市,西區,吉龍里,1105,1585,614,323,937,26,963
公投第１１案,臺中市,西區,吉龍里,1106,1557,577,376,953,28,981
公投第１１案,臺中市,西區,吉龍里,1107,1663,592,277,869,40,909
公投第１１案,臺中市,西區,土庫里,1108,1921,644,442,1086,36,1122
公投第１１案,臺中市,西區,土庫里,1109,1952,630,391,1021,36,1057
公投第１１案,臺中市,西區,土庫里,1110,1708,570,330,900,35,935
公投第１１案,臺中市,西區,大忠里,1111,1131,452,254,706,19,725
公投第１１案,臺中市,西區,大忠里,1112,1916,671,361,1032,25,1057
公投第１１案,臺中市,西區,大忠里,1113,1275,519,251,770,17,787
公投第１１案,臺中市,西區,民龍里,1114,1822,627,298,925,42,967
公投第１１案,臺中市,西區,民龍里,1115,1374,499,271,770,36,806
公投第１１案,臺中市,西區,和龍里,1116,1129,430,186,616,33,649
公投第１１案,臺中市,西區,和龍里,1117,1201,421,222,643,36,679
公投第１１案,臺中市,西區,後龍里,1118,1639,569,298,867,45,912
公投第１１案,臺中市,西區,後龍里,1119,1863,673,376,1049,41,1090
公投第１１案,臺中市,西區,双龍里,1120,1287,554,237,791,34,825
公投第１１案,臺中市,西區,双龍里,1121,1504,569,300,869,51,920
公投第１１案,臺中市,西區,昇平里,1122,1308,488,261,749,21,770
公投第１１案,臺中市,西區,昇平里,1123,1433,520,280,800,47,847
公投第１１案,臺中市,西區,昇平里,1124,1450,527,266,793,32,825
公投第１１案,臺中市,西區,昇平里,1125,1465,569,314,883,36,919
公投第１１案,臺中市,西區,中興里,1126,1818,632,324,956,36,992
公投第１１案,臺中市,西區,中興里,1127,1782,651,357,1008,34,1042
公投第１１案,臺中市,西區,公益里,1128,1428,543,317,860,34,894
公投第１１案,臺中市,西區,公益里,1129,1366,478,229,707,20,727
公投第１１案,臺中市,西區,公德里,1130,1498,528,295,823,34,857
公投第１１案,臺中市,西區,公德里,1131,1350,522,284,806,28,834
公投第１１案,臺中市,西區,公德里,1132,1339,525,274,799,21,820
公投第１１案,臺中市,西區,公正里,1133,1613,623,309,932,28,960
公投第１１案,臺中市,西區,公正里,1134,1454,510,307,817,39,856
公投第１１案,臺中市,西區,公正里,1135,1597,600,353,953,29,982
公投第１１案,臺中市,西區,公正里,1136,1411,532,322,854,45,899
公投第１１案,臺中市,西區,公平里,1137,1493,545,306,851,48,899
公投第１１案,臺中市,西區,公平里,1138,1600,648,295,943,39,982
公投第１１案,臺中市,西區,公平里,1139,1710,588,345,933,44,977
公投第１１案,臺中市,西區,忠明里,1140,1139,435,227,662,19,681
公投第１１案,臺中市,西區,忠明里,1141,1105,444,222,666,21,687
公投第１１案,臺中市,西區,忠明里,1142,1498,543,286,829,37,866
公投第１１案,臺中市,西區,忠明里,1143,1921,645,306,951,40,991
公投第１１案,臺中市,西區,忠誠里,1144,1340,499,245,744,42,786
公投第１１案,臺中市,西區,忠誠里,1145,1536,615,317,932,39,971
公投第１１案,臺中市,西區,忠誠里,1146,1361,484,272,756,46,802
公投第１１案,臺中市,西區,忠誠里,1147,1430,579,295,874,24,898
公投第１１案,臺中市,東區,新庄里,1148,1138,283,152,435,18,453
公投第１１案,臺中市,東區,新庄里,1149,984,386,182,568,19,587
公投第１１案,臺中市,東區,新庄里,1150,877,341,152,493,29,522
公投第１１案,臺中市,東區,振興里,1151,1070,426,225,651,31,682
公投第１１案,臺中市,東區,振興里,1152,1106,422,232,654,33,687
公投第１１案,臺中市,東區,振興里,1153,953,360,187,547,36,583
公投第１１案,臺中市,東區,東橋里,1154,1195,515,208,723,23,746
公投第１１案,臺中市,東區,東橋里,1155,1251,505,205,710,16,726
公投第１１案,臺中市,東區,東橋里,1156,1190,453,232,685,35,720
公投第１１案,臺中市,東區,東興里,1157,1394,507,254,761,33,794
公投第１１案,臺中市,東區,東興里,1158,1443,568,280,848,49,897
公投第１１案,臺中市,東區,泉源里,1159,762,316,127,443,28,471
公投第１１案,臺中市,東區,泉源里,1160,1140,488,220,708,36,744
公投第１１案,臺中市,東區,干城里,1161,1211,469,242,711,47,758
公投第１１案,臺中市,東區,干城里,1162,755,311,149,460,20,480
公投第１１案,臺中市,東區,旱溪里,1163,1491,543,257,800,50,850
公投第１１案,臺中市,東區,旱溪里,1164,1000,373,181,554,27,581
公投第１１案,臺中市,東區,樂成里,1165,1114,418,230,648,41,689
公投第１１案,臺中市,東區,樂成里,1166,1101,423,195,618,27,645
公投第１１案,臺中市,東區,東門里,1167,1169,508,208,716,45,761
公投第１１案,臺中市,東區,東門里,1168,1283,537,236,773,41,814
公投第１１案,臺中市,東區,東門里,1169,1168,483,229,712,27,739
公投第１１案,臺中市,東區,東門里,1170,1386,500,268,768,28,796
公投第１１案,臺中市,東區,東門里,1171,1557,563,325,888,39,927
公投第１１案,臺中市,東區,十甲里,1172,1380,509,269,778,44,822
公投第１１案,臺中市,東區,十甲里,1173,1674,675,307,982,30,1012
公投第１１案,臺中市,東區,十甲里,1174,1604,691,285,976,23,999
公投第１１案,臺中市,東區,東英里,1175,1815,690,359,1049,47,1096
公投第１１案,臺中市,東區,東英里,1176,1700,645,289,934,35,969
公投第１１案,臺中市,東區,東英里,1177,1592,622,268,890,26,916
公投第１１案,臺中市,東區,東英里,1178,1850,665,311,976,41,1017
公投第１１案,臺中市,東區,東南里,1179,1252,519,210,729,36,765
公投第１１案,臺中市,東區,東南里,1180,1250,480,279,759,37,796
公投第１１案,臺中市,東區,東南里,1181,1241,503,235,738,25,763
公投第１１案,臺中市,東區,東勢里,1182,1318,420,248,668,42,710
公投第１１案,臺中市,東區,東勢里,1183,1288,484,210,694,47,741
公投第１１案,臺中市,東區,合作里,1184,1442,588,274,862,48,910
公投第１１案,臺中市,東區,合作里,1185,1202,485,215,700,33,733
公投第１１案,臺中市,東區,合作里,1186,1452,597,218,815,45,860
公投第１１案,臺中市,東區,富仁里,1187,1480,530,272,802,26,828
公投第１１案,臺中市,東區,富仁里,1188,1736,706,250,956,39,995
公投第１１案,臺中市,東區,富仁里,1189,867,312,151,463,32,495
公投第１１案,臺中市,東區,富台里,1190,1693,644,215,859,45,904
公投第１１案,臺中市,東區,東信里,1191,1538,637,268,905,42,947
公投第１１案,臺中市,東區,東信里,1192,1593,606,338,944,61,1005
公投第１１案,臺中市,東區,東信里,1193,1481,534,256,790,20,810
公投第１１案,臺中市,東區,東信里,1194,1414,572,285,857,28,885
公投第１１案,臺中市,東區,東信里,1195,1297,492,246,738,23,761
公投第１１案,臺中市,東區,東信里,1196,1394,545,249,794,43,837
公投第１１案,臺中市,南區,長春里,1197,937,382,174,556,21,577
公投第１１案,臺中市,南區,長春里,1198,1001,408,213,621,34,655
公投第１１案,臺中市,南區,長榮里,1199,1249,539,248,787,39,826
公投第１１案,臺中市,南區,長榮里,1200,1202,548,237,785,37,822
公投第１１案,臺中市,南區,城隍里,1201,1130,428,235,663,55,718
公投第１１案,臺中市,南區,城隍里,1202,1239,510,240,750,36,786
公投第１１案,臺中市,南區,城隍里,1203,1238,460,235,695,36,731
公投第１１案,臺中市,南區,國光里,1204,1272,510,247,757,41,798
公投第１１案,臺中市,南區,國光里,1205,1273,500,242,742,40,782
公投第１１案,臺中市,南區,國光里,1206,1317,497,257,754,54,808
公投第１１案,臺中市,南區,南門里,1207,1160,502,255,757,31,788
公投第１１案,臺中市,南區,南門里,1208,1205,477,237,714,85,799
公投第１１案,臺中市,南區,南門里,1209,1111,387,253,640,48,688
公投第１１案,臺中市,南區,德義里,1210,1407,570,322,892,38,930
公投第１１案,臺中市,南區,德義里,1211,1419,565,260,825,29,854
公投第１１案,臺中市,南區,積善里,1212,1157,484,221,705,34,739
公投第１１案,臺中市,南區,積善里,1213,1415,528,279,807,34,841
公投第１１案,臺中市,南區,江川里,1214,1289,561,255,816,35,851
公投第１１案,臺中市,南區,江川里,1215,1454,565,271,836,39,875
公投第１１案,臺中市,南區,新榮里,1216,1491,568,272,840,35,875
公投第１１案,臺中市,南區,新榮里,1217,1394,544,253,797,35,832
公投第１１案,臺中市,南區,新榮里,1218,1430,546,280,826,38,864
公投第１１案,臺中市,南區,福興里,1219,1342,527,255,782,62,844
公投第１１案,臺中市,南區,福興里,1220,1304,570,264,834,50,884
公投第１１案,臺中市,南區,福興里,1221,1190,477,267,744,29,773
公投第１１案,臺中市,南區,福平里,1222,1273,511,209,720,41,761
公投第１１案,臺中市,南區,福平里,1223,1387,586,281,867,39,906
公投第１１案,臺中市,南區,福平里,1224,1356,522,260,782,39,821
公投第１１案,臺中市,南區,福平里,1225,1304,530,253,783,45,828
公投第１１案,臺中市,南區,福順里,1226,1256,521,276,797,23,820
公投第１１案,臺中市,南區,福順里,1227,1364,532,308,840,30,870
公投第１１案,臺中市,南區,福順里,1228,1361,529,270,799,54,853
公投第１１案,臺中市,南區,福順里,1229,1407,578,273,851,23,874
公投第１１案,臺中市,南區,和平里,1230,1308,543,218,761,39,800
公投第１１案,臺中市,南區,和平里,1231,1250,466,250,716,28,744
公投第１１案,臺中市,南區,和平里,1232,1284,480,238,718,23,741
公投第１１案,臺中市,南區,平和里,1233,1175,466,264,730,34,764
公投第１１案,臺中市,南區,平和里,1234,1158,525,217,742,28,770
公投第１１案,臺中市,南區,平和里,1235,1168,443,229,672,47,719
公投第１１案,臺中市,南區,南和里,1236,1626,664,330,994,43,1037
公投第１１案,臺中市,南區,南和里,1237,2115,581,299,880,25,905
公投第１１案,臺中市,南區,南和里,1238,1805,669,310,979,33,1012
公投第１１案,臺中市,南區,南和里,1239,1695,630,298,928,19,947
公投第１１案,臺中市,南區,永興里,1240,1643,636,375,1011,35,1046
公投第１１案,臺中市,南區,永興里,1241,1423,636,215,851,37,888
公投第１１案,臺中市,南區,永興里,1242,1542,597,302,899,37,936
公投第１１案,臺中市,南區,永興里,1243,1533,580,329,909,21,930
公投第１１案,臺中市,南區,永興里,1244,1531,616,324,940,46,986
公投第１１案,臺中市,南區,永和里,1245,1392,560,225,785,23,808
公投第１１案,臺中市,南區,永和里,1246,1592,580,310,890,30,920
公投第１１案,臺中市,南區,永和里,1247,1431,556,304,860,39,899
公投第１１案,臺中市,南區,樹義里,1248,1799,621,336,957,27,984
公投第１１案,臺中市,南區,樹義里,1249,1708,722,333,1055,36,1091
公投第１１案,臺中市,南區,樹義里,1250,1700,627,323,950,43,993
公投第１１案,臺中市,南區,樹義里,1251,1751,781,297,1078,21,1099
公投第１１案,臺中市,南區,樹義里,1252,2109,763,448,1211,60,1271
公投第１１案,臺中市,南區,樹義里,1253,1697,633,334,967,42,1009
公投第１１案,臺中市,南區,工學里,1254,1456,524,305,829,41,870
公投第１１案,臺中市,南區,工學里,1255,1726,741,366,1107,46,1153
公投第１１案,臺中市,南區,工學里,1256,1723,691,352,1043,41,1084
公投第１１案,臺中市,南區,工學里,1257,1569,638,302,940,32,972
公投第１１案,臺中市,南區,樹德里,1258,1274,506,260,766,39,805
公投第１１案,臺中市,南區,樹德里,1259,1390,622,275,897,27,924
公投第１１案,臺中市,南區,樹德里,1260,1295,517,314,831,20,851
公投第１１案,臺中市,南區,樹德里,1261,1312,542,222,764,40,804
公投第１１案,臺中市,南區,樹德里,1262,1417,602,275,877,30,907
公投第１１案,臺中市,南區,樹德里,1263,1230,549,277,826,31,857
公投第１１案,臺中市,南區,西川里,1264,1308,504,261,765,28,793
公投第１１案,臺中市,南區,西川里,1265,1467,547,287,834,53,887
公投第１１案,臺中市,南區,西川里,1266,1399,536,293,829,29,858
公投第１１案,臺中市,南區,崇倫里,1267,1207,486,216,702,32,734
公投第１１案,臺中市,南區,崇倫里,1268,1317,494,277,771,32,803
公投第１１案,臺中市,南區,崇倫里,1269,1563,565,326,891,26,917
公投第１１案,臺中市,南區,崇倫里,1270,1221,484,256,740,30,770
公投第１１案,臺中市,太平區,太平里,1271,1821,640,312,952,46,998
公投第１１案,臺中市,太平區,太平里,1272,1680,585,266,851,35,886
公投第１１案,臺中市,太平區,太平里,1273,1947,734,334,1068,63,1131
公投第１１案,臺中市,太平區,長億里,1274,1910,799,299,1098,46,1144
公投第１１案,臺中市,太平區,長億里,1275,1894,660,323,983,31,1014
公投第１１案,臺中市,太平區,長億里,1276,1953,698,336,1034,45,1079
公投第１１案,臺中市,太平區,永成里,1277,1846,711,308,1019,43,1062
公投第１１案,臺中市,太平區,永成里,1278,1493,619,238,857,27,884
公投第１１案,臺中市,太平區,永成里,1279,1605,613,250,863,33,896
公投第１１案,臺中市,太平區,永成里,1280,1619,690,263,953,34,987
公投第１１案,臺中市,太平區,中平里,1281,2011,744,315,1059,55,1114
公投第１１案,臺中市,太平區,中平里,1282,2056,753,345,1098,25,1123
公投第１１案,臺中市,太平區,中政里,1283,1876,658,317,975,51,1026
公投第１１案,臺中市,太平區,中政里,1284,1815,666,276,942,48,990
公投第１１案,臺中市,太平區,平安里,1285,1281,477,220,697,29,726
公投第１１案,臺中市,太平區,平安里,1286,1004,418,196,614,36,650
公投第１１案,臺中市,太平區,中興里,1287,1886,733,329,1062,59,1121
公投第１１案,臺中市,太平區,中興里,1288,1431,568,229,797,67,864
公投第１１案,臺中市,太平區,永平里,1289,1930,666,344,1010,52,1062
公投第１１案,臺中市,太平區,永平里,1290,2164,718,367,1085,44,1129
公投第１１案,臺中市,太平區,東平里,1291,2048,761,313,1074,42,1116
公投第１１案,臺中市,太平區,東平里,1292,2035,736,97,833,51,884
公投第１１案,臺中市,太平區,成功里,1293,1685,585,294,879,57,936
公投第１１案,臺中市,太平區,成功里,1294,2185,692,331,1023,61,1084
公投第１１案,臺中市,太平區,東和里,1295,1176,429,188,617,30,647
公投第１１案,臺中市,太平區,東和里,1296,1597,578,274,852,25,877
公投第１１案,臺中市,太平區,建國里,1297,1378,470,219,689,63,752
公投第１１案,臺中市,太平區,建國里,1298,1546,580,258,838,29,867
公投第１１案,臺中市,太平區,建興里,1299,1890,600,318,918,43,961
公投第１１案,臺中市,太平區,建興里,1300,1053,398,162,560,37,597
公投第１１案,臺中市,太平區,坪林里,1301,1582,629,265,894,63,957
公投第１１案,臺中市,太平區,坪林里,1302,1699,689,273,962,40,1002
公投第１１案,臺中市,太平區,大興里,1303,1493,505,300,805,46,851
公投第１１案,臺中市,太平區,大興里,1304,1063,409,183,592,43,635
公投第１１案,臺中市,太平區,勤益里,1305,1117,474,171,645,37,682
公投第１１案,臺中市,太平區,勤益里,1306,1084,437,179,616,38,654
公投第１１案,臺中市,太平區,光華里,1307,1776,581,313,894,33,927
公投第１１案,臺中市,太平區,光華里,1308,1729,628,266,894,45,939
公投第１１案,臺中市,太平區,光華里,1309,1658,566,228,794,47,841
公投第１１案,臺中市,太平區,光明里,1310,2010,748,294,1042,40,1082
公投第１１案,臺中市,太平區,光明里,1311,1752,601,288,889,47,936
公投第１１案,臺中市,太平區,中山里,1312,1654,676,271,947,53,1000
公投第１１案,臺中市,太平區,中山里,1313,1951,525,246,771,24,795
公投第１１案,臺中市,太平區,豐年里,1314,2170,793,415,1208,62,1270
公投第１１案,臺中市,太平區,豐年里,1315,2231,803,501,1304,61,1365
公投第１１案,臺中市,太平區,宜欣里,1316,1623,644,270,914,40,954
公投第１１案,臺中市,太平區,宜欣里,1317,1548,546,215,761,27,788
公投第１１案,臺中市,太平區,宜欣里,1318,1442,519,225,744,52,796
公投第１１案,臺中市,太平區,宜欣里,1319,1501,507,218,725,27,752
公投第１１案,臺中市,太平區,宜佳里,1320,2025,651,333,984,28,1012
公投第１１案,臺中市,太平區,宜佳里,1321,1885,671,306,977,38,1015
公投第１１案,臺中市,太平區,宜佳里,1322,2155,686,338,1024,41,1065
公投第１１案,臺中市,太平區,宜昌里,1323,1775,600,294,894,31,925
公投第１１案,臺中市,太平區,宜昌里,1324,2021,607,273,880,62,942
公投第１１案,臺中市,太平區,新坪里,1325,2075,792,345,1137,64,1201
公投第１１案,臺中市,太平區,新坪里,1326,1723,567,295,862,40,902
公投第１１案,臺中市,太平區,新坪里,1327,2049,767,346,1113,31,1144
公投第１１案,臺中市,太平區,新坪里,1328,1415,526,232,758,22,780
公投第１１案,臺中市,太平區,新吉里,1329,1778,686,303,989,21,1010
公投第１１案,臺中市,太平區,新吉里,1330,1706,581,285,866,41,907
公投第１１案,臺中市,太平區,新吉里,1331,2090,743,364,1107,31,1138
公投第１１案,臺中市,太平區,新城里,1332,2093,686,323,1009,36,1045
公投第１１案,臺中市,太平區,新城里,1333,1688,578,234,812,30,842
公投第１１案,臺中市,太平區,新城里,1334,1488,484,249,733,20,753
公投第１１案,臺中市,太平區,新光里,1335,1667,639,305,944,37,981
公投第１１案,臺中市,太平區,新光里,1336,1793,612,253,865,46,911
公投第１１案,臺中市,太平區,新光里,1337,1903,703,358,1061,27,1088
公投第１１案,臺中市,太平區,新光里,1338,1834,729,259,988,42,1030
公投第１１案,臺中市,太平區,新興里,1339,1526,570,237,807,36,843
公投第１１案,臺中市,太平區,新興里,1340,1483,594,321,915,16,931
公投第１１案,臺中市,太平區,新興里,1341,1694,621,319,940,25,965
公投第１１案,臺中市,太平區,新高里,1342,1952,662,301,963,20,983
公投第１１案,臺中市,太平區,新高里,1343,1995,717,343,1060,38,1098
公投第１１案,臺中市,太平區,新高里,1344,1311,491,250,741,21,762
公投第１１案,臺中市,太平區,新高里,1345,1537,614,374,988,30,1018
公投第１１案,臺中市,太平區,新福里,1346,1974,641,291,932,52,984
公投第１１案,臺中市,太平區,新福里,1347,1828,648,354,1002,39,1041
公投第１１案,臺中市,太平區,新福里,1348,2191,696,375,1071,26,1097
公投第１１案,臺中市,太平區,頭汴里,1349,1825,689,238,927,56,983
公投第１１案,臺中市,太平區,聖和里,1350,1559,568,241,809,12,821
公投第１１案,臺中市,太平區,東汴里,1351,1225,457,191,648,46,694
公投第１１案,臺中市,太平區,興隆里,1352,1678,629,257,886,53,939
公投第１１案,臺中市,太平區,興隆里,1353,1501,492,243,735,67,802
公投第１１案,臺中市,太平區,福隆里,1354,1450,623,261,884,38,922
公投第１１案,臺中市,太平區,福隆里,1355,2126,732,338,1070,56,1126
公投第１１案,臺中市,太平區,黃竹里,1356,699,307,103,410,40,450
公投第１１案,臺中市,太平區,光隆里,1357,1428,457,261,718,36,754
公投第１１案,臺中市,太平區,光隆里,1358,1666,593,326,919,57,976
公投第１１案,臺中市,太平區,永隆里,1359,1241,482,218,700,25,725
公投第１１案,臺中市,太平區,永隆里,1360,1266,485,235,720,62,782
公投第１１案,臺中市,太平區,德隆里,1361,1166,481,155,636,34,670
公投第１１案,臺中市,太平區,德隆里,1362,1790,688,304,992,57,1049
公投第１１案,臺中市,太平區,德隆里,1363,1754,555,223,778,37,815
公投第１１案,臺中市,大里區,東湖里,1364,1614,584,239,823,28,851
公投第１１案,臺中市,大里區,東湖里,1365,1599,545,265,810,24,834
公投第１１案,臺中市,大里區,東湖里,1366,1715,550,282,832,44,876
公投第１１案,臺中市,大里區,東湖里,1367,1264,517,205,722,27,749
公投第１１案,臺中市,大里區,東湖里,1368,1416,476,258,734,25,759
公投第１１案,臺中市,大里區,東湖里,1369,1188,429,200,629,31,660
公投第１１案,臺中市,大里區,東湖里,1370,1359,493,222,715,40,755
公投第１１案,臺中市,大里區,西湖里,1371,1457,535,259,794,53,847
公投第１１案,臺中市,大里區,西湖里,1372,1403,531,251,782,52,834
公投第１１案,臺中市,大里區,大里里,1373,1697,635,289,924,38,962
公投第１１案,臺中市,大里區,大里里,1374,1811,697,325,1022,63,1085
公投第１１案,臺中市,大里區,新里里,1375,1830,649,199,848,44,892
公投第１１案,臺中市,大里區,新里里,1376,2228,633,297,930,46,976
公投第１１案,臺中市,大里區,新里里,1377,1997,728,309,1037,42,1079
公投第１１案,臺中市,大里區,新里里,1378,2033,853,423,1276,26,1302
公投第１１案,臺中市,大里區,新里里,1379,1835,722,381,1103,15,1118
公投第１１案,臺中市,大里區,國光里,1380,1268,468,240,708,32,740
公投第１１案,臺中市,大里區,國光里,1381,1645,640,274,914,39,953
公投第１１案,臺中市,大里區,國光里,1382,1561,655,289,944,17,961
公投第１１案,臺中市,大里區,國光里,1383,1301,569,259,828,25,853
公投第１１案,臺中市,大里區,樹王里,1384,1621,503,250,753,43,796
公投第１１案,臺中市,大里區,樹王里,1385,1797,640,287,927,47,974
公投第１１案,臺中市,大里區,祥興里,1386,1230,463,205,668,19,687
公投第１１案,臺中市,大里區,祥興里,1387,1488,569,211,780,36,816
公投第１１案,臺中市,大里區,祥興里,1388,1459,498,262,760,46,806
公投第１１案,臺中市,大里區,祥興里,1389,1647,622,287,909,34,943
公投第１１案,臺中市,大里區,祥興里,1390,1100,447,210,657,36,693
公投第１１案,臺中市,大里區,內新里,1391,1410,536,238,774,40,814
公投第１１案,臺中市,大里區,內新里,1392,1807,660,258,918,39,957
公投第１１案,臺中市,大里區,內新里,1393,1331,485,243,728,31,759
公投第１１案,臺中市,大里區,內新里,1394,1801,636,312,948,24,972
公投第１１案,臺中市,大里區,內新里,1395,1909,637,311,948,31,979
公投第１１案,臺中市,大里區,中新里,1396,1699,564,279,843,31,874
公投第１１案,臺中市,大里區,中新里,1397,1627,631,273,904,33,937
公投第１１案,臺中市,大里區,中新里,1398,1912,664,340,1004,43,1047
公投第１１案,臺中市,大里區,東昇里,1399,1753,638,259,897,48,945
公投第１１案,臺中市,大里區,東昇里,1400,1602,635,244,879,20,899
公投第１１案,臺中市,大里區,大元里,1401,1144,395,218,613,41,654
公投第１１案,臺中市,大里區,大元里,1402,1655,645,275,920,60,980
公投第１１案,臺中市,大里區,大元里,1403,1438,506,273,779,28,807
公投第１１案,臺中市,大里區,夏田里,1404,1000,363,199,562,35,597
公投第１１案,臺中市,大里區,仁化里,1405,1711,619,298,917,45,962
公投第１１案,臺中市,大里區,仁化里,1406,1698,649,285,934,12,946
公投第１１案,臺中市,大里區,仁化里,1407,1914,694,313,1007,62,1069
公投第１１案,臺中市,大里區,仁化里,1408,1465,534,284,818,39,857
公投第１１案,臺中市,大里區,仁化里,1409,1581,597,255,852,52,904
公投第１１案,臺中市,大里區,仁德里,1410,1509,602,278,880,45,925
公投第１１案,臺中市,大里區,仁德里,1411,1570,594,242,836,24,860
公投第１１案,臺中市,大里區,仁德里,1412,1425,501,298,799,31,830
公投第１１案,臺中市,大里區,仁德里,1413,1384,522,257,779,45,824
公投第１１案,臺中市,大里區,健民里,1414,1204,393,185,578,31,609
公投第１１案,臺中市,大里區,健民里,1415,1761,607,258,865,36,901
公投第１１案,臺中市,大里區,健民里,1416,1473,491,205,696,27,723
公投第１１案,臺中市,大里區,塗城里,1417,1675,647,267,914,40,954
公投第１１案,臺中市,大里區,塗城里,1418,1755,683,278,961,33,994
公投第１１案,臺中市,大里區,塗城里,1419,1593,624,275,899,56,955
公投第１１案,臺中市,大里區,塗城里,1420,1799,639,307,946,55,1001
公投第１１案,臺中市,大里區,塗城里,1421,1606,581,277,858,55,913
公投第１１案,臺中市,大里區,東興里,1422,1875,652,340,992,33,1025
公投第１１案,臺中市,大里區,東興里,1423,1670,617,304,921,40,961
公投第１１案,臺中市,大里區,東興里,1424,1898,675,325,1000,48,1048
公投第１１案,臺中市,大里區,東興里,1425,1679,597,284,881,31,912
公投第１１案,臺中市,大里區,大明里,1426,1373,481,228,709,46,755
公投第１１案,臺中市,大里區,大明里,1427,1299,510,211,721,30,751
公投第１１案,臺中市,大里區,大明里,1428,1430,525,257,782,30,812
公投第１１案,臺中市,大里區,永隆里,1429,1805,755,352,1107,37,1144
公投第１１案,臺中市,大里區,永隆里,1430,1806,743,415,1158,23,1181
公投第１１案,臺中市,大里區,永隆里,1431,1826,804,359,1163,29,1192
公投第１１案,臺中市,大里區,永隆里,1432,1805,801,353,1154,25,1179
公投第１１案,臺中市,大里區,永隆里,1433,1907,751,374,1125,28,1153
公投第１１案,臺中市,大里區,日新里,1434,1103,477,198,675,22,697
公投第１１案,臺中市,大里區,日新里,1435,1419,543,211,754,35,789
公投第１１案,臺中市,大里區,日新里,1436,1434,598,179,777,45,822
公投第１１案,臺中市,大里區,西榮里,1437,1875,655,290,945,27,972
公投第１１案,臺中市,大里區,西榮里,1438,1862,668,335,1003,37,1040
公投第１１案,臺中市,大里區,西榮里,1439,1850,673,307,980,34,1014
公投第１１案,臺中市,大里區,長榮里,1440,1622,606,285,891,39,930
公投第１１案,臺中市,大里區,長榮里,1441,1638,683,296,979,44,1023
公投第１１案,臺中市,大里區,長榮里,1442,1633,681,289,970,53,1023
公投第１１案,臺中市,大里區,長榮里,1443,1662,604,329,933,29,962
公投第１１案,臺中市,大里區,長榮里,1444,1917,699,414,1113,21,1134
公投第１１案,臺中市,大里區,金城里,1445,1701,576,269,845,58,903
公投第１１案,臺中市,大里區,金城里,1446,1549,540,268,808,35,843
公投第１１案,臺中市,大里區,金城里,1447,1567,658,264,922,24,946
公投第１１案,臺中市,大里區,金城里,1448,1614,614,278,892,34,926
公投第１１案,臺中市,大里區,金城里,1449,1811,703,308,1011,58,1069
公投第１１案,臺中市,大里區,金城里,1450,1336,490,245,735,29,764
公投第１１案,臺中市,大里區,立仁里,1451,1759,672,264,936,41,977
公投第１１案,臺中市,大里區,立仁里,1452,1783,614,295,909,41,950
公投第１１案,臺中市,大里區,立仁里,1453,1736,597,258,855,31,886
公投第１１案,臺中市,大里區,立德里,1454,1874,741,297,1038,35,1073
公投第１１案,臺中市,大里區,立德里,1455,1889,717,330,1047,41,1088
公投第１１案,臺中市,大里區,立德里,1456,1947,767,272,1039,52,1091
公投第１１案,臺中市,大里區,立德里,1457,1938,776,329,1105,28,1133
公投第１１案,臺中市,大里區,新仁里,1458,1836,656,309,965,60,1025
公投第１１案,臺中市,大里區,新仁里,1459,1913,720,292,1012,47,1059
公投第１１案,臺中市,大里區,新仁里,1460,1913,670,284,954,67,1021
公投第１１案,臺中市,大里區,新仁里,1461,1937,717,255,972,36,1008
公投第１１案,臺中市,大里區,瑞城里,1462,1508,578,228,806,17,823
公投第１１案,臺中市,大里區,瑞城里,1463,1340,547,235,782,33,815
公投第１１案,臺中市,大里區,瑞城里,1464,1656,649,284,933,34,967
公投第１１案,臺中市,大里區,瑞城里,1465,1290,488,203,691,26,717
公投第１１案,臺中市,大里區,瑞城里,1466,1655,604,284,888,31,919
公投第１１案,臺中市,大里區,瑞城里,1467,1260,426,202,628,17,645
公投第１１案,臺中市,大里區,瑞城里,1468,1247,76,53,129,23,152
公投第１１案,臺中市,大里區,瑞城里,1469,1548,563,264,827,42,869
公投第１１案,臺中市,霧峰區,桐林里,1470,1205,490,225,715,35,750
公投第１１案,臺中市,霧峰區,吉峰里,1471,1620,608,288,896,36,932
公投第１１案,臺中市,霧峰區,吉峰里,1472,1559,610,300,910,59,969
公投第１１案,臺中市,霧峰區,吉峰里,1473,1660,633,269,902,53,955
公投第１１案,臺中市,霧峰區,吉峰里,1474,1602,646,297,943,45,988
公投第１１案,臺中市,霧峰區,吉峰里,1475,1325,494,206,700,36,736
公投第１１案,臺中市,霧峰區,吉峰里,1476,1515,618,224,842,51,893
公投第１１案,臺中市,霧峰區,甲寅里,1477,1561,569,255,824,56,880
公投第１１案,臺中市,霧峰區,甲寅里,1478,1691,629,253,882,40,922
公投第１１案,臺中市,霧峰區,甲寅里,1479,1486,555,264,819,40,859
公投第１１案,臺中市,霧峰區,本鄉里,1480,975,418,169,587,30,617
公投第１１案,臺中市,霧峰區,本鄉里,1481,1358,596,214,810,37,847
公投第１１案,臺中市,霧峰區,中正里,1482,1141,506,228,734,27,761
公投第１１案,臺中市,霧峰區,中正里,1483,855,394,91,485,32,517
公投第１１案,臺中市,霧峰區,錦榮里,1484,1202,474,201,675,46,721
公投第１１案,臺中市,霧峰區,萊園里,1485,1078,397,176,573,41,614
公投第１１案,臺中市,霧峰區,本堂里,1486,1456,564,282,846,55,901
公投第１１案,臺中市,霧峰區,本堂里,1487,1573,627,297,924,38,962
公投第１１案,臺中市,霧峰區,本堂里,1488,1591,646,255,901,42,943
公投第１１案,臺中市,霧峰區,本堂里,1489,1214,528,213,741,42,783
公投第１１案,臺中市,霧峰區,北柳里,1490,1267,463,225,688,42,730
公投第１１案,臺中市,霧峰區,北柳里,1491,1277,487,229,716,46,762
公投第１１案,臺中市,霧峰區,北柳里,1492,1366,515,237,752,38,790
公投第１１案,臺中市,霧峰區,南柳里,1493,994,430,217,647,42,689
公投第１１案,臺中市,霧峰區,南柳里,1494,863,348,181,529,21,550
公投第１１案,臺中市,霧峰區,四德里,1495,1274,464,224,688,45,733
公投第１１案,臺中市,霧峰區,四德里,1496,1162,420,212,632,53,685
公投第１１案,臺中市,霧峰區,五福里,1497,1252,495,212,707,70,777
公投第１１案,臺中市,霧峰區,五福里,1498,1322,512,231,743,45,788
公投第１１案,臺中市,霧峰區,丁台里,1499,1116,442,222,664,48,712
公投第１１案,臺中市,霧峰區,丁台里,1500,1156,433,246,679,55,734
公投第１１案,臺中市,霧峰區,北勢里,1501,1147,527,170,697,36,733
公投第１１案,臺中市,霧峰區,北勢里,1502,928,407,179,586,44,630
公投第１１案,臺中市,霧峰區,南勢里,1503,1296,486,209,695,38,733
公投第１１案,臺中市,霧峰區,萬豐里,1504,1314,416,232,648,69,717
公投第１１案,臺中市,霧峰區,萬豐里,1505,1328,636,109,745,70,815
公投第１１案,臺中市,霧峰區,舊正里,1506,989,355,102,457,135,592
公投第１１案,臺中市,霧峰區,舊正里,1507,1088,440,189,629,58,687
公投第１１案,臺中市,霧峰區,坑口里,1508,1363,595,219,814,85,899
公投第１１案,臺中市,霧峰區,坑口里,1509,1573,650,272,922,43,965
公投第１１案,臺中市,霧峰區,峰谷里,1510,1117,430,186,616,44,660
公投第１１案,臺中市,霧峰區,六股里,1511,1342,581,230,811,60,871
公投第１１案,臺中市,霧峰區,六股里,1512,1024,419,197,616,69,685
公投第１１案,臺中市,東勢區,慶福里,1513,1299,460,204,664,58,722
公投第１１案,臺中市,東勢區,慶東里,1514,1007,394,151,545,48,593
公投第１１案,臺中市,東勢區,慶東里,1515,859,306,126,432,48,480
公投第１１案,臺中市,東勢區,上城里,1516,991,444,154,598,42,640
公投第１１案,臺中市,東勢區,下城里,1517,863,304,129,433,26,459
公投第１１案,臺中市,東勢區,詒福里,1518,1628,617,239,856,74,930
公投第１１案,臺中市,東勢區,新盛里,1519,1335,464,214,678,49,727
公投第１１案,臺中市,東勢區,新盛里,1520,1092,481,193,674,34,708
公投第１１案,臺中市,東勢區,新盛里,1521,1050,478,157,635,43,678
公投第１１案,臺中市,東勢區,新盛里,1522,1431,584,203,787,37,824
公投第１１案,臺中市,東勢區,福隆里,1523,1372,583,197,780,55,835
公投第１１案,臺中市,東勢區,福隆里,1524,1412,579,230,809,29,838
公投第１１案,臺中市,東勢區,福隆里,1525,878,366,109,475,45,520
公投第１１案,臺中市,東勢區,隆興里,1526,1475,522,188,710,57,767
公投第１１案,臺中市,東勢區,中嵙里,1527,872,350,110,460,16,476
公投第１１案,臺中市,東勢區,中嵙里,1528,1006,381,136,517,52,569
公投第１１案,臺中市,東勢區,泰昌里,1529,1222,478,193,671,27,698
公投第１１案,臺中市,東勢區,泰昌里,1530,1228,569,204,773,37,810
公投第１１案,臺中市,東勢區,泰昌里,1531,1036,486,154,640,25,665
公投第１１案,臺中市,東勢區,上新里,1532,977,443,171,614,22,636
公投第１１案,臺中市,東勢區,廣興里,1533,1395,550,205,755,36,791
公投第１１案,臺中市,東勢區,延平里,1534,1169,512,181,693,50,743
公投第１１案,臺中市,東勢區,延平里,1535,1027,459,143,602,42,644
公投第１１案,臺中市,東勢區,南平里,1536,984,433,139,572,34,606
公投第１１案,臺中市,東勢區,南平里,1537,866,421,138,559,27,586
公投第１１案,臺中市,東勢區,東安里,1538,1031,443,144,587,54,641
公投第１１案,臺中市,東勢區,中寧里,1539,865,409,132,541,37,578
公投第１１案,臺中市,東勢區,北興里,1540,1357,617,204,821,39,860
公投第１１案,臺中市,東勢區,粵寧里,1541,736,306,124,430,23,453
公投第１１案,臺中市,東勢區,粵寧里,1542,1314,554,190,744,37,781
公投第１１案,臺中市,東勢區,下新里,1543,1677,612,255,867,56,923
公投第１１案,臺中市,東勢區,東新里,1544,950,408,155,563,22,585
公投第１１案,臺中市,東勢區,東新里,1545,1007,440,168,608,23,631
公投第１１案,臺中市,東勢區,興隆里,1546,1214,430,184,614,30,644
公投第１１案,臺中市,東勢區,茂興里,1547,907,363,116,479,41,520
公投第１１案,臺中市,東勢區,茂興里,1548,902,290,160,450,47,497
公投第１１案,臺中市,東勢區,泰興里,1549,720,230,90,320,13,333
公投第１１案,臺中市,東勢區,埤頭里,1550,666,222,88,310,11,321
公投第１１案,臺中市,東勢區,明正里,1551,1361,492,208,700,49,749
公投第１１案,臺中市,石岡區,石岡里,1552,1244,484,207,691,39,730
公投第１１案,臺中市,石岡區,萬安里,1553,1539,568,237,805,53,858
公投第１１案,臺中市,石岡區,九房里,1554,1202,461,204,665,52,717
公投第１１案,臺中市,石岡區,金星里,1555,1272,434,195,629,68,697
公投第１１案,臺中市,石岡區,龍興里,1556,652,252,105,357,34,391
公投第１１案,臺中市,石岡區,萬興里,1557,1457,592,280,872,81,953
公投第１１案,臺中市,石岡區,梅子里,1558,1836,666,310,976,69,1045
公投第１１案,臺中市,石岡區,土牛里,1559,1001,389,153,542,43,585
公投第１１案,臺中市,石岡區,德興里,1560,1448,577,267,844,51,895
公投第１１案,臺中市,石岡區,和盛里,1561,1229,501,224,725,41,766
公投第１１案,臺中市,新社區,新社里,1562,1011,413,153,566,25,591
公投第１１案,臺中市,新社區,新社里,1563,1195,612,82,694,24,718
公投第１１案,臺中市,新社區,新社里,1564,1053,455,184,639,31,670
公投第１１案,臺中市,新社區,復盛里,1565,961,299,129,428,22,450
公投第１１案,臺中市,新社區,復盛里,1566,919,352,119,471,13,484
公投第１１案,臺中市,新社區,中正里,1567,1367,597,192,789,51,840
公投第１１案,臺中市,新社區,月湖里,1568,1010,353,149,502,31,533
公投第１１案,臺中市,新社區,崑山里,1569,1169,347,176,523,59,582
公投第１１案,臺中市,新社區,大南里,1570,989,366,159,525,42,567
公投第１１案,臺中市,新社區,大南里,1571,894,352,133,485,25,510
公投第１１案,臺中市,新社區,永源里,1572,1033,419,131,550,28,578
公投第１１案,臺中市,新社區,永源里,1573,1058,307,142,449,33,482
公投第１１案,臺中市,新社區,永源里,1574,845,297,125,422,15,437
公投第１１案,臺中市,新社區,中興里,1575,576,272,94,366,24,390
公投第１１案,臺中市,新社區,協成里,1576,1229,418,172,590,40,630
公投第１１案,臺中市,新社區,協成里,1577,890,263,154,417,17,434
公投第１１案,臺中市,新社區,協成里,1578,781,271,131,402,20,422
公投第１１案,臺中市,新社區,東興里,1579,1244,450,184,634,47,681
公投第１１案,臺中市,新社區,慶西里,1580,213,49,20,69,12,81
公投第１１案,臺中市,新社區,慶西里,1581,676,202,93,295,29,324
公投第１１案,臺中市,新社區,中和里,1582,585,203,56,259,23,282
公投第１１案,臺中市,新社區,福興里,1583,938,386,114,500,36,536
公投第１１案,臺中市,新社區,福興里,1584,224,78,25,103,8,111
公投第１１案,臺中市,和平區,南勢里,1585,956,395,184,579,39,618
公投第１１案,臺中市,和平區,南勢里,1586,963,432,153,585,43,628
公投第１１案,臺中市,和平區,天輪里,1587,456,167,91,258,14,272
公投第１１案,臺中市,和平區,博愛里,1588,1011,484,141,625,37,662
公投第１１案,臺中市,和平區,博愛里,1589,636,271,89,360,23,383
公投第１１案,臺中市,和平區,自由里,1590,270,101,32,133,4,137
公投第１１案,臺中市,和平區,自由里,1591,460,258,69,327,30,357
公投第１１案,臺中市,和平區,自由里,1592,321,163,68,231,11,242
公投第１１案,臺中市,和平區,達觀里,1593,783,337,150,487,27,514
公投第１１案,臺中市,和平區,達觀里,1594,336,137,60,197,16,213
公投第１１案,臺中市,和平區,中坑里,1595,451,219,88,307,9,316
公投第１１案,臺中市,和平區,梨山里,1596,366,163,46,209,11,220
公投第１１案,臺中市,和平區,梨山里,1597,771,288,75,363,12,375
公投第１１案,臺中市,和平區,梨山里,1598,574,231,70,301,20,321
公投第１１案,臺中市,和平區,梨山里,1599,274,124,38,162,9,171
公投第１１案,臺中市,和平區,平等里,1600,157,56,27,83,5,88
公投第１１案,臺中市,和平區,平等里,1601,713,309,88,397,17,414
公投第１１案,臺南市,後壁區,後壁里,1,743,266,115,381,45,426
公投第１１案,臺南市,後壁區,後壁里,2,898,315,123,438,21,459
公投第１１案,臺南市,後壁區,侯伯里,3,786,238,110,348,38,386
公投第１１案,臺南市,後壁區,侯伯里,4,534,178,67,245,33,278
公投第１１案,臺南市,後壁區,嘉苳里,5,1034,318,161,479,53,532
公投第１１案,臺南市,後壁區,嘉苳里,6,232,44,46,90,16,106
公投第１１案,臺南市,後壁區,土溝里,7,479,140,61,201,34,235
公投第１１案,臺南市,後壁區,土溝里,8,837,260,118,378,27,405
公投第１１案,臺南市,後壁區,上茄苳里,9,1085,269,150,419,39,458
公投第１１案,臺南市,後壁區,上茄苳里,10,1157,282,134,416,17,433
公投第１１案,臺南市,後壁區,菁豐里,11,755,251,90,341,45,386
公投第１１案,臺南市,後壁區,菁豐里,12,458,139,92,231,25,256
公投第１１案,臺南市,後壁區,菁寮里,13,371,115,40,155,24,179
公投第１１案,臺南市,後壁區,菁寮里,14,676,210,93,303,30,333
公投第１１案,臺南市,後壁區,菁寮里,15,428,119,46,165,25,190
公投第１１案,臺南市,後壁區,新嘉里,16,547,173,52,225,18,243
公投第１１案,臺南市,後壁區,新嘉里,17,455,151,53,204,31,235
公投第１１案,臺南市,後壁區,長短樹里,18,984,287,104,391,44,435
公投第１１案,臺南市,後壁區,長短樹里,19,483,132,69,201,24,225
公投第１１案,臺南市,後壁區,長短樹里,20,536,152,53,205,22,227
公投第１１案,臺南市,後壁區,竹新里,21,958,237,96,333,11,344
公投第１１案,臺南市,後壁區,竹新里,22,441,170,52,222,34,256
公投第１１案,臺南市,後壁區,新東里,23,677,226,107,333,44,377
公投第１１案,臺南市,後壁區,新東里,24,996,390,118,508,35,543
公投第１１案,臺南市,後壁區,頂安里,25,1255,388,164,552,26,578
公投第１１案,臺南市,後壁區,長安里,26,678,196,90,286,15,301
公投第１１案,臺南市,後壁區,長安里,27,553,162,66,228,13,241
公投第１１案,臺南市,後壁區,福安里,28,616,154,65,219,19,238
公投第１１案,臺南市,後壁區,福安里,29,1189,388,160,548,39,587
公投第１１案,臺南市,白河區,白河里,30,1176,409,182,591,50,641
公投第１１案,臺南市,白河區,白河里,31,546,181,85,266,16,282
公投第１１案,臺南市,白河區,永安里,32,859,303,155,458,19,477
公投第１１案,臺南市,白河區,永安里,33,946,344,154,498,37,535
公投第１１案,臺南市,白河區,永安里,34,1116,368,181,549,34,583
公投第１１案,臺南市,白河區,外角里,35,1397,398,156,554,29,583
公投第１１案,臺南市,白河區,庄內里,36,756,199,107,306,19,325
公投第１１案,臺南市,白河區,庄內里,37,871,265,120,385,43,428
公投第１１案,臺南市,白河區,秀祐里,38,897,308,118,426,26,452
公投第１１案,臺南市,白河區,河東里,39,784,175,81,256,33,289
公投第１１案,臺南市,白河區,河東里,40,572,148,87,235,15,250
公投第１１案,臺南市,白河區,虎山里,41,457,104,46,150,10,160
公投第１１案,臺南市,白河區,大林里,42,600,172,55,227,13,240
公投第１１案,臺南市,白河區,崁頭里,43,375,71,40,111,5,116
公投第１１案,臺南市,白河區,六溪里,44,508,94,51,145,10,155
公投第１１案,臺南市,白河區,關嶺里,45,631,128,68,196,15,211
公投第１１案,臺南市,白河區,關嶺里,46,391,77,32,109,14,123
公投第１１案,臺南市,白河區,仙草里,47,799,241,60,301,25,326
公投第１１案,臺南市,白河區,仙草里,48,506,120,47,167,17,184
公投第１１案,臺南市,白河區,詔豐里,49,832,224,111,335,38,373
公投第１１案,臺南市,白河區,詔豐里,50,1179,366,172,538,23,561
公投第１１案,臺南市,白河區,大竹里,51,744,165,91,256,20,276
公投第１１案,臺南市,白河區,大竹里,52,699,163,81,244,25,269
公投第１１案,臺南市,白河區,廣蓮里,53,633,170,61,231,8,239
公投第１１案,臺南市,白河區,廣蓮里,54,859,279,127,406,60,466
公投第１１案,臺南市,白河區,竹門里,55,884,236,114,350,44,394
公投第１１案,臺南市,白河區,崎內里,56,740,141,66,207,12,219
公投第１１案,臺南市,白河區,昇安里,57,1334,370,169,539,36,575
公投第１１案,臺南市,白河區,汴頭里,58,723,215,98,313,43,356
公投第１１案,臺南市,白河區,內角里,59,682,235,99,334,55,389
公投第１１案,臺南市,白河區,馬稠後里,60,855,243,143,386,55,441
公投第１１案,臺南市,白河區,馬稠後里,61,543,140,66,206,24,230
公投第１１案,臺南市,東山區,東山里,62,1401,412,160,572,38,610
公投第１１案,臺南市,東山區,東中里,63,1185,351,137,488,22,510
公投第１１案,臺南市,東山區,東中里,64,1303,319,165,484,50,534
公投第１１案,臺南市,東山區,東正里,65,732,183,86,269,28,297
公投第１１案,臺南市,東山區,東正里,66,721,180,77,257,29,286
公投第１１案,臺南市,東山區,大客里,67,1104,229,134,363,46,409
公投第１１案,臺南市,東山區,三榮里,68,943,277,104,381,24,405
公投第１１案,臺南市,東山區,科里里,69,653,127,45,172,1,173
公投第１１案,臺南市,東山區,科里里,70,596,181,76,257,39,296
公投第１１案,臺南市,東山區,東河里,71,878,239,119,358,41,399
公投第１１案,臺南市,東山區,聖賢里,72,771,197,93,290,36,326
公投第１１案,臺南市,東山區,聖賢里,73,483,123,69,192,20,212
公投第１１案,臺南市,東山區,聖賢里,74,640,196,92,288,34,322
公投第１１案,臺南市,東山區,南溪里,75,425,70,29,99,7,106
公投第１１案,臺南市,東山區,水雲里,76,394,109,31,140,11,151
公投第１１案,臺南市,東山區,林安里,77,373,127,46,173,19,192
公投第１１案,臺南市,東山區,東原里,78,1257,358,98,456,36,492
公投第１１案,臺南市,東山區,東原里,79,887,194,68,262,9,271
公投第１１案,臺南市,東山區,嶺南里,80,658,142,49,191,12,203
公投第１１案,臺南市,東山區,南勢里,81,1101,229,91,320,24,344
公投第１１案,臺南市,東山區,青山里,82,1057,231,89,320,15,335
公投第１１案,臺南市,東山區,高原里,83,639,204,76,280,30,310
公投第１１案,臺南市,東山區,高原里,84,270,75,33,108,9,117
公投第１１案,臺南市,鹽水區,水秀里,85,1037,371,138,509,55,564
公投第１１案,臺南市,鹽水區,水秀里,86,480,161,82,243,14,257
公投第１１案,臺南市,鹽水區,津城里,87,636,239,118,357,24,381
公投第１１案,臺南市,鹽水區,津城里,88,321,121,54,175,6,181
公投第１１案,臺南市,鹽水區,津城里,89,497,199,83,282,16,298
公投第１１案,臺南市,鹽水區,月港里,90,759,286,148,434,12,446
公投第１１案,臺南市,鹽水區,月港里,91,341,110,46,156,11,167
公投第１１案,臺南市,鹽水區,月港里,92,507,180,87,267,15,282
公投第１１案,臺南市,鹽水區,橋南里,93,863,263,119,382,17,399
公投第１１案,臺南市,鹽水區,橋南里,94,1373,430,201,631,26,657
公投第１１案,臺南市,鹽水區,橋南里,95,1507,469,222,691,59,750
公投第１１案,臺南市,鹽水區,岸內里,96,1374,460,218,678,53,731
公投第１１案,臺南市,鹽水區,岸內里,97,1244,374,189,563,37,600
公投第１１案,臺南市,鹽水區,岸內里,98,1022,396,128,524,15,539
公投第１１案,臺南市,鹽水區,汫水里,99,921,212,105,317,41,358
公投第１１案,臺南市,鹽水區,義中里,100,847,272,155,427,32,459
公投第１１案,臺南市,鹽水區,義中里,101,736,159,81,240,13,253
公投第１１案,臺南市,鹽水區,三明里,102,761,254,122,376,20,396
公投第１１案,臺南市,鹽水區,三明里,103,285,88,41,129,13,142
公投第１１案,臺南市,鹽水區,三明里,104,493,129,68,197,30,227
公投第１１案,臺南市,鹽水區,文昌里,105,621,169,70,239,15,254
公投第１１案,臺南市,鹽水區,文昌里,106,392,104,37,141,12,153
公投第１１案,臺南市,鹽水區,歡雅里,107,925,288,133,421,27,448
公投第１１案,臺南市,鹽水區,歡雅里,108,728,203,90,293,36,329
公投第１１案,臺南市,鹽水區,三和里,109,214,50,22,72,13,85
公投第１１案,臺南市,鹽水區,三和里,110,387,132,41,173,6,179
公投第１１案,臺南市,鹽水區,三和里,111,301,96,47,143,14,157
公投第１１案,臺南市,鹽水區,竹林里,112,755,174,103,277,33,310
公投第１１案,臺南市,鹽水區,竹林里,113,365,103,40,143,13,156
公投第１１案,臺南市,鹽水區,坔頭港里,114,935,271,142,413,35,448
公投第１１案,臺南市,鹽水區,坔頭港里,115,494,147,57,204,32,236
公投第１１案,臺南市,新營區,忠政里,116,1693,520,238,758,40,798
公投第１１案,臺南市,新營區,忠政里,117,1561,553,262,815,58,873
公投第１１案,臺南市,新營區,忠政里,118,1487,536,231,767,42,809
公投第１１案,臺南市,新營區,民權里,119,1232,451,180,631,25,656
公投第１１案,臺南市,新營區,民權里,120,1067,351,172,523,29,552
公投第１１案,臺南市,新營區,三仙里,121,1419,436,212,648,33,681
公投第１１案,臺南市,新營區,三仙里,122,1466,555,239,794,30,824
公投第１１案,臺南市,新營區,永平里,123,932,335,185,520,52,572
公投第１１案,臺南市,新營區,永平里,124,1099,358,162,520,25,545
公投第１１案,臺南市,新營區,永平里,125,757,254,98,352,23,375
公投第１１案,臺南市,新營區,大宏里,126,888,323,168,491,24,515
公投第１１案,臺南市,新營區,大宏里,127,1115,371,194,565,20,585
公投第１１案,臺南市,新營區,大宏里,128,937,316,134,450,16,466
公投第１１案,臺南市,新營區,王公里,129,1387,530,123,653,40,693
公投第１１案,臺南市,新營區,王公里,130,1526,505,214,719,46,765
公投第１１案,臺南市,新營區,王公里,131,1301,473,234,707,28,735
公投第１１案,臺南市,新營區,新東里,132,1538,569,267,836,35,871
公投第１１案,臺南市,新營區,新東里,133,1584,574,268,842,18,860
公投第１１案,臺南市,新營區,新東里,134,1583,547,314,861,32,893
公投第１１案,臺南市,新營區,新東里,135,1530,521,299,820,21,841
公投第１１案,臺南市,新營區,中營里,136,1193,439,234,673,33,706
公投第１１案,臺南市,新營區,土庫里,137,1439,355,205,560,22,582
公投第１１案,臺南市,新營區,興業里,138,1438,538,234,772,37,809
公投第１１案,臺南市,新營區,興業里,139,359,128,65,193,17,210
公投第１１案,臺南市,新營區,南興里,140,1233,332,184,516,23,539
公投第１１案,臺南市,新營區,南興里,141,1227,367,143,510,24,534
公投第１１案,臺南市,新營區,民生里,142,1320,413,178,591,23,614
公投第１１案,臺南市,新營區,民生里,143,1930,529,284,813,31,844
公投第１１案,臺南市,新營區,新北里,144,1501,503,249,752,42,794
公投第１１案,臺南市,新營區,新北里,145,1475,465,228,693,33,726
公投第１１案,臺南市,新營區,新北里,146,1753,588,302,890,47,937
公投第１１案,臺南市,新營區,新南里,147,1748,550,287,837,34,871
公投第１１案,臺南市,新營區,新南里,148,1741,553,314,867,36,903
公投第１１案,臺南市,新營區,新南里,149,1433,436,252,688,23,711
公投第１１案,臺南市,新營區,民榮里,150,1595,533,257,790,44,834
公投第１１案,臺南市,新營區,民榮里,151,959,310,131,441,22,463
公投第１１案,臺南市,新營區,民榮里,152,1865,558,286,844,69,913
公投第１１案,臺南市,新營區,埤寮里,153,1678,473,241,714,74,788
公投第１１案,臺南市,新營區,護鎮里,154,1373,405,167,572,53,625
公投第１１案,臺南市,新營區,太南里,155,1431,353,199,552,26,578
公投第１１案,臺南市,新營區,太南里,156,291,70,41,111,5,116
公投第１１案,臺南市,新營區,太北里,157,1749,542,294,836,52,888
公投第１１案,臺南市,新營區,南紙里,158,1862,562,259,821,47,868
公投第１１案,臺南市,新營區,南紙里,159,1821,613,302,915,67,982
公投第１１案,臺南市,新營區,嘉芳里,160,1845,577,248,825,42,867
公投第１１案,臺南市,新營區,姑爺里,161,542,157,48,205,11,216
公投第１１案,臺南市,新營區,姑爺里,162,402,97,47,144,10,154
公投第１１案,臺南市,新營區,五興里,163,703,245,109,354,57,411
公投第１１案,臺南市,新營區,五興里,164,941,259,141,400,34,434
公投第１１案,臺南市,柳營區,士林里,165,1166,372,173,545,34,579
公投第１１案,臺南市,柳營區,士林里,166,625,235,104,339,12,351
公投第１１案,臺南市,柳營區,光福里,167,738,236,91,327,26,353
公投第１１案,臺南市,柳營區,光福里,168,834,351,137,488,12,500
公投第１１案,臺南市,柳營區,中埕里,169,1104,362,151,513,29,542
公投第１１案,臺南市,柳營區,東昇里,170,1015,333,134,467,18,485
公投第１１案,臺南市,柳營區,東昇里,171,1720,637,246,883,72,955
公投第１１案,臺南市,柳營區,八翁里,172,1391,404,198,602,62,664
公投第１１案,臺南市,柳營區,人和里,173,425,137,65,202,5,207
公投第１１案,臺南市,柳營區,人和里,174,318,89,36,125,11,136
公投第１１案,臺南市,柳營區,太康里,175,753,225,118,343,32,375
公投第１１案,臺南市,柳營區,太康里,176,730,216,89,305,39,344
公投第１１案,臺南市,柳營區,重溪里,177,725,242,99,341,28,369
公投第１１案,臺南市,柳營區,重溪里,178,787,277,125,402,24,426
公投第１１案,臺南市,柳營區,重溪里,179,297,105,50,155,17,172
公投第１１案,臺南市,柳營區,篤農里,180,673,239,100,339,37,376
公投第１１案,臺南市,柳營區,篤農里,181,640,226,98,324,43,367
公投第１１案,臺南市,柳營區,大農里,182,660,156,103,259,30,289
公投第１１案,臺南市,柳營區,神農里,183,1212,377,134,511,47,558
公投第１１案,臺南市,柳營區,神農里,184,202,60,21,81,9,90
公投第１１案,臺南市,柳營區,果毅里,185,1049,326,130,456,60,516
公投第１１案,臺南市,柳營區,果毅里,186,158,45,31,76,1,77
公投第１１案,臺南市,柳營區,旭山里,187,921,268,135,403,61,464
公投第１１案,臺南市,柳營區,旭山里,188,504,155,59,214,21,235
公投第１１案,臺南市,柳營區,旭山里,189,157,46,16,62,3,65
公投第１１案,臺南市,北門區,永隆里,190,484,156,80,236,8,244
公投第１１案,臺南市,北門區,永隆里,191,401,113,38,151,15,166
公投第１１案,臺南市,北門區,北門里,192,456,153,42,195,7,202
公投第１１案,臺南市,北門區,北門里,193,382,139,64,203,11,214
公投第１１案,臺南市,北門區,玉港里,194,356,122,51,173,12,185
公投第１１案,臺南市,北門區,玉港里,195,389,121,44,165,3,168
公投第１１案,臺南市,北門區,保吉里,196,742,247,68,315,10,325
公投第１１案,臺南市,北門區,保吉里,197,599,197,61,258,13,271
公投第１１案,臺南市,北門區,蚵寮里,198,594,167,58,225,25,250
公投第１１案,臺南市,北門區,蚵寮里,199,572,175,60,235,13,248
公投第１１案,臺南市,北門區,蚵寮里,200,318,68,37,105,5,110
公投第１１案,臺南市,北門區,雙春里,201,473,117,50,167,12,179
公投第１１案,臺南市,北門區,錦湖里,202,954,241,101,342,12,354
公投第１１案,臺南市,北門區,慈安里,203,737,260,109,369,33,402
公投第１１案,臺南市,北門區,三光里,204,679,148,77,225,11,236
公投第１１案,臺南市,北門區,三光里,205,521,124,58,182,24,206
公投第１１案,臺南市,北門區,文山里,206,632,166,54,220,22,242
公投第１１案,臺南市,北門區,文山里,207,636,163,84,247,9,256
公投第１１案,臺南市,學甲區,秀昌里,208,862,306,153,459,32,491
公投第１１案,臺南市,學甲區,秀昌里,209,611,234,112,346,9,355
公投第１１案,臺南市,學甲區,秀昌里,210,936,305,161,466,19,485
公投第１１案,臺南市,學甲區,明宜里,211,1066,328,166,494,28,522
公投第１１案,臺南市,學甲區,明宜里,212,869,306,164,470,16,486
公投第１１案,臺南市,學甲區,慈福里,213,635,218,96,314,26,340
公投第１１案,臺南市,學甲區,慈福里,214,822,261,116,377,9,386
公投第１１案,臺南市,學甲區,慈福里,215,443,143,44,187,11,198
公投第１１案,臺南市,學甲區,仁得里,216,1370,475,199,674,35,709
公投第１１案,臺南市,學甲區,仁得里,217,1117,405,172,577,37,614
公投第１１案,臺南市,學甲區,仁得里,218,1365,439,196,635,51,686
公投第１１案,臺南市,學甲區,新達里,219,1489,474,196,670,47,717
公投第１１案,臺南市,學甲區,新達里,220,627,170,70,240,30,270
公投第１１案,臺南市,學甲區,新榮里,221,1052,343,172,515,19,534
公投第１１案,臺南市,學甲區,新榮里,222,1183,404,160,564,16,580
公投第１１案,臺南市,學甲區,大灣里,223,979,294,119,413,14,427
公投第１１案,臺南市,學甲區,豐和里,224,1241,327,173,500,59,559
公投第１１案,臺南市,學甲區,中洲里,225,843,236,84,320,20,340
公投第１１案,臺南市,學甲區,中洲里,226,580,195,62,257,28,285
公投第１１案,臺南市,學甲區,光華里,227,832,227,88,315,17,332
公投第１１案,臺南市,學甲區,光華里,228,406,101,48,149,5,154
公投第１１案,臺南市,學甲區,宅港里,229,818,284,120,404,25,429
公投第１１案,臺南市,學甲區,平和里,230,1052,273,131,404,14,418
公投第１１案,臺南市,學甲區,三慶里,231,578,157,88,245,10,255
公投第１１案,臺南市,學甲區,三慶里,232,430,122,48,170,12,182
公投第１１案,臺南市,學甲區,三慶里,233,361,130,36,166,11,177
公投第１１案,臺南市,將軍區,長榮里,234,1110,423,187,610,41,651
公投第１１案,臺南市,將軍區,西甲里,235,1418,474,205,679,28,707
公投第１１案,臺南市,將軍區,西甲里,236,969,341,128,469,27,496
公投第１１案,臺南市,將軍區,忠嘉里,237,519,199,89,288,29,317
公投第１１案,臺南市,將軍區,忠嘉里,238,1106,384,161,545,13,558
公投第１１案,臺南市,將軍區,忠嘉里,239,542,168,83,251,23,274
公投第１１案,臺南市,將軍區,忠嘉里,240,315,97,33,130,5,135
公投第１１案,臺南市,將軍區,苓仔寮里,241,584,188,78,266,15,281
公投第１１案,臺南市,將軍區,苓仔寮里,242,398,120,58,178,9,187
公投第１１案,臺南市,將軍區,苓仔寮里,243,608,167,78,245,22,267
公投第１１案,臺南市,將軍區,苓仔寮里,244,442,144,69,213,17,230
公投第１１案,臺南市,將軍區,巷埔里,245,650,185,70,255,10,265
公投第１１案,臺南市,將軍區,巷埔里,246,573,166,46,212,14,226
公投第１１案,臺南市,將軍區,將軍里,247,617,202,66,268,10,278
公投第１１案,臺南市,將軍區,將軍里,248,573,206,66,272,23,295
公投第１１案,臺南市,將軍區,將軍里,249,434,157,49,206,17,223
公投第１１案,臺南市,將軍區,玉山里,250,849,261,92,353,17,370
公投第１１案,臺南市,將軍區,廣山里,251,645,180,70,250,18,268
公投第１１案,臺南市,將軍區,長沙里,252,690,228,60,288,25,313
公投第１１案,臺南市,將軍區,長沙里,253,663,185,43,228,17,245
公投第１１案,臺南市,將軍區,平沙里,254,1175,411,126,537,22,559
公投第１１案,臺南市,將軍區,鯤鯓里,255,837,235,82,317,26,343
公投第１１案,臺南市,將軍區,鯤鯓里,256,1061,350,147,497,60,557
公投第１１案,臺南市,將軍區,鯤溟里,257,976,311,93,404,17,421
公投第１１案,臺南市,七股區,後港里,258,534,168,82,250,10,260
公投第１１案,臺南市,七股區,後港里,259,508,208,80,288,9,297
公投第１１案,臺南市,七股區,大潭里,260,665,186,80,266,3,269
公投第１１案,臺南市,七股區,篤加里,261,834,273,97,370,18,388
公投第１１案,臺南市,七股區,頂山里,262,810,311,75,386,16,402
公投第１１案,臺南市,七股區,西寮里,263,480,164,33,197,8,205
公投第１１案,臺南市,七股區,塩埕里,264,445,133,37,170,15,185
公投第１１案,臺南市,七股區,中寮里,265,680,153,55,208,10,218
公投第１１案,臺南市,七股區,龍山里,266,838,270,85,355,20,375
公投第１１案,臺南市,七股區,龍山里,267,780,254,74,328,18,346
公投第１１案,臺南市,七股區,溪南里,268,350,130,62,192,8,200
公投第１１案,臺南市,七股區,七股里,269,907,334,152,486,46,532
公投第１１案,臺南市,七股區,玉成里,270,780,258,80,338,18,356
公投第１１案,臺南市,七股區,大埕里,271,1658,491,218,709,55,764
公投第１１案,臺南市,七股區,大埕里,272,913,352,104,456,18,474
公投第１１案,臺南市,七股區,樹林里,273,1202,368,176,544,57,601
公投第１１案,臺南市,七股區,樹林里,274,696,189,82,271,12,283
公投第１１案,臺南市,七股區,竹橋里,275,647,211,102,313,23,336
公投第１１案,臺南市,七股區,竹橋里,276,622,265,96,361,27,388
公投第１１案,臺南市,七股區,義合里,277,1175,482,158,640,46,686
公投第１１案,臺南市,七股區,義合里,278,698,193,121,314,19,333
公投第１１案,臺南市,七股區,永吉里,279,983,354,123,477,38,515
公投第１１案,臺南市,七股區,三股里,280,1366,454,150,604,32,636
公投第１１案,臺南市,七股區,十份里,281,1379,391,183,574,39,613
公投第１１案,臺南市,佳里區,東寧里,282,1391,499,231,730,52,782
公投第１１案,臺南市,佳里區,東寧里,283,829,309,158,467,28,495
公投第１１案,臺南市,佳里區,忠仁里,284,1401,462,188,650,38,688
公投第１１案,臺南市,佳里區,忠仁里,285,1452,451,197,648,17,665
公投第１１案,臺南市,佳里區,鎮山里,286,1382,498,184,682,39,721
公投第１１案,臺南市,佳里區,鎮山里,287,1463,505,221,726,53,779
公投第１１案,臺南市,佳里區,鎮山里,288,1280,431,169,600,45,645
公投第１１案,臺南市,佳里區,鎮山里,289,1486,509,244,753,60,813
公投第１１案,臺南市,佳里區,安西里,290,1378,475,252,727,43,770
公投第１１案,臺南市,佳里區,安西里,291,1505,552,237,789,50,839
公投第１１案,臺南市,佳里區,安西里,292,1860,652,262,914,56,970
公投第１１案,臺南市,佳里區,安西里,293,1134,402,180,582,51,633
公投第１１案,臺南市,佳里區,文新里,294,1426,492,241,733,31,764
公投第１１案,臺南市,佳里區,文新里,295,1779,600,306,906,37,943
公投第１１案,臺南市,佳里區,文新里,296,1906,665,317,982,42,1024
公投第１１案,臺南市,佳里區,建南里,297,1425,459,232,691,33,724
公投第１１案,臺南市,佳里區,建南里,298,1255,433,194,627,32,659
公投第１１案,臺南市,佳里區,建南里,299,1524,480,222,702,58,760
公投第１１案,臺南市,佳里區,南勢里,300,1631,524,285,809,30,839
公投第１１案,臺南市,佳里區,南勢里,301,1546,600,235,835,36,871
公投第１１案,臺南市,佳里區,南勢里,302,1187,472,201,673,39,712
公投第１１案,臺南市,佳里區,六安里,303,1381,464,233,697,41,738
公投第１１案,臺南市,佳里區,六安里,304,1364,451,207,658,31,689
公投第１１案,臺南市,佳里區,六安里,305,1314,481,209,690,16,706
公投第１１案,臺南市,佳里區,佳化里,306,1164,428,189,617,36,653
公投第１１案,臺南市,佳里區,佳化里,307,961,344,137,481,37,518
公投第１１案,臺南市,佳里區,佳興里,308,1218,417,179,596,45,641
公投第１１案,臺南市,佳里區,佳興里,309,919,341,148,489,26,515
公投第１１案,臺南市,佳里區,營溪里,310,689,230,102,332,28,360
公投第１１案,臺南市,佳里區,營溪里,311,383,113,60,173,13,186
公投第１１案,臺南市,佳里區,海澄里,312,1507,497,182,679,46,725
公投第１１案,臺南市,佳里區,海澄里,313,702,224,94,318,28,346
公投第１１案,臺南市,佳里區,下營里,314,907,354,120,474,32,506
公投第１１案,臺南市,佳里區,下營里,315,937,473,156,629,37,666
公投第１１案,臺南市,佳里區,塭內里,316,1030,328,171,499,56,555
公投第１１案,臺南市,佳里區,塭內里,317,981,326,150,476,40,516
公投第１１案,臺南市,佳里區,塭內里,318,787,274,96,370,22,392
公投第１１案,臺南市,佳里區,民安里,319,1513,548,179,727,54,781
公投第１１案,臺南市,佳里區,子龍里,320,714,223,91,314,17,331
公投第１１案,臺南市,佳里區,子龍里,321,745,214,117,331,42,373
公投第１１案,臺南市,佳里區,子龍里,322,951,276,152,428,32,460
公投第１１案,臺南市,西港區,西港里,323,933,327,136,463,11,474
公投第１１案,臺南市,西港區,西港里,324,901,276,175,451,24,475
公投第１１案,臺南市,西港區,西港里,325,1314,418,187,605,27,632
公投第１１案,臺南市,西港區,慶安里,326,1349,436,207,643,49,692
公投第１１案,臺南市,西港區,慶安里,327,1014,381,155,536,31,567
公投第１１案,臺南市,西港區,慶安里,328,1900,507,244,751,25,776
公投第１１案,臺南市,西港區,南海里,329,1663,462,248,710,45,755
公投第１１案,臺南市,西港區,南海里,330,738,210,101,311,13,324
公投第１１案,臺南市,西港區,港東里,331,1211,410,201,611,42,653
公投第１１案,臺南市,西港區,港東里,332,382,113,61,174,17,191
公投第１１案,臺南市,西港區,檨林里,333,786,252,112,364,24,388
公投第１１案,臺南市,西港區,檨林里,334,838,277,115,392,10,402
公投第１１案,臺南市,西港區,後營里,335,1449,380,206,586,37,623
公投第１１案,臺南市,西港區,營西里,336,1479,393,196,589,36,625
公投第１１案,臺南市,西港區,金砂里,337,763,289,103,392,40,432
公投第１１案,臺南市,西港區,劉厝里,338,1297,380,177,557,22,579
公投第１１案,臺南市,西港區,竹林里,339,1393,438,210,648,31,679
公投第１１案,臺南市,西港區,永樂里,340,958,267,121,388,16,404
公投第１１案,臺南市,西港區,永樂里,341,391,137,66,203,18,221
公投第１１案,臺南市,西港區,新復里,342,805,272,117,389,34,423
公投第１１案,臺南市,下營區,下營里,343,1558,493,177,670,38,708
公投第１１案,臺南市,下營區,仁里里,344,1112,290,156,446,27,473
公投第１１案,臺南市,下營區,仁里里,345,893,266,112,378,50,428
公投第１１案,臺南市,下營區,宅內里,346,1623,499,180,679,39,718
公投第１１案,臺南市,下營區,後街里,347,1568,499,227,726,63,789
公投第１１案,臺南市,下營區,新興里,348,985,366,124,490,20,510
公投第１１案,臺南市,下營區,新興里,349,953,311,123,434,12,446
公投第１１案,臺南市,下營區,營前里,350,1031,345,143,488,17,505
公投第１１案,臺南市,下營區,營前里,351,1077,398,172,570,37,607
公投第１１案,臺南市,下營區,大吉里,352,703,173,93,266,30,296
公投第１１案,臺南市,下營區,大吉里,353,854,250,106,356,18,374
公投第１１案,臺南市,下營區,茅營里,354,1164,380,168,548,53,601
公投第１１案,臺南市,下營區,茅營里,355,1091,329,143,472,23,495
公投第１１案,臺南市,下營區,開化里,356,959,324,131,455,36,491
公投第１１案,臺南市,下營區,開化里,357,935,293,137,430,19,449
公投第１１案,臺南市,下營區,西連里,358,893,303,132,435,33,468
公投第１１案,臺南市,下營區,賀建里,359,1293,465,157,622,66,688
公投第１１案,臺南市,下營區,紅甲里,360,1185,362,181,543,83,626
公投第１１案,臺南市,下營區,紅甲里,361,1070,292,115,407,19,426
公投第１１案,臺南市,六甲區,六甲里,362,819,289,143,432,38,470
公投第１１案,臺南市,六甲區,六甲里,363,645,222,100,322,14,336
公投第１１案,臺南市,六甲區,六甲里,364,1444,406,240,646,33,679
公投第１１案,臺南市,六甲區,甲東里,365,1554,407,223,630,50,680
公投第１１案,臺南市,六甲區,甲東里,366,1171,308,186,494,38,532
公投第１１案,臺南市,六甲區,甲南里,367,1351,396,210,606,48,654
公投第１１案,臺南市,六甲區,七甲里,368,1010,275,137,412,57,469
公投第１１案,臺南市,六甲區,七甲里,369,919,251,144,395,47,442
公投第１１案,臺南市,六甲區,二甲里,370,1369,399,214,613,54,667
公投第１１案,臺南市,六甲區,二甲里,371,976,317,161,478,39,517
公投第１１案,臺南市,六甲區,二甲里,372,1015,337,64,401,51,452
公投第１１案,臺南市,六甲區,水林里,373,1176,342,168,510,34,544
公投第１１案,臺南市,六甲區,水林里,374,939,307,142,449,38,487
公投第１１案,臺南市,六甲區,中社里,375,712,227,116,343,32,375
公投第１１案,臺南市,六甲區,中社里,376,881,287,150,437,27,464
公投第１１案,臺南市,六甲區,龜港里,377,1184,421,216,637,57,694
公投第１１案,臺南市,六甲區,菁埔里,378,599,252,93,345,22,367
公投第１１案,臺南市,六甲區,王爺里,379,759,165,66,231,8,239
公投第１１案,臺南市,六甲區,大丘里,380,621,151,77,228,23,251
公投第１１案,臺南市,麻豆區,新興里,381,1205,416,175,591,43,634
公投第１１案,臺南市,麻豆區,新興里,382,660,217,134,351,19,370
公投第１１案,臺南市,麻豆區,巷口里,383,523,190,89,279,16,295
公投第１１案,臺南市,麻豆區,巷口里,384,1597,488,296,784,23,807
公投第１１案,臺南市,麻豆區,東角里,385,1262,429,232,661,41,702
公投第１１案,臺南市,麻豆區,東角里,386,1325,466,262,728,32,760
公投第１１案,臺南市,麻豆區,晋江里,387,1384,427,254,681,26,707
公投第１１案,臺南市,麻豆區,晋江里,388,1121,380,204,584,19,603
公投第１１案,臺南市,麻豆區,中興里,389,1021,325,170,495,8,503
公投第１１案,臺南市,麻豆區,中興里,390,954,306,153,459,18,477
公投第１１案,臺南市,麻豆區,興農里,391,1513,450,224,674,25,699
公投第１１案,臺南市,麻豆區,油車里,392,1726,499,252,751,37,788
公投第１１案,臺南市,麻豆區,油車里,393,1804,593,284,877,35,912
公投第１１案,臺南市,麻豆區,北勢里,394,1106,351,166,517,26,543
公投第１１案,臺南市,麻豆區,大埕里,395,1503,488,269,757,33,790
公投第１１案,臺南市,麻豆區,大埕里,396,1302,417,197,614,48,662
公投第１１案,臺南市,麻豆區,清水里,397,645,201,109,310,14,324
公投第１１案,臺南市,麻豆區,清水里,398,777,291,118,409,29,438
公投第１１案,臺南市,麻豆區,南勢里,399,1612,502,241,743,40,783
公投第１１案,臺南市,麻豆區,南勢里,400,718,217,103,320,17,337
公投第１１案,臺南市,麻豆區,寮廍里,401,1656,511,216,727,23,750
公投第１１案,臺南市,麻豆區,埤頭里,402,1355,398,226,624,47,671
公投第１１案,臺南市,麻豆區,埤頭里,403,977,257,136,393,19,412
公投第１１案,臺南市,麻豆區,海埔里,404,1012,297,157,454,26,480
公投第１１案,臺南市,麻豆區,海埔里,405,626,205,127,332,18,350
公投第１１案,臺南市,麻豆區,海埔里,406,467,105,48,153,6,159
公投第１１案,臺南市,麻豆區,港尾里,407,1260,396,175,571,24,595
公投第１１案,臺南市,麻豆區,麻口里,408,1111,393,160,553,46,599
公投第１１案,臺南市,麻豆區,安業里,409,550,162,117,279,19,298
公投第１１案,臺南市,麻豆區,安業里,410,798,246,133,379,46,425
公投第１１案,臺南市,麻豆區,謝厝寮里,411,852,304,141,445,63,508
公投第１１案,臺南市,麻豆區,謝厝寮里,412,830,226,118,344,9,353
公投第１１案,臺南市,麻豆區,安正里,413,941,246,144,390,22,412
公投第１１案,臺南市,麻豆區,井東里,414,1158,411,197,608,22,630
公投第１１案,臺南市,麻豆區,井東里,415,612,196,87,283,9,292
公投第１１案,臺南市,官田區,官田里,416,1104,361,144,505,13,518
公投第１１案,臺南市,官田區,官田里,417,965,292,144,436,37,473
公投第１１案,臺南市,官田區,二鎮里,418,1402,472,217,689,32,721
公投第１１案,臺南市,官田區,二鎮里,419,1653,558,211,769,141,910
公投第１１案,臺南市,官田區,烏山頭里,420,966,266,151,417,36,453
公投第１１案,臺南市,官田區,烏山頭里,421,284,81,35,116,10,126
公投第１１案,臺南市,官田區,大崎里,422,402,80,48,128,5,133
公投第１１案,臺南市,官田區,隆田里,423,982,336,157,493,17,510
公投第１１案,臺南市,官田區,隆田里,424,975,298,124,422,28,450
公投第１１案,臺南市,官田區,隆本里,425,802,242,134,376,23,399
公投第１１案,臺南市,官田區,隆本里,426,1118,409,183,592,28,620
公投第１１案,臺南市,官田區,隆本里,427,1455,460,253,713,26,739
公投第１１案,臺南市,官田區,南廍里,428,1208,399,183,582,29,611
公投第１１案,臺南市,官田區,東西庄里,429,1293,396,187,583,65,648
公投第１１案,臺南市,官田區,東西庄里,430,607,160,83,243,20,263
公投第１１案,臺南市,官田區,渡拔里,431,501,162,72,234,14,248
公投第１１案,臺南市,官田區,渡拔里,432,728,239,129,368,40,408
公投第１１案,臺南市,官田區,渡拔里,433,842,282,143,425,15,440
公投第１１案,臺南市,官田區,渡拔里,434,515,166,81,247,32,279
公投第１１案,臺南市,官田區,社子里,435,873,255,107,362,21,383
公投第１１案,臺南市,大內區,石湖里,436,759,230,79,309,26,335
公投第１１案,臺南市,大內區,石湖里,437,262,64,21,85,4,89
公投第１１案,臺南市,大內區,石林里,438,646,171,80,251,12,263
公投第１１案,臺南市,大內區,石城里,439,1473,404,174,578,35,613
公投第１１案,臺南市,大內區,內江里,440,915,345,104,449,52,501
公投第１１案,臺南市,大內區,大內里,441,779,266,133,399,41,440
公投第１１案,臺南市,大內區,內郭里,442,637,213,135,348,45,393
公投第１１案,臺南市,大內區,頭社里,443,993,320,141,461,22,483
公投第１１案,臺南市,大內區,環湖里,444,766,302,85,387,30,417
公投第１１案,臺南市,大內區,二溪里,445,841,308,97,405,38,443
公投第１１案,臺南市,大內區,曲溪里,446,583,201,62,263,29,292
公投第１１案,臺南市,楠西區,楠西里,447,978,317,119,436,40,476
公投第１１案,臺南市,楠西區,楠西里,448,870,313,123,436,39,475
公投第１１案,臺南市,楠西區,灣丘里,449,1160,287,109,396,13,409
公投第１１案,臺南市,楠西區,密枝里,450,699,217,76,293,19,312
公投第１１案,臺南市,楠西區,照興里,451,990,288,97,385,11,396
公投第１１案,臺南市,楠西區,鹿田里,452,928,299,102,401,23,424
公投第１１案,臺南市,楠西區,龜丹里,453,660,243,72,315,26,341
公投第１１案,臺南市,楠西區,東勢里,454,1187,365,158,523,62,585
公投第１１案,臺南市,楠西區,東勢里,455,1056,322,142,464,32,496
公投第１１案,臺南市,南化區,南化里,456,690,228,107,335,37,372
公投第１１案,臺南市,南化區,南化里,457,695,226,126,352,35,387
公投第１１案,臺南市,南化區,小崙里,458,806,223,105,328,35,363
公投第１１案,臺南市,南化區,東和里,459,654,173,64,237,35,272
公投第１１案,臺南市,南化區,西埔里,460,783,178,76,254,31,285
公投第１１案,臺南市,南化區,中坑里,461,425,145,51,196,12,208
公投第１１案,臺南市,南化區,北平里,462,559,186,68,254,22,276
公投第１１案,臺南市,南化區,北寮里,463,1189,357,154,511,21,532
公投第１１案,臺南市,南化區,玉山里,464,1044,379,147,526,24,550
公投第１１案,臺南市,南化區,關山里,465,941,341,122,463,26,489
公投第１１案,臺南市,玉井區,玉井里,466,1242,425,165,590,27,617
公投第１１案,臺南市,玉井區,玉田里,467,1141,427,157,584,26,610
公投第１１案,臺南市,玉井區,玉田里,468,698,235,98,333,16,349
公投第１１案,臺南市,玉井區,玉田里,469,849,285,128,413,23,436
公投第１１案,臺南市,玉井區,玉田里,470,949,351,131,482,30,512
公投第１１案,臺南市,玉井區,中正里,471,618,198,89,287,31,318
公投第１１案,臺南市,玉井區,中正里,472,594,197,60,257,8,265
公投第１１案,臺南市,玉井區,竹圍里,473,927,271,110,381,22,403
公投第１１案,臺南市,玉井區,竹圍里,474,512,177,69,246,28,274
公投第１１案,臺南市,玉井區,沙田里,475,509,165,55,220,25,245
公投第１１案,臺南市,玉井區,三埔里,476,496,204,60,264,20,284
公投第１１案,臺南市,玉井區,三和里,477,759,256,94,350,16,366
公投第１１案,臺南市,玉井區,望明里,478,669,188,72,260,9,269
公投第１１案,臺南市,玉井區,望明里,479,787,257,87,344,39,383
公投第１１案,臺南市,玉井區,層林里,480,620,215,67,282,22,304
公投第１１案,臺南市,玉井區,豐里里,481,987,426,32,458,46,504
公投第１１案,臺南市,左鎮區,光和里,482,392,127,48,175,17,192
公投第１１案,臺南市,左鎮區,榮和里,483,644,256,65,321,24,345
公投第１１案,臺南市,左鎮區,左鎮里,484,468,133,58,191,8,199
公投第１１案,臺南市,左鎮區,中正里,485,753,230,91,321,15,336
公投第１１案,臺南市,左鎮區,睦光里,486,345,107,42,149,13,162
公投第１１案,臺南市,左鎮區,內庄里,487,393,117,45,162,12,174
公投第１１案,臺南市,左鎮區,岡林里,488,420,168,41,209,17,226
公投第１１案,臺南市,左鎮區,草山里,489,313,87,34,121,11,132
公投第１１案,臺南市,左鎮區,二寮里,490,186,59,15,74,3,77
公投第１１案,臺南市,左鎮區,澄山里,491,504,145,53,198,33,231
公投第１１案,臺南市,善化區,東關里,492,1132,356,175,531,10,541
公投第１１案,臺南市,善化區,坐駕里,493,1845,597,287,884,39,923
公投第１１案,臺南市,善化區,坐駕里,494,2090,680,334,1014,40,1054
公投第１１案,臺南市,善化區,光文里,495,1582,574,263,837,42,879
公投第１１案,臺南市,善化區,光文里,496,1901,655,363,1018,40,1058
公投第１１案,臺南市,善化區,光文里,497,1818,608,312,920,39,959
公投第１１案,臺南市,善化區,文昌里,498,1639,564,251,815,41,856
公投第１１案,臺南市,善化區,文昌里,499,1061,363,204,567,30,597
公投第１１案,臺南市,善化區,南關里,500,1786,669,287,956,56,1012
公投第１１案,臺南市,善化區,頂街里,501,1147,443,161,604,28,632
公投第１１案,臺南市,善化區,文正里,502,1581,515,241,756,34,790
公投第１１案,臺南市,善化區,胡家里,503,1240,411,215,626,41,667
公投第１１案,臺南市,善化區,胡厝里,504,1743,571,234,805,23,828
公投第１１案,臺南市,善化區,什乃里,505,1246,448,248,696,24,720
公投第１１案,臺南市,善化區,溪美里,506,961,310,169,479,21,500
公投第１１案,臺南市,善化區,溪美里,507,938,304,141,445,9,454
公投第１１案,臺南市,善化區,六分里,508,722,266,121,387,18,405
公投第１１案,臺南市,善化區,六德里,509,1062,365,146,511,27,538
公投第１１案,臺南市,善化區,田寮里,510,1715,584,251,835,56,891
公投第１１案,臺南市,善化區,昌隆里,511,1120,360,156,516,42,558
公投第１１案,臺南市,善化區,昌隆里,512,865,288,131,419,21,440
公投第１１案,臺南市,善化區,牛庄里,513,1574,481,294,775,46,821
公投第１１案,臺南市,善化區,嘉北里,514,1535,436,221,657,42,699
公投第１１案,臺南市,善化區,嘉南里,515,1106,362,181,543,47,590
公投第１１案,臺南市,善化區,小新里,516,1402,482,207,689,34,723
公投第１１案,臺南市,善化區,小新里,517,1458,570,260,830,46,876
公投第１１案,臺南市,善化區,小新里,518,1380,393,230,623,25,648
公投第１１案,臺南市,善化區,蓮潭里,519,1232,387,251,638,5,643
公投第１１案,臺南市,善化區,蓮潭里,520,1069,341,235,576,7,583
公投第１１案,臺南市,安定區,蘇林里,521,1251,536,197,733,46,779
公投第１１案,臺南市,安定區,蘇林里,522,899,331,142,473,37,510
公投第１１案,臺南市,安定區,蘇厝里,523,1106,406,166,572,40,612
公投第１１案,臺南市,安定區,蘇厝里,524,948,380,128,508,26,534
公投第１１案,臺南市,安定區,安定里,525,1442,463,221,684,33,717
公投第１１案,臺南市,安定區,安加里,526,1385,494,196,690,41,731
公投第１１案,臺南市,安定區,安加里,527,801,335,100,435,24,459
公投第１１案,臺南市,安定區,港尾里,528,736,212,113,325,20,345
公投第１１案,臺南市,安定區,港尾里,529,781,271,118,389,19,408
公投第１１案,臺南市,安定區,中榮里,530,795,288,135,423,17,440
公投第１１案,臺南市,安定區,中榮里,531,862,335,141,476,35,511
公投第１１案,臺南市,安定區,港口里,532,1487,508,200,708,26,734
公投第１１案,臺南市,安定區,港口里,533,1385,487,213,700,32,732
公投第１１案,臺南市,安定區,港南里,534,1518,504,221,725,23,748
公投第１１案,臺南市,安定區,港南里,535,1094,429,179,608,35,643
公投第１１案,臺南市,安定區,嘉同里,536,1590,590,239,829,63,892
公投第１１案,臺南市,安定區,嘉同里,537,754,297,115,412,17,429
公投第１１案,臺南市,安定區,中沙里,538,716,252,131,383,26,409
公投第１１案,臺南市,安定區,新吉里,539,1492,517,266,783,33,816
公投第１１案,臺南市,安定區,新吉里,540,943,337,152,489,32,521
公投第１１案,臺南市,安定區,海寮里,541,1157,427,185,612,30,642
公投第１１案,臺南市,安定區,海寮里,542,1384,498,228,726,44,770
公投第１１案,臺南市,安定區,文科里,543,967,326,172,498,34,532
公投第１１案,臺南市,安定區,文科里,544,611,234,110,344,15,359
公投第１１案,臺南市,新市區,新市里,545,960,309,155,464,22,486
公投第１１案,臺南市,新市區,新市里,546,1118,424,207,631,28,659
公投第１１案,臺南市,新市區,新市里,547,850,271,136,407,10,417
公投第１１案,臺南市,新市區,新和里,548,1241,433,201,634,27,661
公投第１１案,臺南市,新市區,新和里,549,1297,470,210,680,24,704
公投第１１案,臺南市,新市區,新和里,550,962,368,156,524,22,546
公投第１１案,臺南市,新市區,新和里,551,1237,456,218,674,27,701
公投第１１案,臺南市,新市區,新和里,552,1326,450,238,688,31,719
公投第１１案,臺南市,新市區,社內里,553,1211,460,203,663,37,700
公投第１１案,臺南市,新市區,社內里,554,1305,437,208,645,25,670
公投第１１案,臺南市,新市區,大洲里,555,688,266,85,351,26,377
公投第１１案,臺南市,新市區,豐華里,556,911,341,154,495,21,516
公投第１１案,臺南市,新市區,三舍里,557,1525,475,239,714,27,741
公投第１１案,臺南市,新市區,大營里,558,1091,319,157,476,6,482
公投第１１案,臺南市,新市區,大營里,559,1122,387,171,558,10,568
公投第１１案,臺南市,新市區,大營里,560,1049,363,146,509,21,530
公投第１１案,臺南市,新市區,大社里,561,1564,488,242,730,14,744
公投第１１案,臺南市,新市區,大社里,562,1515,530,246,776,36,812
公投第１１案,臺南市,新市區,大社里,563,1378,502,217,719,19,738
公投第１１案,臺南市,新市區,潭頂里,564,827,333,151,484,33,517
公投第１１案,臺南市,新市區,潭頂里,565,960,411,158,569,48,617
公投第１１案,臺南市,新市區,港墘里,566,951,347,126,473,27,500
公投第１１案,臺南市,新市區,港墘里,567,1264,450,207,657,39,696
公投第１１案,臺南市,新市區,港墘里,568,1173,395,219,614,23,637
公投第１１案,臺南市,新市區,永就里,569,684,252,136,388,10,398
公投第１１案,臺南市,新市區,永就里,570,1055,444,175,619,34,653
公投第１１案,臺南市,新市區,永就里,571,1122,443,223,666,26,692
公投第１１案,臺南市,山上區,明和里,572,855,219,108,327,39,366
公投第１１案,臺南市,山上區,明和里,573,836,221,96,317,22,339
公投第１１案,臺南市,山上區,南洲里,574,753,234,119,353,29,382
公投第１１案,臺南市,山上區,南洲里,575,788,261,96,357,21,378
公投第１１案,臺南市,山上區,山上里,576,984,319,153,472,25,497
公投第１１案,臺南市,山上區,新莊里,577,972,288,148,436,7,443
公投第１１案,臺南市,山上區,玉峯里,578,553,126,51,177,3,180
公投第１１案,臺南市,山上區,平陽里,579,378,108,49,157,7,164
公投第１１案,臺南市,山上區,豐德里,580,392,119,54,173,12,185
公投第１１案,臺南市,新化區,武安里,581,746,317,108,425,30,455
公投第１１案,臺南市,新化區,武安里,582,1102,413,206,619,35,654
公投第１１案,臺南市,新化區,武安里,583,370,152,59,211,8,219
公投第１１案,臺南市,新化區,武安里,584,947,355,180,535,32,567
公投第１１案,臺南市,新化區,東榮里,585,1154,430,155,585,29,614
公投第１１案,臺南市,新化區,東榮里,586,1082,351,210,561,46,607
公投第１１案,臺南市,新化區,東榮里,587,1075,408,171,579,32,611
公投第１１案,臺南市,新化區,東榮里,588,640,236,92,328,12,340
公投第１１案,臺南市,新化區,護國里,589,410,145,62,207,14,221
公投第１１案,臺南市,新化區,護國里,590,533,192,71,263,19,282
公投第１１案,臺南市,新化區,護國里,591,836,325,151,476,12,488
公投第１１案,臺南市,新化區,護國里,592,978,287,122,409,14,423
公投第１１案,臺南市,新化區,太平里,593,1348,473,259,732,35,767
公投第１１案,臺南市,新化區,太平里,594,1015,332,169,501,36,537
公投第１１案,臺南市,新化區,太平里,595,1228,410,165,575,23,598
公投第１１案,臺南市,新化區,太平里,596,789,288,137,425,31,456
公投第１１案,臺南市,新化區,協興里,597,1022,376,168,544,15,559
公投第１１案,臺南市,新化區,協興里,598,1021,396,129,525,17,542
公投第１１案,臺南市,新化區,協興里,599,1229,461,222,683,31,714
公投第１１案,臺南市,新化區,唪口里,600,1153,399,189,588,14,602
公投第１１案,臺南市,新化區,唪口里,601,1012,297,131,428,23,451
公投第１１案,臺南市,新化區,北勢里,602,1458,515,261,776,35,811
公投第１１案,臺南市,新化區,豐榮里,603,1645,632,265,897,29,926
公投第１１案,臺南市,新化區,豐榮里,604,1016,386,182,568,25,593
公投第１１案,臺南市,新化區,豐榮里,605,559,198,91,289,11,300
公投第１１案,臺南市,新化區,全興里,606,1222,456,200,656,23,679
公投第１１案,臺南市,新化區,全興里,607,1562,567,319,886,35,921
公投第１１案,臺南市,新化區,崙頂里,608,994,290,159,449,30,479
公投第１１案,臺南市,新化區,崙頂里,609,1013,369,137,506,61,567
公投第１１案,臺南市,新化區,知義里,610,1197,464,187,651,30,681
公投第１１案,臺南市,新化區,知義里,611,1021,352,130,482,36,518
公投第１１案,臺南市,新化區,山脚里,612,1428,467,161,628,26,654
公投第１１案,臺南市,新化區,大坑里,613,456,136,61,197,22,219
公投第１１案,臺南市,新化區,𦰡拔里,614,1037,401,162,563,32,595
公投第１１案,臺南市,新化區,𦰡拔里,615,1097,434,152,586,32,618
公投第１１案,臺南市,新化區,羊林里,616,902,335,139,474,29,503
公投第１１案,臺南市,新化區,礁坑里,617,999,322,134,456,60,516
公投第１１案,臺南市,安南區,東和里,618,2549,863,459,1322,33,1355
公投第１１案,臺南市,安南區,󻕯南里,619,2321,806,367,1173,49,1222
公投第１１案,臺南市,安南區,󻕯南里,620,2156,768,383,1151,43,1194
公投第１１案,臺南市,安南區,州南里,621,1662,640,280,920,55,975
公投第１１案,臺南市,安南區,州南里,622,1512,614,228,842,62,904
公投第１１案,臺南市,安南區,州南里,623,1625,552,232,784,42,826
公投第１１案,臺南市,安南區,安順里,624,2143,680,320,1000,39,1039
公投第１１案,臺南市,安南區,安順里,625,2457,863,412,1275,53,1328
公投第１１案,臺南市,安南區,州北里,626,2148,744,395,1139,64,1203
公投第１１案,臺南市,安南區,州北里,627,2364,766,403,1169,58,1227
公投第１１案,臺南市,安南區,新順里,628,1868,568,324,892,33,925
公投第１１案,臺南市,安南區,新順里,629,1797,670,340,1010,42,1052
公投第１１案,臺南市,安南區,新順里,630,2268,818,342,1160,52,1212
公投第１１案,臺南市,安南區,頂安里,631,2291,697,329,1026,41,1067
公投第１１案,臺南市,安南區,頂安里,632,2255,769,340,1109,39,1148
公投第１１案,臺南市,安南區,安慶里,633,1940,582,325,907,42,949
公投第１１案,臺南市,安南區,安慶里,634,2013,728,364,1092,33,1125
公投第１１案,臺南市,安南區,安慶里,635,2024,689,309,998,38,1036
公投第１１案,臺南市,安南區,溪北里,636,1613,599,342,941,49,990
公投第１１案,臺南市,安南區,溪北里,637,1178,408,185,593,33,626
公投第１１案,臺南市,安南區,安和里,638,2143,753,334,1087,65,1152
公投第１１案,臺南市,安南區,安西里,639,1721,575,341,916,51,967
公投第１１案,臺南市,安南區,安西里,640,1773,649,314,963,49,1012
公投第１１案,臺南市,安南區,溪頂里,641,1428,518,252,770,15,785
公投第１１案,臺南市,安南區,溪頂里,642,1626,578,281,859,34,893
公投第１１案,臺南市,安南區,溪頂里,643,1358,448,252,700,35,735
公投第１１案,臺南市,安南區,安東里,644,1447,567,260,827,27,854
公投第１１案,臺南市,安南區,安東里,645,1358,464,241,705,69,774
公投第１１案,臺南市,安南區,鳳凰里,646,2116,698,324,1022,43,1065
公投第１１案,臺南市,安南區,鳳凰里,647,2321,758,349,1107,33,1140
公投第１１案,臺南市,安南區,梅花里,648,2117,721,322,1043,35,1078
公投第１１案,臺南市,安南區,梅花里,649,1927,589,310,899,64,963
公投第１１案,臺南市,安南區,理想里,650,2242,709,365,1074,73,1147
公投第１１案,臺南市,安南區,理想里,651,2334,765,341,1106,49,1155
公投第１１案,臺南市,安南區,大安里,652,1822,650,296,946,47,993
公投第１１案,臺南市,安南區,大安里,653,1813,652,314,966,55,1021
公投第１１案,臺南市,安南區,原佃里,654,2188,733,378,1111,58,1169
公投第１１案,臺南市,安南區,長安里,655,2399,785,336,1121,55,1176
公投第１１案,臺南市,安南區,長安里,656,2247,681,326,1007,61,1068
公投第１１案,臺南市,安南區,公親里,657,1165,444,234,678,49,727
公投第１１案,臺南市,安南區,布袋里,658,1539,502,242,744,41,785
公投第１１案,臺南市,安南區,總頭里,659,1835,668,302,970,70,1040
公投第１１案,臺南市,安南區,南興里,660,1797,614,305,919,61,980
公投第１１案,臺南市,安南區,學東里,661,2223,649,374,1023,69,1092
公投第１１案,臺南市,安南區,公󻕯里,662,977,368,196,564,60,624
公投第１１案,臺南市,安南區,佃東里,663,1642,502,249,751,18,769
公投第１１案,臺南市,安南區,佃東里,664,1697,574,309,883,58,941
公投第１１案,臺南市,安南區,佃西里,665,1966,627,295,922,45,967
公投第１１案,臺南市,安南區,淵西里,666,1319,431,219,650,53,703
公投第１１案,臺南市,安南區,淵西里,667,1909,580,310,890,45,935
公投第１１案,臺南市,安南區,海西里,668,1763,614,287,901,46,947
公投第１１案,臺南市,安南區,海西里,669,965,308,161,469,50,519
公投第１１案,臺南市,安南區,海東里,670,1547,358,311,669,46,715
公投第１１案,臺南市,安南區,海東里,671,1784,577,288,865,47,912
公投第１１案,臺南市,安南區,海東里,672,2145,686,307,993,40,1033
公投第１１案,臺南市,安南區,溪心里,673,2443,869,410,1279,32,1311
公投第１１案,臺南市,安南區,溪心里,674,2565,796,320,1116,20,1136
公投第１１案,臺南市,安南區,溪心里,675,2480,835,397,1232,59,1291
公投第１１案,臺南市,安南區,淵東里,676,2349,643,354,997,62,1059
公投第１１案,臺南市,安南區,淵東里,677,2168,730,376,1106,58,1164
公投第１１案,臺南市,安南區,淵中里,678,1630,575,245,820,35,855
公投第１１案,臺南市,安南區,淵中里,679,1675,547,218,765,43,808
公投第１１案,臺南市,安南區,溪墘里,680,1627,665,303,968,51,1019
公投第１１案,臺南市,安南區,溪墘里,681,1493,572,215,787,38,825
公投第１１案,臺南市,安南區,海佃里,682,1397,519,228,747,42,789
公投第１１案,臺南市,安南區,海佃里,683,1416,494,222,716,40,756
公投第１１案,臺南市,安南區,海佃里,684,1460,516,251,767,18,785
公投第１１案,臺南市,安南區,國安里,685,2222,665,304,969,48,1017
公投第１１案,臺南市,安南區,溪東里,686,2070,690,340,1030,68,1098
公投第１１案,臺南市,安南區,溪東里,687,1739,626,310,936,30,966
公投第１１案,臺南市,安南區,安富里,688,1830,626,268,894,45,939
公投第１１案,臺南市,安南區,安富里,689,1803,680,331,1011,48,1059
公投第１１案,臺南市,安南區,安富里,690,1800,646,342,988,32,1020
公投第１１案,臺南市,安南區,幸福里,691,1815,529,286,815,36,851
公投第１１案,臺南市,安南區,幸福里,692,1846,614,267,881,33,914
公投第１１案,臺南市,安南區,海南里,693,905,358,170,528,29,557
公投第１１案,臺南市,安南區,海南里,694,1073,408,222,630,34,664
公投第１１案,臺南市,安南區,城東里,695,1579,593,263,856,61,917
公投第１１案,臺南市,安南區,城南里,696,1876,615,284,899,76,975
公投第１１案,臺南市,安南區,城南里,697,1194,378,206,584,39,623
公投第１１案,臺南市,安南區,青草里,698,1475,408,186,594,31,625
公投第１１案,臺南市,安南區,城西里,699,1380,492,200,692,16,708
公投第１１案,臺南市,安南區,城北里,700,1462,445,273,718,27,745
公投第１１案,臺南市,安南區,城中里,701,1044,426,159,585,33,618
公投第１１案,臺南市,安南區,砂崙里,702,603,232,113,345,50,395
公投第１１案,臺南市,安南區,砂崙里,703,690,246,123,369,30,399
公投第１１案,臺南市,安南區,顯宮里,704,1447,449,232,681,42,723
公投第１１案,臺南市,安南區,鹿耳里,705,910,398,166,564,35,599
公投第１１案,臺南市,安南區,四草里,706,1850,591,270,861,43,904
公投第１１案,臺南市,安南區,塩田里,707,1501,568,288,856,33,889
公投第１１案,臺南市,永康區,五王里,708,1398,463,263,726,39,765
公投第１１案,臺南市,永康區,五王里,709,1478,454,206,660,25,685
公投第１１案,臺南市,永康區,五王里,710,1442,464,246,710,14,724
公投第１１案,臺南市,永康區,五王里,711,1353,440,209,649,21,670
公投第１１案,臺南市,永康區,三合里,712,1160,423,181,604,20,624
公投第１１案,臺南市,永康區,三合里,713,1122,410,203,613,17,630
公投第１１案,臺南市,永康區,三合里,714,1165,416,170,586,6,592
公投第１１案,臺南市,永康區,六合里,715,1317,432,221,653,15,668
公投第１１案,臺南市,永康區,六合里,716,1376,487,195,682,23,705
公投第１１案,臺南市,永康區,六合里,717,1361,457,252,709,22,731
公投第１１案,臺南市,永康區,六合里,718,1374,494,291,785,18,803
公投第１１案,臺南市,永康區,網寮里,719,1709,531,284,815,34,849
公投第１１案,臺南市,永康區,網寮里,720,1717,532,264,796,33,829
公投第１１案,臺南市,永康區,網寮里,721,1759,550,276,826,23,849
公投第１１案,臺南市,永康區,網寮里,722,1636,558,268,826,19,845
公投第１１案,臺南市,永康區,二王里,723,1442,500,230,730,32,762
公投第１１案,臺南市,永康區,二王里,724,1545,509,250,759,20,779
公投第１１案,臺南市,永康區,二王里,725,1565,576,198,774,29,803
公投第１１案,臺南市,永康區,二王里,726,1684,533,269,802,19,821
公投第１１案,臺南市,永康區,二王里,727,1548,522,230,752,25,777
公投第１１案,臺南市,永康區,永康里,728,1389,508,249,757,18,775
公投第１１案,臺南市,永康區,永康里,729,1369,475,230,705,30,735
公投第１１案,臺南市,永康區,永康里,730,1415,539,195,734,42,776
公投第１１案,臺南市,永康區,永康里,731,1386,406,223,629,9,638
公投第１１案,臺南市,永康區,永康里,732,1747,290,135,425,7,432
公投第１１案,臺南市,永康區,永康里,733,1485,485,259,744,26,770
公投第１１案,臺南市,永康區,埔園里,734,1747,574,282,856,36,892
公投第１１案,臺南市,永康區,埔園里,735,1744,519,260,779,24,803
公投第１１案,臺南市,永康區,埔園里,736,1797,589,261,850,28,878
公投第１１案,臺南市,永康區,埔園里,737,1800,650,290,940,41,981
公投第１１案,臺南市,永康區,龍埔里,738,1720,602,225,827,16,843
公投第１１案,臺南市,永康區,龍埔里,739,1708,610,289,899,19,918
公投第１１案,臺南市,永康區,正強里,740,1519,582,263,845,19,864
公投第１１案,臺南市,永康區,正強里,741,1497,563,239,802,46,848
公投第１１案,臺南市,永康區,正強里,742,1509,587,238,825,22,847
公投第１１案,臺南市,永康區,正強里,743,1542,627,259,886,31,917
公投第１１案,臺南市,永康區,正強里,744,1536,520,304,824,21,845
公投第１１案,臺南市,永康區,大橋里,745,1531,515,284,799,24,823
公投第１１案,臺南市,永康區,大橋里,746,1327,496,246,742,23,765
公投第１１案,臺南市,永康區,大橋里,747,1456,496,261,757,18,775
公投第１１案,臺南市,永康區,大橋里,748,1396,479,295,774,14,788
公投第１１案,臺南市,永康區,東橋里,749,1636,527,289,816,33,849
公投第１１案,臺南市,永康區,東橋里,750,1592,527,310,837,27,864
公投第１１案,臺南市,永康區,東橋里,751,2017,545,401,946,10,956
公投第１１案,臺南市,永康區,東橋里,752,672,248,115,363,10,373
公投第１１案,臺南市,永康區,西橋里,753,1611,526,243,769,20,789
公投第１１案,臺南市,永康區,西橋里,754,1502,481,286,767,28,795
公投第１１案,臺南市,永康區,安康里,755,1660,484,257,741,11,752
公投第１１案,臺南市,永康區,安康里,756,1561,423,255,678,19,697
公投第１１案,臺南市,永康區,安康里,757,1590,491,295,786,16,802
公投第１１案,臺南市,永康區,蔦松里,758,924,308,178,486,12,498
公投第１１案,臺南市,永康區,蔦松里,759,938,355,176,531,19,550
公投第１１案,臺南市,永康區,三民里,760,957,355,168,523,28,551
公投第１１案,臺南市,永康區,三民里,761,496,156,93,249,29,278
公投第１１案,臺南市,永康區,塩行里,762,1717,571,300,871,39,910
公投第１１案,臺南市,永康區,塩行里,763,1615,497,253,750,31,781
公投第１１案,臺南市,永康區,塩行里,764,1554,545,237,782,12,794
公投第１１案,臺南市,永康區,塩興里,765,1196,425,175,600,20,620
公投第１１案,臺南市,永康區,塩興里,766,1274,425,227,652,20,672
公投第１１案,臺南市,永康區,塩興里,767,1215,422,207,629,18,647
公投第１１案,臺南市,永康區,塩洲里,768,1457,505,255,760,11,771
公投第１１案,臺南市,永康區,塩洲里,769,1451,537,245,782,14,796
公投第１１案,臺南市,永康區,塩洲里,770,1423,458,207,665,26,691
公投第１１案,臺南市,永康區,塩洲里,771,1394,522,222,744,26,770
公投第１１案,臺南市,永康區,甲頂里,772,890,323,168,491,25,516
公投第１１案,臺南市,永康區,甲頂里,773,1018,419,171,590,27,617
公投第１１案,臺南市,永康區,甲頂里,774,368,132,66,198,17,215
公投第１１案,臺南市,永康區,尚頂里,775,1208,482,219,701,30,731
公投第１１案,臺南市,永康區,尚頂里,776,1187,351,225,576,18,594
公投第１１案,臺南市,永康區,尚頂里,777,1381,448,239,687,16,703
公投第１１案,臺南市,永康區,龍潭里,778,1405,473,234,707,36,743
公投第１１案,臺南市,永康區,龍潭里,779,1445,444,236,680,48,728
公投第１１案,臺南市,永康區,龍潭里,780,1687,544,274,818,33,851
公投第１１案,臺南市,永康區,龍潭里,781,1535,466,230,696,32,728
公投第１１案,臺南市,永康區,永明里,782,1542,546,261,807,30,837
公投第１１案,臺南市,永康區,永明里,783,1618,540,265,805,22,827
公投第１１案,臺南市,永康區,永明里,784,1338,469,249,718,21,739
公投第１１案,臺南市,永康區,王行里,785,1285,468,237,705,38,743
公投第１１案,臺南市,永康區,王行里,786,1240,419,216,635,23,658
公投第１１案,臺南市,永康區,烏竹里,787,1343,444,199,643,32,675
公投第１１案,臺南市,永康區,烏竹里,788,1327,506,236,742,24,766
公投第１１案,臺南市,永康區,西勢里,789,1565,509,285,794,24,818
公投第１１案,臺南市,永康區,西勢里,790,1476,541,230,771,55,826
公投第１１案,臺南市,永康區,西勢里,791,1476,488,266,754,23,777
公投第１１案,臺南市,永康區,西勢里,792,1463,539,281,820,27,847
公投第１１案,臺南市,永康區,新樹里,793,983,362,169,531,44,575
公投第１１案,臺南市,永康區,新樹里,794,1116,436,187,623,30,653
公投第１１案,臺南市,永康區,大灣里,795,1117,366,179,545,50,595
公投第１１案,臺南市,永康區,大灣里,796,1069,336,167,503,32,535
公投第１１案,臺南市,永康區,大灣里,797,1180,452,225,677,24,701
公投第１１案,臺南市,永康區,東灣里,798,1176,428,177,605,51,656
公投第１１案,臺南市,永康區,東灣里,799,1158,357,222,579,32,611
公投第１１案,臺南市,永康區,東灣里,800,1208,441,224,665,47,712
公投第１１案,臺南市,永康區,西灣里,801,1501,510,248,758,52,810
公投第１１案,臺南市,永康區,西灣里,802,1298,490,231,721,23,744
公投第１１案,臺南市,永康區,西灣里,803,1542,514,289,803,17,820
公投第１１案,臺南市,永康區,西灣里,804,1537,545,287,832,28,860
公投第１１案,臺南市,永康區,西灣里,805,1359,509,278,787,40,827
公投第１１案,臺南市,永康區,南灣里,806,1139,361,176,537,23,560
公投第１１案,臺南市,永康區,南灣里,807,1158,364,192,556,24,580
公投第１１案,臺南市,永康區,南灣里,808,1538,481,266,747,39,786
公投第１１案,臺南市,永康區,崑山里,809,1166,400,187,587,13,600
公投第１１案,臺南市,永康區,崑山里,810,1228,414,214,628,25,653
公投第１１案,臺南市,永康區,崑山里,811,1200,416,247,663,23,686
公投第１１案,臺南市,永康區,崑山里,812,1131,411,213,624,17,641
公投第１１案,臺南市,永康區,崑山里,813,1147,394,218,612,17,629
公投第１１案,臺南市,永康區,北灣里,814,1442,474,223,697,39,736
公投第１１案,臺南市,永康區,北灣里,815,1325,446,221,667,24,691
公投第１１案,臺南市,永康區,北灣里,816,1260,405,175,580,22,602
公投第１１案,臺南市,永康區,北興里,817,1631,540,236,776,25,801
公投第１１案,臺南市,永康區,北興里,818,1549,509,236,745,24,769
公投第１１案,臺南市,永康區,北興里,819,1666,566,261,827,17,844
公投第１１案,臺南市,永康區,復興里,820,1012,335,129,464,34,498
公投第１１案,臺南市,永康區,復興里,821,976,327,125,452,15,467
公投第１１案,臺南市,永康區,光復里,822,531,201,84,285,12,297
公投第１１案,臺南市,永康區,建國里,823,859,331,146,477,23,500
公投第１１案,臺南市,永康區,建國里,824,937,292,152,444,23,467
公投第１１案,臺南市,永康區,復國里,825,1307,469,202,671,35,706
公投第１１案,臺南市,永康區,復國里,826,1482,496,207,703,16,719
公投第１１案,臺南市,永康區,復國里,827,1341,417,189,606,25,631
公投第１１案,臺南市,永康區,復國里,828,1376,435,229,664,34,698
公投第１１案,臺南市,永康區,復國里,829,1390,445,222,667,23,690
公投第１１案,臺南市,永康區,復國里,830,1534,535,268,803,32,835
公投第１１案,臺南市,永康區,復華里,831,1460,564,230,794,15,809
公投第１１案,臺南市,永康區,復華里,832,1383,481,219,700,13,713
公投第１１案,臺南市,永康區,復華里,833,1299,459,186,645,29,674
公投第１１案,臺南市,永康區,復華里,834,1264,452,236,688,14,702
公投第１１案,臺南市,永康區,復華里,835,1355,477,273,750,22,772
公投第１１案,臺南市,永康區,復華里,836,1414,491,204,695,23,718
公投第１１案,臺南市,永康區,復華里,837,1109,403,208,611,18,629
公投第１１案,臺南市,永康區,神洲里,838,1151,408,153,561,29,590
公投第１１案,臺南市,永康區,成功里,839,1026,438,199,637,26,663
公投第１１案,臺南市,永康區,成功里,840,1071,431,147,578,18,596
公投第１１案,臺南市,永康區,中華里,841,1387,556,268,824,53,877
公投第１１案,臺南市,永康區,中華里,842,1377,519,271,790,25,815
公投第１１案,臺南市,永康區,中興里,843,1687,612,260,872,44,916
公投第１１案,臺南市,永康區,中興里,844,1700,545,275,820,29,849
公投第１１案,臺南市,永康區,勝利里,845,1444,518,274,792,19,811
公投第１１案,臺南市,永康區,勝利里,846,1485,511,229,740,26,766
公投第１１案,臺南市,永康區,勝利里,847,1717,558,249,807,26,833
公投第１１案,臺南市,永康區,勝利里,848,1701,487,275,762,36,798
公投第１１案,臺南市,永康區,勝利里,849,1382,464,226,690,22,712
公投第１１案,臺南市,北區,開元里,850,1793,585,282,867,44,911
公投第１１案,臺南市,北區,開元里,851,1708,592,235,827,38,865
公投第１１案,臺南市,北區,元寶里,852,997,311,197,508,7,515
公投第１１案,臺南市,北區,元寶里,853,1452,374,262,636,18,654
公投第１１案,臺南市,北區,元寶里,854,1351,432,238,670,20,690
公投第１１案,臺南市,北區,合興里,855,1323,532,269,801,33,834
公投第１１案,臺南市,北區,合興里,856,1073,441,163,604,29,633
公投第１１案,臺南市,北區,合興里,857,1138,446,200,646,24,670
公投第１１案,臺南市,北區,力行里,858,1189,444,173,617,25,642
公投第１１案,臺南市,北區,力行里,859,1262,475,263,738,32,770
公投第１１案,臺南市,北區,重興里,860,1017,385,207,592,19,611
公投第１１案,臺南市,北區,重興里,861,847,304,155,459,16,475
公投第１１案,臺南市,北區,東興里,862,1076,422,173,595,30,625
公投第１１案,臺南市,北區,東興里,863,954,365,191,556,14,570
公投第１１案,臺南市,北區,長勝里,864,1300,462,191,653,48,701
公投第１１案,臺南市,北區,長勝里,865,1390,514,192,706,29,735
公投第１１案,臺南市,北區,長勝里,866,1318,501,206,707,36,743
公投第１１案,臺南市,北區,振興里,867,974,354,165,519,11,530
公投第１１案,臺南市,北區,振興里,868,990,350,174,524,21,545
公投第１１案,臺南市,北區,仁愛里,869,1016,375,233,608,19,627
公投第１１案,臺南市,北區,仁愛里,870,1053,391,174,565,27,592
公投第１１案,臺南市,北區,中樓里,871,1466,495,226,721,46,767
公投第１１案,臺南市,北區,永祥里,872,1535,559,255,814,42,856
公投第１１案,臺南市,北區,永祥里,873,1544,559,117,676,36,712
公投第１１案,臺南市,北區,北門里,874,1760,663,291,954,39,993
公投第１１案,臺南市,北區,北門里,875,1372,491,219,710,31,741
公投第１１案,臺南市,北區,北門里,876,1002,393,166,559,27,586
公投第１１案,臺南市,北區,北門里,877,1171,452,194,646,40,686
公投第１１案,臺南市,北區,大光里,878,1285,423,195,618,23,641
公投第１１案,臺南市,北區,大光里,879,1036,384,130,514,34,548
公投第１１案,臺南市,北區,大光里,880,1392,494,222,716,33,749
公投第１１案,臺南市,北區,大光里,881,1147,453,154,607,36,643
公投第１１案,臺南市,北區,大興里,882,1526,497,197,694,30,724
公投第１１案,臺南市,北區,大興里,883,1559,559,270,829,24,853
公投第１１案,臺南市,北區,公園里,884,892,313,141,454,58,512
公投第１１案,臺南市,北區,公園里,885,937,304,155,459,28,487
公投第１１案,臺南市,北區,北華里,886,1449,523,268,791,43,834
公投第１１案,臺南市,北區,北華里,887,1160,415,192,607,20,627
公投第１１案,臺南市,北區,北華里,888,1567,368,203,571,32,603
公投第１１案,臺南市,北區,長興里,889,1346,481,217,698,30,728
公投第１１案,臺南市,北區,長興里,890,1451,469,224,693,15,708
公投第１１案,臺南市,北區,小北里,891,1522,526,261,787,24,811
公投第１１案,臺南市,北區,小北里,892,1278,460,196,656,20,676
公投第１１案,臺南市,北區,小北里,893,1164,382,186,568,39,607
公投第１１案,臺南市,北區,正覺里,894,1091,365,191,556,9,565
公投第１１案,臺南市,北區,正覺里,895,993,362,152,514,25,539
公投第１１案,臺南市,北區,正覺里,896,1119,377,145,522,18,540
公投第１１案,臺南市,北區,成功里,897,1685,575,304,879,52,931
公投第１１案,臺南市,北區,成功里,898,1368,464,263,727,17,744
公投第１１案,臺南市,北區,成功里,899,1389,475,248,723,33,756
公投第１１案,臺南市,北區,華德里,900,1469,540,294,834,20,854
公投第１１案,臺南市,北區,華德里,901,1655,600,323,923,32,955
公投第１１案,臺南市,北區,福德里,902,1261,450,248,698,18,716
公投第１１案,臺南市,北區,福德里,903,1490,523,258,781,15,796
公投第１１案,臺南市,北區,福德里,904,1436,531,278,809,23,832
公投第１１案,臺南市,北區,成德里,905,1340,513,231,744,49,793
公投第１１案,臺南市,北區,成德里,906,1464,485,293,778,29,807
公投第１１案,臺南市,北區,成德里,907,1513,550,307,857,18,875
公投第１１案,臺南市,北區,和順里,908,1709,584,364,948,20,968
公投第１１案,臺南市,北區,和順里,909,1517,544,336,880,30,910
公投第１１案,臺南市,北區,和順里,910,1598,528,302,830,17,847
公投第１１案,臺南市,北區,立人里,911,1399,427,283,710,34,744
公投第１１案,臺南市,北區,立人里,912,1214,429,191,620,48,668
公投第１１案,臺南市,北區,雙安里,913,1064,353,235,588,16,604
公投第１１案,臺南市,北區,雙安里,914,1148,418,256,674,30,704
公投第１１案,臺南市,北區,文成里,915,1391,518,254,772,30,802
公投第１１案,臺南市,北區,文成里,916,1584,588,290,878,27,905
公投第１１案,臺南市,北區,元美里,917,1595,573,297,870,23,893
公投第１１案,臺南市,北區,元美里,918,1397,500,237,737,26,763
公投第１１案,臺南市,北區,文元里,919,1662,541,322,863,29,892
公投第１１案,臺南市,北區,文元里,920,1634,522,308,830,20,850
公投第１１案,臺南市,北區,大和里,921,1793,686,295,981,36,1017
公投第１１案,臺南市,北區,大和里,922,1872,669,347,1016,45,1061
公投第１１案,臺南市,北區,大港里,923,1874,654,329,983,36,1019
公投第１１案,臺南市,北區,大港里,924,1760,609,259,868,51,919
公投第１１案,臺南市,北區,大港里,925,1753,567,288,855,51,906
公投第１１案,臺南市,北區,大豐里,926,1502,435,246,681,17,698
公投第１１案,臺南市,北區,大豐里,927,1470,506,268,774,26,800
公投第１１案,臺南市,北區,大豐里,928,1319,458,208,666,43,709
公投第１１案,臺南市,北區,賢北里,929,1876,701,321,1022,34,1056
公投第１１案,臺南市,北區,賢北里,930,1720,585,313,898,14,912
公投第１１案,臺南市,中西區,赤嵌里,931,1332,338,359,697,43,740
公投第１１案,臺南市,中西區,赤嵌里,932,1246,479,207,686,41,727
公投第１１案,臺南市,中西區,赤嵌里,933,1276,451,183,634,44,678
公投第１１案,臺南市,中西區,郡王里,934,1583,563,312,875,32,907
公投第１１案,臺南市,中西區,郡王里,935,1464,503,307,810,28,838
公投第１１案,臺南市,中西區,法華里,936,1234,393,245,638,17,655
公投第１１案,臺南市,中西區,法華里,937,1368,394,372,766,24,790
公投第１１案,臺南市,中西區,開山里,938,1322,431,210,641,26,667
公投第１１案,臺南市,中西區,開山里,939,1216,386,231,617,28,645
公投第１１案,臺南市,中西區,永華里,940,1289,446,234,680,23,703
公投第１１案,臺南市,中西區,永華里,941,1237,481,202,683,22,705
公投第１１案,臺南市,中西區,藥王里,942,1189,372,197,569,26,595
公投第１１案,臺南市,中西區,藥王里,943,1201,427,224,651,37,688
公投第１１案,臺南市,中西區,藥王里,944,1065,420,182,602,37,639
公投第１１案,臺南市,中西區,光賢里,945,1055,416,180,596,26,622
公投第１１案,臺南市,中西區,光賢里,946,1170,442,251,693,24,717
公投第１１案,臺南市,中西區,光賢里,947,1280,538,239,777,24,801
公投第１１案,臺南市,中西區,大涼里,948,1223,415,246,661,35,696
公投第１１案,臺南市,中西區,大涼里,949,1292,489,227,716,41,757
公投第１１案,臺南市,中西區,西湖里,950,993,369,208,577,13,590
公投第１１案,臺南市,中西區,西湖里,951,1541,518,307,825,33,858
公投第１１案,臺南市,中西區,西湖里,952,1652,609,345,954,43,997
公投第１１案,臺南市,中西區,西湖里,953,1212,441,226,667,22,689
公投第１１案,臺南市,中西區,西賢里,954,1621,591,293,884,41,925
公投第１１案,臺南市,中西區,西賢里,955,1660,566,348,914,31,945
公投第１１案,臺南市,中西區,西賢里,956,1595,563,276,839,31,870
公投第１１案,臺南市,中西區,城隍里,957,1436,495,240,735,35,770
公投第１１案,臺南市,中西區,城隍里,958,1265,460,220,680,44,724
公投第１１案,臺南市,中西區,城隍里,959,856,350,156,506,27,533
公投第１１案,臺南市,中西區,南美里,960,1168,417,181,598,29,627
公投第１１案,臺南市,中西區,南美里,961,1134,411,227,638,32,670
公投第１１案,臺南市,中西區,南美里,962,995,393,201,594,32,626
公投第１１案,臺南市,中西區,南門里,963,1313,552,234,786,28,814
公投第１１案,臺南市,中西區,南門里,964,1265,472,256,728,30,758
公投第１１案,臺南市,中西區,小西門里,965,1215,399,222,621,31,652
公投第１１案,臺南市,中西區,小西門里,966,1248,444,225,669,25,694
公投第１１案,臺南市,中西區,小西門里,967,687,222,139,361,22,383
公投第１１案,臺南市,中西區,五條港里,968,1139,402,190,592,49,641
公投第１１案,臺南市,中西區,五條港里,969,971,371,169,540,27,567
公投第１１案,臺南市,中西區,兌悅里,970,1254,353,158,511,42,553
公投第１１案,臺南市,中西區,兌悅里,971,979,388,164,552,28,580
公投第１１案,臺南市,中西區,兌悅里,972,1745,590,281,871,41,912
公投第１１案,臺南市,中西區,淺草里,973,1074,366,193,559,32,591
公投第１１案,臺南市,中西區,淺草里,974,1436,516,182,698,28,726
公投第１１案,臺南市,中西區,府前里,975,865,287,177,464,37,501
公投第１１案,臺南市,中西區,府前里,976,1164,420,194,614,25,639
公投第１１案,臺南市,中西區,南廠里,977,1285,410,217,627,31,658
公投第１１案,臺南市,中西區,南廠里,978,1078,375,186,561,33,594
公投第１１案,臺南市,中西區,南廠里,979,1704,555,220,775,43,818
公投第１１案,臺南市,中西區,西和里,980,1296,502,215,717,43,760
公投第１１案,臺南市,中西區,西和里,981,1128,387,215,602,35,637
公投第１１案,臺南市,中西區,西和里,982,1245,435,234,669,20,689
公投第１１案,臺南市,安平區,文平里,983,1753,641,290,931,43,974
公投第１１案,臺南市,安平區,文平里,984,1859,607,324,931,29,960
公投第１１案,臺南市,安平區,文平里,985,1382,517,271,788,23,811
公投第１１案,臺南市,安平區,建平里,986,2547,872,388,1260,31,1291
公投第１１案,臺南市,安平區,建平里,987,2407,788,430,1218,38,1256
公投第１１案,臺南市,安平區,怡平里,988,2070,593,352,945,27,972
公投第１１案,臺南市,安平區,怡平里,989,2132,727,395,1122,16,1138
公投第１１案,臺南市,安平區,華平里,990,1450,522,273,795,11,806
公投第１１案,臺南市,安平區,華平里,991,1605,508,294,802,17,819
公投第１１案,臺南市,安平區,華平里,992,1755,602,316,918,28,946
公投第１１案,臺南市,安平區,平通里,993,1728,522,271,793,27,820
公投第１１案,臺南市,安平區,平通里,994,1754,459,278,737,20,757
公投第１１案,臺南市,安平區,平通里,995,1686,543,294,837,35,872
公投第１１案,臺南市,安平區,平通里,996,1843,669,302,971,28,999
公投第１１案,臺南市,安平區,億載里,997,1565,566,296,862,26,888
公投第１１案,臺南市,安平區,億載里,998,1288,471,235,706,10,716
公投第１１案,臺南市,安平區,育平里,999,1653,518,292,810,11,821
公投第１１案,臺南市,安平區,育平里,1000,1697,562,272,834,7,841
公投第１１案,臺南市,安平區,育平里,1001,2154,649,342,991,27,1018
公投第１１案,臺南市,安平區,育平里,1002,2107,678,324,1002,30,1032
公投第１１案,臺南市,安平區,國平里,1003,1675,582,318,900,27,927
公投第１１案,臺南市,安平區,國平里,1004,1979,616,375,991,35,1026
公投第１１案,臺南市,安平區,國平里,1005,1602,483,294,777,22,799
公投第１１案,臺南市,安平區,國平里,1006,1586,505,284,789,17,806
公投第１１案,臺南市,安平區,漁光里,1007,438,148,60,208,4,212
公投第１１案,臺南市,安平區,平安里,1008,1780,553,317,870,33,903
公投第１１案,臺南市,安平區,平安里,1009,1623,498,289,787,29,816
公投第１１案,臺南市,安平區,天妃里,1010,2157,705,313,1018,51,1069
公投第１１案,臺南市,安平區,天妃里,1011,1286,445,201,646,30,676
公投第１１案,臺南市,安平區,王城里,1012,1492,507,246,753,36,789
公投第１１案,臺南市,安平區,王城里,1013,1325,440,187,627,13,640
公投第１１案,臺南市,安平區,金城里,1014,2001,651,286,937,54,991
公投第１１案,臺南市,南區,大恩里,1015,1221,442,237,679,31,710
公投第１１案,臺南市,南區,大恩里,1016,2171,676,294,970,45,1015
公投第１１案,臺南市,南區,大林里,1017,1150,433,218,651,20,671
公投第１１案,臺南市,南區,大林里,1018,1122,447,190,637,25,662
公投第１１案,臺南市,南區,大忠里,1019,1444,478,210,688,30,718
公投第１１案,臺南市,南區,大忠里,1020,1765,550,290,840,44,884
公投第１１案,臺南市,南區,大忠里,1021,1298,494,235,729,38,767
公投第１１案,臺南市,南區,新生里,1022,1458,564,217,781,23,804
公投第１１案,臺南市,南區,新生里,1023,1940,661,302,963,16,979
公投第１１案,臺南市,南區,竹溪里,1024,1637,556,266,822,40,862
公投第１１案,臺南市,南區,明德里,1025,871,247,149,396,8,404
公投第１１案,臺南市,南區,大成里,1026,589,208,123,331,7,338
公投第１１案,臺南市,南區,大成里,1027,801,331,170,501,32,533
公投第１１案,臺南市,南區,田寮里,1028,990,397,151,548,28,576
公投第１１案,臺南市,南區,田寮里,1029,1222,498,220,718,23,741
公投第１１案,臺南市,南區,田寮里,1030,997,382,171,553,46,599
公投第１１案,臺南市,南區,新興里,1031,1204,400,198,598,30,628
公投第１１案,臺南市,南區,新興里,1032,1570,469,260,729,26,755
公投第１１案,臺南市,南區,再興里,1033,1222,408,246,654,26,680
公投第１１案,臺南市,南區,再興里,1034,1076,341,181,522,19,541
公投第１１案,臺南市,南區,廣州里,1035,1127,418,206,624,18,642
公投第１１案,臺南市,南區,廣州里,1036,1135,429,178,607,40,647
公投第１１案,臺南市,南區,新昌里,1037,1263,436,208,644,29,673
公投第１１案,臺南市,南區,新昌里,1038,1014,351,163,514,17,531
公投第１１案,臺南市,南區,文華里,1039,1491,561,245,806,35,841
公投第１１案,臺南市,南區,文華里,1040,1815,621,328,949,29,978
公投第１１案,臺南市,南區,文南里,1041,1398,461,264,725,12,737
公投第１１案,臺南市,南區,文南里,1042,2107,610,281,891,26,917
公投第１１案,臺南市,南區,文南里,1043,1587,645,268,913,26,939
公投第１１案,臺南市,南區,金華里,1044,1626,563,285,848,30,878
公投第１１案,臺南市,南區,金華里,1045,1761,578,274,852,29,881
公投第１１案,臺南市,南區,金華里,1046,1630,577,264,841,35,876
公投第１１案,臺南市,南區,國宅里,1047,1542,538,253,791,42,833
公投第１１案,臺南市,南區,國宅里,1048,1464,486,243,729,56,785
公投第１１案,臺南市,南區,鹽埕里,1049,1727,608,259,867,50,917
公投第１１案,臺南市,南區,鹽埕里,1050,1085,419,214,633,30,663
公投第１１案,臺南市,南區,鹽埕里,1051,939,349,144,493,18,511
公投第１１案,臺南市,南區,光明里,1052,1419,446,203,649,35,684
公投第１１案,臺南市,南區,光明里,1053,1333,416,217,633,40,673
公投第１１案,臺南市,南區,光明里,1054,1465,466,252,718,26,744
公投第１１案,臺南市,南區,明亮里,1055,1099,402,192,594,19,613
公投第１１案,臺南市,南區,明亮里,1056,1133,390,170,560,18,578
公投第１１案,臺南市,南區,明亮里,1057,1375,481,191,672,49,721
公投第１１案,臺南市,南區,府南里,1058,1781,529,275,804,33,837
公投第１１案,臺南市,南區,府南里,1059,1542,587,263,850,27,877
公投第１１案,臺南市,南區,府南里,1060,1486,489,222,711,26,737
公投第１１案,臺南市,南區,明興里,1061,1640,604,257,861,51,912
公投第１１案,臺南市,南區,明興里,1062,1701,519,226,745,26,771
公投第１１案,臺南市,南區,郡南里,1063,1541,519,211,730,41,771
公投第１１案,臺南市,南區,郡南里,1064,2027,667,302,969,58,1027
公投第１１案,臺南市,南區,建南里,1065,1774,680,322,1002,41,1043
公投第１１案,臺南市,南區,建南里,1066,1613,534,265,799,44,843
公投第１１案,臺南市,南區,建南里,1067,1707,577,268,845,19,864
公投第１１案,臺南市,南區,南都里,1068,1657,386,187,573,26,599
公投第１１案,臺南市,南區,南都里,1069,1077,397,168,565,20,585
公投第１１案,臺南市,南區,南華里,1070,1185,418,194,612,25,637
公投第１１案,臺南市,南區,南華里,1071,1249,416,219,635,27,662
公投第１１案,臺南市,南區,開南里,1072,1985,632,250,882,23,905
公投第１１案,臺南市,南區,開南里,1073,2017,587,297,884,35,919
公投第１１案,臺南市,南區,開南里,1074,1717,545,263,808,39,847
公投第１１案,臺南市,南區,彰南里,1075,929,355,145,500,24,524
公投第１１案,臺南市,南區,彰南里,1076,695,232,140,372,23,395
公投第１１案,臺南市,南區,鯤鯓里,1077,997,349,139,488,14,502
公投第１１案,臺南市,南區,鯤鯓里,1078,784,283,107,390,10,400
公投第１１案,臺南市,南區,喜北里,1079,1119,452,159,611,41,652
公投第１１案,臺南市,南區,喜北里,1080,1054,344,142,486,21,507
公投第１１案,臺南市,南區,喜南里,1081,1245,385,209,594,51,645
公投第１１案,臺南市,南區,喜東里,1082,2064,616,323,939,43,982
公投第１１案,臺南市,南區,省躬里,1083,2056,560,284,844,21,865
公投第１１案,臺南市,南區,省躬里,1084,1373,464,201,665,13,678
公投第１１案,臺南市,南區,永寧里,1085,1002,341,151,492,26,518
公投第１１案,臺南市,南區,永寧里,1086,760,274,137,411,39,450
公投第１１案,臺南市,南區,松安里,1087,1031,363,180,543,37,580
公投第１１案,臺南市,南區,松安里,1088,744,253,125,378,35,413
公投第１１案,臺南市,南區,佛壇里,1089,1186,413,200,613,36,649
公投第１１案,臺南市,南區,佛壇里,1090,1358,493,220,713,33,746
公投第１１案,臺南市,南區,同安里,1091,897,293,129,422,16,438
公投第１１案,臺南市,南區,同安里,1092,1265,445,195,640,27,667
公投第１１案,臺南市,南區,興農里,1093,1093,371,163,534,22,556
公投第１１案,臺南市,南區,興農里,1094,1016,384,181,565,18,583
公投第１１案,臺南市,東區,崇信里,1095,2681,691,344,1035,41,1076
公投第１１案,臺南市,東區,崇信里,1096,1811,645,309,954,30,984
公投第１１案,臺南市,東區,崇學里,1097,1491,600,288,888,50,938
公投第１１案,臺南市,東區,崇學里,1098,1378,458,277,735,21,756
公投第１１案,臺南市,東區,崇德里,1099,1552,557,312,869,32,901
公投第１１案,臺南市,東區,崇德里,1100,1326,523,245,768,13,781
公投第１１案,臺南市,東區,崇德里,1101,1594,560,306,866,32,898
公投第１１案,臺南市,東區,崇善里,1102,1639,580,339,919,29,948
公投第１１案,臺南市,東區,崇善里,1103,1724,601,308,909,37,946
公投第１１案,臺南市,東區,崇善里,1104,1629,586,280,866,44,910
公投第１１案,臺南市,東區,崇成里,1105,1399,483,278,761,32,793
公投第１１案,臺南市,東區,崇成里,1106,1534,556,282,838,25,863
公投第１１案,臺南市,東區,崇文里,1107,1656,579,323,902,31,933
公投第１１案,臺南市,東區,崇文里,1108,1322,481,213,694,36,730
公投第１１案,臺南市,東區,崇文里,1109,1620,563,311,874,26,900
公投第１１案,臺南市,東區,崇文里,1110,1331,540,259,799,22,821
公投第１１案,臺南市,東區,東智里,1111,1039,412,168,580,25,605
公投第１１案,臺南市,東區,東智里,1112,1257,458,174,632,25,657
公投第１１案,臺南市,東區,大智里,1113,2067,686,326,1012,63,1075
公投第１１案,臺南市,東區,大智里,1114,2153,821,322,1143,29,1172
公投第１１案,臺南市,東區,大智里,1115,2363,856,366,1222,28,1250
公投第１１案,臺南市,東區,德高里,1116,1427,513,235,748,37,785
公投第１１案,臺南市,東區,德高里,1117,1555,629,279,908,25,933
公投第１１案,臺南市,東區,仁和里,1118,2115,644,284,928,41,969
公投第１１案,臺南市,東區,仁和里,1119,2340,737,376,1113,47,1160
公投第１１案,臺南市,東區,和平里,1120,2474,827,449,1276,34,1310
公投第１１案,臺南市,東區,和平里,1121,2391,859,352,1211,34,1245
公投第１１案,臺南市,東區,虎尾里,1122,1673,596,313,909,33,942
公投第１１案,臺南市,東區,虎尾里,1123,1594,559,304,863,22,885
公投第１１案,臺南市,東區,虎尾里,1124,1607,573,288,861,59,920
公投第１１案,臺南市,東區,裕聖里,1125,2087,789,410,1199,22,1221
公投第１１案,臺南市,東區,裕聖里,1126,2369,858,468,1326,30,1356
公投第１１案,臺南市,東區,復興里,1127,1696,607,272,879,38,917
公投第１１案,臺南市,東區,復興里,1128,1612,583,307,890,24,914
公投第１１案,臺南市,東區,自強里,1129,1708,549,312,861,36,897
公投第１１案,臺南市,東區,自強里,1130,1560,531,299,830,31,861
公投第１１案,臺南市,東區,自強里,1131,1854,607,344,951,41,992
公投第１１案,臺南市,東區,東聖里,1132,2278,747,369,1116,31,1147
公投第１１案,臺南市,東區,關聖里,1133,2093,714,360,1074,38,1112
公投第１１案,臺南市,東區,關聖里,1134,2242,815,436,1251,30,1281
公投第１１案,臺南市,東區,南聖里,1135,1152,437,226,663,34,697
公投第１１案,臺南市,東區,南聖里,1136,1318,516,268,784,14,798
公投第１１案,臺南市,東區,文聖里,1137,2200,802,411,1213,35,1248
公投第１１案,臺南市,東區,文聖里,1138,1960,739,395,1134,15,1149
公投第１１案,臺南市,東區,後甲里,1139,1489,553,239,792,41,833
公投第１１案,臺南市,東區,後甲里,1140,1443,490,264,754,43,797
公投第１１案,臺南市,東區,東光里,1141,1498,532,345,877,33,910
公投第１１案,臺南市,東區,東光里,1142,1622,578,316,894,22,916
公投第１１案,臺南市,東區,東光里,1143,1738,614,328,942,32,974
公投第１１案,臺南市,東區,東明里,1144,1501,467,293,760,40,800
公投第１１案,臺南市,東區,東明里,1145,1482,549,248,797,41,838
公投第１１案,臺南市,東區,莊敬里,1146,1829,567,313,880,37,917
公投第１１案,臺南市,東區,莊敬里,1147,1764,579,342,921,46,967
公投第１１案,臺南市,東區,小東里,1148,1427,536,270,806,27,833
公投第１１案,臺南市,東區,小東里,1149,1427,467,263,730,43,773
公投第１１案,臺南市,東區,小東里,1150,1388,514,246,760,24,784
公投第１１案,臺南市,東區,大學里,1151,1131,394,282,676,23,699
公投第１１案,臺南市,東區,成大里,1152,1000,348,173,521,31,552
公投第１１案,臺南市,東區,成大里,1153,996,368,166,534,21,555
公投第１１案,臺南市,東區,東門里,1154,935,338,130,468,31,499
公投第１１案,臺南市,東區,東門里,1155,947,330,186,516,32,548
公投第１１案,臺南市,東區,圍下里,1156,1090,361,226,587,7,594
公投第１１案,臺南市,東區,圍下里,1157,896,315,139,454,24,478
公投第１１案,臺南市,東區,中西里,1158,1589,551,294,845,30,875
公投第１１案,臺南市,東區,中西里,1159,1497,560,265,825,28,853
公投第１１案,臺南市,東區,東安里,1160,1386,479,219,698,31,729
公投第１１案,臺南市,東區,新東里,1161,1101,405,209,614,14,628
公投第１１案,臺南市,東區,新東里,1162,1332,508,236,744,33,777
公投第１１案,臺南市,東區,崇誨里,1163,1185,452,209,661,18,679
公投第１１案,臺南市,東區,崇誨里,1164,1262,511,212,723,25,748
公投第１１案,臺南市,東區,衛國里,1165,1517,530,229,759,37,796
公投第１１案,臺南市,東區,裕農里,1166,1287,439,234,673,43,716
公投第１１案,臺南市,東區,裕農里,1167,1657,590,297,887,41,928
公投第１１案,臺南市,東區,富強里,1168,2238,787,374,1161,63,1224
公投第１１案,臺南市,東區,富強里,1169,2246,755,396,1151,41,1192
公投第１１案,臺南市,東區,富裕里,1170,2191,739,392,1131,41,1172
公投第１１案,臺南市,東區,忠孝里,1171,2063,669,403,1072,37,1109
公投第１１案,臺南市,東區,忠孝里,1172,2177,810,395,1205,51,1256
公投第１１案,臺南市,東區,崇明里,1173,1863,727,315,1042,44,1086
公投第１１案,臺南市,東區,崇明里,1174,2185,794,400,1194,32,1226
公投第１１案,臺南市,東區,大福里,1175,1721,550,255,805,37,842
公投第１１案,臺南市,東區,大德里,1176,1556,534,265,799,64,863
公投第１１案,臺南市,東區,路東里,1177,1602,590,303,893,28,921
公投第１１案,臺南市,東區,大同里,1178,1523,544,219,763,47,810
公投第１１案,臺南市,東區,大同里,1179,1382,439,248,687,34,721
公投第１１案,臺南市,東區,泉南里,1180,1486,531,256,787,23,810
公投第１１案,臺南市,東區,泉南里,1181,1560,561,276,837,36,873
公投第１１案,臺南市,東區,泉南里,1182,1684,524,271,795,47,842
公投第１１案,臺南市,東區,龍山里,1183,1653,570,320,890,25,915
公投第１１案,臺南市,東區,龍山里,1184,1554,491,364,855,15,870
公投第１１案,臺南市,東區,龍山里,1185,1408,495,288,783,25,808
公投第１１案,臺南市,東區,德光里,1186,2084,802,394,1196,30,1226
公投第１１案,臺南市,東區,德光里,1187,1896,610,397,1007,34,1041
公投第１１案,臺南市,仁德區,太子里,1188,1318,465,225,690,39,729
公投第１１案,臺南市,仁德區,太子里,1189,1406,490,237,727,43,770
公投第１１案,臺南市,仁德區,太子里,1190,1465,506,208,714,56,770
公投第１１案,臺南市,仁德區,太子里,1191,1192,452,220,672,48,720
公投第１１案,臺南市,仁德區,土庫里,1192,1429,521,267,788,42,830
公投第１１案,臺南市,仁德區,土庫里,1193,1320,424,230,654,72,726
公投第１１案,臺南市,仁德區,一甲里,1194,1373,567,234,801,36,837
公投第１１案,臺南市,仁德區,一甲里,1195,1330,513,221,734,36,770
公投第１１案,臺南市,仁德區,仁德里,1196,1687,642,280,922,28,950
公投第１１案,臺南市,仁德區,仁德里,1197,1491,466,247,713,47,760
公投第１１案,臺南市,仁德區,仁德里,1198,1151,362,163,525,22,547
公投第１１案,臺南市,仁德區,仁德里,1199,1407,499,218,717,14,731
公投第１１案,臺南市,仁德區,仁德里,1200,1465,583,229,812,26,838
公投第１１案,臺南市,仁德區,仁義里,1201,1335,509,225,734,24,758
公投第１１案,臺南市,仁德區,仁義里,1202,1490,497,243,740,49,789
公投第１１案,臺南市,仁德區,仁義里,1203,1453,569,251,820,32,852
公投第１１案,臺南市,仁德區,仁義里,1204,990,340,151,491,26,517
公投第１１案,臺南市,仁德區,仁義里,1205,1573,613,245,858,30,888
公投第１１案,臺南市,仁德區,仁義里,1206,1031,373,163,536,32,568
公投第１１案,臺南市,仁德區,仁義里,1207,1194,408,213,621,22,643
公投第１１案,臺南市,仁德區,新田里,1208,1268,444,180,624,41,665
公投第１１案,臺南市,仁德區,新田里,1209,929,322,171,493,38,531
公投第１１案,臺南市,仁德區,新田里,1210,1145,389,168,557,11,568
公投第１１案,臺南市,仁德區,後壁里,1211,1413,483,232,715,28,743
公投第１１案,臺南市,仁德區,後壁里,1212,1465,527,212,739,49,788
公投第１１案,臺南市,仁德區,後壁里,1213,1390,514,237,751,45,796
公投第１１案,臺南市,仁德區,後壁里,1214,1396,483,234,717,52,769
公投第１１案,臺南市,仁德區,後壁里,1215,1906,616,333,949,49,998
公投第１１案,臺南市,仁德區,後壁里,1216,1546,520,237,757,19,776
公投第１１案,臺南市,仁德區,上崙里,1217,1546,459,224,683,27,710
公投第１１案,臺南市,仁德區,上崙里,1218,1399,482,237,719,33,752
公投第１１案,臺南市,仁德區,上崙里,1219,1748,578,291,869,61,930
公投第１１案,臺南市,仁德區,上崙里,1220,1140,418,201,619,25,644
公投第１１案,臺南市,仁德區,文賢里,1221,1277,458,200,658,35,693
公投第１１案,臺南市,仁德區,文賢里,1222,1019,444,184,628,31,659
公投第１１案,臺南市,仁德區,保安里,1223,1414,509,214,723,20,743
公投第１１案,臺南市,仁德區,保安里,1224,1349,465,189,654,20,674
公投第１１案,臺南市,仁德區,成功里,1225,1471,517,222,739,23,762
公投第１１案,臺南市,仁德區,成功里,1226,1324,501,206,707,16,723
公投第１１案,臺南市,仁德區,成功里,1227,1310,462,146,608,41,649
公投第１１案,臺南市,仁德區,成功里,1228,554,203,90,293,21,314
公投第１１案,臺南市,仁德區,仁和里,1229,1395,552,155,707,42,749
公投第１１案,臺南市,仁德區,仁愛里,1230,1264,475,168,643,14,657
公投第１１案,臺南市,仁德區,二行里,1231,1180,435,161,596,63,659
公投第１１案,臺南市,仁德區,二行里,1232,928,319,137,456,21,477
公投第１１案,臺南市,仁德區,大甲里,1233,965,339,140,479,15,494
公投第１１案,臺南市,仁德區,大甲里,1234,1119,397,176,573,25,598
公投第１１案,臺南市,仁德區,中洲里,1235,1206,447,173,620,40,660
公投第１１案,臺南市,仁德區,中洲里,1236,1466,509,206,715,44,759
公投第１１案,臺南市,歸仁區,南保里,1237,1560,531,244,775,41,816
公投第１１案,臺南市,歸仁區,南保里,1238,1383,550,260,810,34,844
公投第１１案,臺南市,歸仁區,南保里,1239,1491,512,267,779,24,803
公投第１１案,臺南市,歸仁區,南保里,1240,1482,492,233,725,36,761
公投第１１案,臺南市,歸仁區,南興里,1241,1330,473,254,727,22,749
公投第１１案,臺南市,歸仁區,南興里,1242,1399,487,272,759,32,791
公投第１１案,臺南市,歸仁區,南興里,1243,1416,479,225,704,30,734
公投第１１案,臺南市,歸仁區,六甲里,1244,1336,361,203,564,35,599
公投第１１案,臺南市,歸仁區,六甲里,1245,1183,385,169,554,43,597
公投第１１案,臺南市,歸仁區,六甲里,1246,1237,422,192,614,21,635
公投第１１案,臺南市,歸仁區,歸南里,1247,1133,398,197,595,39,634
公投第１１案,臺南市,歸仁區,歸南里,1248,1149,380,187,567,33,600
公投第１１案,臺南市,歸仁區,後市里,1249,1105,398,185,583,6,589
公投第１１案,臺南市,歸仁區,後市里,1250,1099,378,188,566,46,612
公投第１１案,臺南市,歸仁區,後市里,1251,1082,413,181,594,44,638
公投第１１案,臺南市,歸仁區,文化里,1252,1519,593,256,849,29,878
公投第１１案,臺南市,歸仁區,文化里,1253,1467,550,264,814,29,843
公投第１１案,臺南市,歸仁區,辜厝里,1254,1090,374,174,548,30,578
公投第１１案,臺南市,歸仁區,辜厝里,1255,1131,397,178,575,19,594
公投第１１案,臺南市,歸仁區,辜厝里,1256,1080,386,178,564,25,589
公投第１１案,臺南市,歸仁區,新厝里,1257,1121,367,159,526,20,546
公投第１１案,臺南市,歸仁區,新厝里,1258,1336,454,237,691,35,726
公投第１１案,臺南市,歸仁區,許厝里,1259,1128,372,191,563,54,617
公投第１１案,臺南市,歸仁區,許厝里,1260,1055,376,167,543,26,569
公投第１１案,臺南市,歸仁區,許厝里,1261,1102,401,162,563,31,594
公投第１１案,臺南市,歸仁區,看西里,1262,1068,272,197,469,29,498
公投第１１案,臺南市,歸仁區,看西里,1263,1033,380,176,556,44,600
公投第１１案,臺南市,歸仁區,看東里,1264,1772,508,227,735,12,747
公投第１１案,臺南市,歸仁區,崙頂里,1265,1399,488,247,735,46,781
公投第１１案,臺南市,歸仁區,崙頂里,1266,1544,536,257,793,28,821
公投第１１案,臺南市,歸仁區,沙崙里,1267,684,196,101,297,15,312
公投第１１案,臺南市,歸仁區,大潭里,1268,839,309,167,476,26,502
公投第１１案,臺南市,歸仁區,大潭里,1269,1014,370,203,573,40,613
公投第１１案,臺南市,歸仁區,武東里,1270,1906,471,211,682,24,706
公投第１１案,臺南市,歸仁區,歸仁里,1271,1245,470,215,685,33,718
公投第１１案,臺南市,歸仁區,歸仁里,1272,1048,363,175,538,22,560
公投第１１案,臺南市,歸仁區,八甲里,1273,1175,425,179,604,24,628
公投第１１案,臺南市,歸仁區,八甲里,1274,1411,441,241,682,31,713
公投第１１案,臺南市,歸仁區,七甲里,1275,1514,545,283,828,29,857
公投第１１案,臺南市,歸仁區,七甲里,1276,1678,561,287,848,57,905
公投第１１案,臺南市,歸仁區,媽廟里,1277,949,337,173,510,33,543
公投第１１案,臺南市,歸仁區,媽廟里,1278,1009,418,155,573,42,615
公投第１１案,臺南市,歸仁區,西埔里,1279,984,408,206,614,3,617
公投第１１案,臺南市,歸仁區,西埔里,1280,756,319,116,435,22,457
公投第１１案,臺南市,歸仁區,大廟里,1281,1478,571,265,836,47,883
公投第１１案,臺南市,歸仁區,大廟里,1282,1467,542,273,815,57,872
公投第１１案,臺南市,關廟區,關廟里,1283,982,358,162,520,14,534
公投第１１案,臺南市,關廟區,關廟里,1284,1156,467,190,657,42,699
公投第１１案,臺南市,關廟區,山西里,1285,1006,330,153,483,20,503
公投第１１案,臺南市,關廟區,山西里,1286,1043,404,197,601,37,638
公投第１１案,臺南市,關廟區,香洋里,1287,1012,351,187,538,53,591
公投第１１案,臺南市,關廟區,香洋里,1288,1013,309,161,470,21,491
公投第１１案,臺南市,關廟區,香洋里,1289,1294,423,194,617,35,652
公投第１１案,臺南市,關廟區,北勢里,1290,1264,419,198,617,35,652
公投第１１案,臺南市,關廟區,北勢里,1291,1166,419,173,592,40,632
公投第１１案,臺南市,關廟區,新埔里,1292,1018,341,176,517,23,540
公投第１１案,臺南市,關廟區,新光里,1293,733,215,94,309,34,343
公投第１１案,臺南市,關廟區,五甲里,1294,1093,404,217,621,32,653
公投第１１案,臺南市,關廟區,五甲里,1295,1081,427,175,602,16,618
公投第１１案,臺南市,關廟區,五甲里,1296,978,362,185,547,34,581
公投第１１案,臺南市,關廟區,東勢里,1297,1116,319,181,500,45,545
公投第１１案,臺南市,關廟區,東勢里,1298,972,342,137,479,44,523
公投第１１案,臺南市,關廟區,東勢里,1299,1045,348,193,541,59,600
公投第１１案,臺南市,關廟區,松腳里,1300,872,319,136,455,34,489
公投第１１案,臺南市,關廟區,松腳里,1301,1007,352,196,548,42,590
公投第１１案,臺南市,關廟區,花園里,1302,763,296,132,428,33,461
公投第１１案,臺南市,關廟區,花園里,1303,630,208,91,299,35,334
公投第１１案,臺南市,關廟區,花園里,1304,959,364,157,521,40,561
公投第１１案,臺南市,關廟區,花園里,1305,1123,420,155,575,24,599
公投第１１案,臺南市,關廟區,深坑里,1306,804,305,122,427,39,466
公投第１１案,臺南市,關廟區,深坑里,1307,720,269,116,385,15,400
公投第１１案,臺南市,關廟區,布袋里,1308,843,269,101,370,19,389
公投第１１案,臺南市,關廟區,布袋里,1309,358,111,58,169,14,183
公投第１１案,臺南市,關廟區,南雄里,1310,797,274,107,381,50,431
公投第１１案,臺南市,關廟區,南雄里,1311,709,228,86,314,15,329
公投第１１案,臺南市,關廟區,埤頭里,1312,904,317,112,429,15,444
公投第１１案,臺南市,關廟區,埤頭里,1313,963,344,156,500,27,527
公投第１１案,臺南市,關廟區,下湖里,1314,489,177,103,280,13,293
公投第１１案,臺南市,龍崎區,崎頂里,1315,1047,353,161,514,47,561
公投第１１案,臺南市,龍崎區,土崎里,1316,630,218,77,295,21,316
公投第１１案,臺南市,龍崎區,中坑里,1317,141,38,14,52,7,59
公投第１１案,臺南市,龍崎區,楠坑里,1318,367,121,53,174,10,184
公投第１１案,臺南市,龍崎區,牛埔里,1319,337,125,41,166,19,185
公投第１１案,臺南市,龍崎區,大坪里,1320,318,96,42,138,6,144
公投第１１案,臺南市,龍崎區,龍船里,1321,427,152,38,190,24,214
公投第１１案,臺南市,龍崎區,石𥕢里,1322,446,143,48,191,12,203
公投第１１案,桃園市,桃園區,大林里,1,1593,485,278,763,42,805
公投第１１案,桃園市,桃園區,大林里,2,1934,507,317,824,32,856
公投第１１案,桃園市,桃園區,大林里,3,1661,573,300,873,44,917
公投第１１案,桃園市,桃園區,大林里,4,1448,436,225,661,17,678
公投第１１案,桃園市,桃園區,大樹里,5,1974,586,333,919,34,953
公投第１１案,桃園市,桃園區,大樹里,6,1882,542,267,809,56,865
公投第１１案,桃園市,桃園區,大豐里,7,1800,521,334,855,24,879
公投第１１案,桃園市,桃園區,大豐里,8,1598,531,305,836,39,875
公投第１１案,桃園市,桃園區,大豐里,9,1626,460,253,713,60,773
公投第１１案,桃園市,桃園區,建國里,10,1590,493,263,756,42,798
公投第１１案,桃園市,桃園區,建國里,11,1637,507,285,792,36,828
公投第１１案,桃園市,桃園區,建國里,12,1943,583,285,868,51,919
公投第１１案,桃園市,桃園區,雲林里,13,1482,457,285,742,39,781
公投第１１案,桃園市,桃園區,雲林里,14,1423,487,261,748,36,784
公投第１１案,桃園市,桃園區,雲林里,15,1509,487,321,808,29,837
公投第１１案,桃園市,桃園區,雲林里,16,1567,567,269,836,16,852
公投第１１案,桃園市,桃園區,福安里,17,1305,466,211,677,32,709
公投第１１案,桃園市,桃園區,福安里,18,1416,437,234,671,28,699
公投第１１案,桃園市,桃園區,福安里,19,1439,490,300,790,18,808
公投第１１案,桃園市,桃園區,福林里,20,1399,270,476,746,39,785
公投第１１案,桃園市,桃園區,福林里,21,1540,519,309,828,33,861
公投第１１案,桃園市,桃園區,福林里,22,1638,525,262,787,20,807
公投第１１案,桃園市,桃園區,福林里,23,1228,431,209,640,24,664
公投第１１案,桃園市,桃園區,豐林里,24,1649,524,262,786,44,830
公投第１１案,桃園市,桃園區,豐林里,25,1601,547,255,802,34,836
公投第１１案,桃園市,桃園區,豐林里,26,1477,445,259,704,53,757
公投第１１案,桃園市,桃園區,豐林里,27,1503,543,245,788,32,820
公投第１１案,桃園市,桃園區,中和里,28,1375,482,264,746,50,796
公投第１１案,桃園市,桃園區,中興里,29,1743,617,305,922,29,951
公投第１１案,桃園市,桃園區,中興里,30,1862,578,305,883,32,915
公投第１１案,桃園市,桃園區,中興里,31,1728,575,302,877,32,909
公投第１１案,桃園市,桃園區,文化里,32,690,214,136,350,14,364
公投第１１案,桃園市,桃園區,文昌里,33,852,309,176,485,31,516
公投第１１案,桃園市,桃園區,文明里,34,1353,478,268,746,42,788
公投第１１案,桃園市,桃園區,北門里,35,1698,448,218,666,17,683
公投第１１案,桃園市,桃園區,民生里,36,1452,437,259,696,44,740
公投第１１案,桃園市,桃園區,永興里,37,1681,555,281,836,47,883
公投第１１案,桃園市,桃園區,光興里,38,1669,521,279,800,44,844
公投第１１案,桃園市,桃園區,光興里,39,1530,560,296,856,24,880
公投第１１案,桃園市,桃園區,光興里,40,1582,522,308,830,36,866
公投第１１案,桃園市,桃園區,西門里,41,1587,498,237,735,28,763
公投第１１案,桃園市,桃園區,西湖里,42,1451,484,275,759,40,799
公投第１１案,桃園市,桃園區,武陵里,43,1582,438,269,707,32,739
公投第１１案,桃園市,桃園區,長美里,44,1028,360,199,559,29,588
公投第１１案,桃園市,桃園區,南門里,45,1934,609,318,927,39,966
公投第１１案,桃園市,桃園區,南門里,46,1016,351,174,525,34,559
公投第１１案,桃園市,桃園區,南門里,47,1079,370,190,560,24,584
公投第１１案,桃園市,桃園區,南門里,48,1837,583,308,891,16,907
公投第１１案,桃園市,桃園區,南華里,49,1390,486,226,712,42,754
公投第１１案,桃園市,桃園區,中山里,50,1489,513,261,774,21,795
公投第１１案,桃園市,桃園區,中山里,51,1821,622,402,1024,14,1038
公投第１１案,桃園市,桃園區,中山里,52,1563,489,265,754,17,771
公投第１１案,桃園市,桃園區,中山里,53,1697,564,325,889,25,914
公投第１１案,桃園市,桃園區,中平里,54,1740,595,313,908,32,940
公投第１１案,桃園市,桃園區,中平里,55,1626,551,283,834,27,861
公投第１１案,桃園市,桃園區,中平里,56,1239,395,284,679,16,695
公投第１１案,桃園市,桃園區,中正里,57,1766,511,346,857,28,885
公投第１１案,桃園市,桃園區,中正里,58,1555,541,265,806,31,837
公投第１１案,桃園市,桃園區,中正里,59,1831,602,340,942,27,969
公投第１１案,桃園市,桃園區,中成里,60,1115,437,203,640,29,669
公投第１１案,桃園市,桃園區,中成里,61,1562,524,306,830,33,863
公投第１１案,桃園市,桃園區,中成里,62,1744,603,273,876,22,898
公投第１１案,桃園市,桃園區,中信里,63,1838,517,331,848,23,871
公投第１１案,桃園市,桃園區,中信里,64,1889,635,352,987,42,1029
公投第１１案,桃園市,桃園區,中信里,65,1985,560,322,882,46,928
公投第１１案,桃園市,桃園區,中原里,66,1524,551,289,840,34,874
公投第１１案,桃園市,桃園區,中原里,67,1425,545,301,846,27,873
公投第１１案,桃園市,桃園區,中原里,68,1606,578,317,895,31,926
公投第１１案,桃園市,桃園區,中泰里,69,2056,773,370,1143,23,1166
公投第１１案,桃園市,桃園區,中泰里,70,2010,704,380,1084,26,1110
公投第１１案,桃園市,桃園區,中聖里,71,2245,713,363,1076,33,1109
公投第１１案,桃園市,桃園區,中聖里,72,1590,479,333,812,32,844
公投第１１案,桃園市,桃園區,中聖里,73,1536,597,298,895,19,914
公投第１１案,桃園市,桃園區,中路里,74,1949,591,319,910,35,945
公投第１１案,桃園市,桃園區,中路里,75,1965,604,334,938,35,973
公投第１１案,桃園市,桃園區,中德里,76,2414,685,366,1051,37,1088
公投第１１案,桃園市,桃園區,中德里,77,1942,643,318,961,31,992
公投第１１案,桃園市,桃園區,中德里,78,2156,699,360,1059,48,1107
公投第１１案,桃園市,桃園區,文中里,79,1404,476,276,752,42,794
公投第１１案,桃園市,桃園區,文中里,80,1194,469,242,711,20,731
公投第１１案,桃園市,桃園區,玉山里,81,1449,498,281,779,56,835
公投第１１案,桃園市,桃園區,玉山里,82,1803,536,288,824,50,874
公投第１１案,桃園市,桃園區,玉山里,83,1692,584,284,868,36,904
公投第１１案,桃園市,桃園區,泰山里,84,1913,645,333,978,28,1006
公投第１１案,桃園市,桃園區,泰山里,85,1815,609,309,918,36,954
公投第１１案,桃園市,桃園區,龍山里,86,1173,346,205,551,38,589
公投第１１案,桃園市,桃園區,龍山里,87,1162,387,185,572,21,593
公投第１１案,桃園市,桃園區,龍山里,88,1194,343,158,501,52,553
公投第１１案,桃園市,桃園區,龍安里,89,1695,558,301,859,41,900
公投第１１案,桃園市,桃園區,龍安里,90,1797,571,305,876,24,900
公投第１１案,桃園市,桃園區,龍安里,91,1592,554,245,799,21,820
公投第１１案,桃園市,桃園區,龍岡里,92,1780,584,276,860,42,902
公投第１１案,桃園市,桃園區,龍岡里,93,1904,544,303,847,28,875
公投第１１案,桃園市,桃園區,龍岡里,94,2021,636,331,967,30,997
公投第１１案,桃園市,桃園區,龍祥里,95,1545,547,230,777,25,802
公投第１１案,桃園市,桃園區,龍祥里,96,1617,506,245,751,28,779
公投第１１案,桃園市,桃園區,龍祥里,97,1683,551,275,826,15,841
公投第１１案,桃園市,桃園區,龍壽里,98,1834,657,304,961,43,1004
公投第１１案,桃園市,桃園區,龍壽里,99,2055,613,341,954,29,983
公投第１１案,桃園市,桃園區,龍壽里,100,1828,597,283,880,14,894
公投第１１案,桃園市,桃園區,龍鳳里,101,1873,584,306,890,28,918
公投第１１案,桃園市,桃園區,龍鳳里,102,3687,499,233,732,25,757
公投第１１案,桃園市,桃園區,龍鳳里,103,1850,621,253,874,36,910
公投第１１案,桃園市,桃園區,龍鳳里,104,1827,586,307,893,28,921
公投第１１案,桃園市,桃園區,中埔里,105,1149,462,205,667,29,696
公投第１１案,桃園市,桃園區,中埔里,106,1061,374,209,583,41,624
公投第１１案,桃園市,桃園區,中寧里,107,1831,528,309,837,31,868
公投第１１案,桃園市,桃園區,中寧里,108,2168,682,350,1032,37,1069
公投第１１案,桃園市,桃園區,中寧里,109,1874,587,325,912,13,925
公投第１１案,桃園市,桃園區,北埔里,110,1524,436,250,686,19,705
公投第１１案,桃園市,桃園區,北埔里,111,1528,500,292,792,17,809
公投第１１案,桃園市,桃園區,北埔里,112,1489,492,277,769,28,797
公投第１１案,桃園市,桃園區,永安里,113,1308,406,229,635,46,681
公投第１１案,桃園市,桃園區,永安里,114,1583,515,257,772,38,810
公投第１１案,桃園市,桃園區,永安里,115,1618,540,304,844,37,881
公投第１１案,桃園市,桃園區,同安里,116,2127,628,384,1012,48,1060
公投第１１案,桃園市,桃園區,同安里,117,2033,625,339,964,20,984
公投第１１案,桃園市,桃園區,同安里,118,2098,698,338,1036,30,1066
公投第１１案,桃園市,桃園區,同安里,119,2126,751,358,1109,40,1149
公投第１１案,桃園市,桃園區,同德里,120,1917,624,284,908,41,949
公投第１１案,桃園市,桃園區,同德里,121,1997,608,346,954,28,982
公投第１１案,桃園市,桃園區,同德里,122,1929,649,357,1006,25,1031
公投第１１案,桃園市,桃園區,自強里,123,1691,424,405,829,30,859
公投第１１案,桃園市,桃園區,自強里,124,1900,608,336,944,18,962
公投第１１案,桃園市,桃園區,自強里,125,1761,576,315,891,45,936
公投第１１案,桃園市,桃園區,自強里,126,1922,623,335,958,18,976
公投第１１案,桃園市,桃園區,西埔里,127,1995,645,302,947,47,994
公投第１１案,桃園市,桃園區,西埔里,128,1063,379,186,565,25,590
公投第１１案,桃園市,桃園區,明德里,129,1412,463,239,702,29,731
公投第１１案,桃園市,桃園區,明德里,130,1746,572,357,929,15,944
公投第１１案,桃園市,桃園區,東埔里,131,1689,471,301,772,39,811
公投第１１案,桃園市,桃園區,東埔里,132,1542,447,229,676,19,695
公投第１１案,桃園市,桃園區,東埔里,133,1437,467,221,688,34,722
公投第１１案,桃園市,桃園區,長安里,134,1679,540,305,845,25,870
公投第１１案,桃園市,桃園區,長安里,135,1886,556,285,841,34,875
公投第１１案,桃園市,桃園區,長德里,136,1657,532,308,840,49,889
公投第１１案,桃園市,桃園區,長德里,137,1349,453,264,717,18,735
公投第１１案,桃園市,桃園區,長德里,138,1805,592,326,918,21,939
公投第１１案,桃園市,桃園區,信光里,139,1846,570,316,886,50,936
公投第１１案,桃園市,桃園區,信光里,140,1644,509,245,754,26,780
公投第１１案,桃園市,桃園區,信光里,141,1674,494,280,774,29,803
公投第１１案,桃園市,桃園區,信光里,142,1737,556,298,854,29,883
公投第１１案,桃園市,桃園區,南埔里,143,1566,533,274,807,35,842
公投第１１案,桃園市,桃園區,南埔里,144,1517,499,279,778,34,812
公投第１１案,桃園市,桃園區,南埔里,145,1619,471,254,725,26,751
公投第１１案,桃園市,桃園區,莊敬里,146,1774,558,307,865,34,899
公投第１１案,桃園市,桃園區,莊敬里,147,1666,568,276,844,24,868
公投第１１案,桃園市,桃園區,莊敬里,148,1528,508,278,786,13,799
公投第１１案,桃園市,桃園區,莊敬里,149,1709,525,300,825,33,858
公投第１１案,桃園市,桃園區,莊敬里,150,1719,512,344,856,15,871
公投第１１案,桃園市,桃園區,慈文里,151,1569,468,231,699,36,735
公投第１１案,桃園市,桃園區,慈文里,152,1505,498,228,726,50,776
公投第１１案,桃園市,桃園區,慈文里,153,1496,488,241,729,34,763
公投第１１案,桃園市,桃園區,慈文里,154,1505,509,272,781,22,803
公投第１１案,桃園市,桃園區,新埔里,155,1807,560,328,888,24,912
公投第１１案,桃園市,桃園區,新埔里,156,1857,615,315,930,34,964
公投第１１案,桃園市,桃園區,新埔里,157,1589,566,274,840,54,894
公投第１１案,桃園市,桃園區,新埔里,158,2088,660,370,1030,31,1061
公投第１１案,桃園市,桃園區,新埔里,159,1893,595,325,920,32,952
公投第１１案,桃園市,桃園區,瑞慶里,160,1303,394,186,580,24,604
公投第１１案,桃園市,桃園區,瑞慶里,161,1416,463,261,724,34,758
公投第１１案,桃園市,桃園區,瑞慶里,162,1351,419,226,645,23,668
公投第１１案,桃園市,桃園區,瑞慶里,163,1659,511,284,795,22,817
公投第１１案,桃園市,桃園區,寶安里,164,2103,683,311,994,20,1014
公投第１１案,桃園市,桃園區,寶安里,165,1943,612,333,945,20,965
公投第１１案,桃園市,桃園區,寶安里,166,1927,612,333,945,33,978
公投第１１案,桃園市,桃園區,寶安里,167,1929,564,283,847,32,879
公投第１１案,桃園市,桃園區,寶慶里,168,2204,771,436,1207,28,1235
公投第１１案,桃園市,桃園區,寶慶里,169,2033,535,379,914,18,932
公投第１１案,桃園市,桃園區,寶慶里,170,1656,570,256,826,17,843
公投第１１案,桃園市,桃園區,三元里,171,1712,529,295,824,44,868
公投第１１案,桃園市,桃園區,三元里,172,1738,538,310,848,29,877
公投第１１案,桃園市,桃園區,三民里,173,1432,617,284,901,13,914
公投第１１案,桃園市,桃園區,三民里,174,1421,496,292,788,32,820
公投第１１案,桃園市,桃園區,三民里,175,1344,446,247,693,10,703
公投第１１案,桃園市,桃園區,大有里,176,1942,592,292,884,18,902
公投第１１案,桃園市,桃園區,大有里,177,2001,661,325,986,23,1009
公投第１１案,桃園市,桃園區,大有里,178,1941,564,305,869,20,889
公投第１１案,桃園市,桃園區,大業里,179,1702,563,335,898,28,926
公投第１１案,桃園市,桃園區,大業里,180,1589,504,289,793,26,819
公投第１１案,桃園市,桃園區,大業里,181,1544,528,243,771,25,796
公投第１１案,桃園市,桃園區,大興里,182,1860,531,259,790,32,822
公投第１１案,桃園市,桃園區,大興里,183,1726,537,288,825,44,869
公投第１１案,桃園市,桃園區,大興里,184,1798,533,305,838,31,869
公投第１１案,桃園市,桃園區,成功里,185,1925,602,350,952,35,987
公投第１１案,桃園市,桃園區,成功里,186,1945,598,352,950,32,982
公投第１１案,桃園市,桃園區,汴洲里,187,1764,495,303,798,36,834
公投第１１案,桃園市,桃園區,汴洲里,188,1899,688,293,981,50,1031
公投第１１案,桃園市,桃園區,汴洲里,189,1415,462,255,717,15,732
公投第１１案,桃園市,桃園區,忠義里,190,1790,546,285,831,22,853
公投第１１案,桃園市,桃園區,忠義里,191,1693,485,295,780,19,799
公投第１１案,桃園市,桃園區,東山里,192,1916,591,319,910,39,949
公投第１１案,桃園市,桃園區,東門里,193,1434,429,237,666,17,683
公投第１１案,桃園市,桃園區,東門里,194,1494,522,298,820,32,852
公投第１１案,桃園市,桃園區,青溪里,195,1311,444,230,674,49,723
公投第１１案,桃園市,桃園區,青溪里,196,1476,492,258,750,40,790
公投第１１案,桃園市,桃園區,青溪里,197,1484,491,319,810,23,833
公投第１１案,桃園市,桃園區,春日里,198,1514,481,268,749,24,773
公投第１１案,桃園市,桃園區,春日里,199,1446,509,215,724,28,752
公投第１１案,桃園市,桃園區,春日里,200,1573,507,251,758,24,782
公投第１１案,桃園市,桃園區,春日里,201,1564,458,236,694,25,719
公投第１１案,桃園市,桃園區,朝陽里,202,1015,353,193,546,30,576
公投第１１案,桃園市,桃園區,朝陽里,203,955,305,164,469,22,491
公投第１１案,桃園市,桃園區,會稽里,204,1796,640,232,872,29,901
公投第１１案,桃園市,桃園區,會稽里,205,1878,574,322,896,16,912
公投第１１案,桃園市,桃園區,會稽里,206,1729,554,271,825,27,852
公投第１１案,桃園市,桃園區,會稽里,207,1843,556,265,821,17,838
公投第１１案,桃園市,桃園區,會稽里,208,1817,496,269,765,19,784
公投第１１案,桃園市,桃園區,萬壽里,209,979,366,167,533,21,554
公投第１１案,桃園市,桃園區,福元里,210,1363,445,264,709,15,724
公投第１１案,桃園市,桃園區,福元里,211,1546,521,255,776,18,794
公投第１１案,桃園市,桃園區,福元里,212,1308,414,224,638,24,662
公投第１１案,桃園市,桃園區,寶山里,213,2164,679,348,1027,44,1071
公投第１１案,桃園市,桃園區,寶山里,214,2020,603,332,935,40,975
公投第１１案,桃園市,桃園區,寶山里,215,1924,556,278,834,27,861
公投第１１案,桃園市,桃園區,寶山里,216,2088,281,579,860,37,897
公投第１１案,桃園市,龜山區,精忠里,217,874,342,128,470,21,491
公投第１１案,桃園市,龜山區,精忠里,218,2014,767,253,1020,51,1071
公投第１１案,桃園市,龜山區,精忠里,219,2145,658,372,1030,26,1056
公投第１１案,桃園市,龜山區,陸光里,220,1744,698,207,905,42,947
公投第１１案,桃園市,龜山區,陸光里,221,1885,753,232,985,40,1025
公投第１１案,桃園市,龜山區,中興里,222,1546,495,214,709,45,754
公投第１１案,桃園市,龜山區,中興里,223,1684,516,282,798,41,839
公投第１１案,桃園市,龜山區,中興里,224,1477,454,216,670,30,700
公投第１１案,桃園市,龜山區,新興里,225,1528,591,225,816,41,857
公投第１１案,桃園市,龜山區,新興里,226,1428,181,98,279,14,293
公投第１１案,桃園市,龜山區,新路里,227,1525,548,257,805,31,836
公投第１１案,桃園市,龜山區,新路里,228,1041,391,197,588,23,611
公投第１１案,桃園市,龜山區,新路里,229,1404,436,260,696,21,717
公投第１１案,桃園市,龜山區,新路里,230,1478,539,239,778,38,816
公投第１１案,桃園市,龜山區,龜山里,231,2178,750,326,1076,46,1122
公投第１１案,桃園市,龜山區,龜山里,232,1672,560,281,841,60,901
公投第１１案,桃園市,龜山區,龜山里,233,1376,446,209,655,27,682
公投第１１案,桃園市,龜山區,龜山里,234,1480,470,258,728,27,755
公投第１１案,桃園市,龜山區,大同里,235,1258,450,206,656,35,691
公投第１１案,桃園市,龜山區,大同里,236,1464,495,241,736,21,757
公投第１１案,桃園市,龜山區,大同里,237,1844,570,320,890,51,941
公投第１１案,桃園市,龜山區,大同里,238,1169,362,234,596,15,611
公投第１１案,桃園市,龜山區,山頂里,239,1921,487,242,729,32,761
公投第１１案,桃園市,龜山區,山頂里,240,1694,518,266,784,25,809
公投第１１案,桃園市,龜山區,山頂里,241,1771,598,344,942,46,988
公投第１１案,桃園市,龜山區,山德里,242,1665,494,243,737,49,786
公投第１１案,桃園市,龜山區,山德里,243,1439,442,255,697,49,746
公投第１１案,桃園市,龜山區,山德里,244,1728,521,223,744,48,792
公投第１１案,桃園市,龜山區,山福里,245,1788,611,295,906,30,936
公投第１１案,桃園市,龜山區,山福里,246,1465,440,232,672,35,707
公投第１１案,桃園市,龜山區,幸福里,247,1659,427,229,656,39,695
公投第１１案,桃園市,龜山區,幸福里,248,1693,455,260,715,33,748
公投第１１案,桃園市,龜山區,幸福里,249,1818,440,251,691,17,708
公投第１１案,桃園市,龜山區,龍壽里,250,1752,540,303,843,50,893
公投第１１案,桃園市,龜山區,龍華里,251,1818,576,338,914,23,937
公投第１１案,桃園市,龜山區,龍華里,252,1499,480,263,743,20,763
公投第１１案,桃園市,龜山區,迴龍里,253,1916,587,360,947,34,981
公投第１１案,桃園市,龜山區,迴龍里,254,1804,581,316,897,28,925
公投第１１案,桃園市,龜山區,迴龍里,255,2127,630,370,1000,23,1023
公投第１１案,桃園市,龜山區,嶺頂里,256,1005,313,181,494,42,536
公投第１１案,桃園市,龜山區,嶺頂里,257,1449,470,273,743,44,787
公投第１１案,桃園市,龜山區,嶺頂里,258,1498,405,270,675,53,728
公投第１１案,桃園市,龜山區,新嶺里,259,2149,631,285,916,40,956
公投第１１案,桃園市,龜山區,新嶺里,260,1771,432,248,680,37,717
公投第１１案,桃園市,龜山區,兔坑里,261,841,288,145,433,19,452
公投第１１案,桃園市,龜山區,兔坑里,262,2284,664,334,998,48,1046
公投第１１案,桃園市,龜山區,兔坑里,263,1228,420,205,625,31,656
公投第１１案,桃園市,龜山區,福源里,264,1979,629,283,912,30,942
公投第１１案,桃園市,龜山區,舊路里,265,1378,420,200,620,34,654
公投第１１案,桃園市,龜山區,舊路里,266,1061,329,173,502,34,536
公投第１１案,桃園市,龜山區,大坑里,267,1917,587,289,876,45,921
公投第１１案,桃園市,龜山區,楓福里,268,1540,579,294,873,30,903
公投第１１案,桃園市,龜山區,楓福里,269,1433,508,244,752,26,778
公投第１１案,桃園市,龜山區,楓樹里,270,1455,458,262,720,24,744
公投第１１案,桃園市,龜山區,楓樹里,271,2280,778,393,1171,54,1225
公投第１１案,桃園市,龜山區,樂善里,272,1668,520,303,823,35,858
公投第１１案,桃園市,龜山區,樂善里,273,1885,572,328,900,31,931
公投第１１案,桃園市,龜山區,長庚里,274,1849,500,393,893,8,901
公投第１１案,桃園市,龜山區,長庚里,275,1704,489,444,933,14,947
公投第１１案,桃園市,龜山區,公西里,276,1156,374,208,582,35,617
公投第１１案,桃園市,龜山區,大崗里,277,2114,546,308,854,43,897
公投第１１案,桃園市,龜山區,大崗里,278,1943,493,313,806,28,834
公投第１１案,桃園市,龜山區,大湖里,279,1800,502,316,818,19,837
公投第１１案,桃園市,龜山區,大湖里,280,2020,554,384,938,37,975
公投第１１案,桃園市,龜山區,大湖里,281,1319,449,260,709,24,733
公投第１１案,桃園市,龜山區,大華里,282,2229,736,413,1149,40,1189
公投第１１案,桃園市,龜山區,大華里,283,1992,578,333,911,26,937
公投第１１案,桃園市,龜山區,大華里,284,2237,662,341,1003,36,1039
公投第１１案,桃園市,龜山區,大華里,285,2133,614,378,992,32,1024
公投第１１案,桃園市,龜山區,文化里,286,2187,656,415,1071,37,1108
公投第１１案,桃園市,龜山區,文化里,287,1959,596,326,922,32,954
公投第１１案,桃園市,龜山區,文化里,288,1910,529,331,860,30,890
公投第１１案,桃園市,龜山區,南上里,289,1840,630,297,927,55,982
公投第１１案,桃園市,龜山區,南美里,290,2266,758,346,1104,24,1128
公投第１１案,桃園市,龜山區,文青里,291,2387,698,350,1048,25,1073
公投第１１案,桃園市,龜山區,文青里,292,1692,517,278,795,18,813
公投第１１案,桃園市,龜山區,文青里,293,904,269,182,451,15,466
公投第１１案,桃園市,龜山區,文青里,294,1469,504,257,761,25,786
公投第１１案,桃園市,八德區,興仁里,295,1761,530,253,783,51,834
公投第１１案,桃園市,八德區,興仁里,296,1804,466,250,716,18,734
公投第１１案,桃園市,八德區,興仁里,297,1813,325,167,492,19,511
公投第１１案,桃園市,八德區,興仁里,298,1784,519,283,802,25,827
公投第１１案,桃園市,八德區,福興里,299,2257,646,286,932,22,954
公投第１１案,桃園市,八德區,福興里,300,1857,533,237,770,25,795
公投第１１案,桃園市,八德區,福興里,301,2261,667,297,964,34,998
公投第１１案,桃園市,八德區,福興里,302,1903,629,317,946,41,987
公投第１１案,桃園市,八德區,瑞豐里,303,1955,647,283,930,48,978
公投第１１案,桃園市,八德區,瑞豐里,304,1665,483,241,724,17,741
公投第１１案,桃園市,八德區,瑞興里,305,1431,470,271,741,32,773
公投第１１案,桃園市,八德區,瑞興里,306,1263,486,186,672,29,701
公投第１１案,桃園市,八德區,瑞泰里,307,1583,566,267,833,35,868
公投第１１案,桃園市,八德區,瑞泰里,308,1246,427,228,655,29,684
公投第１１案,桃園市,八德區,瑞泰里,309,1356,471,222,693,30,723
公投第１１案,桃園市,八德區,瑞發里,310,1630,579,268,847,57,904
公投第１１案,桃園市,八德區,瑞發里,311,1586,552,233,785,25,810
公投第１１案,桃園市,八德區,瑞德里,312,1649,566,253,819,57,876
公投第１１案,桃園市,八德區,瑞德里,313,1910,573,262,835,62,897
公投第１１案,桃園市,八德區,瑞祥里,314,1612,580,243,823,70,893
公投第１１案,桃園市,八德區,瑞祥里,315,1640,591,230,821,36,857
公投第１１案,桃園市,八德區,廣德里,316,1303,413,224,637,38,675
公投第１１案,桃園市,八德區,廣德里,317,1413,488,273,761,46,807
公投第１１案,桃園市,八德區,廣興里,318,1711,570,270,840,34,874
公投第１１案,桃園市,八德區,廣興里,319,1562,549,233,782,55,837
公投第１１案,桃園市,八德區,廣隆里,320,1735,606,276,882,1,883
公投第１１案,桃園市,八德區,廣隆里,321,1658,564,260,824,24,848
公投第１１案,桃園市,八德區,廣隆里,322,1022,401,179,580,34,614
公投第１１案,桃園市,八德區,竹園里,323,1673,502,230,732,39,771
公投第１１案,桃園市,八德區,竹園里,324,1741,576,251,827,33,860
公投第１１案,桃園市,八德區,霄裡里,325,2110,691,325,1016,51,1067
公投第１１案,桃園市,八德區,龍友里,326,1145,434,152,586,28,614
公投第１１案,桃園市,八德區,龍友里,327,1010,435,151,586,36,622
公投第１１案,桃園市,八德區,茄明里,328,1848,527,271,798,26,824
公投第１１案,桃園市,八德區,茄明里,329,1334,492,212,704,27,731
公投第１１案,桃園市,八德區,茄明里,330,1349,382,195,577,19,596
公投第１１案,桃園市,八德區,茄苳里,331,1341,473,251,724,38,762
公投第１１案,桃園市,八德區,茄苳里,332,1178,460,179,639,42,681
公投第１１案,桃園市,八德區,永豐里,333,1374,466,245,711,37,748
公投第１１案,桃園市,八德區,永豐里,334,1462,434,253,687,53,740
公投第１１案,桃園市,八德區,高明里,335,1943,557,257,814,52,866
公投第１１案,桃園市,八德區,高明里,336,1928,452,252,704,59,763
公投第１１案,桃園市,八德區,高城里,337,1403,447,220,667,22,689
公投第１１案,桃園市,八德區,高城里,338,1672,499,257,756,49,805
公投第１１案,桃園市,八德區,白鷺里,339,1947,569,300,869,36,905
公投第１１案,桃園市,八德區,白鷺里,340,1200,416,205,621,37,658
公投第１１案,桃園市,八德區,大湳里,341,1895,565,288,853,45,898
公投第１１案,桃園市,八德區,大湳里,342,1988,577,295,872,43,915
公投第１１案,桃園市,八德區,大發里,343,2006,664,334,998,44,1042
公投第１１案,桃園市,八德區,大仁里,344,2061,604,311,915,5,920
公投第１１案,桃園市,八德區,大仁里,345,2108,613,312,925,56,981
公投第１１案,桃園市,八德區,大明里,346,1862,577,270,847,42,889
公投第１１案,桃園市,八德區,大明里,347,1681,503,184,687,23,710
公投第１１案,桃園市,八德區,大安里,348,1317,468,207,675,49,724
公投第１１案,桃園市,八德區,大安里,349,2093,709,420,1129,37,1166
公投第１１案,桃園市,八德區,大竹里,350,1499,539,268,807,47,854
公投第１１案,桃園市,八德區,大興里,351,1782,582,263,845,64,909
公投第１１案,桃園市,八德區,大興里,352,1763,593,296,889,21,910
公投第１１案,桃園市,八德區,大愛里,353,1226,411,216,627,46,673
公投第１１案,桃園市,八德區,大愛里,354,1311,452,255,707,19,726
公投第１１案,桃園市,八德區,大華里,355,1170,411,223,634,31,665
公投第１１案,桃園市,八德區,大華里,356,1313,494,202,696,30,726
公投第１１案,桃園市,八德區,大順里,357,1186,403,217,620,21,641
公投第１１案,桃園市,八德區,大順里,358,1481,447,246,693,29,722
公投第１１案,桃園市,八德區,大和里,359,1998,633,342,975,50,1025
公投第１１案,桃園市,八德區,大和里,360,916,325,163,488,27,515
公投第１１案,桃園市,八德區,大和里,361,1943,606,294,900,28,928
公投第１１案,桃園市,八德區,大和里,362,2076,676,302,978,38,1016
公投第１１案,桃園市,八德區,大昌里,363,1363,479,204,683,54,737
公投第１１案,桃園市,八德區,大昌里,364,1491,520,222,742,47,789
公投第１１案,桃園市,八德區,大信里,365,1474,487,222,709,53,762
公投第１１案,桃園市,八德區,大信里,366,718,132,32,164,11,175
公投第１１案,桃園市,八德區,大信里,367,1386,453,235,688,42,730
公投第１１案,桃園市,八德區,陸光里,368,1487,504,215,719,53,772
公投第１１案,桃園市,八德區,陸光里,369,1552,550,203,753,60,813
公投第１１案,桃園市,八德區,陸光里,370,1255,422,154,576,38,614
公投第１１案,桃園市,八德區,大同里,371,1505,525,281,806,36,842
公投第１１案,桃園市,八德區,大慶里,372,1436,461,212,673,30,703
公投第１１案,桃園市,八德區,大成里,373,1618,426,398,824,58,882
公投第１１案,桃園市,八德區,大成里,374,1685,590,221,811,43,854
公投第１１案,桃園市,八德區,大義里,375,1835,539,272,811,37,848
公投第１１案,桃園市,八德區,大義里,376,1881,622,293,915,39,954
公投第１１案,桃園市,八德區,大忠里,377,1766,582,248,830,35,865
公投第１１案,桃園市,八德區,大智里,378,1817,587,270,857,69,926
公投第１１案,桃園市,八德區,大智里,379,2198,778,335,1113,20,1133
公投第１１案,桃園市,八德區,大宏里,380,1732,592,304,896,30,926
公投第１１案,桃園市,八德區,大宏里,381,2089,669,393,1062,13,1075
公投第１１案,桃園市,八德區,大正里,382,1257,466,223,689,32,721
公投第１１案,桃園市,八德區,大正里,383,1267,416,204,620,34,654
公投第１１案,桃園市,八德區,大正里,384,1427,501,259,760,17,777
公投第１１案,桃園市,八德區,大福里,385,1685,626,305,931,45,976
公投第１１案,桃園市,八德區,大福里,386,1748,607,295,902,44,946
公投第１１案,桃園市,八德區,大福里,387,1650,793,297,1090,45,1135
公投第１１案,桃園市,八德區,大強里,388,1478,495,273,768,37,805
公投第１１案,桃園市,八德區,大強里,389,1607,594,244,838,31,869
公投第１１案,桃園市,八德區,大勇里,390,1841,640,339,979,49,1028
公投第１１案,桃園市,八德區,大勇里,391,2082,671,342,1013,36,1049
公投第１１案,桃園市,八德區,大榮里,392,1959,587,286,873,42,915
公投第１１案,桃園市,八德區,大千里,393,2209,666,424,1090,46,1136
公投第１１案,桃園市,八德區,大漢里,394,1864,618,308,926,38,964
公投第１１案,桃園市,八德區,大漢里,395,2000,600,357,957,40,997
公投第１１案,桃園市,蘆竹區,新興里,396,1358,458,200,658,59,717
公投第１１案,桃園市,蘆竹區,新興里,397,1538,508,224,732,55,787
公投第１１案,桃園市,蘆竹區,中福里,398,2118,615,239,854,44,898
公投第１１案,桃園市,蘆竹區,中福里,399,1673,615,274,889,52,941
公投第１１案,桃園市,蘆竹區,上興里,400,1500,539,268,807,18,825
公投第１１案,桃園市,蘆竹區,上興里,401,1699,613,262,875,24,899
公投第１１案,桃園市,蘆竹區,中興里,402,2250,756,358,1114,34,1148
公投第１１案,桃園市,蘆竹區,中興里,403,2354,680,360,1040,17,1057
公投第１１案,桃園市,蘆竹區,新莊里,404,1446,478,213,691,25,716
公投第１１案,桃園市,蘆竹區,新莊里,405,1623,491,240,731,49,780
公投第１１案,桃園市,蘆竹區,新莊里,406,1747,552,288,840,21,861
公投第１１案,桃園市,蘆竹區,上竹里,407,1988,662,330,992,36,1028
公投第１１案,桃園市,蘆竹區,上竹里,408,1437,509,226,735,26,761
公投第１１案,桃園市,蘆竹區,宏竹里,409,1532,571,253,824,37,861
公投第１１案,桃園市,蘆竹區,宏竹里,410,1447,462,242,704,37,741
公投第１１案,桃園市,蘆竹區,大竹里,411,2189,729,354,1083,37,1120
公投第１１案,桃園市,蘆竹區,大竹里,412,2498,812,334,1146,33,1179
公投第１１案,桃園市,蘆竹區,富竹里,413,1322,465,233,698,24,722
公投第１１案,桃園市,蘆竹區,蘆竹里,414,1991,530,269,799,47,846
公投第１１案,桃園市,蘆竹區,蘆竹里,415,2097,615,320,935,53,988
公投第１１案,桃園市,蘆竹區,南興里,416,1558,532,290,822,29,851
公投第１１案,桃園市,蘆竹區,南興里,417,1891,611,352,963,25,988
公投第１１案,桃園市,蘆竹區,南興里,418,1590,488,257,745,28,773
公投第１１案,桃園市,蘆竹區,福昌里,419,2404,712,324,1036,46,1082
公投第１１案,桃園市,蘆竹區,福昌里,420,2522,818,396,1214,30,1244
公投第１１案,桃園市,蘆竹區,福興里,421,1633,548,275,823,21,844
公投第１１案,桃園市,蘆竹區,福興里,422,1715,568,291,859,30,889
公投第１１案,桃園市,蘆竹區,正興里,423,2215,660,357,1017,19,1036
公投第１１案,桃園市,蘆竹區,正興里,424,2029,634,319,953,28,981
公投第１１案,桃園市,蘆竹區,順興里,425,1731,524,283,807,25,832
公投第１１案,桃園市,蘆竹區,順興里,426,1820,611,290,901,23,924
公投第１１案,桃園市,蘆竹區,蘆興里,427,1633,565,285,850,32,882
公投第１１案,桃園市,蘆竹區,南榮里,428,1668,530,259,789,21,810
公投第１１案,桃園市,蘆竹區,南榮里,429,1493,526,279,805,16,821
公投第１１案,桃園市,蘆竹區,南崁里,430,1864,651,292,943,32,975
公投第１１案,桃園市,蘆竹區,南崁里,431,1703,536,301,837,23,860
公投第１１案,桃園市,蘆竹區,錦興里,432,1893,621,333,954,29,983
公投第１１案,桃園市,蘆竹區,錦興里,433,1922,671,366,1037,22,1059
公投第１１案,桃園市,蘆竹區,興榮里,434,1393,531,213,744,14,758
公投第１１案,桃園市,蘆竹區,興榮里,435,1338,493,228,721,18,739
公投第１１案,桃園市,蘆竹區,錦中里,436,1688,569,272,841,15,856
公投第１１案,桃園市,蘆竹區,錦中里,437,1462,478,241,719,34,753
公投第１１案,桃園市,蘆竹區,長興里,438,1232,435,191,626,23,649
公投第１１案,桃園市,蘆竹區,長興里,439,1356,410,211,621,27,648
公投第１１案,桃園市,蘆竹區,五福里,440,1181,467,228,695,26,721
公投第１１案,桃園市,蘆竹區,五福里,441,1199,403,186,589,18,607
公投第１１案,桃園市,蘆竹區,中山里,442,1710,586,298,884,17,901
公投第１１案,桃園市,蘆竹區,中山里,443,1423,446,239,685,24,709
公投第１１案,桃園市,蘆竹區,福祿里,444,1522,490,309,799,20,819
公投第１１案,桃園市,蘆竹區,福祿里,445,1639,559,184,743,25,768
公投第１１案,桃園市,蘆竹區,羊稠里,446,2055,672,324,996,32,1028
公投第１１案,桃園市,蘆竹區,羊稠里,447,2178,657,407,1064,33,1097
公投第１１案,桃園市,蘆竹區,吉祥里,448,1709,557,331,888,38,926
公投第１１案,桃園市,蘆竹區,長壽里,449,1667,581,304,885,35,920
公投第１１案,桃園市,蘆竹區,長壽里,450,1745,602,329,931,13,944
公投第１１案,桃園市,蘆竹區,長壽里,451,1967,678,371,1049,29,1078
公投第１１案,桃園市,蘆竹區,吉祥里,452,1802,670,323,993,21,1014
公投第１１案,桃園市,蘆竹區,營盤里,453,2727,873,428,1301,28,1329
公投第１１案,桃園市,蘆竹區,營盤里,454,1868,549,317,866,25,891
公投第１１案,桃園市,蘆竹區,營福里,455,1537,490,262,752,30,782
公投第１１案,桃園市,蘆竹區,營福里,456,1616,517,306,823,26,849
公投第１１案,桃園市,蘆竹區,瓦窯里,457,1483,573,262,835,25,860
公投第１１案,桃園市,蘆竹區,瓦窯里,458,1689,554,254,808,39,847
公投第１１案,桃園市,蘆竹區,內厝里,459,1318,379,169,548,19,567
公投第１１案,桃園市,蘆竹區,內厝里,460,1203,507,208,715,56,771
公投第１１案,桃園市,蘆竹區,山鼻里,461,1771,553,270,823,22,845
公投第１１案,桃園市,蘆竹區,山腳里,462,1832,574,259,833,32,865
公投第１１案,桃園市,蘆竹區,山腳里,463,1763,564,262,826,63,889
公投第１１案,桃園市,蘆竹區,外社里,464,1497,415,235,650,24,674
公投第１１案,桃園市,蘆竹區,坑子里,465,1671,604,287,891,102,993
公投第１１案,桃園市,蘆竹區,坑口里,466,929,337,155,492,45,537
公投第１１案,桃園市,蘆竹區,坑口里,467,1559,567,259,826,45,871
公投第１１案,桃園市,蘆竹區,海湖里,468,1497,541,243,784,29,813
公投第１１案,桃園市,蘆竹區,海湖里,469,1441,606,264,870,42,912
公投第１１案,桃園市,蘆竹區,濱海里,470,1465,479,222,701,51,752
公投第１１案,桃園市,蘆竹區,濱海里,471,1029,336,165,501,32,533
公投第１１案,桃園市,大園區,大園里,472,1538,452,222,674,28,702
公投第１１案,桃園市,大園區,大園里,473,1616,441,204,645,18,663
公投第１１案,桃園市,大園區,大園里,474,1437,517,257,774,40,814
公投第１１案,桃園市,大園區,大園里,475,1554,579,256,835,25,860
公投第１１案,桃園市,大園區,田心里,476,1237,377,230,607,29,636
公投第１１案,桃園市,大園區,田心里,477,1347,455,210,665,36,701
公投第１１案,桃園市,大園區,田心里,478,1261,396,235,631,26,657
公投第１１案,桃園市,大園區,田心里,479,1256,393,203,596,42,638
公投第１１案,桃園市,大園區,田心里,480,1370,436,198,634,19,653
公投第１１案,桃園市,大園區,溪海里,481,1610,477,237,714,33,747
公投第１１案,桃園市,大園區,溪海里,482,1419,462,211,673,41,714
公投第１１案,桃園市,大園區,溪海里,483,1588,433,197,630,27,657
公投第１１案,桃園市,大園區,和平里,484,1612,507,270,777,41,818
公投第１１案,桃園市,大園區,橫峰里,485,1440,440,238,678,40,718
公投第１１案,桃園市,大園區,橫峰里,486,1326,399,224,623,27,650
公投第１１案,桃園市,大園區,橫峰里,487,1455,551,232,783,39,822
公投第１１案,桃園市,大園區,橫峰里,488,1562,518,271,789,51,840
公投第１１案,桃園市,大園區,橫峰里,489,1284,451,249,700,29,729
公投第１１案,桃園市,大園區,橫峰里,490,1454,415,263,678,15,693
公投第１１案,桃園市,大園區,橫峰里,491,1490,469,275,744,15,759
公投第１１案,桃園市,大園區,五權里,492,1617,510,239,749,25,774
公投第１１案,桃園市,大園區,五權里,493,1594,537,271,808,27,835
公投第１１案,桃園市,大園區,五權里,494,1650,566,239,805,42,847
公投第１１案,桃園市,大園區,埔心里,495,1467,449,244,693,21,714
公投第１１案,桃園市,大園區,埔心里,496,1494,498,243,741,25,766
公投第１１案,桃園市,大園區,埔心里,497,1538,505,243,748,35,783
公投第１１案,桃園市,大園區,埔心里,498,1397,472,219,691,26,717
公投第１１案,桃園市,大園區,大海里,499,1637,516,244,760,22,782
公投第１１案,桃園市,大園區,三石里,500,1452,464,206,670,33,703
公投第１１案,桃園市,大園區,三石里,501,1414,582,254,836,34,870
公投第１１案,桃園市,大園區,菓林里,502,1670,596,256,852,22,874
公投第１１案,桃園市,大園區,菓林里,503,1701,549,251,800,4,804
公投第１１案,桃園市,大園區,菓林里,504,1813,545,238,783,20,803
公投第１１案,桃園市,大園區,菓林里,505,1687,532,268,800,19,819
公投第１１案,桃園市,大園區,竹圍里,506,1650,562,274,836,6,842
公投第１１案,桃園市,大園區,竹圍里,507,1556,551,301,852,32,884
公投第１１案,桃園市,大園區,海口里,508,1844,532,275,807,17,824
公投第１１案,桃園市,大園區,沙崙里,509,1336,402,203,605,48,653
公投第１１案,桃園市,大園區,沙崙里,510,1414,577,171,748,39,787
公投第１１案,桃園市,大園區,後厝里,511,1238,481,229,710,38,748
公投第１１案,桃園市,大園區,後厝里,512,1227,495,211,706,34,740
公投第１１案,桃園市,大園區,圳頭里,513,1199,376,218,594,21,615
公投第１１案,桃園市,大園區,圳頭里,514,1349,410,199,609,26,635
公投第１１案,桃園市,大園區,內海里,515,1120,352,197,549,31,580
公投第１１案,桃園市,大園區,內海里,516,1080,369,182,551,22,573
公投第１１案,桃園市,大園區,北港里,517,1341,416,203,619,39,658
公投第１１案,桃園市,大園區,北港里,518,1345,461,225,686,27,713
公投第１１案,桃園市,大園區,南港里,519,1565,454,228,682,23,705
公投第１１案,桃園市,大園區,南港里,520,1519,423,212,635,23,658
公投第１１案,桃園市,大園區,南港里,521,2130,654,283,937,50,987
公投第１１案,桃園市,大溪區,興和里,522,1477,508,283,791,46,837
公投第１１案,桃園市,大溪區,福仁里,523,1006,358,183,541,20,561
公投第１１案,桃園市,大溪區,田心里,524,1553,533,232,765,49,814
公投第１１案,桃園市,大溪區,田心里,525,1597,513,305,818,54,872
公投第１１案,桃園市,大溪區,田心里,526,1358,470,221,691,36,727
公投第１１案,桃園市,大溪區,一心里,527,1585,497,240,737,26,763
公投第１１案,桃園市,大溪區,一心里,528,1612,510,281,791,46,837
公投第１１案,桃園市,大溪區,一心里,529,1555,476,221,697,33,730
公投第１１案,桃園市,大溪區,一德里,530,1282,486,251,737,38,775
公投第１１案,桃園市,大溪區,一德里,531,1392,470,220,690,42,732
公投第１１案,桃園市,大溪區,一德里,532,1422,461,227,688,36,724
公投第１１案,桃園市,大溪區,一德里,533,1448,497,241,738,53,791
公投第１１案,桃園市,大溪區,月眉里,534,1269,477,257,734,44,778
公投第１１案,桃園市,大溪區,永福里,535,977,351,183,534,56,590
公投第１１案,桃園市,大溪區,康安里,536,1359,474,248,722,49,771
公投第１１案,桃園市,大溪區,義和里,537,1135,405,238,643,51,694
公投第１１案,桃園市,大溪區,義和里,538,660,190,121,311,41,352
公投第１１案,桃園市,大溪區,美華里,539,1056,294,191,485,48,533
公投第１１案,桃園市,大溪區,美華里,540,1263,409,198,607,46,653
公投第１１案,桃園市,大溪區,美華里,541,717,244,122,366,36,402
公投第１１案,桃園市,大溪區,福安里,542,1299,356,172,528,33,561
公投第１１案,桃園市,大溪區,福安里,543,976,334,159,493,50,543
公投第１１案,桃園市,大溪區,復興里,544,938,335,145,480,30,510
公投第１１案,桃園市,大溪區,新峰里,545,832,278,126,404,28,432
公投第１１案,桃園市,大溪區,中新里,546,866,266,114,380,23,403
公投第１１案,桃園市,大溪區,中新里,547,694,189,125,314,32,346
公投第１１案,桃園市,大溪區,瑞興里,548,1410,438,230,668,41,709
公投第１１案,桃園市,大溪區,瑞興里,549,1303,456,158,614,37,651
公投第１１案,桃園市,大溪區,仁善里,550,1125,361,201,562,28,590
公投第１１案,桃園市,大溪區,仁善里,551,1170,404,216,620,23,643
公投第１１案,桃園市,大溪區,仁善里,552,1308,475,265,740,24,764
公投第１１案,桃園市,大溪區,仁美里,553,1094,372,197,569,50,619
公投第１１案,桃園市,大溪區,仁美里,554,2153,810,300,1110,40,1150
公投第１１案,桃園市,大溪區,僑愛里,555,1173,600,49,649,29,678
公投第１１案,桃園市,大溪區,僑愛里,556,1369,486,202,688,20,708
公投第１１案,桃園市,大溪區,仁義里,557,1446,516,185,701,43,744
公投第１１案,桃園市,大溪區,仁義里,558,1406,438,145,583,40,623
公投第１１案,桃園市,大溪區,仁和里,559,1592,590,240,830,30,860
公投第１１案,桃園市,大溪區,仁和里,560,1497,571,244,815,40,855
公投第１１案,桃園市,大溪區,仁和里,561,1559,562,276,838,52,890
公投第１１案,桃園市,大溪區,仁愛里,562,1684,593,256,849,18,867
公投第１１案,桃園市,大溪區,仁愛里,563,1959,705,340,1045,45,1090
公投第１１案,桃園市,大溪區,仁愛里,564,1369,539,212,751,32,783
公投第１１案,桃園市,大溪區,仁武里,565,1431,529,237,766,41,807
公投第１１案,桃園市,大溪區,仁武里,566,1657,468,202,670,22,692
公投第１１案,桃園市,大溪區,仁文里,567,1387,408,196,604,22,626
公投第１１案,桃園市,大溪區,仁文里,568,1085,382,172,554,23,577
公投第１１案,桃園市,大溪區,仁文里,569,1403,553,222,775,26,801
公投第１１案,桃園市,大溪區,南興里,570,1511,464,248,712,72,784
公投第１１案,桃園市,大溪區,南興里,571,1719,487,259,746,55,801
公投第１１案,桃園市,大溪區,南興里,572,1717,483,244,727,67,794
公投第１１案,桃園市,大溪區,光明里,573,1207,403,182,585,61,646
公投第１１案,桃園市,大溪區,光明里,574,1188,439,185,624,51,675
公投第１１案,桃園市,大溪區,員林里,575,1514,505,232,737,20,757
公投第１１案,桃園市,大溪區,三元里,576,1529,580,240,820,40,860
公投第１１案,桃園市,大溪區,三元里,577,1260,511,203,714,30,744
公投第１１案,桃園市,大溪區,瑞源里,578,831,342,127,469,20,489
公投第１１案,桃園市,大溪區,瑞源里,579,1407,509,233,742,39,781
公投第１１案,桃園市,大溪區,瑞源里,580,1494,507,203,710,49,759
公投第１１案,桃園市,復興區,三民里,581,1991,820,238,1058,70,1128
公投第１１案,桃園市,復興區,澤仁里,582,1392,593,175,768,35,803
公投第１１案,桃園市,復興區,霞雲里,583,564,257,70,327,7,334
公投第１１案,桃園市,復興區,義盛里,584,716,305,107,412,16,428
公投第１１案,桃園市,復興區,羅浮里,585,1016,445,164,609,40,649
公投第１１案,桃園市,復興區,長興里,586,669,204,92,296,14,310
公投第１１案,桃園市,復興區,奎輝里,587,760,297,83,380,13,393
公投第１１案,桃園市,復興區,高義里,588,751,328,92,420,16,436
公投第１１案,桃園市,復興區,三光里,589,683,298,83,381,15,396
公投第１１案,桃園市,復興區,華陵里,590,1224,594,105,699,17,716
公投第１１案,桃園市,中壢區,後寮里,591,1401,484,267,751,18,769
公投第１１案,桃園市,中壢區,後寮里,592,1798,564,300,864,34,898
公投第１１案,桃園市,中壢區,後寮里,593,1642,483,263,746,32,778
公投第１１案,桃園市,中壢區,明德里,594,1670,615,268,883,23,906
公投第１１案,桃園市,中壢區,明德里,595,1456,535,256,791,18,809
公投第１１案,桃園市,中壢區,明德里,596,1531,604,291,895,23,918
公投第１１案,桃園市,中壢區,至善里,597,1623,620,287,907,25,932
公投第１１案,桃園市,中壢區,至善里,598,1953,628,238,866,26,892
公投第１１案,桃園市,中壢區,龍慈里,599,1155,446,200,646,17,663
公投第１１案,桃園市,中壢區,龍慈里,600,1800,577,234,811,23,834
公投第１１案,桃園市,中壢區,龍慈里,601,1757,573,263,836,14,850
公投第１１案,桃園市,中壢區,龍興里,602,1281,534,193,727,30,757
公投第１１案,桃園市,中壢區,龍興里,603,1462,557,254,811,19,830
公投第１１案,桃園市,中壢區,龍興里,604,1560,693,92,785,31,816
公投第１１案,桃園市,中壢區,龍德里,605,1602,651,257,908,25,933
公投第１１案,桃園市,中壢區,龍德里,606,1006,456,163,619,28,647
公投第１１案,桃園市,中壢區,龍德里,607,1474,572,247,819,18,837
公投第１１案,桃園市,中壢區,龍岡里,608,1627,610,227,837,51,888
公投第１１案,桃園市,中壢區,龍岡里,609,1519,578,249,827,32,859
公投第１１案,桃園市,中壢區,龍岡里,610,1526,578,221,799,50,849
公投第１１案,桃園市,中壢區,龍東里,611,1618,570,239,809,64,873
公投第１１案,桃園市,中壢區,龍東里,612,1554,565,307,872,34,906
公投第１１案,桃園市,中壢區,龍東里,613,1706,664,217,881,43,924
公投第１１案,桃園市,中壢區,龍昌里,614,1818,699,306,1005,31,1036
公投第１１案,桃園市,中壢區,龍昌里,615,1991,681,290,971,27,998
公投第１１案,桃園市,中壢區,龍昌里,616,1609,591,241,832,30,862
公投第１１案,桃園市,中壢區,龍平里,617,1329,470,155,625,33,658
公投第１１案,桃園市,中壢區,龍平里,618,1587,518,218,736,59,795
公投第１１案,桃園市,中壢區,仁美里,619,1955,685,300,985,14,999
公投第１１案,桃園市,中壢區,仁美里,620,1711,582,259,841,49,890
公投第１１案,桃園市,中壢區,仁美里,621,1712,598,254,852,28,880
公投第１１案,桃園市,中壢區,仁福里,622,1448,558,236,794,42,836
公投第１１案,桃園市,中壢區,仁福里,623,1605,527,621,1148,37,1185
公投第１１案,桃園市,中壢區,仁福里,624,1633,541,232,773,8,781
公投第１１案,桃園市,中壢區,華愛里,625,1795,664,316,980,39,1019
公投第１１案,桃園市,中壢區,華愛里,626,1689,639,264,903,15,918
公投第１１案,桃園市,中壢區,普仁里,627,1201,450,204,654,19,673
公投第１１案,桃園市,中壢區,普仁里,628,1353,468,239,707,18,725
公投第１１案,桃園市,中壢區,普仁里,629,1587,536,249,785,13,798
公投第１１案,桃園市,中壢區,普忠里,630,1883,697,291,988,34,1022
公投第１１案,桃園市,中壢區,普忠里,631,1448,491,243,734,16,750
公投第１１案,桃園市,中壢區,普強里,632,1810,624,300,924,28,952
公投第１１案,桃園市,中壢區,普強里,633,1916,627,311,938,44,982
公投第１１案,桃園市,中壢區,普慶里,634,1177,494,168,662,19,681
公投第１１案,桃園市,中壢區,普慶里,635,1410,567,241,808,35,843
公投第１１案,桃園市,中壢區,信義里,636,1368,478,228,706,17,723
公投第１１案,桃園市,中壢區,信義里,637,1424,581,252,833,28,861
公投第１１案,桃園市,中壢區,信義里,638,1573,562,297,859,21,880
公投第１１案,桃園市,中壢區,正義里,639,1152,437,204,641,20,661
公投第１１案,桃園市,中壢區,正義里,640,1178,436,219,655,17,672
公投第１１案,桃園市,中壢區,正義里,641,1966,692,321,1013,31,1044
公投第１１案,桃園市,中壢區,普義里,642,3474,458,236,694,24,718
公投第１１案,桃園市,中壢區,普義里,643,2099,725,372,1097,37,1134
公投第１１案,桃園市,中壢區,德義里,644,1178,415,213,628,36,664
公投第１１案,桃園市,中壢區,德義里,645,1397,528,286,814,41,855
公投第１１案,桃園市,中壢區,仁義里,646,1669,564,325,889,39,928
公投第１１案,桃園市,中壢區,仁義里,647,2087,750,322,1072,39,1111
公投第１１案,桃園市,中壢區,忠義里,648,1900,636,311,947,26,973
公投第１１案,桃園市,中壢區,忠義里,649,1640,473,235,708,17,725
公投第１１案,桃園市,中壢區,龍安里,650,994,406,174,580,23,603
公投第１１案,桃園市,中壢區,龍安里,651,1131,502,192,694,34,728
公投第１１案,桃園市,中壢區,仁愛里,652,1625,614,314,928,28,956
公投第１１案,桃園市,中壢區,仁愛里,653,1384,546,285,831,28,859
公投第１１案,桃園市,中壢區,仁德里,654,1588,568,249,817,41,858
公投第１１案,桃園市,中壢區,仁德里,655,1445,534,201,735,50,785
公投第１１案,桃園市,中壢區,仁和里,656,1743,559,221,780,34,814
公投第１１案,桃園市,中壢區,仁和里,657,1812,574,263,837,15,852
公投第１１案,桃園市,中壢區,仁祥里,658,1546,510,247,757,32,789
公投第１１案,桃園市,中壢區,仁祥里,659,1290,466,160,626,34,660
公投第１１案,桃園市,中壢區,華勛里,660,2145,728,254,982,65,1047
公投第１１案,桃園市,中壢區,華勛里,661,1451,436,257,693,25,718
公投第１１案,桃園市,中壢區,中堅里,662,1489,541,210,751,27,778
公投第１１案,桃園市,中壢區,中堅里,663,827,302,136,438,24,462
公投第１１案,桃園市,中壢區,中堅里,664,1442,511,209,720,27,747
公投第１１案,桃園市,中壢區,興仁里,665,1842,591,278,869,24,893
公投第１１案,桃園市,中壢區,興仁里,666,1520,492,222,714,25,739
公投第１１案,桃園市,中壢區,中正里,667,1764,534,247,781,37,818
公投第１１案,桃園市,中壢區,中正里,668,1488,592,224,816,12,828
公投第１１案,桃園市,中壢區,中正里,669,1593,555,266,821,29,850
公投第１１案,桃園市,中壢區,中山里,670,1505,531,256,787,16,803
公投第１１案,桃園市,中壢區,中山里,671,1661,604,245,849,22,871
公投第１１案,桃園市,中壢區,中山里,672,1492,542,247,789,26,815
公投第１１案,桃園市,中壢區,篤行里,673,1249,376,214,590,30,620
公投第１１案,桃園市,中壢區,篤行里,674,1257,466,214,680,23,703
公投第１１案,桃園市,中壢區,自強里,675,1659,446,374,820,45,865
公投第１１案,桃園市,中壢區,自強里,676,1815,631,344,975,16,991
公投第１１案,桃園市,中壢區,中興里,677,1702,568,275,843,25,868
公投第１１案,桃園市,中壢區,中興里,678,1541,526,276,802,24,826
公投第１１案,桃園市,中壢區,自立里,679,1659,572,222,794,25,819
公投第１１案,桃園市,中壢區,自立里,680,1874,673,240,913,56,969
公投第１１案,桃園市,中壢區,自立里,681,1603,604,177,781,21,802
公投第１１案,桃園市,中壢區,自信里,682,1735,575,270,845,36,881
公投第１１案,桃園市,中壢區,自信里,683,1815,595,298,893,18,911
公投第１１案,桃園市,中壢區,自信里,684,1873,601,315,916,17,933
公投第１１案,桃園市,中壢區,莊敬里,685,1739,669,254,923,48,971
公投第１１案,桃園市,中壢區,莊敬里,686,1709,555,257,812,32,844
公投第１１案,桃園市,中壢區,自治里,687,1655,624,261,885,27,912
公投第１１案,桃園市,中壢區,自治里,688,1664,631,229,860,34,894
公投第１１案,桃園市,中壢區,內壢里,689,1087,382,144,526,18,544
公投第１１案,桃園市,中壢區,內壢里,690,1065,384,180,564,40,604
公投第１１案,桃園市,中壢區,成功里,691,1844,643,301,944,49,993
公投第１１案,桃園市,中壢區,成功里,692,1220,375,185,560,28,588
公投第１１案,桃園市,中壢區,成功里,693,1219,398,235,633,25,658
公投第１１案,桃園市,中壢區,福德里,694,1260,445,215,660,37,697
公投第１１案,桃園市,中壢區,福德里,695,1594,616,274,890,38,928
公投第１１案,桃園市,中壢區,中原里,696,1733,559,320,879,62,941
公投第１１案,桃園市,中壢區,中原里,697,1979,676,330,1006,41,1047
公投第１１案,桃園市,中壢區,忠孝里,698,1621,577,297,874,18,892
公投第１１案,桃園市,中壢區,忠孝里,699,1391,521,244,765,23,788
公投第１１案,桃園市,中壢區,忠孝里,700,1531,548,277,825,24,849
公投第１１案,桃園市,中壢區,復興里,701,1943,640,267,907,29,936
公投第１１案,桃園市,中壢區,復興里,702,1363,460,235,695,23,718
公投第１１案,桃園市,中壢區,復興里,703,2172,649,300,949,37,986
公投第１１案,桃園市,中壢區,復興里,704,1798,609,243,852,27,879
公投第１１案,桃園市,中壢區,復興里,705,1671,572,248,820,12,832
公投第１１案,桃園市,中壢區,復華里,706,1969,644,318,962,27,989
公投第１１案,桃園市,中壢區,復華里,707,1563,648,307,955,28,983
公投第１１案,桃園市,中壢區,復華里,708,1762,640,316,956,24,980
公投第１１案,桃園市,中壢區,文化里,709,1923,552,242,794,31,825
公投第１１案,桃園市,中壢區,文化里,710,1572,587,276,863,38,901
公投第１１案,桃園市,中壢區,文化里,711,1850,684,316,1000,21,1021
公投第１１案,桃園市,中壢區,文化里,712,1583,523,259,782,37,819
公投第１１案,桃園市,中壢區,文化里,713,1735,577,296,873,31,904
公投第１１案,桃園市,中壢區,和平里,714,1292,406,262,668,21,689
公投第１１案,桃園市,中壢區,和平里,715,1265,448,224,672,22,694
公投第１１案,桃園市,中壢區,內定里,716,1798,585,327,912,28,940
公投第１１案,桃園市,中壢區,內定里,717,1822,673,328,1001,41,1042
公投第１１案,桃園市,中壢區,內定里,718,1613,568,283,851,17,868
公投第１１案,桃園市,中壢區,內定里,719,1405,448,285,733,25,758
公投第１１案,桃園市,中壢區,石頭里,720,1730,597,323,920,57,977
公投第１１案,桃園市,中壢區,中央里,721,1384,551,282,833,22,855
公投第１１案,桃園市,中壢區,中央里,722,1122,403,212,615,20,635
公投第１１案,桃園市,中壢區,中央里,723,992,376,195,571,31,602
公投第１１案,桃園市,中壢區,新興里,724,1820,590,335,925,27,952
公投第１１案,桃園市,中壢區,新興里,725,1847,634,273,907,31,938
公投第１１案,桃園市,中壢區,林森里,726,1302,515,205,720,34,754
公投第１１案,桃園市,中壢區,林森里,727,1203,462,203,665,33,698
公投第１１案,桃園市,中壢區,林森里,728,1226,519,239,758,31,789
公投第１１案,桃園市,中壢區,振興里,729,1234,507,199,706,30,736
公投第１１案,桃園市,中壢區,振興里,730,2023,687,281,968,43,1011
公投第１１案,桃園市,中壢區,振興里,731,1555,500,220,720,28,748
公投第１１案,桃園市,中壢區,東興里,732,1951,645,303,948,33,981
公投第１１案,桃園市,中壢區,東興里,733,1383,481,261,742,31,773
公投第１１案,桃園市,中壢區,健行里,734,1164,485,186,671,33,704
公投第１１案,桃園市,中壢區,健行里,735,1482,559,235,794,23,817
公投第１１案,桃園市,中壢區,健行里,736,1770,654,255,909,42,951
公投第１１案,桃園市,中壢區,水尾里,737,1703,625,312,937,52,989
公投第１１案,桃園市,中壢區,水尾里,738,1841,651,281,932,46,978
公投第１１案,桃園市,中壢區,金華里,739,1941,657,386,1043,30,1073
公投第１１案,桃園市,中壢區,金華里,740,2029,730,365,1095,32,1127
公投第１１案,桃園市,中壢區,忠福里,741,1636,647,271,918,23,941
公投第１１案,桃園市,中壢區,忠福里,742,1528,573,264,837,37,874
公投第１１案,桃園市,中壢區,忠福里,743,2289,667,386,1053,47,1100
公投第１１案,桃園市,中壢區,忠福里,744,2020,606,364,970,25,995
公投第１１案,桃園市,中壢區,幸福里,745,2027,708,335,1043,38,1081
公投第１１案,桃園市,中壢區,幸福里,746,1883,528,286,814,18,832
公投第１１案,桃園市,中壢區,幸福里,747,2080,661,329,990,34,1024
公投第１１案,桃園市,中壢區,永福里,748,646,207,125,332,10,342
公投第１１案,桃園市,中壢區,永福里,749,1780,743,324,1067,38,1105
公投第１１案,桃園市,中壢區,永福里,750,1372,568,209,777,16,793
公投第１１案,桃園市,中壢區,永福里,751,1668,640,299,939,28,967
公投第１１案,桃園市,中壢區,青埔里,752,1987,632,342,974,19,993
公投第１１案,桃園市,中壢區,青埔里,753,1520,529,278,807,18,825
公投第１１案,桃園市,中壢區,新街里,754,852,292,150,442,24,466
公投第１１案,桃園市,中壢區,新街里,755,1209,394,245,639,29,668
公投第１１案,桃園市,中壢區,興南里,756,1481,503,261,764,45,809
公投第１１案,桃園市,中壢區,興南里,757,1564,483,244,727,23,750
公投第１１案,桃園市,中壢區,興國里,758,1957,681,341,1022,46,1068
公投第１１案,桃園市,中壢區,興平里,759,1223,450,237,687,38,725
公投第１１案,桃園市,中壢區,興平里,760,1182,468,225,693,28,721
公投第１１案,桃園市,中壢區,興和里,761,1066,394,203,597,34,631
公投第１１案,桃園市,中壢區,興和里,762,1701,645,301,946,34,980
公投第１１案,桃園市,中壢區,永興里,763,943,319,158,477,29,506
公投第１１案,桃園市,中壢區,中壢里,764,731,278,143,421,23,444
公投第１１案,桃園市,中壢區,中榮里,765,851,297,151,448,43,491
公投第１１案,桃園市,中壢區,中建里,766,1011,338,191,529,32,561
公投第１１案,桃園市,中壢區,舊明里,767,1532,585,273,858,26,884
公投第１１案,桃園市,中壢區,新明里,768,1028,360,173,533,29,562
公投第１１案,桃園市,中壢區,新明里,769,1157,453,208,661,25,686
公投第１１案,桃園市,中壢區,新明里,770,1591,514,297,811,36,847
公投第１１案,桃園市,中壢區,光明里,771,2156,665,321,986,44,1030
公投第１１案,桃園市,中壢區,光明里,772,1479,459,225,684,24,708
公投第１１案,桃園市,中壢區,光明里,773,1780,605,313,918,27,945
公投第１１案,桃園市,中壢區,永光里,774,1651,571,281,852,44,896
公投第１１案,桃園市,中壢區,永光里,775,1870,663,323,986,26,1012
公投第１１案,桃園市,中壢區,永光里,776,1913,575,290,865,12,877
公投第１１案,桃園市,中壢區,三民里,777,1609,531,212,743,30,773
公投第１１案,桃園市,中壢區,三民里,778,1539,492,251,743,30,773
公投第１１案,桃園市,中壢區,五權里,779,1426,488,250,738,26,764
公投第１１案,桃園市,中壢區,五權里,780,1618,522,245,767,26,793
公投第１１案,桃園市,中壢區,五權里,781,1441,519,235,754,31,785
公投第１１案,桃園市,中壢區,五權里,782,1528,538,276,814,31,845
公投第１１案,桃園市,中壢區,五福里,783,1683,574,285,859,52,911
公投第１１案,桃園市,中壢區,五福里,784,1945,684,335,1019,55,1074
公投第１１案,桃園市,中壢區,芝芭里,785,1534,523,252,775,40,815
公投第１１案,桃園市,中壢區,芝芭里,786,1810,580,291,871,41,912
公投第１１案,桃園市,中壢區,洽溪里,787,1097,338,174,512,50,562
公投第１１案,桃園市,中壢區,洽溪里,788,1917,572,337,909,28,937
公投第１１案,桃園市,中壢區,洽溪里,789,1858,548,378,926,33,959
公投第１１案,桃園市,中壢區,內厝里,790,1576,481,360,841,38,879
公投第１１案,桃園市,中壢區,內厝里,791,1478,558,200,758,35,793
公投第１１案,桃園市,中壢區,內厝里,792,1589,524,291,815,25,840
公投第１１案,桃園市,中壢區,月眉里,793,2037,696,361,1057,63,1120
公投第１１案,桃園市,中壢區,月眉里,794,1158,446,210,656,34,690
公投第１１案,桃園市,中壢區,月眉里,795,1967,715,331,1046,43,1089
公投第１１案,桃園市,中壢區,山東里,796,1830,605,274,879,47,926
公投第１１案,桃園市,中壢區,山東里,797,1856,682,287,969,37,1006
公投第１１案,桃園市,中壢區,過嶺里,798,2068,637,344,981,65,1046
公投第１１案,桃園市,中壢區,過嶺里,799,2152,555,305,860,34,894
公投第１１案,桃園市,中壢區,過嶺里,800,2158,604,349,953,37,990
公投第１１案,桃園市,平鎮區,平鎮里,801,1487,459,230,689,43,732
公投第１１案,桃園市,平鎮區,平鎮里,802,1453,513,220,733,30,763
公投第１１案,桃園市,平鎮區,平鎮里,803,1491,534,235,769,34,803
公投第１１案,桃園市,平鎮區,鎮興里,804,1346,439,222,661,43,704
公投第１１案,桃園市,平鎮區,鎮興里,805,1660,557,256,813,26,839
公投第１１案,桃園市,平鎮區,南勢里,806,1921,653,241,894,32,926
公投第１１案,桃園市,平鎮區,南勢里,807,1974,817,215,1032,24,1056
公投第１１案,桃園市,平鎮區,南勢里,808,1867,619,284,903,33,936
公投第１１案,桃園市,平鎮區,金星里,809,1786,638,266,904,21,925
公投第１１案,桃園市,平鎮區,金星里,810,1634,468,199,667,20,687
公投第１１案,桃園市,平鎮區,金星里,811,1080,426,165,591,19,610
公投第１１案,桃園市,平鎮區,金星里,812,1514,504,254,758,30,788
公投第１１案,桃園市,平鎮區,平安里,813,1918,578,264,842,46,888
公投第１１案,桃園市,平鎮區,平安里,814,1182,425,176,601,54,655
公投第１１案,桃園市,平鎮區,平安里,815,1667,520,254,774,30,804
公投第１１案,桃園市,平鎮區,平南里,816,1640,515,230,745,21,766
公投第１１案,桃園市,平鎮區,平南里,817,1603,538,264,802,29,831
公投第１１案,桃園市,平鎮區,平南里,818,1556,601,264,865,13,878
公投第１１案,桃園市,平鎮區,平南里,819,1697,583,247,830,36,866
公投第１１案,桃園市,平鎮區,山峰里,820,1130,403,163,566,18,584
公投第１１案,桃園市,平鎮區,山峰里,821,1196,445,178,623,33,656
公投第１１案,桃園市,平鎮區,福林里,822,1685,584,270,854,35,889
公投第１１案,桃園市,平鎮區,福林里,823,1532,620,205,825,34,859
公投第１１案,桃園市,平鎮區,湧光里,824,1564,592,215,807,22,829
公投第１１案,桃園市,平鎮區,湧光里,825,1824,880,18,898,31,929
公投第１１案,桃園市,平鎮區,湧光里,826,1912,654,270,924,22,946
公投第１１案,桃園市,平鎮區,莊敬里,827,1048,377,151,528,35,563
公投第１１案,桃園市,平鎮區,莊敬里,828,1259,497,179,676,35,711
公投第１１案,桃園市,平鎮區,莊敬里,829,1061,407,137,544,21,565
公投第１１案,桃園市,平鎮區,莊敬里,830,1072,465,154,619,23,642
公投第１１案,桃園市,平鎮區,湧豐里,831,1788,637,244,881,47,928
公投第１１案,桃園市,平鎮區,湧安里,832,1510,539,236,775,23,798
公投第１１案,桃園市,平鎮區,湧安里,833,1403,504,208,712,28,740
公投第１１案,桃園市,平鎮區,湧安里,834,1407,500,230,730,36,766
公投第１１案,桃園市,平鎮區,宋屋里,835,1901,680,284,964,52,1016
公投第１１案,桃園市,平鎮區,宋屋里,836,1994,642,278,920,17,937
公投第１１案,桃園市,平鎮區,平興里,837,1730,586,281,867,27,894
公投第１１案,桃園市,平鎮區,平興里,838,1905,656,328,984,26,1010
公投第１１案,桃園市,平鎮區,平興里,839,1723,621,304,925,19,944
公投第１１案,桃園市,平鎮區,廣興里,840,1307,492,206,698,34,732
公投第１１案,桃園市,平鎮區,廣興里,841,1337,466,242,708,38,746
公投第１１案,桃園市,平鎮區,廣興里,842,980,407,208,615,21,636
公投第１１案,桃園市,平鎮區,廣興里,843,1818,591,309,900,35,935
公投第１１案,桃園市,平鎮區,廣達里,844,1463,513,258,771,34,805
公投第１１案,桃園市,平鎮區,廣達里,845,1213,484,212,696,19,715
公投第１１案,桃園市,平鎮區,廣達里,846,1085,411,192,603,35,638
公投第１１案,桃園市,平鎮區,廣仁里,847,1458,523,186,709,26,735
公投第１１案,桃園市,平鎮區,廣仁里,848,1408,528,224,752,29,781
公投第１１案,桃園市,平鎮區,廣仁里,849,1396,481,212,693,29,722
公投第１１案,桃園市,平鎮區,復旦里,850,1044,418,237,655,16,671
公投第１１案,桃園市,平鎮區,復旦里,851,1124,411,203,614,16,630
公投第１１案,桃園市,平鎮區,復旦里,852,1517,545,271,816,14,830
公投第１１案,桃園市,平鎮區,復旦里,853,1571,520,292,812,19,831
公投第１１案,桃園市,平鎮區,復興里,854,1752,666,313,979,23,1002
公投第１１案,桃園市,平鎮區,復興里,855,1434,576,263,839,28,867
公投第１１案,桃園市,平鎮區,復興里,856,1710,635,322,957,28,985
公投第１１案,桃園市,平鎮區,義民里,857,1555,684,157,841,32,873
公投第１１案,桃園市,平鎮區,義民里,858,2051,645,320,965,30,995
公投第１１案,桃園市,平鎮區,義民里,859,1477,493,276,769,21,790
公投第１１案,桃園市,平鎮區,義興里,860,1501,564,248,812,16,828
公投第１１案,桃園市,平鎮區,義興里,861,1405,498,249,747,35,782
公投第１１案,桃園市,平鎮區,義興里,862,1656,577,261,838,42,880
公投第１１案,桃園市,平鎮區,義興里,863,1921,586,302,888,21,909
公投第１１案,桃園市,平鎮區,雙連里,864,1717,565,252,817,25,842
公投第１１案,桃園市,平鎮區,雙連里,865,1319,439,245,684,42,726
公投第１１案,桃園市,平鎮區,雙連里,866,1745,560,289,849,41,890
公投第１１案,桃園市,平鎮區,高雙里,867,1721,611,280,891,53,944
公投第１１案,桃園市,平鎮區,高雙里,868,1206,427,213,640,28,668
公投第１１案,桃園市,平鎮區,高雙里,869,1202,493,268,761,21,782
公投第１１案,桃園市,平鎮區,北勢里,870,1208,461,202,663,42,705
公投第１１案,桃園市,平鎮區,北勢里,871,1267,515,232,747,22,769
公投第１１案,桃園市,平鎮區,北華里,872,1094,385,205,590,24,614
公投第１１案,桃園市,平鎮區,北華里,873,1394,528,256,784,40,824
公投第１１案,桃園市,平鎮區,北華里,874,1215,468,251,719,15,734
公投第１１案,桃園市,平鎮區,新勢里,875,1010,391,171,562,27,589
公投第１１案,桃園市,平鎮區,新勢里,876,1261,575,125,700,23,723
公投第１１案,桃園市,平鎮區,新勢里,877,1314,540,211,751,22,773
公投第１１案,桃園市,平鎮區,北安里,878,722,280,122,402,20,422
公投第１１案,桃園市,平鎮區,北安里,879,839,293,144,437,16,453
公投第１１案,桃園市,平鎮區,新榮里,880,1399,535,230,765,15,780
公投第１１案,桃園市,平鎮區,新榮里,881,1968,629,331,960,30,990
公投第１１案,桃園市,平鎮區,新榮里,882,1672,594,281,875,22,897
公投第１１案,桃園市,平鎮區,新富里,883,2213,448,187,635,15,650
公投第１１案,桃園市,平鎮區,新富里,884,949,377,201,578,15,593
公投第１１案,桃園市,平鎮區,新富里,885,1621,596,338,934,32,966
公投第１１案,桃園市,平鎮區,新富里,886,1643,534,273,807,24,831
公投第１１案,桃園市,平鎮區,新英里,887,1844,658,321,979,32,1011
公投第１１案,桃園市,平鎮區,新英里,888,1752,597,314,911,36,947
公投第１１案,桃園市,平鎮區,新貴里,889,1577,497,249,746,42,788
公投第１１案,桃園市,平鎮區,新貴里,890,1517,536,275,811,30,841
公投第１１案,桃園市,平鎮區,北興里,891,1039,385,201,586,27,613
公投第１１案,桃園市,平鎮區,北興里,892,1318,513,240,753,24,777
公投第１１案,桃園市,平鎮區,北興里,893,1636,268,577,845,25,870
公投第１１案,桃園市,平鎮區,金陵里,894,1316,469,251,720,25,745
公投第１１案,桃園市,平鎮區,金陵里,895,1474,501,307,808,20,828
公投第１１案,桃園市,平鎮區,北貴里,896,1480,472,206,678,37,715
公投第１１案,桃園市,平鎮區,北貴里,897,1330,504,187,691,17,708
公投第１１案,桃園市,平鎮區,北貴里,898,1228,443,210,653,29,682
公投第１１案,桃園市,平鎮區,北富里,899,1377,503,267,770,40,810
公投第１１案,桃園市,平鎮區,北富里,900,1198,477,228,705,26,731
公投第１１案,桃園市,平鎮區,北富里,901,1231,495,222,717,33,750
公投第１１案,桃園市,平鎮區,建安里,902,1243,451,225,676,39,715
公投第１１案,桃園市,平鎮區,建安里,903,1590,576,230,806,34,840
公投第１１案,桃園市,平鎮區,建安里,904,1366,495,211,706,31,737
公投第１１案,桃園市,平鎮區,華安里,905,1332,479,202,681,37,718
公投第１１案,桃園市,平鎮區,華安里,906,1201,388,183,571,26,597
公投第１１案,桃園市,平鎮區,華安里,907,1668,540,229,769,19,788
公投第１１案,桃園市,平鎮區,東安里,908,1351,476,183,659,43,702
公投第１１案,桃園市,平鎮區,東安里,909,1460,478,211,689,22,711
公投第１１案,桃園市,平鎮區,新安里,910,1841,632,263,895,24,919
公投第１１案,桃園市,平鎮區,新安里,911,1475,511,199,710,11,721
公投第１１案,桃園市,平鎮區,新安里,912,1011,399,140,539,20,559
公投第１１案,桃園市,平鎮區,東勢里,913,1052,336,155,491,29,520
公投第１１案,桃園市,平鎮區,東勢里,914,1154,454,212,666,40,706
公投第１１案,桃園市,平鎮區,東勢里,915,1645,560,234,794,30,824
公投第１１案,桃園市,平鎮區,東勢里,916,1539,498,228,726,47,773
公投第１１案,桃園市,平鎮區,龍恩里,917,1385,489,214,703,47,750
公投第１１案,桃園市,平鎮區,龍恩里,918,1395,502,218,720,24,744
公投第１１案,桃園市,平鎮區,東社里,919,1711,611,213,824,40,864
公投第１１案,桃園市,平鎮區,東社里,920,1631,570,228,798,36,834
公投第１１案,桃園市,平鎮區,忠貞里,921,1110,399,206,605,18,623
公投第１１案,桃園市,平鎮區,貿易里,922,1931,770,262,1032,30,1062
公投第１１案,桃園市,平鎮區,龍興里,923,1127,391,198,589,31,620
公投第１１案,桃園市,平鎮區,龍興里,924,1414,633,108,741,45,786
公投第１１案,桃園市,平鎮區,中正里,925,1609,604,223,827,28,855
公投第１１案,桃園市,楊梅區,仁美里,926,1269,468,200,668,41,709
公投第１１案,桃園市,楊梅區,仁美里,927,1246,543,190,733,40,773
公投第１１案,桃園市,楊梅區,仁美里,928,1408,571,207,778,40,818
公投第１１案,桃園市,楊梅區,埔心里,929,1434,553,230,783,34,817
公投第１１案,桃園市,楊梅區,光華里,930,1515,549,201,750,43,793
公投第１１案,桃園市,楊梅區,光華里,931,1657,570,204,774,44,818
公投第１１案,桃園市,楊梅區,金龍里,932,1137,470,164,634,22,656
公投第１１案,桃園市,楊梅區,四維里,933,2211,761,325,1086,25,1111
公投第１１案,桃園市,楊梅區,四維里,934,2008,685,302,987,27,1014
公投第１１案,桃園市,楊梅區,永平里,935,1911,671,304,975,28,1003
公投第１１案,桃園市,楊梅區,瑞塘里,936,1449,539,239,778,39,817
公投第１１案,桃園市,楊梅區,瑞塘里,937,1877,563,262,825,43,868
公投第１１案,桃園市,楊梅區,瑞塘里,938,1988,679,250,929,22,951
公投第１１案,桃園市,楊梅區,瑞坪里,939,1931,702,324,1026,26,1052
公投第１１案,桃園市,楊梅區,瑞坪里,940,1938,652,274,926,31,957
公投第１１案,桃園市,楊梅區,瑞坪里,941,1677,611,247,858,25,883
公投第１１案,桃園市,楊梅區,梅溪里,942,1848,603,299,902,20,922
公投第１１案,桃園市,楊梅區,梅溪里,943,1882,647,309,956,17,973
公投第１１案,桃園市,楊梅區,瑞溪里,944,1541,426,198,624,10,634
公投第１１案,桃園市,楊梅區,瑞溪里,945,1938,650,288,938,22,960
公投第１１案,桃園市,楊梅區,金溪里,946,1562,498,200,698,26,724
公投第１１案,桃園市,楊梅區,金溪里,947,2125,719,421,1140,40,1180
公投第１１案,桃園市,楊梅區,三民里,948,1516,597,254,851,37,888
公投第１１案,桃園市,楊梅區,三民里,949,1807,641,229,870,19,889
公投第１１案,桃園市,楊梅區,楊明里,950,2101,672,310,982,21,1003
公投第１１案,桃園市,楊梅區,楊明里,951,2054,706,351,1057,31,1088
公投第１１案,桃園市,楊梅區,楊明里,952,2226,712,294,1006,21,1027
公投第１１案,桃園市,楊梅區,裕成里,953,1405,530,230,760,11,771
公投第１１案,桃園市,楊梅區,裕成里,954,1843,574,279,853,28,881
公投第１１案,桃園市,楊梅區,裕新里,955,2324,683,312,995,33,1028
公投第１１案,桃園市,楊梅區,大同里,956,1713,611,273,884,19,903
公投第１１案,桃園市,楊梅區,大同里,957,1587,694,222,916,29,945
公投第１１案,桃園市,楊梅區,中山里,958,1416,543,259,802,23,825
公投第１１案,桃園市,楊梅區,中山里,959,1591,604,250,854,18,872
公投第１１案,桃園市,楊梅區,楊梅里,960,1943,702,266,968,31,999
公投第１１案,桃園市,楊梅區,楊梅里,961,1762,649,273,922,27,949
公投第１１案,桃園市,楊梅區,楊江里,962,1083,400,170,570,21,591
公投第１１案,桃園市,楊梅區,梅新里,963,2027,728,284,1012,39,1051
公投第１１案,桃園市,楊梅區,紅梅里,964,1274,484,205,689,46,735
公投第１１案,桃園市,楊梅區,紅梅里,965,1359,568,195,763,26,789
公投第１１案,桃園市,楊梅區,永寧里,966,2444,573,265,838,32,870
公投第１１案,桃園市,楊梅區,永寧里,967,2298,702,304,1006,29,1035
公投第１１案,桃園市,楊梅區,永寧里,968,2222,757,322,1079,16,1095
公投第１１案,桃園市,楊梅區,大平里,969,1610,584,241,825,41,866
公投第１１案,桃園市,楊梅區,大平里,970,1627,588,251,839,31,870
公投第１１案,桃園市,楊梅區,秀才里,971,1589,613,213,826,37,863
公投第１１案,桃園市,楊梅區,秀才里,972,1758,620,276,896,43,939
公投第１１案,桃園市,楊梅區,東流里,973,1776,528,209,737,41,778
公投第１１案,桃園市,楊梅區,東流里,974,1000,310,153,463,21,484
公投第１１案,桃園市,楊梅區,豐野里,975,2290,669,304,973,61,1034
公投第１１案,桃園市,楊梅區,豐野里,976,1551,526,241,767,48,815
公投第１１案,桃園市,楊梅區,富岡里,977,1861,617,267,884,49,933
公投第１１案,桃園市,楊梅區,富豐里,978,1141,323,165,488,52,540
公投第１１案,桃園市,楊梅區,富豐里,979,1785,609,216,825,38,863
公投第１１案,桃園市,楊梅區,員本里,980,1498,534,221,755,45,800
公投第１１案,桃園市,楊梅區,員本里,981,1187,389,186,575,50,625
公投第１１案,桃園市,楊梅區,三湖里,982,1270,471,199,670,40,710
公投第１１案,桃園市,楊梅區,三湖里,983,1424,504,211,715,30,745
公投第１１案,桃園市,楊梅區,頭湖里,984,1273,418,311,729,16,745
公投第１１案,桃園市,楊梅區,頭湖里,985,1534,469,225,694,25,719
公投第１１案,桃園市,楊梅區,上湖里,986,1783,496,298,794,54,848
公投第１１案,桃園市,楊梅區,上湖里,987,1709,579,220,799,21,820
公投第１１案,桃園市,楊梅區,上湖里,988,1920,589,261,850,37,887
公投第１１案,桃園市,楊梅區,上田里,989,1194,429,186,615,30,645
公投第１１案,桃園市,楊梅區,上田里,990,1408,500,232,732,21,753
公投第１１案,桃園市,楊梅區,高山里,991,1737,535,218,753,31,784
公投第１１案,桃園市,楊梅區,高山里,992,1920,680,250,930,24,954
公投第１１案,桃園市,楊梅區,高上里,993,1234,424,129,553,37,590
公投第１１案,桃園市,楊梅區,高上里,994,1491,529,254,783,47,830
公投第１１案,桃園市,楊梅區,青山里,995,2020,644,274,918,28,946
公投第１１案,桃園市,楊梅區,青山里,996,1863,560,283,843,25,868
公投第１１案,桃園市,楊梅區,高榮里,997,1692,617,256,873,42,915
公投第１１案,桃園市,楊梅區,高榮里,998,1686,591,266,857,30,887
公投第１１案,桃園市,楊梅區,雙榮里,999,1626,564,265,829,58,887
公投第１１案,桃園市,楊梅區,雙榮里,1000,1557,582,248,830,16,846
公投第１１案,桃園市,楊梅區,新榮里,1001,1603,631,261,892,36,928
公投第１１案,桃園市,楊梅區,新榮里,1002,1889,602,283,885,46,931
公投第１１案,桃園市,楊梅區,水美里,1003,1448,582,207,789,28,817
公投第１１案,桃園市,楊梅區,水美里,1004,1351,505,224,729,39,768
公投第１１案,桃園市,楊梅區,水美里,1005,1313,499,216,715,42,757
公投第１１案,桃園市,楊梅區,瑞原里,1006,1689,578,263,841,39,880
公投第１１案,桃園市,楊梅區,瑞原里,1007,2063,679,275,954,23,977
公投第１１案,桃園市,龍潭區,黃唐里,1008,1482,534,218,752,27,779
公投第１１案,桃園市,龍潭區,黃唐里,1009,1528,520,231,751,22,773
公投第１１案,桃園市,龍潭區,黃唐里,1010,1503,540,237,777,29,806
公投第１１案,桃園市,龍潭區,永興里,1011,1568,523,230,753,41,794
公投第１１案,桃園市,龍潭區,永興里,1012,1216,423,171,594,39,633
公投第１１案,桃園市,龍潭區,中山里,1013,2088,628,271,899,50,949
公投第１１案,桃園市,龍潭區,中山里,1014,1987,737,328,1065,49,1114
公投第１１案,桃園市,龍潭區,中山里,1015,1586,622,281,903,37,940
公投第１１案,桃園市,龍潭區,烏樹林里,1016,1221,400,206,606,29,635
公投第１１案,桃園市,龍潭區,烏樹林里,1017,1134,453,176,629,23,652
公投第１１案,桃園市,龍潭區,烏林里,1018,2081,690,285,975,38,1013
公投第１１案,桃園市,龍潭區,烏林里,1019,1925,633,263,896,31,927
公投第１１案,桃園市,龍潭區,百年里,1020,2095,781,329,1110,25,1135
公投第１１案,桃園市,龍潭區,百年里,1021,2040,800,325,1125,30,1155
公投第１１案,桃園市,龍潭區,凌雲里,1022,1790,562,263,825,48,873
公投第１１案,桃園市,龍潭區,凌雲里,1023,1872,547,412,959,59,1018
公投第１１案,桃園市,龍潭區,龍祥里,1024,1726,643,277,920,56,976
公投第１１案,桃園市,龍潭區,龍祥里,1025,1792,677,260,937,44,981
公投第１１案,桃園市,龍潭區,八德里,1026,1398,526,222,748,26,774
公投第１１案,桃園市,龍潭區,八德里,1027,1345,456,199,655,23,678
公投第１１案,桃園市,龍潭區,八德里,1028,1409,511,227,738,33,771
公投第１１案,桃園市,龍潭區,聖德里,1029,1362,418,233,651,22,673
公投第１１案,桃園市,龍潭區,聖德里,1030,1650,600,296,896,41,937
公投第１１案,桃園市,龍潭區,上林里,1031,1597,583,212,795,36,831
公投第１１案,桃園市,龍潭區,上林里,1032,1410,513,208,721,29,750
公投第１１案,桃園市,龍潭區,上林里,1033,1275,482,198,680,30,710
公投第１１案,桃園市,龍潭區,龍潭里,1034,1909,723,353,1076,43,1119
公投第１１案,桃園市,龍潭區,龍星里,1035,2024,768,320,1088,27,1115
公投第１１案,桃園市,龍潭區,龍星里,1036,2002,725,317,1042,36,1078
公投第１１案,桃園市,龍潭區,中正里,1037,1786,664,321,985,30,1015
公投第１１案,桃園市,龍潭區,中正里,1038,1756,637,282,919,18,937
公投第１１案,桃園市,龍潭區,中正里,1039,1830,734,278,1012,14,1026
公投第１１案,桃園市,龍潭區,上華里,1040,1697,691,290,981,25,1006
公投第１１案,桃園市,龍潭區,上華里,1041,1519,608,229,837,26,863
公投第１１案,桃園市,龍潭區,九龍里,1042,1805,629,249,878,40,918
公投第１１案,桃園市,龍潭區,九龍里,1043,1792,587,198,785,25,810
公投第１１案,桃園市,龍潭區,武漢里,1044,1500,613,219,832,49,881
公投第１１案,桃園市,龍潭區,祥和里,1045,1427,489,211,700,18,718
公投第１１案,桃園市,龍潭區,東興里,1046,1444,432,182,614,43,657
公投第１１案,桃園市,龍潭區,東興里,1047,1321,467,172,639,32,671
公投第１１案,桃園市,龍潭區,東興里,1048,1215,491,204,695,28,723
公投第１１案,桃園市,龍潭區,中興里,1049,1297,484,171,655,36,691
公投第１１案,桃園市,龍潭區,中興里,1050,1407,461,215,676,20,696
公投第１１案,桃園市,龍潭區,中興里,1051,1564,505,234,739,36,775
公投第１１案,桃園市,龍潭區,北興里,1052,1317,470,193,663,38,701
公投第１１案,桃園市,龍潭區,北興里,1053,1023,354,125,479,29,508
公投第１１案,桃園市,龍潭區,佳安里,1054,1721,668,259,927,29,956
公投第１１案,桃園市,龍潭區,佳安里,1055,1764,700,236,936,34,970
公投第１１案,桃園市,龍潭區,三坑里,1056,1499,543,228,771,53,824
公投第１１案,桃園市,龍潭區,大平里,1057,2151,698,275,973,59,1032
公投第１１案,桃園市,龍潭區,三林里,1058,1524,606,240,846,22,868
公投第１１案,桃園市,龍潭區,三林里,1059,1456,588,271,859,17,876
公投第１１案,桃園市,龍潭區,建林里,1060,1847,823,221,1044,24,1068
公投第１１案,桃園市,龍潭區,建林里,1061,1899,853,281,1134,19,1153
公投第１１案,桃園市,龍潭區,富林里,1062,1725,668,245,913,27,940
公投第１１案,桃園市,龍潭區,富林里,1063,1665,700,270,970,42,1012
公投第１１案,桃園市,龍潭區,高平里,1064,1649,550,250,800,26,826
公投第１１案,桃園市,龍潭區,高平里,1065,1539,501,211,712,33,745
公投第１１案,桃園市,龍潭區,高原里,1066,1541,611,264,875,37,912
公投第１１案,桃園市,龍潭區,高原里,1067,1375,492,233,725,27,752
公投第１１案,桃園市,龍潭區,高原里,1068,1453,508,251,759,25,784
公投第１１案,桃園市,龍潭區,三和里,1069,1074,395,182,577,37,614
公投第１１案,桃園市,龍潭區,三和里,1070,1299,509,235,744,14,758
公投第１１案,桃園市,龍潭區,三水里,1071,678,228,103,331,15,346
公投第１１案,桃園市,新屋區,新屋里,1072,1306,552,216,768,13,781
公投第１１案,桃園市,新屋區,新屋里,1073,1556,623,200,823,37,860
公投第１１案,桃園市,新屋區,新生里,1074,1849,751,317,1068,52,1120
公投第１１案,桃園市,新屋區,新生里,1075,2096,782,399,1181,52,1233
公投第１１案,桃園市,新屋區,後湖里,1076,1517,513,234,747,50,797
公投第１１案,桃園市,新屋區,清華里,1077,2095,760,372,1132,54,1186
公投第１１案,桃園市,新屋區,清華里,1078,1856,586,263,849,38,887
公投第１１案,桃園市,新屋區,石磊里,1079,1986,723,317,1040,59,1099
公投第１１案,桃園市,新屋區,東明里,1080,1425,457,206,663,45,708
公投第１１案,桃園市,新屋區,社子里,1081,1385,456,197,653,39,692
公投第１１案,桃園市,新屋區,埔頂里,1082,1271,479,266,745,36,781
公投第１１案,桃園市,新屋區,埔頂里,1083,1271,452,204,656,25,681
公投第１１案,桃園市,新屋區,九斗里,1084,1234,453,219,672,33,705
公投第１１案,桃園市,新屋區,九斗里,1085,1085,363,202,565,42,607
公投第１１案,桃園市,新屋區,頭洲里,1086,1992,794,319,1113,30,1143
公投第１１案,桃園市,新屋區,頭洲里,1087,2032,770,364,1134,61,1195
公投第１１案,桃園市,新屋區,大坡里,1088,1291,453,189,642,66,708
公投第１１案,桃園市,新屋區,望間里,1089,1401,467,224,691,32,723
公投第１１案,桃園市,新屋區,後庄里,1090,1106,441,172,613,34,647
公投第１１案,桃園市,新屋區,蚵間里,1091,908,349,152,501,13,514
公投第１１案,桃園市,新屋區,深圳里,1092,663,259,121,380,28,408
公投第１１案,桃園市,新屋區,槺榔里,1093,1088,384,164,548,35,583
公投第１１案,桃園市,新屋區,笨港里,1094,1050,441,180,621,49,670
公投第１１案,桃園市,新屋區,永安里,1095,896,354,149,503,24,527
公投第１１案,桃園市,新屋區,永安里,1096,1369,513,234,747,73,820
公投第１１案,桃園市,新屋區,永興里,1097,995,300,164,464,33,497
公投第１１案,桃園市,新屋區,下埔里,1098,741,295,118,413,22,435
公投第１１案,桃園市,新屋區,石牌里,1099,943,373,169,542,40,582
公投第１１案,桃園市,新屋區,下田里,1100,1714,616,230,846,58,904
公投第１１案,桃園市,新屋區,赤欄里,1101,1340,493,213,706,25,731
公投第１１案,桃園市,觀音區,觀音里,1102,1371,427,192,619,38,657
公投第１１案,桃園市,觀音區,觀音里,1103,1362,393,166,559,25,584
公投第１１案,桃園市,觀音區,白玉里,1104,997,297,193,490,43,533
公投第１１案,桃園市,觀音區,廣興里,1105,1407,464,192,656,32,688
公投第１１案,桃園市,觀音區,大潭里,1106,1692,577,295,872,29,901
公投第１１案,桃園市,觀音區,保生里,1107,1279,475,173,648,21,669
公投第１１案,桃園市,觀音區,保生里,1108,791,292,121,413,10,423
公投第１１案,桃園市,觀音區,武威里,1109,892,363,125,488,19,507
公投第１１案,桃園市,觀音區,三和里,1110,886,346,160,506,27,533
公投第１１案,桃園市,觀音區,新興里,1111,712,259,114,373,22,395
公投第１１案,桃園市,觀音區,坑尾里,1112,1609,505,234,739,76,815
公投第１１案,桃園市,觀音區,金湖里,1113,1274,461,212,673,33,706
公投第１１案,桃園市,觀音區,金湖里,1114,1351,393,186,579,23,602
公投第１１案,桃園市,觀音區,藍埔里,1115,1262,461,235,696,32,728
公投第１１案,桃園市,觀音區,藍埔里,1116,1242,444,231,675,32,707
公投第１１案,桃園市,觀音區,大同里,1117,1461,470,269,739,36,775
公投第１１案,桃園市,觀音區,大同里,1118,1613,539,276,815,32,847
公投第１１案,桃園市,觀音區,大堀里,1119,1479,516,233,749,41,790
公投第１１案,桃園市,觀音區,崙坪里,1120,1552,480,236,716,31,747
公投第１１案,桃園市,觀音區,崙坪里,1121,1517,505,263,768,21,789
公投第１１案,桃園市,觀音區,崙坪里,1122,1691,527,271,798,38,836
公投第１１案,桃園市,觀音區,富源里,1123,1157,427,210,637,12,649
公投第１１案,桃園市,觀音區,富源里,1124,1455,496,219,715,32,747
公投第１１案,桃園市,觀音區,富源里,1125,1150,390,194,584,26,610
公投第１１案,桃園市,觀音區,上大里,1126,1112,400,195,595,32,627
公投第１１案,桃園市,觀音區,上大里,1127,1251,399,209,608,17,625
公投第１１案,桃園市,觀音區,新坡里,1128,1446,489,248,737,57,794
公投第１１案,桃園市,觀音區,新坡里,1129,1493,480,246,726,65,791
公投第１１案,桃園市,觀音區,廣福里,1130,1339,456,213,669,39,708
公投第１１案,桃園市,觀音區,廣福里,1131,1137,443,196,639,29,668
公投第１１案,桃園市,觀音區,塔腳里,1132,1043,340,161,501,29,530
公投第１１案,桃園市,觀音區,保障里,1133,993,286,152,438,23,461
公投第１１案,桃園市,觀音區,保障里,1134,975,316,167,483,21,504
公投第１１案,桃園市,觀音區,草漯里,1135,2029,562,304,866,35,901
公投第１１案,桃園市,觀音區,草新里,1136,1765,621,298,919,38,957
公投第１１案,桃園市,觀音區,草新里,1137,1809,620,274,894,33,927
公投第１１案,桃園市,觀音區,草新里,1138,1869,599,276,875,28,903
公投第１１案,桃園市,觀音區,樹林里,1139,1870,540,228,768,45,813
公投第１１案,桃園市,觀音區,樹林里,1140,1932,439,235,674,23,697
公投第１１案,桃園市,觀音區,富林里,1141,899,275,139,414,7,421
公投第１１案,桃園市,觀音區,富林里,1142,985,288,129,417,13,430
