公投案編號,縣市,行政區,村里,投開票所,投票權人數,同意票數,不同意票數,有效票數,無效票數,投票人數
公投第９案,連江縣,,,,11205,4751,736,5487,248,5735
公投第９案,金門縣,,,,122695,33982,6656,40638,3092,43730
公投第９案,宜蘭縣,,,,386089,149047,45210,194257,17663,211920
公投第９案,新竹縣,,,,445051,187845,47564,235409,14059,249468
公投第９案,苗栗縣,,,,461580,190918,51594,242512,18483,260995
公投第９案,彰化縣,,,,1066994,435289,124114,559403,49307,608710
公投第９案,南投縣,,,,427089,178955,46704,225659,18796,244455
公投第９案,雲林縣,,,,584480,205923,61421,267344,29764,297108
公投第９案,嘉義縣,,,,442775,149984,47427,197411,22181,219592
公投第９案,屏東縣,,,,711720,248756,79806,328562,34063,362625
公投第９案,臺東縣,,,,185996,65154,19668,84822,9028,93850
公投第９案,花蓮縣,,,,278059,104326,28174,132500,11987,144487
公投第９案,澎湖縣,,,,90405,28923,7616,36539,3443,39982
公投第９案,基隆市,,,,320030,119425,33714,153139,9960,163099
公投第９案,新竹市,,,,351775,146486,39257,185743,10937,196680
公投第９案,嘉義市,,,,221553,84825,25741,110566,7468,118034
公投第９案,臺北市,,,,2228430,922395,279844,1202239,74941,1277180
公投第９案,高雄市,,,,2353342,968007,290441,1258448,97698,1356146
公投第９案,新北市,,,,3375513,1338359,382433,1720792,127605,1848397
公投第９案,臺中市,,,,2295642,979821,256540,1236361,81945,1318306
公投第９案,臺南市,,,,1594821,560594,178274,738868,60334,799202
公投第９案,桃園市,,,,1801823,688091,178491,866582,53039,919621
公投第９案,連江縣,北竿鄉,,,2125,888,162,1050,53,1103
公投第９案,連江縣,莒光鄉,,,1481,620,112,732,45,777
公投第９案,連江縣,東引鄉,,,1138,497,66,563,18,581
公投第９案,連江縣,南竿鄉,,,6461,2746,396,3142,132,3274
公投第９案,金門縣,金寧鄉,,,28162,7833,1706,9539,651,10190
公投第９案,金門縣,金湖鎮,,,25915,7148,1498,8646,730,9376
公投第９案,金門縣,金城鎮,,,37815,10357,1954,12311,872,13183
公投第９案,金門縣,烈嶼鄉,,,11676,3399,572,3971,283,4254
公投第９案,金門縣,烏坵鄉,,,567,135,19,154,11,165
公投第９案,金門縣,金沙鎮,,,18560,5110,907,6017,545,6562
公投第９案,宜蘭縣,蘇澳鎮,,,34512,13047,4165,17212,1971,19183
公投第９案,宜蘭縣,壯圍鄉,,,21447,8267,2706,10973,1259,12232
公投第９案,宜蘭縣,羅東鎮,,,57686,23633,7130,30763,2324,33087
公投第９案,宜蘭縣,南澳鄉,,,4644,1938,476,2414,218,2632
公投第９案,宜蘭縣,大同鄉,,,4935,1552,486,2038,285,2323
公投第９案,宜蘭縣,三星鄉,,,19051,6720,2202,8922,991,9913
公投第９案,宜蘭縣,冬山鄉,,,45405,17337,5095,22432,1730,24162
公投第９案,宜蘭縣,員山鄉,,,28131,10227,3218,13445,1551,14996
公投第９案,宜蘭縣,五結鄉,,,34892,13187,3935,17122,1445,18567
公投第９案,宜蘭縣,礁溪鄉,,,31084,11637,3652,15289,1324,16613
公投第９案,宜蘭縣,頭城鎮,,,25135,9379,3000,12379,1381,13760
公投第９案,宜蘭縣,宜蘭市,,,79167,32123,9145,41268,3184,44452
公投第９案,新竹縣,寶山鄉,,,12973,5620,1533,7153,431,7584
公投第９案,新竹縣,峨眉鄉,,,5068,2175,595,2770,279,3049
公投第９案,新竹縣,竹北市,,,137129,60847,14949,75796,3703,79499
公投第９案,新竹縣,北埔鄉,,,8180,3408,853,4261,284,4545
公投第９案,新竹縣,新豐鄉,,,45790,19113,4910,24023,1488,25511
公投第９案,新竹縣,五峰鄉,,,3997,1167,381,1548,103,1651
公投第９案,新竹縣,竹東鎮,,,78794,31963,7885,39848,2370,42218
公投第９案,新竹縣,新埔鎮,,,28894,12046,3055,15101,1093,16194
公投第９案,新竹縣,關西鎮,,,24712,10235,2748,12983,974,13957
公投第９案,新竹縣,橫山鄉,,,11346,4871,1288,6159,516,6675
公投第９案,新竹縣,湖口鄉,,,63511,26766,6632,33398,1932,35330
公投第９案,新竹縣,芎林鄉,,,17293,7422,2022,9444,673,10117
公投第９案,新竹縣,尖石鄉,,,7364,2212,713,2925,213,3138
公投第９案,苗栗縣,通霄鎮,,,29709,10767,3578,14345,1550,15895
公投第９案,苗栗縣,後龍鎮,,,30948,11663,3645,15308,1670,16978
公投第９案,苗栗縣,竹南鎮,,,68528,28434,7574,36008,2346,38354
公投第９案,苗栗縣,苑裡鎮,,,38890,15629,4685,20314,1797,22111
公投第９案,苗栗縣,西湖鄉,,,6382,2572,703,3275,247,3522
公投第９案,苗栗縣,大湖鄉,,,12653,4826,1340,6166,561,6727
公投第９案,苗栗縣,三義鄉,,,13889,6215,1468,7683,453,8136
公投第９案,苗栗縣,頭屋鄉,,,9390,4274,1432,5706,379,6085
公投第９案,苗栗縣,公館鄉,,,28318,12057,3320,15377,1336,16713
公投第９案,苗栗縣,銅鑼鄉,,,15424,6390,1673,8063,577,8640
公投第９案,苗栗縣,造橋鄉,,,11027,4561,1261,5822,591,6413
公投第９案,苗栗縣,南庄鄉,,,8784,2985,947,3932,376,4308
公投第９案,苗栗縣,獅潭鄉,,,3968,1450,374,1824,194,2018
公投第９案,苗栗縣,泰安鄉,,,5180,2394,688,3082,275,3357
公投第９案,苗栗縣,三灣鄉,,,5852,2313,742,3055,320,3375
公投第９案,苗栗縣,苗栗市,,,74249,33058,7432,40490,2312,42802
公投第９案,苗栗縣,頭份市,,,83617,35262,8947,44209,2801,47010
公投第９案,苗栗縣,卓蘭鎮,,,14772,6068,1785,7853,698,8551
公投第９案,彰化縣,竹塘鄉,,,12821,4563,1487,6050,772,6822
公投第９案,彰化縣,彰化市,,,190995,82918,24013,106931,8048,114979
公投第９案,彰化縣,北斗鎮,,,27593,11516,3186,14702,1353,16055
公投第９案,彰化縣,鹿港鎮,,,70505,29288,7935,37223,3450,40673
公投第９案,彰化縣,員林市,,,102028,41981,11756,53737,3746,57483
公投第９案,彰化縣,和美鎮,,,75286,31150,8679,39829,2760,42589
公投第９案,彰化縣,秀水鄉,,,32394,13713,4039,17752,1407,19159
公投第９案,彰化縣,福興鄉,,,39745,14916,4420,19336,2066,21402
公投第９案,彰化縣,田中鎮,,,35391,14161,4397,18558,1808,20366
公投第９案,彰化縣,社頭鄉,,,36306,15033,4210,19243,1509,20752
公投第９案,彰化縣,田尾鄉,,,23179,9767,2733,12500,1114,13614
公投第９案,彰化縣,芳苑鄉,,,29291,9721,2873,12594,1607,14201
公投第９案,彰化縣,溪州鄉,,,25405,8840,2710,11550,1308,12858
公投第９案,彰化縣,大城鄉,,,14713,3812,1159,4971,633,5604
公投第９案,彰化縣,埤頭鄉,,,25677,9747,2585,12332,1576,13908
公投第９案,彰化縣,芬園鄉,,,20408,7947,2336,10283,1021,11304
公投第９案,彰化縣,永靖鄉,,,31239,13073,3831,16904,1549,18453
公投第９案,彰化縣,埔心鄉,,,29642,12765,3760,16525,1644,18169
公投第９案,彰化縣,埔鹽鄉,,,28026,12202,3172,15374,1600,16974
公投第９案,彰化縣,二水鄉,,,13339,5428,1776,7204,783,7987
公投第９案,彰化縣,大村鄉,,,31492,13263,3714,16977,1492,18469
公投第９案,彰化縣,線西鄉,,,14065,5957,1685,7642,722,8364
公投第９案,彰化縣,花壇鄉,,,38924,16349,4652,21001,1751,22752
公投第９案,彰化縣,伸港鄉,,,30407,12503,3290,15793,1402,17195
公投第９案,彰化縣,二林鎮,,,42976,15738,4574,20312,2130,22442
公投第９案,彰化縣,溪湖鎮,,,45147,18938,5142,24080,2056,26136
公投第９案,南投縣,仁愛鄉,,,12589,4727,1405,6132,519,6651
公投第９案,南投縣,竹山鎮,,,47034,18660,4928,23588,2221,25809
公投第９案,南投縣,國姓鄉,,,16597,6677,1824,8501,784,9285
公投第９案,南投縣,南投市,,,84328,38111,9402,47513,3138,50651
公投第９案,南投縣,集集鎮,,,9611,3923,1084,5007,526,5533
公投第９案,南投縣,草屯鎮,,,82922,35644,9073,44717,2943,47660
公投第９案,南投縣,中寮鄉,,,13181,5406,1473,6879,735,7614
公投第９案,南投縣,水里鄉,,,15458,6143,1693,7836,693,8529
公投第９案,南投縣,鹿谷鄉,,,15941,6158,1620,7778,737,8515
公投第９案,南投縣,信義鄉,,,13299,4802,1623,6425,1071,7496
公投第９案,南投縣,埔里鎮,,,68763,29122,7155,36277,2927,39204
公投第９案,南投縣,魚池鄉,,,13958,5432,1494,6926,632,7558
公投第９案,南投縣,名間鄉,,,33408,14150,3930,18080,1870,19950
公投第９案,雲林縣,臺西鄉,,,21125,6431,1833,8264,1227,9491
公投第９案,雲林縣,麥寮鄉,,,37119,12612,3512,16124,1876,18000
公投第９案,雲林縣,崙背鄉,,,21050,6828,2094,8922,1095,10017
公投第９案,雲林縣,四湖鄉,,,20983,5308,1658,6966,1030,7996
公投第９案,雲林縣,口湖鄉,,,24193,7175,2418,9593,1543,11136
公投第９案,雲林縣,褒忠鄉,,,11381,3848,1298,5146,550,5696
公投第９案,雲林縣,莿桐鄉,,,24570,8760,3042,11802,1627,13429
公投第９案,雲林縣,大埤鄉,,,16509,5545,2021,7566,839,8405
公投第９案,雲林縣,元長鄉,,,22830,6209,2193,8402,1168,9570
公投第９案,雲林縣,西螺鎮,,,38142,13877,4030,17907,2025,19932
公投第９案,雲林縣,虎尾鎮,,,58167,22054,6123,28177,2270,30447
公投第９案,雲林縣,斗六市,,,89761,37857,9790,47647,3219,50866
公投第９案,雲林縣,斗南鎮,,,38138,15189,4288,19477,1835,21312
公投第９案,雲林縣,林內鄉,,,15551,5885,1800,7685,1061,8746
公投第９案,雲林縣,古坑鄉,,,27477,9837,2928,12765,1454,14219
公投第９案,雲林縣,二崙鄉,,,23367,7059,2495,9554,1370,10924
公投第９案,雲林縣,土庫鎮,,,24412,8494,2672,11166,1471,12637
公投第９案,雲林縣,北港鎮,,,33958,12419,3822,16241,2050,18291
公投第９案,雲林縣,水林鄉,,,22508,6252,2074,8326,1211,9537
公投第９案,雲林縣,東勢鄉,,,13239,4284,1330,5614,843,6457
公投第９案,嘉義縣,竹崎鄉,,,31228,10766,3339,14105,1485,15590
公投第９案,嘉義縣,梅山鄉,,,17083,6323,1919,8242,1001,9243
公投第９案,嘉義縣,東石鄉,,,21915,5321,1829,7150,1256,8406
公投第９案,嘉義縣,溪口鄉,,,13105,4264,1472,5736,724,6460
公投第９案,嘉義縣,義竹鄉,,,16647,5589,1748,7337,920,8257
公投第９案,嘉義縣,太保市,,,31568,11386,3585,14971,1457,16428
公投第９案,嘉義縣,新港鄉,,,27342,9650,3135,12785,1652,14437
公投第９案,嘉義縣,布袋鎮,,,23965,7715,2385,10100,1333,11433
公投第９案,嘉義縣,鹿草鄉,,,13937,4178,1371,5549,951,6500
公投第９案,嘉義縣,六腳鄉,,,20821,5627,1792,7419,954,8373
公投第９案,嘉義縣,大林鎮,,,26922,9524,2915,12439,1139,13578
公投第９案,嘉義縣,番路鄉,,,10156,3930,1119,5049,520,5569
公投第９案,嘉義縣,阿里山鄉,,,4691,1540,400,1940,105,2045
公投第９案,嘉義縣,朴子市,,,35191,12495,3747,16242,1655,17897
公投第９案,嘉義縣,中埔鄉,,,39139,12424,3869,16293,1632,17925
公投第９案,嘉義縣,民雄鄉,,,61209,22263,7199,29462,3013,32475
公投第９案,嘉義縣,水上鄉,,,43857,15484,5157,20641,2221,22862
公投第９案,嘉義縣,大埔鄉,,,3999,1505,446,1951,163,2114
公投第９案,屏東縣,鹽埔鄉,,,22402,7682,2584,10266,1126,11392
公投第９案,屏東縣,高樹鄉,,,21697,6606,2450,9056,1304,10360
公投第９案,屏東縣,竹田鄉,,,15353,5870,2003,7873,909,8782
公投第９案,屏東縣,萬巒鄉,,,17945,5851,2028,7879,1026,8905
公投第９案,屏東縣,內埔鄉,,,47558,15290,4786,20076,1864,21940
公投第９案,屏東縣,潮州鎮,,,46444,16646,5232,21878,1897,23775
公投第９案,屏東縣,東港鎮,,,39495,13808,4617,18425,2364,20789
公投第９案,屏東縣,萬丹鄉,,,43478,15318,5129,20447,2282,22729
公投第９案,屏東縣,麟洛鄉,,,9970,3938,1208,5146,423,5569
公投第９案,屏東縣,長治鄉,,,26256,9495,3250,12745,1553,14298
公投第９案,屏東縣,新園鄉,,,30706,10271,3619,13890,1967,15857
公投第９案,屏東縣,里港鄉,,,22128,7828,2811,10639,1417,12056
公投第９案,屏東縣,屏東市,,,170148,64458,18343,82801,5695,88496
公投第９案,屏東縣,恆春鎮,,,25661,8238,2668,10906,894,11800
公投第９案,屏東縣,來義鄉,,,6257,2515,662,3177,389,3566
公投第９案,屏東縣,九如鄉,,,19132,6789,2253,9042,1276,10318
公投第９案,屏東縣,琉球鄉,,,10706,2928,867,3795,552,4347
公投第９案,屏東縣,瑪家鄉,,,5663,2264,780,3044,235,3279
公投第９案,屏東縣,獅子鄉,,,4230,1346,367,1713,121,1834
公投第９案,屏東縣,牡丹鄉,,,4314,1251,370,1621,108,1729
公投第９案,屏東縣,泰武鄉,,,4344,1771,611,2382,318,2700
公投第９案,屏東縣,三地門鄉,,,6373,2114,776,2890,296,3186
公投第９案,屏東縣,霧臺鄉,,,2950,1077,381,1458,112,1570
公投第９案,屏東縣,枋山鄉,,,4856,1577,577,2154,247,2401
公投第９案,屏東縣,春日鄉,,,3923,719,261,980,48,1028
公投第９案,屏東縣,滿州鄉,,,7206,2125,650,2775,219,2994
公投第９案,屏東縣,林邊鄉,,,15691,5595,1994,7589,1007,8596
公投第９案,屏東縣,佳冬鄉,,,17063,5642,1673,7315,1050,8365
公投第９案,屏東縣,車城鄉,,,7595,1997,728,2725,297,3022
公投第９案,屏東縣,南州鄉,,,9479,3287,1090,4377,571,4948
公投第９案,屏東縣,崁頂鄉,,,12270,4264,1436,5700,588,6288
公投第９案,屏東縣,新埤鄉,,,9033,2922,1058,3980,490,4470
公投第９案,屏東縣,枋寮鄉,,,21394,7274,2544,9818,1418,11236
公投第９案,臺東縣,太麻里鄉,,,9666,3009,1008,4017,545,4562
公投第９案,臺東縣,臺東市,,,87803,34398,9425,43823,3431,47254
公投第９案,臺東縣,海端鄉,,,3278,1102,424,1526,206,1732
公投第９案,臺東縣,長濱鄉,,,6484,1578,567,2145,448,2593
公投第９案,臺東縣,卑南鄉,,,14976,5260,1677,6937,840,7777
公投第９案,臺東縣,成功鎮,,,12426,4034,1197,5231,846,6077
公投第９案,臺東縣,達仁鄉,,,3137,1191,388,1579,186,1765
公投第９案,臺東縣,關山鎮,,,7509,2664,750,3414,259,3673
公投第９案,臺東縣,蘭嶼鄉,,,4181,972,443,1415,128,1543
公投第９案,臺東縣,綠島鄉,,,3579,1139,317,1456,92,1548
公投第９案,臺東縣,金峰鄉,,,3028,1011,396,1407,210,1617
公投第９案,臺東縣,延平鄉,,,2930,979,346,1325,186,1511
公投第９案,臺東縣,池上鄉,,,7162,2180,719,2899,342,3241
公投第９案,臺東縣,東河鄉,,,7635,2037,739,2776,424,3200
公投第９案,臺東縣,大武鄉,,,5266,1563,565,2128,543,2671
公投第９案,臺東縣,鹿野鄉,,,6936,2037,707,2744,342,3086
公投第９案,花蓮縣,卓溪鄉,,,4947,1801,540,2341,338,2679
公投第９案,花蓮縣,壽豐鄉,,,15847,5961,1919,7880,861,8741
公投第９案,花蓮縣,吉安鄉,,,72116,28426,6905,35331,2503,37834
公投第９案,花蓮縣,玉里鎮,,,20650,6471,1980,8451,1232,9683
公投第９案,花蓮縣,秀林鄉,,,12562,4080,1398,5478,550,6028
公投第９案,花蓮縣,萬榮鄉,,,5269,1748,734,2482,344,2826
公投第９案,花蓮縣,新城鄉,,,17029,6577,1897,8474,685,9159
公投第９案,花蓮縣,花蓮市,,,84807,34380,8293,42673,2728,45401
公投第９案,花蓮縣,鳳林鎮,,,9676,3785,953,4738,555,5293
公投第９案,花蓮縣,瑞穗鄉,,,10279,3418,1003,4421,601,5022
公投第９案,花蓮縣,豐濱鄉,,,4395,1129,456,1585,302,1887
公投第９案,花蓮縣,富里鄉,,,9065,2681,890,3571,547,4118
公投第９案,花蓮縣,光復鄉,,,11417,3869,1206,5075,741,5816
公投第９案,澎湖縣,七美鄉,,,3374,660,215,875,118,993
公投第９案,澎湖縣,馬公市,,,53655,19190,4770,23960,1889,25849
公投第９案,澎湖縣,望安鄉,,,4628,1146,380,1526,233,1759
公投第９案,澎湖縣,西嶼鄉,,,7382,1545,522,2067,362,2429
公投第９案,澎湖縣,白沙鄉,,,8625,2487,741,3228,372,3600
公投第９案,澎湖縣,湖西鄉,,,12741,3895,988,4883,469,5352
公投第９案,基隆市,暖暖區,,,33225,12776,3535,16311,832,17143
公投第９案,基隆市,中正區,,,45545,15237,4438,19675,1514,21189
公投第９案,基隆市,仁愛區,,,36738,13796,4161,17957,1543,19500
公投第９案,基隆市,安樂區,,,70396,27117,7202,34319,2039,36358
公投第９案,基隆市,七堵區,,,46256,17292,5343,22635,1570,24205
公投第９案,基隆市,信義區,,,46014,17997,4548,22545,1198,23743
公投第９案,基隆市,中山區,,,41856,15210,4487,19697,1264,20961
公投第９案,新竹市,北區,,,123122,50518,13579,64097,4102,68199
公投第９案,新竹市,香山區,,,64896,26916,7119,34035,2259,36294
公投第９案,新竹市,東區,,,163757,69052,18559,87611,4576,92187
公投第９案,嘉義市,東區,,,100647,38093,12423,50516,3289,53805
公投第９案,嘉義市,西區,,,120906,46732,13318,60050,4179,64229
公投第９案,臺北市,士林區,,,241854,95594,32145,127739,9355,137094
公投第９案,臺北市,文山區,,,227211,100344,26928,127272,7692,134964
公投第９案,臺北市,大安區,,,252645,105524,31885,137409,7116,144525
公投第９案,臺北市,南港區,,,101907,42721,12523,55244,3123,58367
公投第９案,臺北市,松山區,,,169278,72672,21614,94286,5549,99835
公投第９案,臺北市,大同區,,,107557,42181,15060,57241,4408,61649
公投第９案,臺北市,內湖區,,,236824,101210,28795,130005,6798,136803
公投第９案,臺北市,信義區,,,190444,80252,22789,103041,6057,109098
公投第９案,臺北市,中正區,,,128292,54214,16318,70532,3896,74428
公投第９案,臺北市,北投區,,,213250,85399,26239,111638,7510,119148
公投第９案,臺北市,萬華區,,,164020,63881,20023,83904,6601,90505
公投第９案,臺北市,中山區,,,195148,78403,25525,103928,6836,110764
公投第９案,高雄市,新興區,,,44355,18404,6488,24892,1616,26508
公投第９案,高雄市,燕巢區,,,26012,10042,3140,13182,1444,14626
公投第９案,高雄市,旗山區,,,31996,12146,3836,15982,1525,17507
公投第９案,高雄市,大寮區,,,97309,38925,11430,50355,4150,54505
公投第９案,高雄市,彌陀區,,,16487,6401,2587,8988,1082,10070
公投第９案,高雄市,林園區,,,59129,22575,6889,29464,2778,32242
公投第９案,高雄市,鹽埕區,,,21617,8309,2943,11252,676,11928
公投第９案,高雄市,楠梓區,,,153132,65274,18600,83874,7198,91072
公投第９案,高雄市,左營區,,,161367,71184,19573,90757,5424,96181
公投第９案,高雄市,三民區,,,289519,120091,37189,157280,10524,167804
公投第９案,高雄市,鼓山區,,,114979,48707,14112,62819,4086,66905
公投第９案,高雄市,小港區,,,132733,55215,15762,70977,5177,76154
公投第９案,高雄市,大樹區,,,36772,13972,4324,18296,1704,20000
公投第９案,高雄市,鳳山區,,,300510,129085,35291,164376,11320,175696
公投第９案,高雄市,旗津區,,,24860,8132,2910,11042,1324,12366
公投第９案,高雄市,前金區,,,23928,9799,3417,13216,904,14120
公投第９案,高雄市,苓雅區,,,146786,62255,19545,81800,5685,87485
公投第９案,高雄市,田寮區,,,6671,2021,706,2727,358,3085
公投第９案,高雄市,岡山區,,,81244,35934,9783,45717,3433,49150
公投第９案,高雄市,仁武區,,,73611,30858,8796,39654,2570,42224
公投第９案,高雄市,鳥松區,,,39191,16620,5282,21902,1550,23452
公投第９案,高雄市,橋頭區,,,32565,13650,4323,17973,1929,19902
公投第９案,高雄市,大社區,,,30046,11744,3908,15652,1396,17048
公投第９案,高雄市,湖內區,,,25729,9497,3356,12853,1079,13932
公投第９案,高雄市,阿蓮區,,,24534,9103,2878,11981,954,12935
公投第９案,高雄市,梓官區,,,31025,12179,3914,16093,1582,17675
公投第９案,高雄市,路竹區,,,43850,17739,5509,23248,2307,25555
公投第９案,高雄市,永安區,,,12001,5146,1654,6800,682,7482
公投第９案,高雄市,茄萣區,,,26212,9093,3132,12225,1502,13727
公投第９案,高雄市,茂林區,,,1615,758,213,971,90,1061
公投第９案,高雄市,桃源區,,,3498,1239,395,1634,109,1743
公投第９案,高雄市,甲仙區,,,5417,1767,518,2285,314,2599
公投第９案,高雄市,美濃區,,,35311,13318,3814,17132,1879,19011
公投第９案,高雄市,內門區,,,13002,3998,1359,5357,762,6119
公投第９案,高雄市,杉林區,,,10607,3088,1137,4225,507,4732
公投第９案,高雄市,六龜區,,,11501,3496,1226,4722,698,5420
公投第９案,高雄市,那瑪夏區,,,2424,917,303,1220,165,1385
公投第９案,高雄市,前鎮區,,,161797,65326,20199,85525,7215,92740
公投第９案,新北市,金山區,,,18978,6592,2052,8644,929,9573
公投第９案,新北市,瑞芳區,,,35036,11889,3499,15388,1389,16777
公投第９案,新北市,貢寮區,,,11279,3212,1103,4315,491,4806
公投第９案,新北市,雙溪區,,,7999,2684,763,3447,415,3862
公投第９案,新北市,泰山區,,,64252,25751,7077,32828,2195,35023
公投第９案,新北市,板橋區,,,463411,183906,55619,239525,18834,258359
公投第９案,新北市,永和區,,,187798,82910,20904,103814,6214,110028
公投第９案,新北市,蘆洲區,,,167457,62795,19292,82087,6999,89086
公投第９案,新北市,石碇區,,,6861,2295,801,3096,305,3401
公投第９案,新北市,三重區,,,329846,126943,40687,167630,15951,183581
公投第９案,新北市,樹林區,,,152102,59598,18134,77732,5540,83272
公投第９案,新北市,中和區,,,355978,146291,38167,184458,11790,196248
公投第９案,新北市,新店區,,,264053,112489,27746,140235,8099,148334
公投第９案,新北市,新莊區,,,344981,139805,40941,180746,14127,194873
公投第９案,新北市,鶯歌區,,,71645,27021,7767,34788,2543,37331
公投第９案,新北市,三峽區,,,94291,35620,10204,45824,3252,49076
公投第９案,新北市,土城區,,,200783,78444,23052,101496,8032,109528
公投第９案,新北市,淡水區,,,147272,56884,15744,72628,4275,76903
公投第９案,新北市,汐止區,,,173831,66826,18635,85461,5764,91225
公投第９案,新北市,五股區,,,72443,27203,8114,35317,2891,38208
公投第９案,新北市,林口區,,,86203,36130,9352,45482,2631,48113
公投第９案,新北市,三芝區,,,20119,6678,2109,8787,749,9536
公投第９案,新北市,坪林區,,,5891,1953,621,2574,354,2928
公投第９案,新北市,深坑區,,,20624,8138,2354,10492,709,11201
公投第９案,新北市,八里區,,,32970,12479,3635,16114,1313,17427
公投第９案,新北市,石門區,,,10528,3763,1130,4893,535,5428
公投第９案,新北市,平溪區,,,4321,1356,440,1796,231,2027
公投第９案,新北市,萬里區,,,19297,6706,1960,8666,881,9547
公投第９案,新北市,烏來區,,,5264,1998,531,2529,167,2696
公投第９案,臺中市,清水區,,,71528,30691,8080,38771,3018,41789
公投第９案,臺中市,霧峰區,,,55225,24158,6486,30644,2571,33215
公投第９案,臺中市,大里區,,,171769,70764,18720,89484,6179,95663
公投第９案,臺中市,和平區,,,9498,4219,1051,5270,393,5663
公投第９案,臺中市,太平區,,,157926,63860,16284,80144,5343,85487
公投第９案,臺中市,龍井區,,,63584,26267,6958,33225,2229,35454
公投第９案,臺中市,外埔區,,,27059,11940,2774,14714,1017,15731
公投第９案,臺中市,烏日區,,,61705,26319,7090,33409,2506,35915
公投第９案,臺中市,大雅區,,,77189,33234,7930,41164,2665,43829
公投第９案,臺中市,大安區,,,16520,6877,1904,8781,907,9688
公投第９案,臺中市,石岡區,,,12880,5462,1576,7038,585,7623
公投第９案,臺中市,沙鹿區,,,74207,31524,7795,39319,2682,42001
公投第９案,臺中市,后里區,,,44962,18978,5164,24142,1842,25984
公投第９案,臺中市,潭子區,,,89487,38184,9737,47921,2886,50807
公投第９案,臺中市,神岡區,,,54565,23245,6451,29696,2231,31927
公投第９案,臺中市,大甲區,,,63069,26358,6823,33181,2601,35782
公投第９案,臺中市,梧棲區,,,47040,19604,5267,24871,1888,26759
公投第９案,臺中市,北屯區,,,227720,98529,23765,122294,7061,129355
公投第９案,臺中市,南區,,,103643,46759,12828,59587,3822,63409
公投第９案,臺中市,南屯區,,,135448,60752,16391,77143,4455,81598
公投第９案,臺中市,北區,,,124621,52039,13793,65832,3502,69334
公投第９案,臺中市,東勢區,,,43181,18187,4704,22891,2135,25026
公投第９案,臺中市,西屯區,,,183814,79926,20371,100297,5642,105939
公投第９案,臺中市,中區,,,14696,5791,1823,7614,526,8140
公投第９案,臺中市,東區,,,64291,27322,7695,35017,2488,37505
公投第９案,臺中市,西區,,,95040,40385,11765,52150,2891,55041
公投第９案,臺中市,豐原區,,,136658,60188,16041,76229,5127,81356
公投第９案,臺中市,新社區,,,20860,8051,2049,10100,760,10860
公投第９案,臺中市,大肚區,,,47457,20208,5225,25433,1993,27426
公投第９案,臺南市,安南區,,,159654,57329,18271,75600,6561,82161
公投第９案,臺南市,六甲區,,,19144,6067,2143,8210,895,9105
公投第９案,臺南市,官田區,,,18675,5969,2099,8068,687,8755
公投第９案,臺南市,白河區,,,24894,6981,2370,9351,909,10260
公投第９案,臺南市,關廟區,,,29913,10607,3519,14126,1243,15369
公投第９案,臺南市,鹽水區,,,22121,6972,2373,9345,886,10231
公投第９案,臺南市,龍崎區,,,3713,1191,348,1539,160,1699
公投第９案,臺南市,中西區,,,65261,24374,8814,33188,2516,35704
公投第９案,臺南市,北區,,,110906,41607,13080,54687,3729,58416
公投第９案,臺南市,柳營區,,,18804,6152,1934,8086,937,9023
公投第９案,臺南市,永康區,,,195001,71529,21293,92822,6646,99468
公投第９案,臺南市,安平區,,,55379,19673,6250,25923,1661,27584
公投第９案,臺南市,左鎮區,,,4418,1234,439,1673,231,1904
公投第９案,臺南市,學甲區,,,22567,7318,2285,9603,855,10458
公投第９案,臺南市,新營區,,,64949,22908,6715,29623,1878,31501
公投第９案,臺南市,七股區,,,19950,5754,1890,7644,781,8425
公投第９案,臺南市,西港區,,,21564,6712,2132,8844,761,9605
公投第９案,臺南市,佳里區,,,50407,18292,5510,23802,1986,25788
公投第９案,臺南市,新化區,,,37296,13548,4320,17868,1826,19694
公投第９案,臺南市,將軍區,,,17754,5072,1558,6630,665,7295
公投第９案,臺南市,北門區,,,9925,2663,846,3509,292,3801
公投第９案,臺南市,善化區,,,39950,13857,4592,18449,1620,20069
公投第９案,臺南市,新市區,,,30386,11298,3479,14777,1250,16027
公投第９案,臺南市,安定區,,,26104,9470,2944,12414,1263,13677
公投第９案,臺南市,山上區,,,6511,1873,609,2482,275,2757
公投第９案,臺南市,玉井區,,,12357,4104,1186,5290,505,5795
公投第９案,臺南市,楠西區,,,8528,2572,744,3316,341,3657
公投第９案,臺南市,南化區,,,7786,2456,808,3264,355,3619
公投第９案,臺南市,歸仁區,,,57387,20762,6557,27319,2338,29657
公投第９案,臺南市,南區,,,108650,37203,12765,49968,4367,54335
公投第９案,臺南市,東區,,,153359,58738,18683,77421,4959,82380
公投第９案,臺南市,仁德區,,,64632,24009,7048,31057,2573,33630
公投第９案,臺南市,麻豆區,,,37963,12403,4280,16683,1193,17876
公投第９案,臺南市,後壁區,,,20841,6290,1929,8219,1046,9265
公投第９案,臺南市,東山區,,,18471,4446,1557,6003,746,6749
公投第９案,臺南市,大內區,,,8654,2718,875,3593,429,4022
公投第９案,臺南市,下營區,,,20947,6443,2029,8472,969,9441
公投第９案,桃園市,龍潭區,,,101574,40992,9904,50896,2941,53837
公投第９案,桃園市,大園區,,,73900,26424,7468,33892,2188,36080
公投第９案,桃園市,大溪區,,,78285,29096,8537,37633,3237,40870
公投第９案,桃園市,八德區,,,165065,61711,15775,77486,5315,82801
公投第９案,桃園市,中壢區,,,334402,133601,31671,165272,9376,174648
公投第９案,桃園市,桃園區,,,359790,135146,36154,171300,9713,181013
公投第９案,桃園市,蘆竹區,,,129252,47832,13297,61129,3997,65126
公投第９案,桃園市,新屋區,,,41461,16624,4714,21338,1533,22871
公投第９案,桃園市,平鎮區,,,183560,73505,18054,91559,4915,96474
公投第９案,桃園市,觀音區,,,55149,19925,5698,25623,1844,27467
公投第９案,桃園市,楊梅區,,,137917,52981,12652,65633,3838,69471
公投第９案,桃園市,龜山區,,,131702,46731,13559,60290,3728,64018
公投第９案,桃園市,復興區,,,9766,3523,1008,4531,414,4945
公投第９案,連江縣,南竿鄉,介壽村,1,1967,837,126,963,50,1013
公投第９案,連江縣,南竿鄉,福沃村、復興村,2,1837,727,111,838,40,878
公投第９案,連江縣,南竿鄉,清水村、珠螺村,3,1114,476,92,568,21,589
公投第９案,連江縣,南竿鄉,馬祖村、津沙村、四維村、仁愛村,4,1543,706,67,773,21,794
公投第９案,連江縣,北竿鄉,后沃村、橋仔村、塘岐村,5,1515,640,130,770,45,815
公投第９案,連江縣,北竿鄉,坂里村、白沙村、芹壁村,6,610,248,32,280,8,288
公投第９案,連江縣,莒光鄉,田沃村、西坵村、青帆村,7,698,270,48,318,17,335
公投第９案,連江縣,莒光鄉,大坪村、福正村,8,783,350,64,414,28,442
公投第９案,連江縣,東引鄉,樂華村、中柳村,9,1138,497,66,563,18,581
公投第９案,金門縣,金城鎮,東門里,1,1396,400,67,467,25,492
公投第９案,金門縣,金城鎮,東門里,2,1831,504,124,628,60,688
公投第９案,金門縣,金城鎮,東門里,3,1750,487,104,591,47,638
公投第９案,金門縣,金城鎮,南門里,4,1889,570,94,664,54,718
公投第９案,金門縣,金城鎮,南門里,5,1675,411,90,501,36,537
公投第９案,金門縣,金城鎮,南門里,6,1901,626,106,732,48,780
公投第９案,金門縣,金城鎮,西門里,7,1610,395,99,494,62,556
公投第９案,金門縣,金城鎮,西門里,8,1687,484,85,569,33,602
公投第９案,金門縣,金城鎮,西門里,9,1594,474,79,553,27,580
公投第９案,金門縣,金城鎮,西門里,10,1726,488,83,571,27,598
公投第９案,金門縣,金城鎮,西門里,11,1733,505,93,598,33,631
公投第９案,金門縣,金城鎮,西門里,12,1532,508,88,596,29,625
公投第９案,金門縣,金城鎮,北門里,13,2079,554,108,662,59,721
公投第９案,金門縣,金城鎮,北門里,14,2033,529,81,610,39,649
公投第９案,金門縣,金城鎮,賢庵里,15,2517,709,127,836,46,882
公投第９案,金門縣,金城鎮,賢庵里,16,2083,569,114,683,43,726
公投第９案,金門縣,金城鎮,金水里,17,2140,586,107,693,41,734
公投第９案,金門縣,金城鎮,古城里,18,2435,549,98,647,60,707
公投第９案,金門縣,金城鎮,古城里,19,1353,239,63,302,43,345
公投第９案,金門縣,金城鎮,珠沙里,20,1574,398,76,474,22,496
公投第９案,金門縣,金城鎮,珠沙里,21,1277,372,68,440,38,478
公投第９案,金門縣,金寧鄉,古寧村,22,1735,388,77,465,76,541
公投第９案,金門縣,金寧鄉,古寧村,23,1537,367,83,450,34,484
公投第９案,金門縣,金寧鄉,安美村,24,1766,445,103,548,43,591
公投第９案,金門縣,金寧鄉,安美村,25,1015,303,55,358,17,375
公投第９案,金門縣,金寧鄉,安美村,26,1726,466,91,557,53,610
公投第９案,金門縣,金寧鄉,湖埔村,27,1691,414,82,496,36,532
公投第９案,金門縣,金寧鄉,湖埔村,28,2044,586,237,823,42,865
公投第９案,金門縣,金寧鄉,湖埔村,29,1848,636,90,726,38,764
公投第９案,金門縣,金寧鄉,湖埔村,30,1735,498,69,567,31,598
公投第９案,金門縣,金寧鄉,榜林村,31,1795,487,100,587,40,627
公投第９案,金門縣,金寧鄉,榜林村,32,1834,441,89,530,51,581
公投第９案,金門縣,金寧鄉,榜林村,33,1528,433,88,521,31,552
公投第９案,金門縣,金寧鄉,盤山村,34,1473,470,72,542,26,568
公投第９案,金門縣,金寧鄉,盤山村,35,1679,473,75,548,51,599
公投第９案,金門縣,金寧鄉,盤山村,36,1921,661,240,901,30,931
公投第９案,金門縣,金寧鄉,盤山村,37,1298,371,78,449,18,467
公投第９案,金門縣,金寧鄉,后盤村,38,1537,394,77,471,34,505
公投第９案,金門縣,烈嶼鄉,林湖村,39,1647,604,80,684,38,722
公投第９案,金門縣,烈嶼鄉,林湖村,40,1733,506,77,583,34,617
公投第９案,金門縣,烈嶼鄉,黃埔村,41,1635,472,88,560,44,604
公投第９案,金門縣,烈嶼鄉,西口村,42,1296,334,66,400,40,440
公投第９案,金門縣,烈嶼鄉,西口村,43,1099,275,54,329,26,355
公投第９案,金門縣,烈嶼鄉,上林村,44,1425,374,73,447,39,486
公投第９案,金門縣,烈嶼鄉,上岐村,45,1412,426,75,501,24,525
公投第９案,金門縣,烈嶼鄉,上岐村,46,1429,408,59,467,38,505
公投第９案,金門縣,烏坵鄉,大坵村,47,275,64,10,74,4,78
公投第９案,金門縣,烏坵鄉,小坵村,48,292,71,9,80,7,87
公投第９案,金門縣,金湖鎮,新市里,49,1348,401,91,492,48,540
公投第９案,金門縣,金湖鎮,新市里,50,1386,348,91,439,45,484
公投第９案,金門縣,金湖鎮,新市里,51,1403,481,79,560,44,604
公投第９案,金門縣,金湖鎮,山外里,52,1771,540,93,633,40,673
公投第９案,金門縣,金湖鎮,山外里,53,1493,415,86,501,59,560
公投第９案,金門縣,金湖鎮,溪湖里,54,1510,399,72,471,64,535
公投第９案,金門縣,金湖鎮,蓮庵里,55,1607,399,64,463,45,508
公投第９案,金門縣,金湖鎮,料羅里,56,2006,510,96,606,60,666
公投第９案,金門縣,金湖鎮,新湖里,57,1780,431,186,617,26,643
公投第９案,金門縣,金湖鎮,新湖里,58,1739,516,88,604,31,635
公投第９案,金門縣,金湖鎮,新湖里,59,1384,374,72,446,32,478
公投第９案,金門縣,金湖鎮,新湖里,60,1400,397,94,491,37,528
公投第９案,金門縣,金湖鎮,新湖里,61,1325,450,102,552,33,585
公投第９案,金門縣,金湖鎮,正義里,62,1236,314,62,376,36,412
公投第９案,金門縣,金湖鎮,正義里,63,1382,347,79,426,45,471
公投第９案,金門縣,金湖鎮,瓊林里,64,1631,452,66,518,42,560
公投第９案,金門縣,金湖鎮,瓊林里,65,1514,374,77,451,43,494
公投第９案,金門縣,金沙鎮,汶沙里,66,1909,505,98,603,52,655
公投第９案,金門縣,金沙鎮,汶沙里,67,1524,487,87,574,51,625
公投第９案,金門縣,金沙鎮,汶沙里,68,1673,431,59,490,55,545
公投第９案,金門縣,金沙鎮,何斗里,69,2003,502,85,587,73,660
公投第９案,金門縣,金沙鎮,浦山里,70,1212,382,81,463,30,493
公投第９案,金門縣,金沙鎮,浦山里,71,1126,297,79,376,34,410
公投第９案,金門縣,金沙鎮,西園里,72,1540,371,65,436,43,479
公投第９案,金門縣,金沙鎮,官嶼里,73,1216,280,59,339,37,376
公投第９案,金門縣,金沙鎮,官嶼里,74,950,200,34,234,24,258
公投第９案,金門縣,金沙鎮,三山里,75,1895,581,73,654,47,701
公投第９案,金門縣,金沙鎮,大洋里,76,1135,357,72,429,34,463
公投第９案,金門縣,金沙鎮,光前里,77,1252,336,60,396,39,435
公投第９案,金門縣,金沙鎮,光前里,78,1125,381,55,436,26,462
公投第９案,宜蘭縣,宜蘭市,民族里,1,982,376,117,493,23,516
公投第９案,宜蘭縣,宜蘭市,民族里,2,1270,510,140,650,48,698
公投第９案,宜蘭縣,宜蘭市,建軍里,3,849,356,87,443,18,461
公投第９案,宜蘭縣,宜蘭市,建軍里,4,756,318,94,412,28,440
公投第９案,宜蘭縣,宜蘭市,泰山里,5,1107,367,136,503,43,546
公投第９案,宜蘭縣,宜蘭市,泰山里,6,893,364,88,452,44,496
公投第９案,宜蘭縣,宜蘭市,負郭里,7,912,374,96,470,33,503
公投第９案,宜蘭縣,宜蘭市,負郭里,8,1335,539,155,694,57,751
公投第９案,宜蘭縣,宜蘭市,負郭里,9,686,256,74,330,35,365
公投第９案,宜蘭縣,宜蘭市,思源里,10,1366,635,150,785,30,815
公投第９案,宜蘭縣,宜蘭市,思源里,11,1363,586,155,741,35,776
公投第９案,宜蘭縣,宜蘭市,思源里,12,1540,674,166,840,44,884
公投第９案,宜蘭縣,宜蘭市,七結里,13,1341,563,140,703,24,727
公投第９案,宜蘭縣,宜蘭市,七結里,14,1209,487,140,627,57,684
公投第９案,宜蘭縣,宜蘭市,文化里,15,900,351,116,467,40,507
公投第９案,宜蘭縣,宜蘭市,文化里,16,980,369,105,474,40,514
公投第９案,宜蘭縣,宜蘭市,文化里,17,1165,473,142,615,27,642
公投第９案,宜蘭縣,宜蘭市,復興里,18,904,383,96,479,24,503
公投第９案,宜蘭縣,宜蘭市,復興里,19,813,341,87,428,29,457
公投第９案,宜蘭縣,宜蘭市,復興里,20,978,376,119,495,44,539
公投第９案,宜蘭縣,宜蘭市,民權里,21,1282,416,130,546,30,576
公投第９案,宜蘭縣,宜蘭市,民權里,22,465,187,74,261,13,274
公投第９案,宜蘭縣,宜蘭市,神農里,23,669,251,91,342,51,393
公投第９案,宜蘭縣,宜蘭市,神農里,24,923,392,96,488,39,527
公投第９案,宜蘭縣,宜蘭市,神農里,25,1006,383,108,491,37,528
公投第９案,宜蘭縣,宜蘭市,大新里,26,762,345,108,453,44,497
公投第９案,宜蘭縣,宜蘭市,新民里,27,727,306,109,415,36,451
公投第９案,宜蘭縣,宜蘭市,新民里,28,833,370,126,496,61,557
公投第９案,宜蘭縣,宜蘭市,進士里,29,1143,469,133,602,42,644
公投第９案,宜蘭縣,宜蘭市,進士里,30,979,400,112,512,21,533
公投第９案,宜蘭縣,宜蘭市,南橋里,31,1214,482,125,607,54,661
公投第９案,宜蘭縣,宜蘭市,凱旋里,32,1283,488,165,653,67,720
公投第９案,宜蘭縣,宜蘭市,南津里,33,946,402,109,511,37,548
公投第９案,宜蘭縣,宜蘭市,南津里,34,1090,459,93,552,34,586
公投第９案,宜蘭縣,宜蘭市,建業里,35,943,398,115,513,18,531
公投第９案,宜蘭縣,宜蘭市,建業里,36,774,333,119,452,40,492
公投第９案,宜蘭縣,宜蘭市,擺厘里,37,968,440,118,558,33,591
公投第９案,宜蘭縣,宜蘭市,擺厘里,38,926,424,121,545,27,572
公投第９案,宜蘭縣,宜蘭市,擺厘里,39,1019,433,129,562,50,612
公投第９案,宜蘭縣,宜蘭市,延平里,40,1084,438,123,561,51,612
公投第９案,宜蘭縣,宜蘭市,延平里,41,1095,449,111,560,33,593
公投第９案,宜蘭縣,宜蘭市,延平里,42,1083,483,116,599,23,622
公投第９案,宜蘭縣,宜蘭市,成功里,43,1108,450,104,554,37,591
公投第９案,宜蘭縣,宜蘭市,成功里,44,848,363,110,473,21,494
公投第９案,宜蘭縣,宜蘭市,成功里,45,1095,454,111,565,38,603
公投第９案,宜蘭縣,宜蘭市,東村里,46,1110,481,118,599,26,625
公投第９案,宜蘭縣,宜蘭市,東村里,47,1104,478,110,588,56,644
公投第９案,宜蘭縣,宜蘭市,新東里,48,1134,475,126,601,39,640
公投第９案,宜蘭縣,宜蘭市,新東里,49,1146,478,138,616,43,659
公投第９案,宜蘭縣,宜蘭市,新東里,50,876,378,99,477,51,528
公投第９案,宜蘭縣,宜蘭市,黎明里,51,905,378,74,452,54,506
公投第９案,宜蘭縣,宜蘭市,黎明里,52,910,381,104,485,49,534
公投第９案,宜蘭縣,宜蘭市,七張里,53,1434,489,151,640,32,672
公投第９案,宜蘭縣,宜蘭市,孝廉里,54,1152,419,151,570,67,637
公投第９案,宜蘭縣,宜蘭市,東門里,55,966,393,145,538,37,575
公投第９案,宜蘭縣,宜蘭市,小東里,56,711,279,94,373,41,414
公投第９案,宜蘭縣,宜蘭市,小東里,57,884,378,112,490,44,534
公投第９案,宜蘭縣,宜蘭市,菜園里,58,1326,538,172,710,56,766
公投第９案,宜蘭縣,宜蘭市,慈安里,59,909,326,111,437,27,464
公投第９案,宜蘭縣,宜蘭市,慈安里,60,894,350,101,451,39,490
公投第９案,宜蘭縣,宜蘭市,中興里,61,1259,487,113,600,35,635
公投第９案,宜蘭縣,宜蘭市,中興里,62,789,308,81,389,30,419
公投第９案,宜蘭縣,宜蘭市,中興里,63,867,355,88,443,31,474
公投第９案,宜蘭縣,宜蘭市,新生里,64,1454,548,172,720,87,807
公投第９案,宜蘭縣,宜蘭市,新生里,65,1130,575,71,646,47,693
公投第９案,宜蘭縣,宜蘭市,茭白里,66,1087,399,91,490,18,508
公投第９案,宜蘭縣,宜蘭市,茭白里,67,938,401,119,520,57,577
公投第９案,宜蘭縣,宜蘭市,北津里,68,1285,500,145,645,67,712
公投第９案,宜蘭縣,宜蘭市,北津里,69,952,335,118,453,27,480
公投第９案,宜蘭縣,宜蘭市,梅洲里,70,948,360,148,508,63,571
公投第９案,宜蘭縣,宜蘭市,梅洲里,71,1160,429,127,556,49,605
公投第９案,宜蘭縣,宜蘭市,梅洲里,72,1015,432,95,527,74,601
公投第９案,宜蘭縣,宜蘭市,南門里,73,424,190,54,244,17,261
公投第９案,宜蘭縣,宜蘭市,南門里,74,964,389,124,513,49,562
公投第９案,宜蘭縣,宜蘭市,中山里,75,959,333,124,457,58,515
公投第９案,宜蘭縣,宜蘭市,西門里,76,814,354,109,463,46,509
公投第９案,宜蘭縣,宜蘭市,西門里,77,885,351,127,478,50,528
公投第９案,宜蘭縣,宜蘭市,北門里,78,1162,443,174,617,58,675
公投第９案,宜蘭縣,羅東鎮,開明里,79,689,280,95,375,32,407
公投第９案,宜蘭縣,羅東鎮,開明里,80,718,281,88,369,29,398
公投第９案,宜蘭縣,羅東鎮,大新里,81,1475,543,214,757,66,823
公投第９案,宜蘭縣,羅東鎮,東安里,82,1466,552,178,730,65,795
公投第９案,宜蘭縣,羅東鎮,東安里,83,1075,436,131,567,36,603
公投第９案,宜蘭縣,羅東鎮,東安里,84,963,366,108,474,62,536
公投第９案,宜蘭縣,羅東鎮,新群里,85,1511,573,148,721,92,813
公投第９案,宜蘭縣,羅東鎮,新群里,86,1166,446,144,590,36,626
公投第９案,宜蘭縣,羅東鎮,羅莊里,87,1273,506,163,669,62,731
公投第９案,宜蘭縣,羅東鎮,羅莊里,88,1735,688,183,871,44,915
公投第９案,宜蘭縣,羅東鎮,南昌里,89,1487,608,175,783,57,840
公投第９案,宜蘭縣,羅東鎮,南昌里,90,837,372,103,475,27,502
公投第９案,宜蘭縣,羅東鎮,南豪里,91,1312,549,170,719,66,785
公投第９案,宜蘭縣,羅東鎮,成功里,92,1502,580,166,746,55,801
公投第９案,宜蘭縣,羅東鎮,仁德里,93,1138,431,128,559,23,582
公投第９案,宜蘭縣,羅東鎮,仁和里,94,1010,372,140,512,50,562
公投第９案,宜蘭縣,羅東鎮,中山里,95,1373,498,202,700,90,790
公投第９案,宜蘭縣,羅東鎮,漢民里,96,1089,441,135,576,36,612
公投第９案,宜蘭縣,羅東鎮,漢民里,97,1304,515,146,661,46,707
公投第９案,宜蘭縣,羅東鎮,漢民里,98,1288,462,160,622,67,689
公投第９案,宜蘭縣,羅東鎮,維揚里,99,1036,448,137,585,57,642
公投第９案,宜蘭縣,羅東鎮,維揚里,100,969,457,117,574,39,613
公投第９案,宜蘭縣,羅東鎮,維揚里,101,985,439,113,552,40,592
公投第９案,宜蘭縣,羅東鎮,西安里,102,1420,557,212,769,70,839
公投第９案,宜蘭縣,羅東鎮,西安里,103,1430,622,152,774,46,820
公投第９案,宜蘭縣,羅東鎮,北成里,104,1075,453,131,584,47,631
公投第９案,宜蘭縣,羅東鎮,北成里,105,879,374,111,485,36,521
公投第９案,宜蘭縣,羅東鎮,北成里,106,850,340,104,444,25,469
公投第９案,宜蘭縣,羅東鎮,國華里,107,1111,498,134,632,30,662
公投第９案,宜蘭縣,羅東鎮,國華里,108,1139,524,144,668,41,709
公投第９案,宜蘭縣,羅東鎮,國華里,109,1130,528,132,660,34,694
公投第９案,宜蘭縣,羅東鎮,國華里,110,980,396,139,535,44,579
公投第９案,宜蘭縣,羅東鎮,賢文里,111,1431,587,164,751,54,805
公投第９案,宜蘭縣,羅東鎮,賢文里,112,1109,464,128,592,40,632
公投第９案,宜蘭縣,羅東鎮,賢文里,113,1083,462,116,578,32,610
公投第９案,宜蘭縣,羅東鎮,公正里,114,1404,591,165,756,54,810
公投第９案,宜蘭縣,羅東鎮,公正里,115,1288,509,180,689,50,739
公投第９案,宜蘭縣,羅東鎮,集祥里,116,1183,357,143,500,46,546
公投第９案,宜蘭縣,羅東鎮,信義里,117,1105,481,140,621,40,661
公投第９案,宜蘭縣,羅東鎮,信義里,118,987,423,141,564,37,601
公投第９案,宜蘭縣,羅東鎮,信義里,119,773,344,88,432,41,473
公投第９案,宜蘭縣,羅東鎮,樹林里,120,1366,664,160,824,41,865
公投第９案,宜蘭縣,羅東鎮,樹林里,121,907,434,123,557,27,584
公投第９案,宜蘭縣,羅東鎮,樹林里,122,1158,546,128,674,43,717
公投第９案,宜蘭縣,羅東鎮,竹林里,123,977,382,128,510,52,562
公投第９案,宜蘭縣,羅東鎮,竹林里,124,972,354,124,478,52,530
公投第９案,宜蘭縣,羅東鎮,竹林里,125,977,405,136,541,35,576
公投第９案,宜蘭縣,羅東鎮,仁愛里,126,1398,576,191,767,55,822
公投第９案,宜蘭縣,羅東鎮,仁愛里,127,1022,410,137,547,28,575
公投第９案,宜蘭縣,羅東鎮,仁愛里,128,1131,509,135,644,47,691
公投第９案,宜蘭縣,蘇澳鎮,龍德里,129,1194,458,142,600,72,672
公投第９案,宜蘭縣,蘇澳鎮,龍德里,130,1128,402,141,543,44,587
公投第９案,宜蘭縣,蘇澳鎮,龍德里,131,1042,453,136,589,54,643
公投第９案,宜蘭縣,蘇澳鎮,頂寮里,132,997,429,115,544,39,583
公投第９案,宜蘭縣,蘇澳鎮,永榮里,133,1303,506,169,675,63,738
公投第９案,宜蘭縣,蘇澳鎮,永榮里,134,1260,508,164,672,74,746
公投第９案,宜蘭縣,蘇澳鎮,永榮里,135,1130,419,132,551,78,629
公投第９案,宜蘭縣,蘇澳鎮,存仁里,136,559,210,57,267,48,315
公投第９案,宜蘭縣,蘇澳鎮,存仁里,137,351,109,39,148,32,180
公投第９案,宜蘭縣,蘇澳鎮,港邊里,138,889,323,108,431,57,488
公投第９案,宜蘭縣,蘇澳鎮,港邊里,139,434,156,55,211,23,234
公投第９案,宜蘭縣,蘇澳鎮,隘丁里,140,835,357,114,471,31,502
公投第９案,宜蘭縣,蘇澳鎮,隘丁里,141,975,384,122,506,47,553
公投第９案,宜蘭縣,蘇澳鎮,隘丁里,142,1135,446,153,599,74,673
公投第９案,宜蘭縣,蘇澳鎮,新城里,143,788,357,119,476,35,511
公投第９案,宜蘭縣,蘇澳鎮,新城里,144,469,150,67,217,31,248
公投第９案,宜蘭縣,蘇澳鎮,聖愛里,145,811,304,94,398,33,431
公投第９案,宜蘭縣,蘇澳鎮,聖愛里,146,867,362,77,439,21,460
公投第９案,宜蘭縣,蘇澳鎮,聖愛里,147,1139,446,137,583,57,640
公投第９案,宜蘭縣,蘇澳鎮,聖湖里,148,1146,439,124,563,36,599
公投第９案,宜蘭縣,蘇澳鎮,聖湖里,149,1154,463,125,588,65,653
公投第９案,宜蘭縣,蘇澳鎮,蘇西里,150,908,307,105,412,30,442
公投第９案,宜蘭縣,蘇澳鎮,蘇西里,151,656,273,69,342,22,364
公投第９案,宜蘭縣,蘇澳鎮,蘇西里,152,834,365,95,460,58,518
公投第９案,宜蘭縣,蘇澳鎮,蘇北里,153,1025,417,142,559,46,605
公投第９案,宜蘭縣,蘇澳鎮,蘇南里,154,455,163,81,244,20,264
公投第９案,宜蘭縣,蘇澳鎮,蘇東里,155,535,223,65,288,25,313
公投第９案,宜蘭縣,蘇澳鎮,長安里,156,536,226,76,302,36,338
公投第９案,宜蘭縣,蘇澳鎮,永光里,157,451,181,70,251,23,274
公投第９案,宜蘭縣,蘇澳鎮,永春里,158,593,205,82,287,43,330
公投第９案,宜蘭縣,蘇澳鎮,永樂里,159,441,172,47,219,28,247
公投第９案,宜蘭縣,蘇澳鎮,南安里,160,954,384,109,493,55,548
公投第９案,宜蘭縣,蘇澳鎮,南正里,161,952,338,113,451,67,518
公投第９案,宜蘭縣,蘇澳鎮,南成里,162,1125,363,149,512,75,587
公投第９案,宜蘭縣,蘇澳鎮,南興里,163,763,283,73,356,72,428
公投第９案,宜蘭縣,蘇澳鎮,南興里,164,706,200,70,270,41,311
公投第９案,宜蘭縣,蘇澳鎮,南寧里,165,1068,327,114,441,74,515
公投第９案,宜蘭縣,蘇澳鎮,南建里,166,666,234,90,324,64,388
公投第９案,宜蘭縣,蘇澳鎮,南建里,167,574,178,69,247,78,325
公投第９案,宜蘭縣,蘇澳鎮,東澳里,168,351,97,28,125,9,134
公投第９案,宜蘭縣,蘇澳鎮,南強里,169,717,260,86,346,59,405
公投第９案,宜蘭縣,蘇澳鎮,朝陽里,170,373,117,19,136,18,154
公投第９案,宜蘭縣,蘇澳鎮,朝陽里,171,223,53,23,76,14,90
公投第９案,宜蘭縣,頭城鎮,石城里,172,292,62,31,93,11,104
公投第９案,宜蘭縣,頭城鎮,大里里,173,688,239,84,323,45,368
公投第９案,宜蘭縣,頭城鎮,龜山里,174,688,280,78,358,38,396
公投第９案,宜蘭縣,頭城鎮,大溪里,175,879,279,109,388,56,444
公投第９案,宜蘭縣,頭城鎮,合興里,176,335,126,51,177,27,204
公投第９案,宜蘭縣,頭城鎮,更新里,177,624,235,117,352,41,393
公投第９案,宜蘭縣,頭城鎮,更新里,178,732,212,84,296,47,343
公投第９案,宜蘭縣,頭城鎮,外澳里,179,892,280,92,372,47,419
公投第９案,宜蘭縣,頭城鎮,港口里,180,690,211,74,285,28,313
公投第９案,宜蘭縣,頭城鎮,武營里,181,842,311,98,409,43,452
公投第９案,宜蘭縣,頭城鎮,武營里,182,736,272,99,371,39,410
公投第９案,宜蘭縣,頭城鎮,大坑里,183,788,281,81,362,32,394
公投第９案,宜蘭縣,頭城鎮,大坑里,184,560,177,79,256,30,286
公投第９案,宜蘭縣,頭城鎮,城東里,185,712,302,90,392,31,423
公投第９案,宜蘭縣,頭城鎮,城北里,186,502,229,58,287,34,321
公投第９案,宜蘭縣,頭城鎮,城西里,187,569,253,71,324,35,359
公投第９案,宜蘭縣,頭城鎮,城南里,188,633,258,70,328,33,361
公投第９案,宜蘭縣,頭城鎮,竹安里,189,1132,328,127,455,73,528
公投第９案,宜蘭縣,頭城鎮,竹安里,190,1035,345,108,453,42,495
公投第９案,宜蘭縣,頭城鎮,新建里,191,847,342,124,466,37,503
公投第９案,宜蘭縣,頭城鎮,新建里,192,1172,462,144,606,52,658
公投第９案,宜蘭縣,頭城鎮,拔雅里,193,896,348,95,443,22,465
公投第９案,宜蘭縣,頭城鎮,拔雅里,194,1075,481,116,597,28,625
公投第９案,宜蘭縣,頭城鎮,福成里,195,931,356,126,482,66,548
公投第９案,宜蘭縣,頭城鎮,金面里,196,1021,403,106,509,53,562
公投第９案,宜蘭縣,頭城鎮,金面里,197,709,222,74,296,51,347
公投第９案,宜蘭縣,頭城鎮,金盈里,198,689,310,92,402,40,442
公投第９案,宜蘭縣,頭城鎮,頂埔里,199,615,265,73,338,46,384
公投第９案,宜蘭縣,頭城鎮,頂埔里,200,759,284,81,365,50,415
公投第９案,宜蘭縣,頭城鎮,下埔里,201,917,376,113,489,73,562
公投第９案,宜蘭縣,頭城鎮,中崙里,202,1045,409,128,537,63,600
公投第９案,宜蘭縣,頭城鎮,二城里,203,1130,441,127,568,68,636
公投第９案,宜蘭縣,礁溪鄉,白雲村,204,1122,397,95,492,38,530
公投第９案,宜蘭縣,礁溪鄉,白雲村,205,505,178,60,238,28,266
公投第９案,宜蘭縣,礁溪鄉,玉石村,206,988,356,111,467,42,509
公投第９案,宜蘭縣,礁溪鄉,玉石村,207,971,346,127,473,40,513
公投第９案,宜蘭縣,礁溪鄉,德陽村,208,1246,434,126,560,56,616
公投第９案,宜蘭縣,礁溪鄉,德陽村,209,1655,560,179,739,45,784
公投第９案,宜蘭縣,礁溪鄉,德陽村,210,1132,349,128,477,35,512
公投第９案,宜蘭縣,礁溪鄉,大忠村,211,783,317,88,405,30,435
公投第９案,宜蘭縣,礁溪鄉,大忠村,212,928,348,112,460,38,498
公投第９案,宜蘭縣,礁溪鄉,大忠村,213,848,331,80,411,42,453
公投第９案,宜蘭縣,礁溪鄉,大義村,214,663,291,91,382,35,417
公投第９案,宜蘭縣,礁溪鄉,六結村,215,608,236,74,310,27,337
公投第９案,宜蘭縣,礁溪鄉,六結村,216,833,327,98,425,39,464
公投第９案,宜蘭縣,礁溪鄉,二龍村,217,1233,421,113,534,23,557
公投第９案,宜蘭縣,礁溪鄉,時潮村,218,854,310,112,422,57,479
公投第９案,宜蘭縣,礁溪鄉,時潮村,219,575,185,75,260,28,288
公投第９案,宜蘭縣,礁溪鄉,玉田村,220,835,311,112,423,43,466
公投第９案,宜蘭縣,礁溪鄉,玉田村,221,1305,523,164,687,57,744
公投第９案,宜蘭縣,礁溪鄉,三民村,222,830,321,104,425,35,460
公投第９案,宜蘭縣,礁溪鄉,三民村,223,649,254,129,383,45,428
公投第９案,宜蘭縣,礁溪鄉,三民村,224,923,336,107,443,49,492
公投第９案,宜蘭縣,礁溪鄉,林美村,225,1177,381,102,483,49,532
公投第９案,宜蘭縣,礁溪鄉,白鵝村,226,840,310,106,416,44,460
公投第９案,宜蘭縣,礁溪鄉,玉光村,227,1051,414,122,536,35,571
公投第９案,宜蘭縣,礁溪鄉,光武村,228,1339,457,148,605,54,659
公投第９案,宜蘭縣,礁溪鄉,吳沙村,229,1194,522,127,649,53,702
公投第９案,宜蘭縣,礁溪鄉,吳沙村,230,1314,517,164,681,91,772
公投第９案,宜蘭縣,礁溪鄉,龍潭村,231,1125,435,137,572,23,595
公投第９案,宜蘭縣,礁溪鄉,龍潭村,232,1207,502,147,649,71,720
公投第９案,宜蘭縣,礁溪鄉,龍潭村,233,979,377,117,494,55,549
公投第９案,宜蘭縣,礁溪鄉,匏崙村,234,954,432,143,575,10,585
公投第９案,宜蘭縣,礁溪鄉,二結村,235,418,159,54,213,7,220
公投第９案,宜蘭縣,壯圍鄉,吉祥村,236,1435,563,206,769,92,861
公投第９案,宜蘭縣,壯圍鄉,吉祥村,237,1049,419,155,574,51,625
公投第９案,宜蘭縣,壯圍鄉,古結村,238,1068,430,156,586,70,656
公投第９案,宜蘭縣,壯圍鄉,美福村,239,868,299,118,417,80,497
公投第９案,宜蘭縣,壯圍鄉,美福村,240,967,382,92,474,34,508
公投第９案,宜蘭縣,壯圍鄉,新南村,241,940,395,111,506,71,577
公投第９案,宜蘭縣,壯圍鄉,東港村,242,975,322,92,414,38,452
公投第９案,宜蘭縣,壯圍鄉,復興村,243,797,306,108,414,76,490
公投第９案,宜蘭縣,壯圍鄉,復興村,244,808,305,96,401,64,465
公投第９案,宜蘭縣,壯圍鄉,過嶺村,245,911,307,149,456,82,538
公投第９案,宜蘭縣,壯圍鄉,過嶺村,246,612,222,65,287,29,316
公投第９案,宜蘭縣,壯圍鄉,永鎮村,247,790,329,123,452,51,503
公投第９案,宜蘭縣,壯圍鄉,忠孝村,248,878,356,111,467,56,523
公投第９案,宜蘭縣,壯圍鄉,忠孝村,249,723,329,83,412,51,463
公投第９案,宜蘭縣,壯圍鄉,忠孝村,250,737,134,187,321,36,357
公投第９案,宜蘭縣,壯圍鄉,古亭村,251,686,264,97,361,52,413
公投第９案,宜蘭縣,壯圍鄉,古亭村,252,895,340,104,444,1,445
公投第９案,宜蘭縣,壯圍鄉,功勞村,253,1237,543,143,686,67,753
公投第９案,宜蘭縣,壯圍鄉,美城村,254,1134,455,133,588,62,650
公投第９案,宜蘭縣,壯圍鄉,美城村,255,1107,423,128,551,61,612
公投第９案,宜蘭縣,壯圍鄉,新社村,256,1057,413,136,549,47,596
公投第９案,宜蘭縣,壯圍鄉,大福村,257,1051,476,21,497,38,535
公投第９案,宜蘭縣,壯圍鄉,大福村,258,722,255,92,347,50,397
公投第９案,宜蘭縣,員山鄉,員山村,259,1393,519,151,670,29,699
公投第９案,宜蘭縣,員山鄉,員山村,260,895,331,99,430,29,459
公投第９案,宜蘭縣,員山鄉,員山村,261,1231,484,109,593,76,669
公投第９案,宜蘭縣,員山鄉,員山村,262,1098,440,93,533,27,560
公投第９案,宜蘭縣,員山鄉,員山村,263,1031,396,93,489,39,528
公投第９案,宜蘭縣,員山鄉,尚德村,264,1030,377,105,482,73,555
公投第９案,宜蘭縣,員山鄉,尚德村,265,1168,379,114,493,52,545
公投第９案,宜蘭縣,員山鄉,惠好村,266,809,288,114,402,56,458
公投第９案,宜蘭縣,員山鄉,惠好村,267,778,300,93,393,54,447
公投第９案,宜蘭縣,員山鄉,七賢村,268,1465,616,158,774,68,842
公投第９案,宜蘭縣,員山鄉,深溝村,269,979,398,125,523,55,578
公投第９案,宜蘭縣,員山鄉,深溝村,270,860,329,101,430,47,477
公投第９案,宜蘭縣,員山鄉,蓁巷村,271,1205,384,139,523,74,597
公投第９案,宜蘭縣,員山鄉,內城村,272,1082,397,125,522,86,608
公投第９案,宜蘭縣,員山鄉,內城村,273,412,141,62,203,40,243
公投第９案,宜蘭縣,員山鄉,中華村,274,403,113,55,168,18,186
公投第９案,宜蘭縣,員山鄉,中華村,275,232,66,27,93,11,104
公投第９案,宜蘭縣,員山鄉,永和村,276,944,316,134,450,55,505
公投第９案,宜蘭縣,員山鄉,永和村,277,894,336,100,436,56,492
公投第９案,宜蘭縣,員山鄉,頭分村,278,1356,530,134,664,88,752
公投第９案,宜蘭縣,員山鄉,枕山村,279,780,299,101,400,53,453
公投第９案,宜蘭縣,員山鄉,枕山村,280,932,318,181,499,85,584
公投第９案,宜蘭縣,員山鄉,枕山村,281,583,175,85,260,34,294
公投第９案,宜蘭縣,員山鄉,同樂村,282,900,346,88,434,70,504
公投第９案,宜蘭縣,員山鄉,同樂村,283,747,264,100,364,40,404
公投第９案,宜蘭縣,員山鄉,同樂村,284,788,289,94,383,43,426
公投第９案,宜蘭縣,員山鄉,湖東村,285,884,313,102,415,50,465
公投第９案,宜蘭縣,員山鄉,逸仙村,286,857,307,80,387,23,410
公投第９案,宜蘭縣,員山鄉,湖北村,287,1016,344,112,456,29,485
公投第９案,宜蘭縣,員山鄉,湖西村,288,690,204,68,272,33,305
公投第９案,宜蘭縣,員山鄉,湖西村,289,689,228,76,304,58,362
公投第９案,宜蘭縣,冬山鄉,珍珠村,290,807,340,104,444,43,487
公投第９案,宜蘭縣,冬山鄉,珍珠村,291,817,343,98,441,15,456
公投第９案,宜蘭縣,冬山鄉,補城村,292,1156,472,129,601,57,658
公投第９案,宜蘭縣,冬山鄉,三奇村,293,892,331,106,437,37,474
公投第９案,宜蘭縣,冬山鄉,大興村,294,897,362,120,482,43,525
公投第９案,宜蘭縣,冬山鄉,東城村,295,1392,585,181,766,66,832
公投第９案,宜蘭縣,冬山鄉,香和村,296,1471,603,190,793,44,837
公投第９案,宜蘭縣,冬山鄉,香和村,297,1435,453,149,602,32,634
公投第９案,宜蘭縣,冬山鄉,南興村,298,1519,566,166,732,37,769
公投第９案,宜蘭縣,冬山鄉,南興村,299,1456,628,168,796,21,817
公投第９案,宜蘭縣,冬山鄉,安平村,300,711,272,106,378,51,429
公投第９案,宜蘭縣,冬山鄉,冬山村,301,694,300,67,367,38,405
公投第９案,宜蘭縣,冬山鄉,太和村,302,1526,655,237,892,61,953
公投第９案,宜蘭縣,冬山鄉,八寶村,303,884,332,110,442,31,473
公投第９案,宜蘭縣,冬山鄉,丸山村,304,1465,505,139,644,73,717
公投第９案,宜蘭縣,冬山鄉,中山村,305,488,173,66,239,37,276
公投第９案,宜蘭縣,冬山鄉,順安村,306,1218,466,122,588,59,647
公投第９案,宜蘭縣,冬山鄉,順安村,307,1291,498,114,612,43,655
公投第９案,宜蘭縣,冬山鄉,順安村,308,1324,484,144,628,35,663
公投第９案,宜蘭縣,冬山鄉,順安村,309,1160,416,116,532,40,572
公投第９案,宜蘭縣,冬山鄉,永美村,310,1246,476,137,613,58,671
公投第９案,宜蘭縣,冬山鄉,永美村,311,1754,682,159,841,37,878
公投第９案,宜蘭縣,冬山鄉,武淵村,312,1217,444,112,556,86,642
公投第９案,宜蘭縣,冬山鄉,群英村,313,1495,526,131,657,61,718
公投第９案,宜蘭縣,冬山鄉,群英村,314,937,359,113,472,38,510
公投第９案,宜蘭縣,冬山鄉,群英村,315,1101,402,127,529,29,558
公投第９案,宜蘭縣,冬山鄉,群英村,316,1118,394,126,520,60,580
公投第９案,宜蘭縣,冬山鄉,清溝村,317,1301,554,149,703,49,752
公投第９案,宜蘭縣,冬山鄉,清溝村,318,1225,469,124,593,35,628
公投第９案,宜蘭縣,冬山鄉,清溝村,319,1206,497,161,658,46,704
公投第９案,宜蘭縣,冬山鄉,鹿埔村,320,1278,443,152,595,33,628
公投第９案,宜蘭縣,冬山鄉,鹿埔村,321,1151,431,133,564,30,594
公投第９案,宜蘭縣,冬山鄉,得安村,322,1094,382,111,493,48,541
公投第９案,宜蘭縣,冬山鄉,廣興村,323,1247,507,139,646,61,707
公投第９案,宜蘭縣,冬山鄉,廣興村,324,1247,443,125,568,59,627
公投第９案,宜蘭縣,冬山鄉,廣安村,325,979,403,100,503,27,530
公投第９案,宜蘭縣,冬山鄉,廣安村,326,698,310,89,399,24,423
公投第９案,宜蘭縣,冬山鄉,柯林村,327,1726,601,195,796,67,863
公投第９案,宜蘭縣,冬山鄉,大進村,328,782,230,80,310,19,329
公投第９案,宜蘭縣,五結鄉,三興村,329,1076,387,109,496,54,550
公投第９案,宜蘭縣,五結鄉,三興村,330,944,345,112,457,26,483
公投第９案,宜蘭縣,五結鄉,二結村,331,836,347,78,425,27,452
公投第９案,宜蘭縣,五結鄉,二結村,332,937,371,108,479,48,527
公投第９案,宜蘭縣,五結鄉,鎮安村,333,1255,468,149,617,40,657
公投第９案,宜蘭縣,五結鄉,鎮安村,334,1270,446,170,616,67,683
公投第９案,宜蘭縣,五結鄉,上四村,335,801,295,76,371,25,396
公投第９案,宜蘭縣,五結鄉,上四村,336,802,294,86,380,37,417
公投第９案,宜蘭縣,五結鄉,中興村,337,1306,476,135,611,39,650
公投第９案,宜蘭縣,五結鄉,四結村,338,1190,455,118,573,53,626
公投第９案,宜蘭縣,五結鄉,四結村,339,1316,504,141,645,29,674
公投第９案,宜蘭縣,五結鄉,福興村,340,965,399,92,491,27,518
公投第９案,宜蘭縣,五結鄉,福興村,341,814,315,83,398,37,435
公投第９案,宜蘭縣,五結鄉,五結村,342,1254,469,132,601,42,643
公投第９案,宜蘭縣,五結鄉,五結村,343,1060,439,107,546,59,605
公投第９案,宜蘭縣,五結鄉,五結村,344,1323,527,164,691,36,727
公投第９案,宜蘭縣,五結鄉,協和村,345,1120,464,135,599,42,641
公投第９案,宜蘭縣,五結鄉,協和村,346,893,357,91,448,25,473
公投第９案,宜蘭縣,五結鄉,協和村,347,1220,448,154,602,45,647
公投第９案,宜蘭縣,五結鄉,大吉村,348,924,408,107,515,21,536
公投第９案,宜蘭縣,五結鄉,大吉村,349,933,409,106,515,46,561
公投第９案,宜蘭縣,五結鄉,大吉村,350,986,399,98,497,31,528
公投第９案,宜蘭縣,五結鄉,大吉村,351,748,285,82,367,41,408
公投第９案,宜蘭縣,五結鄉,孝威村,352,1550,573,160,733,100,833
公投第９案,宜蘭縣,五結鄉,錦眾村,353,629,247,82,329,26,355
公投第９案,宜蘭縣,五結鄉,錦眾村,354,806,298,106,404,36,440
公投第９案,宜蘭縣,五結鄉,利澤村,355,956,313,135,448,45,493
公投第９案,宜蘭縣,五結鄉,利澤村,356,1066,387,134,521,45,566
公投第９案,宜蘭縣,五結鄉,成興村,357,1513,531,148,679,70,749
公投第９案,宜蘭縣,五結鄉,成興村,358,1566,584,189,773,51,824
公投第９案,宜蘭縣,五結鄉,季新村,359,894,319,109,428,65,493
公投第９案,宜蘭縣,五結鄉,季新村,360,1235,361,153,514,67,581
公投第９案,宜蘭縣,五結鄉,季新村,361,704,267,86,353,43,396
公投第９案,宜蘭縣,三星鄉,員山村,362,215,78,22,100,14,114
公投第９案,宜蘭縣,三星鄉,天山村,363,523,150,54,204,37,241
公投第９案,宜蘭縣,三星鄉,天福村,364,745,224,114,338,52,390
公投第９案,宜蘭縣,三星鄉,萬德村,365,617,201,69,270,33,303
公投第９案,宜蘭縣,三星鄉,貴林村,366,497,157,68,225,39,264
公投第９案,宜蘭縣,三星鄉,萬富村,367,735,261,89,350,61,411
公投第９案,宜蘭縣,三星鄉,雙賢村,368,583,205,70,275,49,324
公投第９案,宜蘭縣,三星鄉,人和村,369,436,160,42,202,31,233
公投第９案,宜蘭縣,三星鄉,義德村,370,1224,425,143,568,68,636
公投第９案,宜蘭縣,三星鄉,集慶村,371,1151,369,121,490,53,543
公投第９案,宜蘭縣,三星鄉,月眉村,372,870,318,123,441,36,477
公投第９案,宜蘭縣,三星鄉,拱照村,373,1284,378,107,485,47,532
公投第９案,宜蘭縣,三星鄉,行健村,374,897,361,123,484,46,530
公投第９案,宜蘭縣,三星鄉,大隱村,375,1439,558,156,714,60,774
公投第９案,宜蘭縣,三星鄉,大隱村,376,1445,504,172,676,55,731
公投第９案,宜蘭縣,三星鄉,大隱村,377,1402,543,140,683,43,726
公投第９案,宜蘭縣,三星鄉,大義村,378,1230,416,169,585,55,640
公投第９案,宜蘭縣,三星鄉,尚武村,379,774,288,83,371,61,432
公投第９案,宜蘭縣,三星鄉,大洲村,380,827,330,104,434,43,477
公投第９案,宜蘭縣,三星鄉,大洲村,381,736,260,96,356,34,390
公投第９案,宜蘭縣,三星鄉,尾塹村,382,1421,534,137,671,74,745
公投第９案,宜蘭縣,大同鄉,寒溪村,383,893,222,81,303,56,359
公投第９案,宜蘭縣,大同鄉,崙埤村,384,632,322,86,408,53,461
公投第９案,宜蘭縣,大同鄉,松羅村,385,684,220,49,269,23,292
公投第９案,宜蘭縣,大同鄉,復興村,386,264,106,37,143,32,175
公投第９案,宜蘭縣,大同鄉,英士村,387,337,93,14,107,6,113
公投第９案,宜蘭縣,大同鄉,樂水村,388,404,102,29,131,9,140
公投第９案,宜蘭縣,大同鄉,太平村,389,55,16,6,22,4,26
公投第９案,宜蘭縣,大同鄉,茂安村,390,199,83,46,129,24,153
公投第９案,宜蘭縣,大同鄉,四季村,391,787,165,62,227,21,248
公投第９案,宜蘭縣,大同鄉,南山村,392,680,223,76,299,57,356
公投第９案,宜蘭縣,南澳鄉,東岳村,393,444,173,40,213,12,225
公投第９案,宜蘭縣,南澳鄉,南澳村,394,1210,463,100,563,28,591
公投第９案,宜蘭縣,南澳鄉,碧候村,395,962,402,101,503,77,580
公投第９案,宜蘭縣,南澳鄉,金岳村,396,411,112,34,146,4,150
公投第９案,宜蘭縣,南澳鄉,武塔村,397,447,238,51,289,18,307
公投第９案,宜蘭縣,南澳鄉,金洋村,398,475,251,79,330,38,368
公投第９案,宜蘭縣,南澳鄉,澳花村,399,695,299,71,370,41,411
公投第９案,新竹縣,竹北市,鹿場里,1,1319,671,150,821,30,851
公投第９案,新竹縣,竹北市,鹿場里,2,1321,634,143,777,25,802
公投第９案,新竹縣,竹北市,鹿場里,3,1272,607,151,758,40,798
公投第９案,新竹縣,竹北市,鹿場里,4,1467,660,150,810,30,840
公投第９案,新竹縣,竹北市,鹿場里,5,1226,528,151,679,14,693
公投第９案,新竹縣,竹北市,鹿場里,6,1412,654,133,787,13,800
公投第９案,新竹縣,竹北市,鹿場里,7,1400,719,150,869,6,875
公投第９案,新竹縣,竹北市,東平里,8,1415,697,159,856,22,878
公投第９案,新竹縣,竹北市,東平里,9,1361,618,154,772,20,792
公投第９案,新竹縣,竹北市,東平里,10,1515,643,171,814,21,835
公投第９案,新竹縣,竹北市,東平里,11,1495,676,188,864,23,887
公投第９案,新竹縣,竹北市,東平里,12,1417,639,170,809,28,837
公投第９案,新竹縣,竹北市,東平里,13,1548,654,201,855,28,883
公投第９案,新竹縣,竹北市,東平里,14,1434,584,175,759,23,782
公投第９案,新竹縣,竹北市,中興里,15,1385,651,129,780,34,814
公投第９案,新竹縣,竹北市,中興里,16,1247,636,122,758,34,792
公投第９案,新竹縣,竹北市,中興里,17,1373,608,160,768,27,795
公投第９案,新竹縣,竹北市,中興里,18,1345,667,165,832,27,859
公投第９案,新竹縣,竹北市,中興里,19,1165,527,106,633,36,669
公投第９案,新竹縣,竹北市,隘口里,20,1164,552,162,714,35,749
公投第９案,新竹縣,竹北市,隘口里,21,1212,560,163,723,31,754
公投第９案,新竹縣,竹北市,東海里,22,1507,600,136,736,23,759
公投第９案,新竹縣,竹北市,東海里,23,1576,639,128,767,43,810
公投第９案,新竹縣,竹北市,東興里,24,1464,661,136,797,31,828
公投第９案,新竹縣,竹北市,東興里,25,1428,640,153,793,23,816
公投第９案,新竹縣,竹北市,東興里,26,1442,557,153,710,17,727
公投第９案,新竹縣,竹北市,東興里,27,1415,640,147,787,54,841
公投第９案,新竹縣,竹北市,北興里,28,1666,655,162,817,29,846
公投第９案,新竹縣,竹北市,北興里,29,1751,700,207,907,32,939
公投第９案,新竹縣,竹北市,十興里,30,1196,549,155,704,29,733
公投第９案,新竹縣,竹北市,十興里,31,1235,588,134,722,19,741
公投第９案,新竹縣,竹北市,十興里,32,1204,552,115,667,17,684
公投第９案,新竹縣,竹北市,十興里,33,1308,628,148,776,18,794
公投第９案,新竹縣,竹北市,十興里,34,1233,536,148,684,16,700
公投第９案,新竹縣,竹北市,興安里,35,1129,515,133,648,25,673
公投第９案,新竹縣,竹北市,興安里,36,1069,527,110,637,22,659
公投第９案,新竹縣,竹北市,興安里,37,1114,554,117,671,41,712
公投第９案,新竹縣,竹北市,文化里,38,1103,530,119,649,20,669
公投第９案,新竹縣,竹北市,文化里,39,1029,512,128,640,30,670
公投第９案,新竹縣,竹北市,文化里,40,1133,575,132,707,24,731
公投第９案,新竹縣,竹北市,斗崙里,41,1301,591,142,733,23,756
公投第９案,新竹縣,竹北市,斗崙里,42,1798,813,189,1002,47,1049
公投第９案,新竹縣,竹北市,斗崙里,43,1427,660,163,823,26,849
公投第９案,新竹縣,竹北市,斗崙里,44,1462,733,135,868,34,902
公投第９案,新竹縣,竹北市,中崙里,45,1342,678,137,815,35,850
公投第９案,新竹縣,竹北市,中崙里,46,1480,715,146,861,28,889
公投第９案,新竹縣,竹北市,中崙里,47,1645,734,162,896,31,927
公投第９案,新竹縣,竹北市,中崙里,48,1256,652,131,783,20,803
公投第９案,新竹縣,竹北市,北崙里,49,1181,554,137,691,34,725
公投第９案,新竹縣,竹北市,北崙里,50,1329,675,150,825,33,858
公投第９案,新竹縣,竹北市,北崙里,51,1228,617,136,753,25,778
公投第９案,新竹縣,竹北市,新崙里,52,1552,659,177,836,40,876
公投第９案,新竹縣,竹北市,新崙里,53,1480,685,176,861,30,891
公投第９案,新竹縣,竹北市,新崙里,54,1487,606,165,771,31,802
公投第９案,新竹縣,竹北市,新崙里,55,1470,595,169,764,40,804
公投第９案,新竹縣,竹北市,竹北里,56,1477,623,130,753,32,785
公投第９案,新竹縣,竹北市,竹北里,57,1611,716,215,931,52,983
公投第９案,新竹縣,竹北市,竹北里,58,1555,691,145,836,68,904
公投第９案,新竹縣,竹北市,竹北里,59,1468,619,138,757,42,799
公投第９案,新竹縣,竹北市,竹仁里,60,1509,667,177,844,50,894
公投第９案,新竹縣,竹北市,竹仁里,61,1602,688,156,844,45,889
公投第９案,新竹縣,竹北市,竹仁里,62,1448,642,169,811,53,864
公投第９案,新竹縣,竹北市,竹仁里,63,1318,599,137,736,59,795
公投第９案,新竹縣,竹北市,竹仁里,64,1634,764,181,945,49,994
公投第９案,新竹縣,竹北市,竹仁里,65,1345,566,145,711,58,769
公投第９案,新竹縣,竹北市,福德里,66,958,485,116,601,27,628
公投第９案,新竹縣,竹北市,福德里,67,1112,555,106,661,40,701
公投第９案,新竹縣,竹北市,福德里,68,1134,475,128,603,66,669
公投第９案,新竹縣,竹北市,竹義里,69,1483,674,154,828,26,854
公投第９案,新竹縣,竹北市,竹義里,70,1332,568,145,713,35,748
公投第９案,新竹縣,竹北市,竹義里,71,1482,621,115,736,26,762
公投第９案,新竹縣,竹北市,竹義里,72,1449,469,126,595,24,619
公投第９案,新竹縣,竹北市,泰和里,73,1319,582,112,694,24,718
公投第９案,新竹縣,竹北市,泰和里,74,1332,550,137,687,40,727
公投第９案,新竹縣,竹北市,泰和里,75,1412,547,169,716,34,750
公投第９案,新竹縣,竹北市,泰和里,76,1640,689,154,843,45,888
公投第９案,新竹縣,竹北市,新社里,77,1323,556,165,721,41,762
公投第９案,新竹縣,竹北市,新社里,78,1428,627,169,796,54,850
公投第９案,新竹縣,竹北市,新社里,79,1533,694,143,837,58,895
公投第９案,新竹縣,竹北市,新社里,80,1346,544,129,673,27,700
公投第９案,新竹縣,竹北市,新社里,81,1219,509,113,622,47,669
公投第９案,新竹縣,竹北市,新國里,82,1466,674,163,837,56,893
公投第９案,新竹縣,竹北市,新國里,83,1147,468,128,596,36,632
公投第９案,新竹縣,竹北市,新國里,84,1529,597,111,708,43,751
公投第９案,新竹縣,竹北市,新國里,85,1522,679,147,826,51,877
公投第９案,新竹縣,竹北市,聯興里,86,1383,635,142,777,52,829
公投第９案,新竹縣,竹北市,聯興里,87,1569,548,305,853,42,895
公投第９案,新竹縣,竹北市,聯興里,88,1506,632,131,763,21,784
公投第９案,新竹縣,竹北市,麻園里,89,877,386,79,465,41,506
公投第９案,新竹縣,竹北市,麻園里,90,1074,446,133,579,47,626
公投第９案,新竹縣,竹北市,溪州里,91,1089,531,134,665,37,702
公投第９案,新竹縣,竹北市,溪州里,92,1336,588,152,740,53,793
公投第９案,新竹縣,竹北市,新庄里,93,1058,431,115,546,57,603
公投第９案,新竹縣,竹北市,白地里,94,937,441,125,566,59,625
公投第９案,新竹縣,竹北市,白地里,95,1206,505,146,651,41,692
公投第９案,新竹縣,竹北市,新港里,96,1205,481,148,629,52,681
公投第９案,新竹縣,竹北市,大眉里,97,1718,749,205,954,74,1028
公投第９案,新竹縣,竹北市,大義里,98,917,358,115,473,51,524
公投第９案,新竹縣,竹北市,大義里,99,668,293,81,374,30,404
公投第９案,新竹縣,竹北市,尚義里,100,824,334,87,421,34,455
公投第９案,新竹縣,竹北市,尚義里,101,782,312,83,395,69,464
公投第９案,新竹縣,竹北市,崇義里,102,977,401,121,522,76,598
公投第９案,新竹縣,竹北市,崇義里,103,937,328,95,423,22,445
公投第９案,新竹縣,竹東鎮,上坪里,104,309,117,25,142,10,152
公投第９案,新竹縣,竹東鎮,瑞峰里,105,416,140,46,186,29,215
公投第９案,新竹縣,竹東鎮,軟橋里,106,386,142,40,182,10,192
公投第９案,新竹縣,竹東鎮,員崠里,107,950,371,80,451,22,473
公投第９案,新竹縣,竹東鎮,員崠里,108,1275,536,106,642,16,658
公投第９案,新竹縣,竹東鎮,上舘里,109,1213,480,133,613,44,657
公投第９案,新竹縣,竹東鎮,上舘里,110,1548,672,153,825,38,863
公投第９案,新竹縣,竹東鎮,上舘里,111,1246,478,113,591,33,624
公投第９案,新竹縣,竹東鎮,上舘里,112,1252,429,104,533,42,575
公投第９案,新竹縣,竹東鎮,上舘里,113,1359,555,116,671,47,718
公投第９案,新竹縣,竹東鎮,上舘里,114,1255,490,136,626,43,669
公投第９案,新竹縣,竹東鎮,上舘里,115,1304,566,146,712,38,750
公投第９案,新竹縣,竹東鎮,東寧里,116,1292,559,121,680,44,724
公投第９案,新竹縣,竹東鎮,東寧里,117,1111,455,85,540,14,554
公投第９案,新竹縣,竹東鎮,東寧里,118,880,385,95,480,43,523
公投第９案,新竹縣,竹東鎮,中正里,119,670,293,76,369,24,393
公投第９案,新竹縣,竹東鎮,中正里,120,1244,557,123,680,45,725
公投第９案,新竹縣,竹東鎮,大鄉里,121,1126,436,118,554,54,608
公投第９案,新竹縣,竹東鎮,大鄉里,122,1073,442,103,545,40,585
公投第９案,新竹縣,竹東鎮,大鄉里,123,1215,520,131,651,45,696
公投第９案,新竹縣,竹東鎮,大鄉里,124,1155,526,111,637,22,659
公投第９案,新竹縣,竹東鎮,中山里,125,852,338,103,441,43,484
公投第９案,新竹縣,竹東鎮,中山里,126,875,365,132,497,29,526
公投第９案,新竹縣,竹東鎮,南華里,127,1070,504,118,622,32,654
公投第９案,新竹縣,竹東鎮,東華里,128,704,287,67,354,26,380
公投第９案,新竹縣,竹東鎮,商華里,129,951,273,75,348,34,382
公投第９案,新竹縣,竹東鎮,商華里,130,984,436,102,538,19,557
公投第９案,新竹縣,竹東鎮,商華里,131,1113,374,88,462,13,475
公投第９案,新竹縣,竹東鎮,竹東里,132,595,255,81,336,20,356
公投第９案,新竹縣,竹東鎮,竹東里,133,762,320,94,414,52,466
公投第９案,新竹縣,竹東鎮,忠孝里,134,763,311,89,400,21,421
公投第９案,新竹縣,竹東鎮,忠孝里,135,813,320,83,403,16,419
公投第９案,新竹縣,竹東鎮,鷄林里,136,1310,465,125,590,29,619
公投第９案,新竹縣,竹東鎮,鷄林里,137,1434,547,119,666,38,704
公投第９案,新竹縣,竹東鎮,鷄林里,138,1131,486,119,605,29,634
公投第９案,新竹縣,竹東鎮,仁愛里,139,967,408,102,510,19,529
公投第９案,新竹縣,竹東鎮,仁愛里,140,1196,441,133,574,38,612
公投第９案,新竹縣,竹東鎮,仁愛里,141,1154,495,124,619,36,655
公投第９案,新竹縣,竹東鎮,榮樂里,142,715,309,95,404,35,439
公投第９案,新竹縣,竹東鎮,榮樂里,143,685,296,75,371,14,385
公投第９案,新竹縣,竹東鎮,榮華里,144,1352,532,136,668,50,718
公投第９案,新竹縣,竹東鎮,榮華里,145,1407,611,139,750,56,806
公投第９案,新竹縣,竹東鎮,榮華里,146,1362,595,105,700,29,729
公投第９案,新竹縣,竹東鎮,榮華里,147,1330,593,126,719,32,751
公投第９案,新竹縣,竹東鎮,榮華里,148,1441,585,143,728,60,788
公投第９案,新竹縣,竹東鎮,五豐里,149,1248,503,103,606,22,628
公投第９案,新竹縣,竹東鎮,五豐里,150,1263,434,105,539,27,566
公投第９案,新竹縣,竹東鎮,五豐里,151,1232,450,113,563,27,590
公投第９案,新竹縣,竹東鎮,五豐里,152,1143,407,103,510,31,541
公投第９案,新竹縣,竹東鎮,五豐里,153,1529,652,148,800,29,829
公投第９案,新竹縣,竹東鎮,五豐里,154,1140,475,105,580,45,625
公投第９案,新竹縣,竹東鎮,陸豐里,155,570,255,91,346,18,364
公投第９案,新竹縣,竹東鎮,三重里,156,1345,515,114,629,25,654
公投第９案,新竹縣,竹東鎮,三重里,157,1381,529,147,676,56,732
公投第９案,新竹縣,竹東鎮,三重里,158,1379,568,141,709,55,764
公投第９案,新竹縣,竹東鎮,三重里,159,1033,437,110,547,53,600
公投第９案,新竹縣,竹東鎮,三重里,160,1066,462,85,547,35,582
公投第９案,新竹縣,竹東鎮,二重里,161,938,412,104,516,38,554
公投第９案,新竹縣,竹東鎮,二重里,162,952,444,102,546,40,586
公投第９案,新竹縣,竹東鎮,二重里,163,1468,677,151,828,43,871
公投第９案,新竹縣,竹東鎮,二重里,164,1915,744,198,942,34,976
公投第９案,新竹縣,竹東鎮,二重里,165,1220,464,121,585,43,628
公投第９案,新竹縣,竹東鎮,二重里,166,1166,419,92,511,20,531
公投第９案,新竹縣,竹東鎮,二重里,167,1492,551,132,683,30,713
公投第９案,新竹縣,竹東鎮,二重里,168,1245,473,140,613,38,651
公投第９案,新竹縣,竹東鎮,頭重里,169,1083,451,135,586,36,622
公投第９案,新竹縣,竹東鎮,頭重里,170,1102,445,132,577,29,606
公投第９案,新竹縣,竹東鎮,頭重里,171,1068,466,94,560,20,580
公投第９案,新竹縣,竹東鎮,頭重里,172,1097,452,149,601,25,626
公投第９案,新竹縣,竹東鎮,員山里,173,962,391,68,459,22,481
公投第９案,新竹縣,竹東鎮,員山里,174,909,373,115,488,26,514
公投第９案,新竹縣,竹東鎮,柯湖里,175,603,219,53,272,30,302
公投第９案,新竹縣,新埔鎮,新埔里,176,983,440,97,537,49,586
公投第９案,新竹縣,新埔鎮,新生里,177,597,262,81,343,26,369
公投第９案,新竹縣,新埔鎮,新民里,178,1070,464,92,556,27,583
公投第９案,新竹縣,新埔鎮,田新里,179,935,406,83,489,38,527
公投第９案,新竹縣,新埔鎮,田新里,180,753,316,89,405,27,432
公投第９案,新竹縣,新埔鎮,田新里,181,838,427,99,526,26,552
公投第９案,新竹縣,新埔鎮,旱坑里,182,924,395,86,481,37,518
公投第９案,新竹縣,新埔鎮,旱坑里,183,905,353,66,419,28,447
公投第９案,新竹縣,新埔鎮,五埔里,184,948,407,93,500,38,538
公投第９案,新竹縣,新埔鎮,五埔里,185,1017,440,102,542,52,594
公投第９案,新竹縣,新埔鎮,四座里,186,1176,550,127,677,41,718
公投第９案,新竹縣,新埔鎮,四座里,187,1122,499,143,642,56,698
公投第９案,新竹縣,新埔鎮,四座里,188,1022,340,98,438,17,455
公投第９案,新竹縣,新埔鎮,照門里,189,1429,521,140,661,49,710
公投第９案,新竹縣,新埔鎮,清水里,190,451,209,55,264,41,305
公投第９案,新竹縣,新埔鎮,鹿鳴里,191,724,283,103,386,24,410
公投第９案,新竹縣,新埔鎮,新北里,192,617,273,80,353,39,392
公投第９案,新竹縣,新埔鎮,巨埔里,193,1144,487,139,626,52,678
公投第９案,新竹縣,新埔鎮,內立里,194,1139,482,134,616,40,656
公投第９案,新竹縣,新埔鎮,寶石里,195,861,380,81,461,20,481
公投第９案,新竹縣,新埔鎮,文山里,196,1093,417,108,525,34,559
公投第９案,新竹縣,新埔鎮,文山里,197,978,366,102,468,40,508
公投第９案,新竹縣,新埔鎮,文山里,198,1040,366,103,469,38,507
公投第９案,新竹縣,新埔鎮,文山里,199,1160,469,115,584,38,622
公投第９案,新竹縣,新埔鎮,上寮里,200,950,430,120,550,25,575
公投第９案,新竹縣,新埔鎮,上寮里,201,882,372,93,465,32,497
公投第９案,新竹縣,新埔鎮,下寮里,202,1281,549,136,685,54,739
公投第９案,新竹縣,新埔鎮,下寮里,203,1212,484,128,612,39,651
公投第９案,新竹縣,新埔鎮,南平里,204,1013,376,70,446,38,484
公投第９案,新竹縣,新埔鎮,北平里,205,630,283,92,375,28,403
公投第９案,新竹縣,關西鎮,東興里,206,480,222,56,278,29,307
公投第９案,新竹縣,關西鎮,西安里,207,903,401,104,505,38,543
公投第９案,新竹縣,關西鎮,西安里,208,1020,433,123,556,38,594
公投第９案,新竹縣,關西鎮,南雄里,209,705,268,84,352,25,377
公投第９案,新竹縣,關西鎮,北斗里,210,1056,432,113,545,34,579
公投第９案,新竹縣,關西鎮,北斗里,211,1275,488,165,653,46,699
公投第９案,新竹縣,關西鎮,北斗里,212,1287,571,134,705,49,754
公投第９案,新竹縣,關西鎮,北山里,213,771,330,107,437,29,466
公投第９案,新竹縣,關西鎮,仁安里,214,1046,411,115,526,43,569
公投第９案,新竹縣,關西鎮,南山里,215,1030,427,126,553,49,602
公投第９案,新竹縣,關西鎮,東安里,216,1208,530,115,645,40,685
公投第９案,新竹縣,關西鎮,東安里,217,1095,417,85,502,26,528
公投第９案,新竹縣,關西鎮,東安里,218,1350,505,145,650,61,711
公投第９案,新竹縣,關西鎮,東山里,219,846,401,108,509,26,535
公投第９案,新竹縣,關西鎮,東光里,220,1362,524,145,669,74,743
公投第９案,新竹縣,關西鎮,南新里,221,903,309,102,411,34,445
公投第９案,新竹縣,關西鎮,新富里,222,551,185,59,244,21,265
公投第９案,新竹縣,關西鎮,玉山里,223,461,128,48,176,15,191
公投第９案,新竹縣,關西鎮,金山里,224,572,232,53,285,34,319
公投第９案,新竹縣,關西鎮,錦山里,225,943,359,115,474,32,506
公投第９案,新竹縣,關西鎮,大同里,226,808,305,121,426,42,468
公投第９案,新竹縣,關西鎮,石光里,227,923,463,96,559,24,583
公投第９案,新竹縣,關西鎮,石光里,228,903,406,93,499,36,535
公投第９案,新竹縣,關西鎮,東平里,229,977,435,95,530,43,573
公投第９案,新竹縣,關西鎮,上林里,230,824,357,107,464,40,504
公投第９案,新竹縣,關西鎮,新力里,231,559,272,54,326,16,342
公投第９案,新竹縣,關西鎮,南和里,232,854,424,80,504,30,534
公投第９案,新竹縣,湖口鄉,和興村,233,1393,496,58,554,50,604
公投第９案,新竹縣,湖口鄉,和興村,234,1505,649,174,823,49,872
公投第９案,新竹縣,湖口鄉,東興村,235,1188,545,167,712,44,756
公投第９案,新竹縣,湖口鄉,東興村,236,1267,541,141,682,45,727
公投第９案,新竹縣,湖口鄉,東興村,237,1668,741,162,903,31,934
公投第９案,新竹縣,湖口鄉,德盛村,238,1719,757,182,939,59,998
公投第９案,新竹縣,湖口鄉,德盛村,239,1162,535,139,674,45,719
公投第９案,新竹縣,湖口鄉,德盛村,240,1833,713,181,894,44,938
公投第９案,新竹縣,湖口鄉,愛勢村,241,1444,595,171,766,52,818
公投第９案,新竹縣,湖口鄉,愛勢村,242,1347,625,151,776,61,837
公投第９案,新竹縣,湖口鄉,愛勢村,243,1202,559,127,686,17,703
公投第９案,新竹縣,湖口鄉,仁勢村,244,851,380,94,474,41,515
公投第９案,新竹縣,湖口鄉,孝勢村,245,1272,554,143,697,58,755
公投第９案,新竹縣,湖口鄉,中勢村,246,1275,548,135,683,40,723
公投第９案,新竹縣,湖口鄉,中勢村,247,1560,728,176,904,12,916
公投第９案,新竹縣,湖口鄉,中正村,248,1147,518,139,657,77,734
公投第９案,新竹縣,湖口鄉,中正村,249,1729,752,165,917,51,968
公投第９案,新竹縣,湖口鄉,信勢村,250,1402,554,160,714,39,753
公投第９案,新竹縣,湖口鄉,信勢村,251,1183,507,144,651,52,703
公投第９案,新竹縣,湖口鄉,信勢村,252,1282,578,152,730,50,780
公投第９案,新竹縣,湖口鄉,信勢村,253,1335,579,181,760,38,798
公投第９案,新竹縣,湖口鄉,信義村,254,1493,719,165,884,43,927
公投第９案,新竹縣,湖口鄉,信義村,255,1877,825,156,981,18,999
公投第９案,新竹縣,湖口鄉,波羅村,256,1082,511,114,625,43,668
公投第９案,新竹縣,湖口鄉,波羅村,257,1115,461,163,624,62,686
公投第９案,新竹縣,湖口鄉,長嶺村,258,1193,437,131,568,32,600
公投第９案,新竹縣,湖口鄉,長嶺村,259,1947,789,171,960,44,1004
公投第９案,新竹縣,湖口鄉,長安村,260,1125,445,178,623,49,672
公投第９案,新竹縣,湖口鄉,湖口村,261,1050,469,101,570,41,611
公投第９案,新竹縣,湖口鄉,湖口村,262,1733,753,198,951,49,1000
公投第９案,新竹縣,湖口鄉,湖鏡村,263,1284,571,144,715,45,760
公投第９案,新竹縣,湖口鄉,湖鏡村,264,1062,489,112,601,32,633
公投第９案,新竹縣,湖口鄉,湖南村,265,1547,687,134,821,69,890
公投第９案,新竹縣,湖口鄉,中興村,266,1494,561,136,697,41,738
公投第９案,新竹縣,湖口鄉,中興村,267,1634,600,151,751,34,785
公投第９案,新竹縣,湖口鄉,中興村,268,1444,545,110,655,13,668
公投第９案,新竹縣,湖口鄉,中興村,269,1324,546,123,669,25,694
公投第９案,新竹縣,湖口鄉,鳳凰村,270,1058,459,106,565,36,601
公投第９案,新竹縣,湖口鄉,鳳凰村,271,1220,369,103,472,25,497
公投第９案,新竹縣,湖口鄉,鳳凰村,272,1333,552,160,712,36,748
公投第９案,新竹縣,湖口鄉,鳳凰村,273,1461,574,137,711,55,766
公投第９案,新竹縣,湖口鄉,勝利村,274,1429,568,145,713,32,745
公投第９案,新竹縣,湖口鄉,勝利村,275,1506,560,117,677,23,700
公投第９案,新竹縣,湖口鄉,勝利村,276,1103,511,111,622,44,666
公投第９案,新竹縣,湖口鄉,鳳山村,277,1495,550,151,701,40,741
公投第９案,新竹縣,湖口鄉,鳳山村,278,752,328,78,406,28,434
公投第９案,新竹縣,湖口鄉,鳳山村,279,986,433,95,528,18,546
公投第９案,新竹縣,新豐鄉,福興村,280,1080,403,117,520,57,577
公投第９案,新竹縣,新豐鄉,青埔村,281,887,335,104,439,27,466
公投第９案,新竹縣,新豐鄉,青埔村,282,954,379,122,501,35,536
公投第９案,新竹縣,新豐鄉,中崙村,283,1003,412,106,518,32,550
公投第９案,新竹縣,新豐鄉,中崙村,284,1106,448,117,565,39,604
公投第９案,新竹縣,新豐鄉,中崙村,285,1123,495,134,629,29,658
公投第９案,新竹縣,新豐鄉,瑞興村,286,891,370,115,485,43,528
公投第９案,新竹縣,新豐鄉,瑞興村,287,874,323,85,408,32,440
公投第９案,新竹縣,新豐鄉,後湖村,288,824,326,99,425,33,458
公投第９案,新竹縣,新豐鄉,後湖村,289,975,380,86,466,24,490
公投第９案,新竹縣,新豐鄉,坡頭村,290,847,321,106,427,49,476
公投第９案,新竹縣,新豐鄉,埔和村,291,1477,598,151,749,82,831
公投第９案,新竹縣,新豐鄉,埔和村,292,1266,425,183,608,57,665
公投第９案,新竹縣,新豐鄉,新豐村,293,1029,375,122,497,63,560
公投第９案,新竹縣,新豐鄉,新豐村,294,1063,369,150,519,52,571
公投第９案,新竹縣,新豐鄉,員山村,295,1055,467,91,558,23,581
公投第９案,新竹縣,新豐鄉,員山村,296,1445,638,137,775,28,803
公投第９案,新竹縣,新豐鄉,忠孝村,297,1413,698,134,832,34,866
公投第９案,新竹縣,新豐鄉,忠孝村,298,971,489,115,604,31,635
公投第９案,新竹縣,新豐鄉,忠孝村,299,1135,526,126,652,28,680
公投第９案,新竹縣,新豐鄉,山崎村,300,1269,509,133,642,38,680
公投第９案,新竹縣,新豐鄉,山崎村,301,1257,533,141,674,37,711
公投第９案,新竹縣,新豐鄉,山崎村,302,1662,749,170,919,47,966
公投第９案,新竹縣,新豐鄉,上坑村,303,1486,550,174,724,31,755
公投第９案,新竹縣,新豐鄉,鳳坑村,304,1067,459,146,605,62,667
公投第９案,新竹縣,新豐鄉,重興村,305,1302,604,126,730,56,786
公投第９案,新竹縣,新豐鄉,重興村,306,1410,555,171,726,63,789
公投第９案,新竹縣,新豐鄉,重興村,307,1267,514,141,655,40,695
公投第９案,新竹縣,新豐鄉,重興村,308,1258,469,117,586,45,631
公投第９案,新竹縣,新豐鄉,崎頂村,309,1217,470,100,570,17,587
公投第９案,新竹縣,新豐鄉,崎頂村,310,1456,625,147,772,29,801
公投第９案,新竹縣,新豐鄉,松林村,311,1157,516,128,644,35,679
公投第９案,新竹縣,新豐鄉,松林村,312,1089,438,108,546,26,572
公投第９案,新竹縣,新豐鄉,松林村,313,1160,532,108,640,9,649
公投第９案,新竹縣,新豐鄉,松林村,314,976,502,90,592,15,607
公投第９案,新竹縣,新豐鄉,松柏村,315,1443,606,161,767,39,806
公投第９案,新竹縣,新豐鄉,松柏村,316,1247,489,115,604,24,628
公投第９案,新竹縣,新豐鄉,松柏村,317,1411,645,119,764,27,791
公投第９案,新竹縣,新豐鄉,松柏村,318,1238,571,115,686,50,736
公投第９案,新竹縣,芎林鄉,華龍村,319,417,173,61,234,9,243
公投第９案,新竹縣,芎林鄉,五龍村,320,534,260,85,345,29,374
公投第９案,新竹縣,芎林鄉,秀湖村,321,963,436,90,526,39,565
公投第９案,新竹縣,芎林鄉,永興村,322,418,203,49,252,20,272
公投第９案,新竹縣,芎林鄉,石潭村,323,1312,531,142,673,48,721
公投第９案,新竹縣,芎林鄉,石潭村,324,1354,487,158,645,35,680
公投第９案,新竹縣,芎林鄉,新鳳村,325,785,324,106,430,40,470
公投第９案,新竹縣,芎林鄉,新鳳村,326,797,338,83,421,68,489
公投第９案,新竹縣,芎林鄉,中坑村,327,623,280,75,355,19,374
公投第９案,新竹縣,芎林鄉,水坑村,328,759,310,95,405,31,436
公投第９案,新竹縣,芎林鄉,文林村,329,1272,478,126,604,41,645
公投第９案,新竹縣,芎林鄉,文林村,330,1129,525,110,635,35,670
公投第９案,新竹縣,芎林鄉,芎林村,331,713,319,99,418,25,443
公投第９案,新竹縣,芎林鄉,芎林村,332,839,375,106,481,40,521
公投第９案,新竹縣,芎林鄉,上山村,333,1123,556,145,701,34,735
公投第９案,新竹縣,芎林鄉,上山村,334,981,453,99,552,25,577
公投第９案,新竹縣,芎林鄉,上山村,335,1078,467,148,615,42,657
公投第９案,新竹縣,芎林鄉,上山村,336,1094,449,110,559,36,595
公投第９案,新竹縣,芎林鄉,下山村,337,1102,458,135,593,57,650
公投第９案,新竹縣,橫山鄉,橫山村,338,1231,556,149,705,46,751
公投第９案,新竹縣,橫山鄉,橫山村,339,1041,458,118,576,53,629
公投第９案,新竹縣,橫山鄉,橫山村,340,1132,506,138,644,42,686
公投第９案,新竹縣,橫山鄉,田寮村,341,859,372,103,475,33,508
公投第９案,新竹縣,橫山鄉,南昌村,342,204,80,25,105,13,118
公投第９案,新竹縣,橫山鄉,豐鄉村,343,222,65,24,89,11,100
公投第９案,新竹縣,橫山鄉,豐田村,344,338,131,47,178,40,218
公投第９案,新竹縣,橫山鄉,內灣村,345,916,367,91,458,34,492
公投第９案,新竹縣,橫山鄉,力行村,346,573,177,44,221,17,238
公投第９案,新竹縣,橫山鄉,力行村,347,275,133,43,176,12,188
公投第９案,新竹縣,橫山鄉,福興村,348,463,157,45,202,24,226
公投第９案,新竹縣,橫山鄉,沙坑村,349,690,333,67,400,39,439
公投第９案,新竹縣,橫山鄉,沙坑村,350,288,93,34,127,14,141
公投第９案,新竹縣,橫山鄉,新興村,351,685,329,83,412,30,442
公投第９案,新竹縣,橫山鄉,新興村,352,868,401,99,500,37,537
公投第９案,新竹縣,橫山鄉,大肚村,353,1561,713,178,891,71,962
公投第９案,新竹縣,北埔鄉,北埔村,354,1158,422,124,546,19,565
公投第９案,新竹縣,北埔鄉,南興村,355,1238,519,156,675,57,732
公投第９案,新竹縣,北埔鄉,大湖村,356,580,256,59,315,22,337
公投第９案,新竹縣,北埔鄉,埔尾村,357,931,412,95,507,31,538
公投第９案,新竹縣,北埔鄉,埔尾村,358,1653,701,158,859,68,927
公投第９案,新竹縣,北埔鄉,水磜村,359,845,349,97,446,38,484
公投第９案,新竹縣,北埔鄉,南埔村,360,384,164,36,200,10,210
公投第９案,新竹縣,北埔鄉,大林村,361,763,333,69,402,18,420
公投第９案,新竹縣,北埔鄉,南坑村,362,333,131,38,169,14,183
公投第９案,新竹縣,北埔鄉,外坪村,363,295,121,21,142,7,149
公投第９案,新竹縣,寶山鄉,雙溪村,364,1158,477,129,606,56,662
公投第９案,新竹縣,寶山鄉,雙溪村,365,1437,641,159,800,24,824
公投第９案,新竹縣,寶山鄉,雙新村,366,1470,594,195,789,52,841
公投第９案,新竹縣,寶山鄉,雙新村,367,1170,517,150,667,41,708
公投第９案,新竹縣,寶山鄉,大崎村,368,1900,845,208,1053,47,1100
公投第９案,新竹縣,寶山鄉,三峰村,369,1056,414,99,513,24,537
公投第９案,新竹縣,寶山鄉,新城村,370,1205,546,150,696,60,756
公投第９案,新竹縣,寶山鄉,寶斗村,371,766,318,89,407,32,439
公投第９案,新竹縣,寶山鄉,深井村,372,846,392,93,485,34,519
公投第９案,新竹縣,寶山鄉,寶山村,373,804,352,100,452,36,488
公投第９案,新竹縣,寶山鄉,油田村,374,607,269,77,346,14,360
公投第９案,新竹縣,寶山鄉,山湖村,375,554,255,84,339,11,350
公投第９案,新竹縣,峨眉鄉,峨眉村,376,879,409,114,523,47,570
公投第９案,新竹縣,峨眉鄉,中盛村,377,683,295,85,380,50,430
公投第９案,新竹縣,峨眉鄉,石井村,378,604,257,82,339,26,365
公投第９案,新竹縣,峨眉鄉,七星村,379,339,139,39,178,21,199
公投第９案,新竹縣,峨眉鄉,七星村,380,276,76,31,107,7,114
公投第９案,新竹縣,峨眉鄉,富興村,381,1406,628,145,773,84,857
公投第９案,新竹縣,峨眉鄉,湖光村,382,462,220,45,265,24,289
公投第９案,新竹縣,峨眉鄉,湖光村,383,419,151,54,205,20,225
公投第９案,新竹縣,尖石鄉,嘉樂村,384,474,136,38,174,11,185
公投第９案,新竹縣,尖石鄉,嘉樂村,385,357,127,32,159,9,168
公投第９案,新竹縣,尖石鄉,義興村,386,225,73,21,94,16,110
公投第９案,新竹縣,尖石鄉,義興村,387,374,134,28,162,6,168
公投第９案,新竹縣,尖石鄉,新樂村,388,773,234,65,299,10,309
公投第９案,新竹縣,尖石鄉,新樂村,389,490,151,43,194,17,211
公投第９案,新竹縣,尖石鄉,錦屏村,390,531,138,39,177,4,181
公投第９案,新竹縣,尖石鄉,錦屏村,391,660,206,51,257,10,267
公投第９案,新竹縣,尖石鄉,梅花村,392,613,236,102,338,62,400
公投第９案,新竹縣,尖石鄉,玉峰村,393,593,179,72,251,2,253
公投第９案,新竹縣,尖石鄉,玉峰村,394,575,176,64,240,18,258
公投第９案,新竹縣,尖石鄉,玉峰村,395,126,63,13,76,8,84
公投第９案,新竹縣,尖石鄉,秀巒村,396,499,128,29,157,5,162
公投第９案,新竹縣,尖石鄉,秀巒村,397,785,141,59,200,19,219
公投第９案,新竹縣,尖石鄉,秀巒村,398,289,90,57,147,16,163
公投第９案,新竹縣,五峰鄉,大隘村,399,672,247,76,323,33,356
公投第９案,新竹縣,五峰鄉,大隘村,400,713,220,68,288,15,303
公投第９案,新竹縣,五峰鄉,桃山村,401,594,149,41,190,7,197
公投第９案,新竹縣,五峰鄉,桃山村,402,896,255,79,334,33,367
公投第９案,新竹縣,五峰鄉,花園村,403,727,199,77,276,5,281
公投第９案,新竹縣,五峰鄉,竹林村,404,395,97,40,137,10,147
公投第９案,苗栗縣,苗栗市,中苗里,1,1087,502,90,592,32,624
公投第９案,苗栗縣,苗栗市,青苗里,2,1018,450,89,539,32,571
公投第９案,苗栗縣,苗栗市,維祥里,3,1156,506,103,609,25,634
公投第９案,苗栗縣,苗栗市,維祥里,4,1118,477,102,579,35,614
公投第９案,苗栗縣,苗栗市,維祥里,5,1084,488,109,597,41,638
公投第９案,苗栗縣,苗栗市,維新里,6,1203,561,120,681,40,721
公投第９案,苗栗縣,苗栗市,維新里,7,1306,586,138,724,49,773
公投第９案,苗栗縣,苗栗市,維新里,8,1193,530,147,677,38,715
公投第９案,苗栗縣,苗栗市,玉清里,9,1115,516,114,630,30,660
公投第９案,苗栗縣,苗栗市,玉清里,10,1119,526,114,640,47,687
公投第９案,苗栗縣,苗栗市,玉華里,11,1132,525,139,664,32,696
公投第９案,苗栗縣,苗栗市,玉華里,12,1289,584,122,706,34,740
公投第９案,苗栗縣,苗栗市,玉華里,13,1264,590,132,722,36,758
公投第９案,苗栗縣,苗栗市,綠苗里,14,870,382,84,466,26,492
公投第９案,苗栗縣,苗栗市,高苗里,15,1008,397,80,477,34,511
公投第９案,苗栗縣,苗栗市,高苗里,16,1078,429,107,536,32,568
公投第９案,苗栗縣,苗栗市,高苗里,17,1077,507,112,619,26,645
公投第９案,苗栗縣,苗栗市,新苗里,18,880,382,94,476,33,509
公投第９案,苗栗縣,苗栗市,玉苗里,19,894,364,91,455,48,503
公投第９案,苗栗縣,苗栗市,大同里,20,522,221,57,278,25,303
公投第９案,苗栗縣,苗栗市,恭敬里,21,1376,655,159,814,58,872
公投第９案,苗栗縣,苗栗市,水源里,22,1391,589,128,717,34,751
公投第９案,苗栗縣,苗栗市,水源里,23,1081,479,117,596,52,648
公投第９案,苗栗縣,苗栗市,勝利里,24,1272,532,128,660,49,709
公投第９案,苗栗縣,苗栗市,勝利里,25,1112,549,123,672,41,713
公投第９案,苗栗縣,苗栗市,勝利里,26,813,432,87,519,25,544
公投第９案,苗栗縣,苗栗市,勝利里,27,767,329,83,412,25,437
公投第９案,苗栗縣,苗栗市,清華里,28,1010,450,96,546,18,564
公投第９案,苗栗縣,苗栗市,清華里,29,1182,532,103,635,32,667
公投第９案,苗栗縣,苗栗市,清華里,30,965,451,86,537,15,552
公投第９案,苗栗縣,苗栗市,上苗里,31,607,299,53,352,12,364
公投第９案,苗栗縣,苗栗市,上苗里,32,990,475,112,587,25,612
公投第９案,苗栗縣,苗栗市,北苗里,33,1230,475,104,579,89,668
公投第９案,苗栗縣,苗栗市,北苗里,34,1372,613,134,747,44,791
公投第９案,苗栗縣,苗栗市,北苗里,35,1213,537,126,663,47,710
公投第９案,苗栗縣,苗栗市,北苗里,36,1272,560,123,683,41,724
公投第９案,苗栗縣,苗栗市,嘉盛里,37,1221,571,135,706,43,749
公投第９案,苗栗縣,苗栗市,嘉盛里,38,1104,495,106,601,45,646
公投第９案,苗栗縣,苗栗市,嘉盛里,39,1171,474,120,594,12,606
公投第９案,苗栗縣,苗栗市,福星里,40,1392,600,135,735,50,785
公投第９案,苗栗縣,苗栗市,福星里,41,1356,599,162,761,35,796
公投第９案,苗栗縣,苗栗市,福星里,42,1387,604,158,762,48,810
公投第９案,苗栗縣,苗栗市,福安里,43,1206,524,113,637,39,676
公投第９案,苗栗縣,苗栗市,福安里,44,1004,471,130,601,36,637
公投第９案,苗栗縣,苗栗市,福安里,45,1202,515,129,644,31,675
公投第９案,苗栗縣,苗栗市,嘉新里,46,1052,499,113,612,30,642
公投第９案,苗栗縣,苗栗市,嘉新里,47,873,418,96,514,27,541
公投第９案,苗栗縣,苗栗市,嘉新里,48,975,528,95,623,30,653
公投第９案,苗栗縣,苗栗市,建功里,49,1003,498,119,617,26,643
公投第９案,苗栗縣,苗栗市,建功里,50,1000,451,113,564,16,580
公投第９案,苗栗縣,苗栗市,建功里,51,1047,467,83,550,37,587
公投第９案,苗栗縣,苗栗市,建功里,52,1025,499,90,589,36,625
公投第９案,苗栗縣,苗栗市,福麗里,53,1130,485,109,594,16,610
公投第９案,苗栗縣,苗栗市,福麗里,54,1146,526,100,626,28,654
公投第９案,苗栗縣,苗栗市,福麗里,55,1432,627,160,787,45,832
公投第９案,苗栗縣,苗栗市,福麗里,56,1492,543,111,654,40,694
公投第９案,苗栗縣,苗栗市,文山里,57,1125,533,128,661,29,690
公投第９案,苗栗縣,苗栗市,文山里,58,1241,530,130,660,35,695
公投第９案,苗栗縣,苗栗市,文山里,59,1278,595,127,722,45,767
公投第９案,苗栗縣,苗栗市,文聖里,60,1293,588,104,692,22,714
公投第９案,苗栗縣,苗栗市,文聖里,61,1342,554,123,677,32,709
公投第９案,苗栗縣,苗栗市,文聖里,62,857,361,86,447,29,476
公投第９案,苗栗縣,苗栗市,新川里,63,1180,493,116,609,38,647
公投第９案,苗栗縣,苗栗市,南勢里,64,1072,501,109,610,26,636
公投第９案,苗栗縣,苗栗市,南勢里,65,912,392,62,454,29,483
公投第９案,苗栗縣,苗栗市,新英里,66,796,314,81,395,31,426
公投第９案,苗栗縣,苗栗市,新英里,67,869,323,83,406,24,430
公投第９案,苗栗縣,公館鄉,館中村,68,789,365,108,473,48,521
公投第９案,苗栗縣,公館鄉,館中村,69,792,397,95,492,29,521
公投第９案,苗栗縣,公館鄉,館東村,70,1117,478,150,628,90,718
公投第９案,苗栗縣,公館鄉,館東村,71,1255,569,149,718,67,785
公投第９案,苗栗縣,公館鄉,館南村,72,1141,517,124,641,40,681
公投第９案,苗栗縣,公館鄉,館南村,73,1172,494,152,646,41,687
公投第９案,苗栗縣,公館鄉,館南村,74,1100,501,152,653,42,695
公投第９案,苗栗縣,公館鄉,中義村,75,1232,488,123,611,41,652
公投第９案,苗栗縣,公館鄉,中義村,76,1081,409,101,510,59,569
公投第９案,苗栗縣,公館鄉,玉泉村,77,1250,615,122,737,38,775
公投第９案,苗栗縣,公館鄉,玉泉村,78,1081,457,134,591,40,631
公投第９案,苗栗縣,公館鄉,大坑村,79,964,374,115,489,64,553
公投第９案,苗栗縣,公館鄉,福基村,80,1038,436,130,566,66,632
公投第９案,苗栗縣,公館鄉,福德村,81,360,154,54,208,19,227
公投第９案,苗栗縣,公館鄉,福星村,82,865,350,107,457,42,499
公投第９案,苗栗縣,公館鄉,福星村,83,1166,484,124,608,44,652
公投第９案,苗栗縣,公館鄉,石墻村,84,719,325,78,403,25,428
公投第９案,苗栗縣,公館鄉,石墻村,85,788,300,92,392,43,435
公投第９案,苗栗縣,公館鄉,開礦村,86,303,135,42,177,25,202
公投第９案,苗栗縣,公館鄉,五谷村,87,1322,601,157,758,37,795
公投第９案,苗栗縣,公館鄉,五谷村,88,933,368,110,478,55,533
公投第９案,苗栗縣,公館鄉,玉谷村,89,1455,576,158,734,58,792
公投第９案,苗栗縣,公館鄉,鶴岡村,90,1615,677,222,899,100,999
公投第９案,苗栗縣,公館鄉,鶴山村,91,1451,588,150,738,68,806
公投第９案,苗栗縣,公館鄉,尖山村,92,1462,641,169,810,72,882
公投第９案,苗栗縣,公館鄉,仁安村,93,1317,522,149,671,66,737
公投第９案,苗栗縣,公館鄉,南河村,94,221,107,18,125,6,131
公投第９案,苗栗縣,公館鄉,北河村,95,329,129,35,164,11,175
公投第９案,苗栗縣,頭屋鄉,頭屋村,96,1335,670,163,833,60,893
公投第９案,苗栗縣,頭屋鄉,頭屋村,97,1168,619,143,762,65,827
公投第９案,苗栗縣,頭屋鄉,獅潭村,98,792,397,91,488,28,516
公投第９案,苗栗縣,頭屋鄉,獅潭村,99,918,479,139,618,40,658
公投第９案,苗栗縣,頭屋鄉,北坑村,100,725,364,71,435,28,463
公投第９案,苗栗縣,頭屋鄉,曲洞村,101,899,410,115,525,29,554
公投第９案,苗栗縣,頭屋鄉,飛鳳村,102,369,135,32,167,14,181
公投第９案,苗栗縣,頭屋鄉,象山村,103,844,379,100,479,25,504
公投第９案,苗栗縣,頭屋鄉,象山村,104,1007,458,110,568,26,594
公投第９案,苗栗縣,頭屋鄉,明德村,105,794,80,391,471,30,501
公投第９案,苗栗縣,頭屋鄉,明德村,106,211,117,23,140,17,157
公投第９案,苗栗縣,頭屋鄉,鳴鳳村,107,328,166,54,220,17,237
公投第９案,苗栗縣,銅鑼鄉,銅鑼村,108,887,430,83,513,35,548
公投第９案,苗栗縣,銅鑼鄉,銅鑼村,109,1052,465,118,583,47,630
公投第９案,苗栗縣,銅鑼鄉,銅鑼村,110,1347,646,154,800,26,826
公投第９案,苗栗縣,銅鑼鄉,銅鑼村,111,1177,400,226,626,45,671
公投第９案,苗栗縣,銅鑼鄉,樟樹村,112,1268,500,138,638,45,683
公投第９案,苗栗縣,銅鑼鄉,九湖村,113,1185,423,124,547,31,578
公投第９案,苗栗縣,銅鑼鄉,福興村,114,1029,476,78,554,42,596
公投第９案,苗栗縣,銅鑼鄉,朝陽村,115,905,411,79,490,31,521
公投第９案,苗栗縣,銅鑼鄉,朝陽村,116,750,342,94,436,30,466
公投第９案,苗栗縣,銅鑼鄉,竹森村,117,1080,425,96,521,41,562
公投第９案,苗栗縣,銅鑼鄉,中平村,118,1108,434,115,549,52,601
公投第９案,苗栗縣,銅鑼鄉,中平村,119,862,338,76,414,43,457
公投第９案,苗栗縣,銅鑼鄉,中平村,120,1216,491,128,619,28,647
公投第９案,苗栗縣,銅鑼鄉,興隆村,121,588,222,51,273,30,303
公投第９案,苗栗縣,銅鑼鄉,盛隆村,122,429,156,48,204,30,234
公投第９案,苗栗縣,銅鑼鄉,新隆村,123,541,231,65,296,21,317
公投第９案,苗栗縣,三義鄉,廣盛村,124,853,385,96,481,42,523
公投第９案,苗栗縣,三義鄉,廣盛村,125,983,483,104,587,24,611
公投第９案,苗栗縣,三義鄉,廣盛村,126,1080,485,126,611,37,648
公投第９案,苗栗縣,三義鄉,廣盛村,127,1216,523,99,622,26,648
公投第９案,苗栗縣,三義鄉,勝興村,128,1017,494,80,574,29,603
公投第９案,苗栗縣,三義鄉,勝興村,129,1180,489,116,605,28,633
公投第９案,苗栗縣,三義鄉,勝興村,130,1198,569,95,664,20,684
公投第９案,苗栗縣,三義鄉,龍騰村,131,417,179,46,225,16,241
公投第９案,苗栗縣,三義鄉,双湖村,132,991,391,101,492,24,516
公投第９案,苗栗縣,三義鄉,双湖村,133,834,381,89,470,17,487
公投第９案,苗栗縣,三義鄉,双潭村,134,622,254,81,335,31,366
公投第９案,苗栗縣,三義鄉,双潭村,135,749,338,86,424,36,460
公投第９案,苗栗縣,三義鄉,西湖村,136,692,338,94,432,28,460
公投第９案,苗栗縣,三義鄉,西湖村,137,759,396,100,496,39,535
公投第９案,苗栗縣,三義鄉,鯉魚潭村,138,629,238,72,310,25,335
公投第９案,苗栗縣,三義鄉,鯉魚潭村,139,669,272,83,355,31,386
公投第９案,苗栗縣,西湖鄉,高埔村,140,601,238,66,304,21,325
公投第９案,苗栗縣,西湖鄉,下埔村,141,566,249,71,320,21,341
公投第９案,苗栗縣,西湖鄉,五湖村,142,843,352,106,458,32,490
公投第９案,苗栗縣,西湖鄉,四湖村,143,648,257,65,322,22,344
公投第９案,苗栗縣,西湖鄉,三湖村,144,936,349,95,444,30,474
公投第９案,苗栗縣,西湖鄉,龍洞村,145,461,178,52,230,16,246
公投第９案,苗栗縣,西湖鄉,金獅村,146,515,222,59,281,12,293
公投第９案,苗栗縣,西湖鄉,湖東村,147,1141,431,121,552,63,615
公投第９案,苗栗縣,西湖鄉,二湖村,148,671,296,68,364,30,394
公投第９案,苗栗縣,通霄鎮,通東里,149,1142,417,163,580,71,651
公投第９案,苗栗縣,通霄鎮,通西里,150,884,370,141,511,59,570
公投第９案,苗栗縣,通霄鎮,通西里,151,1068,394,135,529,69,598
公投第９案,苗栗縣,通霄鎮,平元里,152,1009,408,118,526,42,568
公投第９案,苗栗縣,通霄鎮,平元里,153,859,387,123,510,50,560
公投第９案,苗栗縣,通霄鎮,平安里,154,1040,420,141,561,41,602
公投第９案,苗栗縣,通霄鎮,平安里,155,1008,323,82,405,19,424
公投第９案,苗栗縣,通霄鎮,圳頭里,156,686,262,90,352,56,408
公投第９案,苗栗縣,通霄鎮,梅南里,157,761,352,97,449,55,504
公投第９案,苗栗縣,通霄鎮,梅南里,158,790,280,83,363,34,397
公投第９案,苗栗縣,通霄鎮,通南里,159,966,367,115,482,48,530
公投第９案,苗栗縣,通霄鎮,通南里,160,972,314,117,431,72,503
公投第９案,苗栗縣,通霄鎮,通南里,161,771,291,90,381,49,430
公投第９案,苗栗縣,通霄鎮,內湖里,162,758,219,76,295,34,329
公投第９案,苗栗縣,通霄鎮,內湖里,163,1078,401,138,539,43,582
公投第９案,苗栗縣,通霄鎮,楓樹里,164,459,126,46,172,27,199
公投第９案,苗栗縣,通霄鎮,烏眉里,165,894,317,86,403,46,449
公投第９案,苗栗縣,通霄鎮,福龍里,166,402,106,42,148,11,159
公投第９案,苗栗縣,通霄鎮,福源里,167,802,292,107,399,35,434
公投第９案,苗栗縣,通霄鎮,城北里,168,684,233,86,319,28,347
公投第９案,苗栗縣,通霄鎮,城南里,169,943,321,78,399,41,440
公投第９案,苗栗縣,通霄鎮,南和里,170,790,309,110,419,60,479
公投第９案,苗栗縣,通霄鎮,福興里,171,673,210,55,265,12,277
公投第９案,苗栗縣,通霄鎮,坪頂里,172,1232,460,123,583,65,648
公投第９案,苗栗縣,通霄鎮,五南里,173,1286,526,143,669,84,753
公投第９案,苗栗縣,通霄鎮,五北里,174,649,249,92,341,46,387
公投第９案,苗栗縣,通霄鎮,五北里,175,769,267,87,354,32,386
公投第９案,苗栗縣,通霄鎮,通灣里,176,1148,395,162,557,76,633
公投第９案,苗栗縣,通霄鎮,通灣里,177,1138,357,133,490,85,575
公投第９案,苗栗縣,通霄鎮,新埔里,178,1121,370,117,487,57,544
公投第９案,苗栗縣,通霄鎮,內島里,179,769,321,82,403,24,427
公投第９案,苗栗縣,通霄鎮,白東里,180,616,188,98,286,8,294
公投第９案,苗栗縣,通霄鎮,白東里,181,799,258,142,400,36,436
公投第９案,苗栗縣,通霄鎮,白西里,182,743,257,80,337,35,372
公投第９案,苗栗縣,苑裡鎮,苑東里,183,873,351,116,467,56,523
公投第９案,苗栗縣,苑裡鎮,苑東里,184,1346,594,145,739,49,788
公投第９案,苗栗縣,苑裡鎮,苑南里,185,951,447,128,575,56,631
公投第９案,苗栗縣,苑裡鎮,苑南里,186,615,235,68,303,18,321
公投第９案,苗栗縣,苑裡鎮,苑北里,187,878,415,78,493,53,546
公投第９案,苗栗縣,苑裡鎮,西平里,188,767,335,106,441,26,467
公投第９案,苗栗縣,苑裡鎮,西平里,189,776,288,102,390,44,434
公投第９案,苗栗縣,苑裡鎮,苑港里,190,1231,453,128,581,56,637
公投第９案,苗栗縣,苑裡鎮,西勢里,191,1145,480,153,633,39,672
公投第９案,苗栗縣,苑裡鎮,西勢里,192,850,329,104,433,38,471
公投第９案,苗栗縣,苑裡鎮,海岸里,193,1052,379,137,516,62,578
公投第９案,苗栗縣,苑裡鎮,房裡里,194,1114,469,128,597,42,639
公投第９案,苗栗縣,苑裡鎮,房裡里,195,1136,446,168,614,58,672
公投第９案,苗栗縣,苑裡鎮,客庄里,196,1194,479,145,624,44,668
公投第９案,苗栗縣,苑裡鎮,客庄里,197,1579,677,172,849,51,900
公投第９案,苗栗縣,苑裡鎮,客庄里,198,1149,491,165,656,57,713
公投第９案,苗栗縣,苑裡鎮,中正里,199,1057,425,149,574,66,640
公投第９案,苗栗縣,苑裡鎮,中正里,200,1101,417,98,515,24,539
公投第９案,苗栗縣,苑裡鎮,苑坑里,201,912,284,99,383,43,426
公投第９案,苗栗縣,苑裡鎮,水坡里,202,652,238,88,326,38,364
公投第９案,苗栗縣,苑裡鎮,新復里,203,1348,558,156,714,71,785
公投第９案,苗栗縣,苑裡鎮,山脚里,204,733,240,89,329,18,347
公投第９案,苗栗縣,苑裡鎮,山脚里,205,662,260,52,312,15,327
公投第９案,苗栗縣,苑裡鎮,舊社里,206,893,370,102,472,44,516
公投第９案,苗栗縣,苑裡鎮,舊社里,207,910,397,102,499,46,545
公投第９案,苗栗縣,苑裡鎮,福田里,208,1270,469,165,634,62,696
公投第９案,苗栗縣,苑裡鎮,石鎮里,209,545,203,60,263,29,292
公投第９案,苗栗縣,苑裡鎮,蕉埔里,210,792,349,90,439,62,501
公投第９案,苗栗縣,苑裡鎮,南勢里,211,726,288,94,382,36,418
公投第９案,苗栗縣,苑裡鎮,泰田里,212,827,254,70,324,20,344
公投第９案,苗栗縣,苑裡鎮,泰田里,213,782,306,98,404,60,464
公投第９案,苗栗縣,苑裡鎮,上舘里,214,788,301,98,399,35,434
公投第９案,苗栗縣,苑裡鎮,上舘里,215,846,317,104,421,41,462
公投第９案,苗栗縣,苑裡鎮,玉田里,216,828,340,111,451,53,504
公投第９案,苗栗縣,苑裡鎮,玉田里,217,943,377,125,502,48,550
公投第９案,苗栗縣,苑裡鎮,社苓里,218,1082,458,142,600,33,633
公投第９案,苗栗縣,苑裡鎮,社苓里,219,1234,520,166,686,63,749
公投第９案,苗栗縣,苑裡鎮,山柑里,220,1434,582,148,730,53,783
公投第９案,苗栗縣,苑裡鎮,田心里,221,987,423,108,531,39,570
公投第９案,苗栗縣,苑裡鎮,田心里,222,882,385,128,513,49,562
公投第９案,苗栗縣,後龍鎮,南龍里,223,590,216,83,299,36,335
公投第９案,苗栗縣,後龍鎮,南龍里,224,883,379,130,509,49,558
公投第９案,苗栗縣,後龍鎮,中龍里,225,793,340,97,437,57,494
公投第９案,苗栗縣,後龍鎮,北龍里,226,732,298,108,406,33,439
公投第９案,苗栗縣,後龍鎮,北龍里,227,592,238,87,325,35,360
公投第９案,苗栗縣,後龍鎮,大庄里,228,1113,450,152,602,61,663
公投第９案,苗栗縣,後龍鎮,大庄里,229,1195,486,132,618,59,677
公投第９案,苗栗縣,後龍鎮,大庄里,230,997,437,130,567,48,615
公投第９案,苗栗縣,後龍鎮,大庄里,231,913,282,128,410,28,438
公投第９案,苗栗縣,後龍鎮,東明里,232,641,221,77,298,39,337
公投第９案,苗栗縣,後龍鎮,東明里,233,848,313,87,400,37,437
公投第９案,苗栗縣,後龍鎮,灣寶里,234,1264,471,140,611,91,702
公投第９案,苗栗縣,後龍鎮,海寶里,235,965,332,115,447,42,489
公投第９案,苗栗縣,後龍鎮,豐富里,236,1216,624,152,776,76,852
公投第９案,苗栗縣,後龍鎮,校椅里,237,977,400,92,492,39,531
公投第９案,苗栗縣,後龍鎮,埔頂里,238,943,312,112,424,51,475
公投第９案,苗栗縣,後龍鎮,埔頂里,239,910,333,119,452,69,521
公投第９案,苗栗縣,後龍鎮,埔頂里,240,851,344,83,427,47,474
公投第９案,苗栗縣,後龍鎮,新民里,241,725,295,119,414,33,447
公投第９案,苗栗縣,後龍鎮,新民里,242,650,260,83,343,45,388
公投第９案,苗栗縣,後龍鎮,復興里,243,706,226,93,319,49,368
公投第９案,苗栗縣,後龍鎮,大山里,244,748,272,109,381,50,431
公投第９案,苗栗縣,後龍鎮,大山里,245,801,268,69,337,40,377
公投第９案,苗栗縣,後龍鎮,溪洲里,246,1107,438,137,575,50,625
公投第９案,苗栗縣,後龍鎮,溪洲里,247,1197,454,138,592,61,653
公投第９案,苗栗縣,後龍鎮,外埔里,248,1036,363,110,473,53,526
公投第９案,苗栗縣,後龍鎮,海埔里,249,913,274,100,374,38,412
公投第９案,苗栗縣,後龍鎮,秀水里,250,719,287,96,383,57,440
公投第９案,苗栗縣,後龍鎮,水尾里,251,1037,410,97,507,92,599
公投第９案,苗栗縣,後龍鎮,龍津里,252,601,226,60,286,20,306
公投第９案,苗栗縣,後龍鎮,龍坑里,253,1269,405,124,529,49,578
公投第９案,苗栗縣,後龍鎮,福寧里,254,735,254,69,323,34,357
公投第９案,苗栗縣,後龍鎮,中和里,255,422,95,36,131,14,145
公投第９案,苗栗縣,後龍鎮,中和里,256,625,267,64,331,24,355
公投第９案,苗栗縣,後龍鎮,南港里,257,1234,393,117,510,64,574
公投第９案,苗栗縣,造橋鄉,造橋村,258,1171,571,131,702,62,764
公投第９案,苗栗縣,造橋鄉,造橋村,259,889,405,87,492,36,528
公投第９案,苗栗縣,造橋鄉,平興村,260,479,173,40,213,24,237
公投第９案,苗栗縣,造橋鄉,豐湖村,261,1024,441,123,564,36,600
公投第９案,苗栗縣,造橋鄉,大西村,262,1214,465,128,593,64,657
公投第９案,苗栗縣,造橋鄉,大西村,263,1071,380,132,512,50,562
公投第９案,苗栗縣,造橋鄉,大西村,264,1157,439,117,556,51,607
公投第９案,苗栗縣,造橋鄉,錦水村,265,512,208,53,261,36,297
公投第９案,苗栗縣,造橋鄉,大龍村,266,491,225,60,285,25,310
公投第９案,苗栗縣,造橋鄉,朝陽村,267,1272,553,148,701,65,766
公投第９案,苗栗縣,造橋鄉,談文村,268,785,315,95,410,42,452
公投第９案,苗栗縣,造橋鄉,龍昇村,269,962,386,147,533,100,633
公投第９案,苗栗縣,竹南鎮,竹南里,270,1086,460,155,615,35,650
公投第９案,苗栗縣,竹南鎮,竹南里,271,826,363,90,453,32,485
公投第９案,苗栗縣,竹南鎮,照南里,272,1051,391,110,501,51,552
公投第９案,苗栗縣,竹南鎮,照南里,273,1235,576,115,691,39,730
公投第９案,苗栗縣,竹南鎮,照南里,274,1016,437,120,557,58,615
公投第９案,苗栗縣,竹南鎮,正南里,275,1472,543,191,734,64,798
公投第９案,苗栗縣,竹南鎮,正南里,276,1301,486,121,607,32,639
公投第９案,苗栗縣,竹南鎮,新南里,277,1544,589,148,737,42,779
公投第９案,苗栗縣,竹南鎮,新南里,278,1512,637,155,792,38,830
公投第９案,苗栗縣,竹南鎮,新南里,279,1463,589,136,725,49,774
公投第９案,苗栗縣,竹南鎮,大厝里,280,1073,453,120,573,27,600
公投第９案,苗栗縣,竹南鎮,大厝里,281,1453,643,152,795,33,828
公投第９案,苗栗縣,竹南鎮,大厝里,282,1245,592,122,714,40,754
公投第９案,苗栗縣,竹南鎮,大厝里,283,1487,692,158,850,39,889
公投第９案,苗栗縣,竹南鎮,營盤里,284,1018,412,150,562,36,598
公投第９案,苗栗縣,竹南鎮,營盤里,285,1105,486,145,631,25,656
公投第９案,苗栗縣,竹南鎮,營盤里,286,1322,518,139,657,44,701
公投第９案,苗栗縣,竹南鎮,聖福里,287,1140,530,104,634,27,661
公投第９案,苗栗縣,竹南鎮,聖福里,288,1067,504,114,618,36,654
公投第９案,苗栗縣,竹南鎮,聖福里,289,1136,518,151,669,48,717
公投第９案,苗栗縣,竹南鎮,竹興里,290,1253,496,111,607,46,653
公投第９案,苗栗縣,竹南鎮,竹興里,291,963,363,104,467,46,513
公投第９案,苗栗縣,竹南鎮,竹興里,292,1021,386,123,509,47,556
公投第９案,苗栗縣,竹南鎮,龍山里,293,1154,519,132,651,41,692
公投第９案,苗栗縣,竹南鎮,龍山里,294,1042,449,117,566,30,596
公投第９案,苗栗縣,竹南鎮,天文里,295,1293,567,142,709,34,743
公投第９案,苗栗縣,竹南鎮,天文里,296,816,364,98,462,18,480
公投第９案,苗栗縣,竹南鎮,龍鳳里,297,989,410,104,514,48,562
公投第９案,苗栗縣,竹南鎮,龍鳳里,298,1122,541,98,639,39,678
公投第９案,苗栗縣,竹南鎮,山佳里,299,1111,393,100,493,30,523
公投第９案,苗栗縣,竹南鎮,山佳里,300,1036,442,120,562,53,615
公投第９案,苗栗縣,竹南鎮,山佳里,301,1112,433,99,532,28,560
公投第９案,苗栗縣,竹南鎮,山佳里,302,1348,545,125,670,29,699
公投第９案,苗栗縣,竹南鎮,佳興里,303,1114,484,143,627,26,653
公投第９案,苗栗縣,竹南鎮,佳興里,304,1119,484,142,626,44,670
公投第９案,苗栗縣,竹南鎮,佳興里,305,878,387,83,470,29,499
公投第９案,苗栗縣,竹南鎮,中港里,306,1059,478,129,607,44,651
公投第９案,苗栗縣,竹南鎮,中華里,307,869,356,132,488,34,522
公投第９案,苗栗縣,竹南鎮,中華里,308,800,309,105,414,29,443
公投第９案,苗栗縣,竹南鎮,中華里,309,1165,545,126,671,41,712
公投第９案,苗栗縣,竹南鎮,中英里,310,791,328,87,415,41,456
公投第９案,苗栗縣,竹南鎮,中英里,311,677,257,89,346,27,373
公投第９案,苗栗縣,竹南鎮,中美里,312,797,361,108,469,49,518
公投第９案,苗栗縣,竹南鎮,中美里,313,1191,508,107,615,33,648
公投第９案,苗栗縣,竹南鎮,開元里,314,1027,390,122,512,22,534
公投第９案,苗栗縣,竹南鎮,海口里,315,1341,599,146,745,46,791
公投第９案,苗栗縣,竹南鎮,海口里,316,1378,504,147,651,52,703
公投第９案,苗栗縣,竹南鎮,海口里,317,1216,514,140,654,26,680
公投第９案,苗栗縣,竹南鎮,港墘里,318,1570,643,148,791,34,825
公投第９案,苗栗縣,竹南鎮,港墘里,319,538,218,83,301,28,329
公投第９案,苗栗縣,竹南鎮,公舘里,320,1166,423,97,520,24,544
公投第９案,苗栗縣,竹南鎮,大埔里,321,1488,575,172,747,28,775
公投第９案,苗栗縣,竹南鎮,大埔里,322,1449,553,138,691,28,719
公投第９案,苗栗縣,竹南鎮,大埔里,323,1182,449,137,586,75,661
公投第９案,苗栗縣,竹南鎮,頂埔里,324,1175,439,156,595,75,670
公投第９案,苗栗縣,竹南鎮,頂埔里,325,983,401,110,511,46,557
公投第９案,苗栗縣,竹南鎮,崎頂里,326,492,225,64,289,20,309
公投第９案,苗栗縣,竹南鎮,崎頂里,327,1074,435,145,580,42,622
公投第９案,苗栗縣,竹南鎮,崎頂里,328,852,314,113,427,41,468
公投第９案,苗栗縣,竹南鎮,崎頂里,329,1297,544,111,655,29,684
公投第９案,苗栗縣,竹南鎮,公義里,330,1028,384,125,509,49,558
公投第９案,苗栗縣,頭份市,流東里,331,915,321,101,422,75,497
公投第９案,苗栗縣,頭份市,流東里,332,1292,509,165,674,61,735
公投第９案,苗栗縣,頭份市,珊湖里,333,928,394,133,527,25,552
公投第９案,苗栗縣,頭份市,珊湖里,334,835,312,80,392,15,407
公投第９案,苗栗縣,頭份市,斗煥里,335,1070,444,113,557,30,587
公投第９案,苗栗縣,頭份市,斗煥里,336,879,339,78,417,12,429
公投第９案,苗栗縣,頭份市,斗煥里,337,1039,370,126,496,43,539
公投第９案,苗栗縣,頭份市,新華里,338,1129,500,104,604,52,656
公投第９案,苗栗縣,頭份市,新華里,339,1041,441,97,538,34,572
公投第９案,苗栗縣,頭份市,新華里,340,1546,557,159,716,74,790
公投第９案,苗栗縣,頭份市,興隆里,341,935,423,127,550,35,585
公投第９案,苗栗縣,頭份市,興隆里,342,1180,429,142,571,46,617
公投第９案,苗栗縣,頭份市,興隆里,343,1499,547,163,710,50,760
公投第９案,苗栗縣,頭份市,興隆里,344,747,305,83,388,16,404
公投第９案,苗栗縣,頭份市,上埔里,345,1406,574,144,718,30,748
公投第９案,苗栗縣,頭份市,上埔里,346,1193,498,119,617,54,671
公投第９案,苗栗縣,頭份市,土牛里,347,948,387,120,507,45,552
公投第９案,苗栗縣,頭份市,頭份里,348,869,370,70,440,25,465
公投第９案,苗栗縣,頭份市,頭份里,349,1142,487,148,635,33,668
公投第９案,苗栗縣,頭份市,頭份里,350,1286,536,129,665,31,696
公投第９案,苗栗縣,頭份市,忠孝里,351,903,395,108,503,33,536
公投第９案,苗栗縣,頭份市,忠孝里,352,1186,564,127,691,44,735
公投第９案,苗栗縣,頭份市,忠孝里,353,1016,467,102,569,19,588
公投第９案,苗栗縣,頭份市,自強里,354,985,422,107,529,30,559
公投第９案,苗栗縣,頭份市,自強里,355,1037,428,106,534,28,562
公投第９案,苗栗縣,頭份市,信義里,356,947,338,92,430,34,464
公投第９案,苗栗縣,頭份市,仁愛里,357,890,404,82,486,32,518
公投第９案,苗栗縣,頭份市,仁愛里,358,646,284,89,373,33,406
公投第９案,苗栗縣,頭份市,上興里,359,975,399,129,528,49,577
公投第９案,苗栗縣,頭份市,上興里,360,1015,282,95,377,15,392
公投第９案,苗栗縣,頭份市,下興里,361,1399,636,155,791,57,848
公投第９案,苗栗縣,頭份市,下興里,362,1143,500,140,640,46,686
公投第９案,苗栗縣,頭份市,和平里,363,1030,514,110,624,47,671
公投第９案,苗栗縣,頭份市,山下里,364,1338,580,157,737,36,773
公投第９案,苗栗縣,頭份市,山下里,365,1450,604,136,740,35,775
公投第９案,苗栗縣,頭份市,山下里,366,1042,477,105,582,23,605
公投第９案,苗栗縣,頭份市,後庄里,367,1326,601,148,749,49,798
公投第９案,苗栗縣,頭份市,後庄里,368,1270,641,128,769,34,803
公投第９案,苗栗縣,頭份市,後庄里,369,1288,557,120,677,36,713
公投第９案,苗栗縣,頭份市,合興里,370,1243,568,119,687,32,719
公投第９案,苗栗縣,頭份市,合興里,371,1280,588,133,721,30,751
公投第９案,苗栗縣,頭份市,文化里,372,1618,642,187,829,79,908
公投第９案,苗栗縣,頭份市,文化里,373,1759,715,173,888,49,937
公投第９案,苗栗縣,頭份市,中興里,374,1264,584,124,708,41,749
公投第９案,苗栗縣,頭份市,中興里,375,1326,593,132,725,39,764
公投第９案,苗栗縣,頭份市,蟠桃里,376,1551,711,142,853,34,887
公投第９案,苗栗縣,頭份市,蟠桃里,377,1574,631,146,777,36,813
公投第９案,苗栗縣,頭份市,建國里,378,1262,543,154,697,37,734
公投第９案,苗栗縣,頭份市,建國里,379,1171,518,129,647,39,686
公投第９案,苗栗縣,頭份市,建國里,380,1074,526,137,663,33,696
公投第９案,苗栗縣,頭份市,成功里,381,1141,540,124,664,26,690
公投第９案,苗栗縣,頭份市,成功里,382,1259,545,149,694,36,730
公投第９案,苗栗縣,頭份市,成功里,383,1186,488,126,614,41,655
公投第９案,苗栗縣,頭份市,民族里,384,1121,447,105,552,31,583
公投第９案,苗栗縣,頭份市,民族里,385,847,349,109,458,28,486
公投第９案,苗栗縣,頭份市,民權里,386,993,430,135,565,33,598
公投第９案,苗栗縣,頭份市,民權里,387,1055,409,29,438,33,471
公投第９案,苗栗縣,頭份市,東庄里,388,1655,624,144,768,59,827
公投第９案,苗栗縣,頭份市,東庄里,389,1799,734,174,908,81,989
公投第９案,苗栗縣,頭份市,田寮里,390,1141,485,139,624,38,662
公投第９案,苗栗縣,頭份市,田寮里,391,1431,605,139,744,37,781
公投第９案,苗栗縣,頭份市,田寮里,392,1412,498,126,624,26,650
公投第９案,苗栗縣,頭份市,民生里,393,1074,431,101,532,32,564
公投第９案,苗栗縣,頭份市,民生里,394,1245,568,129,697,46,743
公投第９案,苗栗縣,頭份市,蘆竹里,395,1344,564,186,750,51,801
公投第９案,苗栗縣,頭份市,尖山里,396,1363,611,173,784,58,842
公投第９案,苗栗縣,頭份市,廣興里,397,898,420,102,522,41,563
公投第９案,苗栗縣,頭份市,尖下里,398,1182,502,131,633,76,709
公投第９案,苗栗縣,頭份市,尖下里,399,1413,582,148,730,41,771
公投第９案,苗栗縣,頭份市,濫坑里,400,991,460,126,586,30,616
公投第９案,苗栗縣,頭份市,濫坑里,401,1180,515,139,654,42,696
公投第９案,苗栗縣,三灣鄉,三灣村,402,996,437,113,550,44,594
公投第９案,苗栗縣,三灣鄉,三灣村,403,1205,482,137,619,72,691
公投第９案,苗栗縣,三灣鄉,內灣村,404,635,253,101,354,33,387
公投第９案,苗栗縣,三灣鄉,銅鏡村,405,862,334,120,454,39,493
公投第９案,苗栗縣,三灣鄉,頂寮村,406,238,83,23,106,12,118
公投第９案,苗栗縣,三灣鄉,北埔村,407,541,196,64,260,33,293
公投第９案,苗栗縣,三灣鄉,大河村,408,578,206,65,271,28,299
公投第９案,苗栗縣,三灣鄉,大坪村,409,405,180,64,244,34,278
公投第９案,苗栗縣,三灣鄉,永和村,410,392,142,55,197,25,222
公投第９案,苗栗縣,南庄鄉,東村,411,1155,434,146,580,59,639
公投第９案,苗栗縣,南庄鄉,西村,412,650,237,87,324,41,365
公投第９案,苗栗縣,南庄鄉,南江村,413,1353,474,164,638,62,700
公投第９案,苗栗縣,南庄鄉,田美村,414,813,238,77,315,40,355
公投第９案,苗栗縣,南庄鄉,獅山村,415,837,262,67,329,28,357
公投第９案,苗栗縣,南庄鄉,南富村,416,1093,418,118,536,36,572
公投第９案,苗栗縣,南庄鄉,員林村,417,1048,390,131,521,50,571
公投第９案,苗栗縣,南庄鄉,蓬萊村,418,872,314,89,403,46,449
公投第９案,苗栗縣,南庄鄉,東河村,419,963,218,68,286,14,300
公投第９案,苗栗縣,大湖鄉,大湖村,420,744,277,97,374,28,402
公投第９案,苗栗縣,大湖鄉,大湖村,421,881,376,81,457,31,488
公投第９案,苗栗縣,大湖鄉,明湖村,422,596,253,49,302,37,339
公投第９案,苗栗縣,大湖鄉,大寮村,423,1260,461,108,569,83,652
公投第９案,苗栗縣,大湖鄉,靜湖村,424,867,339,82,421,34,455
公投第９案,苗栗縣,大湖鄉,靜湖村,425,923,373,90,463,47,510
公投第９案,苗栗縣,大湖鄉,富興村,426,1395,504,169,673,64,737
公投第９案,苗栗縣,大湖鄉,大南村,427,561,142,47,189,14,203
公投第９案,苗栗縣,大湖鄉,南湖村,428,638,267,76,343,27,370
公投第９案,苗栗縣,大湖鄉,東興村,429,754,274,86,360,39,399
公投第９案,苗栗縣,大湖鄉,武榮村,430,501,175,60,235,12,247
公投第９案,苗栗縣,大湖鄉,義和村,431,652,229,93,322,38,360
公投第９案,苗栗縣,大湖鄉,義和村,432,843,300,87,387,21,408
公投第９案,苗栗縣,大湖鄉,栗林村,433,1020,424,110,534,44,578
公投第９案,苗栗縣,大湖鄉,新開村,434,1018,432,105,537,42,579
公投第９案,苗栗縣,獅潭鄉,百壽村,435,328,96,23,119,8,127
公投第９案,苗栗縣,獅潭鄉,永興村,436,565,147,61,208,41,249
公投第９案,苗栗縣,獅潭鄉,新店村,437,911,369,93,462,62,524
公投第９案,苗栗縣,獅潭鄉,和興村,438,568,193,47,240,26,266
公投第９案,苗栗縣,獅潭鄉,豐林村,439,580,250,66,316,25,341
公投第９案,苗栗縣,獅潭鄉,新豐村,440,333,128,29,157,9,166
公投第９案,苗栗縣,獅潭鄉,竹木村,441,683,267,55,322,23,345
公投第９案,苗栗縣,卓蘭鎮,老庄里,442,961,369,187,556,31,587
公投第９案,苗栗縣,卓蘭鎮,老庄里,443,1017,399,111,510,62,572
公投第９案,苗栗縣,卓蘭鎮,新榮里,444,1095,452,175,627,75,702
公投第９案,苗栗縣,卓蘭鎮,中街里,445,745,336,82,418,29,447
公投第９案,苗栗縣,卓蘭鎮,新厝里,446,783,294,88,382,48,430
公投第９案,苗栗縣,卓蘭鎮,新厝里,447,745,267,72,339,18,357
公投第９案,苗栗縣,卓蘭鎮,豐田里,448,999,356,100,456,28,484
公投第９案,苗栗縣,卓蘭鎮,西坪里,449,671,299,81,380,38,418
公投第９案,苗栗縣,卓蘭鎮,苗豐里,450,734,336,85,421,59,480
公投第９案,苗栗縣,卓蘭鎮,上新里,451,865,389,88,477,57,534
公投第９案,苗栗縣,卓蘭鎮,上新里,452,828,367,102,469,50,519
公投第９案,苗栗縣,卓蘭鎮,上新里,453,386,168,47,215,30,245
公投第９案,苗栗縣,卓蘭鎮,內灣里,454,688,322,86,408,36,444
公投第９案,苗栗縣,卓蘭鎮,內灣里,455,792,348,99,447,47,494
公投第９案,苗栗縣,卓蘭鎮,內灣里,456,729,303,92,395,34,429
公投第９案,苗栗縣,卓蘭鎮,坪林里,457,1093,360,123,483,28,511
公投第９案,苗栗縣,卓蘭鎮,坪林里,458,615,262,69,331,13,344
公投第９案,苗栗縣,卓蘭鎮,西坪里,459,86,41,2,43,2,45
公投第９案,苗栗縣,卓蘭鎮,景山里,460,940,400,96,496,13,509
公投第９案,苗栗縣,泰安鄉,八卦村,461,325,100,29,129,17,146
公投第９案,苗栗縣,泰安鄉,錦水村,462,484,195,68,263,23,286
公投第９案,苗栗縣,泰安鄉,錦水村,463,666,337,100,437,48,485
公投第９案,苗栗縣,泰安鄉,清安村,464,574,273,72,345,44,389
公投第９案,苗栗縣,泰安鄉,清安村,465,333,135,21,156,13,169
公投第９案,苗栗縣,泰安鄉,大興村,466,495,253,65,318,17,335
公投第９案,苗栗縣,泰安鄉,中興村,467,544,265,90,355,38,393
公投第９案,苗栗縣,泰安鄉,梅園村,468,500,152,60,212,23,235
公投第９案,苗栗縣,泰安鄉,象鼻村,469,670,325,106,431,46,477
公投第９案,苗栗縣,泰安鄉,士林村,470,589,359,77,436,6,442
公投第９案,彰化縣,彰化市,桃源里,1,871,378,108,486,38,524
公投第９案,彰化縣,彰化市,桃源里,2,751,241,80,321,40,361
公投第９案,彰化縣,彰化市,桃源里,3,923,424,132,556,51,607
公投第９案,彰化縣,彰化市,東興里,4,779,312,122,434,49,483
公投第９案,彰化縣,彰化市,東興里,5,779,334,111,445,33,478
公投第９案,彰化縣,彰化市,華北里,6,720,276,110,386,38,424
公投第９案,彰化縣,彰化市,華北里,7,749,304,101,405,40,445
公投第９案,彰化縣,彰化市,華陽里,8,767,362,96,458,42,500
公投第９案,彰化縣,彰化市,華陽里,9,1047,437,153,590,63,653
公投第９案,彰化縣,彰化市,大同里,10,1027,404,140,544,41,585
公投第９案,彰化縣,彰化市,永生里,11,1249,523,143,666,56,722
公投第９案,彰化縣,彰化市,建寶里,12,1136,474,149,623,46,669
公投第９案,彰化縣,彰化市,建寶里,13,1169,529,139,668,57,725
公投第９案,彰化縣,彰化市,光南里,14,766,340,113,453,30,483
公投第９案,彰化縣,彰化市,光南里,15,643,277,80,357,19,376
公投第９案,彰化縣,彰化市,介壽里,16,1251,557,121,678,63,741
公投第９案,彰化縣,彰化市,介壽里,17,1301,351,116,467,41,508
公投第９案,彰化縣,彰化市,延平里,18,1280,566,161,727,40,767
公投第９案,彰化縣,彰化市,延平里,19,1179,542,142,684,41,725
公投第９案,彰化縣,彰化市,延平里,20,1168,512,144,656,32,688
公投第９案,彰化縣,彰化市,延平里,21,1218,531,139,670,48,718
公投第９案,彰化縣,彰化市,延平里,22,1351,634,201,835,37,872
公投第９案,彰化縣,彰化市,延平里,23,1204,625,63,688,30,718
公投第９案,彰化縣,彰化市,延平里,24,1189,541,152,693,17,710
公投第９案,彰化縣,彰化市,延和里,25,1207,476,160,636,57,693
公投第９案,彰化縣,彰化市,延和里,26,1161,523,18,541,51,592
公投第９案,彰化縣,彰化市,延和里,27,1166,446,169,615,40,655
公投第９案,彰化縣,彰化市,延和里,28,1362,632,147,779,56,835
公投第９案,彰化縣,彰化市,南興里,29,1236,540,190,730,40,770
公投第９案,彰化縣,彰化市,南興里,30,1065,480,123,603,43,646
公投第９案,彰化縣,彰化市,南興里,31,1199,514,158,672,51,723
公投第９案,彰化縣,彰化市,南興里,32,1233,537,170,707,34,741
公投第９案,彰化縣,彰化市,南興里,33,1245,551,130,681,41,722
公投第９案,彰化縣,彰化市,南興里,34,1153,493,180,673,36,709
公投第９案,彰化縣,彰化市,南瑤里,35,1045,439,112,551,43,594
公投第９案,彰化縣,彰化市,南瑤里,36,1097,471,144,615,15,630
公投第９案,彰化縣,彰化市,南瑤里,37,1190,488,152,640,53,693
公投第９案,彰化縣,彰化市,南瑤里,38,1106,476,160,636,56,692
公投第９案,彰化縣,彰化市,南瑤里,39,1097,500,131,631,30,661
公投第９案,彰化縣,彰化市,南瑤里,40,1048,427,163,590,50,640
公投第９案,彰化縣,彰化市,南瑤里,41,980,445,131,576,39,615
公投第９案,彰化縣,彰化市,成功里,42,707,304,108,412,27,439
公投第９案,彰化縣,彰化市,成功里,43,809,347,103,450,41,491
公投第９案,彰化縣,彰化市,福安里,44,1008,428,153,581,50,631
公投第９案,彰化縣,彰化市,西安里,45,901,341,118,459,58,517
公投第９案,彰化縣,彰化市,西安里,46,951,400,119,519,29,548
公投第９案,彰化縣,彰化市,西安里,47,1076,466,141,607,42,649
公投第９案,彰化縣,彰化市,彰安里,48,1022,391,103,494,33,527
公投第９案,彰化縣,彰化市,彰安里,49,894,373,119,492,44,536
公投第９案,彰化縣,彰化市,彰安里,50,1016,457,127,584,43,627
公投第９案,彰化縣,彰化市,中央里,51,771,317,130,447,48,495
公投第９案,彰化縣,彰化市,富貴里,52,868,344,137,481,43,524
公投第９案,彰化縣,彰化市,民權里,53,1135,448,178,626,63,689
公投第９案,彰化縣,彰化市,萬壽里,54,910,356,136,492,65,557
公投第９案,彰化縣,彰化市,長樂里,55,1004,406,162,568,42,610
公投第９案,彰化縣,彰化市,西興里,56,1077,498,132,630,42,672
公投第９案,彰化縣,彰化市,西興里,57,1258,625,153,778,50,828
公投第９案,彰化縣,彰化市,西興里,58,1025,479,131,610,42,652
公投第９案,彰化縣,彰化市,西勢里,59,1177,534,150,684,59,743
公投第９案,彰化縣,彰化市,西勢里,60,1262,531,132,663,52,715
公投第９案,彰化縣,彰化市,西勢里,61,1209,473,149,622,58,680
公投第９案,彰化縣,彰化市,忠權里,62,1041,458,156,614,46,660
公投第９案,彰化縣,彰化市,忠權里,63,1075,510,123,633,37,670
公投第９案,彰化縣,彰化市,忠權里,64,1029,438,101,539,52,591
公投第９案,彰化縣,彰化市,忠孝里,65,1203,476,146,622,76,698
公投第９案,彰化縣,彰化市,五權里,66,1014,434,106,540,43,583
公投第９案,彰化縣,彰化市,五權里,67,1069,479,131,610,35,645
公投第９案,彰化縣,彰化市,五權里,68,969,371,98,469,28,497
公投第９案,彰化縣,彰化市,五權里,69,1105,403,137,540,31,571
公投第９案,彰化縣,彰化市,平和里,70,981,449,138,587,42,629
公投第９案,彰化縣,彰化市,平和里,71,1095,462,167,629,57,686
公投第９案,彰化縣,彰化市,平和里,72,1087,493,140,633,34,667
公投第９案,彰化縣,彰化市,平和里,73,1050,459,138,597,37,634
公投第９案,彰化縣,彰化市,崙平里,74,1252,551,165,716,51,767
公投第９案,彰化縣,彰化市,崙平里,75,1113,455,126,581,32,613
公投第９案,彰化縣,彰化市,崙平里,76,1009,482,118,600,35,635
公投第９案,彰化縣,彰化市,崙平里,77,999,417,120,537,40,577
公投第９案,彰化縣,彰化市,崙平里,78,997,420,153,573,25,598
公投第９案,彰化縣,彰化市,向陽里,79,1145,557,149,706,38,744
公投第９案,彰化縣,彰化市,向陽里,80,1227,537,159,696,27,723
公投第９案,彰化縣,彰化市,向陽里,81,1208,541,177,718,34,752
公投第９案,彰化縣,彰化市,向陽里,82,1598,712,178,890,38,928
公投第９案,彰化縣,彰化市,莿桐里,83,890,402,104,506,43,549
公投第９案,彰化縣,彰化市,莿桐里,84,1104,517,167,684,27,711
公投第９案,彰化縣,彰化市,莿桐里,85,1097,477,127,604,27,631
公投第９案,彰化縣,彰化市,南美里,86,799,347,76,423,43,466
公投第９案,彰化縣,彰化市,南美里,87,1000,455,123,578,42,620
公投第９案,彰化縣,彰化市,南安里,88,1153,461,136,597,80,677
公投第９案,彰化縣,彰化市,南安里,89,977,433,117,550,52,602
公投第９案,彰化縣,彰化市,東芳里,90,1201,492,147,639,57,696
公投第９案,彰化縣,彰化市,東芳里,91,1057,435,169,604,60,664
公投第９案,彰化縣,彰化市,東芳里,92,1238,485,171,656,70,726
公投第９案,彰化縣,彰化市,磚磘里,93,1210,546,159,705,42,747
公投第９案,彰化縣,彰化市,磚磘里,94,1026,462,128,590,47,637
公投第９案,彰化縣,彰化市,磚磘里,95,1061,515,157,672,39,711
公投第９案,彰化縣,彰化市,卦山里,96,1213,527,146,673,50,723
公投第９案,彰化縣,彰化市,卦山里,97,1264,580,157,737,35,772
公投第９案,彰化縣,彰化市,光復里,98,691,298,118,416,48,464
公投第９案,彰化縣,彰化市,永福里,99,893,384,144,528,48,576
公投第９案,彰化縣,彰化市,光華里,100,733,300,112,412,44,456
公投第９案,彰化縣,彰化市,中正里,101,692,293,107,400,44,444
公投第９案,彰化縣,彰化市,中正里,102,728,302,91,393,40,433
公投第９案,彰化縣,彰化市,中山里,103,773,345,120,465,36,501
公投第９案,彰化縣,彰化市,龍山里,104,975,378,91,469,21,490
公投第９案,彰化縣,彰化市,龍山里,105,908,394,113,507,46,553
公投第９案,彰化縣,彰化市,新興里,106,1156,495,166,661,7,668
公投第９案,彰化縣,彰化市,新興里,107,1235,516,172,688,63,751
公投第９案,彰化縣,彰化市,新興里,108,1376,588,150,738,45,783
公投第９案,彰化縣,彰化市,新興里,109,1389,599,158,757,32,789
公投第９案,彰化縣,彰化市,新華里,110,846,373,134,507,52,559
公投第９案,彰化縣,彰化市,新華里,111,859,414,106,520,33,553
公投第９案,彰化縣,彰化市,興北里,112,781,338,121,459,23,482
公投第９案,彰化縣,彰化市,興北里,113,875,372,107,479,43,522
公投第９案,彰化縣,彰化市,信義里,114,816,338,113,451,33,484
公投第９案,彰化縣,彰化市,民生里,115,687,300,100,400,38,438
公投第９案,彰化縣,彰化市,民生里,116,727,333,93,426,48,474
公投第９案,彰化縣,彰化市,文化里,117,662,307,94,401,26,427
公投第９案,彰化縣,彰化市,文化里,118,633,300,83,383,21,404
公投第９案,彰化縣,彰化市,陽明里,119,906,432,117,549,38,587
公投第９案,彰化縣,彰化市,陽明里,120,853,349,101,450,42,492
公投第９案,彰化縣,彰化市,萬安里,121,1027,491,112,603,41,644
公投第９案,彰化縣,彰化市,萬安里,122,993,481,125,606,40,646
公投第９案,彰化縣,彰化市,萬安里,123,848,361,115,476,46,522
公投第９案,彰化縣,彰化市,萬安里,124,1118,526,152,678,26,704
公投第９案,彰化縣,彰化市,下廍里,125,1263,514,184,698,72,770
公投第９案,彰化縣,彰化市,下廍里,126,1268,585,159,744,54,798
公投第９案,彰化縣,彰化市,下廍里,127,1258,568,150,718,58,776
公投第９案,彰化縣,彰化市,下廍里,128,1212,571,141,712,31,743
公投第９案,彰化縣,彰化市,茄苳里,129,924,404,103,507,66,573
公投第９案,彰化縣,彰化市,茄南里,130,939,435,119,554,42,596
公投第９案,彰化縣,彰化市,茄南里,131,953,434,138,572,69,641
公投第９案,彰化縣,彰化市,茄南里,132,981,473,128,601,48,649
公投第９案,彰化縣,彰化市,寶廍里,133,1249,567,164,731,72,803
公投第９案,彰化縣,彰化市,古夷里,134,817,355,98,453,58,511
公投第９案,彰化縣,彰化市,古夷里,135,872,366,117,483,49,532
公投第９案,彰化縣,彰化市,古夷里,136,689,288,82,370,32,402
公投第９案,彰化縣,彰化市,阿夷里,137,1156,564,125,689,37,726
公投第９案,彰化縣,彰化市,阿夷里,138,1291,558,153,711,29,740
公投第９案,彰化縣,彰化市,阿夷里,139,1139,509,120,629,27,656
公投第９案,彰化縣,彰化市,阿夷里,140,1125,511,137,648,50,698
公投第９案,彰化縣,彰化市,阿夷里,141,1258,501,160,661,52,713
公投第９案,彰化縣,彰化市,阿夷里,142,1123,487,134,621,43,664
公投第９案,彰化縣,彰化市,阿夷里,143,1175,516,133,649,52,701
公投第９案,彰化縣,彰化市,和調里,144,862,384,147,531,39,570
公投第９案,彰化縣,彰化市,和調里,145,872,355,135,490,38,528
公投第９案,彰化縣,彰化市,和調里,146,897,442,111,553,26,579
公投第９案,彰化縣,彰化市,復興里,147,1003,412,120,532,27,559
公投第９案,彰化縣,彰化市,復興里,148,915,384,103,487,21,508
公投第９案,彰化縣,彰化市,復興里,149,1158,485,135,620,48,668
公投第９案,彰化縣,彰化市,復興里,150,1084,510,135,645,38,683
公投第９案,彰化縣,彰化市,中庄里,151,1372,660,153,813,65,878
公投第９案,彰化縣,彰化市,中庄里,152,1113,479,141,620,59,679
公投第９案,彰化縣,彰化市,竹中里,153,800,371,104,475,31,506
公投第９案,彰化縣,彰化市,竹中里,154,885,362,115,477,53,530
公投第９案,彰化縣,彰化市,香山里,155,1000,477,106,583,23,606
公投第９案,彰化縣,彰化市,香山里,156,1159,471,123,594,38,632
公投第９案,彰化縣,彰化市,香山里,157,1123,478,118,596,41,637
公投第９案,彰化縣,彰化市,牛埔里,158,907,410,120,530,64,594
公投第９案,彰化縣,彰化市,牛埔里,159,989,394,104,498,63,561
公投第９案,彰化縣,彰化市,牛埔里,160,1012,451,122,573,65,638
公投第９案,彰化縣,彰化市,台鳳里,161,1033,416,96,512,29,541
公投第９案,彰化縣,彰化市,台鳳里,162,1116,496,193,689,42,731
公投第９案,彰化縣,彰化市,台鳳里,163,1154,554,124,678,34,712
公投第９案,彰化縣,彰化市,台鳳里,164,1064,500,113,613,47,660
公投第９案,彰化縣,彰化市,國聖里,165,770,368,95,463,40,503
公投第９案,彰化縣,彰化市,國聖里,166,889,390,127,517,40,557
公投第９案,彰化縣,彰化市,國聖里,167,786,350,103,453,48,501
公投第９案,彰化縣,彰化市,福山里,168,1120,413,154,567,46,613
公投第９案,彰化縣,彰化市,福山里,169,1269,489,150,639,35,674
公投第９案,彰化縣,彰化市,福山里,170,1159,504,140,644,62,706
公投第９案,彰化縣,彰化市,福山里,171,1184,499,165,664,62,726
公投第９案,彰化縣,彰化市,福山里,172,1089,455,138,593,42,635
公投第９案,彰化縣,彰化市,福山里,173,968,424,131,555,50,605
公投第９案,彰化縣,彰化市,安溪里,174,930,421,100,521,24,545
公投第９案,彰化縣,彰化市,安溪里,175,973,444,126,570,32,602
公投第９案,彰化縣,彰化市,三村里,176,1184,431,137,568,40,608
公投第９案,彰化縣,彰化市,大竹里,177,1002,432,115,547,67,614
公投第９案,彰化縣,彰化市,大竹里,178,1148,486,128,614,27,641
公投第９案,彰化縣,彰化市,大竹里,179,1112,487,117,604,42,646
公投第９案,彰化縣,彰化市,田中里,180,907,463,96,559,61,620
公投第９案,彰化縣,彰化市,快官里,181,1112,474,132,606,72,678
公投第９案,彰化縣,彰化市,竹巷里,182,823,292,83,375,48,423
公投第９案,彰化縣,彰化市,福田里,183,1276,645,133,778,84,862
公投第９案,彰化縣,彰化市,石牌里,184,1161,479,120,599,60,659
公投第９案,彰化縣,花壇鄉,花壇村,185,901,388,104,492,49,541
公投第９案,彰化縣,花壇鄉,花壇村,186,1042,467,128,595,36,631
公投第９案,彰化縣,花壇鄉,花壇村,187,1314,528,133,661,20,681
公投第９案,彰化縣,花壇鄉,金墩村,188,808,332,93,425,56,481
公投第９案,彰化縣,花壇鄉,金墩村,189,1019,416,127,543,43,586
公投第９案,彰化縣,花壇鄉,中庄村,190,1144,466,158,624,76,700
公投第９案,彰化縣,花壇鄉,中庄村,191,1240,506,119,625,105,730
公投第９案,彰化縣,花壇鄉,崙雅村,192,1425,632,158,790,84,874
公投第９案,彰化縣,花壇鄉,劉厝村,193,1095,477,138,615,71,686
公投第９案,彰化縣,花壇鄉,南口村,194,910,391,122,513,43,556
公投第９案,彰化縣,花壇鄉,南口村,195,982,407,138,545,31,576
公投第９案,彰化縣,花壇鄉,北口村,196,1070,399,153,552,21,573
公投第９案,彰化縣,花壇鄉,北口村,197,700,268,87,355,18,373
公投第９案,彰化縣,花壇鄉,中口村,198,764,339,116,455,45,500
公投第９案,彰化縣,花壇鄉,文德村,199,953,417,129,546,55,601
公投第９案,彰化縣,花壇鄉,文德村,200,974,423,107,530,25,555
公投第９案,彰化縣,花壇鄉,文德村,201,1111,441,138,579,68,647
公投第９案,彰化縣,花壇鄉,白沙村,202,1101,503,104,607,66,673
公投第９案,彰化縣,花壇鄉,白沙村,203,1110,457,110,567,44,611
公投第９案,彰化縣,花壇鄉,白沙村,204,1262,525,153,678,59,737
公投第９案,彰化縣,花壇鄉,白沙村,205,1103,452,164,616,32,648
公投第９案,彰化縣,花壇鄉,岩竹村,206,1347,469,160,629,68,697
公投第９案,彰化縣,花壇鄉,長沙村,207,1169,459,126,585,49,634
公投第９案,彰化縣,花壇鄉,長沙村,208,1274,570,139,709,55,764
公投第９案,彰化縣,花壇鄉,長沙村,209,1280,606,147,753,41,794
公投第９案,彰化縣,花壇鄉,長沙村,210,1244,539,131,670,43,713
公投第９案,彰化縣,花壇鄉,橋頭村,211,1159,476,145,621,59,680
公投第９案,彰化縣,花壇鄉,橋頭村,212,1042,508,113,621,35,656
公投第９案,彰化縣,花壇鄉,橋頭村,213,1111,436,157,593,44,637
公投第９案,彰化縣,花壇鄉,灣雅村,214,893,416,102,518,49,567
公投第９案,彰化縣,花壇鄉,灣東村,215,953,380,120,500,65,565
公投第９案,彰化縣,花壇鄉,三春村,216,987,389,99,488,30,518
公投第９案,彰化縣,花壇鄉,三春村,217,925,411,134,545,53,598
公投第９案,彰化縣,花壇鄉,永春村,218,951,398,93,491,36,527
公投第９案,彰化縣,花壇鄉,永春村,219,955,411,108,519,25,544
公投第９案,彰化縣,花壇鄉,長春村,220,895,345,111,456,31,487
公投第９案,彰化縣,花壇鄉,長春村,221,711,302,88,390,21,411
公投第９案,彰化縣,芬園鄉,舊社村,222,958,374,119,493,42,535
公投第９案,彰化縣,芬園鄉,舊社村,223,794,318,88,406,50,456
公投第９案,彰化縣,芬園鄉,大埔村,224,1415,499,159,658,88,746
公投第９案,彰化縣,芬園鄉,竹林村,225,927,436,102,538,32,570
公投第９案,彰化縣,芬園鄉,竹林村,226,831,353,82,435,39,474
公投第９案,彰化縣,芬園鄉,楓坑村,227,570,224,72,296,27,323
公投第９案,彰化縣,芬園鄉,社口村,228,1227,465,125,590,48,638
公投第９案,彰化縣,芬園鄉,社口村,229,1238,482,129,611,68,679
公投第９案,彰化縣,芬園鄉,茄荖村,230,1362,550,168,718,67,785
公投第９案,彰化縣,芬園鄉,茄荖村,231,989,403,110,513,68,581
公投第９案,彰化縣,芬園鄉,嘉興村,232,1054,485,119,604,62,666
公投第９案,彰化縣,芬園鄉,嘉興村,233,607,293,75,368,29,397
公投第９案,彰化縣,芬園鄉,芬園村,234,882,390,101,491,45,536
公投第９案,彰化縣,芬園鄉,縣庄村,235,1143,415,106,521,41,562
公投第９案,彰化縣,芬園鄉,圳墘村,236,661,224,57,281,20,301
公投第９案,彰化縣,芬園鄉,溪頭村,237,838,296,105,401,3,404
公投第９案,彰化縣,芬園鄉,溪頭村,238,847,306,104,410,33,443
公投第９案,彰化縣,芬園鄉,進芬村,239,987,412,115,527,65,592
公投第９案,彰化縣,芬園鄉,同安村,240,1217,390,159,549,82,631
公投第９案,彰化縣,芬園鄉,中崙村,241,865,279,98,377,69,446
公投第９案,彰化縣,芬園鄉,大竹村,242,996,353,143,496,43,539
公投第９案,彰化縣,鹿港鎮,大有里,243,1140,475,176,651,59,710
公投第９案,彰化縣,鹿港鎮,中興里,244,511,199,75,274,30,304
公投第９案,彰化縣,鹿港鎮,洛津里,245,857,292,84,376,25,401
公投第９案,彰化縣,鹿港鎮,順興里,246,946,420,130,550,61,611
公投第９案,彰化縣,鹿港鎮,埔崙里,247,945,404,124,528,35,563
公投第９案,彰化縣,鹿港鎮,埔崙里,248,1097,458,138,596,48,644
公投第９案,彰化縣,鹿港鎮,埔崙里,249,1479,538,133,671,45,716
公投第９案,彰化縣,鹿港鎮,埔崙里,250,1425,594,168,762,103,865
公投第９案,彰化縣,鹿港鎮,新宮里,251,880,362,128,490,69,559
公投第９案,彰化縣,鹿港鎮,玉順里,252,1183,457,128,585,73,658
公投第９案,彰化縣,鹿港鎮,東石里,253,1047,444,134,578,73,651
公投第９案,彰化縣,鹿港鎮,東石里,254,1097,415,132,547,23,570
公投第９案,彰化縣,鹿港鎮,東石里,255,1030,413,126,539,54,593
公投第９案,彰化縣,鹿港鎮,東石里,256,1161,488,132,620,45,665
公投第９案,彰化縣,鹿港鎮,郭厝里,257,540,228,63,291,51,342
公投第９案,彰化縣,鹿港鎮,永安里,258,1135,457,139,596,49,645
公投第９案,彰化縣,鹿港鎮,永安里,259,1155,470,137,607,58,665
公投第９案,彰化縣,鹿港鎮,永安里,260,1127,526,126,652,44,696
公投第９案,彰化縣,鹿港鎮,永安里,261,1045,440,137,577,42,619
公投第９案,彰化縣,鹿港鎮,景福里,262,1127,456,131,587,78,665
公投第９案,彰化縣,鹿港鎮,泰興里,263,1178,559,143,702,56,758
公投第９案,彰化縣,鹿港鎮,長興里,264,284,115,40,155,14,169
公投第９案,彰化縣,鹿港鎮,興化里,265,584,247,63,310,35,345
公投第９案,彰化縣,鹿港鎮,龍山里,266,659,304,96,400,33,433
公投第９案,彰化縣,鹿港鎮,菜園里,267,915,342,122,464,21,485
公投第９案,彰化縣,鹿港鎮,街尾里,268,1079,463,152,615,66,681
公投第９案,彰化縣,鹿港鎮,街尾里,269,1129,525,138,663,67,730
公投第９案,彰化縣,鹿港鎮,詔安里,270,1273,512,121,633,70,703
公投第９案,彰化縣,鹿港鎮,詔安里,271,706,263,72,335,36,371
公投第９案,彰化縣,鹿港鎮,海埔里,272,1137,413,113,526,104,630
公投第９案,彰化縣,鹿港鎮,海埔里,273,1195,476,133,609,53,662
公投第９案,彰化縣,鹿港鎮,海埔里,274,1225,485,114,599,63,662
公投第９案,彰化縣,鹿港鎮,洋厝里,275,957,441,129,570,60,630
公投第９案,彰化縣,鹿港鎮,洋厝里,276,758,268,65,333,72,405
公投第９案,彰化縣,鹿港鎮,洋厝里,277,723,286,88,374,56,430
公投第９案,彰化縣,鹿港鎮,草中里,278,984,423,83,506,31,537
公投第９案,彰化縣,鹿港鎮,草中里,279,1018,490,99,589,54,643
公投第９案,彰化縣,鹿港鎮,草中里,280,1165,466,123,589,56,645
公投第９案,彰化縣,鹿港鎮,頭南里,281,1161,425,124,549,61,610
公投第９案,彰化縣,鹿港鎮,頭南里,282,1020,499,14,513,44,557
公投第９案,彰化縣,鹿港鎮,山崙里,283,1068,409,141,550,65,615
公投第９案,彰化縣,鹿港鎮,山崙里,284,1024,429,134,563,42,605
公投第９案,彰化縣,鹿港鎮,山崙里,285,974,395,111,506,90,596
公投第９案,彰化縣,鹿港鎮,頂番里,286,1505,574,154,728,79,807
公投第９案,彰化縣,鹿港鎮,頂番里,287,1092,450,109,559,44,603
公投第９案,彰化縣,鹿港鎮,頂番里,288,1223,550,129,679,63,742
公投第９案,彰化縣,鹿港鎮,頭崙里,289,1572,559,132,691,44,735
公投第９案,彰化縣,鹿港鎮,頭崙里,290,1003,452,118,570,49,619
公投第９案,彰化縣,鹿港鎮,溝墘里,291,933,425,98,523,32,555
公投第９案,彰化縣,鹿港鎮,溝墘里,292,1093,485,119,604,59,663
公投第９案,彰化縣,鹿港鎮,溝墘里,293,907,382,96,478,29,507
公投第９案,彰化縣,鹿港鎮,溝墘里,294,1219,484,139,623,48,671
公投第９案,彰化縣,鹿港鎮,廖厝里,295,1397,658,162,820,66,886
公投第９案,彰化縣,鹿港鎮,廖厝里,296,1229,537,131,668,36,704
公投第９案,彰化縣,鹿港鎮,廖厝里,297,1444,625,127,752,31,783
公投第９案,彰化縣,鹿港鎮,東崎里,298,1227,538,136,674,65,739
公投第９案,彰化縣,鹿港鎮,東崎里,299,1187,510,142,652,63,715
公投第９案,彰化縣,鹿港鎮,東崎里,300,1296,529,128,657,28,685
公投第９案,彰化縣,鹿港鎮,東崎里,301,1451,514,168,682,71,753
公投第９案,彰化縣,鹿港鎮,頂厝里,302,1299,503,154,657,72,729
公投第９案,彰化縣,鹿港鎮,頂厝里,303,1298,620,142,762,42,804
公投第９案,彰化縣,鹿港鎮,頂厝里,304,1458,626,166,792,49,841
公投第９案,彰化縣,鹿港鎮,頂厝里,305,1138,470,148,618,44,662
公投第９案,彰化縣,鹿港鎮,頂厝里,306,1170,469,152,621,64,685
公投第９案,彰化縣,鹿港鎮,頂厝里,307,1221,557,126,683,58,741
公投第９案,彰化縣,福興鄉,三汴村,308,1363,487,195,682,58,740
公投第９案,彰化縣,福興鄉,萬豐村,309,821,351,95,446,39,485
公投第９案,彰化縣,福興鄉,元中村,310,1256,486,111,597,60,657
公投第９案,彰化縣,福興鄉,外中村,311,1166,404,137,541,94,635
公投第９案,彰化縣,福興鄉,外埔村,312,1464,500,211,711,52,763
公投第９案,彰化縣,福興鄉,大崙村,313,1251,486,128,614,51,665
公投第９案,彰化縣,福興鄉,番婆村,314,1465,562,154,716,58,774
公投第９案,彰化縣,福興鄉,番婆村,315,960,334,104,438,32,470
公投第９案,彰化縣,福興鄉,橋頭村,316,1323,470,167,637,79,716
公投第９案,彰化縣,福興鄉,橋頭村,317,1365,533,156,689,64,753
公投第９案,彰化縣,福興鄉,社尾村,318,1458,457,139,596,50,646
公投第９案,彰化縣,福興鄉,番社村,319,1492,537,158,695,89,784
公投第９案,彰化縣,福興鄉,西勢村,320,888,299,97,396,29,425
公投第９案,彰化縣,福興鄉,西勢村,321,1054,428,135,563,62,625
公投第９案,彰化縣,福興鄉,同安村,322,1043,388,81,469,52,521
公投第９案,彰化縣,福興鄉,同安村,323,1340,487,172,659,82,741
公投第９案,彰化縣,福興鄉,秀厝村,324,1085,382,131,513,38,551
公投第９案,彰化縣,福興鄉,秀厝村,325,1392,522,136,658,46,704
公投第９案,彰化縣,福興鄉,福興村,326,1316,536,148,684,88,772
公投第９案,彰化縣,福興鄉,福興村,327,1255,523,175,698,56,754
公投第９案,彰化縣,福興鄉,福興村,328,1101,509,120,629,42,671
公投第９案,彰化縣,福興鄉,福南村,329,1167,454,112,566,87,653
公投第９案,彰化縣,福興鄉,福南村,330,1393,486,161,647,86,733
公投第９案,彰化縣,福興鄉,鎮平村,331,1216,498,131,629,64,693
公投第９案,彰化縣,福興鄉,三和村,332,1063,368,106,474,57,531
公投第９案,彰化縣,福興鄉,二港村,333,1306,501,135,636,69,705
公投第９案,彰化縣,福興鄉,福寶村,334,1287,412,121,533,63,596
公投第９案,彰化縣,福興鄉,頂粘村,335,994,401,108,509,49,558
公投第９案,彰化縣,福興鄉,頂粘村,336,1311,527,123,650,91,741
公投第９案,彰化縣,福興鄉,廈粘村,337,926,389,111,500,49,549
公投第９案,彰化縣,福興鄉,廈粘村,338,995,337,118,455,58,513
公投第９案,彰化縣,福興鄉,麥厝村,339,1079,447,138,585,88,673
公投第９案,彰化縣,福興鄉,麥厝村,340,1150,415,106,521,84,605
公投第９案,彰化縣,秀水鄉,秀水村,341,1066,459,126,585,82,667
公投第９案,彰化縣,秀水鄉,秀水村,342,620,271,80,351,46,397
公投第９案,彰化縣,秀水鄉,安溪村,343,876,333,92,425,16,441
公投第９案,彰化縣,秀水鄉,安溪村,344,1196,507,181,688,48,736
公投第９案,彰化縣,秀水鄉,莊雅村,345,1369,577,167,744,47,791
公投第９案,彰化縣,秀水鄉,莊雅村,346,1273,527,173,700,57,757
公投第９案,彰化縣,秀水鄉,陝西村,347,1433,605,146,751,55,806
公投第９案,彰化縣,秀水鄉,金興村,348,967,435,109,544,26,570
公投第９案,彰化縣,秀水鄉,金興村,349,921,409,103,512,23,535
公投第９案,彰化縣,秀水鄉,安東村,350,689,316,78,394,40,434
公投第９案,彰化縣,秀水鄉,安東村,351,688,286,97,383,38,421
公投第９案,彰化縣,秀水鄉,安東村,352,1252,530,190,720,60,780
公投第９案,彰化縣,秀水鄉,安東村,353,1281,500,153,653,38,691
公投第９案,彰化縣,秀水鄉,鶴鳴村,354,754,294,99,393,23,416
公投第９案,彰化縣,秀水鄉,鶴鳴村,355,1024,393,138,531,51,582
公投第９案,彰化縣,秀水鄉,鶴鳴村,356,1433,594,142,736,28,764
公投第９案,彰化縣,秀水鄉,馬興村,357,1366,617,208,825,52,877
公投第９案,彰化縣,秀水鄉,馬興村,358,895,382,115,497,47,544
公投第９案,彰化縣,秀水鄉,義興村,359,1386,543,141,684,68,752
公投第９案,彰化縣,秀水鄉,福安村,360,896,357,122,479,65,544
公投第９案,彰化縣,秀水鄉,福安村,361,804,376,117,493,35,528
公投第９案,彰化縣,秀水鄉,福安村,362,827,409,85,494,24,518
公投第９案,彰化縣,秀水鄉,福安村,363,996,432,120,552,41,593
公投第９案,彰化縣,秀水鄉,福安村,364,931,443,129,572,47,619
公投第９案,彰化縣,秀水鄉,埔崙村,365,715,270,98,368,35,403
公投第９案,彰化縣,秀水鄉,埔崙村,366,1229,532,177,709,58,767
公投第９案,彰化縣,秀水鄉,曾厝村,367,890,338,89,427,30,457
公投第９案,彰化縣,秀水鄉,曾厝村,368,811,348,116,464,45,509
公投第９案,彰化縣,秀水鄉,金陵村,369,786,346,109,455,31,486
公投第９案,彰化縣,秀水鄉,金陵村,370,931,402,106,508,34,542
公投第９案,彰化縣,秀水鄉,下崙村,371,1265,540,151,691,77,768
公投第９案,彰化縣,秀水鄉,下崙村,372,824,342,82,424,40,464
公投第９案,彰化縣,和美鎮,竹營里,373,1341,508,172,680,56,736
公投第９案,彰化縣,和美鎮,竹營里,374,1480,555,158,713,56,769
公投第９案,彰化縣,和美鎮,竹營里,375,1529,626,185,811,44,855
公投第９案,彰化縣,和美鎮,竹營里,376,1711,623,191,814,25,839
公投第９案,彰化縣,和美鎮,和東里,377,1057,446,136,582,32,614
公投第９案,彰化縣,和美鎮,和東里,378,1032,461,122,583,39,622
公投第９案,彰化縣,和美鎮,和東里,379,1015,423,132,555,58,613
公投第９案,彰化縣,和美鎮,和東里,380,1209,533,153,686,46,732
公投第９案,彰化縣,和美鎮,和南里,381,430,181,55,236,15,251
公投第９案,彰化縣,和美鎮,和北里,382,856,343,103,446,19,465
公投第９案,彰化縣,和美鎮,和北里,383,966,463,104,567,27,594
公投第９案,彰化縣,和美鎮,和西里,384,1059,410,134,544,36,580
公投第９案,彰化縣,和美鎮,和西里,385,1117,474,127,601,34,635
公投第９案,彰化縣,和美鎮,和西里,386,1066,411,130,541,50,591
公投第９案,彰化縣,和美鎮,四張里,387,1252,485,140,625,49,674
公投第９案,彰化縣,和美鎮,四張里,388,1528,596,164,760,45,805
公投第９案,彰化縣,和美鎮,頭前里,389,826,356,104,460,35,495
公投第９案,彰化縣,和美鎮,頭前里,390,854,364,88,452,29,481
公投第９案,彰化縣,和美鎮,面前里,391,1387,531,157,688,50,738
公投第９案,彰化縣,和美鎮,面前里,392,765,352,100,452,26,478
公投第９案,彰化縣,和美鎮,鎮平里,393,1438,565,137,702,48,750
公投第９案,彰化縣,和美鎮,鎮平里,394,1396,613,151,764,66,830
公投第９案,彰化縣,和美鎮,大霞里,395,658,276,78,354,25,379
公投第９案,彰化縣,和美鎮,大霞里,396,809,372,114,486,29,515
公投第９案,彰化縣,和美鎮,源埤里,397,932,362,103,465,15,480
公投第９案,彰化縣,和美鎮,源埤里,398,888,359,96,455,32,487
公投第９案,彰化縣,和美鎮,南佃里,399,1144,500,148,648,50,698
公投第９案,彰化縣,和美鎮,南佃里,400,1077,470,100,570,39,609
公投第９案,彰化縣,和美鎮,雅溝里,401,1349,498,155,653,58,711
公投第９案,彰化縣,和美鎮,山犁里,402,1155,500,164,664,57,721
公投第９案,彰化縣,和美鎮,山犁里,403,1253,546,117,663,32,695
公投第９案,彰化縣,和美鎮,山犁里,404,1252,519,123,642,42,684
公投第９案,彰化縣,和美鎮,山犁里,405,1474,662,100,762,32,794
公投第９案,彰化縣,和美鎮,仁愛里,406,1396,531,130,661,35,696
公投第９案,彰化縣,和美鎮,仁愛里,407,1348,493,161,654,53,707
公投第９案,彰化縣,和美鎮,嘉犁里,408,999,459,126,585,35,620
公投第９案,彰化縣,和美鎮,嘉犁里,409,911,385,115,500,46,546
公投第９案,彰化縣,和美鎮,詔安里,410,1005,414,146,560,30,590
公投第９案,彰化縣,和美鎮,詔安里,411,967,410,107,517,44,561
公投第９案,彰化縣,和美鎮,鐵山里,412,1308,553,174,727,37,764
公投第９案,彰化縣,和美鎮,鐵山里,413,1324,564,139,703,38,741
公投第９案,彰化縣,和美鎮,柑井里,414,1102,444,161,605,53,658
公投第９案,彰化縣,和美鎮,柑井里,415,1124,437,131,568,51,619
公投第９案,彰化縣,和美鎮,柑井里,416,1211,506,135,641,63,704
公投第９案,彰化縣,和美鎮,竹園里,417,884,433,122,555,39,594
公投第９案,彰化縣,和美鎮,新庄里,418,1119,439,149,588,64,652
公投第９案,彰化縣,和美鎮,新庄里,419,1300,527,136,663,62,725
公投第９案,彰化縣,和美鎮,犁盛里,420,1104,436,126,562,44,606
公投第９案,彰化縣,和美鎮,犁盛里,421,1213,586,145,731,7,738
公投第９案,彰化縣,和美鎮,中寮里,422,1127,403,135,538,41,579
公投第９案,彰化縣,和美鎮,中圍里,423,919,382,91,473,51,524
公投第９案,彰化縣,和美鎮,中圍里,424,987,472,119,591,1,592
公投第９案,彰化縣,和美鎮,中圍里,425,958,408,136,544,48,592
公投第９案,彰化縣,和美鎮,糖友里,426,1362,592,153,745,44,789
公投第９案,彰化縣,和美鎮,糖友里,427,1461,612,157,769,24,793
公投第９案,彰化縣,和美鎮,糖友里,428,1405,614,153,767,31,798
公投第９案,彰化縣,和美鎮,還社里,429,860,374,102,476,45,521
公投第９案,彰化縣,和美鎮,塗厝里,430,875,367,80,447,25,472
公投第９案,彰化縣,和美鎮,塗厝里,431,871,362,105,467,39,506
公投第９案,彰化縣,和美鎮,地潭里,432,883,389,112,501,49,550
公投第９案,彰化縣,和美鎮,湖內里,433,1224,469,138,607,69,676
公投第９案,彰化縣,和美鎮,嘉寶里,434,1075,446,103,549,49,598
公投第９案,彰化縣,和美鎮,嘉寶里,435,956,389,108,497,44,541
公投第９案,彰化縣,和美鎮,月眉里,436,1037,418,111,529,51,580
公投第９案,彰化縣,和美鎮,月眉里,437,1011,431,101,532,25,557
公投第９案,彰化縣,和美鎮,月眉里,438,1023,390,130,520,54,574
公投第９案,彰化縣,和美鎮,好修里,439,719,274,85,359,31,390
公投第９案,彰化縣,和美鎮,好修里,440,913,358,116,474,42,516
公投第９案,彰化縣,伸港鄉,大同村,441,1182,453,98,551,43,594
公投第９案,彰化縣,伸港鄉,大同村,442,1166,560,123,683,37,720
公投第９案,彰化縣,伸港鄉,海尾村,443,966,400,109,509,51,560
公投第９案,彰化縣,伸港鄉,海尾村,444,873,362,80,442,44,486
公投第９案,彰化縣,伸港鄉,全興村,445,812,365,81,446,46,492
公投第９案,彰化縣,伸港鄉,全興村,446,875,369,90,459,33,492
公投第９案,彰化縣,伸港鄉,溪底村,447,904,350,105,455,49,504
公投第９案,彰化縣,伸港鄉,溪底村,448,1008,421,95,516,44,560
公投第９案,彰化縣,伸港鄉,定興村,449,1154,554,72,626,58,684
公投第９案,彰化縣,伸港鄉,定興村,450,1486,542,165,707,77,784
公投第９案,彰化縣,伸港鄉,什股村,451,1095,436,122,558,50,608
公投第９案,彰化縣,伸港鄉,什股村,452,1087,410,118,528,30,558
公投第９案,彰化縣,伸港鄉,泉州村,453,1085,440,149,589,58,647
公投第９案,彰化縣,伸港鄉,泉州村,454,908,399,109,508,35,543
公投第９案,彰化縣,伸港鄉,泉厝村,455,1264,593,125,718,47,765
公投第９案,彰化縣,伸港鄉,曾家村,456,854,318,99,417,53,470
公投第９案,彰化縣,伸港鄉,曾家村,457,846,312,82,394,32,426
公投第９案,彰化縣,伸港鄉,蚵寮村,458,1143,387,119,506,103,609
公投第９案,彰化縣,伸港鄉,新港村,459,1357,569,146,715,34,749
公投第９案,彰化縣,伸港鄉,新港村,460,1349,511,166,677,71,748
公投第９案,彰化縣,伸港鄉,新港村,461,1154,490,129,619,57,676
公投第９案,彰化縣,伸港鄉,新港村,462,1279,526,131,657,39,696
公投第９案,彰化縣,伸港鄉,埤墘村,463,1317,547,166,713,61,774
公投第９案,彰化縣,伸港鄉,七嘉村,464,990,435,124,559,49,608
公投第９案,彰化縣,伸港鄉,七嘉村,465,852,378,89,467,36,503
公投第９案,彰化縣,伸港鄉,七嘉村,466,1178,501,139,640,35,675
公投第９案,彰化縣,伸港鄉,汴頭村,467,1088,410,132,542,76,618
公投第９案,彰化縣,伸港鄉,汴頭村,468,1135,465,127,592,54,646
公投第９案,彰化縣,線西鄉,線西村,469,1071,466,103,569,35,604
公投第９案,彰化縣,線西鄉,線西村,470,1166,512,135,647,44,691
公投第９案,彰化縣,線西鄉,頂庄村,471,1269,552,132,684,68,752
公投第９案,彰化縣,線西鄉,寓埔村,472,1138,460,141,601,50,651
公投第９案,彰化縣,線西鄉,寓埔村,473,1128,487,158,645,76,721
公投第９案,彰化縣,線西鄉,塭仔村,474,1275,528,149,677,86,763
公投第９案,彰化縣,線西鄉,溝內村,475,1187,502,150,652,55,707
公投第９案,彰化縣,線西鄉,下犁村,476,991,404,141,545,58,603
公投第９案,彰化縣,線西鄉,下犁村,477,938,380,113,493,68,561
公投第９案,彰化縣,線西鄉,頂犁村,478,1276,488,132,620,60,680
公投第９案,彰化縣,線西鄉,頂犁村,479,1285,538,161,699,57,756
公投第９案,彰化縣,線西鄉,德興村,480,1341,640,170,810,65,875
公投第９案,彰化縣,員林市,崙雅里,481,1087,452,83,535,25,560
公投第９案,彰化縣,員林市,崙雅里,482,1353,508,145,653,43,696
公投第９案,彰化縣,員林市,振興里,483,1313,507,138,645,54,699
公投第９案,彰化縣,員林市,振興里,484,1328,453,113,566,30,596
公投第９案,彰化縣,員林市,林厝里,485,1055,425,135,560,35,595
公投第９案,彰化縣,員林市,林厝里,486,959,375,111,486,43,529
公投第９案,彰化縣,員林市,林厝里,487,772,303,106,409,42,451
公投第９案,彰化縣,員林市,出水里,488,831,355,111,466,45,511
公投第９案,彰化縣,員林市,出水里,489,854,279,59,338,11,349
公投第９案,彰化縣,員林市,湖水里,490,1190,381,110,491,38,529
公投第９案,彰化縣,員林市,大峯里,491,726,302,76,378,21,399
公投第９案,彰化縣,員林市,鎮興里,492,1124,429,133,562,65,627
公投第９案,彰化縣,員林市,鎮興里,493,860,278,117,395,57,452
公投第９案,彰化縣,員林市,浮圳里,494,1122,502,132,634,47,681
公投第９案,彰化縣,員林市,浮圳里,495,1075,435,153,588,51,639
公投第９案,彰化縣,員林市,西東里,496,993,370,117,487,63,550
公投第９案,彰化縣,員林市,西東里,497,967,392,85,477,28,505
公投第９案,彰化縣,員林市,南東里,498,1008,396,124,520,57,577
公投第９案,彰化縣,員林市,南東里,499,804,314,95,409,47,456
公投第９案,彰化縣,員林市,中東里,500,867,342,102,444,31,475
公投第９案,彰化縣,員林市,中東里,501,885,350,88,438,30,468
公投第９案,彰化縣,員林市,東北里,502,1097,370,80,450,19,469
公投第９案,彰化縣,員林市,東北里,503,1255,524,104,628,35,663
公投第９案,彰化縣,員林市,東和里,504,1063,446,118,564,50,614
公投第９案,彰化縣,員林市,民生里,505,925,325,160,485,32,517
公投第９案,彰化縣,員林市,民生里,506,947,380,136,516,43,559
公投第９案,彰化縣,員林市,民生里,507,916,384,134,518,28,546
公投第９案,彰化縣,員林市,黎明里,508,862,358,88,446,32,478
公投第９案,彰化縣,員林市,黎明里,509,987,408,126,534,21,555
公投第９案,彰化縣,員林市,惠來里,510,1085,437,109,546,45,591
公投第９案,彰化縣,員林市,惠來里,511,1110,494,116,610,27,637
公投第９案,彰化縣,員林市,惠來里,512,1095,421,116,537,22,559
公投第９案,彰化縣,員林市,惠來里,513,1278,584,163,747,35,782
公投第９案,彰化縣,員林市,惠來里,514,1109,491,129,620,33,653
公投第９案,彰化縣,員林市,中央里,515,1055,411,122,533,70,603
公投第９案,彰化縣,員林市,中央里,516,876,360,110,470,29,499
公投第９案,彰化縣,員林市,溝皂里,517,1115,369,137,506,51,557
公投第９案,彰化縣,員林市,溝皂里,518,1186,521,126,647,42,689
公投第９案,彰化縣,員林市,大饒里,519,995,447,114,561,40,601
公投第９案,彰化縣,員林市,大饒里,520,999,398,103,501,12,513
公投第９案,彰化縣,員林市,大饒里,521,1201,512,113,625,33,658
公投第９案,彰化縣,員林市,大明里,522,1342,548,153,701,39,740
公投第９案,彰化縣,員林市,大明里,523,1086,420,127,547,27,574
公投第９案,彰化縣,員林市,萬年里,524,854,322,99,421,37,458
公投第９案,彰化縣,員林市,萬年里,525,1064,446,112,558,27,585
公投第９案,彰化縣,員林市,萬年里,526,879,393,115,508,10,518
公投第９案,彰化縣,員林市,萬年里,527,827,430,99,529,27,556
公投第９案,彰化縣,員林市,中正里,528,867,346,92,438,16,454
公投第９案,彰化縣,員林市,中正里,529,1201,507,132,639,38,677
公投第９案,彰化縣,員林市,中正里,530,1106,484,118,602,40,642
公投第９案,彰化縣,員林市,仁美里,531,845,338,123,461,43,504
公投第９案,彰化縣,員林市,仁美里,532,894,388,102,490,35,525
公投第９案,彰化縣,員林市,仁美里,533,849,363,100,463,39,502
公投第９案,彰化縣,員林市,新興里,534,747,331,96,427,44,471
公投第９案,彰化縣,員林市,和平里,535,884,401,119,520,32,552
公投第９案,彰化縣,員林市,和平里,536,900,344,105,449,27,476
公投第９案,彰化縣,員林市,和平里,537,1040,397,109,506,37,543
公投第９案,彰化縣,員林市,光明里,538,831,323,110,433,20,453
公投第９案,彰化縣,員林市,中山里,539,591,254,86,340,41,381
公投第９案,彰化縣,員林市,三條里,540,1330,515,153,668,54,722
公投第９案,彰化縣,員林市,三條里,541,1295,575,130,705,29,734
公投第９案,彰化縣,員林市,忠孝里,542,1283,498,159,657,58,715
公投第９案,彰化縣,員林市,忠孝里,543,943,408,124,532,36,568
公投第９案,彰化縣,員林市,仁愛里,544,1388,602,198,800,50,850
公投第９案,彰化縣,員林市,三和里,545,1176,506,138,644,37,681
公投第９案,彰化縣,員林市,三和里,546,867,335,71,406,9,415
公投第９案,彰化縣,員林市,三和里,547,1121,438,130,568,52,620
公投第９案,彰化縣,員林市,三和里,548,1190,476,122,598,33,631
公投第９案,彰化縣,員林市,三和里,549,945,415,111,526,39,565
公投第９案,彰化縣,員林市,三和里,550,906,411,99,510,36,546
公投第９案,彰化縣,員林市,三橋里,551,978,397,132,529,59,588
公投第９案,彰化縣,員林市,三橋里,552,949,404,103,507,48,555
公投第９案,彰化縣,員林市,三橋里,553,949,431,101,532,23,555
公投第９案,彰化縣,員林市,三愛里,554,1006,439,97,536,29,565
公投第９案,彰化縣,員林市,三愛里,555,889,352,127,479,49,528
公投第９案,彰化縣,員林市,三愛里,556,923,429,126,555,20,575
公投第９案,彰化縣,員林市,三信里,557,1209,559,140,699,46,745
公投第９案,彰化縣,員林市,三信里,558,1075,484,126,610,40,650
公投第９案,彰化縣,員林市,三多里,559,1342,637,152,789,35,824
公投第９案,彰化縣,員林市,三多里,560,1039,502,149,651,37,688
公投第９案,彰化縣,員林市,三義里,561,1131,451,94,545,84,629
公投第９案,彰化縣,員林市,三義里,562,1356,507,163,670,31,701
公投第９案,彰化縣,員林市,新生里,563,1370,580,141,721,53,774
公投第９案,彰化縣,員林市,新生里,564,1090,459,127,586,42,628
公投第９案,彰化縣,員林市,新生里,565,821,407,105,512,18,530
公投第９案,彰化縣,員林市,新生里,566,910,395,113,508,33,541
公投第９案,彰化縣,員林市,南平里,567,1203,496,144,640,47,687
公投第９案,彰化縣,員林市,南平里,568,1378,573,144,717,56,773
公投第９案,彰化縣,員林市,南平里,569,1352,577,160,737,31,768
公投第９案,彰化縣,員林市,南平里,570,1060,480,144,624,25,649
公投第９案,彰化縣,員林市,南興里,571,1317,541,134,675,44,719
公投第９案,彰化縣,員林市,南興里,572,1120,437,131,568,41,609
公投第９案,彰化縣,員林市,南興里,573,1025,420,94,514,42,556
公投第９案,彰化縣,員林市,南興里,574,1097,444,139,583,45,628
公投第９案,彰化縣,員林市,源潭里,575,859,363,126,489,40,529
公投第９案,彰化縣,員林市,源潭里,576,837,315,113,428,37,465
公投第９案,彰化縣,員林市,大埔里,577,1090,480,150,630,53,683
公投第９案,彰化縣,員林市,大埔里,578,1073,420,112,532,64,596
公投第９案,彰化縣,大村鄉,大村村,579,1426,639,197,836,65,901
公投第９案,彰化縣,大村鄉,大村村,580,1726,789,210,999,86,1085
公投第９案,彰化縣,大村鄉,茄苳村,581,797,339,104,443,60,503
公投第９案,彰化縣,大村鄉,茄苳村,582,745,306,81,387,29,416
公投第９案,彰化縣,大村鄉,田洋村,583,1125,494,120,614,73,687
公投第９案,彰化縣,大村鄉,貢旗村,584,1486,571,201,772,91,863
公投第９案,彰化縣,大村鄉,南勢村,585,1426,598,154,752,83,835
公投第９案,彰化縣,大村鄉,大橋村,586,824,381,105,486,39,525
公投第９案,彰化縣,大村鄉,大橋村,587,1177,436,124,560,45,605
公投第９案,彰化縣,大村鄉,加錫村,588,1478,647,164,811,70,881
公投第９案,彰化縣,大村鄉,大崙村,589,779,284,100,384,22,406
公投第９案,彰化縣,大村鄉,大崙村,590,812,353,107,460,48,508
公投第９案,彰化縣,大村鄉,新興村,591,1161,472,129,601,40,641
公投第９案,彰化縣,大村鄉,擺塘村,592,1238,505,114,619,36,655
公投第９案,彰化縣,大村鄉,擺塘村,593,1259,505,152,657,69,726
公投第９案,彰化縣,大村鄉,過溝村,594,1412,599,164,763,57,820
公投第９案,彰化縣,大村鄉,過溝村,595,1401,615,143,758,35,793
公投第９案,彰化縣,大村鄉,村上村,596,1395,612,157,769,69,838
公投第９案,彰化縣,大村鄉,美港村,597,996,399,141,540,61,601
公投第９案,彰化縣,大村鄉,美港村,598,1047,455,112,567,44,611
公投第９案,彰化縣,大村鄉,美港村,599,985,416,118,534,48,582
公投第９案,彰化縣,大村鄉,黃厝村,600,1054,481,130,611,46,657
公投第９案,彰化縣,大村鄉,黃厝村,601,1200,498,166,664,46,710
公投第９案,彰化縣,大村鄉,福興村,602,1003,430,113,543,75,618
公投第９案,彰化縣,大村鄉,福興村,603,1046,400,134,534,46,580
公投第９案,彰化縣,大村鄉,平和村,604,1189,516,146,662,48,710
公投第９案,彰化縣,大村鄉,平和村,605,1305,523,128,651,61,712
公投第９案,彰化縣,永靖鄉,浮圳村,606,1255,456,140,596,67,663
公投第９案,彰化縣,永靖鄉,東寧村,607,889,366,115,481,60,541
公投第９案,彰化縣,永靖鄉,東寧村,608,1026,413,121,534,43,577
公投第９案,彰化縣,永靖鄉,光雲村,609,724,319,89,408,42,450
公投第９案,彰化縣,永靖鄉,光雲村,610,924,407,107,514,39,553
公投第９案,彰化縣,永靖鄉,五汴村,611,659,298,83,381,39,420
公投第９案,彰化縣,永靖鄉,五汴村,612,734,299,102,401,31,432
公投第９案,彰化縣,永靖鄉,永興村,613,758,241,93,334,19,353
公投第９案,彰化縣,永靖鄉,永興村,614,848,394,120,514,43,557
公投第９案,彰化縣,永靖鄉,崙子村,615,1404,507,170,677,80,757
公投第９案,彰化縣,永靖鄉,永東村,616,792,406,98,504,42,546
公投第９案,彰化縣,永靖鄉,永西村,617,695,311,94,405,39,444
公投第９案,彰化縣,永靖鄉,永西村,618,821,396,78,474,35,509
公投第９案,彰化縣,永靖鄉,永南村,619,1064,468,116,584,67,651
公投第９案,彰化縣,永靖鄉,永南村,620,840,333,111,444,41,485
公投第９案,彰化縣,永靖鄉,永北村,621,1079,446,168,614,40,654
公投第９案,彰化縣,永靖鄉,永北村,622,1048,474,137,611,43,654
公投第９案,彰化縣,永靖鄉,港西村,623,960,445,119,564,43,607
公投第９案,彰化縣,永靖鄉,港西村,624,798,351,102,453,25,478
公投第９案,彰化縣,永靖鄉,五福村,625,796,374,113,487,39,526
公投第９案,彰化縣,永靖鄉,五福村,626,662,268,65,333,46,379
公投第９案,彰化縣,永靖鄉,湳港村,627,1040,397,155,552,58,610
公投第９案,彰化縣,永靖鄉,新莊村,628,1025,411,129,540,49,589
公投第９案,彰化縣,永靖鄉,瑚璉村,629,1357,644,173,817,60,877
公投第９案,彰化縣,永靖鄉,瑚璉村,630,1236,518,134,652,68,720
公投第９案,彰化縣,永靖鄉,獨鰲村,631,871,357,106,463,53,516
公投第９案,彰化縣,永靖鄉,敦厚村,632,706,261,84,345,40,385
公投第９案,彰化縣,永靖鄉,崙美村,633,770,364,85,449,33,482
公投第９案,彰化縣,永靖鄉,同安村,634,669,322,84,406,34,440
公投第９案,彰化縣,永靖鄉,同仁村,635,862,332,113,445,49,494
公投第９案,彰化縣,永靖鄉,湳墘村,636,847,339,95,434,38,472
公投第９案,彰化縣,永靖鄉,四芳村,637,668,313,68,381,48,429
公投第９案,彰化縣,永靖鄉,福興村,638,1073,391,124,515,31,546
公投第９案,彰化縣,永靖鄉,竹子村,639,1339,452,140,592,65,657
公投第９案,彰化縣,溪湖鎮,光平里,640,1221,474,154,628,49,677
公投第９案,彰化縣,溪湖鎮,平和里,641,638,296,77,373,36,409
公投第９案,彰化縣,溪湖鎮,太平里,642,817,370,69,439,45,484
公投第９案,彰化縣,溪湖鎮,太平里,643,968,458,90,548,38,586
公投第９案,彰化縣,溪湖鎮,光華里,644,448,224,55,279,16,295
公投第９案,彰化縣,溪湖鎮,湖東里,645,1123,430,104,534,26,560
公投第９案,彰化縣,溪湖鎮,湖東里,646,1166,446,160,606,50,656
公投第９案,彰化縣,溪湖鎮,湖東里,647,1151,472,131,603,30,633
公投第９案,彰化縣,溪湖鎮,湖東里,648,1249,548,142,690,34,724
公投第９案,彰化縣,溪湖鎮,中山里,649,1146,493,126,619,54,673
公投第９案,彰化縣,溪湖鎮,中山里,650,1199,515,124,639,65,704
公投第９案,彰化縣,溪湖鎮,西溪里,651,895,369,104,473,50,523
公投第９案,彰化縣,溪湖鎮,西溪里,652,964,439,111,550,19,569
公投第９案,彰化縣,溪湖鎮,中竹里,653,851,360,110,470,30,500
公投第９案,彰化縣,溪湖鎮,東寮里,654,1072,447,118,565,44,609
公投第９案,彰化縣,溪湖鎮,東寮里,655,1113,487,129,616,50,666
公投第９案,彰化縣,溪湖鎮,東寮里,656,1090,485,127,612,42,654
公投第９案,彰化縣,溪湖鎮,西寮里,657,1193,543,175,718,43,761
公投第９案,彰化縣,溪湖鎮,西寮里,658,952,433,101,534,52,586
公投第９案,彰化縣,溪湖鎮,大突里,659,1172,473,135,608,71,679
公投第９案,彰化縣,溪湖鎮,大突里,660,1027,445,111,556,36,592
公投第９案,彰化縣,溪湖鎮,大突里,661,1188,572,117,689,57,746
公投第９案,彰化縣,溪湖鎮,北勢里,662,1403,529,170,699,50,749
公投第９案,彰化縣,溪湖鎮,汴頭里,663,1397,486,149,635,76,711
公投第９案,彰化縣,溪湖鎮,汴頭里,664,1636,681,180,861,49,910
公投第９案,彰化縣,溪湖鎮,大竹里,665,1298,552,146,698,74,772
公投第９案,彰化縣,溪湖鎮,大竹里,666,1214,520,109,629,70,699
公投第９案,彰化縣,溪湖鎮,湖西里,667,1297,590,139,729,47,776
公投第９案,彰化縣,溪湖鎮,湖西里,668,968,441,105,546,59,605
公投第９案,彰化縣,溪湖鎮,田中里,669,839,356,110,466,35,501
公投第９案,彰化縣,溪湖鎮,河東里,670,907,368,133,501,51,552
公投第９案,彰化縣,溪湖鎮,河東里,671,898,329,88,417,21,438
公投第９案,彰化縣,溪湖鎮,頂庄里,672,650,327,84,411,38,449
公投第９案,彰化縣,溪湖鎮,忠覺里,673,1279,532,124,656,81,737
公投第９案,彰化縣,溪湖鎮,湳底里,674,730,323,97,420,56,476
公投第９案,彰化縣,溪湖鎮,大庭里,675,1407,598,145,743,72,815
公投第９案,彰化縣,溪湖鎮,媽厝里,676,1273,423,149,572,62,634
公投第９案,彰化縣,溪湖鎮,番婆里,677,988,403,109,512,29,541
公投第９案,彰化縣,溪湖鎮,番婆里,678,754,326,104,430,51,481
公投第９案,彰化縣,溪湖鎮,西勢里,679,1052,354,114,468,57,525
公投第９案,彰化縣,溪湖鎮,西勢里,680,1149,434,135,569,48,617
公投第９案,彰化縣,溪湖鎮,東溪里,681,1365,587,182,769,93,862
公投第９案,彰化縣,埔鹽鄉,埔鹽村,682,958,465,86,551,41,592
公投第９案,彰化縣,埔鹽鄉,埔鹽村,683,754,356,102,458,34,492
公投第９案,彰化縣,埔鹽鄉,埔南村,684,757,376,95,471,31,502
公投第９案,彰化縣,埔鹽鄉,埔南村,685,806,366,106,472,31,503
公投第９案,彰化縣,埔鹽鄉,廍子村,686,1280,595,101,696,61,757
公投第９案,彰化縣,埔鹽鄉,出水村,687,928,409,96,505,45,550
公投第９案,彰化縣,埔鹽鄉,南港村,688,895,409,190,599,60,659
公投第９案,彰化縣,埔鹽鄉,南港村,689,815,369,99,468,59,527
公投第９案,彰化縣,埔鹽鄉,打廉村,690,957,415,100,515,44,559
公投第９案,彰化縣,埔鹽鄉,豐澤村,691,1338,557,129,686,100,786
公投第９案,彰化縣,埔鹽鄉,崑崙村,692,1106,474,98,572,63,635
公投第９案,彰化縣,埔鹽鄉,角樹村,693,690,359,70,429,42,471
公投第９案,彰化縣,埔鹽鄉,瓦磘村,694,1230,518,142,660,88,748
公投第９案,彰化縣,埔鹽鄉,好修村,695,847,364,88,452,34,486
公投第９案,彰化縣,埔鹽鄉,好修村,696,897,425,103,528,34,562
公投第９案,彰化縣,埔鹽鄉,西湖村,697,882,358,121,479,50,529
公投第９案,彰化縣,埔鹽鄉,西湖村,698,1180,535,135,670,45,715
公投第９案,彰化縣,埔鹽鄉,大有村,699,1215,478,153,631,74,705
公投第９案,彰化縣,埔鹽鄉,新興村,700,422,218,41,259,22,281
公投第９案,彰化縣,埔鹽鄉,永平村,701,1106,490,83,573,47,620
公投第９案,彰化縣,埔鹽鄉,永樂村,702,874,399,106,505,57,562
公投第９案,彰化縣,埔鹽鄉,石埤村,703,1445,565,190,755,105,860
公投第９案,彰化縣,埔鹽鄉,天盛村,704,875,373,107,480,67,547
公投第９案,彰化縣,埔鹽鄉,太平村,705,837,304,86,390,59,449
公投第９案,彰化縣,埔鹽鄉,太平村,706,685,305,70,375,37,412
公投第９案,彰化縣,埔鹽鄉,新水村,707,733,330,83,413,50,463
公投第９案,彰化縣,埔鹽鄉,新水村,708,798,308,106,414,83,497
公投第９案,彰化縣,埔鹽鄉,三省村,709,1381,576,145,721,76,797
公投第９案,彰化縣,埔鹽鄉,南新村,710,1335,506,141,647,61,708
公投第９案,彰化縣,埔心鄉,東門村,711,1139,506,123,629,81,710
公投第９案,彰化縣,埔心鄉,東門村,712,1217,473,166,639,72,711
公投第９案,彰化縣,埔心鄉,東門村,713,1248,539,168,707,55,762
公投第９案,彰化縣,埔心鄉,埔心村,714,1248,527,187,714,87,801
公投第９案,彰化縣,埔心鄉,義民村,715,916,392,123,515,49,564
公投第９案,彰化縣,埔心鄉,義民村,716,625,285,96,381,30,411
公投第９案,彰化縣,埔心鄉,油車村,717,1271,502,152,654,76,730
公投第９案,彰化縣,埔心鄉,瓦北村,718,608,267,79,346,31,377
公投第９案,彰化縣,埔心鄉,瓦北村,719,1132,517,140,657,71,728
公投第９案,彰化縣,埔心鄉,瓦中村,720,1027,449,131,580,61,641
公投第９案,彰化縣,埔心鄉,瓦中村,721,926,405,125,530,57,587
公投第９案,彰化縣,埔心鄉,瓦南村,722,778,315,100,415,67,482
公投第９案,彰化縣,埔心鄉,瓦南村,723,660,304,84,388,32,420
公投第９案,彰化縣,埔心鄉,經口村,724,1330,592,158,750,67,817
公投第９案,彰化縣,埔心鄉,經口村,725,991,417,127,544,35,579
公投第９案,彰化縣,埔心鄉,太平村,726,985,440,108,548,42,590
公投第９案,彰化縣,埔心鄉,太平村,727,1034,496,60,556,39,595
公投第９案,彰化縣,埔心鄉,大華村,728,612,271,77,348,48,396
公投第９案,彰化縣,埔心鄉,仁里村,729,1236,583,149,732,58,790
公投第９案,彰化縣,埔心鄉,舊舘村,730,775,333,109,442,44,486
公投第９案,彰化縣,埔心鄉,舊舘村,731,738,334,107,441,49,490
公投第９案,彰化縣,埔心鄉,南舘村,732,1036,445,151,596,43,639
公投第９案,彰化縣,埔心鄉,新舘村,733,975,375,113,488,70,558
公投第９案,彰化縣,埔心鄉,芎蕉村,734,885,354,120,474,47,521
公投第９案,彰化縣,埔心鄉,芎蕉村,735,939,407,129,536,53,589
公投第９案,彰化縣,埔心鄉,羅厝村,736,689,287,79,366,47,413
公投第９案,彰化縣,埔心鄉,羅厝村,737,659,284,72,356,29,385
公投第９案,彰化縣,埔心鄉,梧鳳村,738,910,349,114,463,32,495
公投第９案,彰化縣,埔心鄉,二重村,739,1352,614,204,818,75,893
公投第９案,彰化縣,埔心鄉,埤霞村,740,759,295,105,400,42,442
公投第９案,彰化縣,埔心鄉,埤脚村,741,942,408,104,512,55,567
公投第９案,彰化縣,田中鎮,香山里,742,854,290,109,399,77,476
公投第９案,彰化縣,田中鎮,碧峰里,743,963,347,96,443,48,491
公投第９案,彰化縣,田中鎮,碧峰里,744,175,27,11,38,7,45
公投第９案,彰化縣,田中鎮,東源里,745,739,274,81,355,39,394
公投第９案,彰化縣,田中鎮,復興里,746,826,313,91,404,36,440
公投第９案,彰化縣,田中鎮,復興里,747,741,303,85,388,59,447
公投第９案,彰化縣,田中鎮,平和里,748,506,163,42,205,5,210
公投第９案,彰化縣,田中鎮,平和里,749,1001,355,119,474,49,523
公投第９案,彰化縣,田中鎮,頂潭里,750,1281,519,139,658,76,734
公投第９案,彰化縣,田中鎮,新庄里,751,1035,415,125,540,54,594
公投第９案,彰化縣,田中鎮,新庄里,752,1327,569,151,720,55,775
公投第９案,彰化縣,田中鎮,中潭里,753,844,377,107,484,35,519
公投第９案,彰化縣,田中鎮,中潭里,754,913,352,117,469,52,521
公投第９案,彰化縣,田中鎮,龍潭里,755,613,285,69,354,49,403
公投第９案,彰化縣,田中鎮,北路里,756,1382,597,157,754,65,819
公投第９案,彰化縣,田中鎮,北路里,757,1034,515,115,630,41,671
公投第９案,彰化縣,田中鎮,北路里,758,935,457,121,578,39,617
公投第９案,彰化縣,田中鎮,西路里,759,1301,523,186,709,51,760
公投第９案,彰化縣,田中鎮,西路里,760,1100,484,136,620,40,660
公投第９案,彰化縣,田中鎮,東路里,761,1071,430,155,585,55,640
公投第９案,彰化縣,田中鎮,南路里,762,1163,507,157,664,61,725
公投第９案,彰化縣,田中鎮,中路里,763,809,383,104,487,46,533
公投第９案,彰化縣,田中鎮,中路里,764,1155,489,148,637,58,695
公投第９案,彰化縣,田中鎮,梅州里,765,1270,482,158,640,82,722
公投第９案,彰化縣,田中鎮,三安里,766,870,332,109,441,47,488
公投第９案,彰化縣,田中鎮,三安里,767,736,293,86,379,43,422
公投第９案,彰化縣,田中鎮,大崙里,768,1335,491,141,632,61,693
公投第９案,彰化縣,田中鎮,沙崙里,769,876,299,146,445,45,490
公投第９案,彰化縣,田中鎮,沙崙里,770,898,297,137,434,60,494
公投第９案,彰化縣,田中鎮,新民里,771,1298,571,162,733,21,754
公投第９案,彰化縣,田中鎮,新民里,772,1451,538,197,735,80,815
公投第９案,彰化縣,田中鎮,新民里,773,1475,512,268,780,54,834
公投第９案,彰化縣,田中鎮,三民里,774,766,275,84,359,44,403
公投第９案,彰化縣,田中鎮,三民里,775,810,380,24,404,31,435
公投第９案,彰化縣,田中鎮,三光里,776,953,354,141,495,72,567
公投第９案,彰化縣,田中鎮,大社里,777,885,363,123,486,71,557
公投第９案,彰化縣,社頭鄉,社頭村,778,791,287,135,422,41,463
公投第９案,彰化縣,社頭鄉,社頭村,779,984,408,108,516,43,559
公投第９案,彰化縣,社頭鄉,社頭村,780,990,385,107,492,21,513
公投第９案,彰化縣,社頭鄉,廣興村,781,1016,465,114,579,50,629
公投第９案,彰化縣,社頭鄉,廣興村,782,1091,576,52,628,31,659
公投第９案,彰化縣,社頭鄉,廣興村,783,1236,493,177,670,73,743
公投第９案,彰化縣,社頭鄉,廣興村,784,1203,494,130,624,25,649
公投第９案,彰化縣,社頭鄉,東興村,785,753,322,72,394,34,428
公投第９案,彰化縣,社頭鄉,東興村,786,725,263,89,352,34,386
公投第９案,彰化縣,社頭鄉,松竹村,787,1023,430,122,552,71,623
公投第９案,彰化縣,社頭鄉,舊社村,788,562,251,93,344,33,377
公投第９案,彰化縣,社頭鄉,舊社村,789,1049,426,117,543,38,581
公投第９案,彰化縣,社頭鄉,廣福村,790,933,407,114,521,38,559
公投第９案,彰化縣,社頭鄉,橋頭村,791,990,409,145,554,51,605
公投第９案,彰化縣,社頭鄉,橋頭村,792,1076,401,123,524,39,563
公投第９案,彰化縣,社頭鄉,新厝村,793,742,322,104,426,21,447
公投第９案,彰化縣,社頭鄉,新厝村,794,672,275,59,334,26,360
公投第９案,彰化縣,社頭鄉,張厝村,795,1235,477,98,575,51,626
公投第９案,彰化縣,社頭鄉,湳底村,796,750,314,105,419,32,451
公投第９案,彰化縣,社頭鄉,湳底村,797,895,352,99,451,35,486
公投第９案,彰化縣,社頭鄉,仁雅村,798,688,291,73,364,18,382
公投第９案,彰化縣,社頭鄉,仁雅村,799,870,357,88,445,30,475
公投第９案,彰化縣,社頭鄉,仁雅村,800,1140,528,127,655,25,680
公投第９案,彰化縣,社頭鄉,里仁村,801,985,409,136,545,38,583
公投第９案,彰化縣,社頭鄉,美雅村,802,1266,599,130,729,58,787
公投第９案,彰化縣,社頭鄉,崙雅村,803,937,403,102,505,47,552
公投第９案,彰化縣,社頭鄉,清水村,804,1219,526,126,652,38,690
公投第９案,彰化縣,社頭鄉,山湖村,805,1165,447,154,601,70,671
公投第９案,彰化縣,社頭鄉,埤斗村,806,986,406,126,532,52,584
公投第９案,彰化縣,社頭鄉,仁和村,807,724,330,96,426,32,458
公投第９案,彰化縣,社頭鄉,平和村,808,1015,455,100,555,36,591
公投第９案,彰化縣,社頭鄉,協和村,809,1116,411,135,546,25,571
公投第９案,彰化縣,社頭鄉,協和村,810,1061,386,136,522,52,574
公投第９案,彰化縣,社頭鄉,泰安村,811,992,417,129,546,55,601
公投第９案,彰化縣,社頭鄉,朝興村,812,1092,415,121,536,34,570
公投第９案,彰化縣,社頭鄉,龍井村,813,828,344,117,461,45,506
公投第９案,彰化縣,社頭鄉,湳雅村,814,787,288,87,375,51,426
公投第９案,彰化縣,社頭鄉,湳雅村,815,719,264,64,328,16,344
公投第９案,彰化縣,二水鄉,復興村,816,1028,374,149,523,84,607
公投第９案,彰化縣,二水鄉,十五村,817,689,289,93,382,51,433
公投第９案,彰化縣,二水鄉,合和村,818,871,313,95,408,64,472
公投第９案,彰化縣,二水鄉,上豊村,819,953,379,112,491,70,561
公投第９案,彰化縣,二水鄉,過圳村,820,624,220,74,294,46,340
公投第９案,彰化縣,二水鄉,五伯村,821,645,276,102,378,49,427
公投第９案,彰化縣,二水鄉,文化村,822,986,494,118,612,40,652
公投第９案,彰化縣,二水鄉,光化村,823,943,410,143,553,66,619
公投第９案,彰化縣,二水鄉,聖化村,824,455,209,52,261,3,264
公投第９案,彰化縣,二水鄉,二水村,825,831,396,117,513,47,560
公投第９案,彰化縣,二水鄉,惠民村,826,831,351,105,456,41,497
公投第９案,彰化縣,二水鄉,裕民村,827,1013,385,139,524,29,553
公投第９案,彰化縣,二水鄉,大園村,828,796,301,140,441,64,505
公投第９案,彰化縣,二水鄉,修仁村,829,781,312,96,408,44,452
公投第９案,彰化縣,二水鄉,合興村,830,692,244,82,326,21,347
公投第９案,彰化縣,二水鄉,源泉村,831,635,265,79,344,28,372
公投第９案,彰化縣,二水鄉,倡和村,832,566,210,80,290,36,326
公投第９案,彰化縣,北斗鎮,中寮里,833,925,353,96,449,68,517
公投第９案,彰化縣,北斗鎮,中寮里,834,869,357,112,469,52,521
公投第９案,彰化縣,北斗鎮,中寮里,835,855,389,125,514,43,557
公投第９案,彰化縣,北斗鎮,大道里,836,1065,500,123,623,51,674
公投第９案,彰化縣,北斗鎮,大道里,837,828,338,101,439,61,500
公投第９案,彰化縣,北斗鎮,西德里,838,1124,511,112,623,48,671
公投第９案,彰化縣,北斗鎮,西德里,839,1096,502,120,622,45,667
公投第９案,彰化縣,北斗鎮,西德里,840,1213,509,148,657,56,713
公投第９案,彰化縣,北斗鎮,西德里,841,1164,436,136,572,74,646
公投第９案,彰化縣,北斗鎮,西安里,842,730,291,92,383,26,409
公投第９案,彰化縣,北斗鎮,西安里,843,878,369,94,463,26,489
公投第９案,彰化縣,北斗鎮,光復里,844,833,370,98,468,41,509
公投第９案,彰化縣,北斗鎮,光復里,845,957,428,109,537,32,569
公投第９案,彰化縣,北斗鎮,新政里,846,783,323,92,415,30,445
公投第９案,彰化縣,北斗鎮,重慶里,847,573,215,70,285,29,314
公投第９案,彰化縣,北斗鎮,五權里,848,672,259,85,344,32,376
公投第９案,彰化縣,北斗鎮,七星里,849,695,253,84,337,41,378
公投第９案,彰化縣,北斗鎮,七星里,850,747,278,77,355,43,398
公投第９案,彰化縣,北斗鎮,居仁里,851,643,303,79,382,27,409
公投第９案,彰化縣,北斗鎮,居仁里,852,662,296,63,359,34,393
公投第９案,彰化縣,北斗鎮,東光里,853,1085,494,139,633,60,693
公投第９案,彰化縣,北斗鎮,東光里,854,1121,463,140,603,65,668
公投第９案,彰化縣,北斗鎮,文昌里,855,830,389,77,466,42,508
公投第９案,彰化縣,北斗鎮,文昌里,856,975,391,111,502,42,544
公投第９案,彰化縣,北斗鎮,文昌里,857,1212,502,125,627,33,660
公投第９案,彰化縣,北斗鎮,中和里,858,1302,552,148,700,79,779
公投第９案,彰化縣,北斗鎮,新生里,859,1077,384,109,493,35,528
公投第９案,彰化縣,北斗鎮,新生里,860,917,356,91,447,59,506
公投第９案,彰化縣,北斗鎮,大新里,861,825,323,104,427,33,460
公投第９案,彰化縣,北斗鎮,大新里,862,937,382,126,508,46,554
公投第９案,彰化縣,田尾鄉,田尾村,863,1284,462,142,604,53,657
公投第９案,彰化縣,田尾鄉,溪畔村,864,1187,512,149,661,62,723
公投第９案,彰化縣,田尾鄉,打簾村,865,1033,433,138,571,43,614
公投第９案,彰化縣,田尾鄉,打簾村,866,696,326,54,380,45,425
公投第９案,彰化縣,田尾鄉,正義村,867,872,412,93,505,30,535
公投第９案,彰化縣,田尾鄉,北曾村,868,680,276,66,342,20,362
公投第９案,彰化縣,田尾鄉,北曾村,869,875,389,125,514,40,554
公投第９案,彰化縣,田尾鄉,南曾村,870,1337,495,155,650,54,704
公投第９案,彰化縣,田尾鄉,饒平村,871,1376,640,149,789,47,836
公投第９案,彰化縣,田尾鄉,饒平村,872,1186,576,118,694,41,735
公投第９案,彰化縣,田尾鄉,豐田村,873,874,455,105,560,45,605
公投第９案,彰化縣,田尾鄉,仁里村,874,647,231,87,318,38,356
公投第９案,彰化縣,田尾鄉,仁里村,875,959,400,115,515,50,565
公投第９案,彰化縣,田尾鄉,新厝村,876,263,98,34,132,11,143
公投第９案,彰化縣,田尾鄉,溪頂村,877,618,237,67,304,31,335
公投第９案,彰化縣,田尾鄉,柳鳳村,878,938,409,143,552,26,578
公投第９案,彰化縣,田尾鄉,陸豐村,879,880,419,97,516,47,563
公投第９案,彰化縣,田尾鄉,海豐村,880,804,293,90,383,41,424
公投第９案,彰化縣,田尾鄉,海豐村,881,592,227,68,295,30,325
公投第９案,彰化縣,田尾鄉,睦宜村,882,1079,451,140,591,91,682
公投第９案,彰化縣,田尾鄉,新生村,883,1336,567,148,715,58,773
公投第９案,彰化縣,田尾鄉,北鎮村,884,1198,464,131,595,56,651
公投第９案,彰化縣,田尾鄉,南鎮村,885,621,227,81,308,46,354
公投第９案,彰化縣,田尾鄉,福田村,886,760,299,82,381,33,414
公投第９案,彰化縣,田尾鄉,新興村,887,1084,469,156,625,76,701
公投第９案,彰化縣,埤頭鄉,和豊村,888,1178,386,122,508,64,572
公投第９案,彰化縣,埤頭鄉,和豊村,889,1290,495,139,634,51,685
公投第９案,彰化縣,埤頭鄉,興農村,890,973,385,84,469,58,527
公投第９案,彰化縣,埤頭鄉,興農村,891,783,289,90,379,37,416
公投第９案,彰化縣,埤頭鄉,埤頭村,892,733,280,84,364,52,416
公投第９案,彰化縣,埤頭鄉,埤頭村,893,899,346,111,457,68,525
公投第９案,彰化縣,埤頭鄉,豊崙村,894,965,375,111,486,58,544
公投第９案,彰化縣,埤頭鄉,豊崙村,895,1356,514,132,646,66,712
公投第９案,彰化縣,埤頭鄉,崙子村,896,1265,487,125,612,75,687
公投第９案,彰化縣,埤頭鄉,永豊村,897,877,387,92,479,66,545
公投第９案,彰化縣,埤頭鄉,永豊村,898,705,268,69,337,45,382
公投第９案,彰化縣,埤頭鄉,合興村,899,1062,470,64,534,103,637
公投第９案,彰化縣,埤頭鄉,合興村,900,1300,541,139,680,59,739
公投第９案,彰化縣,埤頭鄉,合興村,901,923,387,89,476,62,538
公投第９案,彰化縣,埤頭鄉,平原村,902,1085,381,103,484,46,530
公投第９案,彰化縣,埤頭鄉,平原村,903,1103,476,111,587,66,653
公投第９案,彰化縣,埤頭鄉,崙腳村,904,735,314,28,342,35,377
公投第９案,彰化縣,埤頭鄉,元埔村,905,574,196,63,259,57,316
公投第９案,彰化縣,埤頭鄉,芙朝村,906,767,271,64,335,49,384
公投第９案,彰化縣,埤頭鄉,芙朝村,907,737,259,89,348,58,406
公投第９案,彰化縣,埤頭鄉,新庄村,908,1058,306,119,425,66,491
公投第９案,彰化縣,埤頭鄉,陸嘉村,909,826,270,85,355,70,425
公投第９案,彰化縣,埤頭鄉,竹圍村,910,1082,361,96,457,88,545
公投第９案,彰化縣,埤頭鄉,中和村,911,737,319,78,397,49,446
公投第９案,彰化縣,埤頭鄉,中和村,912,711,275,73,348,28,376
公投第９案,彰化縣,埤頭鄉,庄內村,913,1043,394,130,524,69,593
公投第９案,彰化縣,埤頭鄉,大湖村,914,910,315,95,410,31,441
公投第９案,彰化縣,溪州鄉,溪厝村,915,778,308,73,381,49,430
公投第９案,彰化縣,溪州鄉,溪厝村,916,1061,350,110,460,36,496
公投第９案,彰化縣,溪州鄉,坑厝村,917,701,224,66,290,34,324
公投第９案,彰化縣,溪州鄉,瓦厝村,918,879,340,133,473,57,530
公投第９案,彰化縣,溪州鄉,溪州村,919,654,298,93,391,39,430
公投第９案,彰化縣,溪州鄉,溪州村,920,878,347,97,444,45,489
公投第９案,彰化縣,溪州鄉,尾厝村,921,942,420,105,525,50,575
公投第９案,彰化縣,溪州鄉,尾厝村,922,871,333,99,432,37,469
公投第９案,彰化縣,溪州鄉,東州村,923,1047,385,106,491,26,517
公投第９案,彰化縣,溪州鄉,東州村,924,858,326,118,444,57,501
公投第９案,彰化縣,溪州鄉,舊眉村,925,1409,454,116,570,72,642
公投第９案,彰化縣,溪州鄉,圳寮村,926,792,276,73,349,28,377
公投第９案,彰化縣,溪州鄉,圳寮村,927,714,235,92,327,59,386
公投第９案,彰化縣,溪州鄉,西畔村,928,1109,349,123,472,66,538
公投第９案,彰化縣,溪州鄉,西畔村,929,962,270,107,377,50,427
公投第９案,彰化縣,溪州鄉,柑園村,930,1157,371,89,460,63,523
公投第９案,彰化縣,溪州鄉,成功村,931,952,349,99,448,42,490
公投第９案,彰化縣,溪州鄉,成功村,932,887,333,108,441,35,476
公投第９案,彰化縣,溪州鄉,大庄村,933,866,264,72,336,44,380
公投第９案,彰化縣,溪州鄉,大庄村,934,1010,287,129,416,65,481
公投第９案,彰化縣,溪州鄉,榮光村,935,853,295,102,397,25,422
公投第９案,彰化縣,溪州鄉,潮洋村,936,843,298,73,371,63,434
公投第９案,彰化縣,溪州鄉,張厝村,937,711,177,55,232,11,243
公投第９案,彰化縣,溪州鄉,菜公村,938,851,300,101,401,69,470
公投第９案,彰化縣,溪州鄉,三條村,939,883,278,83,361,40,401
公投第９案,彰化縣,溪州鄉,三圳村,940,1247,400,113,513,58,571
公投第９案,彰化縣,溪州鄉,水尾村,941,1490,573,175,748,88,836
公投第９案,彰化縣,二林鎮,豐田里,942,731,208,88,296,22,318
公投第９案,彰化縣,二林鎮,豐田里,943,1025,426,112,538,48,586
公投第９案,彰化縣,二林鎮,豐田里,944,784,320,105,425,27,452
公投第９案,彰化縣,二林鎮,東和里,945,892,361,114,475,41,516
公投第９案,彰化縣,二林鎮,東和里,946,1256,502,156,658,61,719
公投第９案,彰化縣,二林鎮,南光里,947,1043,404,121,525,45,570
公投第９案,彰化縣,二林鎮,南光里,948,1076,488,123,611,38,649
公投第９案,彰化縣,二林鎮,南光里,949,1082,450,126,576,58,634
公投第９案,彰化縣,二林鎮,西平里,950,1427,551,141,692,64,756
公投第９案,彰化縣,二林鎮,北平里,951,1030,347,112,459,69,528
公投第９案,彰化縣,二林鎮,北平里,952,1033,355,117,472,68,540
公投第９案,彰化縣,二林鎮,北平里,953,977,374,117,491,50,541
公投第９案,彰化縣,二林鎮,中西里,954,683,250,70,320,31,351
公投第９案,彰化縣,二林鎮,中西里,955,975,356,89,445,64,509
公投第９案,彰化縣,二林鎮,廣興里,956,1336,423,109,532,64,596
公投第９案,彰化縣,二林鎮,香田里,957,1019,312,107,419,63,482
公投第９案,彰化縣,二林鎮,外竹里,958,1003,284,94,378,50,428
公投第９案,彰化縣,二林鎮,興華里,959,1151,470,108,578,67,645
公投第９案,彰化縣,二林鎮,東興里,960,1598,627,184,811,99,910
公投第９案,彰化縣,二林鎮,後厝里,961,1488,597,150,747,49,796
公投第９案,彰化縣,二林鎮,後厝里,962,1771,741,201,942,64,1006
公投第９案,彰化縣,二林鎮,頂厝里,963,1360,400,127,527,54,581
公投第９案,彰化縣,二林鎮,趙甲里,964,1613,539,141,680,71,751
公投第９案,彰化縣,二林鎮,振興里,965,1228,428,115,543,91,634
公投第９案,彰化縣,二林鎮,萬興里,966,771,336,74,410,29,439
公投第９案,彰化縣,二林鎮,永興里,967,858,351,118,469,34,503
公投第９案,彰化縣,二林鎮,永興里,968,661,228,57,285,1,286
公投第９案,彰化縣,二林鎮,西庄里,969,1268,427,118,545,83,628
公投第９案,彰化縣,二林鎮,梅芳里,970,1081,365,100,465,44,509
公投第９案,彰化縣,二林鎮,華崙里,971,1213,425,121,546,38,584
公投第９案,彰化縣,二林鎮,華崙里,972,1328,520,151,671,72,743
公投第９案,彰化縣,二林鎮,華崙里,973,1118,342,111,453,81,534
公投第９案,彰化縣,二林鎮,萬合里,974,1157,350,126,476,59,535
公投第９案,彰化縣,二林鎮,東勢里,975,972,340,95,435,38,473
公投第９案,彰化縣,二林鎮,大永里,976,902,332,104,436,47,483
公投第９案,彰化縣,二林鎮,原斗里,977,1273,536,172,708,98,806
公投第９案,彰化縣,二林鎮,西斗里,978,1087,393,111,504,43,547
公投第９案,彰化縣,二林鎮,東華里,979,987,378,124,502,76,578
公投第９案,彰化縣,二林鎮,復豐里,980,719,202,65,267,29,296
公投第９案,彰化縣,大城鄉,山腳村,981,1288,299,69,368,30,398
公投第９案,彰化縣,大城鄉,潭墘村,982,1104,261,81,342,83,425
公投第９案,彰化縣,大城鄉,大城村,983,964,367,104,471,66,537
公投第９案,彰化縣,大城鄉,東城村,984,1312,418,128,546,62,608
公投第９案,彰化縣,大城鄉,西城村,985,853,237,68,305,61,366
公投第９案,彰化縣,大城鄉,上山村,986,518,133,22,155,26,181
公投第９案,彰化縣,大城鄉,上山村,987,574,170,53,223,26,249
公投第９案,彰化縣,大城鄉,永和村,988,702,162,65,227,41,268
公投第９案,彰化縣,大城鄉,公館村,989,376,76,25,101,16,117
公投第９案,彰化縣,大城鄉,公館村,990,693,153,41,194,20,214
公投第９案,彰化縣,大城鄉,豐美村,991,877,239,103,342,43,385
公投第９案,彰化縣,大城鄉,三豐村,992,655,116,55,171,13,184
公投第９案,彰化縣,大城鄉,菜寮村,993,1103,295,80,375,29,404
公投第９案,彰化縣,大城鄉,東港村,994,1192,285,88,373,33,406
公投第９案,彰化縣,大城鄉,西港村,995,917,245,80,325,36,361
公投第９案,彰化縣,大城鄉,頂庄村,996,686,159,40,199,26,225
公投第９案,彰化縣,大城鄉,臺西村,997,899,197,57,254,22,276
公投第９案,彰化縣,芳苑鄉,芳苑村,998,940,201,71,272,58,330
公投第９案,彰化縣,芳苑鄉,芳中村,999,403,91,35,126,26,152
公投第９案,彰化縣,芳苑鄉,仁愛村,1000,756,256,80,336,39,375
公投第９案,彰化縣,芳苑鄉,信義村,1001,548,107,40,147,31,178
公投第９案,彰化縣,芳苑鄉,後寮村,1002,997,360,101,461,54,515
公投第９案,彰化縣,芳苑鄉,三合村,1003,1300,389,123,512,67,579
公投第９案,彰化縣,芳苑鄉,三合村,1004,859,292,112,404,38,442
公投第９案,彰化縣,芳苑鄉,永興村,1005,734,253,75,328,18,346
公投第９案,彰化縣,芳苑鄉,永興村,1006,636,227,52,279,25,304
公投第９案,彰化縣,芳苑鄉,新街村,1007,808,222,84,306,69,375
公投第９案,彰化縣,芳苑鄉,路上村,1008,668,197,58,255,40,295
公投第９案,彰化縣,芳苑鄉,路平村,1009,744,261,87,348,28,376
公投第９案,彰化縣,芳苑鄉,三成村,1010,1026,332,81,413,72,485
公投第９案,彰化縣,芳苑鄉,福榮村,1011,586,156,47,203,11,214
公投第９案,彰化縣,芳苑鄉,頂廍村,1012,593,211,72,283,30,313
公投第９案,彰化縣,芳苑鄉,王功村,1013,1071,386,123,509,72,581
公投第９案,彰化縣,芳苑鄉,王功村,1014,1060,336,128,464,91,555
公投第９案,彰化縣,芳苑鄉,博愛村,1015,708,212,73,285,27,312
公投第９案,彰化縣,芳苑鄉,和平村,1016,735,225,63,288,60,348
公投第９案,彰化縣,芳苑鄉,興仁村,1017,571,199,71,270,60,330
公投第９案,彰化縣,芳苑鄉,興仁村,1018,729,218,56,274,33,307
公投第９案,彰化縣,芳苑鄉,民生村,1019,674,211,73,284,65,349
公投第９案,彰化縣,芳苑鄉,新寶村,1020,846,280,107,387,41,428
公投第９案,彰化縣,芳苑鄉,新寶村,1021,806,321,82,403,50,453
公投第９案,彰化縣,芳苑鄉,五俊村,1022,470,122,36,158,13,171
公投第９案,彰化縣,芳苑鄉,草湖村,1023,1124,486,104,590,58,648
公投第９案,彰化縣,芳苑鄉,草湖村,1024,317,106,23,129,23,152
公投第９案,彰化縣,芳苑鄉,建平村,1025,1158,342,99,441,57,498
公投第９案,彰化縣,芳苑鄉,建平村,1026,967,327,76,403,27,430
公投第９案,彰化縣,芳苑鄉,崙腳村,1027,762,297,62,359,41,400
公投第９案,彰化縣,芳苑鄉,文津村,1028,1086,335,92,427,50,477
公投第９案,彰化縣,芳苑鄉,新生村,1029,747,271,72,343,25,368
公投第９案,彰化縣,芳苑鄉,新生村,1030,653,198,37,235,31,266
公投第９案,彰化縣,芳苑鄉,漢寶村,1031,872,361,90,451,61,512
公投第９案,彰化縣,芳苑鄉,漢寶村,1032,1235,532,158,690,55,745
公投第９案,彰化縣,芳苑鄉,漢寶村,1033,1102,401,130,531,61,592
公投第９案,彰化縣,竹塘鄉,竹元村,1034,1168,457,135,592,75,667
公投第９案,彰化縣,竹塘鄉,竹塘村,1035,965,370,134,504,34,538
公投第９案,彰化縣,竹塘鄉,竹塘村,1036,960,402,134,536,61,597
公投第９案,彰化縣,竹塘鄉,小西村,1037,743,321,97,418,66,484
公投第９案,彰化縣,竹塘鄉,民靖村,1038,751,233,67,300,37,337
公投第９案,彰化縣,竹塘鄉,五庄村,1039,792,250,87,337,43,380
公投第９案,彰化縣,竹塘鄉,五庄村,1040,733,231,65,296,17,313
公投第９案,彰化縣,竹塘鄉,樹腳村,1041,657,238,63,301,45,346
公投第９案,彰化縣,竹塘鄉,田頭村,1042,1063,375,114,489,40,529
公投第９案,彰化縣,竹塘鄉,新廣村,1043,1114,420,131,551,80,631
公投第９案,彰化縣,竹塘鄉,溪墘村,1044,506,204,84,288,55,343
公投第９案,彰化縣,竹塘鄉,竹林村,1045,823,289,89,378,43,421
公投第９案,彰化縣,竹塘鄉,土庫村,1046,654,203,91,294,42,336
公投第９案,彰化縣,竹塘鄉,內新村,1047,577,160,51,211,33,244
公投第９案,彰化縣,竹塘鄉,長安村,1048,772,258,88,346,61,407
公投第９案,彰化縣,竹塘鄉,永安村,1049,543,152,57,209,40,249
公投第９案,南投縣,南投市,龍泉里,1,927,406,118,524,26,550
公投第９案,南投縣,南投市,康壽里,2,667,335,88,423,31,454
公投第９案,南投縣,南投市,康壽里,3,773,370,73,443,34,477
公投第９案,南投縣,南投市,三民里,4,818,365,111,476,38,514
公投第９案,南投縣,南投市,仁和里,5,525,244,84,328,28,356
公投第９案,南投縣,南投市,南投里,6,575,283,69,352,29,381
公投第９案,南投縣,南投市,彰仁里,7,368,179,58,237,16,253
公投第９案,南投縣,南投市,崇文里,8,956,438,147,585,47,632
公投第９案,南投縣,南投市,三興里,9,1245,513,120,633,22,655
公投第９案,南投縣,南投市,三興里,10,1484,795,20,815,28,843
公投第９案,南投縣,南投市,三興里,11,1191,596,133,729,49,778
公投第９案,南投縣,南投市,三興里,12,1506,705,154,859,58,917
公投第９案,南投縣,南投市,三和里,13,1070,485,146,631,45,676
公投第９案,南投縣,南投市,三和里,14,670,318,78,396,23,419
公投第９案,南投縣,南投市,三和里,15,1050,499,148,647,46,693
公投第９案,南投縣,南投市,嘉興里,16,1122,427,130,557,52,609
公投第９案,南投縣,南投市,嘉興里,17,984,393,128,521,36,557
公投第９案,南投縣,南投市,嘉和里,18,1062,533,117,650,29,679
公投第９案,南投縣,南投市,嘉和里,19,1053,475,120,595,48,643
公投第９案,南投縣,南投市,嘉和里,20,1104,486,180,666,36,702
公投第９案,南投縣,南投市,嘉和里,21,1192,505,140,645,56,701
公投第９案,南投縣,南投市,平和里,22,960,395,118,513,35,548
公投第９案,南投縣,南投市,平和里,23,906,418,101,519,39,558
公投第９案,南投縣,南投市,平和里,24,957,440,114,554,45,599
公投第９案,南投縣,南投市,平和里,25,997,447,150,597,55,652
公投第９案,南投縣,南投市,平和里,26,1008,450,131,581,46,627
公投第９案,南投縣,南投市,平和里,27,1164,521,136,657,27,684
公投第９案,南投縣,南投市,振興里,28,587,256,67,323,28,351
公投第９案,南投縣,南投市,振興里,29,734,276,95,371,33,404
公投第９案,南投縣,南投市,振興里,30,724,298,79,377,44,421
公投第９案,南投縣,南投市,千秋里,31,1003,461,98,559,37,596
公投第９案,南投縣,南投市,軍功里,32,1356,595,145,740,48,788
公投第９案,南投縣,南投市,軍功里,33,1373,544,141,685,59,744
公投第９案,南投縣,南投市,軍功里,34,1452,595,162,757,48,805
公投第９案,南投縣,南投市,軍功里,35,362,160,22,182,14,196
公投第９案,南投縣,南投市,東山里,36,389,161,48,209,27,236
公投第９案,南投縣,南投市,營南里,37,1276,594,177,771,60,831
公投第９案,南投縣,南投市,營南里,38,1089,507,144,651,51,702
公投第９案,南投縣,南投市,營北里,39,921,426,115,541,52,593
公投第９案,南投縣,南投市,營北里,40,892,488,112,600,19,619
公投第９案,南投縣,南投市,營北里,41,1050,542,102,644,33,677
公投第９案,南投縣,南投市,營北里,42,1078,552,107,659,22,681
公投第９案,南投縣,南投市,營北里,43,1078,537,94,631,36,667
公投第９案,南投縣,南投市,營北里,44,861,496,97,593,28,621
公投第９案,南投縣,南投市,內興里,45,1221,522,148,670,58,728
公投第９案,南投縣,南投市,內興里,46,1105,513,101,614,34,648
公投第９案,南投縣,南投市,內興里,47,1230,579,150,729,27,756
公投第９案,南投縣,南投市,內興里,48,1092,557,98,655,20,675
公投第９案,南投縣,南投市,內興里,49,1286,689,116,805,17,822
公投第９案,南投縣,南投市,內興里,50,655,326,85,411,40,451
公投第９案,南投縣,南投市,內新里,51,719,346,91,437,34,471
公投第９案,南投縣,南投市,內新里,52,720,306,82,388,28,416
公投第９案,南投縣,南投市,光輝里,53,509,261,61,322,20,342
公投第９案,南投縣,南投市,光榮里,54,492,226,31,257,22,279
公投第９案,南投縣,南投市,光榮里,55,616,307,51,358,19,377
公投第９案,南投縣,南投市,光明里,56,1010,526,78,604,31,635
公投第９案,南投縣,南投市,光華里,57,848,420,70,490,21,511
公投第９案,南投縣,南投市,漳興里,58,1387,649,162,811,67,878
公投第９案,南投縣,南投市,漳興里,59,1245,592,148,740,48,788
公投第９案,南投縣,南投市,漳和里,60,1199,536,121,657,33,690
公投第９案,南投縣,南投市,漳和里,61,1288,588,140,728,54,782
公投第９案,南投縣,南投市,漳和里,62,1040,467,109,576,45,621
公投第９案,南投縣,南投市,漳和里,63,1070,494,117,611,53,664
公投第９案,南投縣,南投市,漳和里,64,1299,647,133,780,36,816
公投第９案,南投縣,南投市,漳和里,65,1122,545,151,696,26,722
公投第９案,南投縣,南投市,平山里,66,1414,633,156,789,44,833
公投第９案,南投縣,南投市,平山里,67,1121,492,133,625,41,666
公投第９案,南投縣,南投市,平山里,68,1434,628,153,781,29,810
公投第９案,南投縣,南投市,平山里,69,1393,588,136,724,49,773
公投第９案,南投縣,南投市,新興里,70,1059,454,120,574,17,591
公投第９案,南投縣,南投市,新興里,71,1218,529,139,668,30,698
公投第９案,南投縣,南投市,新興里,72,1293,510,126,636,25,661
公投第９案,南投縣,南投市,新興里,73,1337,529,107,636,32,668
公投第９案,南投縣,南投市,永豐里,74,876,383,131,514,40,554
公投第９案,南投縣,南投市,永豐里,75,971,415,124,539,26,565
公投第９案,南投縣,南投市,永豐里,76,1012,427,127,554,40,594
公投第９案,南投縣,南投市,福興里,77,973,404,83,487,49,536
公投第９案,南投縣,南投市,福興里,78,1002,449,140,589,40,629
公投第９案,南投縣,南投市,福興里,79,1024,459,109,568,41,609
公投第９案,南投縣,南投市,鳳山里,80,1122,377,114,491,103,594
公投第９案,南投縣,南投市,永興里,81,790,251,105,356,41,397
公投第９案,南投縣,南投市,鳳鳴里,82,647,200,46,246,22,268
公投第９案,南投縣,南投市,福山里,83,950,394,96,490,47,537
公投第９案,南投縣,南投市,福山里,84,980,384,97,481,26,507
公投第９案,南投縣,埔里鎮,東門里,85,828,362,94,456,45,501
公投第９案,南投縣,埔里鎮,東門里,86,786,343,102,445,40,485
公投第９案,南投縣,埔里鎮,東門里,87,1062,451,111,562,45,607
公投第９案,南投縣,埔里鎮,杷城里,88,1201,532,145,677,41,718
公投第９案,南投縣,埔里鎮,杷城里,89,1415,589,140,729,32,761
公投第９案,南投縣,埔里鎮,枇杷里,90,1282,556,129,685,30,715
公投第９案,南投縣,埔里鎮,枇杷里,91,859,374,80,454,46,500
公投第９案,南投縣,埔里鎮,枇杷里,92,1288,531,139,670,74,744
公投第９案,南投縣,埔里鎮,枇杷里,93,1330,585,141,726,32,758
公投第９案,南投縣,埔里鎮,枇杷里,94,1416,577,131,708,58,766
公投第９案,南投縣,埔里鎮,枇杷里,95,1283,475,125,600,38,638
公投第９案,南投縣,埔里鎮,水頭里,96,1151,484,36,520,80,600
公投第９案,南投縣,埔里鎮,水頭里,97,1193,468,127,595,39,634
公投第９案,南投縣,埔里鎮,水頭里,98,1471,618,166,784,74,858
公投第９案,南投縣,埔里鎮,麒麟里,99,1044,374,89,463,70,533
公投第９案,南投縣,埔里鎮,珠格里,100,1122,481,125,606,64,670
公投第９案,南投縣,埔里鎮,溪南里,101,1129,550,127,677,48,725
公投第９案,南投縣,埔里鎮,西門里,102,901,367,97,464,21,485
公投第９案,南投縣,埔里鎮,西門里,103,997,396,84,480,58,538
公投第９案,南投縣,埔里鎮,西門里,104,1209,506,127,633,45,678
公投第９案,南投縣,埔里鎮,南門里,105,838,399,102,501,45,546
公投第９案,南投縣,埔里鎮,北門里,106,1226,450,111,561,50,611
公投第９案,南投縣,埔里鎮,北門里,107,1263,586,137,723,63,786
公投第９案,南投縣,埔里鎮,北安里,108,1045,509,100,609,29,638
公投第９案,南投縣,埔里鎮,北安里,109,1120,518,114,632,45,677
公投第９案,南投縣,埔里鎮,北安里,110,1062,517,122,639,52,691
公投第９案,南投縣,埔里鎮,北梅里,111,1022,443,106,549,36,585
公投第９案,南投縣,埔里鎮,北梅里,112,1051,468,102,570,26,596
公投第９案,南投縣,埔里鎮,北梅里,113,1106,475,104,579,38,617
公投第９案,南投縣,埔里鎮,泰安里,114,1098,471,110,581,28,609
公投第９案,南投縣,埔里鎮,泰安里,115,1067,504,98,602,31,633
公投第９案,南投縣,埔里鎮,大湳里,116,725,281,99,380,48,428
公投第９案,南投縣,埔里鎮,大湳里,117,905,416,86,502,30,532
公投第９案,南投縣,埔里鎮,蜈蚣里,118,1179,455,129,584,51,635
公投第９案,南投縣,埔里鎮,蜈蚣里,119,944,367,87,454,37,491
公投第９案,南投縣,埔里鎮,蜈蚣里,120,465,195,45,240,29,269
公投第９案,南投縣,埔里鎮,同聲里,121,1133,458,127,585,45,630
公投第９案,南投縣,埔里鎮,同聲里,122,1100,437,101,538,40,578
公投第９案,南投縣,埔里鎮,清新里,123,1155,512,119,631,56,687
公投第９案,南投縣,埔里鎮,清新里,124,1254,485,130,615,58,673
公投第９案,南投縣,埔里鎮,清新里,125,1296,515,123,638,60,698
公投第９案,南投縣,埔里鎮,薰化里,126,1023,476,142,618,46,664
公投第９案,南投縣,埔里鎮,大城里,127,964,375,68,443,18,461
公投第９案,南投縣,埔里鎮,大城里,128,986,437,98,535,33,568
公投第９案,南投縣,埔里鎮,大城里,129,1016,483,106,589,28,617
公投第９案,南投縣,埔里鎮,大城里,130,898,368,118,486,46,532
公投第９案,南投縣,埔里鎮,大城里,131,980,440,111,551,42,593
公投第９案,南投縣,埔里鎮,大城里,132,933,425,106,531,27,558
公投第９案,南投縣,埔里鎮,籃城里,133,929,445,151,596,54,650
公投第９案,南投縣,埔里鎮,桃米里,134,1032,418,105,523,66,589
公投第９案,南投縣,埔里鎮,成功里,135,315,113,25,138,9,147
公投第９案,南投縣,埔里鎮,南村里,136,1363,503,148,651,62,713
公投第９案,南投縣,埔里鎮,愛蘭里,137,725,313,88,401,38,439
公投第９案,南投縣,埔里鎮,愛蘭里,138,705,287,112,399,29,428
公投第９案,南投縣,埔里鎮,鐵山里,139,751,350,105,455,33,488
公投第９案,南投縣,埔里鎮,鐵山里,140,932,402,88,490,44,534
公投第９案,南投縣,埔里鎮,房里里,141,956,412,118,530,37,567
公投第９案,南投縣,埔里鎮,房里里,142,376,156,39,195,13,208
公投第９案,南投縣,埔里鎮,向善里,143,682,284,85,369,38,407
公投第９案,南投縣,埔里鎮,一新里,144,990,534,56,590,55,645
公投第９案,南投縣,埔里鎮,合成里,145,1324,486,105,591,79,670
公投第９案,南投縣,埔里鎮,合成里,146,298,90,39,129,15,144
公投第９案,南投縣,埔里鎮,廣成里,147,1170,473,102,575,76,651
公投第９案,南投縣,埔里鎮,史港里,148,604,258,74,332,22,354
公投第９案,南投縣,埔里鎮,福興里,149,999,387,121,508,47,555
公投第９案,南投縣,埔里鎮,牛眠里,150,923,344,78,422,25,447
公投第９案,南投縣,埔里鎮,牛眠里,151,887,403,103,506,31,537
公投第９案,南投縣,埔里鎮,牛眠里,152,981,380,97,477,37,514
公投第９案,南投縣,草屯鎮,玉峰里,153,998,482,101,583,24,607
公投第９案,南投縣,草屯鎮,玉峰里,154,1127,491,106,597,26,623
公投第９案,南投縣,草屯鎮,明正里,155,1401,603,101,704,27,731
公投第９案,南投縣,草屯鎮,明正里,156,1110,428,152,580,35,615
公投第９案,南投縣,草屯鎮,明正里,157,1285,568,144,712,49,761
公投第９案,南投縣,草屯鎮,炎峰里,158,936,399,101,500,34,534
公投第９案,南投縣,草屯鎮,炎峰里,159,1141,474,138,612,48,660
公投第９案,南投縣,草屯鎮,中正里,160,705,335,83,418,27,445
公投第９案,南投縣,草屯鎮,和平里,161,1121,484,157,641,26,667
公投第９案,南投縣,草屯鎮,中山里,162,877,426,117,543,38,581
公投第９案,南投縣,草屯鎮,中山里,163,1401,620,141,761,54,815
公投第９案,南投縣,草屯鎮,敦和里,164,1267,514,136,650,48,698
公投第９案,南投縣,草屯鎮,敦和里,165,1214,563,87,650,71,721
公投第９案,南投縣,草屯鎮,敦和里,166,1259,529,152,681,63,744
公投第９案,南投縣,草屯鎮,敦和里,167,1442,666,174,840,29,869
公投第９案,南投縣,草屯鎮,敦和里,168,1273,572,144,716,45,761
公投第９案,南投縣,草屯鎮,山腳里,169,1145,499,118,617,35,652
公投第９案,南投縣,草屯鎮,山腳里,170,1279,557,130,687,33,720
公投第９案,南投縣,草屯鎮,山腳里,171,1158,514,103,617,24,641
公投第９案,南投縣,草屯鎮,山腳里,172,1335,715,113,828,53,881
公投第９案,南投縣,草屯鎮,山腳里,173,1178,592,132,724,35,759
公投第９案,南投縣,草屯鎮,山腳里,174,1327,608,136,744,38,782
公投第９案,南投縣,草屯鎮,新厝里,175,1000,429,139,568,23,591
公投第９案,南投縣,草屯鎮,新厝里,176,1257,574,110,684,30,714
公投第９案,南投縣,草屯鎮,新厝里,177,883,431,101,532,33,565
公投第９案,南投縣,草屯鎮,上林里,178,1121,481,112,593,29,622
公投第９案,南投縣,草屯鎮,上林里,179,1043,494,91,585,36,621
公投第９案,南投縣,草屯鎮,上林里,180,979,489,96,585,21,606
公投第９案,南投縣,草屯鎮,碧峰里,181,1048,387,106,493,30,523
公投第９案,南投縣,草屯鎮,碧峰里,182,1009,427,107,534,39,573
公投第９案,南投縣,草屯鎮,碧峰里,183,1138,495,90,585,22,607
公投第９案,南投縣,草屯鎮,碧峰里,184,1197,466,161,627,38,665
公投第９案,南投縣,草屯鎮,碧洲里,185,1364,620,147,767,40,807
公投第９案,南投縣,草屯鎮,碧洲里,186,1059,450,125,575,44,619
公投第９案,南投縣,草屯鎮,復興里,187,1108,495,113,608,48,656
公投第９案,南投縣,草屯鎮,復興里,188,879,375,96,471,31,502
公投第９案,南投縣,草屯鎮,復興里,189,957,415,100,515,49,564
公投第９案,南投縣,草屯鎮,御史里,190,1395,515,121,636,20,656
公投第９案,南投縣,草屯鎮,御史里,191,1101,512,130,642,40,682
公投第９案,南投縣,草屯鎮,御史里,192,1297,521,142,663,34,697
公投第９案,南投縣,草屯鎮,御史里,193,877,287,80,367,25,392
公投第９案,南投縣,草屯鎮,御史里,194,1376,487,133,620,56,676
公投第９案,南投縣,草屯鎮,新豐里,195,1008,493,115,608,43,651
公投第９案,南投縣,草屯鎮,新豐里,196,1080,506,121,627,40,667
公投第９案,南投縣,草屯鎮,新豐里,197,1017,393,111,504,58,562
公投第９案,南投縣,草屯鎮,新豐里,198,961,433,135,568,44,612
公投第９案,南投縣,草屯鎮,新庄里,199,1160,510,141,651,57,708
公投第９案,南投縣,草屯鎮,新庄里,200,1121,495,107,602,40,642
公投第９案,南投縣,草屯鎮,新庄里,201,1243,518,143,661,39,700
公投第９案,南投縣,草屯鎮,加老里,202,932,404,115,519,25,544
公投第９案,南投縣,草屯鎮,加老里,203,1323,608,192,800,58,858
公投第９案,南投縣,草屯鎮,石川里,204,1518,565,159,724,44,768
公投第９案,南投縣,草屯鎮,北投里,205,923,389,125,514,55,569
公投第９案,南投縣,草屯鎮,北投里,206,970,375,124,499,36,535
公投第９案,南投縣,草屯鎮,北投里,207,1026,421,120,541,27,568
公投第９案,南投縣,草屯鎮,富寮里,208,1466,596,174,770,53,823
公投第９案,南投縣,草屯鎮,富寮里,209,1180,494,136,630,44,674
公投第９案,南投縣,草屯鎮,富寮里,210,1006,473,124,597,18,615
公投第９案,南投縣,草屯鎮,富寮里,211,1000,368,100,468,37,505
公投第９案,南投縣,草屯鎮,富寮里,212,1128,518,135,653,35,688
公投第９案,南投縣,草屯鎮,富寮里,213,623,254,69,323,14,337
公投第９案,南投縣,草屯鎮,北勢里,214,707,265,104,369,52,421
公投第９案,南投縣,草屯鎮,北勢里,215,719,288,67,355,33,388
公投第９案,南投縣,草屯鎮,北勢里,216,527,188,44,232,26,258
公投第９案,南投縣,草屯鎮,中原里,217,1183,514,128,642,51,693
公投第９案,南投縣,草屯鎮,中原里,218,869,387,109,496,36,532
公投第９案,南投縣,草屯鎮,南埔里,219,1132,403,129,532,24,556
公投第９案,南投縣,草屯鎮,南埔里,220,949,399,115,514,50,564
公投第９案,南投縣,草屯鎮,南埔里,221,965,455,99,554,36,590
公投第９案,南投縣,草屯鎮,南埔里,222,1068,421,107,528,36,564
公投第９案,南投縣,草屯鎮,坪頂里,223,1024,453,125,578,49,627
公投第９案,南投縣,草屯鎮,土城里,224,642,261,64,325,27,352
公投第９案,南投縣,草屯鎮,土城里,225,1017,383,111,494,46,540
公投第９案,南投縣,草屯鎮,平林里,226,1092,480,104,584,39,623
公投第９案,南投縣,草屯鎮,雙冬里,227,1170,458,137,595,61,656
公投第９案,南投縣,草屯鎮,雙冬里,228,1106,487,118,605,60,665
公投第９案,南投縣,竹山鎮,竹山里,229,1170,515,132,647,57,704
公投第９案,南投縣,竹山鎮,竹山里,230,850,361,124,485,47,532
公投第９案,南投縣,竹山鎮,中正里,231,621,242,60,302,40,342
公投第９案,南投縣,竹山鎮,中山里,232,905,362,108,470,30,500
公投第９案,南投縣,竹山鎮,中山里,233,1099,401,94,495,61,556
公投第９案,南投縣,竹山鎮,中山里,234,1214,466,113,579,64,643
公投第９案,南投縣,竹山鎮,中山里,235,1287,575,138,713,64,777
公投第９案,南投縣,竹山鎮,雲林里,236,1191,480,128,608,67,675
公投第９案,南投縣,竹山鎮,雲林里,237,1118,445,124,569,68,637
公投第９案,南投縣,竹山鎮,雲林里,238,1278,562,126,688,37,725
公投第９案,南投縣,竹山鎮,竹圍里,239,1153,486,126,612,53,665
公投第９案,南投縣,竹山鎮,竹圍里,240,1243,476,113,589,88,677
公投第９案,南投縣,竹山鎮,桂林里,241,1308,543,135,678,54,732
公投第９案,南投縣,竹山鎮,桂林里,242,1358,519,147,666,52,718
公投第９案,南投縣,竹山鎮,桂林里,243,1044,406,106,512,60,572
公投第９案,南投縣,竹山鎮,下坪里,244,511,241,47,288,33,321
公投第９案,南投縣,竹山鎮,下坪里,245,682,289,57,346,15,361
公投第９案,南投縣,竹山鎮,中和里,246,989,335,126,461,25,486
公投第９案,南投縣,竹山鎮,中崎里,247,1378,553,154,707,43,750
公投第９案,南投縣,竹山鎮,秀林里,248,217,75,30,105,6,111
公投第９案,南投縣,竹山鎮,秀林里,249,479,206,54,260,28,288
公投第９案,南投縣,竹山鎮,大鞍里,250,430,131,46,177,22,199
公投第９案,南投縣,竹山鎮,延和里,251,1437,587,153,740,70,810
公投第９案,南投縣,竹山鎮,延和里,252,1286,559,169,728,43,771
公投第９案,南投縣,竹山鎮,延和里,253,1080,478,118,596,61,657
公投第９案,南投縣,竹山鎮,延和里,254,1070,446,107,553,40,593
公投第９案,南投縣,竹山鎮,延祥里,255,1295,540,143,683,54,737
公投第９案,南投縣,竹山鎮,延祥里,256,1047,443,117,560,32,592
公投第９案,南投縣,竹山鎮,延祥里,257,1300,544,120,664,60,724
公投第９案,南投縣,竹山鎮,延正里,258,908,321,82,403,25,428
公投第９案,南投縣,竹山鎮,延正里,259,821,265,107,372,48,420
公投第９案,南投縣,竹山鎮,延平里,260,1320,562,154,716,49,765
公投第９案,南投縣,竹山鎮,延平里,261,967,378,88,466,28,494
公投第９案,南投縣,竹山鎮,延平里,262,595,219,48,267,24,291
公投第９案,南投縣,竹山鎮,延山里,263,859,301,100,401,71,472
公投第９案,南投縣,竹山鎮,山崇里,264,1196,472,110,582,65,647
公投第９案,南投縣,竹山鎮,山崇里,265,649,265,68,333,36,369
公投第９案,南投縣,竹山鎮,社寮里,266,1341,525,152,677,64,741
公投第９案,南投縣,竹山鎮,中央里,267,1222,415,125,540,73,613
公投第９案,南投縣,竹山鎮,富州里,268,602,252,68,320,27,347
公投第９案,南投縣,竹山鎮,田子里,269,617,251,62,313,33,346
公投第９案,南投縣,竹山鎮,硘磘里,270,793,338,99,437,52,489
公投第９案,南投縣,竹山鎮,硘磘里,271,922,387,86,473,21,494
公投第９案,南投縣,竹山鎮,德興里,272,366,141,30,171,23,194
公投第９案,南投縣,竹山鎮,德興里,273,509,185,29,214,10,224
公投第９案,南投縣,竹山鎮,福興里,274,193,78,19,97,7,104
公投第９案,南投縣,竹山鎮,福興里,275,406,182,47,229,22,251
公投第９案,南投縣,竹山鎮,鯉魚里,276,495,176,50,226,26,252
公投第９案,南投縣,竹山鎮,鯉魚里,277,307,78,20,98,8,106
公投第９案,南投縣,竹山鎮,坪頂里,278,440,171,31,202,32,234
公投第９案,南投縣,竹山鎮,瑞竹里,279,577,220,50,270,43,313
公投第９案,南投縣,竹山鎮,桶頭里,280,486,109,64,173,39,212
公投第９案,南投縣,竹山鎮,桶頭里,281,403,103,24,127,21,148
公投第９案,南投縣,集集鎮,集集里,282,1070,498,104,602,47,649
公投第９案,南投縣,集集鎮,和平里,283,918,421,107,528,33,561
公投第９案,南投縣,集集鎮,林尾里,284,581,247,72,319,29,348
公投第９案,南投縣,集集鎮,田寮里,285,1194,523,138,661,52,713
公投第９案,南投縣,集集鎮,隘寮里,286,488,141,58,199,22,221
公投第９案,南投縣,集集鎮,玉映里,287,504,218,57,275,38,313
公投第９案,南投縣,集集鎮,吳厝里,288,910,353,106,459,104,563
公投第９案,南投縣,集集鎮,八張里,289,773,332,88,420,63,483
公投第９案,南投縣,集集鎮,八張里,290,709,275,89,364,38,402
公投第９案,南投縣,集集鎮,永昌里,291,960,380,125,505,28,533
公投第９案,南投縣,集集鎮,廣明里,292,503,193,61,254,21,275
公投第９案,南投縣,集集鎮,廣明里,293,419,155,28,183,28,211
公投第９案,南投縣,集集鎮,富山里,294,582,187,51,238,23,261
公投第９案,南投縣,名間鄉,南雅村,295,1050,502,158,660,70,730
公投第９案,南投縣,名間鄉,中正村,296,920,396,103,499,55,554
公投第９案,南投縣,名間鄉,中正村,297,727,340,102,442,32,474
公投第９案,南投縣,名間鄉,中正村,298,861,420,93,513,39,552
公投第９案,南投縣,名間鄉,中正村,299,897,377,108,485,35,520
公投第９案,南投縣,名間鄉,中山村,300,1055,472,129,601,47,648
公投第９案,南投縣,名間鄉,中山村,301,1184,502,127,629,70,699
公投第９案,南投縣,名間鄉,濁水村,302,783,302,105,407,39,446
公投第９案,南投縣,名間鄉,濁水村,303,781,349,91,440,46,486
公投第９案,南投縣,名間鄉,新民村,304,977,399,92,491,42,533
公投第９案,南投縣,名間鄉,炭寮村,305,1015,396,102,498,63,561
公投第９案,南投縣,名間鄉,新街村,306,914,416,95,511,37,548
公投第９案,南投縣,名間鄉,新街村,307,1028,446,114,560,18,578
公投第９案,南投縣,名間鄉,新街村,308,1018,471,105,576,37,613
公投第９案,南投縣,名間鄉,新街村,309,1274,520,154,674,75,749
公投第９案,南投縣,名間鄉,東湖村,310,755,309,103,412,40,452
公投第９案,南投縣,名間鄉,東湖村,311,895,422,124,546,46,592
公投第９案,南投縣,名間鄉,仁和村,312,892,419,73,492,31,523
公投第９案,南投縣,名間鄉,萬丹村,313,951,360,135,495,57,552
公投第９案,南投縣,名間鄉,田仔村,314,1261,515,147,662,62,724
公投第９案,南投縣,名間鄉,大坑村,315,768,297,101,398,44,442
公投第９案,南投縣,名間鄉,大庄村,316,962,390,127,517,68,585
公投第９案,南投縣,名間鄉,大庄村,317,867,359,97,456,76,532
公投第９案,南投縣,名間鄉,廍下村,318,930,400,105,505,57,562
公投第９案,南投縣,名間鄉,赤水村,319,641,247,82,329,59,388
公投第９案,南投縣,名間鄉,赤水村,320,530,183,67,250,30,280
公投第９案,南投縣,名間鄉,竹圍村,321,931,385,110,495,60,555
公投第９案,南投縣,名間鄉,三崙村,322,1127,480,128,608,63,671
公投第９案,南投縣,名間鄉,三崙村,323,443,189,60,249,45,294
公投第９案,南投縣,名間鄉,松山村,324,870,379,106,485,47,532
公投第９案,南投縣,名間鄉,松山村,325,621,247,89,336,54,390
公投第９案,南投縣,名間鄉,松柏村,326,1179,413,143,556,45,601
公投第９案,南投縣,名間鄉,崁腳村,327,881,406,89,495,61,556
公投第９案,南投縣,名間鄉,埔中村,328,876,418,113,531,65,596
公投第９案,南投縣,名間鄉,新厝村,329,783,339,78,417,57,474
公投第９案,南投縣,名間鄉,新光村,330,778,298,75,373,46,419
公投第９案,南投縣,名間鄉,新光村,331,983,387,100,487,52,539
公投第９案,南投縣,鹿谷鄉,鹿谷村,332,934,355,87,442,41,483
公投第９案,南投縣,鹿谷鄉,鹿谷村,333,940,382,106,488,49,537
公投第９案,南投縣,鹿谷鄉,彰雅村,334,852,327,98,425,30,455
公投第９案,南投縣,鹿谷鄉,彰雅村,335,451,134,34,168,33,201
公投第９案,南投縣,鹿谷鄉,廣興村,336,810,377,82,459,30,489
公投第９案,南投縣,鹿谷鄉,廣興村,337,1142,526,129,655,57,712
公投第９案,南投縣,鹿谷鄉,永隆村,338,766,279,53,332,29,361
公投第９案,南投縣,鹿谷鄉,永隆村,339,884,370,99,469,48,517
公投第９案,南投縣,鹿谷鄉,鳳凰村,340,811,319,98,417,43,460
公投第９案,南投縣,鹿谷鄉,鳳凰村,341,581,191,55,246,30,276
公投第９案,南投縣,鹿谷鄉,內湖村,342,578,204,63,267,27,294
公投第９案,南投縣,鹿谷鄉,內湖村,343,467,200,52,252,27,279
公投第９案,南投縣,鹿谷鄉,和雅村,344,622,255,60,315,31,346
公投第９案,南投縣,鹿谷鄉,竹林村,345,740,271,82,353,28,381
公投第９案,南投縣,鹿谷鄉,竹林村,346,767,299,90,389,44,433
公投第９案,南投縣,鹿谷鄉,竹豐村,347,909,398,89,487,42,529
公投第９案,南投縣,鹿谷鄉,初鄉村,348,713,278,68,346,29,375
公投第９案,南投縣,鹿谷鄉,初鄉村,349,717,255,56,311,25,336
公投第９案,南投縣,鹿谷鄉,秀峰村,350,794,278,86,364,36,400
公投第９案,南投縣,鹿谷鄉,清水村,351,726,239,73,312,24,336
公投第９案,南投縣,鹿谷鄉,瑞田村,352,737,221,60,281,34,315
公投第９案,南投縣,中寮鄉,廣興村,353,822,347,101,448,59,507
公投第９案,南投縣,中寮鄉,崁頂村,354,253,109,36,145,10,155
公投第９案,南投縣,中寮鄉,崁頂村,355,221,69,19,88,6,94
公投第９案,南投縣,中寮鄉,八仙村,356,353,126,25,151,6,157
公投第９案,南投縣,中寮鄉,八仙村,357,427,167,40,207,30,237
公投第９案,南投縣,中寮鄉,福盛村,358,406,156,49,205,22,227
公投第９案,南投縣,中寮鄉,福盛村,359,307,109,34,143,16,159
公投第９案,南投縣,中寮鄉,和興村,360,661,286,80,366,35,401
公投第９案,南投縣,中寮鄉,復興村,361,290,130,39,169,24,193
公投第９案,南投縣,中寮鄉,永平村,362,973,409,128,537,36,573
公投第９案,南投縣,中寮鄉,永平村,363,754,333,92,425,31,456
公投第９案,南投縣,中寮鄉,中寮村,364,662,263,74,337,31,368
公投第９案,南投縣,中寮鄉,廣福村,365,490,177,40,217,12,229
公投第９案,南投縣,中寮鄉,永福村,366,335,122,33,155,20,175
公投第９案,南投縣,中寮鄉,永福村,367,990,436,97,533,43,576
公投第９案,南投縣,中寮鄉,義和村,368,461,212,56,268,24,292
公投第９案,南投縣,中寮鄉,義和村,369,614,263,86,349,31,380
公投第９案,南投縣,中寮鄉,清水村,370,895,341,101,442,76,518
公投第９案,南投縣,中寮鄉,內城村,371,465,177,52,229,37,266
公投第９案,南投縣,中寮鄉,龍安村,372,682,286,66,352,50,402
公投第９案,南投縣,中寮鄉,爽文村,373,490,210,57,267,36,303
公投第９案,南投縣,中寮鄉,龍岩村,374,643,277,69,346,49,395
公投第９案,南投縣,中寮鄉,永芳村,375,459,218,47,265,19,284
公投第９案,南投縣,中寮鄉,永和村,376,528,183,52,235,32,267
公投第９案,南投縣,魚池鄉,魚池村,377,922,377,109,486,46,532
公投第９案,南投縣,魚池鄉,魚池村,378,1098,471,119,590,56,646
公投第９案,南投縣,魚池鄉,東池村,379,720,275,78,353,33,386
公投第９案,南投縣,魚池鄉,東池村,380,860,379,88,467,40,507
公投第９案,南投縣,魚池鄉,大林村,381,514,162,64,226,36,262
公投第９案,南投縣,魚池鄉,大林村,382,574,218,53,271,11,282
公投第９案,南投縣,魚池鄉,東光村,383,1249,473,139,612,59,671
公投第９案,南投縣,魚池鄉,共和村,384,293,144,31,175,17,192
公投第９案,南投縣,魚池鄉,共和村,385,513,176,73,249,29,278
公投第９案,南投縣,魚池鄉,共和村,386,186,72,24,96,6,102
公投第９案,南投縣,魚池鄉,新城村,387,841,318,83,401,26,427
公投第９案,南投縣,魚池鄉,新城村,388,270,115,39,154,15,169
公投第９案,南投縣,魚池鄉,新城村,389,275,93,42,135,17,152
公投第９案,南投縣,魚池鄉,大雁村,390,282,85,36,121,8,129
公投第９案,南投縣,魚池鄉,大雁村,391,392,139,35,174,12,186
公投第９案,南投縣,魚池鄉,五城村,392,556,213,58,271,32,303
公投第９案,南投縣,魚池鄉,五城村,393,176,72,13,85,11,96
公投第９案,南投縣,魚池鄉,中明村,394,578,202,49,251,21,272
公投第９案,南投縣,魚池鄉,中明村,395,439,155,53,208,16,224
公投第９案,南投縣,魚池鄉,水社村,396,844,387,78,465,27,492
公投第９案,南投縣,魚池鄉,日月村,397,868,338,90,428,39,467
公投第９案,南投縣,魚池鄉,頭社村,398,405,149,29,178,12,190
公投第９案,南投縣,魚池鄉,頭社村,399,537,214,66,280,25,305
公投第９案,南投縣,魚池鄉,武登村,400,335,134,30,164,20,184
公投第９案,南投縣,魚池鄉,武登村,401,231,71,15,86,18,104
公投第９案,南投縣,國姓鄉,國姓村,402,964,440,100,540,60,600
公投第９案,南投縣,國姓鄉,國姓村,403,736,320,72,392,23,415
公投第９案,南投縣,國姓鄉,石門村,404,801,343,80,423,54,477
公投第９案,南投縣,國姓鄉,石門村,405,964,434,85,519,15,534
公投第９案,南投縣,國姓鄉,大旗村,406,686,283,65,348,37,385
公投第９案,南投縣,國姓鄉,長流村,407,661,267,62,329,33,362
公投第９案,南投縣,國姓鄉,長流村,408,730,281,54,335,43,378
公投第９案,南投縣,國姓鄉,長豐村,409,774,276,99,375,59,434
公投第９案,南投縣,國姓鄉,長福村,410,706,313,87,400,23,423
公投第９案,南投縣,國姓鄉,北港村,411,1012,386,129,515,53,568
公投第９案,南投縣,國姓鄉,北港村,412,868,288,82,370,23,393
公投第９案,南投縣,國姓鄉,福龜村,413,918,452,78,530,32,562
公投第９案,南投縣,國姓鄉,福龜村,414,937,391,87,478,57,535
公投第９案,南投縣,國姓鄉,乾溝村,415,815,309,93,402,51,453
公投第９案,南投縣,國姓鄉,柑林村,416,1134,356,280,636,44,680
公投第９案,南投縣,國姓鄉,大石村,417,714,275,69,344,34,378
公投第９案,南投縣,國姓鄉,北山村,418,1095,454,102,556,48,604
公投第９案,南投縣,國姓鄉,北山村,419,448,166,50,216,21,237
公投第９案,南投縣,國姓鄉,南港村,420,1064,421,98,519,51,570
公投第９案,南投縣,國姓鄉,南港村,421,570,222,52,274,23,297
公投第９案,南投縣,水里鄉,水里村,422,757,312,78,390,32,422
公投第９案,南投縣,水里鄉,新城村,423,554,216,62,278,35,313
公投第９案,南投縣,水里鄉,新城村,424,999,381,148,529,50,579
公投第９案,南投縣,水里鄉,中央村,425,616,228,63,291,23,314
公投第９案,南投縣,水里鄉,城中村,426,875,381,92,473,37,510
公投第９案,南投縣,水里鄉,農富村,427,480,221,52,273,9,282
公投第９案,南投縣,水里鄉,車埕村,428,450,173,42,215,30,245
公投第９案,南投縣,水里鄉,新興村,429,643,244,67,311,43,354
公投第９案,南投縣,水里鄉,北埔村,430,1004,426,130,556,30,586
公投第９案,南投縣,水里鄉,南光村,431,741,316,65,381,15,396
公投第９案,南投縣,水里鄉,南光村,432,802,343,109,452,18,470
公投第９案,南投縣,水里鄉,鉅工村,433,998,454,125,579,62,641
公投第９案,南投縣,水里鄉,永豐村,434,800,284,91,375,64,439
公投第９案,南投縣,水里鄉,永豐村,435,589,270,73,343,21,364
公投第９案,南投縣,水里鄉,民和村,436,887,326,88,414,58,472
公投第９案,南投縣,水里鄉,頂崁村,437,1217,472,117,589,44,633
公投第９案,南投縣,水里鄉,新山村,438,205,60,11,71,1,72
公投第９案,南投縣,水里鄉,郡坑村,439,330,148,33,181,28,209
公投第９案,南投縣,水里鄉,上安村,440,1100,418,110,528,33,561
公投第９案,南投縣,水里鄉,興隆村,441,275,70,18,88,3,91
公投第９案,南投縣,水里鄉,永興村,442,318,96,27,123,4,127
公投第９案,南投縣,水里鄉,玉峰村,443,818,304,92,396,53,449
公投第９案,南投縣,信義鄉,明德村,444,1201,448,128,576,105,681
公投第９案,南投縣,信義鄉,明德村,445,329,121,24,145,22,167
公投第９案,南投縣,信義鄉,愛國村,446,516,169,74,243,21,264
公投第９案,南投縣,信義鄉,自強村,447,424,136,31,167,23,190
公投第９案,南投縣,信義鄉,自強村,448,321,117,27,144,7,151
公投第９案,南投縣,信義鄉,豐丘村,449,648,267,81,348,30,378
公投第９案,南投縣,信義鄉,新鄉村,450,584,253,73,326,98,424
公投第９案,南投縣,信義鄉,羅娜村,451,1376,268,71,339,10,349
公投第９案,南投縣,信義鄉,望美村,452,979,307,88,395,26,421
公投第９案,南投縣,信義鄉,望美村,453,530,219,90,309,82,391
公投第９案,南投縣,信義鄉,同富村,454,961,348,84,432,54,486
公投第９案,南投縣,信義鄉,同富村,455,464,204,31,235,20,255
公投第９案,南投縣,信義鄉,神木村,456,517,60,213,273,30,303
公投第９案,南投縣,信義鄉,神木村,457,149,53,22,75,13,88
公投第９案,南投縣,信義鄉,東埔村,458,1020,423,170,593,167,760
公投第９案,南投縣,信義鄉,人和村,459,929,357,106,463,174,637
公投第９案,南投縣,信義鄉,人和村,460,274,75,30,105,18,123
公投第９案,南投縣,信義鄉,地利村,461,900,445,112,557,75,632
公投第９案,南投縣,信義鄉,雙龍村,462,617,297,98,395,56,451
公投第９案,南投縣,信義鄉,潭南村,463,560,235,70,305,40,345
公投第９案,南投縣,仁愛鄉,南豐村,464,973,377,110,487,31,518
公投第９案,南投縣,仁愛鄉,南豐村,465,296,109,33,142,8,150
公投第９案,南投縣,仁愛鄉,大同村,466,900,320,64,384,17,401
公投第９案,南投縣,仁愛鄉,大同村,467,460,223,61,284,14,298
公投第９案,南投縣,仁愛鄉,大同村,468,305,149,27,176,7,183
公投第９案,南投縣,仁愛鄉,榮興村,469,58,14,3,17,3,20
公投第９案,南投縣,仁愛鄉,春陽村,470,952,285,68,353,16,369
公投第９案,南投縣,仁愛鄉,精英村,471,679,185,47,232,5,237
公投第９案,南投縣,仁愛鄉,都達村,472,623,244,71,315,54,369
公投第９案,南投縣,仁愛鄉,合作村,473,597,116,40,156,5,161
公投第９案,南投縣,仁愛鄉,發祥村,474,384,184,39,223,24,247
公投第９案,南投縣,仁愛鄉,發祥村,475,121,45,12,57,5,62
公投第９案,南投縣,仁愛鄉,發祥村,476,264,106,21,127,4,131
公投第９案,南投縣,仁愛鄉,力行村,477,509,273,72,345,36,381
公投第９案,南投縣,仁愛鄉,翠華村,478,338,133,42,175,32,207
公投第９案,南投縣,仁愛鄉,翠華村,479,169,69,15,84,8,92
公投第９案,南投縣,仁愛鄉,親愛村,480,613,213,51,264,29,293
公投第９案,南投縣,仁愛鄉,親愛村,481,404,127,46,173,17,190
公投第９案,南投縣,仁愛鄉,親愛村,482,134,50,22,72,5,77
公投第９案,南投縣,仁愛鄉,萬豐村,483,630,235,91,326,64,390
公投第９案,南投縣,仁愛鄉,法治村,484,763,215,67,282,16,298
公投第９案,南投縣,仁愛鄉,中正村,485,889,448,77,525,39,564
公投第９案,南投縣,仁愛鄉,互助村,486,672,311,81,392,47,439
公投第９案,南投縣,仁愛鄉,互助村,487,447,57,197,254,18,272
公投第９案,南投縣,仁愛鄉,新生村,488,409,239,48,287,15,302
公投第９案,雲林縣,麥寮鄉,麥豐村,1,1497,446,116,562,74,636
公投第９案,雲林縣,麥寮鄉,麥豐村,2,1738,660,152,812,60,872
公投第９案,雲林縣,麥寮鄉,麥豐村,3,1921,702,160,862,95,957
公投第９案,雲林縣,麥寮鄉,麥豐村,4,1832,509,266,775,79,854
公投第９案,雲林縣,麥寮鄉,麥津村,5,1340,426,119,545,59,604
公投第９案,雲林縣,麥寮鄉,麥津村,6,1138,372,108,480,73,553
公投第９案,雲林縣,麥寮鄉,麥津村,7,1551,544,141,685,70,755
公投第９案,雲林縣,麥寮鄉,瓦磘村,8,715,216,55,271,40,311
公投第９案,雲林縣,麥寮鄉,瓦磘村,9,1194,329,111,440,51,491
公投第９案,雲林縣,麥寮鄉,興華村,10,1023,337,101,438,50,488
公投第９案,雲林縣,麥寮鄉,興華村,11,1558,425,126,551,36,587
公投第９案,雲林縣,麥寮鄉,海豐村,12,1187,327,110,437,36,473
公投第９案,雲林縣,麥寮鄉,海豐村,13,983,298,89,387,33,420
公投第９案,雲林縣,麥寮鄉,後安村,14,1363,470,142,612,83,695
公投第９案,雲林縣,麥寮鄉,後安村,15,1596,526,141,667,93,760
公投第９案,雲林縣,麥寮鄉,中興村,16,1469,576,167,743,119,862
公投第９案,雲林縣,麥寮鄉,三盛村,17,964,286,77,363,56,419
公投第９案,雲林縣,麥寮鄉,三盛村,18,1038,307,76,383,46,429
公投第９案,雲林縣,麥寮鄉,崙後村,19,1230,458,81,539,81,620
公投第９案,雲林縣,麥寮鄉,崙後村,20,1329,460,123,583,57,640
公投第９案,雲林縣,麥寮鄉,橋頭村,21,1129,398,120,518,89,607
公投第９案,雲林縣,麥寮鄉,橋頭村,22,1241,466,125,591,102,693
公投第９案,雲林縣,麥寮鄉,橋頭村,23,1471,571,133,704,101,805
公投第９案,雲林縣,麥寮鄉,新吉村,24,1107,418,143,561,71,632
公投第９案,雲林縣,麥寮鄉,施厝村,25,1636,634,175,809,85,894
公投第９案,雲林縣,麥寮鄉,施厝村,26,1755,601,167,768,59,827
公投第９案,雲林縣,麥寮鄉,雷厝村,27,1158,462,101,563,40,603
公投第９案,雲林縣,麥寮鄉,雷厝村,28,956,388,87,475,38,513
公投第９案,雲林縣,臺西鄉,臺西村,29,1238,494,106,600,77,677
公投第９案,雲林縣,臺西鄉,海南村,30,1091,365,108,473,49,522
公投第９案,雲林縣,臺西鄉,海北村,31,1098,401,100,501,72,573
公投第９案,雲林縣,臺西鄉,海口村,32,1048,300,93,393,44,437
公投第９案,雲林縣,臺西鄉,海口村,33,1025,334,80,414,77,491
公投第９案,雲林縣,臺西鄉,山寮村,34,850,297,78,375,55,430
公投第９案,雲林縣,臺西鄉,溪頂村,35,1460,401,138,539,102,641
公投第９案,雲林縣,臺西鄉,牛厝村,36,1180,257,97,354,86,440
公投第９案,雲林縣,臺西鄉,牛厝村,37,710,161,38,199,36,235
公投第９案,雲林縣,臺西鄉,泉州村,38,620,153,49,202,11,213
公投第９案,雲林縣,臺西鄉,五榔村,39,449,130,50,180,33,213
公投第９案,雲林縣,臺西鄉,光華村,40,687,170,55,225,52,277
公投第９案,雲林縣,臺西鄉,五港村,41,1247,366,116,482,77,559
公投第９案,雲林縣,臺西鄉,五港村,42,583,153,31,184,22,206
公投第９案,雲林縣,臺西鄉,富琦村,43,1042,337,110,447,70,517
公投第９案,雲林縣,臺西鄉,富琦村,44,472,150,38,188,31,219
公投第９案,雲林縣,臺西鄉,永豐村,45,1409,420,88,508,35,543
公投第９案,雲林縣,臺西鄉,和豐村,46,1061,355,109,464,94,558
公投第９案,雲林縣,臺西鄉,和豐村,47,993,276,82,358,40,398
公投第９案,雲林縣,臺西鄉,和豐村,48,1013,299,111,410,82,492
公投第９案,雲林縣,臺西鄉,蚊港村,49,1233,433,101,534,52,586
公投第９案,雲林縣,臺西鄉,蚊港村,50,616,179,55,234,30,264
公投第９案,雲林縣,東勢鄉,月眉村,51,1207,365,112,477,59,536
公投第９案,雲林縣,東勢鄉,復興村,52,540,223,67,290,36,326
公投第９案,雲林縣,東勢鄉,嘉隆村,53,896,249,89,338,35,373
公投第９案,雲林縣,東勢鄉,嘉隆村,54,728,253,81,334,59,393
公投第９案,雲林縣,東勢鄉,東南村,55,1533,622,156,778,91,869
公投第９案,雲林縣,東勢鄉,東北村,56,1203,465,148,613,101,714
公投第９案,雲林縣,東勢鄉,龍潭村,57,817,240,81,321,69,390
公投第９案,雲林縣,東勢鄉,程海村,58,546,230,61,291,34,325
公投第９案,雲林縣,東勢鄉,昌南村,59,853,259,102,361,77,438
公投第９案,雲林縣,東勢鄉,安南村,60,856,208,83,291,69,360
公投第９案,雲林縣,東勢鄉,同安村,61,923,289,92,381,64,445
公投第９案,雲林縣,東勢鄉,同安村,62,1022,325,108,433,48,481
公投第９案,雲林縣,東勢鄉,四美村,63,634,164,44,208,33,241
公投第９案,雲林縣,東勢鄉,四美村,64,394,113,25,138,23,161
公投第９案,雲林縣,東勢鄉,新坤村,65,1087,279,81,360,45,405
公投第９案,雲林縣,褒忠鄉,中民村,66,923,353,86,439,71,510
公投第９案,雲林縣,褒忠鄉,中民村,67,993,426,120,546,38,584
公投第９案,雲林縣,褒忠鄉,埔姜村,68,748,287,70,357,34,391
公投第９案,雲林縣,褒忠鄉,埔姜村,69,702,262,66,328,15,343
公投第９案,雲林縣,褒忠鄉,中勝村,70,752,274,58,332,22,354
公投第９案,雲林縣,褒忠鄉,中勝村,71,756,295,82,377,29,406
公投第９案,雲林縣,褒忠鄉,馬鳴村,72,490,172,58,230,20,250
公投第９案,雲林縣,褒忠鄉,馬鳴村,73,1034,299,95,394,33,427
公投第９案,雲林縣,褒忠鄉,新湖村,74,470,162,50,212,19,231
公投第９案,雲林縣,褒忠鄉,新湖村,75,737,146,195,341,30,371
公投第９案,雲林縣,褒忠鄉,有才村,76,878,305,91,396,41,437
公投第９案,雲林縣,褒忠鄉,田洋村,77,778,257,73,330,60,390
公投第９案,雲林縣,褒忠鄉,龍岩村,78,1224,374,149,523,63,586
公投第９案,雲林縣,褒忠鄉,潮厝村,79,896,236,105,341,75,416
公投第９案,雲林縣,土庫鎮,忠正里,80,809,352,100,452,60,512
公投第９案,雲林縣,土庫鎮,順天里,81,896,345,131,476,59,535
公投第９案,雲林縣,土庫鎮,宮北里,82,687,266,84,350,48,398
公投第９案,雲林縣,土庫鎮,宮北里,83,702,354,81,435,35,470
公投第９案,雲林縣,土庫鎮,越港里,84,1032,471,128,599,37,636
公投第９案,雲林縣,土庫鎮,溪邊里,85,697,235,74,309,61,370
公投第９案,雲林縣,土庫鎮,溪邊里,86,427,140,47,187,39,226
公投第９案,雲林縣,土庫鎮,石廟里,87,1451,595,161,756,71,827
公投第９案,雲林縣,土庫鎮,石廟里,88,1283,528,157,685,31,716
公投第９案,雲林縣,土庫鎮,興新里,89,634,202,64,266,12,278
公投第９案,雲林縣,土庫鎮,興新里,90,796,290,87,377,44,421
公投第９案,雲林縣,土庫鎮,奮起里,91,745,198,85,283,47,330
公投第９案,雲林縣,土庫鎮,奮起里,92,576,190,75,265,23,288
公投第９案,雲林縣,土庫鎮,埤腳里,93,743,225,69,294,60,354
公投第９案,雲林縣,土庫鎮,埤腳里,94,534,153,63,216,16,232
公投第９案,雲林縣,土庫鎮,後埔里,95,1199,349,115,464,82,546
公投第９案,雲林縣,土庫鎮,後埔里,96,1077,331,119,450,90,540
公投第９案,雲林縣,土庫鎮,崙內里,97,819,231,69,300,33,333
公投第９案,雲林縣,土庫鎮,崙內里,98,684,235,84,319,48,367
公投第９案,雲林縣,土庫鎮,大荖里,99,843,306,86,392,64,456
公投第９案,雲林縣,土庫鎮,東平里,100,916,307,93,400,87,487
公投第９案,雲林縣,土庫鎮,東平里,101,948,316,97,413,52,465
公投第９案,雲林縣,土庫鎮,南平里,102,914,328,103,431,35,466
公投第９案,雲林縣,土庫鎮,南平里,103,860,309,87,396,69,465
公投第９案,雲林縣,土庫鎮,西平里,104,929,305,106,411,60,471
公投第９案,雲林縣,土庫鎮,西平里,105,875,254,92,346,71,417
公投第９案,雲林縣,土庫鎮,北平里,106,896,255,64,319,44,363
公投第９案,雲林縣,土庫鎮,新庄里,107,757,210,78,288,53,341
公投第９案,雲林縣,土庫鎮,新庄里,108,683,214,73,287,40,327
公投第９案,雲林縣,虎尾鎮,東仁里,109,1347,559,132,691,53,744
公投第９案,雲林縣,虎尾鎮,東仁里,110,1258,535,160,695,44,739
公投第９案,雲林縣,虎尾鎮,新興里,111,785,288,101,389,38,427
公投第９案,雲林縣,虎尾鎮,新興里,112,890,301,86,387,51,438
公投第９案,雲林縣,虎尾鎮,公安里,113,1413,610,136,746,52,798
公投第９案,雲林縣,虎尾鎮,公安里,114,1431,634,170,804,62,866
公投第９案,雲林縣,虎尾鎮,德興里,115,1224,462,124,586,71,657
公投第９案,雲林縣,虎尾鎮,德興里,116,1325,486,117,603,49,652
公投第９案,雲林縣,虎尾鎮,中山里,117,941,386,112,498,70,568
公投第９案,雲林縣,虎尾鎮,西安里,118,1613,669,160,829,26,855
公投第９案,雲林縣,虎尾鎮,西安里,119,1641,613,164,777,42,819
公投第９案,雲林縣,虎尾鎮,立仁里,120,1200,543,130,673,49,722
公投第９案,雲林縣,虎尾鎮,立仁里,121,1294,517,164,681,75,756
公投第９案,雲林縣,虎尾鎮,立仁里,122,1273,548,133,681,36,717
公投第９案,雲林縣,虎尾鎮,安慶里,123,1438,641,173,814,45,859
公投第９案,雲林縣,虎尾鎮,平和里,124,1361,622,137,759,33,792
公投第９案,雲林縣,虎尾鎮,平和里,125,1444,658,168,826,42,868
公投第９案,雲林縣,虎尾鎮,平和里,126,1490,735,159,894,36,930
公投第９案,雲林縣,虎尾鎮,興南里,127,1307,621,154,775,52,827
公投第９案,雲林縣,虎尾鎮,興南里,128,967,340,111,451,34,485
公投第９案,雲林縣,虎尾鎮,新吉里,129,1865,752,163,915,41,956
公投第９案,雲林縣,虎尾鎮,新吉里,130,1880,772,209,981,38,1019
公投第９案,雲林縣,虎尾鎮,穎川里,131,1099,385,136,521,43,564
公投第９案,雲林縣,虎尾鎮,穎川里,132,901,353,108,461,28,489
公投第９案,雲林縣,虎尾鎮,延平里,133,1120,440,113,553,19,572
公投第９案,雲林縣,虎尾鎮,建國里,134,545,171,53,224,16,240
公投第９案,雲林縣,虎尾鎮,埒內里,135,1420,542,144,686,62,748
公投第９案,雲林縣,虎尾鎮,埒內里,136,1248,483,119,602,0,602
公投第９案,雲林縣,虎尾鎮,堀頭里,137,799,299,86,385,31,416
公投第９案,雲林縣,虎尾鎮,安溪里,138,836,284,101,385,61,446
公投第９案,雲林縣,虎尾鎮,安溪里,139,924,295,103,398,53,451
公投第９案,雲林縣,虎尾鎮,興中里,140,1648,510,142,652,33,685
公投第９案,雲林縣,虎尾鎮,廉使里,141,1616,486,175,661,110,771
公投第９案,雲林縣,虎尾鎮,廉使里,142,1546,519,175,694,55,749
公投第９案,雲林縣,虎尾鎮,惠來里,143,1283,448,137,585,39,624
公投第９案,雲林縣,虎尾鎮,惠來里,144,1078,379,103,482,37,519
公投第９案,雲林縣,虎尾鎮,頂溪里,145,1313,414,140,554,48,602
公投第９案,雲林縣,虎尾鎮,頂溪里,146,1284,406,154,560,36,596
公投第９案,雲林縣,虎尾鎮,中溪里,147,1356,506,123,629,99,728
公投第９案,雲林縣,虎尾鎮,下溪里,148,1504,536,176,712,92,804
公投第９案,雲林縣,虎尾鎮,東屯里,149,1224,393,99,492,40,532
公投第９案,雲林縣,虎尾鎮,西屯里,150,1509,515,129,644,65,709
公投第９案,雲林縣,虎尾鎮,芳草里,151,855,220,82,302,60,362
公投第９案,雲林縣,虎尾鎮,墾地里,152,1549,468,155,623,95,718
公投第９案,雲林縣,虎尾鎮,北溪里,153,851,272,88,360,31,391
公投第９案,雲林縣,虎尾鎮,三合里,154,1272,438,119,557,78,635
公投第９案,雲林縣,四湖鄉,四湖村,155,1082,321,94,415,64,479
公投第９案,雲林縣,四湖鄉,四湖村,156,676,237,78,315,49,364
公投第９案,雲林縣,四湖鄉,湖西村,157,862,304,78,382,21,403
公投第９案,雲林縣,四湖鄉,湖西村,158,477,105,30,135,26,161
公投第９案,雲林縣,四湖鄉,湖西村,159,952,365,98,463,39,502
公投第９案,雲林縣,四湖鄉,新庄村,160,650,169,49,218,18,236
公投第９案,雲林縣,四湖鄉,溪底村,161,969,282,93,375,28,403
公投第９案,雲林縣,四湖鄉,鹿場村,162,925,223,96,319,52,371
公投第９案,雲林縣,四湖鄉,蔡厝村,163,914,264,76,340,39,379
公投第９案,雲林縣,四湖鄉,湖寮村,164,759,142,46,188,54,242
公投第９案,雲林縣,四湖鄉,施湖村,165,1219,302,90,392,54,446
公投第９案,雲林縣,四湖鄉,羊調村,166,937,197,70,267,52,319
公投第９案,雲林縣,四湖鄉,內湖村,167,773,153,47,200,17,217
公投第９案,雲林縣,四湖鄉,飛東村,168,555,128,45,173,52,225
公投第９案,雲林縣,四湖鄉,飛沙村,169,876,189,69,258,38,296
公投第９案,雲林縣,四湖鄉,三姓村,170,360,93,21,114,25,139
公投第９案,雲林縣,四湖鄉,崙北村,171,885,164,54,218,45,263
公投第９案,雲林縣,四湖鄉,崙北村,172,833,186,55,241,45,286
公投第９案,雲林縣,四湖鄉,崙南村,173,785,206,72,278,44,322
公投第９案,雲林縣,四湖鄉,廣溝村,174,705,226,61,287,49,336
公投第９案,雲林縣,四湖鄉,箔子村,175,927,203,50,253,28,281
公投第９案,雲林縣,四湖鄉,箔東村,176,1058,224,78,302,74,376
公投第９案,雲林縣,四湖鄉,林厝村,177,1071,244,102,346,59,405
公投第９案,雲林縣,四湖鄉,林東村,178,1022,200,48,248,20,268
公投第９案,雲林縣,四湖鄉,溪尾村,179,711,181,58,239,38,277
公投第９案,雲林縣,元長鄉,長南村,180,915,299,105,404,40,444
公投第９案,雲林縣,元長鄉,長南村,181,1284,401,131,532,35,567
公投第９案,雲林縣,元長鄉,長南村,182,1150,359,108,467,44,511
公投第９案,雲林縣,元長鄉,長北村,183,744,202,66,268,54,322
公投第９案,雲林縣,元長鄉,長北村,184,790,254,76,330,59,389
公投第９案,雲林縣,元長鄉,子茂村,185,1356,350,130,480,76,556
公投第９案,雲林縣,元長鄉,後湖村,186,739,195,94,289,66,355
公投第９案,雲林縣,元長鄉,山內村,187,965,254,79,333,41,374
公投第９案,雲林縣,元長鄉,合和村,188,1080,295,94,389,75,464
公投第９案,雲林縣,元長鄉,五塊村,189,948,254,72,326,51,377
公投第９案,雲林縣,元長鄉,潭西村,190,762,143,69,212,32,244
公投第９案,雲林縣,元長鄉,潭東村,191,582,179,62,241,23,264
公投第９案,雲林縣,元長鄉,客厝村,192,865,238,52,290,17,307
公投第９案,雲林縣,元長鄉,卓運村,193,362,55,16,71,6,77
公投第９案,雲林縣,元長鄉,頂寮村,194,1162,297,88,385,43,428
公投第９案,雲林縣,元長鄉,下寮村,195,1527,435,129,564,57,621
公投第９案,雲林縣,元長鄉,龍岩村,196,1006,290,117,407,80,487
公投第９案,雲林縣,元長鄉,西莊村,197,855,247,68,315,30,345
公投第９案,雲林縣,元長鄉,鹿北村,198,1181,352,116,468,89,557
公投第９案,雲林縣,元長鄉,鹿南村,199,864,221,84,305,49,354
公投第９案,雲林縣,元長鄉,瓦磘村,200,667,157,66,223,41,264
公投第９案,雲林縣,元長鄉,瓦磘村,201,878,233,74,307,33,340
公投第９案,雲林縣,元長鄉,內寮村,202,610,39,120,159,12,171
公投第９案,雲林縣,元長鄉,崙仔村,203,837,227,101,328,71,399
公投第９案,雲林縣,元長鄉,新吉村,204,701,233,76,309,44,353
公投第９案,雲林縣,口湖鄉,口湖村,205,1134,373,136,509,66,575
公投第９案,雲林縣,口湖鄉,湖東村,206,1225,433,125,558,108,666
公投第９案,雲林縣,口湖鄉,頂湖村,207,647,162,65,227,45,272
公投第９案,雲林縣,口湖鄉,埔南村,208,709,221,82,303,35,338
公投第９案,雲林縣,口湖鄉,埔北村,209,900,230,103,333,94,427
公投第９案,雲林縣,口湖鄉,謝厝村,210,1011,316,100,416,76,492
公投第９案,雲林縣,口湖鄉,蚵寮村,211,1437,350,138,488,37,525
公投第９案,雲林縣,口湖鄉,下崙村,212,848,180,55,235,10,245
公投第９案,雲林縣,口湖鄉,下崙村,213,1193,309,103,412,38,450
公投第９案,雲林縣,口湖鄉,崙中村,214,759,172,54,226,62,288
公投第９案,雲林縣,口湖鄉,崙中村,215,815,226,91,317,49,366
公投第９案,雲林縣,口湖鄉,崙東村,216,1460,451,155,606,98,704
公投第９案,雲林縣,口湖鄉,青蚶村,217,556,96,57,153,10,163
公投第９案,雲林縣,口湖鄉,港東村,218,1532,507,120,627,59,686
公投第９案,雲林縣,口湖鄉,港西村,219,847,266,70,336,23,359
公投第９案,雲林縣,口湖鄉,台子村,220,374,125,28,153,29,182
公投第９案,雲林縣,口湖鄉,台子村,221,1508,472,172,644,188,832
公投第９案,雲林縣,口湖鄉,成龍村,222,951,345,93,438,84,522
公投第９案,雲林縣,口湖鄉,梧南村,223,910,310,126,436,89,525
公投第９案,雲林縣,口湖鄉,梧南村,224,879,341,110,451,55,506
公投第９案,雲林縣,口湖鄉,梧北村,225,1213,352,105,457,130,587
公投第９案,雲林縣,口湖鄉,水井村,226,952,318,87,405,57,462
公投第９案,雲林縣,口湖鄉,後厝村,227,720,238,94,332,57,389
公投第９案,雲林縣,口湖鄉,湖口村,228,1006,232,103,335,33,368
公投第９案,雲林縣,口湖鄉,過港村,229,607,150,46,196,11,207
公投第９案,雲林縣,水林鄉,水北村,230,1355,396,132,528,74,602
公投第９案,雲林縣,水林鄉,水北村,231,887,299,86,385,17,402
公投第９案,雲林縣,水林鄉,水南村,232,1234,478,166,644,66,710
公投第９案,雲林縣,水林鄉,水南村,233,763,234,101,335,16,351
公投第９案,雲林縣,水林鄉,萬興村,234,721,180,77,257,49,306
公投第９案,雲林縣,水林鄉,尖山村,235,647,164,46,210,15,225
公投第９案,雲林縣,水林鄉,大溝村,236,989,280,88,368,62,430
公投第９案,雲林縣,水林鄉,順興村,237,837,197,71,268,39,307
公投第９案,雲林縣,水林鄉,大山村,238,1081,268,78,346,25,371
公投第９案,雲林縣,水林鄉,後寮村,239,704,196,75,271,45,316
公投第９案,雲林縣,水林鄉,春埔村,240,1006,280,117,397,94,491
公投第９案,雲林縣,水林鄉,西井村,241,651,196,54,250,8,258
公投第９案,雲林縣,水林鄉,車港村,242,607,163,42,205,28,233
公投第９案,雲林縣,水林鄉,蘇秦村,243,1033,259,102,361,68,429
公投第９案,雲林縣,水林鄉,灣東村,244,631,140,41,181,15,196
公投第９案,雲林縣,水林鄉,灣西村,245,961,254,89,343,61,404
公投第９案,雲林縣,水林鄉,蕃薯村,246,951,238,94,332,87,419
公投第９案,雲林縣,水林鄉,山腳村,247,838,240,83,323,37,360
公投第９案,雲林縣,水林鄉,松北村,248,1055,297,98,395,105,500
公投第９案,雲林縣,水林鄉,松中村,249,512,114,28,142,28,170
公投第９案,雲林縣,水林鄉,松西村,250,671,167,45,212,19,231
公投第９案,雲林縣,水林鄉,欍埔村,251,693,113,51,164,47,211
公投第９案,雲林縣,水林鄉,塭底村,252,689,143,48,191,48,239
公投第９案,雲林縣,水林鄉,海埔村,253,1022,327,98,425,69,494
公投第９案,雲林縣,水林鄉,土厝村,254,1191,349,80,429,39,468
公投第９案,雲林縣,水林鄉,溪墘村,255,779,280,84,364,50,414
公投第９案,雲林縣,北港鎮,東陽里,256,724,279,86,365,62,427
公投第９案,雲林縣,北港鎮,光民里,257,688,272,91,363,68,431
公投第９案,雲林縣,北港鎮,東華里,258,452,168,55,223,41,264
公投第９案,雲林縣,北港鎮,南安里,259,866,329,105,434,72,506
公投第９案,雲林縣,北港鎮,中和里,260,336,109,47,156,22,178
公投第９案,雲林縣,北港鎮,義民里,261,395,156,32,188,27,215
公投第９案,雲林縣,北港鎮,共榮里,262,376,174,31,205,32,237
公投第９案,雲林縣,北港鎮,西勢里,263,950,364,138,502,43,545
公投第９案,雲林縣,北港鎮,仁和里,264,512,197,77,274,45,319
公投第９案,雲林縣,北港鎮,賜福里,265,324,123,46,169,29,198
公投第９案,雲林縣,北港鎮,公舘里,266,546,189,73,262,36,298
公投第９案,雲林縣,北港鎮,大同里,267,433,185,50,235,23,258
公投第９案,雲林縣,北港鎮,大同里,268,751,271,96,367,64,431
公投第９案,雲林縣,北港鎮,仁安里,269,442,193,50,243,30,273
公投第９案,雲林縣,北港鎮,華勝里,270,1151,455,142,597,70,667
公投第９案,雲林縣,北港鎮,華勝里,271,1224,516,144,660,56,716
公投第９案,雲林縣,北港鎮,華勝里,272,1211,442,146,588,60,648
公投第９案,雲林縣,北港鎮,華勝里,273,1326,503,166,669,75,744
公投第９案,雲林縣,北港鎮,光復里,274,744,333,100,433,45,478
公投第９案,雲林縣,北港鎮,光復里,275,977,453,114,567,60,627
公投第９案,雲林縣,北港鎮,扶朝里,276,960,328,125,453,74,527
公投第９案,雲林縣,北港鎮,水埔里,277,494,121,40,161,10,171
公投第９案,雲林縣,北港鎮,新街里,278,1364,564,157,721,64,785
公投第９案,雲林縣,北港鎮,新街里,279,1123,479,118,597,59,656
公投第９案,雲林縣,北港鎮,新街里,280,1451,606,142,748,72,820
公投第９案,雲林縣,北港鎮,新街里,281,1162,488,132,620,72,692
公投第９案,雲林縣,北港鎮,新街里,282,1130,414,117,531,59,590
公投第９案,雲林縣,北港鎮,劉厝里,283,1149,408,118,526,44,570
公投第９案,雲林縣,北港鎮,後溝里,284,533,154,51,205,35,240
公投第９案,雲林縣,北港鎮,後溝里,285,433,174,66,240,31,271
公投第９案,雲林縣,北港鎮,新厝里,286,377,132,34,166,12,178
公投第９案,雲林縣,北港鎮,府番里,287,809,242,82,324,25,349
公投第９案,雲林縣,北港鎮,草湖里,288,1397,426,126,552,92,644
公投第９案,雲林縣,北港鎮,溝皂里,289,1145,314,106,420,105,525
公投第９案,雲林縣,北港鎮,番溝里,290,828,170,67,237,75,312
公投第９案,雲林縣,北港鎮,大北里,291,557,143,51,194,26,220
公投第９案,雲林縣,北港鎮,好收里,292,1060,309,137,446,53,499
公投第９案,雲林縣,北港鎮,好收里,293,577,183,58,241,37,278
公投第９案,雲林縣,北港鎮,樹腳里,294,931,248,84,332,73,405
公投第９案,雲林縣,北港鎮,樹腳里,295,1018,388,115,503,44,547
公投第９案,雲林縣,北港鎮,樹腳里,296,1032,417,107,524,28,552
公投第９案,雲林縣,崙背鄉,東明村,297,1176,448,129,577,75,652
公投第９案,雲林縣,崙背鄉,西榮村,298,1439,518,125,643,50,693
公投第９案,雲林縣,崙背鄉,南陽村,299,1027,438,117,555,54,609
公投第９案,雲林縣,崙背鄉,南陽村,300,1259,519,114,633,55,688
公投第９案,雲林縣,崙背鄉,崙前村,301,1058,370,111,481,38,519
公投第９案,雲林縣,崙背鄉,崙前村,302,998,318,95,413,32,445
公投第９案,雲林縣,崙背鄉,羅厝村,303,968,318,99,417,33,450
公投第９案,雲林縣,崙背鄉,羅厝村,304,1055,374,122,496,56,552
公投第９案,雲林縣,崙背鄉,港尾村,305,1315,397,136,533,84,617
公投第９案,雲林縣,崙背鄉,阿勸村,306,1027,214,84,298,26,324
公投第９案,雲林縣,崙背鄉,阿勸村,307,997,367,118,485,105,590
公投第９案,雲林縣,崙背鄉,五魁村,308,807,298,80,378,42,420
公投第９案,雲林縣,崙背鄉,大有村,309,698,178,79,257,27,284
公投第９案,雲林縣,崙背鄉,大有村,310,804,227,79,306,60,366
公投第９案,雲林縣,崙背鄉,豐榮村,311,867,288,79,367,38,405
公投第９案,雲林縣,崙背鄉,豐榮村,312,886,235,65,300,38,338
公投第９案,雲林縣,崙背鄉,草湖村,313,1476,401,112,513,103,616
公投第９案,雲林縣,崙背鄉,舊庄村,314,1159,249,84,333,45,378
公投第９案,雲林縣,崙背鄉,水尾村,315,1220,393,174,567,96,663
公投第９案,雲林縣,崙背鄉,枋南村,316,814,278,92,370,38,408
公投第９案,雲林縣,二崙鄉,崙東村,317,1463,464,149,613,38,651
公投第９案,雲林縣,二崙鄉,崙西村,318,1738,502,206,708,65,773
公投第９案,雲林縣,二崙鄉,來惠村,319,625,176,70,246,51,297
公投第９案,雲林縣,二崙鄉,來惠村,320,1018,322,98,420,73,493
公投第９案,雲林縣,二崙鄉,三和村,321,448,107,42,149,6,155
公投第９案,雲林縣,二崙鄉,三和村,322,1048,266,80,346,51,397
公投第９案,雲林縣,二崙鄉,湳仔村,323,1161,412,134,546,86,632
公投第９案,雲林縣,二崙鄉,田尾村,324,991,349,109,458,49,507
公投第９案,雲林縣,二崙鄉,田尾村,325,849,323,109,432,67,499
公投第９案,雲林縣,二崙鄉,定安村,326,890,288,107,395,55,450
公投第９案,雲林縣,二崙鄉,永定村,327,1427,462,143,605,101,706
公投第９案,雲林縣,二崙鄉,大華村,328,891,286,88,374,41,415
公投第９案,雲林縣,二崙鄉,義庄村,329,757,223,64,287,26,313
公投第９案,雲林縣,二崙鄉,楊賢村,330,1497,409,200,609,117,726
公投第９案,雲林縣,二崙鄉,港後村,331,1171,338,140,478,78,556
公投第９案,雲林縣,二崙鄉,港後村,332,686,248,89,337,60,397
公投第９案,雲林縣,二崙鄉,大義村,333,864,220,75,295,91,386
公投第９案,雲林縣,二崙鄉,油車村,334,1073,408,129,537,78,615
公投第９案,雲林縣,二崙鄉,油車村,335,696,196,63,259,25,284
公投第９案,雲林縣,二崙鄉,大庄村,336,1271,283,104,387,61,448
公投第９案,雲林縣,二崙鄉,庄西村,337,912,265,94,359,47,406
公投第９案,雲林縣,二崙鄉,大同村,338,861,233,100,333,37,370
公投第９案,雲林縣,二崙鄉,復興村,339,1030,279,102,381,67,448
公投第９案,雲林縣,西螺鎮,振興里,340,1590,541,190,731,67,798
公投第９案,雲林縣,西螺鎮,大園里,341,1741,660,191,851,91,942
公投第９案,雲林縣,西螺鎮,廣福里,342,1080,505,125,630,63,693
公投第９案,雲林縣,西螺鎮,廣福里,343,1040,464,113,577,70,647
公投第９案,雲林縣,西螺鎮,正興里,344,1346,565,146,711,36,747
公投第９案,雲林縣,西螺鎮,正興里,345,1625,665,152,817,57,874
公投第９案,雲林縣,西螺鎮,永安里,346,354,164,37,201,17,218
公投第９案,雲林縣,西螺鎮,中和里,347,580,209,67,276,43,319
公投第９案,雲林縣,西螺鎮,福興里,348,591,258,82,340,33,373
公投第９案,雲林縣,西螺鎮,光華里,349,1050,431,130,561,59,620
公投第９案,雲林縣,西螺鎮,中興里,350,1147,476,157,633,73,706
公投第９案,雲林縣,西螺鎮,中興里,351,1602,588,189,777,86,863
公投第９案,雲林縣,西螺鎮,漢光里,352,1452,505,194,699,56,755
公投第９案,雲林縣,西螺鎮,漢光里,353,1578,832,20,852,23,875
公投第９案,雲林縣,西螺鎮,漢光里,354,1305,499,126,625,32,657
公投第９案,雲林縣,西螺鎮,新安里,355,1327,404,142,546,52,598
公投第９案,雲林縣,西螺鎮,新豐里,356,1516,558,151,709,66,775
公投第９案,雲林縣,西螺鎮,大新里,357,828,201,78,279,32,311
公投第９案,雲林縣,西螺鎮,大新里,358,788,199,60,259,25,284
公投第９案,雲林縣,西螺鎮,埤頭里,359,863,261,116,377,77,454
公投第９案,雲林縣,西螺鎮,東興里,360,984,303,123,426,87,513
公投第９案,雲林縣,西螺鎮,鹿場里,361,1514,471,187,658,151,809
公投第９案,雲林縣,西螺鎮,廣興里,362,870,281,128,409,57,466
公投第９案,雲林縣,西螺鎮,頂湳里,363,971,344,107,451,65,516
公投第９案,雲林縣,西螺鎮,吳厝里,364,1304,405,120,525,61,586
公投第９案,雲林縣,西螺鎮,九隆里,365,726,256,66,322,32,354
公投第９案,雲林縣,西螺鎮,下湳里,366,823,316,89,405,43,448
公投第９案,雲林縣,西螺鎮,七座里,367,886,254,71,325,22,347
公投第９案,雲林縣,西螺鎮,公舘里,368,1373,455,136,591,95,686
公投第９案,雲林縣,西螺鎮,詔安里,369,983,358,107,465,68,533
公投第９案,雲林縣,西螺鎮,河南里,370,1014,385,101,486,58,544
公投第９案,雲林縣,西螺鎮,安定里,371,939,291,98,389,83,472
公投第９案,雲林縣,西螺鎮,安定里,372,866,276,99,375,50,425
公投第９案,雲林縣,西螺鎮,福田里,373,1486,497,132,629,95,724
公投第９案,雲林縣,莿桐鄉,莿桐村,374,1507,561,194,755,96,851
公投第９案,雲林縣,莿桐鄉,莿桐村,375,1300,510,139,649,47,696
公投第９案,雲林縣,莿桐鄉,莿桐村,376,1272,485,156,641,101,742
公投第９案,雲林縣,莿桐鄉,甘厝村,377,861,275,113,388,71,459
公投第９案,雲林縣,莿桐鄉,甘西村,378,1565,488,152,640,85,725
公投第９案,雲林縣,莿桐鄉,興桐村,379,577,196,64,260,21,281
公投第９案,雲林縣,莿桐鄉,興桐村,380,636,174,82,256,43,299
公投第９案,雲林縣,莿桐鄉,義和村,381,1110,354,143,497,97,594
公投第９案,雲林縣,莿桐鄉,埔子村,382,973,382,130,512,68,580
公投第９案,雲林縣,莿桐鄉,埔子村,383,985,333,138,471,78,549
公投第９案,雲林縣,莿桐鄉,大美村,384,1707,677,207,884,126,1010
公投第９案,雲林縣,莿桐鄉,大美村,385,1284,475,160,635,89,724
公投第９案,雲林縣,莿桐鄉,埔尾村,386,1293,431,225,656,76,732
公投第９案,雲林縣,莿桐鄉,興貴村,387,900,340,109,449,61,510
公投第９案,雲林縣,莿桐鄉,興貴村,388,1040,385,127,512,108,620
公投第９案,雲林縣,莿桐鄉,饒平村,389,1165,417,130,547,36,583
公投第９案,雲林縣,莿桐鄉,四合村,390,871,326,106,432,62,494
公投第９案,雲林縣,莿桐鄉,四合村,391,885,359,117,476,62,538
公投第９案,雲林縣,莿桐鄉,麻園村,392,1489,474,171,645,75,720
公投第９案,雲林縣,莿桐鄉,五華村,393,1347,443,129,572,96,668
公投第９案,雲林縣,莿桐鄉,六合村,394,1150,429,155,584,83,667
公投第９案,雲林縣,莿桐鄉,六合村,395,653,246,95,341,46,387
公投第９案,雲林縣,林內鄉,林南村,396,1036,446,126,572,83,655
公投第９案,雲林縣,林內鄉,林中村,397,1490,561,192,753,81,834
公投第９案,雲林縣,林內鄉,林中村,398,1491,548,169,717,81,798
公投第９案,雲林縣,林內鄉,林中村,399,671,234,67,301,61,362
公投第９案,雲林縣,林內鄉,林北村,400,1436,568,177,745,117,862
公投第９案,雲林縣,林內鄉,林北村,401,751,275,93,368,75,443
公投第９案,雲林縣,林內鄉,坪頂村,402,535,189,70,259,34,293
公投第９案,雲林縣,林內鄉,林茂村,403,811,258,73,331,52,383
公投第９案,雲林縣,林內鄉,九芎村,404,1339,515,150,665,99,764
公投第９案,雲林縣,林內鄉,九芎村,405,1286,514,115,629,78,707
公投第９案,雲林縣,林內鄉,湖本村,406,646,239,83,322,33,355
公投第９案,雲林縣,林內鄉,烏塗村,407,1158,415,150,565,87,652
公投第９案,雲林縣,林內鄉,烏麻村,408,1090,420,130,550,64,614
公投第９案,雲林縣,林內鄉,重興村,409,950,386,112,498,76,574
公投第９案,雲林縣,林內鄉,重興村,410,861,317,93,410,40,450
公投第９案,雲林縣,斗六市,信義里,411,644,242,80,322,10,332
公投第９案,雲林縣,斗六市,四維里,412,617,226,80,306,36,342
公投第９案,雲林縣,斗六市,太平里,413,764,378,91,469,33,502
公投第９案,雲林縣,斗六市,中和里,414,784,335,120,455,32,487
公投第９案,雲林縣,斗六市,光興里,415,760,307,100,407,32,439
公投第９案,雲林縣,斗六市,鎮西里,416,1881,840,223,1063,76,1139
公投第９案,雲林縣,斗六市,鎮西里,417,1829,730,191,921,64,985
公投第９案,雲林縣,斗六市,鎮東里,418,1255,603,127,730,39,769
公投第９案,雲林縣,斗六市,鎮東里,419,1090,557,117,674,30,704
公投第９案,雲林縣,斗六市,文化里,420,1103,527,113,640,33,673
公投第９案,雲林縣,斗六市,文化里,421,1176,524,133,657,49,706
公投第９案,雲林縣,斗六市,三平里,422,1529,648,168,816,30,846
公投第９案,雲林縣,斗六市,三平里,423,1335,614,125,739,44,783
公投第９案,雲林縣,斗六市,三平里,424,1770,767,214,981,58,1039
公投第９案,雲林縣,斗六市,明德里,425,1308,547,159,706,36,742
公投第９案,雲林縣,斗六市,明德里,426,2171,882,205,1087,78,1165
公投第９案,雲林縣,斗六市,鎮北里,427,1193,528,179,707,42,749
公投第９案,雲林縣,斗六市,鎮北里,428,1572,760,167,927,52,979
公投第９案,雲林縣,斗六市,公誠里,429,1009,420,101,521,30,551
公投第９案,雲林縣,斗六市,公誠里,430,1195,561,138,699,45,744
公投第９案,雲林縣,斗六市,忠孝里,431,1415,631,208,839,32,871
公投第９案,雲林縣,斗六市,仁愛里,432,1101,470,154,624,48,672
公投第９案,雲林縣,斗六市,八德里,433,1648,655,169,824,40,864
公投第９案,雲林縣,斗六市,八德里,434,1588,627,142,769,31,800
公投第９案,雲林縣,斗六市,公正里,435,1392,637,140,777,36,813
公投第９案,雲林縣,斗六市,公正里,436,1422,638,143,781,43,824
公投第９案,雲林縣,斗六市,重光里,437,1187,433,92,525,31,556
公投第９案,雲林縣,斗六市,重光里,438,1142,418,133,551,44,595
公投第９案,雲林縣,斗六市,林頭里,439,1421,669,151,820,46,866
公投第９案,雲林縣,斗六市,林頭里,440,1261,537,144,681,33,714
公投第９案,雲林縣,斗六市,林頭里,441,1506,581,166,747,42,789
公投第９案,雲林縣,斗六市,成功里,442,1214,528,144,672,29,701
公投第９案,雲林縣,斗六市,成功里,443,1362,712,71,783,79,862
公投第９案,雲林縣,斗六市,鎮南里,444,1097,448,127,575,22,597
公投第９案,雲林縣,斗六市,鎮南里,445,1262,552,132,684,34,718
公投第９案,雲林縣,斗六市,鎮南里,446,1154,456,139,595,40,635
公投第９案,雲林縣,斗六市,社口里,447,847,360,99,459,47,506
公投第９案,雲林縣,斗六市,社口里,448,1439,633,144,777,38,815
公投第９案,雲林縣,斗六市,龍潭里,449,1747,788,215,1003,62,1065
公投第９案,雲林縣,斗六市,嘉東里,450,1418,603,151,754,61,815
公投第９案,雲林縣,斗六市,崙峰里,451,1112,470,112,582,47,629
公投第９案,雲林縣,斗六市,崙峰里,452,1302,564,135,699,49,748
公投第９案,雲林縣,斗六市,溝埧里,453,669,303,94,397,25,422
公投第９案,雲林縣,斗六市,江厝里,454,752,310,70,380,47,427
公投第９案,雲林縣,斗六市,江厝里,455,1450,569,140,709,33,742
公投第９案,雲林縣,斗六市,三光里,456,555,220,61,281,38,319
公投第９案,雲林縣,斗六市,久安里,457,1470,582,135,717,51,768
公投第９案,雲林縣,斗六市,久安里,458,927,426,102,528,20,548
公投第９案,雲林縣,斗六市,虎溪里,459,1893,844,202,1046,56,1102
公投第９案,雲林縣,斗六市,虎溪里,460,1708,658,217,875,101,976
公投第９案,雲林縣,斗六市,虎溪里,461,1773,640,175,815,58,873
公投第９案,雲林縣,斗六市,保庄里,462,1412,650,150,800,43,843
公投第９案,雲林縣,斗六市,保庄里,463,1354,632,162,794,35,829
公投第９案,雲林縣,斗六市,保庄里,464,1267,522,141,663,32,695
公投第９案,雲林縣,斗六市,保庄里,465,1273,495,148,643,36,679
公投第９案,雲林縣,斗六市,長平里,466,1748,645,163,808,95,903
公投第９案,雲林縣,斗六市,榴中里,467,1238,491,152,643,87,730
公投第９案,雲林縣,斗六市,榴中里,468,1648,664,159,823,69,892
公投第９案,雲林縣,斗六市,榴中里,469,1520,677,181,858,62,920
公投第９案,雲林縣,斗六市,榴北里,470,1087,405,113,518,39,557
公投第９案,雲林縣,斗六市,榴南里,471,1904,794,213,1007,80,1087
公投第９案,雲林縣,斗六市,梅林里,472,702,299,86,385,39,424
公投第９案,雲林縣,斗六市,梅林里,473,1111,426,143,569,66,635
公投第９案,雲林縣,斗六市,湖山里,474,1123,378,116,494,41,535
公投第９案,雲林縣,斗六市,長安里,475,1146,424,118,542,45,587
公投第９案,雲林縣,斗六市,長安里,476,1786,694,197,891,44,935
公投第９案,雲林縣,斗六市,溪洲里,477,1023,387,129,516,67,583
公投第９案,雲林縣,斗六市,溪洲里,478,2072,886,166,1052,94,1146
公投第９案,雲林縣,斗六市,十三里,479,1128,430,115,545,33,578
公投第９案,雲林縣,大埤鄉,北和村,480,750,306,72,378,44,422
公投第９案,雲林縣,大埤鄉,吉田村,481,719,249,74,323,31,354
公投第９案,雲林縣,大埤鄉,豐岡村,482,603,237,52,289,24,313
公投第９案,雲林縣,大埤鄉,聯美村,483,1106,345,115,460,57,517
公投第９案,雲林縣,大埤鄉,南和村,484,1495,521,185,706,69,775
公投第９案,雲林縣,大埤鄉,南和村,485,600,250,74,324,32,356
公投第９案,雲林縣,大埤鄉,大德村,486,1004,401,130,531,59,590
公投第９案,雲林縣,大埤鄉,松竹村,487,948,259,82,341,20,361
公投第９案,雲林縣,大埤鄉,豐田村,488,1539,573,179,752,79,831
公投第９案,雲林縣,大埤鄉,尚義村,489,1430,460,165,625,65,690
公投第９案,雲林縣,大埤鄉,尚義村,490,465,153,46,199,34,233
公投第９案,雲林縣,大埤鄉,嘉興村,491,1307,457,130,587,55,642
公投第９案,雲林縣,大埤鄉,嘉興村,492,474,157,59,216,23,239
公投第９案,雲林縣,大埤鄉,三結村,493,1220,446,179,625,101,726
公投第９案,雲林縣,大埤鄉,怡然村,494,733,74,249,323,21,344
公投第９案,雲林縣,大埤鄉,北鎮村,495,681,255,73,328,41,369
公投第９案,雲林縣,大埤鄉,興安村,496,712,188,72,260,35,295
公投第９案,雲林縣,大埤鄉,西鎮村,497,723,214,85,299,49,348
公投第９案,雲林縣,斗南鎮,東仁里,498,1166,502,128,630,52,682
公投第９案,雲林縣,斗南鎮,西岐里,499,1135,504,143,647,41,688
公投第９案,雲林縣,斗南鎮,西岐里,500,975,461,111,572,32,604
公投第９案,雲林縣,斗南鎮,大同里,501,1459,648,163,811,44,855
公投第９案,雲林縣,斗南鎮,大同里,502,1351,581,152,733,58,791
公投第９案,雲林縣,斗南鎮,南昌里,503,1321,528,153,681,53,734
公投第９案,雲林縣,斗南鎮,南昌里,504,907,375,73,448,49,497
公投第９案,雲林縣,斗南鎮,北銘里,505,1473,658,175,833,86,919
公投第９案,雲林縣,斗南鎮,中天里,506,1277,552,193,745,58,803
公投第９案,雲林縣,斗南鎮,林子里,507,1333,495,161,656,93,749
公投第９案,雲林縣,斗南鎮,石龜里,508,777,297,78,375,37,412
公投第９案,雲林縣,斗南鎮,石溪里,509,877,405,28,433,43,476
公投第９案,雲林縣,斗南鎮,靖興里,510,899,351,84,435,57,492
公投第９案,雲林縣,斗南鎮,新南里,511,688,212,60,272,42,314
公投第９案,雲林縣,斗南鎮,阿丹里,512,1147,409,94,503,41,544
公投第９案,雲林縣,斗南鎮,將軍里,513,1709,596,246,842,98,940
公投第９案,雲林縣,斗南鎮,舊社里,514,1042,440,143,583,43,626
公投第９案,雲林縣,斗南鎮,舊社里,515,1631,594,216,810,62,872
公投第９案,雲林縣,斗南鎮,明昌里,516,1702,727,208,935,89,1024
公投第９案,雲林縣,斗南鎮,明昌里,517,1564,633,206,839,74,913
公投第９案,雲林縣,斗南鎮,僑真里,518,910,296,84,380,41,421
公投第９案,雲林縣,斗南鎮,僑真里,519,1276,558,150,708,50,758
公投第９案,雲林縣,斗南鎮,大東里,520,897,289,79,368,21,389
公投第９案,雲林縣,斗南鎮,埤麻里,521,803,306,89,395,30,425
公投第９案,雲林縣,斗南鎮,西伯里,522,866,364,91,455,48,503
公投第９案,雲林縣,斗南鎮,新崙里,523,852,311,122,433,69,502
公投第９案,雲林縣,斗南鎮,新崙里,524,671,235,93,328,50,378
公投第９案,雲林縣,斗南鎮,東明里,525,981,364,107,471,31,502
公投第９案,雲林縣,斗南鎮,新光里,526,1129,375,111,486,33,519
公投第９案,雲林縣,斗南鎮,新光里,527,1586,643,177,820,116,936
公投第９案,雲林縣,斗南鎮,田頭里,528,1243,547,125,672,84,756
公投第９案,雲林縣,斗南鎮,田頭里,529,984,333,104,437,27,464
公投第９案,雲林縣,斗南鎮,小東里,530,1507,600,141,741,83,824
公投第９案,雲林縣,古坑鄉,棋盤村,531,1126,422,124,546,70,616
公投第９案,雲林縣,古坑鄉,棋盤村,532,994,338,110,448,74,522
公投第９案,雲林縣,古坑鄉,新庄村,533,1517,510,184,694,63,757
公投第９案,雲林縣,古坑鄉,東和村,534,1302,508,136,644,55,699
公投第９案,雲林縣,古坑鄉,東和村,535,1772,616,178,794,73,867
公投第９案,雲林縣,古坑鄉,荷苞村,536,1122,417,128,545,100,645
公投第９案,雲林縣,古坑鄉,荷苞村,537,304,69,21,90,5,95
公投第９案,雲林縣,古坑鄉,高林村,538,1169,479,109,588,93,681
公投第９案,雲林縣,古坑鄉,水碓村,539,1255,420,134,554,90,644
公投第９案,雲林縣,古坑鄉,田心村,540,1078,472,131,603,49,652
公投第９案,雲林縣,古坑鄉,古坑村,541,943,331,75,406,36,442
公投第９案,雲林縣,古坑鄉,古坑村,542,1300,447,129,576,94,670
公投第９案,雲林縣,古坑鄉,朝陽村,543,964,322,95,417,61,478
公投第９案,雲林縣,古坑鄉,朝陽村,544,1144,436,125,561,56,617
公投第９案,雲林縣,古坑鄉,西平村,545,1482,579,131,710,78,788
公投第９案,雲林縣,古坑鄉,湳仔村,546,688,279,64,343,43,386
公投第９案,雲林縣,古坑鄉,永光村,547,998,324,105,429,58,487
公投第９案,雲林縣,古坑鄉,永光村,548,1140,477,120,597,53,650
公投第９案,雲林縣,古坑鄉,永昌村,549,1102,388,152,540,49,589
公投第９案,雲林縣,古坑鄉,永昌村,550,956,358,102,460,36,496
公投第９案,雲林縣,古坑鄉,麻園村,551,695,252,85,337,26,363
公投第９案,雲林縣,古坑鄉,崁腳村,552,1233,380,150,530,31,561
公投第９案,雲林縣,古坑鄉,華南村,553,285,70,32,102,7,109
公投第９案,雲林縣,古坑鄉,華山村,554,734,200,52,252,13,265
公投第９案,雲林縣,古坑鄉,桂林村,555,1150,385,156,541,92,633
公投第９案,雲林縣,古坑鄉,樟湖村,556,453,160,52,212,18,230
公投第９案,雲林縣,古坑鄉,草嶺村,557,571,198,48,246,31,277
公投第９案,嘉義縣,太保市,太保里,1,1210,464,140,604,74,678
公投第９案,嘉義縣,太保市,太保里,2,1076,423,108,531,44,575
公投第９案,嘉義縣,太保市,後庄里,3,488,159,51,210,26,236
公投第９案,嘉義縣,太保市,前潭里,4,1475,477,168,645,64,709
公投第９案,嘉義縣,太保市,後潭里,5,790,251,70,321,36,357
公投第９案,嘉義縣,太保市,後潭里,6,883,292,104,396,43,439
公投第９案,嘉義縣,太保市,梅埔里,7,758,296,63,359,41,400
公投第９案,嘉義縣,太保市,梅埔里,8,389,121,28,149,5,154
公投第９案,嘉義縣,太保市,春珠里,9,1101,344,114,458,56,514
公投第９案,嘉義縣,太保市,崙頂里,10,853,300,96,396,18,414
公投第９案,嘉義縣,太保市,安仁里,11,224,54,23,77,15,92
公投第９案,嘉義縣,太保市,安仁里,12,662,198,65,263,55,318
公投第９案,嘉義縣,太保市,安仁里,13,1630,770,164,934,31,965
公投第９案,嘉義縣,太保市,東勢里,14,913,305,88,393,27,420
公投第９案,嘉義縣,太保市,東勢里,15,779,337,77,414,19,433
公投第９案,嘉義縣,太保市,新埤里,16,1278,428,178,606,96,702
公投第９案,嘉義縣,太保市,舊埤里,17,819,257,86,343,42,385
公投第９案,嘉義縣,太保市,舊埤里,18,1573,570,179,749,30,779
公投第９案,嘉義縣,太保市,田尾里,19,481,181,55,236,25,261
公投第９案,嘉義縣,太保市,田尾里,20,245,110,26,136,5,141
公投第９案,嘉義縣,太保市,港尾里,21,317,105,42,147,22,169
公投第９案,嘉義縣,太保市,港尾里,22,258,82,27,109,9,118
公投第９案,嘉義縣,太保市,過溝里,23,611,205,71,276,57,333
公投第９案,嘉義縣,太保市,過溝里,24,1526,582,200,782,53,835
公投第９案,嘉義縣,太保市,過溝里,25,1196,465,154,619,30,649
公投第９案,嘉義縣,太保市,麻寮里,26,1536,528,211,739,97,836
公投第９案,嘉義縣,太保市,麻寮里,27,1481,551,195,746,81,827
公投第９案,嘉義縣,太保市,麻寮里,28,1450,574,165,739,52,791
公投第９案,嘉義縣,太保市,南新里,29,840,272,93,365,23,388
公投第９案,嘉義縣,太保市,南新里,30,989,334,130,464,37,501
公投第９案,嘉義縣,太保市,北新里,31,1529,576,160,736,109,845
公投第９案,嘉義縣,太保市,北新里,32,1511,564,186,750,95,845
公投第９案,嘉義縣,太保市,埤鄉里,33,697,211,68,279,40,319
公投第９案,嘉義縣,鹿草鄉,後寮村,34,522,142,52,194,46,240
公投第９案,嘉義縣,鹿草鄉,鹿東村,35,563,180,74,254,45,299
公投第９案,嘉義縣,鹿草鄉,鹿草村,36,1304,422,128,550,89,639
公投第９案,嘉義縣,鹿草鄉,西井村,37,1312,438,154,592,65,657
公投第９案,嘉義縣,鹿草鄉,豊稠村,38,320,94,31,125,3,128
公投第９案,嘉義縣,鹿草鄉,豊稠村,39,418,90,17,107,3,110
公投第９案,嘉義縣,鹿草鄉,重寮村,40,1025,295,85,380,57,437
公投第９案,嘉義縣,鹿草鄉,施家村,41,451,106,50,156,30,186
公投第９案,嘉義縣,鹿草鄉,下潭村,42,830,256,82,338,105,443
公投第９案,嘉義縣,鹿草鄉,光潭村,43,1050,301,95,396,93,489
公投第９案,嘉義縣,鹿草鄉,碧潭村,44,972,265,77,342,57,399
公投第９案,嘉義縣,鹿草鄉,松竹村,45,962,277,104,381,59,440
公投第９案,嘉義縣,鹿草鄉,竹山村,46,678,219,73,292,56,348
公投第９案,嘉義縣,鹿草鄉,竹山村,47,262,76,26,102,34,136
公投第９案,嘉義縣,鹿草鄉,後堀村,48,906,257,85,342,48,390
公投第９案,嘉義縣,鹿草鄉,後堀村,49,306,73,21,94,11,105
公投第９案,嘉義縣,鹿草鄉,三角村,50,1062,357,106,463,74,537
公投第９案,嘉義縣,鹿草鄉,三角村,51,373,118,49,167,29,196
公投第９案,嘉義縣,鹿草鄉,下麻村,52,324,114,36,150,25,175
公投第９案,嘉義縣,鹿草鄉,下麻村,53,297,98,26,124,22,146
公投第９案,嘉義縣,水上鄉,水上村,54,1024,341,115,456,44,500
公投第９案,嘉義縣,水上鄉,水上村,55,1015,390,152,542,70,612
公投第９案,嘉義縣,水上鄉,水上村,56,1932,645,215,860,80,940
公投第９案,嘉義縣,水上鄉,水頭村,57,1170,473,158,631,47,678
公投第９案,嘉義縣,水上鄉,水頭村,58,1305,536,151,687,78,765
公投第９案,嘉義縣,水上鄉,粗溪村,59,1242,405,141,546,68,614
公投第９案,嘉義縣,水上鄉,粗溪村,60,324,107,37,144,18,162
公投第９案,嘉義縣,水上鄉,下寮村,61,622,238,70,308,17,325
公投第９案,嘉義縣,水上鄉,下寮村,62,1216,439,111,550,85,635
公投第９案,嘉義縣,水上鄉,三和村,63,1020,421,104,525,33,558
公投第９案,嘉義縣,水上鄉,三和村,64,771,328,109,437,43,480
公投第９案,嘉義縣,水上鄉,回歸村,65,441,190,63,253,23,276
公投第９案,嘉義縣,水上鄉,大堀村,66,626,282,76,358,49,407
公投第９案,嘉義縣,水上鄉,大堀村,67,570,227,84,311,27,338
公投第９案,嘉義縣,水上鄉,大堀村,68,368,121,49,170,22,192
公投第９案,嘉義縣,水上鄉,大崙村,69,1037,306,127,433,100,533
公投第９案,嘉義縣,水上鄉,大崙村,70,1065,374,126,500,75,575
公投第９案,嘉義縣,水上鄉,塗溝村,71,802,318,110,428,81,509
公投第９案,嘉義縣,水上鄉,龍德村,72,1948,647,201,848,56,904
公投第９案,嘉義縣,水上鄉,溪洲村,73,1028,329,127,456,68,524
公投第９案,嘉義縣,水上鄉,三鎮村,74,641,268,79,347,24,371
公投第９案,嘉義縣,水上鄉,靖和村,75,408,163,40,203,21,224
公投第９案,嘉義縣,水上鄉,南和村,76,794,286,112,398,59,457
公投第９案,嘉義縣,水上鄉,南和村,77,569,165,71,236,33,269
公投第９案,嘉義縣,水上鄉,柳新村,78,806,311,99,410,41,451
公投第９案,嘉義縣,水上鄉,柳新村,79,960,389,116,505,48,553
公投第９案,嘉義縣,水上鄉,柳林村,80,2035,742,254,996,114,1110
公投第９案,嘉義縣,水上鄉,柳鄉村,81,1987,691,231,922,95,1017
公投第９案,嘉義縣,水上鄉,內溪村,82,1154,437,119,556,47,603
公投第９案,嘉義縣,水上鄉,寬士村,83,2208,782,240,1022,84,1106
公投第９案,嘉義縣,水上鄉,寬士村,84,2102,641,224,865,71,936
公投第９案,嘉義縣,水上鄉,民生村,85,1309,441,137,578,83,661
公投第９案,嘉義縣,水上鄉,民生村,86,1671,595,231,826,81,907
公投第９案,嘉義縣,水上鄉,義興村,87,822,292,99,391,50,441
公投第９案,嘉義縣,水上鄉,中庄村,88,1772,571,210,781,57,838
公投第９案,嘉義縣,水上鄉,忠和村,89,1919,649,241,890,101,991
公投第９案,嘉義縣,水上鄉,南鄉村,90,912,255,87,342,26,368
公投第９案,嘉義縣,水上鄉,三界村,91,992,340,92,432,37,469
公投第９案,嘉義縣,水上鄉,國姓村,92,1270,349,149,498,65,563
公投第９案,嘉義縣,民雄鄉,東榮村,93,1267,528,146,674,53,727
公投第９案,嘉義縣,民雄鄉,東榮村,94,1030,366,120,486,38,524
公投第９案,嘉義縣,民雄鄉,中樂村,95,1590,732,118,850,89,939
公投第９案,嘉義縣,民雄鄉,西安村,96,1673,610,163,773,40,813
公投第９案,嘉義縣,民雄鄉,西安村,97,1718,644,237,881,78,959
公投第９案,嘉義縣,民雄鄉,寮頂村,98,1040,443,121,564,50,614
公投第９案,嘉義縣,民雄鄉,寮頂村,99,1100,408,124,532,61,593
公投第９案,嘉義縣,民雄鄉,福權村,100,1559,570,156,726,72,798
公投第９案,嘉義縣,民雄鄉,東湖村,101,1862,639,218,857,81,938
公投第９案,嘉義縣,民雄鄉,頂崙村,102,1435,558,178,736,72,808
公投第９案,嘉義縣,民雄鄉,菁埔村,103,1751,532,225,757,158,915
公投第９案,嘉義縣,民雄鄉,中和村,104,933,358,101,459,61,520
公投第９案,嘉義縣,民雄鄉,平和村,105,827,313,142,455,62,517
公投第９案,嘉義縣,民雄鄉,西昌村,106,843,258,77,335,57,392
公投第９案,嘉義縣,民雄鄉,豊收村,107,1774,650,221,871,66,937
公投第９案,嘉義縣,民雄鄉,豊收村,108,385,118,43,161,21,182
公投第９案,嘉義縣,民雄鄉,三興村,109,1306,512,180,692,56,748
公投第９案,嘉義縣,民雄鄉,東興村,110,535,206,69,275,45,320
公投第９案,嘉義縣,民雄鄉,鎮北村,111,1055,402,121,523,89,612
公投第９案,嘉義縣,民雄鄉,北斗村,112,1476,548,185,733,61,794
公投第９案,嘉義縣,民雄鄉,北斗村,113,1583,567,163,730,64,794
公投第９案,嘉義縣,民雄鄉,北斗村,114,758,207,103,310,34,344
公投第９案,嘉義縣,民雄鄉,北斗村,115,1354,469,145,614,59,673
公投第９案,嘉義縣,民雄鄉,双福村,116,1202,445,160,605,79,684
公投第９案,嘉義縣,民雄鄉,双福村,117,1175,453,146,599,47,646
公投第９案,嘉義縣,民雄鄉,福樂村,118,1423,503,158,661,65,726
公投第９案,嘉義縣,民雄鄉,福樂村,119,1612,641,162,803,44,847
公投第９案,嘉義縣,民雄鄉,福樂村,120,1695,687,200,887,35,922
公投第９案,嘉義縣,民雄鄉,福樂村,121,1665,526,177,703,51,754
公投第９案,嘉義縣,民雄鄉,大崎村,122,1019,323,107,430,58,488
公投第９案,嘉義縣,民雄鄉,大崎村,123,1352,489,157,646,60,706
公投第９案,嘉義縣,民雄鄉,秀林村,124,1620,589,208,797,92,889
公投第９案,嘉義縣,民雄鄉,秀林村,125,943,335,106,441,32,473
公投第９案,嘉義縣,民雄鄉,松山村,126,1720,536,194,730,63,793
公投第９案,嘉義縣,民雄鄉,興中村,127,1875,627,220,847,107,954
公投第９案,嘉義縣,民雄鄉,興南村,128,1305,506,170,676,53,729
公投第９案,嘉義縣,民雄鄉,興南村,129,1441,496,171,667,71,738
公投第９案,嘉義縣,民雄鄉,金興村,130,1413,522,162,684,68,752
公投第９案,嘉義縣,民雄鄉,金興村,131,1560,555,188,743,82,825
公投第９案,嘉義縣,民雄鄉,福興村,132,2004,731,259,990,123,1113
公投第９案,嘉義縣,民雄鄉,文隆村,133,1354,557,168,725,69,794
公投第９案,嘉義縣,民雄鄉,文隆村,134,1076,415,134,549,48,597
公投第９案,嘉義縣,民雄鄉,山中村,135,1629,573,213,786,124,910
公投第９案,嘉義縣,民雄鄉,山中村,136,1977,711,190,901,89,990
公投第９案,嘉義縣,民雄鄉,中央村,137,1295,405,193,598,86,684
公投第９案,嘉義縣,新港鄉,宮前村,138,1087,429,100,529,31,560
公投第９案,嘉義縣,新港鄉,宮前村,139,1116,532,129,661,72,733
公投第９案,嘉義縣,新港鄉,宮後村,140,740,269,89,358,51,409
公投第９案,嘉義縣,新港鄉,宮後村,141,827,275,95,370,67,437
公投第９案,嘉義縣,新港鄉,大興村,142,704,295,85,380,51,431
公投第９案,嘉義縣,新港鄉,大興村,143,768,306,105,411,58,469
公投第９案,嘉義縣,新港鄉,福德村,144,761,294,118,412,44,456
公投第９案,嘉義縣,新港鄉,福德村,145,850,284,82,366,66,432
公投第９案,嘉義縣,新港鄉,古民村,146,1327,469,153,622,71,693
公投第９案,嘉義縣,新港鄉,中庄村,147,756,254,96,350,66,416
公投第９案,嘉義縣,新港鄉,中庄村,148,816,279,96,375,86,461
公投第９案,嘉義縣,新港鄉,大潭村,149,667,190,81,271,31,302
公投第９案,嘉義縣,新港鄉,大潭村,150,942,324,95,419,61,480
公投第９案,嘉義縣,新港鄉,西庄村,151,918,277,95,372,66,438
公投第９案,嘉義縣,新港鄉,埤子村,152,554,160,51,211,14,225
公投第９案,嘉義縣,新港鄉,南崙村,153,929,301,93,394,44,438
公投第９案,嘉義縣,新港鄉,北崙村,154,487,129,42,171,34,205
公投第９案,嘉義縣,新港鄉,海瀛村,155,487,163,65,228,42,270
公投第９案,嘉義縣,新港鄉,月眉村,156,836,235,114,349,49,398
公投第９案,嘉義縣,新港鄉,月眉村,157,845,284,116,400,61,461
公投第９案,嘉義縣,新港鄉,月潭村,158,834,304,99,403,50,453
公投第９案,嘉義縣,新港鄉,月潭村,159,753,268,102,370,55,425
公投第９案,嘉義縣,新港鄉,溪北村,160,1328,461,167,628,73,701
公投第９案,嘉義縣,新港鄉,菜公村,161,969,373,126,499,52,551
公投第９案,嘉義縣,新港鄉,中洋村,162,1043,412,138,550,66,616
公投第９案,嘉義縣,新港鄉,三間村,163,1400,615,170,785,65,850
公投第９案,嘉義縣,新港鄉,安和村,164,1017,228,78,306,32,338
公投第９案,嘉義縣,新港鄉,潭大村,165,1132,332,121,453,55,508
公投第９案,嘉義縣,新港鄉,南港村,166,1037,363,112,475,62,537
公投第９案,嘉義縣,新港鄉,板頭村,167,563,207,61,268,65,333
公投第９案,嘉義縣,新港鄉,共和村,168,849,338,61,399,12,411
公投第９案,嘉義縣,大林鎮,東林里,169,483,160,69,229,36,265
公投第９案,嘉義縣,大林鎮,西林里,170,1823,733,211,944,68,1012
公投第９案,嘉義縣,大林鎮,吉林里,171,955,386,109,495,17,512
公投第９案,嘉義縣,大林鎮,平林里,172,1436,519,163,682,34,716
公投第９案,嘉義縣,大林鎮,平林里,173,1390,483,167,650,60,710
公投第９案,嘉義縣,大林鎮,平林里,174,1512,589,175,764,79,843
公投第９案,嘉義縣,大林鎮,平林里,175,1536,629,177,806,52,858
公投第９案,嘉義縣,大林鎮,明華里,176,1165,405,105,510,38,548
公投第９案,嘉義縣,大林鎮,明和里,177,1730,708,232,940,79,1019
公投第９案,嘉義縣,大林鎮,排路里,178,602,169,57,226,15,241
公投第９案,嘉義縣,大林鎮,西結里,179,716,212,82,294,66,360
公投第９案,嘉義縣,大林鎮,湖北里,180,625,153,43,196,9,205
公投第９案,嘉義縣,大林鎮,大糖里,181,193,55,12,67,1,68
公投第９案,嘉義縣,大林鎮,大美里,182,1642,495,186,681,70,751
公投第９案,嘉義縣,大林鎮,過溪里,183,1465,540,157,697,62,759
公投第９案,嘉義縣,大林鎮,中坑里,184,928,284,77,361,49,410
公投第９案,嘉義縣,大林鎮,中坑里,185,361,107,29,136,23,159
公投第９案,嘉義縣,大林鎮,上林里,186,814,243,80,323,21,344
公投第９案,嘉義縣,大林鎮,中林里,187,1579,524,157,681,38,719
公投第９案,嘉義縣,大林鎮,三和里,188,2041,734,218,952,94,1046
公投第９案,嘉義縣,大林鎮,溝背里,189,931,327,93,420,54,474
公投第９案,嘉義縣,大林鎮,義和里,190,675,233,70,303,41,344
公投第９案,嘉義縣,大林鎮,內林里,191,655,225,55,280,29,309
公投第９案,嘉義縣,大林鎮,三角里,192,833,281,83,364,42,406
公投第９案,嘉義縣,大林鎮,三村里,193,832,330,108,438,62,500
公投第９案,嘉義縣,溪口鄉,溪東村,194,1318,480,167,647,100,747
公投第９案,嘉義縣,溪口鄉,溪西村,195,677,251,87,338,52,390
公投第９案,嘉義縣,溪口鄉,溪北村,196,417,141,44,185,14,199
公投第９案,嘉義縣,溪口鄉,溪北村,197,273,88,41,129,18,147
公投第９案,嘉義縣,溪口鄉,柳溝村,198,908,332,133,465,63,528
公投第９案,嘉義縣,溪口鄉,柳溝村,199,386,115,39,154,9,163
公投第９案,嘉義縣,溪口鄉,疊溪村,200,1039,370,144,514,62,576
公投第９案,嘉義縣,溪口鄉,妙崙村,201,708,205,69,274,54,328
公投第９案,嘉義縣,溪口鄉,坪頂村,202,909,287,90,377,15,392
公投第９案,嘉義縣,溪口鄉,柴林村,203,786,294,92,386,44,430
公投第９案,嘉義縣,溪口鄉,林腳村,204,807,239,96,335,46,381
公投第９案,嘉義縣,溪口鄉,美南村,205,1168,318,88,406,20,426
公投第９案,嘉義縣,溪口鄉,美北村,206,1052,373,126,499,87,586
公投第９案,嘉義縣,溪口鄉,本厝村,207,565,157,75,232,53,285
公投第９案,嘉義縣,溪口鄉,本厝村,208,388,152,31,183,22,205
公投第９案,嘉義縣,溪口鄉,游西村,209,701,198,58,256,26,282
公投第９案,嘉義縣,溪口鄉,游東村,210,1003,264,92,356,39,395
公投第９案,嘉義縣,梅山鄉,梅東村,211,1041,368,116,484,30,514
公投第９案,嘉義縣,梅山鄉,梅東村,212,1245,471,162,633,101,734
公投第９案,嘉義縣,梅山鄉,梅南村,213,917,378,121,499,64,563
公投第９案,嘉義縣,梅山鄉,梅北村,214,1189,464,131,595,34,629
公投第９案,嘉義縣,梅山鄉,梅北村,215,1388,545,157,702,84,786
公投第９案,嘉義縣,梅山鄉,梅北村,216,1827,672,203,875,74,949
公投第９案,嘉義縣,梅山鄉,過山村,217,545,231,61,292,51,343
公投第９案,嘉義縣,梅山鄉,圳南村,218,407,107,43,150,33,183
公投第９案,嘉義縣,梅山鄉,圳北村,219,636,224,80,304,33,337
公投第９案,嘉義縣,梅山鄉,双溪村,220,576,204,64,268,61,329
公投第９案,嘉義縣,梅山鄉,大南村,221,1674,612,194,806,104,910
公投第９案,嘉義縣,梅山鄉,安靖村,222,858,270,75,345,15,360
公投第９案,嘉義縣,梅山鄉,永興村,223,526,205,78,283,43,326
公投第９案,嘉義縣,梅山鄉,半天村,224,372,102,42,144,36,180
公投第９案,嘉義縣,梅山鄉,太平村,225,506,164,56,220,33,253
公投第９案,嘉義縣,梅山鄉,太興村,226,433,231,40,271,33,304
公投第９案,嘉義縣,梅山鄉,龍眼村,227,404,120,31,151,12,163
公投第９案,嘉義縣,梅山鄉,碧湖村,228,293,96,32,128,17,145
公投第９案,嘉義縣,梅山鄉,瑞峯村,229,712,317,71,388,60,448
公投第９案,嘉義縣,梅山鄉,瑞里村,230,602,255,80,335,38,373
公投第９案,嘉義縣,梅山鄉,太和村,231,515,171,49,220,30,250
公投第９案,嘉義縣,梅山鄉,太和村,232,417,116,33,149,15,164
公投第９案,嘉義縣,朴子市,安福里,233,1183,469,124,593,51,644
公投第９案,嘉義縣,朴子市,安福里,234,755,257,111,368,45,413
公投第９案,嘉義縣,朴子市,平和里,235,1253,504,125,629,40,669
公投第９案,嘉義縣,朴子市,平和里,236,1078,454,122,576,68,644
公投第９案,嘉義縣,朴子市,內厝里,237,1117,454,161,615,70,685
公投第９案,嘉義縣,朴子市,開元里,238,387,153,61,214,16,230
公投第９案,嘉義縣,朴子市,順天里,239,633,245,67,312,47,359
公投第９案,嘉義縣,朴子市,中正里,240,650,297,36,333,27,360
公投第９案,嘉義縣,朴子市,博厚里,241,825,371,100,471,46,517
公投第９案,嘉義縣,朴子市,文化里,242,810,310,84,394,52,446
公投第９案,嘉義縣,朴子市,文化里,243,940,393,102,495,52,547
公投第９案,嘉義縣,朴子市,永和里,244,905,326,108,434,52,486
公投第９案,嘉義縣,朴子市,永和里,245,1605,538,175,713,51,764
公投第９案,嘉義縣,朴子市,竹圍里,246,1479,587,190,777,66,843
公投第９案,嘉義縣,朴子市,竹圍里,247,1218,479,160,639,60,699
公投第９案,嘉義縣,朴子市,竹圍里,248,1496,624,178,802,55,857
公投第９案,嘉義縣,朴子市,新寮里,249,667,218,84,302,34,336
公投第９案,嘉義縣,朴子市,双溪里,250,627,160,60,220,24,244
公投第９案,嘉義縣,朴子市,溪口里,251,791,267,74,341,54,395
公投第９案,嘉義縣,朴子市,德興里,252,1034,346,121,467,106,573
公投第９案,嘉義縣,朴子市,仁和里,253,1710,610,163,773,25,798
公投第９案,嘉義縣,朴子市,大鄉里,254,1671,573,135,708,44,752
公投第９案,嘉義縣,朴子市,大鄉里,255,1547,454,116,570,45,615
公投第９案,嘉義縣,朴子市,大葛里,256,1602,430,140,570,70,640
公投第９案,嘉義縣,朴子市,大葛里,257,1302,579,128,707,29,736
公投第９案,嘉義縣,朴子市,佳禾里,258,740,245,82,327,49,376
公投第９案,嘉義縣,朴子市,竹村里,259,1054,429,127,556,63,619
公投第９案,嘉義縣,朴子市,崁前里,260,907,246,84,330,17,347
公投第９案,嘉義縣,朴子市,崁後里,261,720,195,78,273,33,306
公投第９案,嘉義縣,朴子市,順安里,262,251,85,35,120,26,146
公投第９案,嘉義縣,朴子市,德家里,263,767,182,90,272,62,334
公投第９案,嘉義縣,朴子市,新庄里,264,702,256,89,345,44,389
公投第９案,嘉義縣,朴子市,梅華里,265,1038,320,110,430,56,486
公投第９案,嘉義縣,朴子市,松華里,266,1228,276,79,355,30,385
公投第９案,嘉義縣,朴子市,南竹里,267,499,163,48,211,46,257
公投第９案,嘉義縣,六腳鄉,蒜頭村,268,1165,346,96,442,41,483
公投第９案,嘉義縣,六腳鄉,蒜東村,269,825,192,56,248,20,268
公投第９案,嘉義縣,六腳鄉,蒜南村,270,850,234,91,325,35,360
公投第９案,嘉義縣,六腳鄉,工廠村,271,222,85,26,111,21,132
公投第９案,嘉義縣,六腳鄉,灣南村,272,1216,401,125,526,60,586
公投第９案,嘉義縣,六腳鄉,灣北村,273,1200,305,82,387,49,436
公投第９案,嘉義縣,六腳鄉,雙涵村,274,877,284,76,360,49,409
公投第９案,嘉義縣,六腳鄉,塗師村,275,644,185,47,232,41,273
公投第９案,嘉義縣,六腳鄉,三義村,276,594,144,46,190,12,202
公投第９案,嘉義縣,六腳鄉,三義村,277,167,34,4,38,1,39
公投第９案,嘉義縣,六腳鄉,正義村,278,204,44,24,68,1,69
公投第９案,嘉義縣,六腳鄉,正義村,279,234,63,19,82,7,89
公投第９案,嘉義縣,六腳鄉,正義村,280,361,84,34,118,6,124
公投第９案,嘉義縣,六腳鄉,正義村,281,592,218,55,273,57,330
公投第９案,嘉義縣,六腳鄉,溪厝村,282,619,190,81,271,37,308
公投第９案,嘉義縣,六腳鄉,港美村,283,714,165,57,222,47,269
公投第９案,嘉義縣,六腳鄉,豐美村,284,1051,342,81,423,61,484
公投第９案,嘉義縣,六腳鄉,六斗村,285,934,302,113,415,67,482
公投第９案,嘉義縣,六腳鄉,崙陽村,286,1044,337,116,453,58,511
公投第９案,嘉義縣,六腳鄉,蘇厝村,287,1476,417,127,544,39,583
公投第９案,嘉義縣,六腳鄉,竹本村,288,618,140,53,193,23,216
公投第９案,嘉義縣,六腳鄉,永賢村,289,478,84,30,114,48,162
公投第９案,嘉義縣,六腳鄉,魚寮村,290,642,136,44,180,52,232
公投第９案,嘉義縣,六腳鄉,潭墘村,291,883,187,62,249,14,263
公投第９案,嘉義縣,六腳鄉,六腳村,292,739,160,39,199,8,207
公投第９案,嘉義縣,六腳鄉,六南村,293,554,134,54,188,27,215
公投第９案,嘉義縣,六腳鄉,崩山村,294,649,128,50,178,23,201
公投第９案,嘉義縣,六腳鄉,古林村,295,689,158,46,204,27,231
公投第９案,嘉義縣,六腳鄉,更寮村,296,455,106,47,153,18,171
公投第９案,嘉義縣,六腳鄉,更寮村,297,125,22,11,33,5,38
公投第９案,嘉義縣,東石鄉,東石村,298,1915,507,195,702,105,807
公投第９案,嘉義縣,東石鄉,猿樹村,299,938,221,82,303,65,368
公投第９案,嘉義縣,東石鄉,型厝村,300,1366,259,82,341,36,377
公投第９案,嘉義縣,東石鄉,塭港村,301,1676,407,139,546,7,553
公投第９案,嘉義縣,東石鄉,三家村,302,1151,263,97,360,104,464
公投第９案,嘉義縣,東石鄉,永屯村,303,716,182,55,237,85,322
公投第９案,嘉義縣,東石鄉,海埔村,304,387,97,23,120,11,131
公投第９案,嘉義縣,東石鄉,龍港村,305,864,164,54,218,13,231
公投第９案,嘉義縣,東石鄉,副瀨村,306,910,183,67,250,17,267
公投第９案,嘉義縣,東石鄉,下揖村,307,760,176,50,226,17,243
公投第９案,嘉義縣,東石鄉,頂揖村,308,166,44,25,69,16,85
公投第９案,嘉義縣,東石鄉,頂揖村,309,212,45,17,62,15,77
公投第９案,嘉義縣,東石鄉,溪下村,310,993,203,71,274,48,322
公投第９案,嘉義縣,東石鄉,港口村,311,306,69,26,95,16,111
公投第９案,嘉義縣,東石鄉,鰲鼓村,312,1046,234,84,318,93,411
公投第９案,嘉義縣,東石鄉,鰲鼓村,313,235,48,15,63,27,90
公投第９案,嘉義縣,東石鄉,港墘村,314,1226,335,114,449,105,554
公投第９案,嘉義縣,東石鄉,蔦松村,315,843,222,78,300,67,367
公投第９案,嘉義縣,東石鄉,圍潭村,316,693,84,57,141,37,178
公投第９案,嘉義縣,東石鄉,洲仔村,317,839,260,76,336,76,412
公投第９案,嘉義縣,東石鄉,東崙村,318,363,108,27,135,11,146
公投第９案,嘉義縣,東石鄉,東崙村,319,321,77,21,98,11,109
公投第９案,嘉義縣,東石鄉,西崙村,320,1083,350,139,489,111,600
公投第９案,嘉義縣,東石鄉,塭仔村,321,901,253,96,349,62,411
公投第９案,嘉義縣,東石鄉,網寮村,322,1216,267,58,325,41,366
公投第９案,嘉義縣,東石鄉,掌潭村,323,418,155,49,204,45,249
公投第９案,嘉義縣,東石鄉,掌潭村,324,371,108,32,140,15,155
公投第９案,嘉義縣,布袋鎮,岱江里,325,614,207,54,261,31,292
公投第９案,嘉義縣,布袋鎮,九龍里,326,372,115,36,151,16,167
公投第９案,嘉義縣,布袋鎮,岑海里,327,914,313,101,414,91,505
公投第９案,嘉義縣,布袋鎮,岑海里,328,1198,416,128,544,93,637
公投第９案,嘉義縣,布袋鎮,興中里,329,1113,343,107,450,74,524
公投第９案,嘉義縣,布袋鎮,光復里,330,992,367,98,465,80,545
公投第９案,嘉義縣,布袋鎮,光復里,331,689,247,64,311,12,323
公投第９案,嘉義縣,布袋鎮,見龍里,332,882,291,103,394,72,466
公投第９案,嘉義縣,布袋鎮,新厝里,333,731,262,77,339,40,379
公投第９案,嘉義縣,布袋鎮,龍江里,334,779,297,86,383,35,418
公投第９案,嘉義縣,布袋鎮,振寮里,335,762,233,68,301,39,340
公投第９案,嘉義縣,布袋鎮,西安里,336,1184,371,97,468,48,516
公投第９案,嘉義縣,布袋鎮,中安里,337,1423,362,120,482,76,558
公投第９案,嘉義縣,布袋鎮,東安里,338,1351,346,114,460,71,531
公投第９案,嘉義縣,布袋鎮,樹林里,339,275,81,27,108,5,113
公投第９案,嘉義縣,布袋鎮,樹林里,340,243,65,33,98,12,110
公投第９案,嘉義縣,布袋鎮,貴舍里,341,661,204,75,279,84,363
公投第９案,嘉義縣,布袋鎮,永安里,342,1145,374,99,473,61,534
公投第９案,嘉義縣,布袋鎮,東港里,343,936,292,86,378,36,414
公投第９案,嘉義縣,布袋鎮,東港里,344,958,320,95,415,38,453
公投第９案,嘉義縣,布袋鎮,江山里,345,298,95,26,121,14,135
公投第９案,嘉義縣,布袋鎮,菜舖里,346,428,167,40,207,37,244
公投第９案,嘉義縣,布袋鎮,考試里,347,121,38,9,47,4,51
公投第９案,嘉義縣,布袋鎮,考試里,348,174,34,11,45,4,49
公投第９案,嘉義縣,布袋鎮,新岑里,349,953,324,80,404,47,451
公投第９案,嘉義縣,布袋鎮,新民里,350,1292,436,172,608,80,688
公投第９案,嘉義縣,布袋鎮,復興里,351,1127,410,114,524,77,601
公投第９案,嘉義縣,布袋鎮,復興里,352,1244,400,145,545,31,576
公投第９案,嘉義縣,布袋鎮,好美里,353,1106,305,120,425,25,450
公投第９案,嘉義縣,義竹鄉,岸腳村,354,482,153,48,201,29,230
公投第９案,嘉義縣,義竹鄉,岸腳村,355,223,87,26,113,18,131
公投第９案,嘉義縣,義竹鄉,義竹村,356,1529,546,178,724,88,812
公投第９案,嘉義縣,義竹鄉,六桂村,357,1175,453,130,583,70,653
公投第９案,嘉義縣,義竹鄉,仁里村,358,886,374,116,490,54,544
公投第９案,嘉義縣,義竹鄉,傳芳村,359,743,226,69,295,39,334
公投第９案,嘉義縣,義竹鄉,頭竹村,360,1236,431,157,588,87,675
公投第９案,嘉義縣,義竹鄉,五厝村,361,377,137,37,174,20,194
公投第９案,嘉義縣,義竹鄉,中平村,362,338,108,25,133,19,152
公投第９案,嘉義縣,義竹鄉,中平村,363,102,44,10,54,5,59
公投第９案,嘉義縣,義竹鄉,埤前村,364,763,231,72,303,24,327
公投第９案,嘉義縣,義竹鄉,平溪村,365,429,152,59,211,28,239
公投第９案,嘉義縣,義竹鄉,後鎮村,366,427,139,45,184,23,207
公投第９案,嘉義縣,義竹鄉,北華村,367,607,213,69,282,47,329
公投第９案,嘉義縣,義竹鄉,新店村,368,1486,485,127,612,49,661
公投第９案,嘉義縣,義竹鄉,東過村,369,835,325,88,413,63,476
公投第９案,嘉義縣,義竹鄉,西過村,370,816,226,63,289,64,353
公投第９案,嘉義縣,義竹鄉,官和村,371,833,217,103,320,61,381
公投第９案,嘉義縣,義竹鄉,官順村,372,433,145,50,195,17,212
公投第９案,嘉義縣,義竹鄉,新富村,373,558,196,37,233,6,239
公投第９案,嘉義縣,義竹鄉,東光村,374,602,189,80,269,41,310
公投第９案,嘉義縣,義竹鄉,東光村,375,140,43,10,53,0,53
公投第９案,嘉義縣,義竹鄉,東榮村,376,393,109,40,149,26,175
公投第９案,嘉義縣,義竹鄉,龍蛟村,377,585,208,54,262,22,284
公投第９案,嘉義縣,義竹鄉,溪洲村,378,526,116,35,151,9,160
公投第９案,嘉義縣,義竹鄉,溪洲村,379,123,36,20,56,11,67
公投第９案,嘉義縣,中埔鄉,富收村,380,1046,302,86,388,16,404
公投第９案,嘉義縣,中埔鄉,富收村,381,1788,565,181,746,95,841
公投第９案,嘉義縣,中埔鄉,和睦村,382,1730,529,188,717,56,773
公投第９案,嘉義縣,中埔鄉,和睦村,383,1581,540,171,711,59,770
公投第９案,嘉義縣,中埔鄉,和美村,384,1594,479,150,629,47,676
公投第９案,嘉義縣,中埔鄉,和美村,385,1801,648,183,831,48,879
公投第９案,嘉義縣,中埔鄉,和美村,386,1862,663,185,848,80,928
公投第９案,嘉義縣,中埔鄉,和美村,387,1803,579,164,743,33,776
公投第９案,嘉義縣,中埔鄉,和興村,388,1481,553,149,702,63,765
公投第９案,嘉義縣,中埔鄉,和興村,389,1366,494,153,647,70,717
公投第９案,嘉義縣,中埔鄉,和興村,390,1599,471,157,628,83,711
公投第９案,嘉義縣,中埔鄉,和興村,391,1196,390,137,527,48,575
公投第９案,嘉義縣,中埔鄉,中埔村,392,1809,557,180,737,82,819
公投第９案,嘉義縣,中埔鄉,塩舘村,393,953,319,103,422,31,453
公投第９案,嘉義縣,中埔鄉,金蘭村,394,1441,442,148,590,77,667
公投第９案,嘉義縣,中埔鄉,隆興村,395,1882,628,173,801,64,865
公投第９案,嘉義縣,中埔鄉,義仁村,396,1470,364,115,479,24,503
公投第９案,嘉義縣,中埔鄉,社口村,397,1699,532,138,670,81,751
公投第９案,嘉義縣,中埔鄉,社口村,398,422,122,30,152,21,173
公投第９案,嘉義縣,中埔鄉,灣潭村,399,1030,330,114,444,69,513
公投第９案,嘉義縣,中埔鄉,裕民村,400,879,255,88,343,51,394
公投第９案,嘉義縣,中埔鄉,龍門村,401,828,235,69,304,15,319
公投第９案,嘉義縣,中埔鄉,石硦村,402,881,345,93,438,60,498
公投第９案,嘉義縣,中埔鄉,石硦村,403,296,86,41,127,21,148
公投第９案,嘉義縣,中埔鄉,頂埔村,404,979,265,116,381,98,479
公投第９案,嘉義縣,中埔鄉,同仁村,405,1268,362,120,482,41,523
公投第９案,嘉義縣,中埔鄉,同仁村,406,670,142,43,185,7,192
公投第９案,嘉義縣,中埔鄉,深坑村,407,754,270,101,371,60,431
公投第９案,嘉義縣,中埔鄉,三層村,408,648,236,79,315,39,354
公投第９案,嘉義縣,中埔鄉,瑞豐村,409,741,210,54,264,28,292
公投第９案,嘉義縣,中埔鄉,沄水村,410,518,168,37,205,4,209
公投第９案,嘉義縣,中埔鄉,沄水村,411,482,147,55,202,39,241
公投第９案,嘉義縣,中埔鄉,東興村,412,348,97,37,134,8,142
公投第９案,嘉義縣,中埔鄉,中崙村,413,294,99,31,130,14,144
公投第９案,嘉義縣,竹崎鄉,竹崎村,414,1312,431,172,603,43,646
公投第９案,嘉義縣,竹崎鄉,竹崎村,415,1210,481,117,598,27,625
公投第９案,嘉義縣,竹崎鄉,和平村,416,991,388,114,502,51,553
公投第９案,嘉義縣,竹崎鄉,和平村,417,1207,429,108,537,56,593
公投第９案,嘉義縣,竹崎鄉,坑頭村,418,752,215,74,289,17,306
公投第９案,嘉義縣,竹崎鄉,沙坑村,419,833,313,100,413,69,482
公投第９案,嘉義縣,竹崎鄉,獅埜村,420,1220,448,150,598,91,689
公投第９案,嘉義縣,竹崎鄉,義和村,421,616,236,86,322,18,340
公投第９案,嘉義縣,竹崎鄉,義仁村,422,1031,350,116,466,62,528
公投第９案,嘉義縣,竹崎鄉,灣橋村,423,1292,421,165,586,82,668
公投第９案,嘉義縣,竹崎鄉,灣橋村,424,1995,765,235,1000,94,1094
公投第９案,嘉義縣,竹崎鄉,灣橋村,425,1996,641,194,835,42,877
公投第９案,嘉義縣,竹崎鄉,鹿滿村,426,1449,517,146,663,93,756
公投第９案,嘉義縣,竹崎鄉,紫雲村,427,1420,515,127,642,49,691
公投第９案,嘉義縣,竹崎鄉,內埔村,428,1590,596,188,784,49,833
公投第９案,嘉義縣,竹崎鄉,昇平村,429,771,261,81,342,44,386
公投第９案,嘉義縣,竹崎鄉,昇平村,430,1014,294,133,427,54,481
公投第９案,嘉義縣,竹崎鄉,桃源村,431,327,71,25,96,12,108
公投第９案,嘉義縣,竹崎鄉,桃源村,432,687,247,81,328,27,355
公投第９案,嘉義縣,竹崎鄉,白杞村,433,641,209,59,268,24,292
公投第９案,嘉義縣,竹崎鄉,塘興村,434,474,177,38,215,10,225
公投第９案,嘉義縣,竹崎鄉,塘興村,435,383,129,29,158,27,185
公投第９案,嘉義縣,竹崎鄉,義隆村,436,619,240,73,313,61,374
公投第９案,嘉義縣,竹崎鄉,龍山村,437,214,66,24,90,8,98
公投第９案,嘉義縣,竹崎鄉,龍山村,438,1568,521,173,694,120,814
公投第９案,嘉義縣,竹崎鄉,文峯村,439,658,200,53,253,36,289
公投第９案,嘉義縣,竹崎鄉,金獅村,440,434,152,64,216,38,254
公投第９案,嘉義縣,竹崎鄉,復金村,441,917,346,92,438,54,492
公投第９案,嘉義縣,竹崎鄉,復金村,442,981,321,102,423,48,471
公投第９案,嘉義縣,竹崎鄉,緞繻村,443,789,224,69,293,24,317
公投第９案,嘉義縣,竹崎鄉,緞繻村,444,108,25,2,27,1,28
公投第９案,嘉義縣,竹崎鄉,仁壽村,445,235,41,9,50,2,52
公投第９案,嘉義縣,竹崎鄉,中和村,446,331,102,26,128,8,136
公投第９案,嘉義縣,竹崎鄉,中和村,447,450,200,59,259,16,275
公投第９案,嘉義縣,竹崎鄉,光華村,448,462,130,34,164,9,173
公投第９案,嘉義縣,竹崎鄉,光華村,449,251,64,21,85,19,104
公投第９案,嘉義縣,番路鄉,江西村,450,1174,478,158,636,71,707
公投第９案,嘉義縣,番路鄉,內甕村,451,449,194,53,247,13,260
公投第９案,嘉義縣,番路鄉,新福村,452,753,320,84,404,39,443
公投第９案,嘉義縣,番路鄉,新福村,453,551,176,53,229,29,258
公投第９案,嘉義縣,番路鄉,下坑村,454,1791,731,189,920,82,1002
公投第９案,嘉義縣,番路鄉,番路村,455,849,340,132,472,65,537
公投第９案,嘉義縣,番路鄉,民和村,456,866,332,110,442,47,489
公投第９案,嘉義縣,番路鄉,觸口村,457,800,335,66,401,38,439
公投第９案,嘉義縣,番路鄉,觸口村,458,444,145,66,211,39,250
公投第９案,嘉義縣,番路鄉,大湖村,459,635,177,49,226,18,244
公投第９案,嘉義縣,番路鄉,公田村,460,319,106,21,127,16,143
公投第９案,嘉義縣,番路鄉,公田村,461,642,290,58,348,28,376
公投第９案,嘉義縣,番路鄉,公興村,462,509,162,42,204,25,229
公投第９案,嘉義縣,番路鄉,草山村,463,162,65,14,79,0,79
公投第９案,嘉義縣,番路鄉,草山村,464,212,79,24,103,10,113
公投第９案,嘉義縣,大埔鄉,大埔村,465,1468,559,164,723,79,802
公投第９案,嘉義縣,大埔鄉,和平村,466,320,85,20,105,6,111
公投第９案,嘉義縣,大埔鄉,和平村,467,304,114,40,154,14,168
公投第９案,嘉義縣,大埔鄉,永樂村,468,184,65,26,91,2,93
公投第９案,嘉義縣,大埔鄉,永樂村,469,234,107,32,139,15,154
公投第９案,嘉義縣,大埔鄉,茄苳村,470,495,179,46,225,10,235
公投第９案,嘉義縣,大埔鄉,茄苳村,471,199,72,25,97,5,102
公投第９案,嘉義縣,大埔鄉,茄苳村,472,226,63,26,89,12,101
公投第９案,嘉義縣,大埔鄉,西興村,473,569,261,67,328,20,348
公投第９案,嘉義縣,阿里山鄉,中山村,474,371,132,31,163,5,168
公投第９案,嘉義縣,阿里山鄉,中正村,475,197,59,16,75,9,84
公投第９案,嘉義縣,阿里山鄉,香林村,476,152,51,15,66,3,69
公投第９案,嘉義縣,阿里山鄉,十字村,477,231,51,20,71,4,75
公投第９案,嘉義縣,阿里山鄉,十字村,478,72,14,5,19,2,21
公投第９案,嘉義縣,阿里山鄉,豐山村,479,311,93,18,111,3,114
公投第９案,嘉義縣,阿里山鄉,來吉村,480,306,122,26,148,16,164
公投第９案,嘉義縣,阿里山鄉,樂野村,481,970,329,74,403,8,411
公投第９案,嘉義縣,阿里山鄉,達邦村,482,827,349,81,430,24,454
公投第９案,嘉義縣,阿里山鄉,里佳村,483,238,88,26,114,0,114
公投第９案,嘉義縣,阿里山鄉,山美村,484,479,82,29,111,7,118
公投第９案,嘉義縣,阿里山鄉,新美村,485,291,69,20,89,6,95
公投第９案,嘉義縣,阿里山鄉,茶山村,486,246,101,39,140,18,158
公投第９案,屏東縣,屏東市,端正里,1,237,78,43,121,7,128
公投第９案,屏東縣,屏東市,武廟里,2,294,92,46,138,27,165
公投第９案,屏東縣,屏東市,大同里,3,582,188,92,280,15,295
公投第９案,屏東縣,屏東市,光榮里,4,713,261,110,371,27,398
公投第９案,屏東縣,屏東市,民權里,5,572,205,74,279,36,315
公投第９案,屏東縣,屏東市,泰安里,6,455,200,68,268,12,280
公投第９案,屏東縣,屏東市,文明里,7,249,107,33,140,2,142
公投第９案,屏東縣,屏東市,維新里,8,1315,429,127,556,30,586
公投第９案,屏東縣,屏東市,維新里,9,1373,405,168,573,46,619
公投第９案,屏東縣,屏東市,大埔里,10,713,288,111,399,40,439
公投第９案,屏東縣,屏東市,必信里,11,573,233,89,322,42,364
公投第９案,屏東縣,屏東市,崇禮里,12,297,122,56,178,21,199
公投第９案,屏東縣,屏東市,崇智里,13,409,189,74,263,18,281
公投第９案,屏東縣,屏東市,慶春里,14,286,105,39,144,16,160
公投第９案,屏東縣,屏東市,楠樹里,15,421,155,53,208,17,225
公投第９案,屏東縣,屏東市,扶風里,16,569,219,89,308,15,323
公投第９案,屏東縣,屏東市,安樂里,17,459,146,91,237,12,249
公投第９案,屏東縣,屏東市,平和里,18,672,291,98,389,25,414
公投第９案,屏東縣,屏東市,金泉里,19,668,254,126,380,43,423
公投第９案,屏東縣,屏東市,勝豐里,20,411,156,69,225,14,239
公投第９案,屏東縣,屏東市,橋南里,21,768,292,114,406,33,439
公投第９案,屏東縣,屏東市,橋南里,22,786,299,104,403,34,437
公投第９案,屏東縣,屏東市,橋北里,23,890,348,135,483,38,521
公投第９案,屏東縣,屏東市,大連里,24,1353,559,156,715,45,760
公投第９案,屏東縣,屏東市,大連里,25,1386,523,163,686,27,713
公投第９案,屏東縣,屏東市,大連里,26,1413,580,139,719,37,756
公投第９案,屏東縣,屏東市,大連里,27,1272,516,136,652,35,687
公投第９案,屏東縣,屏東市,大連里,28,1287,526,135,661,35,696
公投第９案,屏東縣,屏東市,大連里,29,1311,549,162,711,46,757
公投第９案,屏東縣,屏東市,大連里,30,1285,495,174,669,26,695
公投第９案,屏東縣,屏東市,豐田里,31,1297,521,157,678,53,731
公投第９案,屏東縣,屏東市,豐田里,32,1361,536,145,681,29,710
公投第９案,屏東縣,屏東市,豐田里,33,1381,525,144,669,42,711
公投第９案,屏東縣,屏東市,豐榮里,34,1258,530,153,683,55,738
公投第９案,屏東縣,屏東市,豐榮里,35,1259,484,167,651,58,709
公投第９案,屏東縣,屏東市,豐源里,36,1076,425,119,544,41,585
公投第９案,屏東縣,屏東市,豐源里,37,1162,484,147,631,33,664
公投第９案,屏東縣,屏東市,豐源里,38,1318,558,154,712,33,745
公投第９案,屏東縣,屏東市,長春里,39,939,386,60,446,38,484
公投第９案,屏東縣,屏東市,長春里,40,972,417,114,531,30,561
公投第９案,屏東縣,屏東市,瑞光里,41,1535,652,178,830,30,860
公投第９案,屏東縣,屏東市,瑞光里,42,1419,514,129,643,44,687
公投第９案,屏東縣,屏東市,瑞光里,43,1398,503,145,648,22,670
公投第９案,屏東縣,屏東市,瑞光里,44,1405,534,152,686,60,746
公投第９案,屏東縣,屏東市,瑞光里,45,1486,602,77,679,31,710
公投第９案,屏東縣,屏東市,湖南里,46,1061,406,123,529,62,591
公投第９案,屏東縣,屏東市,湖西里,47,1540,472,161,633,107,740
公投第９案,屏東縣,屏東市,歸心里,48,1141,356,132,488,20,508
公投第９案,屏東縣,屏東市,清溪里,49,1247,455,119,574,36,610
公投第９案,屏東縣,屏東市,清溪里,50,1446,550,142,692,38,730
公投第９案,屏東縣,屏東市,清溪里,51,1303,558,145,703,40,743
公投第９案,屏東縣,屏東市,大武里,52,1253,506,128,634,51,685
公投第９案,屏東縣,屏東市,大武里,53,1315,517,145,662,50,712
公投第９案,屏東縣,屏東市,大武里,54,1425,520,170,690,43,733
公投第９案,屏東縣,屏東市,大武里,55,1423,521,152,673,33,706
公投第９案,屏東縣,屏東市,大武里,56,1400,558,162,720,51,771
公投第９案,屏東縣,屏東市,大武里,57,1359,548,191,739,45,784
公投第９案,屏東縣,屏東市,崇武里,58,1328,593,95,688,27,715
公投第９案,屏東縣,屏東市,崇武里,59,1539,649,116,765,43,808
公投第９案,屏東縣,屏東市,凌雲里,60,391,105,2,107,4,111
公投第９案,屏東縣,屏東市,永昌里,61,200,79,27,106,11,117
公投第９案,屏東縣,屏東市,永順里,62,328,103,38,141,25,166
公投第９案,屏東縣,屏東市,鵬程里,63,231,94,23,117,4,121
公投第９案,屏東縣,屏東市,安鎮里,64,945,332,130,462,55,517
公投第９案,屏東縣,屏東市,安鎮里,65,1053,367,123,490,58,548
公投第９案,屏東縣,屏東市,永光里,66,1043,356,117,473,53,526
公投第９案,屏東縣,屏東市,長安里,67,1061,365,116,481,73,554
公投第９案,屏東縣,屏東市,長安里,68,876,289,124,413,41,454
公投第９案,屏東縣,屏東市,前進里,69,1468,481,177,658,111,769
公投第９案,屏東縣,屏東市,前進里,70,1454,486,161,647,66,713
公投第９案,屏東縣,屏東市,大洲里,71,1205,453,150,603,23,626
公投第９案,屏東縣,屏東市,新興里,72,1284,447,153,600,31,631
公投第９案,屏東縣,屏東市,新興里,73,1219,450,130,580,35,615
公投第９案,屏東縣,屏東市,公館里,74,1544,601,181,782,87,869
公投第９案,屏東縣,屏東市,新生里,75,1485,536,184,720,87,807
公投第９案,屏東縣,屏東市,新生里,76,1387,547,155,702,61,763
公投第９案,屏東縣,屏東市,新生里,77,953,358,88,446,35,481
公投第９案,屏東縣,屏東市,新生里,78,1603,605,222,827,52,879
公投第９案,屏東縣,屏東市,頂宅里,79,535,187,63,250,36,286
公投第９案,屏東縣,屏東市,頂柳里,80,1119,430,100,530,44,574
公投第９案,屏東縣,屏東市,大湖里,81,847,333,101,434,38,472
公投第９案,屏東縣,屏東市,大湖里,82,923,346,125,471,73,544
公投第９案,屏東縣,屏東市,龍華里,83,1227,441,127,568,41,609
公投第９案,屏東縣,屏東市,龍華里,84,1039,388,125,513,52,565
公投第９案,屏東縣,屏東市,玉成里,85,1485,507,182,689,97,786
公投第９案,屏東縣,屏東市,擇仁里,86,867,321,95,416,57,473
公投第９案,屏東縣,屏東市,建國里,87,918,376,104,480,39,519
公投第９案,屏東縣,屏東市,萬年里,88,663,216,78,294,49,343
公投第９案,屏東縣,屏東市,厚生里,89,1215,397,134,531,18,549
公投第９案,屏東縣,屏東市,厚生里,90,1628,520,192,712,85,797
公投第９案,屏東縣,屏東市,一心里,91,1209,508,121,629,42,671
公投第９案,屏東縣,屏東市,義勇里,92,1110,550,123,673,23,696
公投第９案,屏東縣,屏東市,光華里,93,684,223,78,301,21,322
公投第９案,屏東縣,屏東市,永安里,94,1349,428,103,531,32,563
公投第９案,屏東縣,屏東市,永安里,95,1457,623,37,660,57,717
公投第９案,屏東縣,屏東市,永安里,96,1447,581,162,743,49,792
公投第９案,屏東縣,屏東市,永安里,97,1354,473,157,630,28,658
公投第９案,屏東縣,屏東市,永安里,98,1583,609,201,810,72,882
公投第９案,屏東縣,屏東市,崇蘭里,99,1707,675,155,830,25,855
公投第９案,屏東縣,屏東市,崇蘭里,100,1637,697,56,753,27,780
公投第９案,屏東縣,屏東市,崇蘭里,101,1459,547,138,685,11,696
公投第９案,屏東縣,屏東市,崇蘭里,102,1759,740,205,945,47,992
公投第９案,屏東縣,屏東市,崇蘭里,103,1950,808,160,968,33,1001
公投第９案,屏東縣,屏東市,崇蘭里,104,1729,791,79,870,50,920
公投第９案,屏東縣,屏東市,崇蘭里,105,1592,601,158,759,25,784
公投第９案,屏東縣,屏東市,潭墘里,106,1437,549,135,684,38,722
公投第９案,屏東縣,屏東市,潭墘里,107,1204,474,94,568,31,599
公投第９案,屏東縣,屏東市,潭墘里,108,1340,557,139,696,38,734
公投第９案,屏東縣,屏東市,潭墘里,109,1322,534,146,680,37,717
公投第９案,屏東縣,屏東市,潭墘里,110,1462,565,127,692,39,731
公投第９案,屏東縣,屏東市,潭墘里,111,3241,1259,261,1520,48,1568
公投第９案,屏東縣,屏東市,潭墘里,112,1477,569,118,687,30,717
公投第９案,屏東縣,屏東市,永城里,113,821,293,72,365,24,389
公投第９案,屏東縣,屏東市,永城里,114,1099,318,108,426,21,447
公投第９案,屏東縣,屏東市,空翔里,115,1688,676,142,818,47,865
公投第９案,屏東縣,屏東市,廣興里,116,1167,408,130,538,45,583
公投第９案,屏東縣,屏東市,廣興里,117,915,323,114,437,52,489
公投第９案,屏東縣,屏東市,勝利里,118,1683,387,94,481,42,523
公投第９案,屏東縣,屏東市,勝利里,119,1497,568,142,710,21,731
公投第９案,屏東縣,屏東市,勝利里,120,1129,404,133,537,26,563
公投第９案,屏東縣,屏東市,勝利里,121,1232,509,120,629,39,668
公投第９案,屏東縣,屏東市,斯文里,122,853,324,106,430,26,456
公投第９案,屏東縣,屏東市,斯文里,123,869,373,112,485,18,503
公投第９案,屏東縣,屏東市,華山里,124,1169,494,129,623,46,669
公投第９案,屏東縣,屏東市,華山里,125,1058,444,115,559,26,585
公投第９案,屏東縣,屏東市,華山里,126,1344,512,124,636,36,672
公投第９案,屏東縣,屏東市,華山里,127,1299,577,136,713,25,738
公投第９案,屏東縣,屏東市,溝美里,128,1204,420,121,541,32,573
公投第９案,屏東縣,屏東市,溝美里,129,1123,426,123,549,33,582
公投第９案,屏東縣,屏東市,三山里,130,1318,417,132,549,39,588
公投第９案,屏東縣,屏東市,海豐里,131,865,334,120,454,60,514
公投第９案,屏東縣,屏東市,仁義里,132,1100,350,100,450,27,477
公投第９案,屏東縣,屏東市,北興里,133,1215,416,114,530,33,563
公投第９案,屏東縣,屏東市,北興里,134,1370,555,128,683,42,725
公投第９案,屏東縣,屏東市,北興里,135,1240,488,122,610,15,625
公投第９案,屏東縣,屏東市,北興里,136,1168,479,143,622,45,667
公投第９案,屏東縣,屏東市,北興里,137,1079,453,121,574,3,577
公投第９案,屏東縣,屏東市,北勢里,138,1289,541,148,689,49,738
公投第９案,屏東縣,屏東市,北勢里,139,1115,413,136,549,29,578
公投第９案,屏東縣,屏東市,中正里,140,1491,585,204,789,47,836
公投第９案,屏東縣,屏東市,中正里,141,1411,505,133,638,39,677
公投第９案,屏東縣,屏東市,中正里,142,1803,675,185,860,33,893
公投第９案,屏東縣,屏東市,興樂里,143,744,314,85,399,27,426
公投第９案,屏東縣,屏東市,明正里,144,678,260,77,337,28,365
公投第９案,屏東縣,屏東市,太平里,145,681,271,87,358,35,393
公投第９案,屏東縣,屏東市,信和里,146,1535,88,136,224,32,256
公投第９案,屏東縣,屏東市,和興里,147,954,355,121,476,77,553
公投第９案,屏東縣,屏東市,仁愛里,148,1018,448,121,569,35,604
公投第９案,屏東縣,屏東市,仁愛里,149,1154,488,133,621,31,652
公投第９案,屏東縣,潮州鎮,潮州里,150,504,203,65,268,37,305
公投第９案,屏東縣,潮州鎮,光華里,151,1711,559,187,746,56,802
公投第９案,屏東縣,潮州鎮,光華里,152,1634,580,200,780,28,808
公投第９案,屏東縣,潮州鎮,光華里,153,1414,483,136,619,29,648
公投第９案,屏東縣,潮州鎮,同榮里,154,603,220,108,328,47,375
公投第９案,屏東縣,潮州鎮,彭城里,155,896,319,105,424,63,487
公投第９案,屏東縣,潮州鎮,三星里,156,1285,458,159,617,58,675
公投第９案,屏東縣,潮州鎮,三星里,157,1744,658,154,812,70,882
公投第９案,屏東縣,潮州鎮,三星里,158,1071,436,145,581,46,627
公投第９案,屏東縣,潮州鎮,三星里,159,1209,439,204,643,66,709
公投第９案,屏東縣,潮州鎮,三共里,160,1159,429,132,561,46,607
公投第９案,屏東縣,潮州鎮,三共里,161,1296,408,145,553,54,607
公投第９案,屏東縣,潮州鎮,三共里,162,1466,586,154,740,45,785
公投第９案,屏東縣,潮州鎮,三共里,163,1130,447,144,591,54,645
公投第９案,屏東縣,潮州鎮,三共里,164,1439,550,176,726,47,773
公投第９案,屏東縣,潮州鎮,三和里,165,897,380,89,469,53,522
公投第９案,屏東縣,潮州鎮,三和里,166,1225,508,128,636,49,685
公投第９案,屏東縣,潮州鎮,九塊里,167,1158,400,137,537,48,585
公投第９案,屏東縣,潮州鎮,九塊里,168,481,121,56,177,39,216
公投第９案,屏東縣,潮州鎮,新生里,169,972,422,71,493,53,546
公投第９案,屏東縣,潮州鎮,新榮里,170,1245,513,169,682,50,732
公投第９案,屏東縣,潮州鎮,五魁里,171,1415,518,172,690,52,742
公投第９案,屏東縣,潮州鎮,蓬萊里,172,1255,408,111,519,17,536
公投第９案,屏東縣,潮州鎮,蓬萊里,173,1058,268,103,371,30,401
公投第９案,屏東縣,潮州鎮,八爺里,174,1187,450,125,575,35,610
公投第９案,屏東縣,潮州鎮,八爺里,175,1083,439,102,541,65,606
公投第９案,屏東縣,潮州鎮,永春里,176,1590,559,147,706,40,746
公投第９案,屏東縣,潮州鎮,永春里,177,1543,510,171,681,66,747
公投第９案,屏東縣,潮州鎮,永春里,178,1631,577,185,762,46,808
公投第９案,屏東縣,潮州鎮,永春里,179,1159,474,114,588,35,623
公投第９案,屏東縣,潮州鎮,永春里,180,1099,433,143,576,41,617
公投第９案,屏東縣,潮州鎮,富春里,181,1200,404,136,540,57,597
公投第９案,屏東縣,潮州鎮,光春里,182,1391,502,137,639,65,704
公投第９案,屏東縣,潮州鎮,興美里,183,881,333,109,442,65,507
公投第９案,屏東縣,潮州鎮,檨子里,184,454,115,52,167,27,194
公投第９案,屏東縣,潮州鎮,泗林里,185,1658,561,219,780,95,875
公投第９案,屏東縣,潮州鎮,四春里,186,822,262,87,349,36,385
公投第９案,屏東縣,潮州鎮,四春里,187,948,264,105,369,20,389
公投第９案,屏東縣,潮州鎮,崙東里,188,1194,334,110,444,32,476
公投第９案,屏東縣,潮州鎮,崙東里,189,337,116,40,156,35,191
公投第９案,屏東縣,東港鎮,新勝里,190,981,450,80,530,66,596
公投第９案,屏東縣,東港鎮,新勝里,191,1070,406,155,561,68,629
公投第９案,屏東縣,東港鎮,頂新里,192,527,222,67,289,52,341
公投第９案,屏東縣,東港鎮,頂中里,193,395,144,64,208,29,237
公投第９案,屏東縣,東港鎮,東和里,194,659,224,67,291,47,338
公投第９案,屏東縣,東港鎮,興台里,195,513,177,72,249,26,275
公投第９案,屏東縣,東港鎮,興東里,196,1732,609,206,815,66,881
公投第９案,屏東縣,東港鎮,興東里,197,1779,710,187,897,52,949
公投第９案,屏東縣,東港鎮,興東里,198,1270,434,152,586,57,643
公投第９案,屏東縣,東港鎮,興東里,199,1327,472,159,631,56,687
公投第９案,屏東縣,東港鎮,興東里,200,1242,477,151,628,65,693
公投第９案,屏東縣,東港鎮,興東里,201,1607,649,132,781,99,880
公投第９案,屏東縣,東港鎮,興農里,202,1305,444,133,577,40,617
公投第９案,屏東縣,東港鎮,中興里,203,695,260,95,355,36,391
公投第９案,屏東縣,東港鎮,朝安里,204,1076,412,157,569,91,660
公投第９案,屏東縣,東港鎮,朝安里,205,567,182,70,252,36,288
公投第９案,屏東縣,東港鎮,八德里,206,806,262,90,352,48,400
公投第９案,屏東縣,東港鎮,東隆里,207,1227,452,154,606,77,683
公投第９案,屏東縣,東港鎮,豐漁里,208,599,187,72,259,62,321
公投第９案,屏東縣,東港鎮,盛漁里,209,1354,362,142,504,46,550
公投第９案,屏東縣,東港鎮,興漁里,210,734,230,88,318,70,388
公投第９案,屏東縣,東港鎮,興漁里,211,1107,361,148,509,126,635
公投第９案,屏東縣,東港鎮,鎮海里,212,1198,380,119,499,93,592
公投第９案,屏東縣,東港鎮,鎮海里,213,1614,503,181,684,137,821
公投第９案,屏東縣,東港鎮,嘉蓮里,214,826,289,84,373,47,420
公投第９案,屏東縣,東港鎮,嘉蓮里,215,912,330,115,445,72,517
公投第９案,屏東縣,東港鎮,南平里,216,432,117,56,173,52,225
公投第９案,屏東縣,東港鎮,南平里,217,1204,394,165,559,123,682
公投第９案,屏東縣,東港鎮,船頭里,218,1304,492,170,662,61,723
公投第９案,屏東縣,東港鎮,船頭里,219,1317,517,163,680,66,746
公投第９案,屏東縣,東港鎮,船頭里,220,1387,505,146,651,51,702
公投第９案,屏東縣,東港鎮,船頭里,221,1310,426,127,553,42,595
公投第９案,屏東縣,東港鎮,下廍里,222,1228,388,147,535,49,584
公投第９案,屏東縣,東港鎮,下廍里,223,766,215,102,317,56,373
公投第９案,屏東縣,東港鎮,大潭里,224,823,280,123,403,67,470
公投第９案,屏東縣,東港鎮,大潭里,225,755,192,52,244,22,266
公投第９案,屏東縣,東港鎮,興和里,226,1094,389,149,538,84,622
公投第９案,屏東縣,東港鎮,共和里,227,753,265,77,342,27,369
公投第９案,屏東縣,恆春鎮,城南里,228,902,309,95,404,33,437
公投第９案,屏東縣,恆春鎮,城北里,229,969,394,121,515,38,553
公投第９案,屏東縣,恆春鎮,城北里,230,1280,485,94,579,46,625
公投第９案,屏東縣,恆春鎮,城西里,231,1133,442,133,575,31,606
公投第９案,屏東縣,恆春鎮,網紗里,232,1552,482,118,600,18,618
公投第９案,屏東縣,恆春鎮,網紗里,233,1485,421,138,559,55,614
公投第９案,屏東縣,恆春鎮,仁壽里,234,896,311,134,445,36,481
公投第９案,屏東縣,恆春鎮,茄湖里,235,531,154,65,219,26,245
公投第９案,屏東縣,恆春鎮,頭溝里,236,478,141,55,196,14,210
公投第９案,屏東縣,恆春鎮,四溝里,237,1020,322,127,449,40,489
公投第９案,屏東縣,恆春鎮,德和里,238,924,272,137,409,23,432
公投第９案,屏東縣,恆春鎮,龍水里,239,1079,320,101,421,19,440
公投第９案,屏東縣,恆春鎮,山海里,240,775,186,66,252,25,277
公投第９案,屏東縣,恆春鎮,山海里,241,813,299,85,384,48,432
公投第９案,屏東縣,恆春鎮,大光里,242,1104,364,104,468,51,519
公投第９案,屏東縣,恆春鎮,大光里,243,1110,299,139,438,56,494
公投第９案,屏東縣,恆春鎮,水泉里,244,692,162,73,235,62,297
公投第９案,屏東縣,恆春鎮,水泉里,245,708,173,57,230,7,237
公投第９案,屏東縣,恆春鎮,山腳里,246,1505,511,161,672,35,707
公投第９案,屏東縣,恆春鎮,山腳里,247,1111,359,107,466,48,514
公投第９案,屏東縣,恆春鎮,山腳里,248,1543,525,132,657,42,699
公投第９案,屏東縣,恆春鎮,南灣里,249,828,216,80,296,21,317
公投第９案,屏東縣,恆春鎮,南灣里,250,844,301,110,411,30,441
公投第９案,屏東縣,恆春鎮,墾丁里,251,1253,418,138,556,47,603
公投第９案,屏東縣,恆春鎮,鵝鑾里,252,1126,372,98,470,43,513
公投第９案,屏東縣,萬丹鄉,香社村,253,1527,407,129,536,59,595
公投第９案,屏東縣,萬丹鄉,新庄村,254,1147,390,103,493,71,564
公投第９案,屏東縣,萬丹鄉,新庄村,255,949,292,106,398,47,445
公投第９案,屏東縣,萬丹鄉,新鐘村,256,990,326,119,445,30,475
公投第９案,屏東縣,萬丹鄉,新鐘村,257,1022,311,92,403,14,417
公投第９案,屏東縣,萬丹鄉,水仙村,258,545,229,80,309,58,367
公投第９案,屏東縣,萬丹鄉,興全村,259,1159,442,136,578,93,671
公投第９案,屏東縣,萬丹鄉,興安村,260,837,302,122,424,72,496
公投第９案,屏東縣,萬丹鄉,甘棠村,261,392,134,48,182,15,197
公投第９案,屏東縣,萬丹鄉,萬惠村,262,847,334,120,454,31,485
公投第９案,屏東縣,萬丹鄉,萬全村,263,1149,403,130,533,47,580
公投第９案,屏東縣,萬丹鄉,萬全村,264,1131,438,117,555,51,606
公投第９案,屏東縣,萬丹鄉,萬全村,265,1178,409,148,557,50,607
公投第９案,屏東縣,萬丹鄉,萬後村,266,711,289,98,387,39,426
公投第９案,屏東縣,萬丹鄉,萬安村,267,595,235,84,319,28,347
公投第９案,屏東縣,萬丹鄉,萬生村,268,1403,573,162,735,64,799
公投第９案,屏東縣,萬丹鄉,寶厝村,269,1094,400,99,499,34,533
公投第９案,屏東縣,萬丹鄉,寶厝村,270,1158,445,142,587,45,632
公投第９案,屏東縣,萬丹鄉,四維村,271,963,362,185,547,53,600
公投第９案,屏東縣,萬丹鄉,四維村,272,1062,371,131,502,59,561
公投第９案,屏東縣,萬丹鄉,竹林村,273,1684,575,208,783,107,890
公投第９案,屏東縣,萬丹鄉,水泉村,274,1702,586,151,737,50,787
公投第９案,屏東縣,萬丹鄉,田厝村,275,976,312,146,458,49,507
公投第９案,屏東縣,萬丹鄉,崙頂村,276,1013,354,138,492,64,556
公投第９案,屏東縣,萬丹鄉,崙頂村,277,847,223,116,339,41,380
公投第９案,屏東縣,萬丹鄉,厦北村,278,1570,580,203,783,129,912
公投第９案,屏東縣,萬丹鄉,厦南村,279,1411,473,140,613,78,691
公投第９案,屏東縣,萬丹鄉,後村村,280,1046,382,145,527,73,600
公投第９案,屏東縣,萬丹鄉,灣內村,281,1385,423,171,594,36,630
公投第９案,屏東縣,萬丹鄉,上村村,282,804,282,104,386,59,445
公投第９案,屏東縣,萬丹鄉,加興村,283,1284,440,172,612,79,691
公投第９案,屏東縣,萬丹鄉,社口村,284,1430,585,58,643,58,701
公投第９案,屏東縣,萬丹鄉,磚寮村,285,960,400,129,529,68,597
公投第９案,屏東縣,萬丹鄉,社皮村,286,786,315,113,428,48,476
公投第９案,屏東縣,萬丹鄉,社皮村,287,1158,383,175,558,91,649
公投第９案,屏東縣,萬丹鄉,社中村,288,1647,493,152,645,64,709
公投第９案,屏東縣,萬丹鄉,社上村,289,1666,532,155,687,83,770
公投第９案,屏東縣,萬丹鄉,廣安村,290,1023,392,150,542,80,622
公投第９案,屏東縣,萬丹鄉,廣安村,291,1227,496,152,648,65,713
公投第９案,屏東縣,長治鄉,進興村,292,1018,375,128,503,68,571
公投第９案,屏東縣,長治鄉,進興村,293,1614,598,197,795,83,878
公投第９案,屏東縣,長治鄉,新潭村,294,1848,742,217,959,88,1047
公投第９案,屏東縣,長治鄉,新潭村,295,1707,666,209,875,77,952
公投第９案,屏東縣,長治鄉,潭頭村,296,972,401,109,510,40,550
公投第９案,屏東縣,長治鄉,潭頭村,297,989,383,122,505,63,568
公投第９案,屏東縣,長治鄉,香楊村,298,735,280,110,390,55,445
公投第９案,屏東縣,長治鄉,香楊村,299,1813,611,220,831,62,893
公投第９案,屏東縣,長治鄉,長興村,300,1073,446,149,595,53,648
公投第９案,屏東縣,長治鄉,崙上村,301,1654,697,98,795,78,873
公投第９案,屏東縣,長治鄉,德榮村,302,1205,434,174,608,73,681
公投第９案,屏東縣,長治鄉,德和村,303,758,279,106,385,46,431
公投第９案,屏東縣,長治鄉,復興村,304,1492,500,210,710,97,807
公投第９案,屏東縣,長治鄉,德成村,305,884,341,103,444,59,503
公投第９案,屏東縣,長治鄉,德協村,306,1090,423,129,552,70,622
公投第９案,屏東縣,長治鄉,繁榮村,307,1422,307,268,575,108,683
公投第９案,屏東縣,長治鄉,繁昌村,308,845,286,111,397,64,461
公投第９案,屏東縣,長治鄉,繁昌村,309,925,304,123,427,99,526
公投第９案,屏東縣,長治鄉,繁隆村,310,1138,401,115,516,98,614
公投第９案,屏東縣,長治鄉,繁華村,311,1242,428,149,577,113,690
公投第９案,屏東縣,長治鄉,繁華村,312,1159,332,99,431,22,453
公投第９案,屏東縣,長治鄉,榮華村,313,673,261,104,365,37,402
公投第９案,屏東縣,麟洛鄉,新田村,314,788,315,93,408,37,445
公投第９案,屏東縣,麟洛鄉,新田村,315,1386,592,170,762,28,790
公投第９案,屏東縣,麟洛鄉,麟頂村,316,957,405,119,524,53,577
公投第９案,屏東縣,麟洛鄉,麟蹄村,317,731,305,87,392,51,443
公投第９案,屏東縣,麟洛鄉,麟蹄村,318,806,341,104,445,59,504
公投第９案,屏東縣,麟洛鄉,麟趾村,319,1207,403,135,538,17,555
公投第９案,屏東縣,麟洛鄉,麟趾村,320,1340,573,154,727,80,807
公投第９案,屏東縣,麟洛鄉,田中村,321,1221,466,172,638,64,702
公投第９案,屏東縣,麟洛鄉,田心村,322,851,307,95,402,19,421
公投第９案,屏東縣,麟洛鄉,田道村,323,683,231,79,310,15,325
公投第９案,屏東縣,九如鄉,九清村,324,1491,567,188,755,81,836
公投第９案,屏東縣,九如鄉,九塊村,325,1375,497,163,660,73,733
公投第９案,屏東縣,九如鄉,九明村,326,1678,597,143,740,51,791
公投第９案,屏東縣,九如鄉,大坵村,327,1166,449,144,593,85,678
公投第９案,屏東縣,九如鄉,玉水村,328,1276,359,132,491,56,547
公投第９案,屏東縣,九如鄉,玉泉村,329,1033,391,111,502,76,578
公投第９案,屏東縣,九如鄉,玉泉村,330,577,281,82,363,34,397
公投第９案,屏東縣,九如鄉,東寧村,331,649,240,91,331,67,398
公投第９案,屏東縣,九如鄉,東寧村,332,1999,699,239,938,151,1089
公投第９案,屏東縣,九如鄉,東寧村,333,1766,639,189,828,92,920
公投第９案,屏東縣,九如鄉,三塊村,334,1600,507,199,706,118,824
公投第９案,屏東縣,九如鄉,耆老村,335,1248,435,154,589,91,680
公投第９案,屏東縣,九如鄉,後庄村,336,1792,595,243,838,199,1037
公投第９案,屏東縣,九如鄉,洽興村,337,1482,533,175,708,102,810
公投第９案,屏東縣,里港鄉,玉田村,338,1552,619,197,816,94,910
公投第９案,屏東縣,里港鄉,玉田村,339,1480,538,174,712,76,788
公投第９案,屏東縣,里港鄉,塔樓村,340,1534,430,192,622,55,677
公投第９案,屏東縣,里港鄉,潮厝村,341,1578,549,188,737,113,850
公投第９案,屏東縣,里港鄉,大平村,342,1127,451,165,616,61,677
公投第９案,屏東縣,里港鄉,永春村,343,845,339,97,436,56,492
公投第９案,屏東縣,里港鄉,春林村,344,1282,450,151,601,64,665
公投第９案,屏東縣,里港鄉,過江村,345,981,388,123,511,56,567
公投第９案,屏東縣,里港鄉,過江村,346,1031,384,135,519,75,594
公投第９案,屏東縣,里港鄉,鐵店村,347,1423,493,200,693,107,800
公投第９案,屏東縣,里港鄉,茄苳村,348,363,94,46,140,26,166
公投第９案,屏東縣,里港鄉,茄苳村,349,1203,400,166,566,131,697
公投第９案,屏東縣,里港鄉,載興村,350,1027,401,161,562,72,634
公投第９案,屏東縣,里港鄉,載興村,351,1384,430,155,585,61,646
公投第９案,屏東縣,里港鄉,土庫村,352,1512,526,159,685,92,777
公投第９案,屏東縣,里港鄉,土庫村,353,522,241,47,288,20,308
公投第９案,屏東縣,里港鄉,三廍村,354,822,287,104,391,68,459
公投第９案,屏東縣,里港鄉,三廍村,355,1007,296,137,433,97,530
公投第９案,屏東縣,里港鄉,中和村,356,956,317,152,469,68,537
公投第９案,屏東縣,里港鄉,瀰力村,357,499,195,62,257,25,282
公投第９案,屏東縣,鹽埔鄉,鹽北村,358,951,350,89,439,35,474
公投第９案,屏東縣,鹽埔鄉,鹽北村,359,899,292,103,395,29,424
公投第９案,屏東縣,鹽埔鄉,鹽中村,360,1116,334,98,432,36,468
公投第９案,屏東縣,鹽埔鄉,鹽中村,361,1241,441,132,573,48,621
公投第９案,屏東縣,鹽埔鄉,鹽南村,362,770,251,84,335,53,388
公投第９案,屏東縣,鹽埔鄉,鹽南村,363,962,354,97,451,51,502
公投第９案,屏東縣,鹽埔鄉,仕絨村,364,1041,429,130,559,71,630
公投第９案,屏東縣,鹽埔鄉,高朗村,365,1367,458,177,635,73,708
公投第９案,屏東縣,鹽埔鄉,高朗村,366,1465,459,138,597,65,662
公投第９案,屏東縣,鹽埔鄉,振興村,367,894,252,111,363,54,417
公投第９案,屏東縣,鹽埔鄉,振興村,368,958,290,104,394,4,398
公投第９案,屏東縣,鹽埔鄉,久愛村,369,924,303,98,401,90,491
公投第９案,屏東縣,鹽埔鄉,新圍村,370,1598,498,143,641,44,685
公投第９案,屏東縣,鹽埔鄉,新圍村,371,1550,500,215,715,114,829
公投第９案,屏東縣,鹽埔鄉,新二村,372,1127,406,122,528,73,601
公投第９案,屏東縣,鹽埔鄉,新二村,373,1150,437,152,589,80,669
公投第９案,屏東縣,鹽埔鄉,新二村,374,1233,453,157,610,65,675
公投第９案,屏東縣,鹽埔鄉,彭厝村,375,984,433,121,554,37,591
公投第９案,屏東縣,鹽埔鄉,洛陽村,376,1619,546,237,783,71,854
公投第９案,屏東縣,鹽埔鄉,永隆村,377,553,196,76,272,33,305
公投第９案,屏東縣,高樹鄉,高樹村,378,883,331,126,457,88,545
公投第９案,屏東縣,高樹鄉,高樹村,379,1255,311,117,428,29,457
公投第９案,屏東縣,高樹鄉,長榮村,380,1278,412,156,568,38,606
公投第９案,屏東縣,高樹鄉,東興村,381,738,217,72,289,28,317
公投第９案,屏東縣,高樹鄉,東振村,382,585,167,68,235,14,249
公投第９案,屏東縣,高樹鄉,源泉村,383,1012,330,124,454,134,588
公投第９案,屏東縣,高樹鄉,建興村,384,1148,352,122,474,89,563
公投第９案,屏東縣,高樹鄉,大埔村,385,591,173,82,255,40,295
公投第９案,屏東縣,高樹鄉,菜寮村,386,786,221,74,295,58,353
公投第９案,屏東縣,高樹鄉,司馬村,387,649,181,59,240,24,264
公投第９案,屏東縣,高樹鄉,舊寮村,388,1229,303,120,423,78,501
公投第９案,屏東縣,高樹鄉,新豐村,389,1446,392,125,517,68,585
公投第９案,屏東縣,高樹鄉,泰山村,390,899,218,107,325,15,340
公投第９案,屏東縣,高樹鄉,泰山村,391,922,294,116,410,62,472
公投第９案,屏東縣,高樹鄉,南華村,392,1259,379,135,514,73,587
公投第９案,屏東縣,高樹鄉,廣福村,393,1056,273,81,354,28,382
公投第９案,屏東縣,高樹鄉,廣興村,394,1116,384,143,527,74,601
公投第９案,屏東縣,高樹鄉,舊庄村,395,1020,361,133,494,89,583
公投第９案,屏東縣,高樹鄉,田子村,396,1055,341,140,481,92,573
公投第９案,屏東縣,高樹鄉,鹽樹村,397,738,267,108,375,48,423
公投第９案,屏東縣,高樹鄉,鹽樹村,398,493,147,46,193,27,220
公投第９案,屏東縣,高樹鄉,新南村,399,1539,552,196,748,108,856
公投第９案,屏東縣,萬巒鄉,萬巒村,400,1239,385,147,532,40,572
公投第９案,屏東縣,萬巒鄉,萬全村,401,759,270,97,367,58,425
公投第９案,屏東縣,萬巒鄉,萬和村,402,932,342,112,454,93,547
公投第９案,屏東縣,萬巒鄉,萬和村,403,769,307,94,401,62,463
公投第９案,屏東縣,萬巒鄉,鹿寮村,404,920,313,116,429,73,502
公投第９案,屏東縣,萬巒鄉,硫黃村,405,560,210,77,287,39,326
公投第９案,屏東縣,萬巒鄉,泗溝村,406,1120,359,111,470,29,499
公投第９案,屏東縣,萬巒鄉,五溝村,407,1048,350,103,453,31,484
公投第９案,屏東縣,萬巒鄉,成德村,408,1438,437,133,570,47,617
公投第９案,屏東縣,萬巒鄉,赤山村,409,834,244,109,353,63,416
公投第９案,屏東縣,萬巒鄉,赤山村,410,813,245,103,348,75,423
公投第９案,屏東縣,萬巒鄉,萬金村,411,1020,285,99,384,47,431
公投第９案,屏東縣,萬巒鄉,萬金村,412,1007,362,135,497,80,577
公投第９案,屏東縣,萬巒鄉,佳佐村,413,1648,466,168,634,95,729
公投第９案,屏東縣,萬巒鄉,佳和村,414,1437,487,167,654,67,721
公投第９案,屏東縣,萬巒鄉,新厝村,415,1228,355,122,477,22,499
公投第９案,屏東縣,萬巒鄉,新置村,416,597,248,59,307,53,360
公投第９案,屏東縣,萬巒鄉,新置村,417,576,186,76,262,52,314
公投第９案,屏東縣,內埔鄉,內埔村,418,1305,422,136,558,39,597
公投第９案,屏東縣,內埔鄉,內埔村,419,1287,414,121,535,38,573
公投第９案,屏東縣,內埔鄉,內埔村,420,1387,471,134,605,17,622
公投第９案,屏東縣,內埔鄉,內田村,421,1540,515,142,657,53,710
公投第９案,屏東縣,內埔鄉,內田村,422,1605,541,157,698,53,751
公投第９案,屏東縣,內埔鄉,興南村,423,1326,457,141,598,56,654
公投第９案,屏東縣,內埔鄉,義亭村,424,591,201,83,284,50,334
公投第９案,屏東縣,內埔鄉,美和村,425,1123,363,117,480,47,527
公投第９案,屏東縣,內埔鄉,美和村,426,1079,372,115,487,21,508
公投第９案,屏東縣,內埔鄉,和興村,427,1485,530,165,695,71,766
公投第９案,屏東縣,內埔鄉,和興村,428,1248,534,121,655,44,699
公投第９案,屏東縣,內埔鄉,東寧村,429,1569,572,161,733,50,783
公投第９案,屏東縣,內埔鄉,東寧村,430,1493,485,164,649,61,710
公投第９案,屏東縣,內埔鄉,東寧村,431,1420,457,114,571,22,593
公投第９案,屏東縣,內埔鄉,豐田村,432,1334,472,137,609,83,692
公投第９案,屏東縣,內埔鄉,豐田村,433,1519,493,168,661,77,738
公投第９案,屏東縣,內埔鄉,振豐村,434,784,281,86,367,54,421
公投第９案,屏東縣,內埔鄉,振豐村,435,888,325,107,432,69,501
公投第９案,屏東縣,內埔鄉,富田村,436,747,187,56,243,15,258
公投第９案,屏東縣,內埔鄉,富田村,437,1168,310,114,424,29,453
公投第９案,屏東縣,內埔鄉,竹圍村,438,546,197,74,271,41,312
公投第９案,屏東縣,內埔鄉,竹圍村,439,1278,444,138,582,55,637
公投第９案,屏東縣,內埔鄉,東勢村,440,1348,383,143,526,50,576
公投第９案,屏東縣,內埔鄉,東勢村,441,1550,423,136,559,89,648
公投第９案,屏東縣,內埔鄉,東片村,442,947,364,128,492,82,574
公投第９案,屏東縣,內埔鄉,上樹村,443,1097,354,134,488,77,565
公投第９案,屏東縣,內埔鄉,老埤村,444,1128,290,137,427,48,475
公投第９案,屏東縣,內埔鄉,老埤村,445,1253,283,98,381,24,405
公投第９案,屏東縣,內埔鄉,中林村,446,1525,390,127,517,31,548
公投第９案,屏東縣,內埔鄉,龍泉村,447,1215,407,143,550,87,637
公投第９案,屏東縣,內埔鄉,龍泉村,448,1216,377,93,470,24,494
公投第９案,屏東縣,內埔鄉,龍潭村,449,1353,437,112,549,34,583
公投第９案,屏東縣,內埔鄉,龍潭村,450,1026,342,100,442,44,486
公投第９案,屏東縣,內埔鄉,建興村,451,862,267,79,346,30,376
公投第９案,屏東縣,內埔鄉,大新村,452,921,228,103,331,25,356
公投第９案,屏東縣,內埔鄉,大新村,453,854,285,93,378,24,402
公投第９案,屏東縣,內埔鄉,黎明村,454,1230,362,109,471,44,515
公投第９案,屏東縣,內埔鄉,黎明村,455,1204,349,112,461,21,482
公投第９案,屏東縣,內埔鄉,隘寮村,456,1301,387,105,492,40,532
公投第９案,屏東縣,內埔鄉,水門村,457,806,319,83,402,45,447
公投第９案,屏東縣,竹田鄉,竹田村,458,1503,561,182,743,92,835
公投第９案,屏東縣,竹田鄉,竹南村,459,899,391,119,510,44,554
公投第９案,屏東縣,竹田鄉,糶糴村,460,716,298,105,403,47,450
公投第９案,屏東縣,竹田鄉,履豐村,461,581,232,104,336,46,382
公投第９案,屏東縣,竹田鄉,頭崙村,462,1327,462,168,630,110,740
公投第９案,屏東縣,竹田鄉,二崙村,463,997,372,165,537,83,620
公投第９案,屏東縣,竹田鄉,美崙村,464,649,239,82,321,22,343
公投第９案,屏東縣,竹田鄉,南勢村,465,476,247,70,317,28,345
公投第９案,屏東縣,竹田鄉,西勢村,466,1259,500,171,671,64,735
公投第９案,屏東縣,竹田鄉,西勢村,467,1227,433,140,573,68,641
公投第９案,屏東縣,竹田鄉,福田村,468,504,219,58,277,45,322
公投第９案,屏東縣,竹田鄉,永豐村,469,860,308,102,410,52,462
公投第９案,屏東縣,竹田鄉,六巷村,470,800,306,83,389,17,406
公投第９案,屏東縣,竹田鄉,泗洲村,471,1134,435,155,590,63,653
公投第９案,屏東縣,竹田鄉,大湖村,472,1229,437,175,612,65,677
公投第９案,屏東縣,竹田鄉,鳳明村,473,1192,430,124,554,63,617
公投第９案,屏東縣,新埤鄉,新埤村,474,1712,568,158,726,50,776
公投第９案,屏東縣,新埤鄉,新埤村,475,314,107,42,149,24,173
公投第９案,屏東縣,新埤鄉,建功村,476,752,269,99,368,38,406
公投第９案,屏東縣,新埤鄉,建功村,477,334,116,45,161,22,183
公投第９案,屏東縣,新埤鄉,打鐵村,478,957,360,122,482,54,536
公投第９案,屏東縣,新埤鄉,南豐村,479,764,279,112,391,60,451
公投第９案,屏東縣,新埤鄉,萬隆村,480,373,116,63,179,34,213
公投第９案,屏東縣,新埤鄉,萬隆村,481,678,203,77,280,34,314
公投第９案,屏東縣,新埤鄉,萬隆村,482,701,216,65,281,31,312
公投第９案,屏東縣,新埤鄉,餉潭村,483,1323,323,147,470,64,534
公投第９案,屏東縣,新埤鄉,箕湖村,484,541,188,74,262,47,309
公投第９案,屏東縣,新埤鄉,箕湖村,485,584,177,54,231,32,263
公投第９案,屏東縣,枋寮鄉,枋寮村,486,1213,463,141,604,76,680
公投第９案,屏東縣,枋寮鄉,新龍村,487,891,324,111,435,77,512
公投第９案,屏東縣,枋寮鄉,保生村,488,970,292,118,410,87,497
公投第９案,屏東縣,枋寮鄉,中寮村,489,629,232,72,304,32,336
公投第９案,屏東縣,枋寮鄉,安樂村,490,840,313,115,428,48,476
公投第９案,屏東縣,枋寮鄉,安樂村,491,774,295,100,395,41,436
公投第９案,屏東縣,枋寮鄉,隆山村,492,1379,454,179,633,83,716
公投第９案,屏東縣,枋寮鄉,隆山村,493,1502,567,172,739,76,815
公投第９案,屏東縣,枋寮鄉,隆山村,494,1276,418,150,568,88,656
公投第９案,屏東縣,枋寮鄉,天時村,495,964,327,113,440,71,511
公投第９案,屏東縣,枋寮鄉,天時村,496,1005,402,111,513,91,604
公投第９案,屏東縣,枋寮鄉,地利村,497,734,244,71,315,24,339
公投第９案,屏東縣,枋寮鄉,地利村,498,725,273,70,343,65,408
公投第９案,屏東縣,枋寮鄉,人和村,499,1046,299,138,437,76,513
公投第９案,屏東縣,枋寮鄉,人和村,500,1067,404,130,534,69,603
公投第９案,屏東縣,枋寮鄉,內寮村,501,718,137,73,210,66,276
公投第９案,屏東縣,枋寮鄉,新開村,502,903,269,106,375,50,425
公投第９案,屏東縣,枋寮鄉,東海村,503,1387,426,174,600,89,689
公投第９案,屏東縣,枋寮鄉,東海村,504,1367,501,151,652,86,738
公投第９案,屏東縣,枋寮鄉,大庄村,505,618,210,122,332,53,385
公投第９案,屏東縣,枋寮鄉,太源村,506,959,260,90,350,36,386
公投第９案,屏東縣,枋寮鄉,玉泉村,507,427,164,37,201,34,235
公投第９案,屏東縣,新園鄉,瓦磘村,508,820,307,115,422,50,472
公投第９案,屏東縣,新園鄉,瓦磘村,509,843,357,94,451,58,509
公投第９案,屏東縣,新園鄉,仙吉村,510,1242,454,131,585,58,643
公投第９案,屏東縣,新園鄉,仙吉村,511,1290,508,167,675,66,741
公投第９案,屏東縣,新園鄉,田洋村,512,1073,390,123,513,51,564
公投第９案,屏東縣,新園鄉,田洋村,513,1088,277,171,448,110,558
公投第９案,屏東縣,新園鄉,港墘村,514,845,283,97,380,38,418
公投第９案,屏東縣,新園鄉,內庄村,515,862,298,123,421,48,469
公投第９案,屏東縣,新園鄉,新東村,516,1183,371,144,515,74,589
公投第９案,屏東縣,新園鄉,新東村,517,1109,374,147,521,90,611
公投第９案,屏東縣,新園鄉,新園村,518,1119,354,114,468,13,481
公投第９案,屏東縣,新園鄉,新園村,519,1152,385,139,524,42,566
公投第９案,屏東縣,新園鄉,港西村,520,1030,380,139,519,54,573
公投第９案,屏東縣,新園鄉,港西村,521,1104,367,124,491,96,587
公投第９案,屏東縣,新園鄉,烏龍村,522,1240,376,131,507,0,507
公投第９案,屏東縣,新園鄉,興龍村,523,1120,284,106,390,29,419
公投第９案,屏東縣,新園鄉,興龍村,524,1074,412,142,554,70,624
公投第９案,屏東縣,新園鄉,中洲村,525,849,265,88,353,44,397
公投第９案,屏東縣,新園鄉,中洲村,526,749,244,99,343,68,411
公投第９案,屏東縣,新園鄉,南龍村,527,1416,457,165,622,94,716
公投第９案,屏東縣,新園鄉,五房村,528,895,312,96,408,72,480
公投第９案,屏東縣,新園鄉,五房村,529,933,353,98,451,67,518
公投第９案,屏東縣,新園鄉,五房村,530,972,338,116,454,57,511
公投第９案,屏東縣,新園鄉,鹽埔村,531,1454,383,136,519,89,608
公投第９案,屏東縣,新園鄉,鹽埔村,532,1653,619,194,813,152,965
公投第９案,屏東縣,新園鄉,鹽埔村,533,1270,392,134,526,105,631
公投第９案,屏東縣,新園鄉,共和村,534,1123,375,156,531,146,677
公投第９案,屏東縣,新園鄉,共和村,535,1198,356,130,486,126,612
公投第９案,屏東縣,崁頂鄉,崁頂村,536,1190,399,119,518,43,561
公投第９案,屏東縣,崁頂鄉,崁頂村,537,1044,385,130,515,68,583
公投第９案,屏東縣,崁頂鄉,園寮村,538,818,283,121,404,48,452
公投第９案,屏東縣,崁頂鄉,園寮村,539,1214,431,139,570,53,623
公投第９案,屏東縣,崁頂鄉,力社村,540,1325,429,134,563,40,603
公投第９案,屏東縣,崁頂鄉,圍內村,541,1253,484,149,633,66,699
公投第９案,屏東縣,崁頂鄉,洲子村,542,1039,367,107,474,54,528
公投第９案,屏東縣,崁頂鄉,北勢村,543,813,248,93,341,44,385
公投第９案,屏東縣,崁頂鄉,北勢村,544,736,218,90,308,22,330
公投第９案,屏東縣,崁頂鄉,越溪村,545,934,355,128,483,42,525
公投第９案,屏東縣,崁頂鄉,港東村,546,900,296,120,416,55,471
公投第９案,屏東縣,崁頂鄉,港東村,547,1004,369,106,475,53,528
公投第９案,屏東縣,林邊鄉,林邊村,548,1458,555,186,741,117,858
公投第９案,屏東縣,林邊鄉,光林村,549,891,350,119,469,50,519
公投第９案,屏東縣,林邊鄉,光林村,550,695,303,75,378,38,416
公投第９案,屏東縣,林邊鄉,永樂村,551,1015,372,153,525,78,603
公投第９案,屏東縣,林邊鄉,永樂村,552,1171,476,141,617,57,674
公投第９案,屏東縣,林邊鄉,永樂村,553,1003,347,114,461,64,525
公投第９案,屏東縣,林邊鄉,中林村,554,725,291,130,421,39,460
公投第９案,屏東縣,林邊鄉,仁和村,555,841,297,122,419,69,488
公投第９案,屏東縣,林邊鄉,仁和村,556,793,293,120,413,57,470
公投第９案,屏東縣,林邊鄉,田厝村,557,919,362,121,483,62,545
公投第９案,屏東縣,林邊鄉,崎峯村,558,1283,420,158,578,61,639
公投第９案,屏東縣,林邊鄉,水利村,559,783,217,102,319,52,371
公投第９案,屏東縣,林邊鄉,水利村,560,1033,308,103,411,53,464
公投第９案,屏東縣,林邊鄉,竹林村,561,1186,393,140,533,101,634
公投第９案,屏東縣,林邊鄉,竹林村,562,773,255,94,349,71,420
公投第９案,屏東縣,林邊鄉,鎮安村,563,1122,356,116,472,38,510
公投第９案,屏東縣,南州鄉,溪洲村,564,872,300,89,389,48,437
公投第９案,屏東縣,南州鄉,溪洲村,565,794,285,98,383,50,433
公投第９案,屏東縣,南州鄉,溪南村,566,962,369,136,505,51,556
公投第９案,屏東縣,南州鄉,七塊村,567,1033,378,145,523,63,586
公投第９案,屏東縣,南州鄉,萬華村,568,1007,341,119,460,54,514
公投第９案,屏東縣,南州鄉,仁里村,569,466,176,71,247,24,271
公投第９案,屏東縣,南州鄉,溪北村,570,708,303,77,380,36,416
公投第９案,屏東縣,南州鄉,米崙村,571,1044,397,71,468,123,591
公投第９案,屏東縣,南州鄉,壽元村,572,1071,270,107,377,51,428
公投第９案,屏東縣,南州鄉,同安村,573,979,284,122,406,37,443
公投第９案,屏東縣,南州鄉,南安村,574,543,184,55,239,34,273
公投第９案,屏東縣,佳冬鄉,佳冬村,575,1472,460,144,604,83,687
公投第９案,屏東縣,佳冬鄉,六根村,576,1360,392,131,523,73,596
公投第９案,屏東縣,佳冬鄉,賴家村,577,804,273,118,391,72,463
公投第９案,屏東縣,佳冬鄉,萬建村,578,925,287,123,410,76,486
公投第９案,屏東縣,佳冬鄉,萬建村,579,855,348,0,348,25,373
公投第９案,屏東縣,佳冬鄉,石光村,580,981,331,94,425,57,482
公投第９案,屏東縣,佳冬鄉,石光村,581,1007,332,95,427,70,497
公投第９案,屏東縣,佳冬鄉,玉光村,582,872,235,107,342,57,399
公投第９案,屏東縣,佳冬鄉,玉光村,583,1255,362,134,496,49,545
公投第９案,屏東縣,佳冬鄉,昌隆村,584,995,414,101,515,101,616
公投第９案,屏東縣,佳冬鄉,豐隆村,585,734,184,67,251,28,279
公投第９案,屏東縣,佳冬鄉,大同村,586,1178,343,100,443,39,482
公投第９案,屏東縣,佳冬鄉,羌園村,587,1095,325,123,448,53,501
公投第９案,屏東縣,佳冬鄉,燄溫村,588,1097,384,139,523,118,641
公投第９案,屏東縣,佳冬鄉,塭豐村,589,1273,549,34,583,80,663
公投第９案,屏東縣,佳冬鄉,塭豐村,590,1160,423,163,586,69,655
公投第９案,屏東縣,琉球鄉,本福村,591,1111,312,83,395,49,444
公投第９案,屏東縣,琉球鄉,本福村,592,972,287,84,371,56,427
公投第９案,屏東縣,琉球鄉,中福村,593,1278,439,130,569,80,649
公投第９案,屏東縣,琉球鄉,漁福村,594,976,330,80,410,85,495
公投第９案,屏東縣,琉球鄉,大福村,595,1658,549,148,697,90,787
公投第９案,屏東縣,琉球鄉,南福村,596,1146,300,84,384,56,440
公投第９案,屏東縣,琉球鄉,天福村,597,1079,88,79,167,48,215
公投第９案,屏東縣,琉球鄉,上福村,598,1613,328,87,415,31,446
公投第９案,屏東縣,琉球鄉,杉福村,599,873,295,92,387,57,444
公投第９案,屏東縣,車城鄉,海口村,600,737,183,79,262,47,309
公投第９案,屏東縣,車城鄉,田中村,601,647,155,51,206,35,241
公投第９案,屏東縣,車城鄉,福興村,602,491,146,46,192,24,216
公投第９案,屏東縣,車城鄉,福興村,603,856,266,99,365,32,397
公投第９案,屏東縣,車城鄉,福安村,604,554,155,59,214,9,223
公投第９案,屏東縣,車城鄉,統埔村,605,388,104,32,136,4,140
公投第９案,屏東縣,車城鄉,溫泉村,606,922,229,87,316,47,363
公投第９案,屏東縣,車城鄉,保力村,607,597,134,41,175,4,179
公投第９案,屏東縣,車城鄉,保力村,608,623,122,44,166,13,179
公投第９案,屏東縣,車城鄉,新街村,609,425,121,46,167,24,191
公投第９案,屏東縣,車城鄉,埔墘村,610,428,146,47,193,22,215
公投第９案,屏東縣,車城鄉,射寮村,611,504,112,38,150,14,164
公投第９案,屏東縣,車城鄉,後灣村,612,423,124,59,183,22,205
公投第９案,屏東縣,滿州鄉,滿州村,613,1575,478,176,654,48,702
公投第９案,屏東縣,滿州鄉,里德村,614,420,142,35,177,9,186
公投第９案,屏東縣,滿州鄉,响林村,615,602,232,86,318,31,349
公投第９案,屏東縣,滿州鄉,永靖村,616,1302,318,121,439,18,457
公投第９案,屏東縣,滿州鄉,港口村,617,1314,500,58,558,50,608
公投第９案,屏東縣,滿州鄉,長樂村,618,1308,261,101,362,28,390
公投第９案,屏東縣,滿州鄉,九棚村,619,367,78,46,124,12,136
公投第９案,屏東縣,滿州鄉,港仔村,620,318,116,27,143,23,166
公投第９案,屏東縣,枋山鄉,枋山村,621,604,260,79,339,26,365
公投第９案,屏東縣,枋山鄉,枋山村,622,428,168,58,226,32,258
公投第９案,屏東縣,枋山鄉,加祿村,623,928,382,119,501,77,578
公投第９案,屏東縣,枋山鄉,加祿村,624,972,314,118,432,27,459
公投第９案,屏東縣,枋山鄉,楓港村,625,1041,282,103,385,66,451
公投第９案,屏東縣,枋山鄉,善餘村,626,883,171,100,271,19,290
公投第９案,屏東縣,三地門鄉,大社村,627,616,178,61,239,19,258
公投第９案,屏東縣,三地門鄉,德文村,628,572,198,76,274,72,346
公投第９案,屏東縣,三地門鄉,達來村,629,323,94,31,125,16,141
公投第９案,屏東縣,三地門鄉,三地村,630,1448,537,197,734,60,794
公投第９案,屏東縣,三地門鄉,賽嘉村,631,726,172,44,216,3,219
公投第９案,屏東縣,三地門鄉,口社村,632,554,188,72,260,26,286
公投第９案,屏東縣,三地門鄉,馬兒村,633,346,103,60,163,17,180
公投第９案,屏東縣,三地門鄉,安坡村,634,458,104,50,154,2,156
公投第９案,屏東縣,三地門鄉,青山村,635,692,260,83,343,15,358
公投第９案,屏東縣,三地門鄉,青葉村,636,638,280,102,382,66,448
公投第９案,屏東縣,霧臺鄉,霧台村,637,346,175,66,241,26,267
公投第９案,屏東縣,霧臺鄉,霧台村,638,677,252,75,327,13,340
公投第９案,屏東縣,霧臺鄉,霧台村,639,162,40,11,51,0,51
公投第９案,屏東縣,霧臺鄉,吉露村,640,189,66,18,84,5,89
公投第９案,屏東縣,霧臺鄉,阿禮村,641,296,138,37,175,35,210
公投第９案,屏東縣,霧臺鄉,好茶村,642,483,180,78,258,10,268
公投第９案,屏東縣,霧臺鄉,佳暮村,643,347,91,41,132,5,137
公投第９案,屏東縣,霧臺鄉,大武村,644,450,135,55,190,18,208
公投第９案,屏東縣,瑪家鄉,瑪家村,645,455,149,62,211,3,214
公投第９案,屏東縣,瑪家鄉,北葉村,646,821,331,163,494,46,540
公投第９案,屏東縣,瑪家鄉,三和村,647,635,274,119,393,69,462
公投第９案,屏東縣,瑪家鄉,三和村,648,695,373,110,483,33,516
公投第９案,屏東縣,瑪家鄉,三和村,649,671,327,76,403,26,429
公投第９案,屏東縣,瑪家鄉,凉山村,650,1057,310,107,417,12,429
公投第９案,屏東縣,瑪家鄉,佳義村,651,900,351,98,449,36,485
公投第９案,屏東縣,瑪家鄉,排灣村,652,429,149,45,194,10,204
公投第９案,屏東縣,泰武鄉,佳平村,653,669,272,64,336,19,355
公投第９案,屏東縣,泰武鄉,佳平村,654,190,63,23,86,9,95
公投第９案,屏東縣,泰武鄉,武潭村,655,922,382,152,534,73,607
公投第９案,屏東縣,泰武鄉,平和村,656,598,270,112,382,61,443
公投第９案,屏東縣,泰武鄉,萬安村,657,771,353,89,442,61,503
公投第９案,屏東縣,泰武鄉,佳興村,658,414,182,64,246,56,302
公投第９案,屏東縣,泰武鄉,泰武村,659,780,249,107,356,39,395
公投第９案,屏東縣,來義鄉,來義村,660,917,383,86,469,120,589
公投第９案,屏東縣,來義鄉,義林村,661,361,123,41,164,17,181
公投第９案,屏東縣,來義鄉,義林村,662,216,58,15,73,1,74
公投第９案,屏東縣,來義鄉,丹林村,663,445,260,51,311,25,336
公投第９案,屏東縣,來義鄉,丹林村,664,280,124,31,155,27,182
公投第９案,屏東縣,來義鄉,古樓村,665,1097,497,96,593,56,649
公投第９案,屏東縣,來義鄉,文樂村,666,840,389,105,494,65,559
公投第９案,屏東縣,來義鄉,望嘉村,667,889,303,97,400,19,419
公投第９案,屏東縣,來義鄉,南和村,668,1212,378,140,518,59,577
公投第９案,屏東縣,春日鄉,春日村,669,909,143,48,191,4,195
公投第９案,屏東縣,春日鄉,古華村,670,663,123,60,183,15,198
公投第９案,屏東縣,春日鄉,士文村,671,304,33,8,41,0,41
公投第９案,屏東縣,春日鄉,七佳村,672,928,226,83,309,18,327
公投第９案,屏東縣,春日鄉,歸崇村,673,641,118,37,155,8,163
公投第９案,屏東縣,春日鄉,力里村,674,478,76,25,101,3,104
公投第９案,屏東縣,獅子鄉,楓林村,675,751,299,35,334,20,354
公投第９案,屏東縣,獅子鄉,丹路村,676,776,246,80,326,28,354
公投第９案,屏東縣,獅子鄉,草埔村,677,711,201,60,261,11,272
公投第９案,屏東縣,獅子鄉,內文村,678,243,112,43,155,28,183
公投第９案,屏東縣,獅子鄉,竹坑村,679,325,114,50,164,14,178
公投第９案,屏東縣,獅子鄉,獅子村,680,476,99,30,129,5,134
公投第９案,屏東縣,獅子鄉,內獅村,681,602,178,50,228,9,237
公投第９案,屏東縣,獅子鄉,南世村,682,346,97,19,116,6,122
公投第９案,屏東縣,牡丹鄉,石門村,683,342,98,34,132,10,142
公投第９案,屏東縣,牡丹鄉,石門村,684,1306,493,116,609,54,663
公投第９案,屏東縣,牡丹鄉,牡丹村,685,693,134,31,165,3,168
公投第９案,屏東縣,牡丹鄉,東源村,686,437,100,46,146,14,160
公投第９案,屏東縣,牡丹鄉,旭海村,687,392,136,47,183,11,194
公投第９案,屏東縣,牡丹鄉,高士村,688,593,188,73,261,10,271
公投第９案,屏東縣,牡丹鄉,四林村,689,551,102,23,125,6,131
公投第９案,臺東縣,臺東市,文化里,1,874,326,84,410,19,429
公投第９案,臺東縣,臺東市,民族里,2,1469,667,168,835,66,901
公投第９案,臺東縣,臺東市,自強里,3,1259,539,124,663,32,695
公投第９案,臺東縣,臺東市,自強里,4,1399,564,153,717,44,761
公投第９案,臺東縣,臺東市,自強里,5,1363,640,150,790,51,841
公投第９案,臺東縣,臺東市,民生里,6,1651,668,179,847,48,895
公投第９案,臺東縣,臺東市,民生里,7,1490,690,186,876,50,926
公投第９案,臺東縣,臺東市,寶桑里,8,859,315,98,413,32,445
公投第９案,臺東縣,臺東市,民權里,9,890,384,119,503,32,535
公投第９案,臺東縣,臺東市,四維里,10,651,253,85,338,38,376
公投第９案,臺東縣,臺東市,中華里,11,1650,583,172,755,71,826
公投第９案,臺東縣,臺東市,仁愛里,12,724,309,106,415,35,450
公投第９案,臺東縣,臺東市,強國里,13,632,262,92,354,27,381
公投第９案,臺東縣,臺東市,大同里,14,771,326,91,417,46,463
公投第９案,臺東縣,臺東市,成功里,15,798,282,98,380,27,407
公投第９案,臺東縣,臺東市,建國里,16,1299,467,161,628,92,720
公投第９案,臺東縣,臺東市,中正里,17,811,339,114,453,32,485
公投第９案,臺東縣,臺東市,中山里,18,764,355,90,445,44,489
公投第９案,臺東縣,臺東市,興國里,19,784,282,104,386,11,397
公投第９案,臺東縣,臺東市,鐵花里,20,427,145,49,194,14,208
公投第９案,臺東縣,臺東市,東海里,21,1292,493,115,608,29,637
公投第９案,臺東縣,臺東市,東海里,22,1501,664,153,817,16,833
公投第９案,臺東縣,臺東市,復國里,23,601,206,66,272,24,296
公投第９案,臺東縣,臺東市,復興里,24,417,151,41,192,11,203
公投第９案,臺東縣,臺東市,新興里,25,1001,397,106,503,48,551
公投第９案,臺東縣,臺東市,新生里,26,1638,712,185,897,53,950
公投第９案,臺東縣,臺東市,新生里,27,1576,655,157,812,57,869
公投第９案,臺東縣,臺東市,新生里,28,1595,679,147,826,66,892
公投第９案,臺東縣,臺東市,新生里,29,1734,750,174,924,44,968
公投第９案,臺東縣,臺東市,中心里,30,1476,612,163,775,67,842
公投第９案,臺東縣,臺東市,中心里,31,1545,700,180,880,44,924
公投第９案,臺東縣,臺東市,馬蘭里,32,1313,595,134,729,56,785
公投第９案,臺東縣,臺東市,馬蘭里,33,1338,632,135,767,51,818
公投第９案,臺東縣,臺東市,光明里,34,1312,564,99,663,36,699
公投第９案,臺東縣,臺東市,光明里,35,1265,552,146,698,47,745
公投第９案,臺東縣,臺東市,豐年里,36,1407,450,158,608,69,677
公投第９案,臺東縣,臺東市,豐年里,37,1552,572,133,705,52,757
公投第９案,臺東縣,臺東市,豐樂里,38,1445,574,164,738,72,810
公投第９案,臺東縣,臺東市,永樂里,39,2098,877,232,1109,77,1186
公投第９案,臺東縣,臺東市,康樂里,40,1324,544,153,697,83,780
公投第９案,臺東縣,臺東市,豐榮里,41,1598,633,165,798,42,840
公投第９案,臺東縣,臺東市,豐榮里,42,1513,605,138,743,30,773
公投第９案,臺東縣,臺東市,豐榮里,43,1679,641,170,811,38,849
公投第９案,臺東縣,臺東市,豐榮里,44,1414,517,155,672,67,739
公投第９案,臺東縣,臺東市,豐榮里,45,1798,692,186,878,67,945
公投第９案,臺東縣,臺東市,豐谷里,46,1749,548,188,736,66,802
公投第９案,臺東縣,臺東市,豐谷里,47,1709,650,191,841,92,933
公投第９案,臺東縣,臺東市,豐谷里,48,1629,617,140,757,67,824
公投第９案,臺東縣,臺東市,豐里里,49,1116,401,121,522,69,591
公投第９案,臺東縣,臺東市,豐里里,50,1259,398,110,508,31,539
公投第９案,臺東縣,臺東市,豐原里,51,1232,380,130,510,44,554
公投第９案,臺東縣,臺東市,富岡里,52,1505,480,182,662,110,772
公投第９案,臺東縣,臺東市,富豐里,53,836,272,71,343,61,404
公投第９案,臺東縣,臺東市,南榮里,54,1294,529,157,686,48,734
公投第９案,臺東縣,臺東市,南榮里,55,1350,499,157,656,63,719
公投第９案,臺東縣,臺東市,岩灣里,56,2162,910,209,1119,77,1196
公投第９案,臺東縣,臺東市,卑南里,57,1627,734,171,905,60,965
公投第９案,臺東縣,臺東市,卑南里,58,1140,477,137,614,57,671
公投第９案,臺東縣,臺東市,南王里,59,1359,538,113,651,47,698
公投第９案,臺東縣,臺東市,南王里,60,1329,525,155,680,59,739
公投第９案,臺東縣,臺東市,豐田里,61,990,366,107,473,42,515
公投第９案,臺東縣,臺東市,豐田里,62,1038,407,121,528,59,587
公投第９案,臺東縣,臺東市,新園里,63,1597,582,174,756,82,838
公投第９案,臺東縣,臺東市,建和里,64,1385,478,172,650,94,744
公投第９案,臺東縣,臺東市,建興里,65,939,307,81,388,21,409
公投第９案,臺東縣,臺東市,建業里,66,1258,374,125,499,56,555
公投第９案,臺東縣,臺東市,知本里,67,1350,450,171,621,5,626
公投第９案,臺東縣,臺東市,建農里,68,1058,357,83,440,34,474
公投第９案,臺東縣,臺東市,建農里,69,895,256,81,337,30,367
公投第９案,臺東縣,成功鎮,信義里,70,516,164,49,213,41,254
公投第９案,臺東縣,成功鎮,信義里,71,960,367,145,512,81,593
公投第９案,臺東縣,成功鎮,信義里,72,365,83,19,102,17,119
公投第９案,臺東縣,成功鎮,和平里,73,747,193,84,277,68,345
公投第９案,臺東縣,成功鎮,忠仁里,74,339,102,37,139,21,160
公投第９案,臺東縣,成功鎮,忠仁里,75,995,332,91,423,27,450
公投第９案,臺東縣,成功鎮,忠仁里,76,863,325,101,426,57,483
公投第９案,臺東縣,成功鎮,忠智里,77,931,354,103,457,46,503
公投第９案,臺東縣,成功鎮,忠智里,78,970,389,79,468,27,495
公投第９案,臺東縣,成功鎮,三民里,79,1365,476,114,590,104,694
公投第９案,臺東縣,成功鎮,三民里,80,1366,501,126,627,89,716
公投第９案,臺東縣,成功鎮,三仙里,81,516,148,55,203,60,263
公投第９案,臺東縣,成功鎮,三仙里,82,887,223,65,288,83,371
公投第９案,臺東縣,成功鎮,忠孝里,83,488,125,41,166,52,218
公投第９案,臺東縣,成功鎮,忠孝里,84,481,114,37,151,43,194
公投第９案,臺東縣,成功鎮,博愛里,85,373,54,17,71,2,73
公投第９案,臺東縣,成功鎮,博愛里,86,264,84,34,118,28,146
公投第９案,臺東縣,關山鎮,里壠里,87,909,406,106,512,25,537
公投第９案,臺東縣,關山鎮,里壠里,88,790,240,77,317,19,336
公投第９案,臺東縣,關山鎮,中福里,89,828,364,93,457,43,500
公投第９案,臺東縣,關山鎮,新福里,90,887,268,74,342,25,367
公投第９案,臺東縣,關山鎮,豐泉里,91,1137,470,114,584,32,616
公投第９案,臺東縣,關山鎮,月眉里,92,732,240,76,316,34,350
公投第９案,臺東縣,關山鎮,德高里,93,912,324,98,422,43,465
公投第９案,臺東縣,關山鎮,德高里,94,779,208,73,281,18,299
公投第９案,臺東縣,關山鎮,電光里,95,535,144,39,183,20,203
公投第９案,臺東縣,卑南鄉,賓朗村,96,1041,379,147,526,73,599
公投第９案,臺東縣,卑南鄉,賓朗村,97,1165,426,100,526,39,565
公投第９案,臺東縣,卑南鄉,美農村,98,219,50,24,74,22,96
公投第９案,臺東縣,卑南鄉,美農村,99,460,128,50,178,36,214
公投第９案,臺東縣,卑南鄉,美農村,100,387,110,30,140,15,155
公投第９案,臺東縣,卑南鄉,初鹿村,101,767,226,74,300,29,329
公投第９案,臺東縣,卑南鄉,初鹿村,102,503,186,49,235,35,270
公投第９案,臺東縣,卑南鄉,明峰村,103,727,232,71,303,43,346
公投第９案,臺東縣,卑南鄉,明峰村,104,436,149,48,197,31,228
公投第９案,臺東縣,卑南鄉,嘉豐村,105,261,51,37,88,8,96
公投第９案,臺東縣,卑南鄉,嘉豐村,106,215,74,28,102,13,115
公投第９案,臺東縣,卑南鄉,太平村,107,1442,587,162,749,52,801
公投第９案,臺東縣,卑南鄉,太平村,108,527,203,42,245,17,262
公投第９案,臺東縣,卑南鄉,太平村,109,1046,394,129,523,56,579
公投第９案,臺東縣,卑南鄉,泰安村,110,1110,370,152,522,72,594
公投第９案,臺東縣,卑南鄉,利嘉村,111,1105,442,134,576,49,625
公投第９案,臺東縣,卑南鄉,東興村,112,1167,437,161,598,128,726
公投第９案,臺東縣,卑南鄉,溫泉村,113,968,301,120,421,49,470
公投第９案,臺東縣,卑南鄉,溫泉村,114,159,38,16,54,5,59
公投第９案,臺東縣,卑南鄉,富山村,115,488,165,31,196,23,219
公投第９案,臺東縣,卑南鄉,富源村,116,347,151,34,185,19,204
公投第９案,臺東縣,卑南鄉,利吉村,117,436,161,38,199,26,225
公投第９案,臺東縣,鹿野鄉,鹿野村,118,522,139,41,180,9,189
公投第９案,臺東縣,鹿野鄉,鹿野村,119,574,216,63,279,28,307
公投第９案,臺東縣,鹿野鄉,龍田村,120,1055,282,99,381,34,415
公投第９案,臺東縣,鹿野鄉,永安村,121,1104,365,109,474,38,512
公投第９案,臺東縣,鹿野鄉,永安村,122,342,113,24,137,17,154
公投第９案,臺東縣,鹿野鄉,瑞隆村,123,895,273,88,361,58,419
公投第９案,臺東縣,鹿野鄉,瑞源村,124,864,245,106,351,56,407
公投第９案,臺東縣,鹿野鄉,瑞和村,125,675,157,79,236,52,288
公投第９案,臺東縣,鹿野鄉,瑞豐村,126,435,137,53,190,23,213
公投第９案,臺東縣,鹿野鄉,瑞豐村,127,470,110,45,155,27,182
公投第９案,臺東縣,池上鄉,福原村,128,992,337,99,436,24,460
公投第９案,臺東縣,池上鄉,福原村,129,929,355,99,454,54,508
公投第９案,臺東縣,池上鄉,福文村,130,434,134,47,181,29,210
公投第９案,臺東縣,池上鄉,福文村,131,703,186,86,272,33,305
公投第９案,臺東縣,池上鄉,慶豐村,132,654,187,53,240,22,262
公投第９案,臺東縣,池上鄉,大坡村,133,324,79,33,112,16,128
公投第９案,臺東縣,池上鄉,大埔村,134,794,234,82,316,40,356
公投第９案,臺東縣,池上鄉,新興村,135,856,277,88,365,48,413
公投第９案,臺東縣,池上鄉,錦園村,136,344,105,23,128,12,140
公投第９案,臺東縣,池上鄉,萬安村,137,311,115,34,149,23,172
公投第９案,臺東縣,池上鄉,富興村,138,386,81,36,117,19,136
公投第９案,臺東縣,池上鄉,振興村,139,435,90,39,129,22,151
公投第９案,臺東縣,東河鄉,都蘭村,140,290,73,23,96,26,122
公投第９案,臺東縣,東河鄉,都蘭村,141,620,221,77,298,38,336
公投第９案,臺東縣,東河鄉,都蘭村,142,1196,443,185,628,108,736
公投第９案,臺東縣,東河鄉,興昌村,143,918,260,84,344,84,428
公投第９案,臺東縣,東河鄉,隆昌村,144,555,165,49,214,41,255
公投第９案,臺東縣,東河鄉,東河村,145,977,264,101,365,30,395
公投第９案,臺東縣,東河鄉,泰源村,146,1197,206,70,276,12,288
公投第９案,臺東縣,東河鄉,北源村,147,867,126,51,177,33,210
公投第９案,臺東縣,東河鄉,北源村,148,345,96,30,126,22,148
公投第９案,臺東縣,東河鄉,北源村,149,408,100,46,146,22,168
公投第９案,臺東縣,東河鄉,尚德村,150,262,83,23,106,8,114
公投第９案,臺東縣,長濱鄉,寧埔村,151,536,166,90,256,53,309
公投第９案,臺東縣,長濱鄉,寧埔村,152,689,149,45,194,27,221
公投第９案,臺東縣,長濱鄉,竹湖村,153,913,280,107,387,112,499
公投第９案,臺東縣,長濱鄉,長濱村,154,1268,321,79,400,27,427
公投第９案,臺東縣,長濱鄉,長濱村,155,725,190,78,268,67,335
公投第９案,臺東縣,長濱鄉,忠勇村,156,532,89,34,123,10,133
公投第９案,臺東縣,長濱鄉,三間村,157,660,148,62,210,69,279
公投第９案,臺東縣,長濱鄉,三間村,158,336,48,11,59,4,63
公投第９案,臺東縣,長濱鄉,三間村,159,195,37,14,51,13,64
公投第９案,臺東縣,長濱鄉,樟原村,160,25,8,3,11,2,13
公投第９案,臺東縣,長濱鄉,樟原村,161,605,142,44,186,64,250
公投第９案,臺東縣,太麻里鄉,美和村,162,722,274,63,337,47,384
公投第９案,臺東縣,太麻里鄉,美和村,163,575,196,69,265,26,291
公投第９案,臺東縣,太麻里鄉,三和村,164,623,203,70,273,37,310
公投第９案,臺東縣,太麻里鄉,華源村,165,622,185,61,246,49,295
公投第９案,臺東縣,太麻里鄉,北里村,166,560,154,37,191,11,202
公投第９案,臺東縣,太麻里鄉,大王村,167,957,338,100,438,101,539
公投第９案,臺東縣,太麻里鄉,大王村,168,809,211,109,320,38,358
公投第９案,臺東縣,太麻里鄉,泰和村,169,673,283,83,366,48,414
公投第９案,臺東縣,太麻里鄉,泰和村,170,737,255,74,329,50,379
公投第９案,臺東縣,太麻里鄉,香蘭村,171,424,140,67,207,31,238
公投第９案,臺東縣,太麻里鄉,香蘭村,172,374,98,58,156,23,179
公投第９案,臺東縣,太麻里鄉,金崙村,173,829,195,62,257,20,277
公投第９案,臺東縣,太麻里鄉,金崙村,174,869,199,62,261,9,270
公投第９案,臺東縣,太麻里鄉,多良村,175,223,49,10,59,5,64
公投第９案,臺東縣,太麻里鄉,多良村,176,669,229,83,312,50,362
公投第９案,臺東縣,大武鄉,南興村,177,568,189,73,262,68,330
公投第９案,臺東縣,大武鄉,尚武村,178,1474,433,134,567,153,720
公投第９案,臺東縣,大武鄉,大武村,179,1327,450,140,590,116,706
公投第９案,臺東縣,大武鄉,大鳥村,180,1134,298,120,418,117,535
公投第９案,臺東縣,大武鄉,大竹村,181,386,102,51,153,60,213
公投第９案,臺東縣,大武鄉,大竹村,182,377,91,47,138,29,167
公投第９案,臺東縣,綠島鄉,南寮村,183,1474,448,115,563,35,598
公投第９案,臺東縣,綠島鄉,中寮村,184,1082,346,98,444,28,472
公投第９案,臺東縣,綠島鄉,公舘村,185,813,272,83,355,26,381
公投第９案,臺東縣,綠島鄉,公舘村,186,210,73,21,94,3,97
公投第９案,臺東縣,海端鄉,加拿村,187,497,164,58,222,41,263
公投第９案,臺東縣,海端鄉,崁頂村,188,569,219,80,299,31,330
公投第９案,臺東縣,海端鄉,海端村,189,971,311,109,420,60,480
公投第９案,臺東縣,海端鄉,廣原村,190,728,250,102,352,41,393
公投第９案,臺東縣,海端鄉,霧鹿村,191,259,83,38,121,19,140
公投第９案,臺東縣,海端鄉,利稻村,192,254,75,37,112,14,126
公投第９案,臺東縣,延平鄉,桃源村,193,1014,341,104,445,55,500
公投第９案,臺東縣,延平鄉,紅葉村,194,426,155,78,233,63,296
公投第９案,臺東縣,延平鄉,永康村,195,315,141,42,183,25,208
公投第９案,臺東縣,延平鄉,武陵村,196,579,157,56,213,19,232
公投第９案,臺東縣,延平鄉,鸞山村,197,596,185,66,251,24,275
公投第９案,臺東縣,金峰鄉,嘉蘭村,198,1241,339,136,475,62,537
公投第９案,臺東縣,金峰鄉,正興村,199,601,225,82,307,38,345
公投第９案,臺東縣,金峰鄉,新興村,200,520,256,86,342,51,393
公投第９案,臺東縣,金峰鄉,賓茂村,201,336,109,54,163,26,189
公投第９案,臺東縣,金峰鄉,歷坵村,202,330,82,38,120,33,153
公投第９案,臺東縣,達仁鄉,安朔村,203,246,101,29,130,24,154
公投第９案,臺東縣,達仁鄉,安朔村,204,340,171,33,204,14,218
公投第９案,臺東縣,達仁鄉,南田村,205,296,148,35,183,12,195
公投第９案,臺東縣,達仁鄉,森永村,206,429,173,55,228,37,265
公投第９案,臺東縣,達仁鄉,新化村,207,331,138,48,186,25,211
公投第９案,臺東縣,達仁鄉,台坂村,208,628,166,70,236,23,259
公投第９案,臺東縣,達仁鄉,土坂村,209,867,294,118,412,51,463
公投第９案,臺東縣,蘭嶼鄉,椰油村,210,943,245,91,336,34,370
公投第９案,臺東縣,蘭嶼鄉,紅頭村,211,1238,350,140,490,39,529
公投第９案,臺東縣,蘭嶼鄉,東清村,212,1240,219,128,347,18,365
公投第９案,臺東縣,蘭嶼鄉,朗島村,213,760,158,84,242,37,279
公投第９案,花蓮縣,花蓮市,民德里,1,1522,653,177,830,29,859
公投第９案,花蓮縣,花蓮市,民勤里,2,1114,510,113,623,28,651
公投第９案,花蓮縣,花蓮市,民勤里,3,670,275,79,354,21,375
公投第９案,花蓮縣,花蓮市,民勤里,4,1397,581,134,715,22,737
公投第９案,花蓮縣,花蓮市,民意里,5,470,164,49,213,25,238
公投第９案,花蓮縣,花蓮市,民意里,6,838,320,67,387,43,430
公投第９案,花蓮縣,花蓮市,民意里,7,721,238,45,283,18,301
公投第９案,花蓮縣,花蓮市,民心里,8,918,380,109,489,39,528
公投第９案,花蓮縣,花蓮市,民享里,9,1539,596,170,766,41,807
公投第９案,花蓮縣,花蓮市,民享里,10,1403,569,128,697,48,745
公投第９案,花蓮縣,花蓮市,民孝里,11,1068,434,99,533,30,563
公投第９案,花蓮縣,花蓮市,民孝里,12,1167,499,113,612,31,643
公投第９案,花蓮縣,花蓮市,民孝里,13,1259,548,141,689,61,750
公投第９案,花蓮縣,花蓮市,民運里,14,1071,399,114,513,68,581
公投第９案,花蓮縣,花蓮市,民運里,15,925,384,108,492,35,527
公投第９案,花蓮縣,花蓮市,民政里,16,1141,521,138,659,51,710
公投第９案,花蓮縣,花蓮市,民政里,17,1163,462,110,572,27,599
公投第９案,花蓮縣,花蓮市,民政里,18,1279,570,126,696,46,742
公投第９案,花蓮縣,花蓮市,民立里,19,1512,542,147,689,28,717
公投第９案,花蓮縣,花蓮市,民樂里,20,615,244,64,308,25,333
公投第９案,花蓮縣,花蓮市,民有里,21,606,247,84,331,16,347
公投第９案,花蓮縣,花蓮市,民主里,22,559,212,42,254,32,286
公投第９案,花蓮縣,花蓮市,民族里,23,442,195,38,233,16,249
公投第９案,花蓮縣,花蓮市,民生里,24,1114,452,82,534,26,560
公投第９案,花蓮縣,花蓮市,民權里,25,416,180,39,219,15,234
公投第９案,花蓮縣,花蓮市,主商里,26,577,265,68,333,19,352
公投第９案,花蓮縣,花蓮市,主勤里,27,810,371,91,462,32,494
公投第９案,花蓮縣,花蓮市,主工里,28,538,226,59,285,24,309
公投第９案,花蓮縣,花蓮市,主信里,29,566,221,55,276,33,309
公投第９案,花蓮縣,花蓮市,主義里,30,469,192,41,233,12,245
公投第９案,花蓮縣,花蓮市,主睦里,31,565,251,52,303,20,323
公投第９案,花蓮縣,花蓮市,主計里,32,816,302,69,371,30,401
公投第９案,花蓮縣,花蓮市,主和里,33,911,356,80,436,40,476
公投第９案,花蓮縣,花蓮市,主和里,34,1029,391,97,488,48,536
公投第９案,花蓮縣,花蓮市,主和里,35,1043,447,109,556,49,605
公投第９案,花蓮縣,花蓮市,主學里,36,856,371,95,466,23,489
公投第９案,花蓮縣,花蓮市,主學里,37,979,405,103,508,29,537
公投第９案,花蓮縣,花蓮市,主農里,38,1331,559,138,697,54,751
公投第９案,花蓮縣,花蓮市,主農里,39,1228,533,119,652,39,691
公投第９案,花蓮縣,花蓮市,主農里,40,955,413,102,515,29,544
公投第９案,花蓮縣,花蓮市,主安里,41,1268,485,119,604,36,640
公投第９案,花蓮縣,花蓮市,主安里,42,1230,483,123,606,40,646
公投第９案,花蓮縣,花蓮市,主權里,43,1369,595,117,712,59,771
公投第９案,花蓮縣,花蓮市,主權里,44,1435,486,120,606,33,639
公投第９案,花蓮縣,花蓮市,主權里,45,1164,487,113,600,40,640
公投第９案,花蓮縣,花蓮市,主權里,46,1249,568,124,692,43,735
公投第９案,花蓮縣,花蓮市,主力里,47,1184,480,119,599,59,658
公投第９案,花蓮縣,花蓮市,主力里,48,1490,612,133,745,36,781
公投第９案,花蓮縣,花蓮市,國風里,49,1022,486,114,600,40,640
公投第９案,花蓮縣,花蓮市,國風里,50,1135,507,112,619,19,638
公投第９案,花蓮縣,花蓮市,國風里,51,1084,469,101,570,40,610
公投第９案,花蓮縣,花蓮市,國威里,52,1339,365,99,464,34,498
公投第９案,花蓮縣,花蓮市,國威里,53,501,224,54,278,22,300
公投第９案,花蓮縣,花蓮市,國治里,54,904,379,94,473,24,497
公投第９案,花蓮縣,花蓮市,國安里,55,490,217,69,286,18,304
公投第９案,花蓮縣,花蓮市,國光里,56,1192,441,92,533,32,565
公投第９案,花蓮縣,花蓮市,國防里,57,869,337,72,409,26,435
公投第９案,花蓮縣,花蓮市,國華里,58,1267,527,115,642,35,677
公投第９案,花蓮縣,花蓮市,國華里,59,959,410,99,509,49,558
公投第９案,花蓮縣,花蓮市,國魂里,60,993,419,89,508,32,540
公投第９案,花蓮縣,花蓮市,國魂里,61,982,403,100,503,49,552
公投第９案,花蓮縣,花蓮市,國聯里,62,1311,489,112,601,18,619
公投第９案,花蓮縣,花蓮市,國聯里,63,1455,549,151,700,47,747
公投第９案,花蓮縣,花蓮市,國盛里,64,1151,407,109,516,20,536
公投第９案,花蓮縣,花蓮市,國盛里,65,1237,467,117,584,26,610
公投第９案,花蓮縣,花蓮市,國盛里,66,1339,500,101,601,43,644
公投第９案,花蓮縣,花蓮市,國強里,67,715,313,76,389,25,414
公投第９案,花蓮縣,花蓮市,國強里,68,1000,417,95,512,43,555
公投第９案,花蓮縣,花蓮市,國富里,69,1410,515,136,651,48,699
公投第９案,花蓮縣,花蓮市,國富里,70,1303,552,119,671,19,690
公投第９案,花蓮縣,花蓮市,國富里,71,1256,512,131,643,31,674
公投第９案,花蓮縣,花蓮市,國富里,72,1105,472,121,593,43,636
公投第９案,花蓮縣,花蓮市,國裕里,73,1089,417,116,533,24,557
公投第９案,花蓮縣,花蓮市,國裕里,74,1043,396,96,492,22,514
公投第９案,花蓮縣,花蓮市,國裕里,75,1080,494,94,588,28,616
公投第９案,花蓮縣,花蓮市,國裕里,76,971,426,77,503,37,540
公投第９案,花蓮縣,花蓮市,國慶里,77,1068,448,131,579,30,609
公投第９案,花蓮縣,花蓮市,國興里,78,1379,560,100,660,34,694
公投第９案,花蓮縣,花蓮市,國興里,79,1362,538,132,670,47,717
公投第９案,花蓮縣,花蓮市,國興里,80,1323,567,151,718,40,758
公投第９案,花蓮縣,花蓮市,國福里,81,1482,483,156,639,35,674
公投第９案,花蓮縣,新城鄉,新城村,82,367,148,48,196,16,212
公投第９案,花蓮縣,新城鄉,新城村,83,929,344,82,426,16,442
公投第９案,花蓮縣,新城鄉,順安村,84,590,217,80,297,57,354
公投第９案,花蓮縣,新城鄉,順安村,85,307,95,51,146,26,172
公投第９案,花蓮縣,新城鄉,康樂村,86,260,105,36,141,19,160
公投第９案,花蓮縣,新城鄉,康樂村,87,1283,509,146,655,65,720
公投第９案,花蓮縣,新城鄉,康樂村,88,885,324,94,418,25,443
公投第９案,花蓮縣,新城鄉,大漢村,89,770,310,96,406,35,441
公投第９案,花蓮縣,新城鄉,大漢村,90,1363,538,146,684,54,738
公投第９案,花蓮縣,新城鄉,大漢村,91,366,134,45,179,13,192
公投第９案,花蓮縣,新城鄉,北埔村,92,1163,404,135,539,51,590
公投第９案,花蓮縣,新城鄉,北埔村,93,1605,623,180,803,34,837
公投第９案,花蓮縣,新城鄉,北埔村,94,1194,478,119,597,42,639
公投第９案,花蓮縣,新城鄉,佳林村,95,979,407,102,509,42,551
公投第９案,花蓮縣,新城鄉,嘉里村,96,1485,611,161,772,49,821
公投第９案,花蓮縣,新城鄉,嘉里村,97,1070,416,105,521,34,555
公投第９案,花蓮縣,新城鄉,嘉里村,98,1164,481,120,601,34,635
公投第９案,花蓮縣,新城鄉,嘉新村,99,880,309,104,413,55,468
公投第９案,花蓮縣,新城鄉,嘉新村,100,369,124,47,171,18,189
公投第９案,花蓮縣,秀林鄉,和平村,101,867,313,92,405,34,439
公投第９案,花蓮縣,秀林鄉,和平村,102,575,182,88,270,27,297
公投第９案,花蓮縣,秀林鄉,崇德村,103,1373,310,151,461,56,517
公投第９案,花蓮縣,秀林鄉,富世村,104,1644,463,159,622,85,707
公投第９案,花蓮縣,秀林鄉,富世村,105,162,66,19,85,4,89
公投第９案,花蓮縣,秀林鄉,秀林村,106,384,118,46,164,29,193
公投第９案,花蓮縣,秀林鄉,秀林村,107,1382,425,109,534,42,576
公投第９案,花蓮縣,秀林鄉,景美村,108,1125,354,116,470,42,512
公投第９案,花蓮縣,秀林鄉,景美村,109,627,190,77,267,18,285
公投第９案,花蓮縣,秀林鄉,佳民村,110,987,405,138,543,51,594
公投第９案,花蓮縣,秀林鄉,水源村,111,1139,444,158,602,102,704
公投第９案,花蓮縣,秀林鄉,銅門村,112,1213,435,141,576,10,586
公投第９案,花蓮縣,秀林鄉,文蘭村,113,754,274,79,353,32,385
公投第９案,花蓮縣,秀林鄉,文蘭村,114,330,101,25,126,18,144
公投第９案,花蓮縣,吉安鄉,永安村,115,1059,429,89,518,36,554
公投第９案,花蓮縣,吉安鄉,永安村,116,983,429,81,510,35,545
公投第９案,花蓮縣,吉安鄉,永安村,117,1031,438,89,527,35,562
公投第９案,花蓮縣,吉安鄉,永安村,118,1105,404,120,524,37,561
公投第９案,花蓮縣,吉安鄉,太昌村,119,1107,421,119,540,34,574
公投第９案,花蓮縣,吉安鄉,太昌村,120,1179,422,128,550,37,587
公投第９案,花蓮縣,吉安鄉,太昌村,121,1453,476,131,607,56,663
公投第９案,花蓮縣,吉安鄉,慶豐村,122,1432,657,139,796,45,841
公投第９案,花蓮縣,吉安鄉,慶豐村,123,1320,556,134,690,40,730
公投第９案,花蓮縣,吉安鄉,慶豐村,124,1356,531,118,649,31,680
公投第９案,花蓮縣,吉安鄉,慶豐村,125,1295,512,108,620,39,659
公投第９案,花蓮縣,吉安鄉,慶豐村,126,1467,614,129,743,54,797
公投第９案,花蓮縣,吉安鄉,吉安村,127,1515,567,184,751,33,784
公投第９案,花蓮縣,吉安鄉,吉安村,128,1063,477,99,576,53,629
公投第９案,花蓮縣,吉安鄉,吉安村,129,1284,437,106,543,19,562
公投第９案,花蓮縣,吉安鄉,吉安村,130,1380,600,138,738,34,772
公投第９案,花蓮縣,吉安鄉,福興村,131,1297,536,135,671,61,732
公投第９案,花蓮縣,吉安鄉,福興村,132,1662,601,171,772,81,853
公投第９案,花蓮縣,吉安鄉,南華村,133,1563,481,173,654,95,749
公投第９案,花蓮縣,吉安鄉,干城村,134,1288,452,121,573,48,621
公投第９案,花蓮縣,吉安鄉,永興村,135,907,360,97,457,41,498
公投第９案,花蓮縣,吉安鄉,永興村,136,917,342,102,444,29,473
公投第９案,花蓮縣,吉安鄉,永興村,137,1021,382,112,494,32,526
公投第９案,花蓮縣,吉安鄉,稻香村,138,1033,471,99,570,44,614
公投第９案,花蓮縣,吉安鄉,稻香村,139,966,404,93,497,53,550
公投第９案,花蓮縣,吉安鄉,稻香村,140,1188,454,102,556,67,623
公投第９案,花蓮縣,吉安鄉,南昌村,141,1480,594,141,735,30,765
公投第９案,花蓮縣,吉安鄉,南昌村,142,1393,514,116,630,45,675
公投第９案,花蓮縣,吉安鄉,南昌村,143,1193,455,107,562,31,593
公投第９案,花蓮縣,吉安鄉,宜昌村,144,1445,544,118,662,31,693
公投第９案,花蓮縣,吉安鄉,宜昌村,145,1301,472,134,606,90,696
公投第９案,花蓮縣,吉安鄉,宜昌村,146,1215,501,140,641,51,692
公投第９案,花蓮縣,吉安鄉,北昌村,147,1135,470,105,575,34,609
公投第９案,花蓮縣,吉安鄉,北昌村,148,1223,570,97,667,28,695
公投第９案,花蓮縣,吉安鄉,北昌村,149,1274,552,100,652,45,697
公投第９案,花蓮縣,吉安鄉,北昌村,150,1124,451,111,562,32,594
公投第９案,花蓮縣,吉安鄉,北昌村,151,1158,509,108,617,33,650
公投第９案,花蓮縣,吉安鄉,北昌村,152,1157,510,108,618,27,645
公投第９案,花蓮縣,吉安鄉,勝安村,153,1258,528,115,643,43,686
公投第９案,花蓮縣,吉安鄉,勝安村,154,1257,498,144,642,29,671
公投第９案,花蓮縣,吉安鄉,勝安村,155,1245,504,113,617,31,648
公投第９案,花蓮縣,吉安鄉,勝安村,156,1166,511,116,627,17,644
公投第９案,花蓮縣,吉安鄉,仁里村,157,1358,522,123,645,63,708
公投第９案,花蓮縣,吉安鄉,仁里村,158,1214,502,97,599,31,630
公投第９案,花蓮縣,吉安鄉,仁里村,159,1151,452,116,568,54,622
公投第９案,花蓮縣,吉安鄉,仁里村,160,1157,475,121,596,44,640
公投第９案,花蓮縣,吉安鄉,仁里村,161,1161,499,110,609,39,648
公投第９案,花蓮縣,吉安鄉,東昌村,162,1304,558,129,687,49,736
公投第９案,花蓮縣,吉安鄉,東昌村,163,1367,511,151,662,52,714
公投第９案,花蓮縣,吉安鄉,東昌村,164,1411,489,140,629,35,664
公投第９案,花蓮縣,吉安鄉,東昌村,165,1409,517,111,628,33,661
公投第９案,花蓮縣,吉安鄉,仁安村,166,1125,393,97,490,41,531
公投第９案,花蓮縣,吉安鄉,仁安村,167,1213,457,132,589,80,669
公投第９案,花蓮縣,吉安鄉,仁和村,168,1141,452,137,589,35,624
公投第９案,花蓮縣,吉安鄉,仁和村,169,1156,414,83,497,32,529
公投第９案,花蓮縣,吉安鄉,仁和村,170,1092,421,87,508,52,560
公投第９案,花蓮縣,吉安鄉,仁和村,171,1026,317,108,425,38,463
公投第９案,花蓮縣,吉安鄉,光華村,172,804,330,73,403,15,418
公投第９案,花蓮縣,吉安鄉,光華村,173,1132,481,100,581,44,625
公投第９案,花蓮縣,壽豐鄉,溪口村,174,1052,350,105,455,46,501
公投第９案,花蓮縣,壽豐鄉,樹湖村,175,357,147,41,188,30,218
公投第９案,花蓮縣,壽豐鄉,豐山村,176,1022,366,99,465,52,517
公投第９案,花蓮縣,壽豐鄉,豐山村,177,875,367,132,499,49,548
公投第９案,花蓮縣,壽豐鄉,豐裡村,178,691,270,103,373,50,423
公投第９案,花蓮縣,壽豐鄉,豐裡村,179,708,231,70,301,23,324
公投第９案,花蓮縣,壽豐鄉,豐坪村,180,894,339,89,428,45,473
公投第９案,花蓮縣,壽豐鄉,壽豐村,181,746,296,79,375,32,407
公投第９案,花蓮縣,壽豐鄉,壽豐村,182,881,304,115,419,50,469
公投第９案,花蓮縣,壽豐鄉,共和村,183,695,318,79,397,32,429
公投第９案,花蓮縣,壽豐鄉,光榮村,184,816,306,126,432,79,511
公投第９案,花蓮縣,壽豐鄉,池南村,185,773,259,99,358,37,395
公投第９案,花蓮縣,壽豐鄉,平和村,186,1029,404,128,532,60,592
公投第９案,花蓮縣,壽豐鄉,平和村,187,407,186,38,224,33,257
公投第９案,花蓮縣,壽豐鄉,志學村,188,1139,464,132,596,53,649
公投第９案,花蓮縣,壽豐鄉,志學村,189,996,390,149,539,34,573
公投第９案,花蓮縣,壽豐鄉,志學村,190,414,135,40,175,12,187
公投第９案,花蓮縣,壽豐鄉,米棧村,191,270,110,38,148,9,157
公投第９案,花蓮縣,壽豐鄉,月眉村,192,836,319,107,426,62,488
公投第９案,花蓮縣,壽豐鄉,鹽寮村,193,507,205,77,282,25,307
公投第９案,花蓮縣,壽豐鄉,水璉村,194,739,195,73,268,48,316
公投第９案,花蓮縣,鳳林鎮,鳳仁里,195,1192,547,123,670,64,734
公投第９案,花蓮縣,鳳林鎮,鳳義里,196,639,239,59,298,25,323
公投第９案,花蓮縣,鳳林鎮,鳳禮里,197,601,286,70,356,44,400
公投第９案,花蓮縣,鳳林鎮,鳳智里,198,1137,563,113,676,49,725
公投第９案,花蓮縣,鳳林鎮,鳳信里,199,742,270,96,366,51,417
公投第９案,花蓮縣,鳳林鎮,鳳信里,200,610,277,43,320,29,349
公投第９案,花蓮縣,鳳林鎮,山興里,201,295,105,45,150,42,192
公投第９案,花蓮縣,鳳林鎮,山興里,202,218,52,10,62,4,66
公投第９案,花蓮縣,鳳林鎮,大榮里,203,720,213,60,273,26,299
公投第９案,花蓮縣,鳳林鎮,大榮里,204,528,198,56,254,32,286
公投第９案,花蓮縣,鳳林鎮,北林里,205,560,189,70,259,29,288
公投第９案,花蓮縣,鳳林鎮,南平里,206,541,199,43,242,49,291
公投第９案,花蓮縣,鳳林鎮,林榮里,207,818,325,76,401,63,464
公投第９案,花蓮縣,鳳林鎮,長橋里,208,984,293,77,370,40,410
公投第９案,花蓮縣,鳳林鎮,森榮里,209,91,29,12,41,8,49
公投第９案,花蓮縣,光復鄉,大華村,210,1295,498,130,628,89,717
公投第９案,花蓮縣,光復鄉,大安村,211,859,387,73,460,43,503
公投第９案,花蓮縣,光復鄉,大平村,212,958,346,120,466,103,569
公投第９案,花蓮縣,光復鄉,大馬村,213,1011,356,134,490,97,587
公投第９案,花蓮縣,光復鄉,大同村,214,1041,366,158,524,79,603
公投第９案,花蓮縣,光復鄉,東富村,215,821,266,96,362,86,448
公投第９案,花蓮縣,光復鄉,東富村,216,188,31,5,36,1,37
公投第９案,花蓮縣,光復鄉,西富村,217,514,198,50,248,34,282
公投第９案,花蓮縣,光復鄉,西富村,218,446,111,34,145,13,158
公投第９案,花蓮縣,光復鄉,南富村,219,851,287,90,377,53,430
公投第９案,花蓮縣,光復鄉,北富村,220,932,233,90,323,23,346
公投第９案,花蓮縣,光復鄉,大進村,221,471,211,30,241,27,268
公投第９案,花蓮縣,光復鄉,大全村,222,640,215,94,309,49,358
公投第９案,花蓮縣,光復鄉,大全村,223,116,35,7,42,3,45
公投第９案,花蓮縣,光復鄉,大興村,224,496,105,28,133,10,143
公投第９案,花蓮縣,光復鄉,大富村,225,324,101,34,135,11,146
公投第９案,花蓮縣,光復鄉,大豐村,226,454,123,33,156,20,176
公投第９案,花蓮縣,豐濱鄉,靜浦村,227,717,179,78,257,85,342
公投第９案,花蓮縣,豐濱鄉,港口村,228,751,150,100,250,54,304
公投第９案,花蓮縣,豐濱鄉,豐濱村,229,613,162,75,237,50,287
公投第９案,花蓮縣,豐濱鄉,豐濱村,230,809,270,68,338,26,364
公投第９案,花蓮縣,豐濱鄉,豐濱村,231,357,41,11,52,2,54
公投第９案,花蓮縣,豐濱鄉,新社村,232,669,175,90,265,75,340
公投第９案,花蓮縣,豐濱鄉,磯崎村,233,479,152,34,186,10,196
公投第９案,花蓮縣,萬榮鄉,西林村,234,1072,362,154,516,78,594
公投第９案,花蓮縣,萬榮鄉,見晴村,235,560,158,49,207,11,218
公投第９案,花蓮縣,萬榮鄉,萬榮村,236,773,316,103,419,39,458
公投第９案,花蓮縣,萬榮鄉,明利村,237,661,170,67,237,13,250
公投第９案,花蓮縣,萬榮鄉,馬遠村,238,442,150,55,205,18,223
公投第９案,花蓮縣,萬榮鄉,馬遠村,239,675,183,94,277,70,347
公投第９案,花蓮縣,萬榮鄉,紅葉村,240,1086,409,212,621,115,736
公投第９案,花蓮縣,瑞穗鄉,瑞穗村,241,813,341,78,419,50,469
公投第９案,花蓮縣,瑞穗鄉,瑞穗村,242,1091,434,102,536,74,610
公投第９案,花蓮縣,瑞穗鄉,瑞美村,243,839,337,89,426,47,473
公投第９案,花蓮縣,瑞穗鄉,瑞美村,244,975,386,111,497,60,557
公投第９案,花蓮縣,瑞穗鄉,瑞良村,245,546,172,62,234,20,254
公投第９案,花蓮縣,瑞穗鄉,瑞祥村,246,1002,376,119,495,75,570
公投第９案,花蓮縣,瑞穗鄉,瑞北村,247,593,179,57,236,40,276
公投第９案,花蓮縣,瑞穗鄉,舞鶴村,248,965,362,115,477,81,558
公投第９案,花蓮縣,瑞穗鄉,鶴岡村,249,863,291,103,394,81,475
公投第９案,花蓮縣,瑞穗鄉,奇美村,250,340,51,18,69,8,77
公投第９案,花蓮縣,瑞穗鄉,富源村,251,764,243,73,316,38,354
公投第９案,花蓮縣,瑞穗鄉,富民村,252,868,118,40,158,11,169
公投第９案,花蓮縣,瑞穗鄉,富興村,253,620,128,36,164,16,180
公投第９案,花蓮縣,玉里鎮,中城里,254,1008,400,103,503,43,546
公投第９案,花蓮縣,玉里鎮,中城里,255,939,419,94,513,43,556
公投第９案,花蓮縣,玉里鎮,中城里,256,1256,493,97,590,66,656
公投第９案,花蓮縣,玉里鎮,中城里,257,929,337,111,448,57,505
公投第９案,花蓮縣,玉里鎮,中城里,258,979,381,114,495,40,535
公投第９案,花蓮縣,玉里鎮,國武里,259,1244,551,132,683,47,730
公投第９案,花蓮縣,玉里鎮,啟模里,260,847,290,81,371,45,416
公投第９案,花蓮縣,玉里鎮,啟模里,261,772,250,75,325,55,380
公投第９案,花蓮縣,玉里鎮,泰昌里,262,558,196,59,255,22,277
公投第９案,花蓮縣,玉里鎮,泰昌里,263,800,184,56,240,21,261
公投第９案,花蓮縣,玉里鎮,永昌里,264,1286,407,119,526,69,595
公投第９案,花蓮縣,玉里鎮,源城里,265,1246,402,118,520,79,599
公投第９案,花蓮縣,玉里鎮,長良里,266,647,184,95,279,66,345
公投第９案,花蓮縣,玉里鎮,樂合里,267,990,159,41,200,21,221
公投第９案,花蓮縣,玉里鎮,東豐里,268,530,148,64,212,51,263
公投第９案,花蓮縣,玉里鎮,觀音里,269,979,225,91,316,47,363
公投第９案,花蓮縣,玉里鎮,觀音里,270,557,173,47,220,100,320
公投第９案,花蓮縣,玉里鎮,松浦里,271,434,107,32,139,19,158
公投第９案,花蓮縣,玉里鎮,松浦里,272,1065,197,80,277,84,361
公投第９案,花蓮縣,玉里鎮,春日里,273,866,239,114,353,108,461
公投第９案,花蓮縣,玉里鎮,德武里,274,769,191,76,267,51,318
公投第９案,花蓮縣,玉里鎮,三民里,275,869,245,83,328,43,371
公投第９案,花蓮縣,玉里鎮,大禹里,276,1080,293,98,391,55,446
公投第９案,花蓮縣,富里鄉,吳江村,277,467,131,43,174,22,196
公投第９案,花蓮縣,富里鄉,東里村,278,1032,260,84,344,63,407
公投第９案,花蓮縣,富里鄉,萬寧村,279,638,184,56,240,37,277
公投第９案,花蓮縣,富里鄉,新興村,280,591,174,65,239,84,323
公投第９案,花蓮縣,富里鄉,竹田村,281,1087,402,122,524,69,593
公投第９案,花蓮縣,富里鄉,羅山村,282,431,145,57,202,22,224
公投第９案,花蓮縣,富里鄉,石牌村,283,893,312,78,390,46,436
公投第９案,花蓮縣,富里鄉,明里村,284,361,90,31,121,28,149
公投第９案,花蓮縣,富里鄉,富里村,285,1362,359,127,486,53,539
公投第９案,花蓮縣,富里鄉,永豐村,286,458,158,53,211,28,239
公投第９案,花蓮縣,富里鄉,豐南村,287,621,121,40,161,33,194
公投第９案,花蓮縣,富里鄉,富南村,288,493,151,65,216,27,243
公投第９案,花蓮縣,富里鄉,學田村,289,631,194,69,263,35,298
公投第９案,花蓮縣,卓溪鄉,崙山村,290,533,204,55,259,23,282
公投第９案,花蓮縣,卓溪鄉,立山村,291,522,192,82,274,51,325
公投第９案,花蓮縣,卓溪鄉,立山村,292,493,127,36,163,17,180
公投第９案,花蓮縣,卓溪鄉,太平村,293,701,309,80,389,49,438
公投第９案,花蓮縣,卓溪鄉,卓溪村,294,746,298,87,385,58,443
公投第９案,花蓮縣,卓溪鄉,卓清村,295,616,219,97,316,70,386
公投第９案,花蓮縣,卓溪鄉,卓清村,296,405,87,24,111,19,130
公投第９案,花蓮縣,卓溪鄉,古風村,297,329,127,32,159,20,179
公投第９案,花蓮縣,卓溪鄉,古風村,298,428,160,36,196,22,218
公投第９案,花蓮縣,卓溪鄉,古風村,299,174,78,11,89,9,98
公投第９案,澎湖縣,馬公市,復興里,1,481,164,44,208,15,223
公投第９案,澎湖縣,馬公市,長安里,2,558,218,48,266,18,284
公投第９案,澎湖縣,馬公市,中央里,3,533,169,52,221,42,263
公投第９案,澎湖縣,馬公市,啟明里,4,922,303,108,411,34,445
公投第９案,澎湖縣,馬公市,重慶里,5,1021,387,114,501,37,538
公投第９案,澎湖縣,馬公市,中興里,6,793,291,78,369,34,403
公投第９案,澎湖縣,馬公市,光復里,7,954,367,101,468,41,509
公投第９案,澎湖縣,馬公市,光復里,8,1001,370,91,461,32,493
公投第９案,澎湖縣,馬公市,光明里,9,1192,380,105,485,43,528
公投第９案,澎湖縣,馬公市,光榮里,10,1402,486,123,609,46,655
公投第９案,澎湖縣,馬公市,光榮里,11,1389,551,110,661,30,691
公投第９案,澎湖縣,馬公市,光榮里,12,1339,521,123,644,44,688
公投第９案,澎湖縣,馬公市,朝陽里,13,1254,416,117,533,53,586
公投第９案,澎湖縣,馬公市,朝陽里,14,1194,443,103,546,53,599
公投第９案,澎湖縣,馬公市,朝陽里,15,1393,461,148,609,63,672
公投第９案,澎湖縣,馬公市,朝陽里,16,1440,578,130,708,42,750
公投第９案,澎湖縣,馬公市,陽明里,17,1215,420,120,540,53,593
公投第９案,澎湖縣,馬公市,陽明里,18,1284,486,94,580,51,631
公投第９案,澎湖縣,馬公市,重光里,19,1512,542,142,684,67,751
公投第９案,澎湖縣,馬公市,西衛里,20,1181,397,110,507,60,567
公投第９案,澎湖縣,馬公市,西衛里,21,1348,518,113,631,40,671
公投第９案,澎湖縣,馬公市,西衛里,22,1391,550,138,688,27,715
公投第９案,澎湖縣,馬公市,西衛里,23,2124,656,252,908,39,947
公投第９案,澎湖縣,馬公市,西文里,24,1500,553,130,683,58,741
公投第９案,澎湖縣,馬公市,西文里,25,1582,623,117,740,34,774
公投第９案,澎湖縣,馬公市,東文里,26,1638,607,145,752,40,792
公投第９案,澎湖縣,馬公市,東文里,27,1554,611,150,761,49,810
公投第９案,澎湖縣,馬公市,案山里,28,980,289,60,349,27,376
公投第９案,澎湖縣,馬公市,案山里,29,892,345,67,412,33,445
公投第９案,澎湖縣,馬公市,光華里,30,778,268,38,306,15,321
公投第９案,澎湖縣,馬公市,前寮里,31,930,361,79,440,31,471
公投第９案,澎湖縣,馬公市,石泉里,32,1481,681,133,814,38,852
公投第９案,澎湖縣,馬公市,石泉里,33,1128,462,108,570,22,592
公投第９案,澎湖縣,馬公市,菜園里,34,415,150,38,188,28,216
公投第９案,澎湖縣,馬公市,東衛里,35,1120,438,77,515,42,557
公投第９案,澎湖縣,馬公市,東衛里,36,950,411,71,482,32,514
公投第９案,澎湖縣,馬公市,安宅里,37,627,207,49,256,24,280
公投第９案,澎湖縣,馬公市,興仁里,38,1055,409,82,491,21,512
公投第９案,澎湖縣,馬公市,烏崁里,39,989,385,89,474,40,514
公投第９案,澎湖縣,馬公市,鐵線里,40,591,235,61,296,33,329
公投第９案,澎湖縣,馬公市,鎖港里,41,1387,453,133,586,71,657
公投第９案,澎湖縣,馬公市,鎖港里,42,1079,307,102,409,56,465
公投第９案,澎湖縣,馬公市,山水里,43,797,289,65,354,43,397
公投第９案,澎湖縣,馬公市,山水里,44,903,287,72,359,21,380
公投第９案,澎湖縣,馬公市,五德里,45,376,118,33,151,23,174
公投第９案,澎湖縣,馬公市,井垵里,46,371,130,47,177,17,194
公投第９案,澎湖縣,馬公市,嵵裡里,47,1173,340,83,423,18,441
公投第９案,澎湖縣,馬公市,風櫃里,48,1389,335,90,425,29,454
公投第９案,澎湖縣,馬公市,虎井里,49,761,108,46,154,59,213
公投第９案,澎湖縣,馬公市,桶盤里,50,288,114,41,155,21,176
公投第９案,澎湖縣,湖西鄉,湖西村,51,1120,430,81,511,61,572
公投第９案,澎湖縣,湖西鄉,湖東村,52,332,101,26,127,13,140
公投第９案,澎湖縣,湖西鄉,青螺村,53,242,64,21,85,2,87
公投第９案,澎湖縣,湖西鄉,白坑村,54,293,67,23,90,9,99
公投第９案,澎湖縣,湖西鄉,南寮村,55,666,172,53,225,48,273
公投第９案,澎湖縣,湖西鄉,北寮村,56,326,118,25,143,19,162
公投第９案,澎湖縣,湖西鄉,紅羅村,57,732,199,51,250,17,267
公投第９案,澎湖縣,湖西鄉,西溪村,58,651,234,39,273,24,297
公投第９案,澎湖縣,湖西鄉,成功村,59,744,237,60,297,12,309
公投第９案,澎湖縣,湖西鄉,東石村,60,134,56,15,71,3,74
公投第９案,澎湖縣,湖西鄉,沙港村,61,794,188,49,237,22,259
公投第９案,澎湖縣,湖西鄉,中西村,62,216,65,11,76,2,78
公投第９案,澎湖縣,湖西鄉,鼎灣村,63,664,143,41,184,9,193
公投第９案,澎湖縣,湖西鄉,潭邊村,64,279,99,26,125,5,130
公投第９案,澎湖縣,湖西鄉,許家村,65,296,113,25,138,7,145
公投第９案,澎湖縣,湖西鄉,城北村,66,257,96,16,112,6,118
公投第９案,澎湖縣,湖西鄉,太武村,67,89,22,4,26,1,27
公投第９案,澎湖縣,湖西鄉,隘門村,68,815,265,89,354,29,383
公投第９案,澎湖縣,湖西鄉,林投村,69,975,287,70,357,21,378
公投第９案,澎湖縣,湖西鄉,尖山村,70,648,222,51,273,42,315
公投第９案,澎湖縣,湖西鄉,龍門村,71,893,266,68,334,23,357
公投第９案,澎湖縣,湖西鄉,龍門村,72,846,283,79,362,76,438
公投第９案,澎湖縣,湖西鄉,菓葉村,73,729,168,65,233,18,251
公投第９案,澎湖縣,白沙鄉,中屯村,74,514,167,70,237,18,255
公投第９案,澎湖縣,白沙鄉,講美村,75,657,235,80,315,18,333
公投第９案,澎湖縣,白沙鄉,城前村,76,109,56,11,67,5,72
公投第９案,澎湖縣,白沙鄉,鎮海村,77,156,54,7,61,4,65
公投第９案,澎湖縣,白沙鄉,港子村,78,293,84,30,114,6,120
公投第９案,澎湖縣,白沙鄉,岐頭村,79,231,58,11,69,2,71
公投第９案,澎湖縣,白沙鄉,小赤村,80,161,58,20,78,9,87
公投第９案,澎湖縣,白沙鄉,赤崁村,81,1705,581,142,723,60,783
公投第９案,澎湖縣,白沙鄉,瓦硐村,82,285,90,23,113,8,121
公投第９案,澎湖縣,白沙鄉,後寮村,83,723,142,57,199,11,210
公投第９案,澎湖縣,白沙鄉,通梁村,84,774,197,59,256,29,285
公投第９案,澎湖縣,白沙鄉,吉貝村,85,1429,260,118,378,108,486
公投第９案,澎湖縣,白沙鄉,鳥嶼村,86,1084,354,72,426,73,499
公投第９案,澎湖縣,白沙鄉,員貝村,87,251,99,21,120,5,125
公投第９案,澎湖縣,白沙鄉,大倉村,88,253,52,20,72,16,88
公投第９案,澎湖縣,西嶼鄉,橫礁村,89,283,28,13,41,1,42
公投第９案,澎湖縣,西嶼鄉,合界村,90,424,84,24,108,14,122
公投第９案,澎湖縣,西嶼鄉,竹灣村,91,826,181,55,236,48,284
公投第９案,澎湖縣,西嶼鄉,小門村,92,282,63,32,95,10,105
公投第９案,澎湖縣,西嶼鄉,大池村,93,661,136,59,195,55,250
公投第９案,澎湖縣,西嶼鄉,二崁村,94,141,16,7,23,4,27
公投第９案,澎湖縣,西嶼鄉,池東村,95,635,132,32,164,12,176
公投第９案,澎湖縣,西嶼鄉,池西村,96,216,49,13,62,4,66
公投第９案,澎湖縣,西嶼鄉,赤馬村,97,572,84,22,106,26,132
公投第９案,澎湖縣,西嶼鄉,內垵村,98,1267,316,93,409,90,499
公投第９案,澎湖縣,西嶼鄉,外垵村,99,942,201,73,274,24,298
公投第９案,澎湖縣,西嶼鄉,外垵村,100,1133,255,99,354,74,428
公投第９案,澎湖縣,望安鄉,東安村,101,734,226,62,288,39,327
公投第９案,澎湖縣,望安鄉,西安村,102,454,131,28,159,31,190
公投第９案,澎湖縣,望安鄉,中社村,103,300,58,19,77,15,92
公投第９案,澎湖縣,望安鄉,水垵村,104,471,135,62,197,41,238
公投第９案,澎湖縣,望安鄉,將軍村,105,672,147,35,182,21,203
公投第９案,澎湖縣,望安鄉,將軍村,106,742,163,83,246,52,298
公投第９案,澎湖縣,望安鄉,東吉村,107,264,64,28,92,16,108
公投第９案,澎湖縣,望安鄉,東坪村,108,476,129,34,163,7,170
公投第９案,澎湖縣,望安鄉,西坪村,109,208,26,11,37,5,42
公投第９案,澎湖縣,望安鄉,花嶼村,110,307,67,18,85,6,91
公投第９案,澎湖縣,七美鄉,東湖村,111,248,45,16,61,5,66
公投第９案,澎湖縣,七美鄉,西湖村,112,581,122,50,172,32,204
公投第９案,澎湖縣,七美鄉,中和村,113,641,139,50,189,35,224
公投第９案,澎湖縣,七美鄉,平和村,114,382,87,20,107,5,112
公投第９案,澎湖縣,七美鄉,海豐村,115,351,51,15,66,6,72
公投第９案,澎湖縣,七美鄉,南港村,116,1171,216,64,280,35,315
公投第９案,基隆市,中正區,長潭里,1,466,181,46,227,21,248
公投第９案,基隆市,中正區,砂子里,2,1262,386,114,500,26,526
公投第９案,基隆市,中正區,砂子里,3,1171,344,158,502,52,554
公投第９案,基隆市,中正區,砂子里,4,2823,846,187,1033,22,1055
公投第９案,基隆市,中正區,八斗里,5,1474,428,152,580,56,636
公投第９案,基隆市,中正區,碧砂里,6,1271,398,92,490,60,550
公投第９案,基隆市,中正區,新富里,7,2707,831,254,1085,75,1160
公投第９案,基隆市,中正區,新富里,8,1545,564,121,685,65,750
公投第９案,基隆市,中正區,新富里,9,761,209,44,253,16,269
公投第９案,基隆市,中正區,新豐里,10,1352,484,142,626,17,643
公投第９案,基隆市,中正區,新豐里,11,1413,496,123,619,19,638
公投第９案,基隆市,中正區,新豐里,12,2665,869,228,1097,47,1144
公投第９案,基隆市,中正區,平寮里,13,1261,394,125,519,68,587
公投第９案,基隆市,中正區,社寮里,14,1753,556,226,782,85,867
公投第９案,基隆市,中正區,和憲里,15,984,296,109,405,37,442
公投第９案,基隆市,中正區,海濱里,16,1166,393,85,478,30,508
公投第９案,基隆市,中正區,正濱里,17,973,339,97,436,33,469
公投第９案,基隆市,中正區,中正里,18,1694,461,122,583,30,613
公投第９案,基隆市,中正區,中濱里,19,1270,470,130,600,32,632
公投第９案,基隆市,中正區,建國里,20,1090,421,107,528,33,561
公投第９案,基隆市,中正區,建國里,21,870,321,107,428,19,447
公投第９案,基隆市,中正區,砂灣里,22,1138,407,118,525,48,573
公投第９案,基隆市,中正區,砂灣里,23,862,291,77,368,42,410
公投第９案,基隆市,中正區,真砂里,24,1341,517,155,672,65,737
公投第９案,基隆市,中正區,正砂里,25,859,330,97,427,43,470
公投第９案,基隆市,中正區,正砂里,26,1457,510,124,634,31,665
公投第９案,基隆市,中正區,中砂里,27,1594,471,123,594,61,655
公投第９案,基隆市,中正區,入船里,28,802,284,98,382,46,428
公投第９案,基隆市,中正區,正船里,29,1267,451,115,566,50,616
公投第９案,基隆市,中正區,中船里,30,1175,406,144,550,66,616
公投第９案,基隆市,中正區,港通里,31,1210,485,148,633,45,678
公投第９案,基隆市,中正區,義重里,32,1037,354,123,477,62,539
公投第９案,基隆市,中正區,正義里,33,1219,438,137,575,59,634
公投第９案,基隆市,中正區,信義里,34,904,293,110,403,27,430
公投第９案,基隆市,中正區,德義里,35,709,313,100,413,26,439
公投第９案,基隆市,信義區,仁壽里,36,1096,426,120,546,45,591
公投第９案,基隆市,信義區,仁義里,37,1232,546,150,696,37,733
公投第９案,基隆市,信義區,義昭里,38,1184,464,131,595,17,612
公投第９案,基隆市,信義區,義幸里,39,1133,470,130,600,63,663
公投第９案,基隆市,信義區,義幸里,40,1188,485,133,618,41,659
公投第９案,基隆市,信義區,義民里,41,725,287,96,383,39,422
公投第９案,基隆市,信義區,義和里,42,1524,518,159,677,43,720
公投第９案,基隆市,信義區,智慧里,43,736,279,84,363,34,397
公投第９案,基隆市,信義區,智誠里,44,611,226,57,283,23,306
公投第９案,基隆市,信義區,智誠里,45,951,301,107,408,16,424
公投第９案,基隆市,信義區,禮儀里,46,1616,617,164,781,40,821
公投第９案,基隆市,信義區,禮東里,47,1516,625,157,782,35,817
公投第９案,基隆市,信義區,信綠里,48,1049,403,111,514,24,538
公投第９案,基隆市,信義區,信綠里,49,1069,402,122,524,29,553
公投第９案,基隆市,信義區,東信里,50,727,311,84,395,25,420
公投第９案,基隆市,信義區,東信里,51,929,436,87,523,20,543
公投第９案,基隆市,信義區,東信里,52,1118,500,152,652,38,690
公投第９案,基隆市,信義區,東信里,53,1339,564,146,710,41,751
公投第９案,基隆市,信義區,東光里,54,999,398,90,488,20,508
公投第９案,基隆市,信義區,東光里,55,764,287,79,366,14,380
公投第９案,基隆市,信義區,東明里,56,1555,564,149,713,30,743
公投第９案,基隆市,信義區,東明里,57,2015,734,200,934,30,964
公投第９案,基隆市,信義區,東安里,58,1268,564,114,678,42,720
公投第９案,基隆市,信義區,東安里,59,1569,615,151,766,60,826
公投第９案,基隆市,信義區,孝賢里,60,1985,723,168,891,62,953
公投第９案,基隆市,信義區,孝賢里,61,1476,656,117,773,28,801
公投第９案,基隆市,信義區,孝忠里,62,1493,648,161,809,28,837
公投第９案,基隆市,信義區,孝忠里,63,1249,589,134,723,27,750
公投第９案,基隆市,信義區,孝忠里,64,1559,581,158,739,22,761
公投第９案,基隆市,信義區,孝忠里,65,1168,446,90,536,18,554
公投第９案,基隆市,信義區,孝忠里,66,1602,671,125,796,28,824
公投第９案,基隆市,信義區,孝德里,67,1485,534,108,642,37,679
公投第９案,基隆市,信義區,孝德里,68,1009,383,95,478,25,503
公投第９案,基隆市,信義區,孝深里,69,2016,681,141,822,39,861
公投第９案,基隆市,信義區,孝深里,70,1764,558,131,689,35,724
公投第９案,基隆市,信義區,孝岡里,71,1295,505,147,652,43,695
公投第９案,基隆市,仁愛區,林泉里,72,1782,556,172,728,94,822
公投第９案,基隆市,仁愛區,花崗里,73,1055,428,116,544,49,593
公投第９案,基隆市,仁愛區,虹橋里,74,1558,515,153,668,43,711
公投第９案,基隆市,仁愛區,水錦里,75,1736,674,171,845,46,891
公投第９案,基隆市,仁愛區,智仁里,76,1243,519,166,685,48,733
公投第９案,基隆市,仁愛區,智仁里,77,1109,447,139,586,37,623
公投第９案,基隆市,仁愛區,和明里,78,1684,768,154,922,48,970
公投第９案,基隆市,仁愛區,忠勇里,79,919,354,107,461,40,501
公投第９案,基隆市,仁愛區,玉田里,80,991,359,131,490,22,512
公投第９案,基隆市,仁愛區,仁德里,81,876,355,87,442,22,464
公投第９案,基隆市,仁愛區,博愛里,82,1046,442,119,561,43,604
公投第９案,基隆市,仁愛區,博愛里,83,434,185,51,236,27,263
公投第９案,基隆市,仁愛區,福仁里,84,764,306,91,397,48,445
公投第９案,基隆市,仁愛區,誠仁里,85,968,341,129,470,26,496
公投第９案,基隆市,仁愛區,吉仁里,86,1326,433,158,591,62,653
公投第９案,基隆市,仁愛區,吉仁里,87,1315,379,124,503,41,544
公投第９案,基隆市,仁愛區,育仁里,88,775,297,99,396,50,446
公投第９案,基隆市,仁愛區,英仁里,89,652,226,104,330,45,375
公投第９案,基隆市,仁愛區,英仁里,90,674,265,78,343,34,377
公投第９案,基隆市,仁愛區,龍門里,91,789,283,91,374,36,410
公投第９案,基隆市,仁愛區,德厚里,92,1715,665,173,838,66,904
公投第９案,基隆市,仁愛區,曲水里,93,849,304,97,401,50,451
公投第９案,基隆市,仁愛區,崇文里,94,875,353,87,440,29,469
公投第９案,基隆市,仁愛區,文安里,95,851,310,85,395,38,433
公投第９案,基隆市,仁愛區,兆連里,96,735,307,90,397,29,426
公投第９案,基隆市,仁愛區,獅球里,97,1009,347,119,466,69,535
公投第９案,基隆市,仁愛區,書院里,98,1082,350,129,479,49,528
公投第９案,基隆市,仁愛區,朝棟里,99,1278,438,157,595,66,661
公投第９案,基隆市,仁愛區,朝棟里,100,1519,681,143,824,45,869
公投第９案,基隆市,仁愛區,光華里,101,1336,419,134,553,41,594
公投第９案,基隆市,仁愛區,光華里,102,1178,479,156,635,57,692
公投第９案,基隆市,仁愛區,明德里,103,708,259,78,337,44,381
公投第９案,基隆市,仁愛區,同風里,104,567,242,90,332,23,355
公投第９案,基隆市,仁愛區,文昌里,105,751,270,93,363,53,416
公投第９案,基隆市,仁愛區,新店里,106,589,240,90,330,23,353
公投第９案,基隆市,中山區,新建里,107,796,293,80,373,28,401
公投第９案,基隆市,中山區,安民里,108,1036,483,106,589,49,638
公投第９案,基隆市,中山區,安平里,109,756,302,86,388,44,432
公投第９案,基隆市,中山區,中山里,110,957,271,112,383,24,407
公投第９案,基隆市,中山區,民治里,111,802,312,78,390,15,405
公投第９案,基隆市,中山區,中興里,112,1263,498,133,631,44,675
公投第９案,基隆市,中山區,仁正里,113,778,331,91,422,20,442
公投第９案,基隆市,中山區,健民里,114,1180,442,146,588,85,673
公投第９案,基隆市,中山區,通化里,115,990,336,102,438,25,463
公投第９案,基隆市,中山區,居仁里,116,1332,394,117,511,31,542
公投第９案,基隆市,中山區,通明里,117,848,278,79,357,35,392
公投第９案,基隆市,中山區,通明里,118,922,330,80,410,16,426
公投第９案,基隆市,中山區,和平里,119,459,184,76,260,11,271
公投第９案,基隆市,中山區,仙洞里,120,574,208,39,247,33,280
公投第９案,基隆市,中山區,太白里,121,877,301,101,402,52,454
公投第９案,基隆市,中山區,協和里,122,1584,505,165,670,33,703
公投第９案,基隆市,中山區,文化里,123,1319,344,107,451,34,485
公投第９案,基隆市,中山區,德安里,124,1938,702,217,919,58,977
公投第９案,基隆市,中山區,德安里,125,1877,650,184,834,53,887
公投第９案,基隆市,中山區,德和里,126,2088,855,213,1068,30,1098
公投第９案,基隆市,中山區,德和里,127,1946,785,208,993,32,1025
公投第９案,基隆市,中山區,德和里,128,1353,537,169,706,59,765
公投第９案,基隆市,中山區,中和里,129,1317,472,154,626,48,674
公投第９案,基隆市,中山區,中和里,130,870,351,115,466,30,496
公投第９案,基隆市,中山區,中和里,131,1322,560,128,688,28,716
公投第９案,基隆市,中山區,中和里,132,1295,459,120,579,12,591
公投第９案,基隆市,中山區,中和里,133,756,342,96,438,21,459
公投第９案,基隆市,中山區,和慶里,134,1602,536,147,683,30,713
公投第９案,基隆市,中山區,和慶里,135,1568,536,174,710,38,748
公投第９案,基隆市,中山區,和慶里,136,1404,519,186,705,32,737
公投第９案,基隆市,中山區,和慶里,137,1909,681,151,832,26,858
公投第９案,基隆市,中山區,西康里,138,1642,498,185,683,72,755
公投第９案,基隆市,中山區,西定里,139,932,322,91,413,19,432
公投第９案,基隆市,中山區,西華里,140,849,323,142,465,48,513
公投第９案,基隆市,中山區,西榮里,141,715,270,109,379,49,428
公投第９案,基隆市,安樂區,新西里,142,1361,451,155,606,65,671
公投第９案,基隆市,安樂區,西川里,143,1213,435,109,544,35,579
公投第９案,基隆市,安樂區,定國里,144,1026,317,104,421,29,450
公投第９案,基隆市,安樂區,定邦里,145,1038,422,120,542,85,627
公投第９案,基隆市,安樂區,慈仁里,146,897,314,137,451,55,506
公投第９案,基隆市,安樂區,干城里,147,1401,518,164,682,59,741
公投第９案,基隆市,安樂區,干城里,148,641,157,49,206,9,215
公投第９案,基隆市,安樂區,永康里,149,1472,515,160,675,55,730
公投第９案,基隆市,安樂區,永康里,150,472,179,49,228,27,255
公投第９案,基隆市,安樂區,安和里,151,841,361,100,461,29,490
公投第９案,基隆市,安樂區,樂一里,152,571,204,70,274,29,303
公投第９案,基隆市,安樂區,嘉仁里,153,1901,633,204,837,43,880
公投第９案,基隆市,安樂區,嘉仁里,154,1349,487,162,649,46,695
公投第９案,基隆市,安樂區,三民里,155,1225,472,109,581,40,621
公投第９案,基隆市,安樂區,三民里,156,1351,538,153,691,53,744
公投第９案,基隆市,安樂區,壯觀里,157,1601,706,154,860,47,907
公投第９案,基隆市,安樂區,壯觀里,158,2513,1042,203,1245,44,1289
公投第９案,基隆市,安樂區,四維里,159,1613,699,136,835,37,872
公投第９案,基隆市,安樂區,四維里,160,1731,703,200,903,36,939
公投第９案,基隆市,安樂區,四維里,161,1424,630,186,816,26,842
公投第９案,基隆市,安樂區,五福里,162,1806,678,176,854,54,908
公投第９案,基隆市,安樂區,五福里,163,1679,716,173,889,48,937
公投第９案,基隆市,安樂區,六合里,164,1902,761,210,971,38,1009
公投第９案,基隆市,安樂區,六合里,165,2040,806,203,1009,40,1049
公投第９案,基隆市,安樂區,七賢里,166,1313,514,144,658,47,705
公投第９案,基隆市,安樂區,七賢里,167,1243,440,143,583,21,604
公投第９案,基隆市,安樂區,長樂里,168,1759,670,186,856,31,887
公投第９案,基隆市,安樂區,長樂里,169,694,309,113,422,15,437
公投第９案,基隆市,安樂區,長樂里,170,866,406,126,532,18,550
公投第９案,基隆市,安樂區,鶯歌里,171,1557,496,145,641,21,662
公投第９案,基隆市,安樂區,鶯歌里,172,1411,524,152,676,31,707
公投第９案,基隆市,安樂區,鶯安里,173,1568,703,155,858,31,889
公投第９案,基隆市,安樂區,鶯安里,174,1400,535,138,673,40,713
公投第９案,基隆市,安樂區,鶯安里,175,1531,655,103,758,13,771
公投第９案,基隆市,安樂區,興寮里,176,1673,632,142,774,19,793
公投第９案,基隆市,安樂區,興寮里,177,1054,398,112,510,48,558
公投第９案,基隆市,安樂區,興寮里,178,1923,630,144,774,33,807
公投第９案,基隆市,安樂區,外寮里,179,1960,771,212,983,63,1046
公投第９案,基隆市,安樂區,外寮里,180,1962,710,214,924,214,1138
公投第９案,基隆市,安樂區,新崙里,181,2117,822,211,1033,63,1096
公投第９案,基隆市,安樂區,新崙里,182,1829,665,131,796,38,834
公投第９案,基隆市,安樂區,武崙里,183,1529,581,125,706,30,736
公投第９案,基隆市,安樂區,武崙里,184,1869,740,172,912,40,952
公投第９案,基隆市,安樂區,武崙里,185,1140,508,98,606,14,620
公投第９案,基隆市,安樂區,中崙里,186,1641,622,174,796,51,847
公投第９案,基隆市,安樂區,內寮里,187,1279,473,147,620,39,659
公投第９案,基隆市,安樂區,內寮里,188,1360,542,122,664,24,688
公投第９案,基隆市,安樂區,內寮里,189,1399,547,176,723,36,759
公投第９案,基隆市,安樂區,內寮里,190,1251,480,131,611,30,641
公投第９案,基隆市,暖暖區,八西里,191,1431,495,160,655,45,700
公投第９案,基隆市,暖暖區,八中里,192,456,158,37,195,7,202
公投第９案,基隆市,暖暖區,八堵里,193,637,245,88,333,20,353
公投第９案,基隆市,暖暖區,八南里,194,735,303,94,397,25,422
公投第９案,基隆市,暖暖區,過港里,195,1078,380,101,481,26,507
公投第９案,基隆市,暖暖區,過港里,196,1238,447,150,597,38,635
公投第９案,基隆市,暖暖區,過港里,197,1325,513,119,632,37,669
公投第９案,基隆市,暖暖區,暖暖里,198,1475,581,150,731,39,770
公投第９案,基隆市,暖暖區,暖暖里,199,1179,385,112,497,28,525
公投第９案,基隆市,暖暖區,暖同里,200,1110,474,132,606,40,646
公投第９案,基隆市,暖暖區,暖同里,201,1443,498,134,632,26,658
公投第９案,基隆市,暖暖區,暖東里,202,415,146,52,198,25,223
公投第９案,基隆市,暖暖區,暖西里,203,1378,501,129,630,22,652
公投第９案,基隆市,暖暖區,暖西里,204,1570,601,185,786,21,807
公投第９案,基隆市,暖暖區,暖西里,205,1603,689,180,869,58,927
公投第９案,基隆市,暖暖區,碇內里,206,1267,529,149,678,39,717
公投第９案,基隆市,暖暖區,碇內里,207,1359,534,142,676,39,715
公投第９案,基隆市,暖暖區,碇和里,208,970,442,95,537,21,558
公投第９案,基隆市,暖暖區,碇和里,209,1002,416,74,490,23,513
公投第９案,基隆市,暖暖區,碇和里,210,944,340,106,446,23,469
公投第９案,基隆市,暖暖區,碇祥里,211,1500,615,183,798,42,840
公投第９案,基隆市,暖暖區,碇祥里,212,1442,426,123,549,28,577
公投第９案,基隆市,暖暖區,碇祥里,213,1165,484,116,600,23,623
公投第９案,基隆市,暖暖區,碇祥里,214,1610,608,168,776,24,800
公投第９案,基隆市,暖暖區,碇安里,215,1328,538,150,688,33,721
公投第９案,基隆市,暖暖區,碇安里,216,1173,418,143,561,27,588
公投第９案,基隆市,暖暖區,碇安里,217,1019,455,109,564,35,599
公投第９案,基隆市,暖暖區,碇安里,218,1373,555,154,709,18,727
公投第９案,基隆市,七堵區,長興里,219,1258,487,154,641,64,705
公投第９案,基隆市,七堵區,長興里,220,1237,477,157,634,52,686
公投第９案,基隆市,七堵區,長興里,221,1259,472,137,609,32,641
公投第９案,基隆市,七堵區,正光里,222,1120,384,120,504,52,556
公投第９案,基隆市,七堵區,正光里,223,1344,468,122,590,46,636
公投第９案,基隆市,七堵區,正明里,224,1011,449,120,569,47,616
公投第９案,基隆市,七堵區,正明里,225,925,324,111,435,29,464
公投第９案,基隆市,七堵區,富民里,226,1735,718,186,904,64,968
公投第９案,基隆市,七堵區,富民里,227,1833,637,330,967,63,1030
公投第９案,基隆市,七堵區,永平里,228,938,345,117,462,25,487
公投第９案,基隆市,七堵區,永平里,229,962,411,112,523,49,572
公投第９案,基隆市,七堵區,永安里,230,1191,480,158,638,35,673
公投第９案,基隆市,七堵區,永安里,231,999,399,118,517,45,562
公投第９案,基隆市,七堵區,八德里,232,282,105,24,129,8,137
公投第９案,基隆市,七堵區,八德里,233,1243,443,149,592,44,636
公投第９案,基隆市,七堵區,自強里,234,1092,391,124,515,47,562
公投第９案,基隆市,七堵區,泰安里,235,1246,456,153,609,59,668
公投第９案,基隆市,七堵區,泰安里,236,1722,636,206,842,44,886
公投第９案,基隆市,七堵區,泰安里,237,1318,488,158,646,38,684
公投第９案,基隆市,七堵區,六堵里,238,975,341,93,434,18,452
公投第９案,基隆市,七堵區,六堵里,239,1285,493,149,642,29,671
公投第９案,基隆市,七堵區,堵南里,240,1077,364,107,471,46,517
公投第９案,基隆市,七堵區,堵南里,241,989,333,105,438,29,467
公投第９案,基隆市,七堵區,長安里,242,1193,423,130,553,42,595
公投第９案,基隆市,七堵區,長安里,243,1273,464,151,615,49,664
公投第９案,基隆市,七堵區,堵北里,244,1774,655,218,873,71,944
公投第９案,基隆市,七堵區,堵北里,245,1689,655,180,835,60,895
公投第９案,基隆市,七堵區,百福里,246,1355,510,120,630,60,690
公投第９案,基隆市,七堵區,百福里,247,1512,518,187,705,56,761
公投第９案,基隆市,七堵區,百福里,248,1486,526,153,679,20,699
公投第９案,基隆市,七堵區,百福里,249,1706,662,158,820,24,844
公投第９案,基隆市,七堵區,實踐里,250,1384,531,159,690,56,746
公投第９案,基隆市,七堵區,實踐里,251,1045,437,150,587,39,626
公投第９案,基隆市,七堵區,實踐里,252,1374,546,154,700,31,731
公投第９案,基隆市,七堵區,瑪南里,253,428,156,55,211,7,218
公投第９案,基隆市,七堵區,瑪東里,254,326,114,52,166,30,196
公投第９案,基隆市,七堵區,瑪西里,255,351,176,49,225,23,248
公投第９案,基隆市,七堵區,友一里,256,1871,676,165,841,32,873
公投第９案,基隆市,七堵區,友二里,257,448,142,52,194,5,199
公投第９案,新竹市,東區,育賢里,1,1512,363,116,479,15,494
公投第９案,新竹市,東區,親仁里,2,953,446,112,558,23,581
公投第９案,新竹市,東區,親仁里,3,729,314,86,400,20,420
公投第９案,新竹市,東區,東門里,4,566,238,86,324,28,352
公投第９案,新竹市,東區,成功里,5,640,256,87,343,24,367
公投第９案,新竹市,東區,榮光里,6,305,114,35,149,23,172
公投第９案,新竹市,東區,中正里,7,563,233,85,318,19,337
公投第９案,新竹市,東區,錦華里,8,741,308,78,386,18,404
公投第９案,新竹市,東區,錦華里,9,1041,442,131,573,17,590
公投第９案,新竹市,東區,文華里,10,1615,689,152,841,24,865
公投第９案,新竹市,東區,文華里,11,1287,555,147,702,38,740
公投第９案,新竹市,東區,文華里,12,1554,685,166,851,28,879
公投第９案,新竹市,東區,復中里,13,1388,612,160,772,29,801
公投第９案,新竹市,東區,復中里,14,1419,627,157,784,38,822
公投第９案,新竹市,東區,復中里,15,1355,529,168,697,58,755
公投第９案,新竹市,東區,復興里,16,1490,621,164,785,39,824
公投第９案,新竹市,東區,復興里,17,1615,702,165,867,31,898
公投第９案,新竹市,東區,復興里,18,1672,724,186,910,36,946
公投第９案,新竹市,東區,三民里,19,1062,475,95,570,40,610
公投第９案,新竹市,東區,三民里,20,1315,551,152,703,49,752
公投第９案,新竹市,東區,三民里,21,1000,433,110,543,51,594
公投第９案,新竹市,東區,三民里,22,1337,574,175,749,39,788
公投第９案,新竹市,東區,東園里,23,1747,747,164,911,29,940
公投第９案,新竹市,東區,東園里,24,1600,729,190,919,38,957
公投第９案,新竹市,東區,東園里,25,1158,509,119,628,28,656
公投第９案,新竹市,東區,東園里,26,828,399,112,511,30,541
公投第９案,新竹市,東區,公園里,27,1573,657,172,829,42,871
公投第９案,新竹市,東區,公園里,28,1550,681,164,845,45,890
公投第９案,新竹市,東區,建華里,29,1317,526,165,691,31,722
公投第９案,新竹市,東區,建華里,30,1040,441,158,599,44,643
公投第９案,新竹市,東區,東山里,31,935,438,78,516,27,543
公投第９案,新竹市,東區,東山里,32,1074,465,106,571,24,595
公投第９案,新竹市,東區,東山里,33,1133,517,134,651,38,689
公投第９案,新竹市,東區,綠水里,34,1262,553,164,717,41,758
公投第９案,新竹市,東區,綠水里,35,1199,525,130,655,25,680
公投第９案,新竹市,東區,綠水里,36,1226,581,136,717,36,753
公投第９案,新竹市,東區,綠水里,37,1377,674,159,833,43,876
公投第９案,新竹市,東區,綠水里,38,991,458,147,605,26,631
公投第９案,新竹市,東區,東勢里,39,1271,536,153,689,76,765
公投第９案,新竹市,東區,東勢里,40,1012,511,120,631,20,651
公投第９案,新竹市,東區,光復里,41,1001,413,115,528,59,587
公投第９案,新竹市,東區,光復里,42,1603,599,199,798,55,853
公投第９案,新竹市,東區,前溪里,43,1236,471,158,629,41,670
公投第９案,新竹市,東區,前溪里,44,1532,553,138,691,47,738
公投第９案,新竹市,東區,水源里,45,1306,534,148,682,39,721
公投第９案,新竹市,東區,水源里,46,1073,450,113,563,63,626
公投第９案,新竹市,東區,水源里,47,952,382,99,481,30,511
公投第９案,新竹市,東區,千甲里,48,1298,448,122,570,34,604
公投第９案,新竹市,東區,千甲里,49,778,328,67,395,17,412
公投第９案,新竹市,東區,豐功里,50,1195,488,180,668,38,706
公投第９案,新竹市,東區,豐功里,51,1569,636,170,806,62,868
公投第９案,新竹市,東區,豐功里,52,1533,761,164,925,34,959
公投第９案,新竹市,東區,武功里,53,1336,639,132,771,41,812
公投第９案,新竹市,東區,武功里,54,1367,676,95,771,36,807
公投第９案,新竹市,東區,武功里,55,1289,627,118,745,42,787
公投第９案,新竹市,東區,軍功里,56,960,388,111,499,29,528
公投第９案,新竹市,東區,軍功里,57,843,400,105,505,29,534
公投第９案,新竹市,東區,軍功里,58,948,412,115,527,44,571
公投第９案,新竹市,東區,立功里,59,915,408,69,477,37,514
公投第９案,新竹市,東區,建功里,60,1801,840,157,997,38,1035
公投第９案,新竹市,東區,建功里,61,1079,456,128,584,26,610
公投第９案,新竹市,東區,建功里,62,676,338,65,403,12,415
公投第９案,新竹市,東區,光明里,63,1132,500,125,625,49,674
公投第９案,新竹市,東區,光明里,64,251,97,44,141,11,152
公投第９案,新竹市,東區,光明里,65,1620,675,202,877,49,926
公投第９案,新竹市,東區,龍山里,66,1479,595,168,763,37,800
公投第９案,新竹市,東區,龍山里,67,1402,555,174,729,24,753
公投第９案,新竹市,東區,龍山里,68,1280,532,146,678,39,717
公投第９案,新竹市,東區,龍山里,69,1228,541,162,703,23,726
公投第９案,新竹市,東區,龍山里,70,1157,484,126,610,8,618
公投第９案,新竹市,東區,龍山里,71,1354,578,163,741,27,768
公投第９案,新竹市,東區,科園里,72,1334,622,145,767,30,797
公投第９案,新竹市,東區,科園里,73,1234,555,128,683,38,721
公投第９案,新竹市,東區,科園里,74,1398,670,176,846,33,879
公投第９案,新竹市,東區,科園里,75,928,403,145,548,22,570
公投第９案,新竹市,東區,科園里,76,1368,684,133,817,29,846
公投第９案,新竹市,東區,埔頂里,77,1215,467,125,592,22,614
公投第９案,新竹市,東區,埔頂里,78,1067,390,108,498,38,536
公投第９案,新竹市,東區,埔頂里,79,1194,491,148,639,17,656
公投第９案,新竹市,東區,埔頂里,80,1193,490,131,621,18,639
公投第９案,新竹市,東區,新莊里,81,1388,568,167,735,70,805
公投第９案,新竹市,東區,新莊里,82,1267,570,137,707,24,731
公投第９案,新竹市,東區,新莊里,83,1299,579,129,708,22,730
公投第９案,新竹市,東區,新莊里,84,1288,570,133,703,36,739
公投第９案,新竹市,東區,關新里,85,1228,549,174,723,21,744
公投第９案,新竹市,東區,關新里,86,1135,547,130,677,12,689
公投第９案,新竹市,東區,關新里,87,1237,607,157,764,21,785
公投第９案,新竹市,東區,關東里,88,1135,464,96,560,40,600
公投第９案,新竹市,東區,關東里,89,1165,463,101,564,24,588
公投第９案,新竹市,東區,關東里,90,1124,465,121,586,33,619
公投第９案,新竹市,東區,關東里,91,1210,521,154,675,36,711
公投第９案,新竹市,東區,金山里,92,1323,542,138,680,36,716
公投第９案,新竹市,東區,金山里,93,1207,515,98,613,21,634
公投第９案,新竹市,東區,金山里,94,1264,493,98,591,33,624
公投第９案,新竹市,東區,金山里,95,1248,513,149,662,16,678
公投第９案,新竹市,東區,仙水里,96,1400,660,163,823,35,858
公投第９案,新竹市,東區,仙水里,97,1473,684,185,869,30,899
公投第９案,新竹市,東區,仙水里,98,1367,578,151,729,40,769
公投第９案,新竹市,東區,仙宮里,99,1233,525,148,673,27,700
公投第９案,新竹市,東區,關帝里,100,507,188,67,255,14,269
公投第９案,新竹市,東區,南門里,101,714,293,95,388,31,419
公投第９案,新竹市,東區,南市里,102,875,337,119,456,52,508
公投第９案,新竹市,東區,福德里,103,1396,574,157,731,54,785
公投第９案,新竹市,東區,振興里,104,1232,465,146,611,38,649
公投第９案,新竹市,東區,振興里,105,1323,507,162,669,46,715
公投第９案,新竹市,東區,振興里,106,1516,544,125,669,22,691
公投第９案,新竹市,東區,振興里,107,1453,534,167,701,43,744
公投第９案,新竹市,東區,新興里,108,880,349,129,478,39,517
公投第９案,新竹市,東區,新興里,109,1058,440,90,530,32,562
公投第９案,新竹市,東區,新興里,110,1061,420,142,562,34,596
公投第９案,新竹市,東區,寺前里,111,710,275,98,373,29,402
公投第９案,新竹市,東區,竹蓮里,112,752,309,99,408,45,453
公投第９案,新竹市,東區,下竹里,113,475,215,66,281,19,300
公投第９案,新竹市,東區,頂竹里,114,880,320,115,435,30,465
公投第９案,新竹市,東區,頂竹里,115,989,394,152,546,30,576
公投第９案,新竹市,東區,頂竹里,116,1059,446,134,580,31,611
公投第９案,新竹市,東區,南大里,117,607,240,82,322,48,370
公投第９案,新竹市,東區,南大里,118,815,322,114,436,38,474
公投第９案,新竹市,東區,新光里,119,777,344,96,440,41,481
公投第９案,新竹市,東區,新光里,120,1399,496,149,645,30,675
公投第９案,新竹市,東區,新光里,121,1216,475,157,632,39,671
公投第９案,新竹市,東區,光鎮里,122,1062,406,112,518,37,555
公投第９案,新竹市,東區,光鎮里,123,1046,470,105,575,25,600
公投第９案,新竹市,東區,光鎮里,124,1332,528,137,665,19,684
公投第９案,新竹市,東區,高峰里,125,1350,532,197,729,53,782
公投第９案,新竹市,東區,高峰里,126,1438,551,155,706,17,723
公投第９案,新竹市,東區,高峰里,127,1414,509,160,669,48,717
公投第９案,新竹市,東區,高峰里,128,1476,604,199,803,29,832
公投第９案,新竹市,東區,湖濱里,129,1326,604,154,758,52,810
公投第９案,新竹市,東區,湖濱里,130,927,448,111,559,14,573
公投第９案,新竹市,東區,湖濱里,131,1273,533,151,684,25,709
公投第９案,新竹市,東區,柴橋里,132,1315,509,150,659,34,693
公投第９案,新竹市,東區,柴橋里,133,1413,593,154,747,34,781
公投第９案,新竹市,東區,柴橋里,134,1064,454,114,568,30,598
公投第９案,新竹市,東區,柴橋里,135,1244,584,177,761,25,786
公投第９案,新竹市,東區,明湖里,136,1160,450,139,589,7,596
公投第９案,新竹市,東區,明湖里,137,1398,520,141,661,23,684
公投第９案,新竹市,東區,明湖里,138,1384,432,118,550,14,564
公投第９案,新竹市,東區,明湖里,139,874,411,94,505,31,536
公投第９案,新竹市,北區,中央里,140,477,164,59,223,11,234
公投第９案,新竹市,北區,西門里,141,535,226,73,299,22,321
公投第９案,新竹市,北區,潛園里,142,746,278,110,388,56,444
公投第９案,新竹市,北區,石坊里,143,546,188,74,262,16,278
公投第９案,新竹市,北區,仁德里,144,711,305,95,400,39,439
公投第９案,新竹市,北區,崇禮里,145,1143,414,114,528,38,566
公投第９案,新竹市,北區,興南里,146,1370,508,156,664,46,710
公投第９案,新竹市,北區,育英里,147,1390,529,180,709,40,749
公投第９案,新竹市,北區,育英里,148,962,407,93,500,30,530
公投第９案,新竹市,北區,育英里,149,1237,499,152,651,17,668
公投第９案,新竹市,北區,台溪里,150,1604,568,179,747,45,792
公投第９案,新竹市,北區,曲溪里,151,758,262,83,345,15,360
公投第９案,新竹市,北區,曲溪里,152,1320,520,116,636,26,662
公投第９案,新竹市,北區,曲溪里,153,1519,562,143,705,58,763
公投第９案,新竹市,北區,曲溪里,154,347,99,29,128,5,133
公投第９案,新竹市,北區,曲溪里,155,1212,529,134,663,44,707
公投第９案,新竹市,北區,西雅里,156,1484,566,165,731,37,768
公投第９案,新竹市,北區,西雅里,157,1428,534,177,711,64,775
公投第９案,新竹市,北區,客雅里,158,1128,474,127,601,24,625
公投第９案,新竹市,北區,客雅里,159,638,247,81,328,16,344
公投第９案,新竹市,北區,中雅里,160,1222,576,79,655,50,705
公投第９案,新竹市,北區,中雅里,161,1076,510,108,618,27,645
公投第９案,新竹市,北區,中雅里,162,937,484,98,582,29,611
公投第９案,新竹市,北區,南勢里,163,1394,566,130,696,52,748
公投第９案,新竹市,北區,南勢里,164,1568,545,174,719,45,764
公投第９案,新竹市,北區,南勢里,165,1159,482,178,660,45,705
公投第９案,新竹市,北區,大鵬里,166,252,86,14,100,5,105
公投第９案,新竹市,北區,大同里,167,761,350,89,439,26,465
公投第９案,新竹市,北區,中山里,168,788,316,111,427,41,468
公投第９案,新竹市,北區,中興里,169,561,253,61,314,46,360
公投第９案,新竹市,北區,新民里,170,1558,574,163,737,85,822
公投第９案,新竹市,北區,長和里,171,1398,483,154,637,32,669
公投第９案,新竹市,北區,北門里,172,957,384,112,496,36,532
公投第９案,新竹市,北區,民富里,173,1195,502,124,626,52,678
公投第９案,新竹市,北區,民富里,174,1236,431,142,573,36,609
公投第９案,新竹市,北區,民富里,175,1255,456,144,600,54,654
公投第９案,新竹市,北區,民富里,176,1114,466,121,587,34,621
公投第９案,新竹市,北區,磐石里,177,1396,577,153,730,24,754
公投第９案,新竹市,北區,磐石里,178,1456,603,178,781,55,836
公投第９案,新竹市,北區,磐石里,179,1374,583,129,712,29,741
公投第９案,新竹市,北區,磐石里,180,1070,411,118,529,44,573
公投第９案,新竹市,北區,新雅里,181,1142,461,118,579,60,639
公投第９案,新竹市,北區,新雅里,182,1103,402,131,533,22,555
公投第９案,新竹市,北區,新雅里,183,1190,457,149,606,71,677
公投第９案,新竹市,北區,新雅里,184,1089,528,115,643,27,670
公投第９案,新竹市,北區,文雅里,185,1272,444,124,568,23,591
公投第９案,新竹市,北區,文雅里,186,1306,530,152,682,60,742
公投第９案,新竹市,北區,文雅里,187,1328,533,149,682,65,747
公投第９案,新竹市,北區,水田里,188,1457,568,148,716,38,754
公投第９案,新竹市,北區,水田里,189,1492,601,182,783,49,832
公投第９案,新竹市,北區,光田里,190,1160,506,143,649,55,704
公投第９案,新竹市,北區,光田里,191,971,404,118,522,48,570
公投第９案,新竹市,北區,光華里,192,1401,330,91,421,19,440
公投第９案,新竹市,北區,光華里,193,1340,581,143,724,38,762
公投第９案,新竹市,北區,光華里,194,1371,595,163,758,37,795
公投第９案,新竹市,北區,金華里,195,1267,516,135,651,22,673
公投第９案,新竹市,北區,金華里,196,1073,500,122,622,44,666
公投第９案,新竹市,北區,金華里,197,1159,499,131,630,48,678
公投第９案,新竹市,北區,金華里,198,1294,513,149,662,25,687
公投第９案,新竹市,北區,湳雅里,199,1442,594,158,752,44,796
公投第９案,新竹市,北區,湳雅里,200,1270,546,156,702,24,726
公投第９案,新竹市,北區,金雅里,201,1179,528,156,684,40,724
公投第９案,新竹市,北區,金雅里,202,949,448,113,561,36,597
公投第９案,新竹市,北區,湳中里,203,1163,500,129,629,44,673
公投第９案,新竹市,北區,湳中里,204,1334,544,147,691,26,717
公投第９案,新竹市,北區,湳中里,205,1415,616,140,756,38,794
公投第９案,新竹市,北區,湳中里,206,1305,588,169,757,32,789
公投第９案,新竹市,北區,湳中里,207,1200,540,114,654,28,682
公投第９案,新竹市,北區,舊社里,208,1106,459,130,589,25,614
公投第９案,新竹市,北區,舊社里,209,1044,481,124,605,23,628
公投第９案,新竹市,北區,舊社里,210,1061,457,136,593,35,628
公投第９案,新竹市,北區,舊社里,211,1518,651,174,825,69,894
公投第９案,新竹市,北區,舊社里,212,1220,551,155,706,50,756
公投第９案,新竹市,北區,金竹里,213,1475,646,175,821,16,837
公投第９案,新竹市,北區,金竹里,214,1373,542,149,691,54,745
公投第９案,新竹市,北區,金竹里,215,1450,632,159,791,28,819
公投第９案,新竹市,北區,金竹里,216,1423,638,147,785,42,827
公投第９案,新竹市,北區,武陵里,217,1059,403,192,595,17,612
公投第９案,新竹市,北區,武陵里,218,1130,547,101,648,38,686
公投第９案,新竹市,北區,武陵里,219,1208,603,110,713,37,750
公投第９案,新竹市,北區,武陵里,220,1226,621,100,721,40,761
公投第９案,新竹市,北區,福林里,221,1175,514,124,638,28,666
公投第９案,新竹市,北區,福林里,222,1371,604,136,740,24,764
公投第９案,新竹市,北區,福林里,223,1306,530,138,668,49,717
公投第９案,新竹市,北區,境福里,224,1340,541,136,677,24,701
公投第９案,新竹市,北區,境福里,225,1111,478,146,624,59,683
公投第９案,新竹市,北區,境福里,226,1197,561,147,708,51,759
公投第９案,新竹市,北區,境福里,227,1008,452,88,540,34,574
公投第９案,新竹市,北區,士林里,228,946,366,108,474,26,500
公投第９案,新竹市,北區,士林里,229,705,299,91,390,32,422
公投第９案,新竹市,北區,古賢里,230,848,333,108,441,63,504
公投第９案,新竹市,北區,南寮里,231,1295,523,131,654,31,685
公投第９案,新竹市,北區,南寮里,232,1467,573,125,698,40,738
公投第９案,新竹市,北區,南寮里,233,1659,555,148,703,47,750
公投第９案,新竹市,北區,南寮里,234,1297,497,131,628,44,672
公投第９案,新竹市,北區,康樂里,235,1374,557,168,725,64,789
公投第９案,新竹市,北區,康樂里,236,1457,631,136,767,73,840
公投第９案,新竹市,北區,中寮里,237,1072,498,102,600,32,632
公投第９案,新竹市,北區,中寮里,238,1350,544,127,671,54,725
公投第９案,新竹市,北區,中寮里,239,971,442,124,566,39,605
公投第９案,新竹市,北區,海濱里,240,1450,641,150,791,58,849
公投第９案,新竹市,北區,海濱里,241,895,364,116,480,26,506
公投第９案,新竹市,北區,海濱里,242,1378,586,132,718,35,753
公投第９案,新竹市,北區,港北里,243,1609,577,179,756,93,849
公投第９案,新竹市,北區,舊港里,244,594,232,71,303,43,346
公投第９案,新竹市,香山區,頂埔里,245,1443,599,124,723,55,778
公投第９案,新竹市,香山區,頂埔里,246,1241,502,143,645,40,685
公投第９案,新竹市,香山區,頂埔里,247,1194,516,105,621,25,646
公投第９案,新竹市,香山區,頂埔里,248,1081,485,93,578,19,597
公投第９案,新竹市,香山區,頂福里,249,807,346,83,429,25,454
公投第９案,新竹市,香山區,頂福里,250,1760,714,189,903,53,956
公投第９案,新竹市,香山區,頂福里,251,1635,718,155,873,40,913
公投第９案,新竹市,香山區,中埔里,252,1473,628,173,801,51,852
公投第９案,新竹市,香山區,中埔里,253,1408,629,136,765,23,788
公投第９案,新竹市,香山區,牛埔里,254,1318,467,120,587,30,617
公投第９案,新竹市,香山區,牛埔里,255,1337,571,131,702,54,756
公投第９案,新竹市,香山區,牛埔里,256,1862,736,187,923,33,956
公投第９案,新竹市,香山區,埔前里,257,1067,450,116,566,20,586
公投第９案,新竹市,香山區,埔前里,258,863,389,107,496,33,529
公投第９案,新竹市,香山區,埔前里,259,1198,541,136,677,64,741
公投第９案,新竹市,香山區,樹下里,260,1138,473,159,632,58,690
公投第９案,新竹市,香山區,樹下里,261,957,460,114,574,56,630
公投第９案,新竹市,香山區,浸水里,262,1348,581,140,721,79,800
公投第９案,新竹市,香山區,浸水里,263,1023,493,130,623,58,681
公投第９案,新竹市,香山區,虎林里,264,970,410,107,517,27,544
公投第９案,新竹市,香山區,虎林里,265,1318,571,133,704,45,749
公投第９案,新竹市,香山區,虎山里,266,1088,431,128,559,47,606
公投第９案,新竹市,香山區,虎山里,267,903,330,80,410,20,430
公投第９案,新竹市,香山區,虎山里,268,1012,398,152,550,39,589
公投第９案,新竹市,香山區,虎山里,269,1014,422,117,539,36,575
公投第９案,新竹市,香山區,虎山里,270,1238,538,134,672,28,700
公投第９案,新竹市,香山區,港南里,271,1182,474,118,592,66,658
公投第９案,新竹市,香山區,港南里,272,1331,592,171,763,83,846
公投第９案,新竹市,香山區,東香里,273,976,464,139,603,15,618
公投第９案,新竹市,香山區,東香里,274,834,328,99,427,17,444
公投第９案,新竹市,香山區,東香里,275,919,401,91,492,38,530
公投第９案,新竹市,香山區,東香里,276,1188,531,133,664,37,701
公投第９案,新竹市,香山區,香村里,277,1086,439,147,586,39,625
公投第９案,新竹市,香山區,香村里,278,1144,529,140,669,44,713
公投第９案,新竹市,香山區,香村里,279,1112,498,116,614,42,656
公投第９案,新竹市,香山區,香山里,280,1476,655,146,801,50,851
公投第９案,新竹市,香山區,香山里,281,1291,560,130,690,29,719
公投第９案,新竹市,香山區,香山里,282,1464,660,193,853,49,902
公投第９案,新竹市,香山區,大庄里,283,1427,638,143,781,70,851
公投第９案,新竹市,香山區,大庄里,284,1336,559,156,715,33,748
公投第９案,新竹市,香山區,美山里,285,1131,390,232,622,34,656
公投第９案,新竹市,香山區,朝山里,286,1070,432,136,568,81,649
公投第９案,新竹市,香山區,朝山里,287,1006,429,127,556,61,617
公投第９案,新竹市,香山區,海山里,288,1223,425,101,526,33,559
公投第９案,新竹市,香山區,海山里,289,1119,449,128,577,28,605
公投第９案,新竹市,香山區,鹽水里,290,1400,509,135,644,40,684
公投第９案,新竹市,香山區,內湖里,291,1627,566,148,714,38,752
公投第９案,新竹市,香山區,內湖里,292,1289,475,121,596,51,647
公投第９案,新竹市,香山區,內湖里,293,1409,520,139,659,56,715
公投第９案,新竹市,香山區,南港里,294,814,290,97,387,28,415
公投第９案,新竹市,香山區,中隘里,295,719,288,81,369,30,399
公投第９案,新竹市,香山區,中隘里,296,1065,368,111,479,19,498
公投第９案,新竹市,香山區,南隘里,297,776,323,83,406,24,430
公投第９案,新竹市,香山區,大湖里,298,890,381,90,471,41,512
公投第９案,新竹市,香山區,茄苳里,299,896,345,76,421,25,446
公投第９案,嘉義市,東區,短竹里,1,1025,427,114,541,30,571
公投第９案,嘉義市,東區,短竹里,2,1276,504,134,638,23,661
公投第９案,嘉義市,東區,蘭潭里,3,974,348,109,457,38,495
公投第９案,嘉義市,東區,蘭潭里,4,1175,515,158,673,45,718
公投第９案,嘉義市,東區,東川里,5,702,298,100,398,33,431
公投第９案,嘉義市,東區,東川里,6,1092,442,111,553,21,574
公投第９案,嘉義市,東區,鹿寮里,7,1023,332,106,438,13,451
公投第９案,嘉義市,東區,盧厝里,8,1816,681,186,867,66,933
公投第９案,嘉義市,東區,文雅里,9,1936,261,741,1002,52,1054
公投第９案,嘉義市,東區,文雅里,10,1698,690,213,903,27,930
公投第９案,嘉義市,東區,王田里,11,1221,500,167,667,27,694
公投第９案,嘉義市,東區,王田里,12,1113,418,157,575,24,599
公投第９案,嘉義市,東區,長竹里,13,1452,574,200,774,49,823
公投第９案,嘉義市,東區,長竹里,14,1395,632,179,811,36,847
公投第９案,嘉義市,東區,後庄里,15,1453,489,160,649,50,699
公投第９案,嘉義市,東區,後庄里,16,1094,423,109,532,22,554
公投第９案,嘉義市,東區,後庄里,17,1420,596,152,748,36,784
公投第９案,嘉義市,東區,新店里,18,1552,645,218,863,45,908
公投第９案,嘉義市,東區,新店里,19,1558,644,184,828,56,884
公投第９案,嘉義市,東區,新店里,20,1062,434,143,577,40,617
公投第９案,嘉義市,東區,圳頭里,21,1199,459,146,605,52,657
公投第９案,嘉義市,東區,圳頭里,22,1236,522,119,641,30,671
公投第９案,嘉義市,東區,圳頭里,23,890,352,97,449,21,470
公投第９案,嘉義市,東區,圳頭里,24,880,374,120,494,39,533
公投第９案,嘉義市,東區,中山里,25,1189,466,144,610,17,627
公投第９案,嘉義市,東區,中山里,26,669,269,89,358,22,380
公投第９案,嘉義市,東區,太平里,27,1435,569,167,736,44,780
公投第９案,嘉義市,東區,太平里,28,1349,582,181,763,47,810
公投第９案,嘉義市,東區,太平里,29,1455,570,165,735,24,759
公投第９案,嘉義市,東區,東興里,30,915,368,126,494,32,526
公投第９案,嘉義市,東區,東興里,31,952,336,150,486,26,512
公投第９案,嘉義市,東區,華南里,32,941,359,115,474,55,529
公投第９案,嘉義市,東區,華南里,33,1080,386,138,524,23,547
公投第９案,嘉義市,東區,中央里,34,1157,381,133,514,24,538
公投第９案,嘉義市,東區,中央里,35,1053,430,145,575,31,606
公投第９案,嘉義市,東區,朝陽里,36,967,318,109,427,26,453
公投第９案,嘉義市,東區,朝陽里,37,1091,380,141,521,27,548
公投第９案,嘉義市,東區,民族里,38,961,388,116,504,61,565
公投第９案,嘉義市,東區,民族里,39,863,244,84,328,26,354
公投第９案,嘉義市,東區,過溝里,40,1023,442,113,555,59,614
公投第９案,嘉義市,東區,過溝里,41,1078,403,154,557,87,644
公投第９案,嘉義市,東區,新開里,42,938,303,163,466,19,485
公投第９案,嘉義市,東區,新開里,43,1049,413,122,535,31,566
公投第９案,嘉義市,東區,宣信里,44,1360,469,167,636,69,705
公投第９案,嘉義市,東區,興南里,45,1615,464,219,683,99,782
公投第９案,嘉義市,東區,豐年里,46,1267,464,156,620,52,672
公投第９案,嘉義市,東區,芳草里,47,1579,515,167,682,70,752
公投第９案,嘉義市,東區,芳草里,48,1831,652,206,858,80,938
公投第９案,嘉義市,東區,芳安里,49,977,400,120,520,33,553
公投第９案,嘉義市,東區,芳安里,50,1169,413,147,560,31,591
公投第９案,嘉義市,東區,頂寮里,51,1238,479,181,660,77,737
公投第９案,嘉義市,東區,頂寮里,52,1266,519,149,668,14,682
公投第９案,嘉義市,東區,安寮里,53,1429,490,131,621,40,661
公投第９案,嘉義市,東區,安寮里,54,1288,528,138,666,22,688
公投第９案,嘉義市,東區,安業里,55,980,391,118,509,29,538
公投第９案,嘉義市,東區,安業里,56,922,334,106,440,27,467
公投第９案,嘉義市,東區,興村里,57,1133,458,155,613,49,662
公投第９案,嘉義市,東區,興村里,58,1235,517,140,657,50,707
公投第９案,嘉義市,東區,興村里,59,1525,606,157,763,18,781
公投第９案,嘉義市,東區,興安里,60,1170,429,128,557,46,603
公投第９案,嘉義市,東區,興安里,61,1177,518,157,675,63,738
公投第９案,嘉義市,東區,興仁里,62,1207,470,153,623,60,683
公投第９案,嘉義市,東區,興仁里,63,1272,533,137,670,53,723
公投第９案,嘉義市,東區,興仁里,64,1188,432,152,584,88,672
公投第９案,嘉義市,東區,北門里,65,1172,418,131,549,25,574
公投第９案,嘉義市,東區,北門里,66,1020,426,127,553,41,594
公投第９案,嘉義市,東區,林森里,67,1332,534,163,697,55,752
公投第９案,嘉義市,東區,林森里,68,1011,440,145,585,37,622
公投第９案,嘉義市,東區,中庄里,69,1682,571,234,805,71,876
公投第９案,嘉義市,東區,中庄里,70,1567,624,166,790,67,857
公投第９案,嘉義市,東區,頂庄里,71,1207,488,130,618,21,639
公投第９案,嘉義市,東區,頂庄里,72,981,433,110,543,18,561
公投第９案,嘉義市,東區,義教里,73,1395,534,149,683,39,722
公投第９案,嘉義市,東區,義教里,74,1434,473,148,621,22,643
公投第９案,嘉義市,東區,仁義里,75,1404,458,134,592,24,616
公投第９案,嘉義市,東區,仁義里,76,1428,595,144,739,41,780
公投第９案,嘉義市,東區,後湖里,77,1823,570,148,718,30,748
公投第９案,嘉義市,東區,後湖里,78,1570,555,164,719,35,754
公投第９案,嘉義市,東區,荖藤里,79,1282,440,149,589,53,642
公投第９案,嘉義市,東區,荖藤里,80,1571,710,164,874,54,928
公投第９案,嘉義市,東區,荖藤里,81,1533,576,155,731,30,761
公投第９案,嘉義市,西區,書院里,82,885,323,111,434,25,459
公投第９案,嘉義市,西區,書院里,83,1109,411,133,544,59,603
公投第９案,嘉義市,西區,永和里,84,1020,336,116,452,43,495
公投第９案,嘉義市,西區,永和里,85,925,400,123,523,53,576
公投第９案,嘉義市,西區,新富里,86,1671,471,211,682,40,722
公投第９案,嘉義市,西區,文化里,87,1215,484,135,619,26,645
公投第９案,嘉義市,西區,文化里,88,1036,397,98,495,26,521
公投第９案,嘉義市,西區,西榮里,89,1129,388,146,534,30,564
公投第９案,嘉義市,西區,西榮里,90,1127,419,23,442,29,471
公投第９案,嘉義市,西區,番社里,91,1415,514,175,689,51,740
公投第９案,嘉義市,西區,國華里,92,1366,521,134,655,27,682
公投第９案,嘉義市,西區,大溪里,93,1053,440,139,579,64,643
公投第９案,嘉義市,西區,大溪里,94,1067,416,112,528,27,555
公投第９案,嘉義市,西區,磚磘里,95,1575,533,81,614,33,647
公投第９案,嘉義市,西區,磚磘里,96,1865,699,219,918,53,971
公投第９案,嘉義市,西區,福全里,97,1196,432,106,538,47,585
公投第９案,嘉義市,西區,福全里,98,1280,431,135,566,25,591
公投第９案,嘉義市,西區,福全里,99,1629,603,189,792,86,878
公投第９案,嘉義市,西區,福安里,100,1393,554,162,716,72,788
公投第９案,嘉義市,西區,福安里,101,1077,428,145,573,53,626
公投第９案,嘉義市,西區,福安里,102,1694,580,176,756,42,798
公投第９案,嘉義市,西區,新西里,103,841,331,116,447,78,525
公投第９案,嘉義市,西區,新西里,104,1183,426,120,546,8,554
公投第９案,嘉義市,西區,港坪里,105,1000,456,117,573,26,599
公投第９案,嘉義市,西區,港坪里,106,1095,469,132,601,24,625
公投第９案,嘉義市,西區,港坪里,107,1256,528,160,688,39,727
公投第９案,嘉義市,西區,頭港里,108,962,425,89,514,45,559
公投第９案,嘉義市,西區,頭港里,109,865,378,127,505,22,527
公投第９案,嘉義市,西區,西平里,110,1396,503,149,652,67,719
公投第９案,嘉義市,西區,西平里,111,1799,731,175,906,69,975
公投第９案,嘉義市,西區,劉厝里,112,1505,565,128,693,34,727
公投第９案,嘉義市,西區,劉厝里,113,1698,661,158,819,65,884
公投第９案,嘉義市,西區,劉厝里,114,1854,727,194,921,27,948
公投第９案,嘉義市,西區,劉厝里,115,1537,512,135,647,17,664
公投第９案,嘉義市,西區,自強里,116,1604,553,188,741,77,818
公投第９案,嘉義市,西區,美源里,117,944,400,130,530,65,595
公投第９案,嘉義市,西區,美源里,118,1627,769,78,847,84,931
公投第９案,嘉義市,西區,美源里,119,1144,472,150,622,50,672
公投第９案,嘉義市,西區,湖內里,120,1362,532,160,692,49,741
公投第９案,嘉義市,西區,湖內里,121,1279,514,171,685,36,721
公投第９案,嘉義市,西區,湖內里,122,1702,759,177,936,1,937
公投第９案,嘉義市,西區,獅子里,123,1358,575,168,743,50,793
公投第９案,嘉義市,西區,獅子里,124,1360,582,180,762,67,829
公投第９案,嘉義市,西區,紅瓦里,125,1589,662,180,842,51,893
公投第９案,嘉義市,西區,光路里,126,1280,571,150,721,38,759
公投第９案,嘉義市,西區,光路里,127,1220,437,119,556,32,588
公投第９案,嘉義市,西區,光路里,128,1172,524,110,634,33,667
公投第９案,嘉義市,西區,光路里,129,1320,531,157,688,43,731
公投第９案,嘉義市,西區,福民里,130,1185,594,129,723,28,751
公投第９案,嘉義市,西區,福民里,131,1278,527,180,707,59,766
公投第９案,嘉義市,西區,福民里,132,1394,467,120,587,33,620
公投第９案,嘉義市,西區,福民里,133,1540,623,188,811,55,866
公投第９案,嘉義市,西區,車店里,134,1548,637,156,793,74,867
公投第９案,嘉義市,西區,車店里,135,1295,502,145,647,35,682
公投第９案,嘉義市,西區,車店里,136,1318,581,161,742,55,797
公投第９案,嘉義市,西區,車店里,137,1545,648,151,799,52,851
公投第９案,嘉義市,西區,垂楊里,138,736,259,74,333,22,355
公投第９案,嘉義市,西區,垂楊里,139,1168,444,119,563,21,584
公投第９案,嘉義市,西區,培元里,140,756,336,101,437,37,474
公投第９案,嘉義市,西區,培元里,141,869,386,70,456,15,471
公投第９案,嘉義市,西區,育英里,142,983,410,120,530,48,578
公投第９案,嘉義市,西區,育英里,143,828,341,93,434,35,469
公投第９案,嘉義市,西區,致遠里,144,1775,776,159,935,44,979
公投第９案,嘉義市,西區,翠岱里,145,1419,594,100,694,44,738
公投第９案,嘉義市,西區,導明里,146,779,282,90,372,18,390
公投第９案,嘉義市,西區,導明里,147,855,314,81,395,16,411
公投第９案,嘉義市,西區,北榮里,148,1146,483,119,602,71,673
公投第９案,嘉義市,西區,北榮里,149,1111,448,144,592,26,618
公投第９案,嘉義市,西區,慶安里,150,767,330,111,441,51,492
公投第９案,嘉義市,西區,慶安里,151,817,262,94,356,26,382
公投第９案,嘉義市,西區,香湖里,152,770,286,109,395,50,445
公投第９案,嘉義市,西區,重興里,153,1135,310,149,459,16,475
公投第９案,嘉義市,西區,重興里,154,835,271,101,372,83,455
公投第９案,嘉義市,西區,後驛里,155,1182,405,119,524,36,560
公投第９案,嘉義市,西區,後驛里,156,944,292,105,397,40,437
公投第９案,嘉義市,西區,湖邊里,157,997,350,112,462,37,499
公投第９案,嘉義市,西區,湖邊里,158,1074,398,130,528,29,557
公投第９案,嘉義市,西區,竹圍里,159,1460,460,141,601,21,622
公投第９案,嘉義市,西區,竹圍里,160,1352,508,143,651,30,681
公投第９案,嘉義市,西區,竹圍里,161,1499,584,181,765,45,810
公投第９案,嘉義市,西區,保生里,162,1262,413,178,591,102,693
公投第９案,嘉義市,西區,保生里,163,1299,458,162,620,43,663
公投第９案,嘉義市,西區,保生里,164,1734,604,187,791,64,855
公投第９案,嘉義市,西區,保安里,165,1674,656,130,786,1,787
公投第９案,嘉義市,西區,保安里,166,1540,569,164,733,26,759
公投第９案,嘉義市,西區,北新里,167,1056,430,137,567,30,597
公投第９案,嘉義市,西區,新厝里,168,1467,550,188,738,114,852
公投第９案,嘉義市,西區,新厝里,169,1431,509,164,673,71,744
公投第９案,嘉義市,西區,新厝里,170,1234,548,144,692,78,770
公投第９案,嘉義市,西區,保福里,171,1266,505,125,630,13,643
公投第９案,嘉義市,西區,保福里,172,1211,492,140,632,28,660
公投第９案,嘉義市,西區,保福里,173,1121,479,128,607,24,631
公投第９案,嘉義市,西區,竹村里,174,1155,398,115,513,20,533
公投第９案,嘉義市,西區,北湖里,175,1546,583,231,814,87,901
公投第９案,嘉義市,西區,北湖里,176,1322,473,147,620,30,650
公投第９案,嘉義市,西區,下埤里,177,1549,584,196,780,88,868
公投第９案,臺北市,北投區,建民里,1,1313,550,187,737,56,793
公投第９案,臺北市,北投區,建民里,2,1403,626,196,822,46,868
公投第９案,臺北市,北投區,建民里,3,1081,463,150,613,52,665
公投第９案,臺北市,北投區,文林里,4,1209,503,178,681,45,726
公投第９案,臺北市,北投區,文林里,5,1326,522,201,723,50,773
公投第９案,臺北市,北投區,文林里,6,1263,531,183,714,49,763
公投第９案,臺北市,北投區,石牌里,7,1580,673,213,886,66,952
公投第９案,臺北市,北投區,石牌里,8,1577,685,221,906,47,953
公投第９案,臺北市,北投區,石牌里,9,1483,635,188,823,67,890
公投第９案,臺北市,北投區,福興里,10,1461,605,175,780,36,816
公投第９案,臺北市,北投區,福興里,11,1466,586,185,771,63,834
公投第９案,臺北市,北投區,福興里,12,1620,683,204,887,63,950
公投第９案,臺北市,北投區,福興里,13,1543,586,185,771,32,803
公投第９案,臺北市,北投區,榮光里,14,1513,586,192,778,57,835
公投第９案,臺北市,北投區,榮光里,15,1534,641,176,817,54,871
公投第９案,臺北市,北投區,榮光里,16,1650,696,203,899,84,983
公投第９案,臺北市,北投區,榮光里,17,1533,659,207,866,41,907
公投第９案,臺北市,北投區,榮華里,18,1702,681,217,898,46,944
公投第９案,臺北市,北投區,榮華里,19,1721,691,235,926,52,978
公投第９案,臺北市,北投區,榮華里,20,1575,651,253,904,56,960
公投第９案,臺北市,北投區,榮華里,21,1530,620,207,827,68,895
公投第９案,臺北市,北投區,裕民里,22,1728,696,252,948,70,1018
公投第９案,臺北市,北投區,裕民里,23,1702,677,202,879,84,963
公投第９案,臺北市,北投區,裕民里,24,1696,664,228,892,67,959
公投第９案,臺北市,北投區,裕民里,25,1684,579,175,754,41,795
公投第９案,臺北市,北投區,振華里,26,1717,726,232,958,71,1029
公投第９案,臺北市,北投區,振華里,27,1605,661,217,878,45,923
公投第９案,臺北市,北投區,振華里,28,1723,727,210,937,50,987
公投第９案,臺北市,北投區,振華里,29,1597,701,224,925,57,982
公投第９案,臺北市,北投區,永和里,30,1700,702,216,918,52,970
公投第９案,臺北市,北投區,永和里,31,1544,567,197,764,40,804
公投第９案,臺北市,北投區,永和里,32,1635,620,197,817,50,867
公投第９案,臺北市,北投區,永和里,33,1495,743,91,834,29,863
公投第９案,臺北市,北投區,永和里,34,1619,671,237,908,31,939
公投第９案,臺北市,北投區,永欣里,35,1683,646,267,913,46,959
公投第９案,臺北市,北投區,永欣里,36,1662,639,190,829,55,884
公投第９案,臺北市,北投區,永欣里,37,1850,641,229,870,40,910
公投第９案,臺北市,北投區,永欣里,38,1674,622,201,823,25,848
公投第９案,臺北市,北投區,永明里,39,1511,675,179,854,62,916
公投第９案,臺北市,北投區,永明里,40,1393,566,167,733,27,760
公投第９案,臺北市,北投區,永明里,41,1279,583,170,753,56,809
公投第９案,臺北市,北投區,東華里,42,1122,452,143,595,39,634
公投第９案,臺北市,北投區,東華里,43,1238,625,167,792,56,848
公投第９案,臺北市,北投區,東華里,44,1477,612,226,838,70,908
公投第９案,臺北市,北投區,吉利里,45,1495,651,197,848,65,913
公投第９案,臺北市,北投區,吉利里,46,1469,654,211,865,48,913
公投第９案,臺北市,北投區,吉利里,47,1462,637,167,804,55,859
公投第９案,臺北市,北投區,吉利里,48,1431,617,166,783,64,847
公投第９案,臺北市,北投區,吉慶里,49,1486,542,203,745,42,787
公投第９案,臺北市,北投區,吉慶里,50,1449,609,212,821,57,878
公投第９案,臺北市,北投區,吉慶里,51,1456,586,207,793,37,830
公投第９案,臺北市,北投區,尊賢里,52,1311,523,173,696,39,735
公投第９案,臺北市,北投區,尊賢里,53,1356,577,156,733,57,790
公投第９案,臺北市,北投區,尊賢里,54,1338,558,174,732,34,766
公投第９案,臺北市,北投區,立賢里,55,1525,622,194,816,31,847
公投第９案,臺北市,北投區,立賢里,56,1620,636,177,813,54,867
公投第９案,臺北市,北投區,立賢里,57,1499,583,169,752,24,776
公投第９案,臺北市,北投區,立農里,58,1497,681,166,847,34,881
公投第９案,臺北市,北投區,立農里,59,1624,633,203,836,64,900
公投第９案,臺北市,北投區,立農里,60,1536,610,166,776,71,847
公投第９案,臺北市,北投區,立農里,61,1469,633,188,821,79,900
公投第９案,臺北市,北投區,立農里,62,1598,628,197,825,60,885
公投第９案,臺北市,北投區,八仙里,63,1690,687,186,873,39,912
公投第９案,臺北市,北投區,八仙里,64,1599,609,193,802,105,907
公投第９案,臺北市,北投區,八仙里,65,1634,677,188,865,64,929
公投第９案,臺北市,北投區,洲美里,66,1660,617,194,811,59,870
公投第９案,臺北市,北投區,奇岩里,67,1900,717,215,932,63,995
公投第９案,臺北市,北投區,奇岩里,68,1797,731,242,973,52,1025
公投第９案,臺北市,北投區,奇岩里,69,1832,731,246,977,81,1058
公投第９案,臺北市,北投區,奇岩里,70,1784,764,226,990,55,1045
公投第９案,臺北市,北投區,奇岩里,71,1732,735,217,952,52,1004
公投第９案,臺北市,北投區,清江里,72,2035,372,134,506,52,558
公投第９案,臺北市,北投區,清江里,73,1504,578,210,788,72,860
公投第９案,臺北市,北投區,清江里,74,1683,743,197,940,67,1007
公投第９案,臺北市,北投區,清江里,75,1635,617,209,826,77,903
公投第９案,臺北市,北投區,清江里,76,1613,653,177,830,79,909
公投第９案,臺北市,北投區,中央里,77,1483,652,90,742,27,769
公投第９案,臺北市,北投區,中央里,78,1500,589,212,801,45,846
公投第９案,臺北市,北投區,中央里,79,1483,615,181,796,65,861
公投第９案,臺北市,北投區,中央里,80,1544,590,222,812,64,876
公投第９案,臺北市,北投區,中央里,81,1532,542,155,697,69,766
公投第９案,臺北市,北投區,長安里,82,1819,744,209,953,69,1022
公投第９案,臺北市,北投區,長安里,83,1863,615,254,869,83,952
公投第９案,臺北市,北投區,長安里,84,1872,646,214,860,40,900
公投第９案,臺北市,北投區,大同里,85,1627,633,203,836,60,896
公投第９案,臺北市,北投區,大同里,86,1696,652,181,833,44,877
公投第９案,臺北市,北投區,大同里,87,1841,695,250,945,63,1008
公投第９案,臺北市,北投區,溫泉里,88,1324,517,177,694,57,751
公投第９案,臺北市,北投區,溫泉里,89,1504,611,154,765,39,804
公投第９案,臺北市,北投區,溫泉里,90,1511,601,196,797,51,848
公投第９案,臺北市,北投區,溫泉里,91,1615,652,243,895,53,948
公投第９案,臺北市,北投區,林泉里,92,1270,484,155,639,35,674
公投第９案,臺北市,北投區,林泉里,93,1492,527,164,691,33,724
公投第９案,臺北市,北投區,中心里,94,1429,527,191,718,42,760
公投第９案,臺北市,北投區,中心里,95,1567,702,71,773,30,803
公投第９案,臺北市,北投區,中心里,96,1388,563,179,742,39,781
公投第９案,臺北市,北投區,中心里,97,1448,518,184,702,23,725
公投第９案,臺北市,北投區,中庸里,98,1356,513,160,673,57,730
公投第９案,臺北市,北投區,中庸里,99,1308,522,162,684,48,732
公投第９案,臺北市,北投區,中庸里,100,1165,492,152,644,55,699
公投第９案,臺北市,北投區,開明里,101,1429,608,176,784,71,855
公投第９案,臺北市,北投區,開明里,102,1472,602,150,752,37,789
公投第９案,臺北市,北投區,開明里,103,1508,674,206,880,65,945
公投第９案,臺北市,北投區,開明里,104,1480,593,193,786,59,845
公投第９案,臺北市,北投區,中和里,105,1142,416,142,558,45,603
公投第９案,臺北市,北投區,中和里,106,1554,619,161,780,41,821
公投第９案,臺北市,北投區,中和里,107,1669,695,208,903,96,999
公投第９案,臺北市,北投區,智仁里,108,1823,759,198,957,72,1029
公投第９案,臺北市,北投區,智仁里,109,1739,697,194,891,65,956
公投第９案,臺北市,北投區,智仁里,110,1771,681,202,883,68,951
公投第９案,臺北市,北投區,秀山里,111,1468,567,149,716,56,772
公投第９案,臺北市,北投區,秀山里,112,1469,585,180,765,34,799
公投第９案,臺北市,北投區,文化里,113,1094,559,113,672,39,711
公投第９案,臺北市,北投區,文化里,114,1101,535,132,667,40,707
公投第９案,臺北市,北投區,文化里,115,1422,639,162,801,63,864
公投第９案,臺北市,北投區,豐年里,116,1390,581,139,720,56,776
公投第９案,臺北市,北投區,豐年里,117,1307,554,155,709,69,778
公投第９案,臺北市,北投區,豐年里,118,1215,505,188,693,77,770
公投第９案,臺北市,北投區,稻香里,119,1642,640,166,806,44,850
公投第９案,臺北市,北投區,稻香里,120,1623,642,148,790,40,830
公投第９案,臺北市,北投區,稻香里,121,1621,648,184,832,61,893
公投第９案,臺北市,北投區,桃源里,122,1367,548,169,717,18,735
公投第９案,臺北市,北投區,桃源里,123,1309,479,186,665,52,717
公投第９案,臺北市,北投區,桃源里,124,1356,571,163,734,37,771
公投第９案,臺北市,北投區,桃源里,125,1365,531,178,709,41,750
公投第９案,臺北市,北投區,一德里,126,1613,616,200,816,40,856
公投第９案,臺北市,北投區,一德里,127,1590,564,158,722,39,761
公投第９案,臺北市,北投區,一德里,128,1662,676,217,893,72,965
公投第９案,臺北市,北投區,一德里,129,1622,641,232,873,62,935
公投第９案,臺北市,北投區,關渡里,130,1820,686,257,943,39,982
公投第９案,臺北市,北投區,關渡里,131,1615,672,197,869,75,944
公投第９案,臺北市,北投區,關渡里,132,1612,528,159,687,64,751
公投第９案,臺北市,北投區,關渡里,133,1652,629,215,844,73,917
公投第９案,臺北市,北投區,關渡里,134,1666,665,211,876,29,905
公投第９案,臺北市,北投區,關渡里,135,1641,631,202,833,52,885
公投第９案,臺北市,北投區,泉源里,136,528,198,82,280,38,318
公投第９案,臺北市,北投區,泉源里,137,1642,516,192,708,74,782
公投第９案,臺北市,北投區,湖山里,138,829,337,99,436,33,469
公投第９案,臺北市,北投區,湖山里,139,690,277,69,346,36,382
公投第９案,臺北市,北投區,大屯里,140,1067,418,109,527,57,584
公投第９案,臺北市,北投區,湖田里,141,892,336,106,442,65,507
公投第９案,臺北市,士林區,仁勇里,142,1695,638,224,862,77,939
公投第９案,臺北市,士林區,仁勇里,143,1720,676,244,920,91,1011
公投第９案,臺北市,士林區,義信里,144,1288,507,154,661,76,737
公投第９案,臺北市,士林區,義信里,145,1546,618,185,803,55,858
公投第９案,臺北市,士林區,福林里,146,652,305,80,385,26,411
公投第９案,臺北市,士林區,福林里,147,870,331,113,444,41,485
公投第９案,臺北市,士林區,福林里,148,1137,471,181,652,55,707
公投第９案,臺北市,士林區,福德里,149,1050,439,171,610,53,663
公投第９案,臺北市,士林區,福德里,150,1031,439,147,586,56,642
公投第９案,臺北市,士林區,福德里,151,1075,449,155,604,33,637
公投第９案,臺北市,士林區,福德里,152,2175,338,128,466,53,519
公投第９案,臺北市,士林區,福志里,153,1775,672,204,876,58,934
公投第９案,臺北市,士林區,福志里,154,1669,724,193,917,59,976
公投第９案,臺北市,士林區,福志里,155,1665,661,291,952,60,1012
公投第９案,臺北市,士林區,福志里,156,1648,701,248,949,75,1024
公投第９案,臺北市,士林區,舊佳里,157,1246,520,165,685,28,713
公投第９案,臺北市,士林區,舊佳里,158,1419,539,210,749,71,820
公投第９案,臺北市,士林區,舊佳里,159,1327,491,209,700,78,778
公投第９案,臺北市,士林區,舊佳里,160,1573,653,259,912,29,941
公投第９案,臺北市,士林區,福佳里,161,1470,616,181,797,75,872
公投第９案,臺北市,士林區,福佳里,162,1775,698,242,940,34,974
公投第９案,臺北市,士林區,福佳里,163,1692,730,174,904,62,966
公投第９案,臺北市,士林區,福佳里,164,1842,764,250,1014,56,1070
公投第９案,臺北市,士林區,後港里,165,1166,507,163,670,47,717
公投第９案,臺北市,士林區,後港里,166,1687,623,192,815,0,815
公投第９案,臺北市,士林區,後港里,167,1624,625,223,848,75,923
公投第９案,臺北市,士林區,後港里,168,1477,620,223,843,83,926
公投第９案,臺北市,士林區,後港里,169,1250,537,175,712,48,760
公投第９案,臺北市,士林區,福中里,170,1434,576,190,766,89,855
公投第９案,臺北市,士林區,福中里,171,1452,578,223,801,65,866
公投第９案,臺北市,士林區,福中里,172,1533,659,235,894,65,959
公投第９案,臺北市,士林區,福中里,173,1515,660,197,857,67,924
公投第９案,臺北市,士林區,前港里,174,1203,497,176,673,55,728
公投第９案,臺北市,士林區,前港里,175,1487,642,203,845,82,927
公投第９案,臺北市,士林區,前港里,176,1252,512,161,673,39,712
公投第９案,臺北市,士林區,百齡里,177,1536,598,208,806,54,860
公投第９案,臺北市,士林區,百齡里,178,1556,643,231,874,73,947
公投第９案,臺北市,士林區,百齡里,179,1511,627,195,822,58,880
公投第９案,臺北市,士林區,百齡里,180,1572,247,251,498,61,559
公投第９案,臺北市,士林區,承德里,181,1668,674,194,868,78,946
公投第９案,臺北市,士林區,承德里,182,1685,636,213,849,107,956
公投第９案,臺北市,士林區,承德里,183,1568,641,207,848,57,905
公投第９案,臺北市,士林區,福華里,184,1327,516,163,679,51,730
公投第９案,臺北市,士林區,福華里,185,1338,482,189,671,75,746
公投第９案,臺北市,士林區,福華里,186,1515,548,183,731,70,801
公投第９案,臺北市,士林區,福華里,187,1452,613,192,805,64,869
公投第９案,臺北市,士林區,明勝里,188,1448,613,161,774,58,832
公投第９案,臺北市,士林區,明勝里,189,1521,627,211,838,52,890
公投第９案,臺北市,士林區,明勝里,190,1461,566,211,777,41,818
公投第９案,臺北市,士林區,福順里,191,1541,532,216,748,82,830
公投第９案,臺北市,士林區,福順里,192,1611,527,163,690,55,745
公投第９案,臺北市,士林區,福順里,193,1595,630,205,835,69,904
公投第９案,臺北市,士林區,富光里,194,1685,629,198,827,38,865
公投第９案,臺北市,士林區,富光里,195,1816,679,220,899,78,977
公投第９案,臺北市,士林區,富光里,196,1687,623,236,859,98,957
公投第９案,臺北市,士林區,葫蘆里,197,1646,626,217,843,83,926
公投第９案,臺北市,士林區,葫蘆里,198,1643,627,202,829,56,885
公投第９案,臺北市,士林區,葫蘆里,199,1687,721,200,921,54,975
公投第９案,臺北市,士林區,葫蘆里,200,1655,699,207,906,68,974
公投第９案,臺北市,士林區,葫東里,201,1779,664,246,910,32,942
公投第９案,臺北市,士林區,葫東里,202,1855,737,273,1010,65,1075
公投第９案,臺北市,士林區,社子里,203,1350,555,168,723,58,781
公投第９案,臺北市,士林區,社子里,204,1455,572,145,717,28,745
公投第９案,臺北市,士林區,社子里,205,1497,452,211,663,60,723
公投第９案,臺北市,士林區,社子里,206,1398,452,162,614,55,669
公投第９案,臺北市,士林區,社新里,207,1747,699,252,951,75,1026
公投第９案,臺北市,士林區,社新里,208,1465,573,171,744,83,827
公投第９案,臺北市,士林區,社新里,209,1530,585,312,897,68,965
公投第９案,臺北市,士林區,社新里,210,1855,642,237,879,83,962
公投第９案,臺北市,士林區,社新里,211,1444,549,196,745,76,821
公投第９案,臺北市,士林區,社園里,212,1563,574,185,759,72,831
公投第９案,臺北市,士林區,社園里,213,1482,520,202,722,80,802
公投第９案,臺北市,士林區,社園里,214,1552,561,212,773,92,865
公投第９案,臺北市,士林區,社園里,215,1790,730,197,927,82,1009
公投第９案,臺北市,士林區,永倫里,216,1628,597,174,771,79,850
公投第９案,臺北市,士林區,永倫里,217,1337,483,196,679,68,747
公投第９案,臺北市,士林區,永倫里,218,1750,601,297,898,90,988
公投第９案,臺北市,士林區,永倫里,219,1668,578,215,793,102,895
公投第９案,臺北市,士林區,福安里,220,1403,432,163,595,73,668
公投第９案,臺北市,士林區,福安里,221,1468,455,192,647,58,705
公投第９案,臺北市,士林區,福安里,222,1471,488,177,665,36,701
公投第９案,臺北市,士林區,富洲里,223,1666,605,177,782,88,870
公投第９案,臺北市,士林區,富洲里,224,1587,570,196,766,57,823
公投第９案,臺北市,士林區,富洲里,225,1987,693,197,890,80,970
公投第９案,臺北市,士林區,岩山里,226,1271,448,152,600,29,629
公投第９案,臺北市,士林區,岩山里,227,1728,720,239,959,75,1034
公投第９案,臺北市,士林區,名山里,228,1630,696,220,916,62,978
公投第９案,臺北市,士林區,名山里,229,1619,679,243,922,49,971
公投第９案,臺北市,士林區,名山里,230,1425,623,161,784,54,838
公投第９案,臺北市,士林區,名山里,231,1623,709,208,917,62,979
公投第９案,臺北市,士林區,聖山里,232,1564,641,221,862,52,914
公投第９案,臺北市,士林區,聖山里,233,1376,573,265,838,56,894
公投第９案,臺北市,士林區,聖山里,234,1517,737,165,902,38,940
公投第９案,臺北市,士林區,芝山里,235,1729,635,250,885,45,930
公投第９案,臺北市,士林區,芝山里,236,1511,673,209,882,44,926
公投第９案,臺北市,士林區,芝山里,237,1811,778,245,1023,53,1076
公投第９案,臺北市,士林區,芝山里,238,1533,637,207,844,47,891
公投第９案,臺北市,士林區,東山里,239,1657,786,233,1019,53,1072
公投第９案,臺北市,士林區,東山里,240,1499,647,160,807,34,841
公投第９案,臺北市,士林區,東山里,241,1402,588,159,747,61,808
公投第９案,臺北市,士林區,德行里,242,1273,540,224,764,66,830
公投第９案,臺北市,士林區,德行里,243,1273,539,174,713,47,760
公投第９案,臺北市,士林區,德行里,244,1316,550,189,739,47,786
公投第９案,臺北市,士林區,德華里,245,1659,659,236,895,64,959
公投第９案,臺北市,士林區,德華里,246,1749,720,191,911,41,952
公投第９案,臺北市,士林區,德華里,247,1552,630,202,832,50,882
公投第９案,臺北市,士林區,忠誠里,248,1529,700,152,852,52,904
公投第９案,臺北市,士林區,忠誠里,249,1644,695,174,869,45,914
公投第９案,臺北市,士林區,忠誠里,250,1779,725,224,949,58,1007
公投第９案,臺北市,士林區,蘭雅里,251,1597,635,212,847,53,900
公投第９案,臺北市,士林區,蘭雅里,252,1454,594,198,792,59,851
公投第９案,臺北市,士林區,蘭雅里,253,1582,669,251,920,46,966
公投第９案,臺北市,士林區,蘭雅里,254,1518,672,190,862,47,909
公投第９案,臺北市,士林區,蘭雅里,255,1501,564,196,760,23,783
公投第９案,臺北市,士林區,蘭興里,256,1420,585,219,804,50,854
公投第９案,臺北市,士林區,蘭興里,257,1494,602,213,815,57,872
公投第９案,臺北市,士林區,蘭興里,258,1568,658,237,895,56,951
公投第９案,臺北市,士林區,蘭興里,259,1208,519,198,717,47,764
公投第９案,臺北市,士林區,三玉里,260,1826,733,223,956,67,1023
公投第９案,臺北市,士林區,三玉里,261,1647,660,214,874,61,935
公投第９案,臺北市,士林區,三玉里,262,1654,660,210,870,67,937
公投第９案,臺北市,士林區,天福里,263,1550,659,217,876,48,924
公投第９案,臺北市,士林區,天福里,264,1298,577,187,764,53,817
公投第９案,臺北市,士林區,天福里,265,1297,552,190,742,68,810
公投第９案,臺北市,士林區,天福里,266,1352,547,172,719,49,768
公投第９案,臺北市,士林區,天祿里,267,1522,594,205,799,51,850
公投第９案,臺北市,士林區,天祿里,268,1602,604,233,837,82,919
公投第９案,臺北市,士林區,天祿里,269,1441,547,226,773,62,835
公投第９案,臺北市,士林區,天壽里,270,1325,502,176,678,26,704
公投第９案,臺北市,士林區,天壽里,271,1567,646,208,854,45,899
公投第９案,臺北市,士林區,天壽里,272,1518,594,226,820,25,845
公投第９案,臺北市,士林區,天和里,273,1549,675,223,898,46,944
公投第９案,臺北市,士林區,天和里,274,1652,674,218,892,34,926
公投第９案,臺北市,士林區,天和里,275,1766,718,259,977,67,1044
公投第９案,臺北市,士林區,天和里,276,1638,654,207,861,25,886
公投第９案,臺北市,士林區,天山里,277,1491,662,187,849,47,896
公投第９案,臺北市,士林區,天山里,278,1521,654,197,851,27,878
公投第９案,臺北市,士林區,天山里,279,1351,586,178,764,62,826
公投第９案,臺北市,士林區,天山里,280,1742,632,242,874,33,907
公投第９案,臺北市,士林區,天玉里,281,1585,644,219,863,50,913
公投第９案,臺北市,士林區,天玉里,282,1521,668,182,850,45,895
公投第９案,臺北市,士林區,天玉里,283,1543,614,218,832,38,870
公投第９案,臺北市,士林區,天玉里,284,1404,606,177,783,45,828
公投第９案,臺北市,士林區,天玉里,285,1541,648,199,847,44,891
公投第９案,臺北市,士林區,天母里,286,1584,637,179,816,60,876
公投第９案,臺北市,士林區,天母里,287,1519,636,210,846,62,908
公投第９案,臺北市,士林區,天母里,288,1482,573,166,739,27,766
公投第９案,臺北市,士林區,天母里,289,1243,496,162,658,52,710
公投第９案,臺北市,士林區,永福里,290,1156,434,175,609,51,660
公投第９案,臺北市,士林區,公館里,291,1262,417,185,602,80,682
公投第９案,臺北市,士林區,新安里,292,889,349,138,487,46,533
公投第９案,臺北市,士林區,新安里,293,858,317,163,480,51,531
公投第９案,臺北市,士林區,陽明里,294,945,324,154,478,53,531
公投第９案,臺北市,士林區,陽明里,295,960,374,122,496,46,542
公投第９案,臺北市,士林區,陽明里,296,876,355,89,444,51,495
公投第９案,臺北市,士林區,菁山里,297,556,228,92,320,43,363
公投第９案,臺北市,士林區,菁山里,298,919,385,122,507,66,573
公投第９案,臺北市,士林區,平等里,299,1360,565,227,792,108,900
公投第９案,臺北市,士林區,溪山里,300,1355,558,185,743,83,826
公投第９案,臺北市,士林區,翠山里,301,1252,543,137,680,42,722
公投第９案,臺北市,士林區,翠山里,302,1182,557,133,690,49,739
公投第９案,臺北市,士林區,臨溪里,303,1431,524,149,673,17,690
公投第９案,臺北市,士林區,臨溪里,304,1240,479,152,631,43,674
公投第９案,臺北市,內湖區,西湖里,305,1661,646,170,816,24,840
公投第９案,臺北市,內湖區,西湖里,306,1602,614,213,827,63,890
公投第９案,臺北市,內湖區,西湖里,307,1655,715,206,921,97,1018
公投第９案,臺北市,內湖區,西湖里,308,1582,681,229,910,46,956
公投第９案,臺北市,內湖區,西康里,309,1688,686,128,814,36,850
公投第９案,臺北市,內湖區,西康里,310,1737,730,202,932,43,975
公投第９案,臺北市,內湖區,西康里,311,1809,769,213,982,72,1054
公投第９案,臺北市,內湖區,西康里,312,1376,580,153,733,52,785
公投第９案,臺北市,內湖區,西康里,313,1747,754,207,961,91,1052
公投第９案,臺北市,內湖區,西安里,314,1389,634,164,798,34,832
公投第９案,臺北市,內湖區,西安里,315,1454,683,183,866,41,907
公投第９案,臺北市,內湖區,西安里,316,1468,665,216,881,48,929
公投第９案,臺北市,內湖區,西安里,317,1603,762,203,965,40,1005
公投第９案,臺北市,內湖區,港墘里,318,1795,731,215,946,44,990
公投第９案,臺北市,內湖區,港墘里,319,1737,779,252,1031,55,1086
公投第９案,臺北市,內湖區,港墘里,320,1744,755,220,975,74,1049
公投第９案,臺北市,內湖區,港都里,321,1661,719,192,911,63,974
公投第９案,臺北市,內湖區,港都里,322,1577,654,213,867,39,906
公投第９案,臺北市,內湖區,港都里,323,1494,697,185,882,26,908
公投第９案,臺北市,內湖區,港富里,324,1626,705,186,891,61,952
公投第９案,臺北市,內湖區,港富里,325,1641,714,191,905,71,976
公投第９案,臺北市,內湖區,港富里,326,1554,658,202,860,44,904
公投第９案,臺北市,內湖區,港富里,327,1728,661,339,1000,46,1046
公投第９案,臺北市,內湖區,港富里,328,1736,714,213,927,60,987
公投第９案,臺北市,內湖區,港華里,329,1461,715,182,897,41,938
公投第９案,臺北市,內湖區,港華里,330,1509,665,169,834,39,873
公投第９案,臺北市,內湖區,港華里,331,1358,550,185,735,27,762
公投第９案,臺北市,內湖區,港華里,332,1761,731,217,948,46,994
公投第９案,臺北市,內湖區,港華里,333,1651,720,190,910,30,940
公投第９案,臺北市,內湖區,內湖里,334,1809,793,227,1020,62,1082
公投第９案,臺北市,內湖區,內湖里,335,1773,788,197,985,41,1026
公投第９案,臺北市,內湖區,內湖里,336,1890,813,196,1009,33,1042
公投第９案,臺北市,內湖區,湖濱里,337,1760,823,249,1072,61,1133
公投第９案,臺北市,內湖區,湖濱里,338,1645,732,202,934,41,975
公投第９案,臺北市,內湖區,湖濱里,339,1324,626,161,787,20,807
公投第９案,臺北市,內湖區,湖濱里,340,1072,508,127,635,28,663
公投第９案,臺北市,內湖區,湖濱里,341,1509,659,174,833,32,865
公投第９案,臺北市,內湖區,紫星里,342,1715,676,263,939,56,995
公投第９案,臺北市,內湖區,紫星里,343,1774,786,204,990,45,1035
公投第９案,臺北市,內湖區,紫星里,344,1796,840,247,1087,50,1137
公投第９案,臺北市,內湖區,紫星里,345,1784,720,240,960,36,996
公投第９案,臺北市,內湖區,大湖里,346,1417,611,205,816,60,876
公投第９案,臺北市,內湖區,大湖里,347,1699,693,238,931,42,973
公投第９案,臺北市,內湖區,大湖里,348,1719,803,231,1034,45,1079
公投第９案,臺北市,內湖區,金龍里,349,1715,743,212,955,23,978
公投第９案,臺北市,內湖區,金龍里,350,1634,630,173,803,31,834
公投第９案,臺北市,內湖區,金龍里,351,1435,569,176,745,71,816
公投第９案,臺北市,內湖區,金瑞里,352,1440,622,149,771,30,801
公投第９案,臺北市,內湖區,金瑞里,353,1446,683,172,855,32,887
公投第９案,臺北市,內湖區,金瑞里,354,1657,673,173,846,56,902
公投第９案,臺北市,內湖區,金瑞里,355,1261,545,155,700,75,775
公投第９案,臺北市,內湖區,碧山里,356,456,138,66,204,32,236
公投第９案,臺北市,內湖區,碧山里,357,1433,700,206,906,38,944
公投第９案,臺北市,內湖區,碧山里,358,1485,616,220,836,37,873
公投第９案,臺北市,內湖區,碧山里,359,1590,672,198,870,36,906
公投第９案,臺北市,內湖區,碧山里,360,1219,572,161,733,52,785
公投第９案,臺北市,內湖區,紫雲里,361,1732,729,217,946,58,1004
公投第９案,臺北市,內湖區,紫雲里,362,1727,767,156,923,30,953
公投第９案,臺北市,內湖區,紫雲里,363,1637,700,213,913,50,963
公投第９案,臺北市,內湖區,清白里,364,1453,625,161,786,44,830
公投第９案,臺北市,內湖區,清白里,365,1617,696,170,866,35,901
公投第９案,臺北市,內湖區,清白里,366,1604,722,154,876,25,901
公投第９案,臺北市,內湖區,清白里,367,1406,661,194,855,34,889
公投第９案,臺北市,內湖區,清白里,368,1353,589,175,764,43,807
公投第９案,臺北市,內湖區,葫洲里,369,1724,787,196,983,50,1033
公投第９案,臺北市,內湖區,葫洲里,370,1378,616,180,796,33,829
公投第９案,臺北市,內湖區,葫洲里,371,1403,668,152,820,30,850
公投第９案,臺北市,內湖區,葫洲里,372,1547,635,186,821,38,859
公投第９案,臺北市,內湖區,紫陽里,373,1718,755,231,986,50,1036
公投第９案,臺北市,內湖區,紫陽里,374,1813,754,238,992,44,1036
公投第９案,臺北市,內湖區,紫陽里,375,1791,811,232,1043,65,1108
公投第９案,臺北市,內湖區,紫陽里,376,1855,848,215,1063,48,1111
公投第９案,臺北市,內湖區,瑞陽里,377,1731,776,180,956,34,990
公投第９案,臺北市,內湖區,瑞陽里,378,1593,753,210,963,58,1021
公投第９案,臺北市,內湖區,瑞陽里,379,1869,764,191,955,48,1003
公投第９案,臺北市,內湖區,瑞陽里,380,1687,783,179,962,53,1015
公投第９案,臺北市,內湖區,瑞光里,381,1530,661,207,868,25,893
公投第９案,臺北市,內湖區,瑞光里,382,1300,622,131,753,47,800
公投第９案,臺北市,內湖區,瑞光里,383,1314,650,153,803,40,843
公投第９案,臺北市,內湖區,五分里,384,1433,542,152,694,33,727
公投第９案,臺北市,內湖區,五分里,385,1450,606,152,758,34,792
公投第９案,臺北市,內湖區,五分里,386,1608,679,179,858,59,917
公投第９案,臺北市,內湖區,五分里,387,1414,635,159,794,43,837
公投第９案,臺北市,內湖區,五分里,388,1492,531,184,715,47,762
公投第９案,臺北市,內湖區,五分里,389,1528,604,171,775,28,803
公投第９案,臺北市,內湖區,東湖里,390,1692,721,213,934,45,979
公投第９案,臺北市,內湖區,東湖里,391,1556,665,202,867,53,920
公投第９案,臺北市,內湖區,東湖里,392,1637,668,202,870,25,895
公投第９案,臺北市,內湖區,東湖里,393,1749,687,216,903,43,946
公投第９案,臺北市,內湖區,樂康里,394,1220,495,141,636,39,675
公投第９案,臺北市,內湖區,樂康里,395,1600,660,206,866,56,922
公投第９案,臺北市,內湖區,樂康里,396,1473,625,181,806,44,850
公投第９案,臺北市,內湖區,樂康里,397,1498,615,190,805,56,861
公投第９案,臺北市,內湖區,樂康里,398,1557,646,198,844,47,891
公投第９案,臺北市,內湖區,內溝里,399,1674,662,201,863,37,900
公投第９案,臺北市,內湖區,內溝里,400,1728,750,237,987,46,1033
公投第９案,臺北市,內湖區,內溝里,401,788,264,88,352,47,399
公投第９案,臺北市,內湖區,週美里,402,1542,572,231,803,70,873
公投第９案,臺北市,內湖區,週美里,403,1676,613,175,788,50,838
公投第９案,臺北市,內湖區,週美里,404,1360,481,183,664,28,692
公投第９案,臺北市,內湖區,週美里,405,1259,611,151,762,29,791
公投第９案,臺北市,內湖區,週美里,406,1301,562,129,691,20,711
公投第９案,臺北市,內湖區,行善里,407,1251,446,159,605,41,646
公投第９案,臺北市,內湖區,行善里,408,1502,616,170,786,64,850
公投第９案,臺北市,內湖區,行善里,409,1596,691,164,855,36,891
公投第９案,臺北市,內湖區,行善里,410,1649,711,195,906,26,932
公投第９案,臺北市,內湖區,石潭里,411,1774,747,174,921,60,981
公投第９案,臺北市,內湖區,石潭里,412,1746,681,196,877,40,917
公投第９案,臺北市,內湖區,湖興里,413,1473,584,190,774,23,797
公投第９案,臺北市,內湖區,湖興里,414,2824,686,217,903,67,970
公投第９案,臺北市,內湖區,湖興里,415,1849,705,216,921,34,955
公投第９案,臺北市,內湖區,湖興里,416,1530,611,192,803,52,855
公投第９案,臺北市,內湖區,湖元里,417,1656,671,223,894,50,944
公投第９案,臺北市,內湖區,湖元里,418,1457,606,194,800,45,845
公投第９案,臺北市,內湖區,湖元里,419,1695,755,207,962,54,1016
公投第９案,臺北市,內湖區,安湖里,420,1663,751,193,944,41,985
公投第９案,臺北市,內湖區,安湖里,421,1654,700,194,894,50,944
公投第９案,臺北市,內湖區,安湖里,422,1642,718,221,939,47,986
公投第９案,臺北市,內湖區,安湖里,423,1685,696,220,916,41,957
公投第９案,臺北市,內湖區,秀湖里,424,1862,753,240,993,54,1047
公投第９案,臺北市,內湖區,秀湖里,425,1900,842,238,1080,50,1130
公投第９案,臺北市,內湖區,秀湖里,426,1790,888,186,1074,55,1129
公投第９案,臺北市,內湖區,安泰里,427,1417,594,167,761,52,813
公投第９案,臺北市,內湖區,安泰里,428,1694,709,196,905,61,966
公投第９案,臺北市,內湖區,安泰里,429,1676,672,172,844,68,912
公投第９案,臺北市,內湖區,金湖里,430,1643,669,223,892,23,915
公投第９案,臺北市,內湖區,金湖里,431,1588,711,178,889,44,933
公投第９案,臺北市,內湖區,金湖里,432,1603,705,206,911,48,959
公投第９案,臺北市,內湖區,金湖里,433,1629,730,182,912,42,954
公投第９案,臺北市,內湖區,金湖里,434,1646,769,196,965,49,1014
公投第９案,臺北市,內湖區,康寧里,435,1883,813,188,1001,42,1043
公投第９案,臺北市,內湖區,康寧里,436,1434,602,163,765,48,813
公投第９案,臺北市,內湖區,康寧里,437,1418,608,154,762,39,801
公投第９案,臺北市,內湖區,康寧里,438,1373,603,162,765,56,821
公投第９案,臺北市,內湖區,康寧里,439,1349,592,169,761,56,817
公投第９案,臺北市,內湖區,明湖里,440,1511,677,201,878,54,932
公投第９案,臺北市,內湖區,明湖里,441,1563,706,187,893,67,960
公投第９案,臺北市,內湖區,明湖里,442,1550,662,191,853,51,904
公投第９案,臺北市,內湖區,蘆洲里,443,1157,466,149,615,39,654
公投第９案,臺北市,內湖區,麗山里,444,1768,724,255,979,41,1020
公投第９案,臺北市,內湖區,麗山里,445,1664,715,198,913,58,971
公投第９案,臺北市,內湖區,麗山里,446,1743,735,227,962,64,1026
公投第９案,臺北市,內湖區,寶湖里,447,1480,660,170,830,31,861
公投第９案,臺北市,內湖區,寶湖里,448,1589,709,224,933,49,982
公投第９案,臺北市,內湖區,寶湖里,449,1371,605,155,760,33,793
公投第９案,臺北市,內湖區,寶湖里,450,1575,721,210,931,39,970
公投第９案,臺北市,內湖區,寶湖里,451,1377,633,147,780,16,796
公投第９案,臺北市,內湖區,南湖里,452,1469,702,212,914,55,969
公投第９案,臺北市,內湖區,南湖里,453,1529,717,205,922,18,940
公投第９案,臺北市,內湖區,南湖里,454,1649,756,197,953,46,999
公投第９案,臺北市,南港區,南港里,455,1280,478,147,625,30,655
公投第９案,臺北市,南港區,南港里,456,1351,579,142,721,26,747
公投第９案,臺北市,南港區,南港里,457,1345,589,146,735,36,771
公投第９案,臺北市,南港區,南港里,458,1679,545,161,706,40,746
公投第９案,臺北市,南港區,中南里,459,1680,602,214,816,61,877
公投第９案,臺北市,南港區,中南里,460,1635,595,185,780,57,837
公投第９案,臺北市,南港區,三重里,461,1459,582,173,755,46,801
公投第９案,臺北市,南港區,三重里,462,1706,738,192,930,29,959
公投第９案,臺北市,南港區,三重里,463,1674,649,200,849,52,901
公投第９案,臺北市,南港區,三重里,464,1491,653,145,798,27,825
公投第９案,臺北市,南港區,新富里,465,1086,515,147,662,36,698
公投第９案,臺北市,南港區,新富里,466,1202,549,174,723,57,780
公投第９案,臺北市,南港區,新富里,467,1198,494,175,669,56,725
公投第９案,臺北市,南港區,中研里,468,1430,517,179,696,35,731
公投第９案,臺北市,南港區,中研里,469,1275,518,209,727,60,787
公投第９案,臺北市,南港區,中研里,470,1344,604,208,812,51,863
公投第９案,臺北市,南港區,中研里,471,1391,587,203,790,39,829
公投第９案,臺北市,南港區,中研里,472,1342,623,170,793,28,821
公投第９案,臺北市,南港區,中研里,473,1389,584,136,720,37,757
公投第９案,臺北市,南港區,九如里,474,1426,626,181,807,46,853
公投第９案,臺北市,南港區,九如里,475,1359,659,120,779,31,810
公投第９案,臺北市,南港區,九如里,476,1366,568,167,735,55,790
公投第９案,臺北市,南港區,九如里,477,1441,641,173,814,25,839
公投第９案,臺北市,南港區,舊莊里,478,1529,600,164,764,65,829
公投第９案,臺北市,南港區,舊莊里,479,1618,590,208,798,56,854
公投第９案,臺北市,南港區,舊莊里,480,1545,526,163,689,64,753
公投第９案,臺北市,南港區,舊莊里,481,1569,666,174,840,51,891
公投第９案,臺北市,南港區,舊莊里,482,1661,619,171,790,35,825
公投第９案,臺北市,南港區,東新里,483,1518,568,166,734,56,790
公投第９案,臺北市,南港區,東新里,484,1552,676,209,885,61,946
公投第９案,臺北市,南港區,東新里,485,1658,634,193,827,24,851
公投第９案,臺北市,南港區,東新里,486,1608,678,191,869,57,926
公投第９案,臺北市,南港區,重陽里,487,1475,571,184,755,38,793
公投第９案,臺北市,南港區,重陽里,488,1722,812,213,1025,43,1068
公投第９案,臺北市,南港區,重陽里,489,1383,679,173,852,37,889
公投第９案,臺北市,南港區,東明里,490,1397,608,165,773,47,820
公投第９案,臺北市,南港區,東明里,491,1352,592,165,757,46,803
公投第９案,臺北市,南港區,東明里,492,1344,610,165,775,38,813
公投第９案,臺北市,南港區,西新里,493,1385,509,178,687,31,718
公投第９案,臺北市,南港區,西新里,494,1399,545,193,738,49,787
公投第９案,臺北市,南港區,西新里,495,1381,555,171,726,42,768
公投第９案,臺北市,南港區,玉成里,496,1548,607,193,800,58,858
公投第９案,臺北市,南港區,玉成里,497,1190,486,130,616,36,652
公投第９案,臺北市,南港區,玉成里,498,1490,637,199,836,32,868
公投第９案,臺北市,南港區,合成里,499,1096,496,147,643,23,666
公投第９案,臺北市,南港區,合成里,500,1238,572,165,737,23,760
公投第９案,臺北市,南港區,合成里,501,1271,568,161,729,36,765
公投第９案,臺北市,南港區,合成里,502,1146,496,128,624,49,673
公投第９案,臺北市,南港區,合成里,503,1232,492,156,648,48,696
公投第９案,臺北市,南港區,新光里,504,1649,630,156,786,37,823
公投第９案,臺北市,南港區,新光里,505,1688,749,177,926,52,978
公投第９案,臺北市,南港區,聯成里,506,1503,666,192,858,34,892
公投第９案,臺北市,南港區,聯成里,507,1542,617,202,819,32,851
公投第９案,臺北市,南港區,聯成里,508,1463,613,204,817,51,868
公投第９案,臺北市,南港區,萬福里,509,1195,526,154,680,80,760
公投第９案,臺北市,南港區,萬福里,510,1254,531,186,717,20,737
公投第９案,臺北市,南港區,萬福里,511,1356,584,156,740,47,787
公投第９案,臺北市,南港區,鴻福里,512,1363,581,193,774,61,835
公投第９案,臺北市,南港區,鴻福里,513,1317,610,177,787,42,829
公投第９案,臺北市,南港區,鴻福里,514,1331,569,170,739,37,776
公投第９案,臺北市,南港區,百福里,515,1610,656,221,877,69,946
公投第９案,臺北市,南港區,百福里,516,1542,623,172,795,40,835
公投第９案,臺北市,南港區,百福里,517,1581,672,199,871,62,933
公投第９案,臺北市,南港區,成福里,518,1225,587,144,731,31,762
公投第９案,臺北市,南港區,成福里,519,1264,579,179,758,52,810
公投第９案,臺北市,南港區,成福里,520,1649,701,219,920,81,1001
公投第９案,臺北市,南港區,成福里,521,1267,488,235,723,20,743
公投第９案,臺北市,南港區,成福里,522,1336,580,143,723,36,759
公投第９案,臺北市,南港區,仁福里,523,1162,551,137,688,28,716
公投第９案,臺北市,南港區,仁福里,524,1045,461,125,586,24,610
公投第９案,臺北市,南港區,仁福里,525,1351,667,171,838,51,889
公投第９案,臺北市,南港區,仁福里,526,1358,593,139,732,31,763
公投第９案,臺北市,松山區,莊敬里,527,1583,686,180,866,46,912
公投第９案,臺北市,松山區,莊敬里,528,1691,692,213,905,75,980
公投第９案,臺北市,松山區,莊敬里,529,1386,579,171,750,43,793
公投第９案,臺北市,松山區,東榮里,530,1362,575,197,772,52,824
公投第９案,臺北市,松山區,東榮里,531,1399,595,196,791,50,841
公投第９案,臺北市,松山區,東榮里,532,1324,537,219,756,47,803
公投第９案,臺北市,松山區,東榮里,533,1296,580,195,775,54,829
公投第９案,臺北市,松山區,東榮里,534,1386,582,217,799,53,852
公投第９案,臺北市,松山區,三民里,535,1529,657,231,888,72,960
公投第９案,臺北市,松山區,三民里,536,1416,613,166,779,40,819
公投第９案,臺北市,松山區,三民里,537,1619,659,182,841,55,896
公投第９案,臺北市,松山區,三民里,538,1386,566,218,784,52,836
公投第９案,臺北市,松山區,新益里,539,1380,642,214,856,33,889
公投第９案,臺北市,松山區,新益里,540,1357,586,194,780,46,826
公投第９案,臺北市,松山區,新益里,541,1296,603,167,770,44,814
公投第９案,臺北市,松山區,富錦里,542,1632,750,181,931,57,988
公投第９案,臺北市,松山區,富錦里,543,1414,592,186,778,46,824
公投第９案,臺北市,松山區,富錦里,544,1404,604,199,803,39,842
公投第９案,臺北市,松山區,新東里,545,1365,629,154,783,68,851
公投第９案,臺北市,松山區,新東里,546,1431,625,172,797,60,857
公投第９案,臺北市,松山區,新東里,547,1483,622,215,837,61,898
公投第９案,臺北市,松山區,富泰里,548,1293,582,172,754,58,812
公投第９案,臺北市,松山區,富泰里,549,1410,621,141,762,43,805
公投第９案,臺北市,松山區,富泰里,550,1307,597,155,752,42,794
公投第９案,臺北市,松山區,介壽里,551,1242,563,173,736,52,788
公投第９案,臺北市,松山區,介壽里,552,1192,545,152,697,30,727
公投第９案,臺北市,松山區,介壽里,553,1276,570,179,749,50,799
公投第９案,臺北市,松山區,精忠里,554,1201,512,163,675,28,703
公投第９案,臺北市,松山區,精忠里,555,1318,592,157,749,43,792
公投第９案,臺北市,松山區,精忠里,556,1157,509,161,670,40,710
公投第９案,臺北市,松山區,東光里,557,1157,497,148,645,18,663
公投第９案,臺北市,松山區,東光里,558,1357,615,166,781,53,834
公投第９案,臺北市,松山區,東光里,559,1215,444,152,596,31,627
公投第９案,臺北市,松山區,東光里,560,1345,569,168,737,41,778
公投第９案,臺北市,松山區,東光里,561,1237,532,169,701,44,745
公投第９案,臺北市,松山區,龍田里,562,1393,747,118,865,43,908
公投第９案,臺北市,松山區,龍田里,563,1331,612,200,812,45,857
公投第９案,臺北市,松山區,龍田里,564,1550,669,232,901,57,958
公投第９案,臺北市,松山區,龍田里,565,1308,621,99,720,21,741
公投第９案,臺北市,松山區,龍田里,566,1490,692,113,805,46,851
公投第９案,臺北市,松山區,龍田里,567,1406,693,165,858,38,896
公投第９案,臺北市,松山區,東昌里,568,1191,542,187,729,38,767
公投第９案,臺北市,松山區,東昌里,569,1095,457,168,625,37,662
公投第９案,臺北市,松山區,東勢里,570,1198,496,166,662,42,704
公投第９案,臺北市,松山區,東勢里,571,1265,553,152,705,45,750
公投第９案,臺北市,松山區,東勢里,572,1225,505,166,671,52,723
公投第９案,臺北市,松山區,中華里,573,1698,758,240,998,50,1048
公投第９案,臺北市,松山區,中華里,574,1819,787,203,990,49,1039
公投第９案,臺北市,松山區,中華里,575,1754,764,224,988,70,1058
公投第９案,臺北市,松山區,民有里,576,1361,567,235,802,44,846
公投第９案,臺北市,松山區,民有里,577,1189,549,153,702,25,727
公投第９案,臺北市,松山區,民有里,578,1214,519,184,703,43,746
公投第９案,臺北市,松山區,民有里,579,1284,533,181,714,47,761
公投第９案,臺北市,松山區,民有里,580,1297,552,202,754,48,802
公投第９案,臺北市,松山區,民有里,581,1330,543,192,735,35,770
公投第９案,臺北市,松山區,民福里,582,1396,655,160,815,53,868
公投第９案,臺北市,松山區,民福里,583,1480,663,150,813,27,840
公投第９案,臺北市,松山區,民福里,584,1419,646,186,832,33,865
公投第９案,臺北市,松山區,民福里,585,1390,607,181,788,55,843
公投第９案,臺北市,松山區,松基里,586,1525,662,207,869,45,914
公投第９案,臺北市,松山區,松基里,587,1633,641,206,847,48,895
公投第９案,臺北市,松山區,慈祐里,588,2677,651,190,841,51,892
公投第９案,臺北市,松山區,慈祐里,589,1281,632,80,712,57,769
公投第９案,臺北市,松山區,慈祐里,590,1469,492,177,669,47,716
公投第９案,臺北市,松山區,慈祐里,591,1700,664,228,892,69,961
公投第９案,臺北市,松山區,安平里,592,1503,597,177,774,39,813
公投第９案,臺北市,松山區,安平里,593,1309,548,159,707,50,757
公投第９案,臺北市,松山區,安平里,594,1376,598,174,772,65,837
公投第９案,臺北市,松山區,安平里,595,1654,609,321,930,32,962
公投第９案,臺北市,松山區,安平里,596,1601,633,190,823,79,902
公投第９案,臺北市,松山區,鵬程里,597,1496,708,135,843,33,876
公投第９案,臺北市,松山區,鵬程里,598,1598,719,218,937,75,1012
公投第９案,臺北市,松山區,鵬程里,599,1751,769,231,1000,57,1057
公投第９案,臺北市,松山區,自強里,600,1557,770,156,926,43,969
公投第９案,臺北市,松山區,自強里,601,1686,885,162,1047,54,1101
公投第９案,臺北市,松山區,自強里,602,1707,880,132,1012,40,1052
公投第９案,臺北市,松山區,自強里,603,1854,993,155,1148,44,1192
公投第９案,臺北市,松山區,自強里,604,1740,745,198,943,40,983
公投第９案,臺北市,松山區,吉祥里,605,1494,627,192,819,66,885
公投第９案,臺北市,松山區,吉祥里,606,1453,649,181,830,44,874
公投第９案,臺北市,松山區,吉祥里,607,1458,651,182,833,38,871
公投第９案,臺北市,松山區,吉祥里,608,1536,657,180,837,46,883
公投第９案,臺北市,松山區,吉祥里,609,1463,638,200,838,39,877
公投第９案,臺北市,松山區,新聚里,610,1790,704,210,914,39,953
公投第９案,臺北市,松山區,新聚里,611,1679,705,248,953,54,1007
公投第９案,臺北市,松山區,新聚里,612,1785,640,220,860,72,932
公投第９案,臺北市,松山區,新聚里,613,1793,737,233,970,67,1037
公投第９案,臺北市,松山區,復盛里,614,1381,614,156,770,50,820
公投第９案,臺北市,松山區,復盛里,615,1279,564,164,728,46,774
公投第９案,臺北市,松山區,復盛里,616,1681,716,225,941,71,1012
公投第９案,臺北市,松山區,復盛里,617,1232,589,137,726,46,772
公投第９案,臺北市,松山區,中正里,618,1533,644,177,821,58,879
公投第９案,臺北市,松山區,中正里,619,1540,677,231,908,39,947
公投第９案,臺北市,松山區,中正里,620,1716,693,212,905,56,961
公投第９案,臺北市,松山區,中正里,621,1664,653,216,869,53,922
公投第９案,臺北市,松山區,中正里,622,1350,553,194,747,31,778
公投第９案,臺北市,松山區,中崙里,623,1837,761,236,997,50,1047
公投第９案,臺北市,松山區,中崙里,624,1558,579,200,779,75,854
公投第９案,臺北市,松山區,美仁里,625,1420,642,180,822,48,870
公投第９案,臺北市,松山區,美仁里,626,1474,594,197,791,55,846
公投第９案,臺北市,松山區,吉仁里,627,1591,641,221,862,47,909
公投第９案,臺北市,松山區,吉仁里,628,1726,743,213,956,58,1014
公投第９案,臺北市,松山區,敦化里,629,1452,570,229,799,43,842
公投第９案,臺北市,松山區,敦化里,630,1482,582,205,787,42,829
公投第９案,臺北市,松山區,敦化里,631,1460,628,192,820,43,863
公投第９案,臺北市,松山區,敦化里,632,1398,545,216,761,43,804
公投第９案,臺北市,松山區,復源里,633,1423,623,184,807,53,860
公投第９案,臺北市,松山區,復源里,634,1226,565,144,709,24,733
公投第９案,臺北市,松山區,復建里,635,1158,515,135,650,51,701
公投第９案,臺北市,松山區,復建里,636,1426,594,190,784,39,823
公投第９案,臺北市,松山區,復建里,637,1177,509,154,663,27,690
公投第９案,臺北市,松山區,復勢里,638,1363,545,200,745,49,794
公投第９案,臺北市,松山區,復勢里,639,1240,550,170,720,49,769
公投第９案,臺北市,松山區,復勢里,640,1375,627,181,808,50,858
公投第９案,臺北市,松山區,復勢里,641,1377,587,196,783,42,825
公投第９案,臺北市,松山區,福成里,642,1225,488,155,643,29,672
公投第９案,臺北市,松山區,福成里,643,1017,425,182,607,40,647
公投第９案,臺北市,信義區,西村里,644,2476,626,149,775,26,801
公投第９案,臺北市,信義區,西村里,645,1381,726,132,858,17,875
公投第９案,臺北市,信義區,西村里,646,1294,615,152,767,53,820
公投第９案,臺北市,信義區,正和里,647,1351,577,180,757,41,798
公投第９案,臺北市,信義區,正和里,648,1296,563,152,715,43,758
公投第９案,臺北市,信義區,正和里,649,1302,597,156,753,48,801
公投第９案,臺北市,信義區,興隆里,650,1025,409,118,527,57,584
公投第９案,臺北市,信義區,興隆里,651,1421,595,163,758,28,786
公投第９案,臺北市,信義區,中興里,652,1501,633,167,800,48,848
公投第９案,臺北市,信義區,中興里,653,1575,594,178,772,42,814
公投第９案,臺北市,信義區,新仁里,654,1516,677,165,842,21,863
公投第９案,臺北市,信義區,新仁里,655,1382,598,190,788,23,811
公投第９案,臺北市,信義區,興雅里,656,1128,494,113,607,50,657
公投第９案,臺北市,信義區,興雅里,657,1397,562,185,747,50,797
公投第９案,臺北市,信義區,興雅里,658,1161,506,167,673,54,727
公投第９案,臺北市,信義區,興雅里,659,1368,580,172,752,43,795
公投第９案,臺北市,信義區,敦厚里,660,1049,470,128,598,25,623
公投第９案,臺北市,信義區,敦厚里,661,1308,562,158,720,49,769
公投第９案,臺北市,信義區,敦厚里,662,1154,514,160,674,45,719
公投第９案,臺北市,信義區,敦厚里,663,1078,497,145,642,23,665
公投第９案,臺北市,信義區,廣居里,664,1375,600,162,762,44,806
公投第９案,臺北市,信義區,廣居里,665,1448,651,173,824,36,860
公投第９案,臺北市,信義區,廣居里,666,1250,562,162,724,25,749
公投第９案,臺北市,信義區,廣居里,667,1381,592,195,787,34,821
公投第９案,臺北市,信義區,廣居里,668,1213,553,160,713,40,753
公投第９案,臺北市,信義區,安康里,669,1373,636,192,828,39,867
公投第９案,臺北市,信義區,安康里,670,1226,550,165,715,42,757
公投第９案,臺北市,信義區,安康里,671,1117,506,161,667,17,684
公投第９案,臺北市,信義區,安康里,672,1123,506,145,651,45,696
公投第９案,臺北市,信義區,安康里,673,1200,538,152,690,38,728
公投第９案,臺北市,信義區,安康里,674,1335,536,135,671,37,708
公投第９案,臺北市,信義區,安康里,675,1332,536,159,695,34,729
公投第９案,臺北市,信義區,六藝里,676,1648,674,236,910,73,983
公投第９案,臺北市,信義區,六藝里,677,1542,602,209,811,69,880
公投第９案,臺北市,信義區,雅祥里,678,1228,516,157,673,57,730
公投第９案,臺北市,信義區,雅祥里,679,1731,705,243,948,56,1004
公投第９案,臺北市,信義區,雅祥里,680,1403,601,180,781,52,833
公投第９案,臺北市,信義區,五常里,681,1929,786,199,985,85,1070
公投第９案,臺北市,信義區,五常里,682,1300,594,167,761,39,800
公投第９案,臺北市,信義區,五全里,683,1486,589,161,750,31,781
公投第９案,臺北市,信義區,五全里,684,1532,530,181,711,63,774
公投第９案,臺北市,信義區,五全里,685,1387,611,199,810,56,866
公投第９案,臺北市,信義區,永吉里,686,1195,470,133,603,56,659
公投第９案,臺北市,信義區,永吉里,687,1068,434,118,552,37,589
公投第９案,臺北市,信義區,永吉里,688,1273,497,126,623,53,676
公投第９案,臺北市,信義區,長春里,689,1329,596,180,776,64,840
公投第９案,臺北市,信義區,長春里,690,1311,496,169,665,45,710
公投第９案,臺北市,信義區,長春里,691,1258,507,150,657,48,705
公投第９案,臺北市,信義區,四育里,692,1277,541,173,714,60,774
公投第９案,臺北市,信義區,四育里,693,1285,569,180,749,64,813
公投第９案,臺北市,信義區,四育里,694,1161,514,166,680,60,740
公投第９案,臺北市,信義區,四育里,695,1299,513,183,696,41,737
公投第９案,臺北市,信義區,四維里,696,1243,518,155,673,45,718
公投第９案,臺北市,信義區,四維里,697,1197,495,160,655,39,694
公投第９案,臺北市,信義區,四維里,698,1224,570,168,738,31,769
公投第９案,臺北市,信義區,四維里,699,1147,473,127,600,34,634
公投第９案,臺北市,信義區,永春里,700,1045,428,118,546,20,566
公投第９案,臺北市,信義區,永春里,701,1096,513,131,644,30,674
公投第９案,臺北市,信義區,永春里,702,1115,484,136,620,13,633
公投第９案,臺北市,信義區,永春里,703,1117,434,155,589,55,644
公投第９案,臺北市,信義區,富台里,704,1019,386,119,505,27,532
公投第９案,臺北市,信義區,富台里,705,1346,585,166,751,50,801
公投第９案,臺北市,信義區,富台里,706,1405,600,141,741,48,789
公投第９案,臺北市,信義區,國業里,707,1356,591,167,758,37,795
公投第９案,臺北市,信義區,國業里,708,1250,587,178,765,35,800
公投第９案,臺北市,信義區,國業里,709,1254,564,159,723,41,764
公投第９案,臺北市,信義區,國業里,710,1317,592,133,725,29,754
公投第９案,臺北市,信義區,國業里,711,1271,581,160,741,58,799
公投第９案,臺北市,信義區,松隆里,712,979,398,122,520,31,551
公投第９案,臺北市,信義區,松隆里,713,1025,404,122,526,46,572
公投第９案,臺北市,信義區,松友里,714,1512,676,42,718,39,757
公投第９案,臺北市,信義區,松友里,715,1483,664,179,843,36,879
公投第９案,臺北市,信義區,松友里,716,1359,635,157,792,36,828
公投第９案,臺北市,信義區,松友里,717,1387,629,160,789,22,811
公投第９案,臺北市,信義區,松光里,718,1455,578,176,754,28,782
公投第９案,臺北市,信義區,松光里,719,1461,602,209,811,28,839
公投第９案,臺北市,信義區,松光里,720,1532,663,190,853,63,916
公投第９案,臺北市,信義區,中坡里,721,1043,472,156,628,41,669
公投第９案,臺北市,信義區,中坡里,722,875,380,136,516,37,553
公投第９案,臺北市,信義區,中坡里,723,927,376,122,498,24,522
公投第９案,臺北市,信義區,中坡里,724,1119,456,165,621,61,682
公投第９案,臺北市,信義區,中行里,725,1463,600,201,801,59,860
公投第９案,臺北市,信義區,中行里,726,1293,595,181,776,42,818
公投第９案,臺北市,信義區,中行里,727,1553,608,201,809,64,873
公投第９案,臺北市,信義區,中行里,728,1360,571,169,740,38,778
公投第９案,臺北市,信義區,中行里,729,1392,588,177,765,63,828
公投第９案,臺北市,信義區,大道里,730,1377,559,191,750,24,774
公投第９案,臺北市,信義區,大道里,731,1377,615,154,769,16,785
公投第９案,臺北市,信義區,大道里,732,1269,461,169,630,36,666
公投第９案,臺北市,信義區,大道里,733,1407,588,181,769,61,830
公投第９案,臺北市,信義區,大仁里,734,1172,477,161,638,41,679
公投第９案,臺北市,信義區,大仁里,735,1182,520,138,658,20,678
公投第９案,臺北市,信義區,大仁里,736,1255,523,167,690,58,748
公投第９案,臺北市,信義區,景新里,737,1689,653,185,838,35,873
公投第９案,臺北市,信義區,景新里,738,1605,651,138,789,31,820
公投第９案,臺北市,信義區,景新里,739,1143,505,115,620,35,655
公投第９案,臺北市,信義區,惠安里,740,1440,593,147,740,37,777
公投第９案,臺北市,信義區,惠安里,741,1495,620,190,810,46,856
公投第９案,臺北市,信義區,惠安里,742,1514,630,225,855,55,910
公投第９案,臺北市,信義區,惠安里,743,1449,586,150,736,56,792
公投第９案,臺北市,信義區,三張里,744,1401,605,187,792,58,850
公投第９案,臺北市,信義區,三張里,745,1181,479,130,609,21,630
公投第９案,臺北市,信義區,三張里,746,1376,762,56,818,30,848
公投第９案,臺北市,信義區,三張里,747,1422,658,163,821,50,871
公投第９案,臺北市,信義區,三張里,748,1267,566,132,698,25,723
公投第９案,臺北市,信義區,三張里,749,1220,475,154,629,24,653
公投第９案,臺北市,信義區,三犁里,750,1562,602,165,767,25,792
公投第９案,臺北市,信義區,三犁里,751,1455,594,176,770,28,798
公投第９案,臺北市,信義區,三犁里,752,1605,661,172,833,48,881
公投第９案,臺北市,信義區,六合里,753,1626,788,183,971,23,994
公投第９案,臺北市,信義區,六合里,754,1561,678,184,862,71,933
公投第９案,臺北市,信義區,六合里,755,1547,528,185,713,31,744
公投第９案,臺北市,信義區,六合里,756,1336,564,169,733,26,759
公投第９案,臺北市,信義區,泰和里,757,1314,490,135,625,39,664
公投第９案,臺北市,信義區,泰和里,758,1297,509,141,650,42,692
公投第９案,臺北市,信義區,泰和里,759,1366,550,147,697,61,758
公投第９案,臺北市,信義區,泰和里,760,1472,608,183,791,47,838
公投第９案,臺北市,信義區,泰和里,761,1450,619,176,795,49,844
公投第９案,臺北市,信義區,景聯里,762,1328,548,175,723,50,773
公投第９案,臺北市,信義區,景聯里,763,1399,604,195,799,56,855
公投第９案,臺北市,信義區,景聯里,764,1373,601,179,780,66,846
公投第９案,臺北市,信義區,景勤里,765,1099,416,130,546,42,588
公投第９案,臺北市,信義區,景勤里,766,1226,512,149,661,49,710
公投第９案,臺北市,信義區,景勤里,767,1267,532,117,649,22,671
公投第９案,臺北市,信義區,雙和里,768,1531,622,199,821,58,879
公投第９案,臺北市,信義區,雙和里,769,1438,647,175,822,51,873
公投第９案,臺北市,信義區,雙和里,770,1657,677,181,858,27,885
公投第９案,臺北市,信義區,雙和里,771,1621,722,93,815,52,867
公投第９案,臺北市,信義區,嘉興里,772,1508,657,185,842,26,868
公投第９案,臺北市,信義區,嘉興里,773,1334,591,162,753,46,799
公投第９案,臺北市,信義區,黎順里,774,1246,427,122,549,43,592
公投第９案,臺北市,信義區,黎順里,775,1196,486,165,651,46,697
公投第９案,臺北市,信義區,黎順里,776,1220,543,146,689,27,716
公投第９案,臺北市,信義區,黎平里,777,1538,627,177,804,38,842
公投第９案,臺北市,信義區,黎平里,778,1565,696,189,885,55,940
公投第９案,臺北市,信義區,黎平里,779,1621,628,163,791,79,870
公投第９案,臺北市,信義區,黎平里,780,1486,595,180,775,65,840
公投第９案,臺北市,信義區,黎忠里,781,1507,614,161,775,25,800
公投第９案,臺北市,信義區,黎忠里,782,1516,649,187,836,57,893
公投第９案,臺北市,信義區,黎忠里,783,1287,582,161,743,60,803
公投第９案,臺北市,信義區,黎安里,784,1050,399,106,505,56,561
公投第９案,臺北市,信義區,黎安里,785,801,358,104,462,36,498
公投第９案,臺北市,中山區,正守里,786,1522,651,173,824,47,871
公投第９案,臺北市,中山區,正守里,787,1332,504,174,678,34,712
公投第９案,臺北市,中山區,正義里,788,1656,584,198,782,54,836
公投第９案,臺北市,中山區,正義里,789,1367,474,188,662,48,710
公投第９案,臺北市,中山區,正義里,790,1732,627,197,824,59,883
公投第９案,臺北市,中山區,正得里,791,1634,673,210,883,54,937
公投第９案,臺北市,中山區,正得里,792,1650,614,239,853,49,902
公投第９案,臺北市,中山區,民安里,793,1392,557,209,766,47,813
公投第９案,臺北市,中山區,民安里,794,1177,501,200,701,25,726
公投第９案,臺北市,中山區,民安里,795,1477,598,214,812,50,862
公投第９案,臺北市,中山區,康樂里,796,1063,385,139,524,57,581
公投第９案,臺北市,中山區,康樂里,797,1296,510,154,664,49,713
公投第９案,臺北市,中山區,中山里,798,1330,512,164,676,34,710
公投第９案,臺北市,中山區,中山里,799,1483,513,229,742,54,796
公投第９案,臺北市,中山區,中山里,800,1542,610,171,781,40,821
公投第９案,臺北市,中山區,中山里,801,1710,634,196,830,58,888
公投第９案,臺北市,中山區,聚盛里,802,1315,486,144,630,36,666
公投第９案,臺北市,中山區,聚盛里,803,1245,483,144,627,70,697
公投第９案,臺北市,中山區,聚盛里,804,1262,490,157,647,38,685
公投第９案,臺北市,中山區,集英里,805,1518,584,225,809,62,871
公投第９案,臺北市,中山區,集英里,806,1522,610,202,812,64,876
公投第９案,臺北市,中山區,集英里,807,1580,538,224,762,67,829
公投第９案,臺北市,中山區,集英里,808,1529,636,182,818,35,853
公投第９案,臺北市,中山區,聚葉里,809,1221,505,130,635,50,685
公投第９案,臺北市,中山區,聚葉里,810,1221,504,186,690,34,724
公投第９案,臺北市,中山區,聚葉里,811,1139,412,137,549,25,574
公投第９案,臺北市,中山區,恆安里,812,1407,519,211,730,77,807
公投第９案,臺北市,中山區,恆安里,813,1321,533,178,711,46,757
公投第９案,臺北市,中山區,恆安里,814,1578,588,164,752,43,795
公投第９案,臺北市,中山區,晴光里,815,1739,666,181,847,48,895
公投第９案,臺北市,中山區,晴光里,816,1637,590,207,797,58,855
公投第９案,臺北市,中山區,晴光里,817,1541,564,208,772,69,841
公投第９案,臺北市,中山區,圓山里,818,1210,492,182,674,49,723
公投第９案,臺北市,中山區,圓山里,819,1331,510,169,679,45,724
公投第９案,臺北市,中山區,圓山里,820,1224,433,157,590,56,646
公投第９案,臺北市,中山區,新庄里,821,1585,672,168,840,61,901
公投第９案,臺北市,中山區,新庄里,822,1523,625,235,860,83,943
公投第９案,臺北市,中山區,新庄里,823,1368,581,186,767,64,831
公投第９案,臺北市,中山區,劍潭里,824,1805,818,165,983,55,1038
公投第９案,臺北市,中山區,劍潭里,825,1404,667,135,802,41,843
公投第９案,臺北市,中山區,大直里,826,1708,756,267,1023,44,1067
公投第９案,臺北市,中山區,大直里,827,1451,661,203,864,53,917
公投第９案,臺北市,中山區,大直里,828,1684,704,268,972,69,1041
公投第９案,臺北市,中山區,大直里,829,1585,688,171,859,32,891
公投第９案,臺北市,中山區,大直里,830,1391,579,185,764,72,836
公投第９案,臺北市,中山區,成功里,831,1375,631,219,850,62,912
公投第９案,臺北市,中山區,成功里,832,1472,651,211,862,12,874
公投第９案,臺北市,中山區,成功里,833,1327,529,178,707,34,741
公投第９案,臺北市,中山區,成功里,834,1401,618,170,788,34,822
公投第９案,臺北市,中山區,永安里,835,1423,608,171,779,56,835
公投第９案,臺北市,中山區,永安里,836,1569,644,237,881,46,927
公投第９案,臺北市,中山區,永安里,837,1651,686,235,921,31,952
公投第９案,臺北市,中山區,永安里,838,1624,640,224,864,22,886
公投第９案,臺北市,中山區,永安里,839,1713,757,230,987,57,1044
公投第９案,臺北市,中山區,金泰里,840,1647,745,188,933,53,986
公投第９案,臺北市,中山區,金泰里,841,1762,696,223,919,40,959
公投第９案,臺北市,中山區,金泰里,842,1399,638,176,814,46,860
公投第９案,臺北市,中山區,金泰里,843,1489,677,193,870,47,917
公投第９案,臺北市,中山區,北安里,844,1269,600,149,749,31,780
公投第９案,臺北市,中山區,北安里,845,998,468,125,593,48,641
公投第９案,臺北市,中山區,新喜里,846,1472,591,175,766,46,812
公投第９案,臺北市,中山區,新喜里,847,1517,545,213,758,49,807
公投第９案,臺北市,中山區,新喜里,848,1704,743,107,850,74,924
公投第９案,臺北市,中山區,新福里,849,1603,573,329,902,39,941
公投第９案,臺北市,中山區,新福里,850,1432,519,186,705,80,785
公投第９案,臺北市,中山區,新福里,851,1500,593,223,816,76,892
公投第９案,臺北市,中山區,松江里,852,1332,554,205,759,44,803
公投第９案,臺北市,中山區,松江里,853,1450,597,229,826,52,878
公投第９案,臺北市,中山區,松江里,854,1434,601,202,803,57,860
公投第９案,臺北市,中山區,松江里,855,1419,548,175,723,53,776
公投第９案,臺北市,中山區,新生里,856,1292,482,184,666,49,715
公投第９案,臺北市,中山區,新生里,857,1526,634,140,774,60,834
公投第９案,臺北市,中山區,新生里,858,1582,522,200,722,56,778
公投第９案,臺北市,中山區,中庄里,859,1588,561,204,765,64,829
公投第９案,臺北市,中山區,中庄里,860,1463,575,204,779,80,859
公投第９案,臺北市,中山區,中庄里,861,1533,535,203,738,50,788
公投第９案,臺北市,中山區,大佳里,862,944,401,111,512,51,563
公投第９案,臺北市,中山區,行政里,863,1745,744,272,1016,71,1087
公投第９案,臺北市,中山區,行政里,864,1679,600,186,786,50,836
公投第９案,臺北市,中山區,行政里,865,3419,560,197,757,51,808
公投第９案,臺北市,中山區,行仁里,866,1387,567,194,761,69,830
公投第９案,臺北市,中山區,行仁里,867,1672,690,226,916,66,982
公投第９案,臺北市,中山區,行仁里,868,1319,542,159,701,65,766
公投第９案,臺北市,中山區,行仁里,869,1364,547,171,718,54,772
公投第９案,臺北市,中山區,行仁里,870,1461,555,202,757,57,814
公投第９案,臺北市,中山區,行孝里,871,1173,461,181,642,51,693
公投第９案,臺北市,中山區,行孝里,872,1171,431,140,571,60,631
公投第９案,臺北市,中山區,行孝里,873,1310,500,200,700,45,745
公投第９案,臺北市,中山區,下埤里,874,1373,604,173,777,44,821
公投第９案,臺北市,中山區,下埤里,875,1290,541,188,729,33,762
公投第９案,臺北市,中山區,下埤里,876,1346,593,177,770,54,824
公投第９案,臺北市,中山區,下埤里,877,1468,615,209,824,62,886
公投第９案,臺北市,中山區,下埤里,878,1178,496,166,662,40,702
公投第９案,臺北市,中山區,江寧里,879,1654,703,225,928,58,986
公投第９案,臺北市,中山區,江寧里,880,1464,613,186,799,61,860
公投第９案,臺北市,中山區,江寧里,881,1450,553,211,764,29,793
公投第９案,臺北市,中山區,江寧里,882,1534,607,210,817,59,876
公投第９案,臺北市,中山區,江山里,883,1703,677,219,896,48,944
公投第９案,臺北市,中山區,江山里,884,1610,671,207,878,76,954
公投第９案,臺北市,中山區,江山里,885,1653,600,241,841,84,925
公投第９案,臺北市,中山區,江山里,886,1694,683,270,953,62,1015
公投第９案,臺北市,中山區,中吉里,887,1623,620,233,853,58,911
公投第９案,臺北市,中山區,中吉里,888,1618,591,289,880,57,937
公投第９案,臺北市,中山區,中吉里,889,1583,605,219,824,50,874
公投第９案,臺北市,中山區,中原里,890,1605,597,294,891,74,965
公投第９案,臺北市,中山區,中原里,891,1398,608,228,836,53,889
公投第９案,臺北市,中山區,中原里,892,1526,708,215,923,59,982
公投第９案,臺北市,中山區,興亞里,893,1555,698,160,858,49,907
公投第９案,臺北市,中山區,興亞里,894,1597,669,171,840,45,885
公投第９案,臺北市,中山區,興亞里,895,1587,626,218,844,87,931
公投第９案,臺北市,中山區,中央里,896,1587,720,178,898,61,959
公投第９案,臺北市,中山區,中央里,897,1546,635,236,871,72,943
公投第９案,臺北市,中山區,朱馥里,898,1322,548,148,696,57,753
公投第９案,臺北市,中山區,朱馥里,899,1267,536,166,702,38,740
公投第９案,臺北市,中山區,朱馥里,900,1210,512,160,672,16,688
公投第９案,臺北市,中山區,朱馥里,901,1295,554,132,686,60,746
公投第９案,臺北市,中山區,龍洲里,902,1467,624,209,833,62,895
公投第９案,臺北市,中山區,龍洲里,903,1491,719,164,883,52,935
公投第９案,臺北市,中山區,龍洲里,904,1516,785,151,936,53,989
公投第９案,臺北市,中山區,朱園里,905,1384,542,174,716,37,753
公投第９案,臺北市,中山區,朱園里,906,1138,556,159,715,31,746
公投第９案,臺北市,中山區,朱園里,907,1513,554,207,761,38,799
公投第９案,臺北市,中山區,埤頭里,908,1559,671,193,864,60,924
公投第９案,臺北市,中山區,埤頭里,909,1429,588,212,800,76,876
公投第９案,臺北市,中山區,朱崙里,910,1245,565,168,733,32,765
公投第９案,臺北市,中山區,朱崙里,911,1214,568,186,754,41,795
公投第９案,臺北市,中山區,力行里,912,1394,579,204,783,42,825
公投第９案,臺北市,中山區,力行里,913,1336,494,173,667,23,690
公投第９案,臺北市,中山區,力行里,914,1227,499,160,659,35,694
公投第９案,臺北市,中山區,力行里,915,1382,582,195,777,42,819
公投第９案,臺北市,中山區,復華里,916,1436,606,165,771,52,823
公投第９案,臺北市,中山區,復華里,917,1405,524,173,697,37,734
公投第９案,臺北市,中山區,復華里,918,1259,564,130,694,34,728
公投第９案,臺北市,大同區,玉泉里,919,1261,499,178,677,73,750
公投第９案,臺北市,大同區,玉泉里,920,1352,556,225,781,49,830
公投第９案,臺北市,大同區,建明里,921,1462,574,209,783,53,836
公投第９案,臺北市,大同區,建明里,922,1510,585,220,805,70,875
公投第９案,臺北市,大同區,建功里,923,1496,552,196,748,38,786
公投第９案,臺北市,大同區,建功里,924,1329,513,180,693,59,752
公投第９案,臺北市,大同區,建功里,925,1307,507,189,696,72,768
公投第９案,臺北市,大同區,建泰里,926,1065,436,138,574,53,627
公投第９案,臺北市,大同區,建泰里,927,1085,435,149,584,28,612
公投第９案,臺北市,大同區,建泰里,928,1047,414,192,606,52,658
公投第９案,臺北市,大同區,永樂里,929,1215,452,157,609,33,642
公投第９案,臺北市,大同區,永樂里,930,1117,440,206,646,37,683
公投第９案,臺北市,大同區,永樂里,931,1186,501,182,683,51,734
公投第９案,臺北市,大同區,永樂里,932,1185,447,212,659,64,723
公投第９案,臺北市,大同區,朝陽里,933,1359,557,175,732,35,767
公投第９案,臺北市,大同區,朝陽里,934,1273,543,150,693,28,721
公投第９案,臺北市,大同區,朝陽里,935,1291,538,214,752,47,799
公投第９案,臺北市,大同區,星明里,936,1288,500,168,668,48,716
公投第９案,臺北市,大同區,星明里,937,1245,545,191,736,43,779
公投第９案,臺北市,大同區,星明里,938,1261,533,207,740,59,799
公投第９案,臺北市,大同區,星明里,939,1348,514,186,700,33,733
公投第９案,臺北市,大同區,光能里,940,1676,638,256,894,86,980
公投第９案,臺北市,大同區,光能里,941,1311,578,160,738,64,802
公投第９案,臺北市,大同區,光能里,942,1316,515,192,707,84,791
公投第９案,臺北市,大同區,大有里,943,1409,534,230,764,69,833
公投第９案,臺北市,大同區,大有里,944,1436,607,208,815,56,871
公投第９案,臺北市,大同區,大有里,945,1408,529,249,778,58,836
公投第９案,臺北市,大同區,延平里,946,1276,485,207,692,40,732
公投第９案,臺北市,大同區,延平里,947,1110,485,123,608,20,628
公投第９案,臺北市,大同區,延平里,948,1324,533,191,724,30,754
公投第９案,臺北市,大同區,雙連里,949,1016,380,166,546,42,588
公投第９案,臺北市,大同區,雙連里,950,1028,453,146,599,42,641
公投第９案,臺北市,大同區,雙連里,951,1158,490,155,645,56,701
公投第９案,臺北市,大同區,雙連里,952,1138,501,144,645,48,693
公投第９案,臺北市,大同區,雙連里,953,1214,527,150,677,53,730
公投第９案,臺北市,大同區,雙連里,954,1090,433,153,586,32,618
公投第９案,臺北市,大同區,雙連里,955,1305,612,179,791,39,830
公投第９案,臺北市,大同區,南芳里,956,1167,458,132,590,33,623
公投第９案,臺北市,大同區,南芳里,957,1148,448,180,628,46,674
公投第９案,臺北市,大同區,南芳里,958,1203,497,197,694,53,747
公投第９案,臺北市,大同區,民權里,959,1441,558,193,751,42,793
公投第９案,臺北市,大同區,民權里,960,1315,544,210,754,63,817
公投第９案,臺北市,大同區,民權里,961,1393,547,180,727,61,788
公投第９案,臺北市,大同區,民權里,962,1278,520,199,719,46,765
公投第９案,臺北市,大同區,景星里,963,1246,463,144,607,57,664
公投第９案,臺北市,大同區,景星里,964,1142,427,163,590,66,656
公投第９案,臺北市,大同區,隆和里,965,1336,549,200,749,63,812
公投第９案,臺北市,大同區,隆和里,966,1363,549,215,764,70,834
公投第９案,臺北市,大同區,蓬萊里,967,1476,677,132,809,18,827
公投第９案,臺北市,大同區,蓬萊里,968,1418,553,217,770,56,826
公投第９案,臺北市,大同區,蓬萊里,969,1460,575,176,751,33,784
公投第９案,臺北市,大同區,國順里,970,1222,383,172,555,61,616
公投第９案,臺北市,大同區,國順里,971,1246,364,167,531,93,624
公投第９案,臺北市,大同區,國慶里,972,1256,487,229,716,68,784
公投第９案,臺北市,大同區,國慶里,973,1289,527,187,714,29,743
公投第９案,臺北市,大同區,國慶里,974,1340,491,190,681,21,702
公投第９案,臺北市,大同區,揚雅里,975,1555,592,192,784,62,846
公投第９案,臺北市,大同區,揚雅里,976,2459,584,157,741,83,824
公投第９案,臺北市,大同區,斯文里,977,1108,326,153,479,51,530
公投第９案,臺北市,大同區,斯文里,978,867,305,124,429,56,485
公投第９案,臺北市,大同區,斯文里,979,1329,561,112,673,53,726
公投第９案,臺北市,大同區,斯文里,980,1162,427,192,619,37,656
公投第９案,臺北市,大同區,鄰江里,981,1434,520,197,717,70,787
公投第９案,臺北市,大同區,鄰江里,982,1351,528,205,733,56,789
公投第９案,臺北市,大同區,鄰江里,983,1531,548,206,754,52,806
公投第９案,臺北市,大同區,鄰江里,984,1507,525,203,728,15,743
公投第９案,臺北市,大同區,至聖里,985,1488,569,204,773,56,829
公投第９案,臺北市,大同區,至聖里,986,1384,559,212,771,82,853
公投第９案,臺北市,大同區,至聖里,987,1460,571,187,758,88,846
公投第９案,臺北市,大同區,至聖里,988,1371,588,191,779,59,838
公投第９案,臺北市,大同區,至聖里,989,1439,550,199,749,33,782
公投第９案,臺北市,大同區,老師里,990,1376,551,200,751,71,822
公投第９案,臺北市,大同區,老師里,991,1366,526,166,692,83,775
公投第９案,臺北市,大同區,老師里,992,1218,519,204,723,64,787
公投第９案,臺北市,大同區,老師里,993,1235,517,154,671,57,728
公投第９案,臺北市,大同區,重慶里,994,1364,525,170,695,27,722
公投第９案,臺北市,大同區,重慶里,995,1408,600,132,732,71,803
公投第９案,臺北市,大同區,重慶里,996,1450,575,214,789,65,854
公投第９案,臺北市,大同區,重慶里,997,1429,613,209,822,70,892
公投第９案,臺北市,大同區,保安里,998,1170,477,169,646,59,705
公投第９案,臺北市,大同區,保安里,999,1245,465,192,657,78,735
公投第９案,臺北市,大同區,保安里,1000,1215,502,200,702,87,789
公投第９案,臺北市,中正區,水源里,1001,1308,568,168,736,46,782
公投第９案,臺北市,中正區,水源里,1002,1317,489,175,664,71,735
公投第９案,臺北市,中正區,富水里,1003,1069,499,132,631,30,661
公投第９案,臺北市,中正區,富水里,1004,1128,456,131,587,42,629
公投第９案,臺北市,中正區,文盛里,1005,1053,445,160,605,41,646
公投第９案,臺北市,中正區,文盛里,1006,1048,448,140,588,17,605
公投第９案,臺北市,中正區,林興里,1007,1297,581,110,691,47,738
公投第９案,臺北市,中正區,林興里,1008,1193,566,132,698,12,710
公投第９案,臺北市,中正區,林興里,1009,1500,694,225,919,51,970
公投第９案,臺北市,中正區,河堤里,1010,1346,531,175,706,34,740
公投第９案,臺北市,中正區,河堤里,1011,1283,545,153,698,28,726
公投第９案,臺北市,中正區,河堤里,1012,1450,574,202,776,48,824
公投第９案,臺北市,中正區,頂東里,1013,1433,605,208,813,45,858
公投第９案,臺北市,中正區,頂東里,1014,1309,611,206,817,43,860
公投第９案,臺北市,中正區,頂東里,1015,1386,617,164,781,33,814
公投第９案,臺北市,中正區,頂東里,1016,1201,530,156,686,45,731
公投第９案,臺北市,中正區,網溪里,1017,1336,608,168,776,48,824
公投第９案,臺北市,中正區,網溪里,1018,1358,592,187,779,51,830
公投第９案,臺北市,中正區,網溪里,1019,1177,495,170,665,49,714
公投第９案,臺北市,中正區,網溪里,1020,1236,579,178,757,29,786
公投第９案,臺北市,中正區,板溪里,1021,1478,619,192,811,44,855
公投第９案,臺北市,中正區,板溪里,1022,1474,628,191,819,31,850
公投第９案,臺北市,中正區,螢圃里,1023,1172,493,154,647,43,690
公投第９案,臺北市,中正區,螢圃里,1024,1310,555,182,737,37,774
公投第９案,臺北市,中正區,螢圃里,1025,1263,540,176,716,41,757
公投第９案,臺北市,中正區,螢圃里,1026,1169,484,179,663,35,698
公投第９案,臺北市,中正區,螢雪里,1027,1391,602,160,762,30,792
公投第９案,臺北市,中正區,螢雪里,1028,1201,476,173,649,27,676
公投第９案,臺北市,中正區,螢雪里,1029,1324,581,160,741,40,781
公投第９案,臺北市,中正區,永功里,1030,1216,475,151,626,68,694
公投第９案,臺北市,中正區,永功里,1031,1183,469,163,632,50,682
公投第９案,臺北市,中正區,永功里,1032,1469,619,204,823,63,886
公投第９案,臺北市,中正區,永功里,1033,1411,595,171,766,55,821
公投第９案,臺北市,中正區,永昌里,1034,1398,574,190,764,82,846
公投第９案,臺北市,中正區,永昌里,1035,1479,608,162,770,70,840
公投第９案,臺北市,中正區,永昌里,1036,1620,652,177,829,80,909
公投第９案,臺北市,中正區,龍興里,1037,1041,459,112,571,18,589
公投第９案,臺北市,中正區,龍興里,1038,1056,419,145,564,18,582
公投第９案,臺北市,中正區,龍興里,1039,1063,503,139,642,41,683
公投第９案,臺北市,中正區,忠勤里,1040,1591,507,169,676,65,741
公投第９案,臺北市,中正區,忠勤里,1041,1502,484,149,633,75,708
公投第９案,臺北市,中正區,忠勤里,1042,1331,525,136,661,51,712
公投第９案,臺北市,中正區,忠勤里,1043,1441,583,176,759,58,817
公投第９案,臺北市,中正區,廈安里,1044,1273,582,166,748,40,788
公投第９案,臺北市,中正區,廈安里,1045,1133,473,169,642,48,690
公投第９案,臺北市,中正區,廈安里,1046,1156,526,128,654,38,692
公投第９案,臺北市,中正區,愛國里,1047,1377,558,186,744,54,798
公投第９案,臺北市,中正區,愛國里,1048,1266,543,164,707,63,770
公投第９案,臺北市,中正區,南門里,1049,1111,538,132,670,41,711
公投第９案,臺北市,中正區,南門里,1050,1124,511,122,633,25,658
公投第９案,臺北市,中正區,龍光里,1051,1373,608,193,801,39,840
公投第９案,臺北市,中正區,龍光里,1052,1351,624,166,790,39,829
公投第９案,臺北市,中正區,南福里,1053,1495,653,195,848,34,882
公投第９案,臺北市,中正區,南福里,1054,1436,666,203,869,52,921
公投第９案,臺北市,中正區,南福里,1055,1516,660,175,835,26,861
公投第９案,臺北市,中正區,南福里,1056,1374,596,165,761,37,798
公投第９案,臺北市,中正區,南福里,1057,1522,712,80,792,42,834
公投第９案,臺北市,中正區,南福里,1058,1336,580,178,758,42,800
公投第９案,臺北市,中正區,龍福里,1059,1551,671,204,875,36,911
公投第９案,臺北市,中正區,龍福里,1060,1594,694,210,904,49,953
公投第９案,臺北市,中正區,龍福里,1061,1503,616,197,813,62,875
公投第９案,臺北市,中正區,新營里,1062,1455,649,185,834,28,862
公投第９案,臺北市,中正區,新營里,1063,1439,644,176,820,20,840
公投第９案,臺北市,中正區,新營里,1064,1469,642,172,814,43,857
公投第９案,臺北市,中正區,新營里,1065,1430,689,139,828,27,855
公投第９案,臺北市,中正區,新營里,1066,1444,659,182,841,46,887
公投第９案,臺北市,中正區,建國里,1067,1254,555,154,709,15,724
公投第９案,臺北市,中正區,光復里,1068,932,390,136,526,45,571
公投第９案,臺北市,中正區,光復里,1069,1055,453,149,602,42,644
公投第９案,臺北市,中正區,光復里,1070,1226,516,167,683,38,721
公投第９案,臺北市,中正區,黎明里,1071,1390,548,154,702,36,738
公投第９案,臺北市,中正區,黎明里,1072,1336,576,163,739,34,773
公投第９案,臺北市,中正區,梅花里,1073,1419,528,182,710,41,751
公投第９案,臺北市,中正區,梅花里,1074,1361,591,200,791,49,840
公投第９案,臺北市,中正區,幸福里,1075,2520,676,199,875,40,915
公投第９案,臺北市,中正區,幸福里,1076,1224,537,153,690,14,704
公投第９案,臺北市,中正區,幸福里,1077,1272,505,158,663,5,668
公投第９案,臺北市,中正區,幸市里,1078,1400,541,232,773,39,812
公投第９案,臺北市,中正區,幸市里,1079,1319,500,184,684,35,719
公投第９案,臺北市,中正區,幸市里,1080,1232,564,167,731,35,766
公投第９案,臺北市,中正區,東門里,1081,1265,575,172,747,47,794
公投第９案,臺北市,中正區,東門里,1082,1055,515,128,643,25,668
公投第９案,臺北市,中正區,東門里,1083,954,409,130,539,27,566
公投第９案,臺北市,中正區,文北里,1084,1018,446,135,581,32,613
公投第９案,臺北市,中正區,文北里,1085,1431,550,215,765,37,802
公投第９案,臺北市,中正區,文北里,1086,1271,465,162,627,42,669
公投第９案,臺北市,中正區,文北里,1087,983,424,147,571,43,614
公投第９案,臺北市,中正區,文祥里,1088,1594,657,205,862,36,898
公投第９案,臺北市,中正區,文祥里,1089,1565,704,187,891,42,933
公投第９案,臺北市,中正區,文祥里,1090,1650,709,212,921,36,957
公投第９案,臺北市,中正區,文祥里,1091,1600,645,197,842,38,880
公投第９案,臺北市,中正區,三愛里,1092,1391,578,177,755,21,776
公投第９案,臺北市,中正區,三愛里,1093,1769,716,241,957,43,1000
公投第９案,臺北市,中正區,三愛里,1094,1487,606,220,826,47,873
公投第９案,臺北市,中正區,三愛里,1095,1291,591,170,761,23,784
公投第９案,臺北市,中正區,三愛里,1096,1289,567,184,751,26,777
公投第９案,臺北市,萬華區,福星里,1097,1305,531,191,722,57,779
公投第９案,臺北市,萬華區,福星里,1098,1183,404,136,540,65,605
公投第９案,臺北市,萬華區,福星里,1099,1176,468,132,600,36,636
公投第９案,臺北市,萬華區,福星里,1100,1169,421,136,557,31,588
公投第９案,臺北市,萬華區,萬壽里,1101,1457,530,162,692,47,739
公投第９案,臺北市,萬華區,萬壽里,1102,1563,506,175,681,73,754
公投第９案,臺北市,萬華區,西門里,1103,1771,618,184,802,41,843
公投第９案,臺北市,萬華區,西門里,1104,1615,569,214,783,51,834
公投第９案,臺北市,萬華區,新起里,1105,1478,531,213,744,82,826
公投第９案,臺北市,萬華區,新起里,1106,1462,550,184,734,38,772
公投第９案,臺北市,萬華區,新起里,1107,1507,515,150,665,70,735
公投第９案,臺北市,萬華區,新起里,1108,1347,531,198,729,62,791
公投第９案,臺北市,萬華區,菜園里,1109,1367,502,166,668,53,721
公投第９案,臺北市,萬華區,菜園里,1110,1277,543,185,728,56,784
公投第９案,臺北市,萬華區,菜園里,1111,1395,547,213,760,44,804
公投第９案,臺北市,萬華區,菜園里,1112,1450,516,200,716,61,777
公投第９案,臺北市,萬華區,青山里,1113,1340,462,178,640,52,692
公投第９案,臺北市,萬華區,青山里,1114,1242,428,185,613,53,666
公投第９案,臺北市,萬華區,青山里,1115,1286,464,175,639,72,711
公投第９案,臺北市,萬華區,青山里,1116,1324,505,150,655,51,706
公投第９案,臺北市,萬華區,富民里,1117,1619,578,204,782,81,863
公投第９案,臺北市,萬華區,富民里,1118,1352,426,192,618,62,680
公投第９案,臺北市,萬華區,富民里,1119,1440,500,185,685,52,737
公投第９案,臺北市,萬華區,福音里,1120,1194,494,174,668,46,714
公投第９案,臺北市,萬華區,福音里,1121,1083,499,132,631,61,692
公投第９案,臺北市,萬華區,福音里,1122,1237,450,165,615,65,680
公投第９案,臺北市,萬華區,仁德里,1123,1625,611,196,807,64,871
公投第９案,臺北市,萬華區,仁德里,1124,1324,529,199,728,73,801
公投第９案,臺北市,萬華區,仁德里,1125,1352,549,178,727,66,793
公投第９案,臺北市,萬華區,富福里,1126,2630,477,196,673,62,735
公投第９案,臺北市,萬華區,富福里,1127,1504,622,216,838,67,905
公投第９案,臺北市,萬華區,富福里,1128,1425,537,178,715,58,773
公投第９案,臺北市,萬華區,柳鄉里,1129,1591,554,183,737,68,805
公投第９案,臺北市,萬華區,柳鄉里,1130,1474,559,163,722,85,807
公投第９案,臺北市,萬華區,柳鄉里,1131,1612,575,182,757,84,841
公投第９案,臺北市,萬華區,華江里,1132,1447,558,180,738,58,796
公投第９案,臺北市,萬華區,華江里,1133,1491,628,182,810,57,867
公投第９案,臺北市,萬華區,華江里,1134,1500,642,193,835,47,882
公投第９案,臺北市,萬華區,華江里,1135,1582,638,221,859,67,926
公投第９案,臺北市,萬華區,華江里,1136,1623,589,190,779,55,834
公投第９案,臺北市,萬華區,糖廍里,1137,1228,456,165,621,34,655
公投第９案,臺北市,萬華區,糖廍里,1138,1268,472,191,663,59,722
公投第９案,臺北市,萬華區,糖廍里,1139,1207,496,176,672,55,727
公投第９案,臺北市,萬華區,糖廍里,1140,1188,514,158,672,42,714
公投第９案,臺北市,萬華區,綠堤里,1141,1474,564,175,739,50,789
公投第９案,臺北市,萬華區,綠堤里,1142,1304,445,119,564,30,594
公投第９案,臺北市,萬華區,綠堤里,1143,1082,303,100,403,54,457
公投第９案,臺北市,萬華區,頂碩里,1144,1052,336,158,494,49,543
公投第９案,臺北市,萬華區,頂碩里,1145,1135,438,148,586,49,635
公投第９案,臺北市,萬華區,頂碩里,1146,1225,453,177,630,63,693
公投第９案,臺北市,萬華區,頂碩里,1147,1583,584,184,768,65,833
公投第９案,臺北市,萬華區,頂碩里,1148,1403,548,179,727,57,784
公投第９案,臺北市,萬華區,雙園里,1149,1406,549,188,737,74,811
公投第９案,臺北市,萬華區,雙園里,1150,1401,555,196,751,62,813
公投第９案,臺北市,萬華區,雙園里,1151,1188,463,174,637,68,705
公投第９案,臺北市,萬華區,和平里,1152,1597,570,195,765,82,847
公投第９案,臺北市,萬華區,和平里,1153,1290,537,192,729,65,794
公投第９案,臺北市,萬華區,和平里,1154,1746,580,221,801,31,832
公投第９案,臺北市,萬華區,和平里,1155,1595,531,172,703,43,746
公投第９案,臺北市,萬華區,和德里,1156,1701,602,229,831,100,931
公投第９案,臺北市,萬華區,和德里,1157,1339,399,181,580,85,665
公投第９案,臺北市,萬華區,和德里,1158,1484,497,147,644,85,729
公投第９案,臺北市,萬華區,和德里,1159,1604,648,201,849,79,928
公投第９案,臺北市,萬華區,全德里,1160,1197,489,155,644,46,690
公投第９案,臺北市,萬華區,全德里,1161,1347,482,177,659,79,738
公投第９案,臺北市,萬華區,全德里,1162,1223,582,161,743,36,779
公投第９案,臺北市,萬華區,日善里,1163,1036,437,134,571,31,602
公投第９案,臺北市,萬華區,日善里,1164,1035,448,160,608,59,667
公投第９案,臺北市,萬華區,日善里,1165,1141,512,142,654,52,706
公投第９案,臺北市,萬華區,忠德里,1166,1271,540,163,703,35,738
公投第９案,臺北市,萬華區,忠德里,1167,1328,549,170,719,93,812
公投第９案,臺北市,萬華區,忠德里,1168,1286,531,175,706,47,753
公投第９案,臺北市,萬華區,錦德里,1169,1679,675,224,899,86,985
公投第９案,臺北市,萬華區,錦德里,1170,1619,616,201,817,89,906
公投第９案,臺北市,萬華區,錦德里,1171,1625,562,188,750,61,811
公投第９案,臺北市,萬華區,孝德里,1172,1623,680,194,874,70,944
公投第９案,臺北市,萬華區,孝德里,1173,1280,488,163,651,71,722
公投第９案,臺北市,萬華區,壽德里,1174,1608,634,204,838,64,902
公投第９案,臺北市,萬華區,壽德里,1175,1453,592,194,786,64,850
公投第９案,臺北市,萬華區,壽德里,1176,1472,642,209,851,47,898
公投第９案,臺北市,萬華區,銘德里,1177,1373,563,195,758,33,791
公投第９案,臺北市,萬華區,銘德里,1178,1394,548,156,704,68,772
公投第９案,臺北市,萬華區,銘德里,1179,1427,537,153,690,40,730
公投第９案,臺北市,萬華區,保德里,1180,1342,568,206,774,52,826
公投第９案,臺北市,萬華區,保德里,1181,1569,653,194,847,83,930
公投第９案,臺北市,萬華區,榮德里,1182,1514,520,172,692,58,750
公投第９案,臺北市,萬華區,榮德里,1183,1720,625,157,782,40,822
公投第９案,臺北市,萬華區,華中里,1184,1461,645,189,834,70,904
公投第９案,臺北市,萬華區,華中里,1185,1264,480,155,635,43,678
公投第９案,臺北市,萬華區,華中里,1186,1334,567,194,761,67,828
公投第９案,臺北市,萬華區,華中里,1187,1446,600,180,780,42,822
公投第９案,臺北市,萬華區,興德里,1188,1307,508,137,645,38,683
公投第９案,臺北市,萬華區,興德里,1189,1420,564,180,744,90,834
公投第９案,臺北市,萬華區,興德里,1190,1427,522,170,692,40,732
公投第９案,臺北市,萬華區,日祥里,1191,956,385,116,501,41,542
公投第９案,臺北市,萬華區,日祥里,1192,1352,562,174,736,58,794
公投第９案,臺北市,萬華區,日祥里,1193,1370,601,137,738,37,775
公投第９案,臺北市,萬華區,日祥里,1194,1222,587,105,692,40,732
公投第９案,臺北市,萬華區,忠貞里,1195,1375,596,137,733,42,775
公投第９案,臺北市,萬華區,忠貞里,1196,1463,641,155,796,58,854
公投第９案,臺北市,萬華區,忠貞里,1197,1527,577,163,740,38,778
公投第９案,臺北市,萬華區,新忠里,1198,1485,616,135,751,52,803
公投第９案,臺北市,萬華區,新忠里,1199,1591,813,120,933,48,981
公投第９案,臺北市,萬華區,新和里,1200,1394,724,144,868,29,897
公投第９案,臺北市,萬華區,新和里,1201,1522,642,188,830,41,871
公投第９案,臺北市,萬華區,新和里,1202,1661,819,144,963,39,1002
公投第９案,臺北市,萬華區,新和里,1203,1561,757,169,926,36,962
公投第９案,臺北市,萬華區,新和里,1204,1406,695,159,854,47,901
公投第９案,臺北市,萬華區,新安里,1205,1498,510,148,658,37,695
公投第９案,臺北市,萬華區,新安里,1206,1478,486,153,639,79,718
公投第９案,臺北市,萬華區,新安里,1207,1170,464,139,603,55,658
公投第９案,臺北市,萬華區,新安里,1208,1376,628,128,756,54,810
公投第９案,臺北市,萬華區,凌霄里,1209,1093,486,103,589,25,614
公投第９案,臺北市,萬華區,凌霄里,1210,1084,493,131,624,61,685
公投第９案,臺北市,萬華區,凌霄里,1211,1119,488,124,612,65,677
公投第９案,臺北市,萬華區,騰雲里,1212,1381,654,167,821,37,858
公投第９案,臺北市,萬華區,騰雲里,1213,1396,602,170,772,34,806
公投第９案,臺北市,大安區,德安里,1214,1184,474,151,625,20,645
公投第９案,臺北市,大安區,德安里,1215,1197,485,132,617,35,652
公投第９案,臺北市,大安區,德安里,1216,1221,508,170,678,19,697
公投第９案,臺北市,大安區,德安里,1217,1246,574,141,715,28,743
公投第９案,臺北市,大安區,仁慈里,1218,1478,629,231,860,44,904
公投第９案,臺北市,大安區,仁慈里,1219,1314,538,161,699,54,753
公投第９案,臺北市,大安區,仁慈里,1220,1594,712,203,915,50,965
公投第９案,臺北市,大安區,和安里,1221,1429,623,201,824,34,858
公投第９案,臺北市,大安區,和安里,1222,1452,688,162,850,26,876
公投第９案,臺北市,大安區,和安里,1223,1551,657,213,870,23,893
公投第９案,臺北市,大安區,和安里,1224,1335,584,176,760,54,814
公投第９案,臺北市,大安區,民炤里,1225,1196,480,140,620,26,646
公投第９案,臺北市,大安區,民炤里,1226,1339,503,195,698,37,735
公投第９案,臺北市,大安區,民炤里,1227,1448,550,225,775,35,810
公投第９案,臺北市,大安區,民炤里,1228,1373,576,174,750,47,797
公投第９案,臺北市,大安區,民炤里,1229,1439,546,219,765,72,837
公投第９案,臺北市,大安區,仁愛里,1230,1174,445,161,606,14,620
公投第９案,臺北市,大安區,仁愛里,1231,1144,420,146,566,33,599
公投第９案,臺北市,大安區,仁愛里,1232,1119,458,118,576,25,601
公投第９案,臺北市,大安區,仁愛里,1233,1024,347,116,463,36,499
公投第９案,臺北市,大安區,義村里,1234,1032,491,117,608,21,629
公投第９案,臺北市,大安區,義村里,1235,1319,643,104,747,43,790
公投第９案,臺北市,大安區,義村里,1236,1369,647,155,802,42,844
公投第９案,臺北市,大安區,義村里,1237,1347,537,219,756,47,803
公投第９案,臺北市,大安區,民輝里,1238,1655,584,238,822,44,866
公投第９案,臺北市,大安區,民輝里,1239,1595,599,184,783,22,805
公投第９案,臺北市,大安區,民輝里,1240,1429,557,190,747,31,778
公投第９案,臺北市,大安區,民輝里,1241,1309,491,155,646,29,675
公投第９案,臺北市,大安區,昌隆里,1242,1508,578,197,775,42,817
公投第９案,臺北市,大安區,昌隆里,1243,1310,481,197,678,41,719
公投第９案,臺北市,大安區,誠安里,1244,1233,445,164,609,30,639
公投第９案,臺北市,大安區,誠安里,1245,1287,483,157,640,49,689
公投第９案,臺北市,大安區,誠安里,1246,1147,418,151,569,25,594
公投第９案,臺北市,大安區,光武里,1247,1260,477,167,644,32,676
公投第９案,臺北市,大安區,光武里,1248,1377,553,154,707,50,757
公投第９案,臺北市,大安區,光武里,1249,1284,472,173,645,70,715
公投第９案,臺北市,大安區,光武里,1250,1314,536,121,657,26,683
公投第９案,臺北市,大安區,光武里,1251,1273,489,155,644,34,678
公投第９案,臺北市,大安區,龍坡里,1252,1146,452,194,646,24,670
公投第９案,臺北市,大安區,龍坡里,1253,1285,525,200,725,29,754
公投第９案,臺北市,大安區,龍坡里,1254,1297,555,198,753,31,784
公投第９案,臺北市,大安區,龍坡里,1255,1101,500,146,646,39,685
公投第９案,臺北市,大安區,龍泉里,1256,1310,514,183,697,53,750
公投第９案,臺北市,大安區,龍泉里,1257,1365,577,209,786,55,841
公投第９案,臺北市,大安區,龍泉里,1258,1372,561,197,758,26,784
公投第９案,臺北市,大安區,古風里,1259,1189,514,177,691,29,720
公投第９案,臺北市,大安區,古風里,1260,1256,537,172,709,40,749
公投第９案,臺北市,大安區,古風里,1261,1151,503,169,672,32,704
公投第９案,臺北市,大安區,古莊里,1262,1501,690,201,891,39,930
公投第９案,臺北市,大安區,古莊里,1263,1520,779,85,864,44,908
公投第９案,臺北市,大安區,古莊里,1264,1529,662,226,888,53,941
公投第９案,臺北市,大安區,古莊里,1265,1579,695,223,918,43,961
公投第９案,臺北市,大安區,龍安里,1266,2619,484,159,643,29,672
公投第９案,臺北市,大安區,龍安里,1267,1290,553,153,706,25,731
公投第９案,臺北市,大安區,龍安里,1268,1307,557,243,800,18,818
公投第９案,臺北市,大安區,龍安里,1269,1489,629,222,851,26,877
公投第９案,臺北市,大安區,錦安里,1270,1097,520,129,649,33,682
公投第９案,臺北市,大安區,錦安里,1271,1328,571,171,742,35,777
公投第９案,臺北市,大安區,錦安里,1272,1189,488,150,638,30,668
公投第９案,臺北市,大安區,錦安里,1273,1270,560,144,704,25,729
公投第９案,臺北市,大安區,福住里,1274,1349,546,198,744,15,759
公投第９案,臺北市,大安區,福住里,1275,1292,542,162,704,24,728
公投第９案,臺北市,大安區,福住里,1276,1314,586,186,772,36,808
公投第９案,臺北市,大安區,福住里,1277,1200,507,186,693,47,740
公投第９案,臺北市,大安區,永康里,1278,1558,641,227,868,34,902
公投第９案,臺北市,大安區,永康里,1279,1561,665,214,879,37,916
公投第９案,臺北市,大安區,光明里,1280,1446,661,163,824,51,875
公投第９案,臺北市,大安區,光明里,1281,1499,652,207,859,27,886
公投第９案,臺北市,大安區,錦泰里,1282,1467,651,175,826,33,859
公投第９案,臺北市,大安區,錦泰里,1283,1511,586,222,808,37,845
公投第９案,臺北市,大安區,錦華里,1284,1600,678,230,908,54,962
公投第９案,臺北市,大安區,錦華里,1285,1573,661,232,893,39,932
公投第９案,臺北市,大安區,錦華里,1286,1467,671,181,852,43,895
公投第９案,臺北市,大安區,龍圖里,1287,1358,575,157,732,66,798
公投第９案,臺北市,大安區,龍圖里,1288,1568,637,208,845,59,904
公投第９案,臺北市,大安區,龍圖里,1289,1411,622,181,803,42,845
公投第９案,臺北市,大安區,龍圖里,1290,1554,631,181,812,29,841
公投第９案,臺北市,大安區,新龍里,1291,1345,633,159,792,30,822
公投第９案,臺北市,大安區,新龍里,1292,1435,669,143,812,23,835
公投第９案,臺北市,大安區,新龍里,1293,1481,731,165,896,28,924
公投第９案,臺北市,大安區,新龍里,1294,1451,741,149,890,33,923
公投第９案,臺北市,大安區,龍陣里,1295,1566,629,225,854,70,924
公投第９案,臺北市,大安區,龍陣里,1296,1525,648,214,862,30,892
公投第９案,臺北市,大安區,龍雲里,1297,1336,564,145,709,43,752
公投第９案,臺北市,大安區,龍雲里,1298,1483,620,203,823,58,881
公投第９案,臺北市,大安區,龍雲里,1299,1396,512,169,681,29,710
公投第９案,臺北市,大安區,龍生里,1300,1406,646,161,807,63,870
公投第９案,臺北市,大安區,龍生里,1301,1434,620,153,773,33,806
公投第９案,臺北市,大安區,龍生里,1302,1288,586,121,707,38,745
公投第９案,臺北市,大安區,龍生里,1303,1407,634,169,803,30,833
公投第９案,臺北市,大安區,住安里,1304,1514,595,186,781,33,814
公投第９案,臺北市,大安區,住安里,1305,1550,563,162,725,46,771
公投第９案,臺北市,大安區,住安里,1306,1490,650,170,820,52,872
公投第９案,臺北市,大安區,義安里,1307,1284,532,145,677,36,713
公投第９案,臺北市,大安區,義安里,1308,1129,501,146,647,31,678
公投第９案,臺北市,大安區,義安里,1309,1193,502,177,679,23,702
公投第９案,臺北市,大安區,義安里,1310,1057,408,153,561,38,599
公投第９案,臺北市,大安區,通化里,1311,1361,573,169,742,44,786
公投第９案,臺北市,大安區,通化里,1312,1412,578,164,742,54,796
公投第９案,臺北市,大安區,通化里,1313,1423,481,165,646,33,679
公投第９案,臺北市,大安區,通化里,1314,1257,472,156,628,106,734
公投第９案,臺北市,大安區,通安里,1315,1133,519,144,663,40,703
公投第９案,臺北市,大安區,通安里,1316,1077,408,172,580,28,608
公投第９案,臺北市,大安區,通安里,1317,1300,555,191,746,44,790
公投第９案,臺北市,大安區,通安里,1318,1319,589,170,759,57,816
公投第９案,臺北市,大安區,臨江里,1319,1265,522,164,686,75,761
公投第９案,臺北市,大安區,臨江里,1320,1265,496,159,655,30,685
公投第９案,臺北市,大安區,臨江里,1321,1103,501,124,625,28,653
公投第９案,臺北市,大安區,法治里,1322,1341,610,153,763,33,796
公投第９案,臺北市,大安區,法治里,1323,1357,632,149,781,42,823
公投第９案,臺北市,大安區,法治里,1324,1260,526,185,711,35,746
公投第９案,臺北市,大安區,全安里,1325,1295,572,166,738,36,774
公投第９案,臺北市,大安區,全安里,1326,1399,566,140,706,34,740
公投第９案,臺北市,大安區,全安里,1327,1150,487,142,629,35,664
公投第９案,臺北市,大安區,群賢里,1328,1351,544,129,673,30,703
公投第９案,臺北市,大安區,群賢里,1329,1341,566,176,742,50,792
公投第９案,臺北市,大安區,群賢里,1330,1129,474,132,606,22,628
公投第９案,臺北市,大安區,群賢里,1331,1328,604,136,740,20,760
公投第９案,臺北市,大安區,群英里,1332,1557,803,135,938,34,972
公投第９案,臺北市,大安區,群英里,1333,1461,711,173,884,43,927
公投第９案,臺北市,大安區,群英里,1334,1589,648,138,786,32,818
公投第９案,臺北市,大安區,群英里,1335,1473,659,133,792,37,829
公投第９案,臺北市,大安區,虎嘯里,1336,1479,634,171,805,38,843
公投第９案,臺北市,大安區,虎嘯里,1337,833,365,127,492,34,526
公投第９案,臺北市,大安區,虎嘯里,1338,999,422,114,536,29,565
公投第９案,臺北市,大安區,臥龍里,1339,1757,792,206,998,45,1043
公投第９案,臺北市,大安區,龍淵里,1340,1573,578,207,785,36,821
公投第９案,臺北市,大安區,龍淵里,1341,1587,708,231,939,46,985
公投第９案,臺北市,大安區,龍淵里,1342,1496,646,220,866,48,914
公投第９案,臺北市,大安區,龍淵里,1343,1440,602,205,807,37,844
公投第９案,臺北市,大安區,龍淵里,1344,1578,696,206,902,54,956
公投第９案,臺北市,大安區,龍門里,1345,1223,518,171,689,27,716
公投第９案,臺北市,大安區,龍門里,1346,1119,454,171,625,17,642
公投第９案,臺北市,大安區,龍門里,1347,1252,537,195,732,17,749
公投第９案,臺北市,大安區,大學里,1348,1576,673,223,896,34,930
公投第９案,臺北市,大安區,大學里,1349,1425,584,184,768,39,807
公投第９案,臺北市,大安區,大學里,1350,1450,590,196,786,21,807
公投第９案,臺北市,大安區,大學里,1351,1444,575,189,764,39,803
公投第９案,臺北市,大安區,大學里,1352,1337,594,205,799,30,829
公投第９案,臺北市,大安區,芳和里,1353,1417,562,173,735,35,770
公投第９案,臺北市,大安區,芳和里,1354,1250,519,160,679,44,723
公投第９案,臺北市,大安區,芳和里,1355,1176,486,140,626,60,686
公投第９案,臺北市,大安區,芳和里,1356,1257,576,156,732,52,784
公投第９案,臺北市,大安區,黎元里,1357,1257,534,164,698,51,749
公投第９案,臺北市,大安區,黎元里,1358,1148,495,144,639,30,669
公投第９案,臺北市,大安區,黎元里,1359,1418,597,165,762,59,821
公投第９案,臺北市,大安區,黎元里,1360,1028,423,128,551,24,575
公投第９案,臺北市,大安區,黎孝里,1361,1445,627,194,821,46,867
公投第９案,臺北市,大安區,黎孝里,1362,1361,620,146,766,43,809
公投第９案,臺北市,大安區,黎孝里,1363,1343,603,174,777,45,822
公投第９案,臺北市,大安區,黎孝里,1364,1267,547,159,706,45,751
公投第９案,臺北市,大安區,黎孝里,1365,1380,532,178,710,36,746
公投第９案,臺北市,大安區,黎和里,1366,1524,623,179,802,54,856
公投第９案,臺北市,大安區,黎和里,1367,1470,641,176,817,41,858
公投第９案,臺北市,大安區,黎和里,1368,1318,533,120,653,52,705
公投第９案,臺北市,大安區,建安里,1369,1430,551,176,727,39,766
公投第９案,臺北市,大安區,建安里,1370,1386,572,179,751,45,796
公投第９案,臺北市,大安區,建安里,1371,1438,562,166,728,34,762
公投第９案,臺北市,大安區,建倫里,1372,1270,487,144,631,18,649
公投第９案,臺北市,大安區,建倫里,1373,1395,560,172,732,48,780
公投第９案,臺北市,大安區,建倫里,1374,1292,551,145,696,43,739
公投第９案,臺北市,大安區,建倫里,1375,1310,528,162,690,43,733
公投第９案,臺北市,大安區,敦安里,1376,1319,535,169,704,36,740
公投第９案,臺北市,大安區,敦安里,1377,1355,575,185,760,23,783
公投第９案,臺北市,大安區,敦安里,1378,1312,504,158,662,28,690
公投第９案,臺北市,大安區,敦安里,1379,1335,563,154,717,27,744
公投第９案,臺北市,大安區,正聲里,1380,1489,575,170,745,35,780
公投第９案,臺北市,大安區,正聲里,1381,1307,558,159,717,29,746
公投第９案,臺北市,大安區,正聲里,1382,1328,492,177,669,31,700
公投第９案,臺北市,大安區,敦煌里,1383,1277,508,147,655,9,664
公投第９案,臺北市,大安區,敦煌里,1384,1314,560,152,712,36,748
公投第９案,臺北市,大安區,敦煌里,1385,1270,529,184,713,54,767
公投第９案,臺北市,大安區,敦煌里,1386,1308,531,176,707,47,754
公投第９案,臺北市,大安區,華聲里,1387,1138,496,154,650,27,677
公投第９案,臺北市,大安區,華聲里,1388,1333,561,149,710,29,739
公投第９案,臺北市,大安區,華聲里,1389,1176,517,134,651,35,686
公投第９案,臺北市,大安區,車層里,1390,1311,528,185,713,46,759
公投第９案,臺北市,大安區,車層里,1391,1295,533,163,696,27,723
公投第９案,臺北市,大安區,車層里,1392,1421,596,181,777,51,828
公投第９案,臺北市,大安區,車層里,1393,1409,586,156,742,44,786
公投第９案,臺北市,大安區,光信里,1394,1434,623,175,798,43,841
公投第９案,臺北市,大安區,光信里,1395,1449,543,185,728,55,783
公投第９案,臺北市,大安區,光信里,1396,1284,524,175,699,60,759
公投第９案,臺北市,大安區,光信里,1397,1248,554,135,689,28,717
公投第９案,臺北市,大安區,光信里,1398,1119,553,174,727,29,756
公投第９案,臺北市,大安區,學府里,1399,883,413,88,501,36,537
公投第９案,臺北市,大安區,學府里,1400,630,248,75,323,35,358
公投第９案,臺北市,大安區,學府里,1401,814,326,130,456,28,484
公投第９案,臺北市,文山區,景行里,1402,1539,624,200,824,39,863
公投第９案,臺北市,文山區,景行里,1403,1548,602,176,778,41,819
公投第９案,臺北市,文山區,景行里,1404,1493,615,213,828,73,901
公投第９案,臺北市,文山區,景行里,1405,1648,732,207,939,57,996
公投第９案,臺北市,文山區,景東里,1406,1544,686,161,847,46,893
公投第９案,臺北市,文山區,景東里,1407,1557,676,176,852,57,909
公投第９案,臺北市,文山區,景東里,1408,1514,642,154,796,53,849
公投第９案,臺北市,文山區,景東里,1409,1540,744,183,927,57,984
公投第９案,臺北市,文山區,景美里,1410,1466,675,192,867,40,907
公投第９案,臺北市,文山區,景美里,1411,1444,690,164,854,42,896
公投第９案,臺北市,文山區,景美里,1412,1455,635,172,807,79,886
公投第９案,臺北市,文山區,景慶里,1413,1440,597,162,759,51,810
公投第９案,臺北市,文山區,景慶里,1414,1398,642,168,810,57,867
公投第９案,臺北市,文山區,景慶里,1415,1412,574,164,738,27,765
公投第９案,臺北市,文山區,景慶里,1416,1426,597,180,777,51,828
公投第９案,臺北市,文山區,景仁里,1417,1437,627,181,808,45,853
公投第９案,臺北市,文山區,景仁里,1418,1340,593,166,759,49,808
公投第９案,臺北市,文山區,景仁里,1419,1568,682,181,863,27,890
公投第９案,臺北市,文山區,景華里,1420,1372,587,167,754,27,781
公投第９案,臺北市,文山區,景華里,1421,1046,451,123,574,29,603
公投第９案,臺北市,文山區,景華里,1422,1274,557,165,722,40,762
公投第９案,臺北市,文山區,景華里,1423,1324,600,144,744,32,776
公投第９案,臺北市,文山區,萬有里,1424,1722,725,226,951,54,1005
公投第９案,臺北市,文山區,萬有里,1425,1737,762,217,979,62,1041
公投第９案,臺北市,文山區,萬有里,1426,1370,658,174,832,20,852
公投第９案,臺北市,文山區,萬祥里,1427,1495,638,191,829,51,880
公投第９案,臺北市,文山區,萬祥里,1428,1328,569,173,742,59,801
公投第９案,臺北市,文山區,萬祥里,1429,1138,490,169,659,50,709
公投第９案,臺北市,文山區,萬隆里,1430,1471,636,198,834,38,872
公投第９案,臺北市,文山區,萬隆里,1431,1144,531,145,676,35,711
公投第９案,臺北市,文山區,萬隆里,1432,1176,551,162,713,50,763
公投第９案,臺北市,文山區,萬隆里,1433,1212,554,161,715,45,760
公投第９案,臺北市,文山區,萬隆里,1434,1214,575,143,718,32,750
公投第９案,臺北市,文山區,萬年里,1435,1170,474,160,634,41,675
公投第９案,臺北市,文山區,萬年里,1436,1308,573,175,748,52,800
公投第９案,臺北市,文山區,萬年里,1437,1190,511,156,667,56,723
公投第９案,臺北市,文山區,萬年里,1438,1110,504,121,625,45,670
公投第９案,臺北市,文山區,萬和里,1439,1512,694,141,835,55,890
公投第９案,臺北市,文山區,萬和里,1440,1387,659,135,794,63,857
公投第９案,臺北市,文山區,萬盛里,1441,1355,600,171,771,43,814
公投第９案,臺北市,文山區,萬盛里,1442,1370,570,198,768,56,824
公投第９案,臺北市,文山區,萬盛里,1443,1484,661,164,825,63,888
公投第９案,臺北市,文山區,興豐里,1444,1786,768,230,998,53,1051
公投第９案,臺北市,文山區,興豐里,1445,1260,560,148,708,57,765
公投第９案,臺北市,文山區,興豐里,1446,1194,583,165,748,30,778
公投第９案,臺北市,文山區,興邦里,1447,1444,623,190,813,47,860
公投第９案,臺北市,文山區,興邦里,1448,1495,502,139,641,55,696
公投第９案,臺北市,文山區,興邦里,1449,1446,696,132,828,59,887
公投第９案,臺北市,文山區,興光里,1450,1450,624,165,789,65,854
公投第９案,臺北市,文山區,興光里,1451,1486,672,194,866,49,915
公投第９案,臺北市,文山區,興家里,1452,1259,592,147,739,34,773
公投第９案,臺北市,文山區,興家里,1453,1317,632,143,775,26,801
公投第９案,臺北市,文山區,興家里,1454,1321,616,182,798,34,832
公投第９案,臺北市,文山區,興家里,1455,1475,643,171,814,49,863
公投第９案,臺北市,文山區,興家里,1456,1271,538,140,678,55,733
公投第９案,臺北市,文山區,興得里,1457,1609,722,203,925,43,968
公投第９案,臺北市,文山區,興得里,1458,1501,642,152,794,35,829
公投第９案,臺北市,文山區,興得里,1459,997,392,115,507,44,551
公投第９案,臺北市,文山區,興得里,1460,1052,517,130,647,39,686
公投第９案,臺北市,文山區,興業里,1461,1247,584,150,734,29,763
公投第９案,臺北市,文山區,興業里,1462,1167,520,157,677,46,723
公投第９案,臺北市,文山區,興業里,1463,1280,578,161,739,31,770
公投第９案,臺北市,文山區,興業里,1464,1153,567,123,690,26,716
公投第９案,臺北市,文山區,興安里,1465,1557,734,180,914,42,956
公投第９案,臺北市,文山區,興安里,1466,1444,654,160,814,46,860
公投第９案,臺北市,文山區,興安里,1467,1459,713,179,892,41,933
公投第９案,臺北市,文山區,興安里,1468,1357,675,156,831,41,872
公投第９案,臺北市,文山區,興福里,1469,1194,616,137,753,40,793
公投第９案,臺北市,文山區,興福里,1470,1184,543,160,703,60,763
公投第９案,臺北市,文山區,興福里,1471,1119,537,135,672,46,718
公投第９案,臺北市,文山區,興福里,1472,1350,615,125,740,53,793
公投第９案,臺北市,文山區,興旺里,1473,1502,629,166,795,48,843
公投第９案,臺北市,文山區,興旺里,1474,1511,666,185,851,58,909
公投第９案,臺北市,文山區,興旺里,1475,1481,746,184,930,37,967
公投第９案,臺北市,文山區,興旺里,1476,1477,721,175,896,30,926
公投第９案,臺北市,文山區,興旺里,1477,1294,606,157,763,42,805
公投第９案,臺北市,文山區,興泰里,1478,1040,527,142,669,40,709
公投第９案,臺北市,文山區,興泰里,1479,1323,624,166,790,40,830
公投第９案,臺北市,文山區,興泰里,1480,1153,516,153,669,48,717
公投第９案,臺北市,文山區,興昌里,1481,1525,690,154,844,52,896
公投第９案,臺北市,文山區,興昌里,1482,1412,592,149,741,49,790
公投第９案,臺北市,文山區,興昌里,1483,1473,644,225,869,60,929
公投第９案,臺北市,文山區,興昌里,1484,1486,658,205,863,29,892
公投第９案,臺北市,文山區,試院里,1485,1616,804,156,960,53,1013
公投第９案,臺北市,文山區,試院里,1486,1489,709,184,893,53,946
公投第９案,臺北市,文山區,試院里,1487,1414,633,157,790,52,842
公投第９案,臺北市,文山區,試院里,1488,1494,711,203,914,52,966
公投第９案,臺北市,文山區,華興里,1489,1547,698,198,896,60,956
公投第９案,臺北市,文山區,華興里,1490,1587,691,221,912,58,970
公投第９案,臺北市,文山區,華興里,1491,1515,768,162,930,29,959
公投第９案,臺北市,文山區,華興里,1492,1573,753,179,932,53,985
公投第９案,臺北市,文山區,華興里,1493,1542,719,199,918,42,960
公投第９案,臺北市,文山區,明義里,1494,1465,598,155,753,58,811
公投第９案,臺北市,文山區,明義里,1495,699,219,88,307,35,342
公投第９案,臺北市,文山區,明義里,1496,1372,504,148,652,56,708
公投第９案,臺北市,文山區,明興里,1497,1448,555,140,695,50,745
公投第９案,臺北市,文山區,明興里,1498,1548,666,183,849,60,909
公投第９案,臺北市,文山區,明興里,1499,1501,683,184,867,36,903
公投第９案,臺北市,文山區,明興里,1500,1560,747,166,913,30,943
公投第９案,臺北市,文山區,木柵里,1501,1567,690,184,874,44,918
公投第９案,臺北市,文山區,木柵里,1502,1554,702,170,872,45,917
公投第９案,臺北市,文山區,木柵里,1503,1544,668,189,857,59,916
公投第９案,臺北市,文山區,木柵里,1504,1528,704,185,889,44,933
公投第９案,臺北市,文山區,木柵里,1505,1543,757,174,931,31,962
公投第９案,臺北市,文山區,木新里,1506,2754,699,204,903,55,958
公投第９案,臺北市,文山區,木新里,1507,1709,631,95,726,66,792
公投第９案,臺北市,文山區,木新里,1508,1515,623,180,803,68,871
公投第９案,臺北市,文山區,木新里,1509,1571,612,173,785,75,860
公投第９案,臺北市,文山區,木新里,1510,1578,661,175,836,71,907
公投第９案,臺北市,文山區,順興里,1511,1454,590,171,761,64,825
公投第９案,臺北市,文山區,順興里,1512,1436,644,157,801,56,857
公投第９案,臺北市,文山區,順興里,1513,1402,657,164,821,55,876
公投第９案,臺北市,文山區,順興里,1514,1117,516,139,655,44,699
公投第９案,臺北市,文山區,順興里,1515,1094,453,123,576,70,646
公投第９案,臺北市,文山區,忠順里,1516,1070,505,140,645,43,688
公投第９案,臺北市,文山區,忠順里,1517,1319,665,143,808,38,846
公投第９案,臺北市,文山區,忠順里,1518,1226,600,148,748,38,786
公投第９案,臺北市,文山區,樟林里,1519,1385,600,140,740,44,784
公投第９案,臺北市,文山區,樟林里,1520,1416,650,162,812,56,868
公投第９案,臺北市,文山區,樟林里,1521,1412,699,150,849,53,902
公投第９案,臺北市,文山區,樟林里,1522,1535,653,174,827,53,880
公投第９案,臺北市,文山區,樟林里,1523,1654,793,99,892,56,948
公投第９案,臺北市,文山區,樟新里,1524,1156,556,142,698,31,729
公投第９案,臺北市,文山區,樟新里,1525,1231,649,100,749,33,782
公投第９案,臺北市,文山區,樟新里,1526,1218,538,140,678,40,718
公投第９案,臺北市,文山區,樟新里,1527,1176,580,132,712,41,753
公投第９案,臺北市,文山區,樟文里,1528,1392,623,95,718,49,767
公投第９案,臺北市,文山區,樟文里,1529,1323,583,165,748,80,828
公投第９案,臺北市,文山區,樟文里,1530,1297,537,163,700,45,745
公投第９案,臺北市,文山區,樟文里,1531,1296,599,153,752,61,813
公投第９案,臺北市,文山區,樟腳里,1532,1613,676,201,877,55,932
公投第９案,臺北市,文山區,樟腳里,1533,1697,753,206,959,69,1028
公投第９案,臺北市,文山區,樟腳里,1534,1579,680,194,874,71,945
公投第９案,臺北市,文山區,樟樹里,1535,1320,639,164,803,39,842
公投第９案,臺北市,文山區,樟樹里,1536,1438,615,170,785,36,821
公投第９案,臺北市,文山區,樟樹里,1537,1465,619,139,758,30,788
公投第９案,臺北市,文山區,萬芳里,1538,1646,697,227,924,60,984
公投第９案,臺北市,文山區,萬芳里,1539,1286,565,173,738,43,781
公投第９案,臺北市,文山區,萬芳里,1540,1219,571,150,721,29,750
公投第９案,臺北市,文山區,萬芳里,1541,1292,606,156,762,42,804
公投第９案,臺北市,文山區,萬芳里,1542,1489,613,178,791,61,852
公投第９案,臺北市,文山區,萬美里,1543,1611,726,195,921,57,978
公投第９案,臺北市,文山區,萬美里,1544,1549,568,191,759,48,807
公投第９案,臺北市,文山區,萬美里,1545,1678,682,189,871,69,940
公投第９案,臺北市,文山區,萬美里,1546,1660,678,207,885,59,944
公投第９案,臺北市,文山區,博嘉里,1547,1816,666,202,868,33,901
公投第９案,臺北市,文山區,博嘉里,1548,985,379,146,525,33,558
公投第９案,臺北市,文山區,博嘉里,1549,1314,612,159,771,38,809
公投第９案,臺北市,文山區,博嘉里,1550,1018,484,136,620,44,664
公投第９案,臺北市,文山區,萬興里,1551,1578,683,205,888,41,929
公投第９案,臺北市,文山區,萬興里,1552,1457,630,191,821,36,857
公投第９案,臺北市,文山區,萬興里,1553,1326,608,162,770,47,817
公投第９案,臺北市,文山區,萬興里,1554,1393,620,184,804,54,858
公投第９案,臺北市,文山區,萬興里,1555,1377,568,169,737,54,791
公投第９案,臺北市,文山區,政大里,1556,1448,637,198,835,30,865
公投第９案,臺北市,文山區,政大里,1557,1447,641,217,858,55,913
公投第９案,臺北市,文山區,政大里,1558,1739,845,239,1084,47,1131
公投第９案,臺北市,文山區,政大里,1559,1457,663,179,842,33,875
公投第９案,臺北市,文山區,指南里,1560,1288,576,172,748,44,792
公投第９案,臺北市,文山區,指南里,1561,1301,514,145,659,59,718
公投第９案,臺北市,文山區,指南里,1562,865,311,107,418,56,474
公投第９案,臺北市,文山區,老泉里,1563,789,284,116,400,38,438
公投第９案,高雄市,桃源區,梅山里,1,264,56,19,75,1,76
公投第９案,高雄市,桃源區,拉芙蘭里,2,233,112,39,151,20,171
公投第９案,高雄市,桃源區,復興里,3,279,138,28,166,8,174
公投第９案,高雄市,桃源區,勤和里,4,223,65,39,104,4,108
公投第９案,高雄市,桃源區,桃源里,5,783,221,79,300,11,311
公投第９案,高雄市,桃源區,高中里,6,632,185,48,233,7,240
公投第９案,高雄市,桃源區,建山里,7,612,291,93,384,31,415
公投第９案,高雄市,桃源區,寶山里,8,472,171,50,221,27,248
公投第９案,高雄市,那瑪夏區,達卡努瓦里,9,741,222,75,297,29,326
公投第９案,高雄市,那瑪夏區,達卡努瓦里,10,585,250,99,349,68,417
公投第９案,高雄市,那瑪夏區,瑪雅里,11,609,316,88,404,62,466
公投第９案,高雄市,那瑪夏區,南沙魯里,12,489,129,41,170,6,176
公投第９案,高雄市,甲仙區,東安里,13,472,124,25,149,11,160
公投第９案,高雄市,甲仙區,西安里,14,882,386,106,492,62,554
公投第９案,高雄市,甲仙區,和安里,15,668,239,72,311,43,354
公投第９案,高雄市,甲仙區,大田里,16,1581,505,156,661,134,795
公投第９案,高雄市,甲仙區,寶隆里,17,673,150,53,203,12,215
公投第９案,高雄市,甲仙區,關山里,18,607,188,54,242,36,278
公投第９案,高雄市,甲仙區,小林里,19,534,175,52,227,16,243
公投第９案,高雄市,六龜區,新威里,20,760,245,101,346,36,382
公投第９案,高雄市,六龜區,新興里,21,666,205,67,272,35,307
公投第９案,高雄市,六龜區,新寮里,22,704,268,82,350,50,400
公投第９案,高雄市,六龜區,新發里,23,1003,325,131,456,56,512
公投第９案,高雄市,六龜區,荖濃里,24,1382,414,129,543,110,653
公投第９案,高雄市,六龜區,六龜里,25,986,240,96,336,74,410
公投第９案,高雄市,六龜區,義寶里,26,1046,353,132,485,38,523
公投第９案,高雄市,六龜區,興龍里,27,812,222,98,320,62,382
公投第９案,高雄市,六龜區,中興里,28,1431,439,143,582,81,663
公投第９案,高雄市,六龜區,寶來里,29,912,320,80,400,79,479
公投第９案,高雄市,六龜區,文武里,30,1472,381,136,517,49,566
公投第９案,高雄市,六龜區,大津里,31,327,84,31,115,28,143
公投第９案,高雄市,杉林區,杉林里,32,640,190,73,263,52,315
公投第９案,高雄市,杉林區,木梓里,33,696,197,64,261,34,295
公投第９案,高雄市,杉林區,集來里,34,1284,275,128,403,45,448
公投第９案,高雄市,杉林區,新庄里,35,1027,269,120,389,49,438
公投第９案,高雄市,杉林區,新庄里,36,482,154,48,202,26,228
公投第９案,高雄市,杉林區,上平里,37,1627,573,208,781,119,900
公投第９案,高雄市,杉林區,月眉里,38,1630,509,163,672,40,712
公投第９案,高雄市,杉林區,大愛里,39,973,231,93,324,25,349
公投第９案,高雄市,杉林區,大愛里,40,987,260,91,351,34,385
公投第９案,高雄市,杉林區,月美里,41,1261,430,149,579,83,662
公投第９案,高雄市,內門區,溝坪里,42,969,280,94,374,64,438
公投第９案,高雄市,內門區,金竹里,43,652,165,62,227,22,249
公投第９案,高雄市,內門區,永富里,44,961,302,122,424,88,512
公投第９案,高雄市,內門區,永吉里,45,426,133,28,161,7,168
公投第９案,高雄市,內門區,永興里,46,398,123,40,163,19,182
公投第９案,高雄市,內門區,石坑里,47,508,162,38,200,19,219
公投第９案,高雄市,內門區,內門里,48,980,367,123,490,81,571
公投第９案,高雄市,內門區,內豊里,49,1225,368,121,489,46,535
公投第９案,高雄市,內門區,觀亭里,50,1722,599,191,790,156,946
公投第９案,高雄市,內門區,中埔里,51,560,172,74,246,29,275
公投第９案,高雄市,內門區,內東里,52,801,210,78,288,22,310
公投第９案,高雄市,內門區,內南里,53,423,138,58,196,19,215
公投第９案,高雄市,內門區,東埔里,54,497,153,49,202,33,235
公投第９案,高雄市,內門區,三平里,55,677,200,82,282,34,316
公投第９案,高雄市,內門區,木柵里,56,593,137,43,180,12,192
公投第９案,高雄市,內門區,內興里,57,597,144,52,196,54,250
公投第９案,高雄市,內門區,瑞山里,58,343,101,31,132,9,141
公投第９案,高雄市,內門區,光興里,59,670,244,73,317,48,365
公投第９案,高雄市,旗山區,太平里,60,1060,459,116,575,55,630
公投第９案,高雄市,旗山區,太平里,61,1125,433,116,549,41,590
公投第９案,高雄市,旗山區,大德里,62,1100,485,131,616,30,646
公投第９案,高雄市,旗山區,大德里,63,1238,535,152,687,26,713
公投第９案,高雄市,旗山區,湄洲里,64,933,404,99,503,19,522
公投第９案,高雄市,旗山區,湄洲里,65,727,251,72,323,21,344
公投第９案,高雄市,旗山區,圓富里,66,1071,406,131,537,59,596
公投第９案,高雄市,旗山區,圓富里,67,744,261,92,353,29,382
公投第９案,高雄市,旗山區,中正里,68,1100,354,118,472,41,513
公投第９案,高雄市,旗山區,中正里,69,369,140,38,178,15,193
公投第９案,高雄市,旗山區,大林里,70,888,255,104,359,14,373
公投第９案,高雄市,旗山區,大林里,71,510,141,54,195,10,205
公投第９案,高雄市,旗山區,上洲里,72,1042,399,160,559,88,647
公投第９案,高雄市,旗山區,新光里,73,791,282,99,381,50,431
公投第９案,高雄市,旗山區,南勝里,74,939,364,124,488,78,566
公投第９案,高雄市,旗山區,南勝里,75,1218,419,133,552,40,592
公投第９案,高雄市,旗山區,中寮里,76,178,54,22,76,20,96
公投第９案,高雄市,旗山區,東平里,77,946,402,118,520,66,586
公投第９案,高雄市,旗山區,東平里,78,1025,361,138,499,40,539
公投第９案,高雄市,旗山區,東昌里,79,1040,431,115,546,82,628
公投第９案,高雄市,旗山區,竹峰里,80,900,392,133,525,49,574
公投第９案,高雄市,旗山區,竹峰里,81,663,233,64,297,33,330
公投第９案,高雄市,旗山區,瑞吉里,82,954,370,98,468,62,530
公投第９案,高雄市,旗山區,瑞吉里,83,1060,401,111,512,36,548
公投第９案,高雄市,旗山區,永和里,84,1110,456,146,602,60,662
公投第９案,高雄市,旗山區,永和里,85,1062,436,137,573,56,629
公投第９案,高雄市,旗山區,永和里,86,1151,461,121,582,37,619
公投第９案,高雄市,旗山區,三協里,87,266,108,31,139,25,164
公投第９案,高雄市,旗山區,三協里,88,633,272,74,346,40,386
公投第９案,高雄市,旗山區,三協里,89,1307,436,155,591,33,624
公投第９案,高雄市,旗山區,鯤洲里,90,754,251,113,364,61,425
公投第９案,高雄市,旗山區,大山里,91,1296,456,183,639,100,739
公投第９案,高雄市,旗山區,中洲里,92,839,252,91,343,23,366
公投第９案,高雄市,旗山區,南洲里,93,1329,541,155,696,53,749
公投第９案,高雄市,旗山區,廣福里,94,628,245,92,337,33,370
公投第９案,高雄市,美濃區,福安里,95,1175,460,141,601,88,689
公投第９案,高雄市,美濃區,福安里,96,1438,515,146,661,29,690
公投第９案,高雄市,美濃區,合和里,97,989,362,91,453,44,497
公投第９案,高雄市,美濃區,合和里,98,1427,568,72,640,79,719
公投第９案,高雄市,美濃區,祿興里,99,1309,513,160,673,63,736
公投第９案,高雄市,美濃區,祿興里,100,1263,520,155,675,89,764
公投第９案,高雄市,美濃區,中壇里,101,997,418,120,538,60,598
公投第９案,高雄市,美濃區,中壇里,102,1064,422,137,559,56,615
公投第９案,高雄市,美濃區,德興里,103,1498,583,145,728,91,819
公投第９案,高雄市,美濃區,龍山里,104,1119,451,130,581,75,656
公投第９案,高雄市,美濃區,龍山里,105,1031,427,111,538,62,600
公投第９案,高雄市,美濃區,獅山里,106,1437,511,157,668,94,762
公投第９案,高雄市,美濃區,獅山里,107,1071,419,129,548,59,607
公投第９案,高雄市,美濃區,龍肚里,108,687,311,27,338,39,377
公投第９案,高雄市,美濃區,龍肚里,109,775,222,67,289,24,313
公投第９案,高雄市,美濃區,廣德里,110,1353,467,150,617,77,694
公投第９案,高雄市,美濃區,興隆里,111,1191,413,128,541,43,584
公投第９案,高雄市,美濃區,中圳里,112,906,315,80,395,34,429
公投第９案,高雄市,美濃區,中圳里,113,1178,519,124,643,48,691
公投第９案,高雄市,美濃區,東門里,114,1252,424,116,540,44,584
公投第９案,高雄市,美濃區,泰安里,115,1549,622,177,799,61,860
公投第９案,高雄市,美濃區,瀰濃里,116,1088,386,107,493,59,552
公投第９案,高雄市,美濃區,瀰濃里,117,1116,445,136,581,54,635
公投第９案,高雄市,美濃區,清水里,118,977,361,126,487,31,518
公投第９案,高雄市,美濃區,清水里,119,816,321,120,441,70,511
公投第９案,高雄市,美濃區,吉洋里,120,955,318,73,391,32,423
公投第９案,高雄市,美濃區,吉洋里,121,943,350,123,473,76,549
公投第９案,高雄市,美濃區,吉和里,122,1371,504,127,631,58,689
公投第９案,高雄市,美濃區,吉東里,123,919,329,121,450,64,514
公投第９案,高雄市,美濃區,吉東里,124,915,380,124,504,58,562
公投第９案,高雄市,美濃區,廣林里,125,828,275,118,393,64,457
公投第９案,高雄市,美濃區,廣林里,126,674,187,76,263,54,317
公投第９案,高雄市,茂林區,多納里,127,507,242,77,319,37,356
公投第９案,高雄市,茂林區,萬山里,128,382,190,49,239,23,262
公投第９案,高雄市,茂林區,茂林里,129,726,326,87,413,30,443
公投第９案,高雄市,茄萣區,福德里,130,976,302,110,412,16,428
公投第９案,高雄市,茄萣區,萬福里,131,887,287,133,420,64,484
公投第９案,高雄市,茄萣區,白雲里,132,1710,639,168,807,43,850
公投第９案,高雄市,茄萣區,嘉賜里,133,1280,392,118,510,51,561
公投第９案,高雄市,茄萣區,嘉賜里,134,1314,495,183,678,38,716
公投第９案,高雄市,茄萣區,嘉賜里,135,1157,479,164,643,33,676
公投第９案,高雄市,茄萣區,嘉安里,136,1785,652,208,860,124,984
公投第９案,高雄市,茄萣區,嘉樂里,137,838,274,119,393,93,486
公投第９案,高雄市,茄萣區,嘉樂里,138,1249,527,169,696,96,792
公投第９案,高雄市,茄萣區,嘉泰里,139,1116,380,124,504,103,607
公投第９案,高雄市,茄萣區,嘉福里,140,978,302,113,415,56,471
公投第９案,高雄市,茄萣區,和協里,141,1125,323,120,443,51,494
公投第９案,高雄市,茄萣區,嘉定里,142,1139,360,172,532,75,607
公投第９案,高雄市,茄萣區,保定里,143,1363,496,143,639,119,758
公投第９案,高雄市,茄萣區,保定里,144,1598,557,197,754,171,925
公投第９案,高雄市,茄萣區,大定里,145,1111,382,146,528,66,594
公投第９案,高雄市,茄萣區,光定里,146,925,273,93,366,50,416
公投第９案,高雄市,茄萣區,吉定里,147,1148,418,128,546,68,614
公投第９案,高雄市,茄萣區,崎漏里,148,1353,469,150,619,40,659
公投第９案,高雄市,茄萣區,崎漏里,149,1331,491,160,651,69,720
公投第９案,高雄市,茄萣區,崎漏里,150,1829,595,214,809,76,885
公投第９案,高雄市,湖內區,海山里,151,1112,373,137,510,41,551
公投第９案,高雄市,湖內區,劉家里,152,1017,355,128,483,94,577
公投第９案,高雄市,湖內區,太爺里,153,796,266,99,365,30,395
公投第９案,高雄市,湖內區,公舘里,154,1079,138,469,607,37,644
公投第９案,高雄市,湖內區,公舘里,155,1115,408,149,557,37,594
公投第９案,高雄市,湖內區,葉厝里,156,1311,484,154,638,42,680
公投第９案,高雄市,湖內區,葉厝里,157,1319,512,121,633,43,676
公投第９案,高雄市,湖內區,大湖里,158,1244,559,154,713,71,784
公投第９案,高雄市,湖內區,大湖里,159,1227,573,138,711,54,765
公投第９案,高雄市,湖內區,大湖里,160,1163,517,122,639,76,715
公投第９案,高雄市,湖內區,田尾里,161,981,416,133,549,40,589
公投第９案,高雄市,湖內區,湖內里,162,780,288,88,376,20,396
公投第９案,高雄市,湖內區,湖內里,163,832,318,105,423,51,474
公投第９案,高雄市,湖內區,湖內里,164,1017,462,133,595,43,638
公投第９案,高雄市,湖內區,湖內里,165,1051,452,117,569,21,590
公投第９案,高雄市,湖內區,海埔里,166,941,337,111,448,37,485
公投第９案,高雄市,湖內區,海埔里,167,863,326,95,421,55,476
公投第９案,高雄市,湖內區,文賢里,168,1160,428,147,575,55,630
公投第９案,高雄市,湖內區,中賢里,169,1090,323,105,428,27,455
公投第９案,高雄市,湖內區,中賢里,170,1122,436,148,584,60,644
公投第９案,高雄市,湖內區,逸賢里,171,1123,347,117,464,37,501
公投第９案,高雄市,湖內區,忠興里,172,684,230,97,327,30,357
公投第９案,高雄市,湖內區,湖東里,173,1249,430,146,576,25,601
公投第９案,高雄市,湖內區,湖東里,174,1453,519,143,662,53,715
公投第９案,高雄市,路竹區,竹滬里,175,1026,373,118,491,29,520
公投第９案,高雄市,路竹區,竹滬里,176,1069,418,130,548,77,625
公投第９案,高雄市,路竹區,竹滬里,177,1127,455,164,619,70,689
公投第９案,高雄市,路竹區,頂寮里,178,1179,454,129,583,81,664
公投第９案,高雄市,路竹區,新達里,179,1237,452,145,597,105,702
公投第９案,高雄市,路竹區,後鄉里,180,1096,451,138,589,67,656
公投第９案,高雄市,路竹區,北嶺里,181,1272,557,162,719,82,801
公投第９案,高雄市,路竹區,社西里,182,1182,500,121,621,70,691
公投第９案,高雄市,路竹區,社西里,183,1127,454,149,603,48,651
公投第９案,高雄市,路竹區,甲北里,184,956,415,95,510,61,571
公投第９案,高雄市,路竹區,甲北里,185,1132,441,162,603,59,662
公投第９案,高雄市,路竹區,甲南里,186,1025,420,144,564,91,655
公投第９案,高雄市,路竹區,甲南里,187,1007,362,129,491,31,522
公投第９案,高雄市,路竹區,甲南里,188,1301,485,139,624,74,698
公投第９案,高雄市,路竹區,下坑里,189,885,354,111,465,42,507
公投第９案,高雄市,路竹區,下坑里,190,837,257,104,361,31,392
公投第９案,高雄市,路竹區,下坑里,191,930,368,131,499,65,564
公投第９案,高雄市,路竹區,竹園里,192,781,249,93,342,62,404
公投第９案,高雄市,路竹區,竹園里,193,1023,387,156,543,66,609
公投第９案,高雄市,路竹區,竹東里,194,1763,758,194,952,85,1037
公投第９案,高雄市,路竹區,竹東里,195,1637,618,218,836,69,905
公投第９案,高雄市,路竹區,竹西里,196,1070,407,126,533,52,585
公投第９案,高雄市,路竹區,竹西里,197,1177,493,133,626,82,708
公投第９案,高雄市,路竹區,文北里,198,1007,413,128,541,51,592
公投第９案,高雄市,路竹區,文北里,199,1026,415,134,549,38,587
公投第９案,高雄市,路竹區,文北里,200,1017,420,124,544,49,593
公投第９案,高雄市,路竹區,文南里,201,1264,528,149,677,55,732
公投第９案,高雄市,路竹區,文南里,202,1089,464,137,601,58,659
公投第９案,高雄市,路竹區,三爺里,203,851,338,116,454,39,493
公投第９案,高雄市,路竹區,鴨寮里,204,1011,422,122,544,79,623
公投第９案,高雄市,路竹區,鴨寮里,205,937,421,139,560,44,604
公投第９案,高雄市,路竹區,社東里,206,820,262,99,361,16,377
公投第９案,高雄市,路竹區,社東里,207,910,400,149,549,34,583
公投第９案,高雄市,路竹區,社中里,208,867,329,107,436,57,493
公投第９案,高雄市,路竹區,竹南里,209,937,374,120,494,35,529
公投第９案,高雄市,路竹區,竹南里,210,900,375,114,489,21,510
公投第９案,高雄市,路竹區,竹南里,211,900,391,105,496,56,552
公投第９案,高雄市,路竹區,社南里,212,918,399,105,504,42,546
公投第９案,高雄市,路竹區,社南里,213,870,400,121,521,37,558
公投第９案,高雄市,路竹區,社南里,214,1150,511,165,676,45,721
公投第９案,高雄市,路竹區,社南里,215,1537,749,184,933,52,985
公投第９案,高雄市,阿蓮區,石安里,216,1299,413,150,563,35,598
公投第９案,高雄市,阿蓮區,中路里,217,1107,415,127,542,30,572
公投第９案,高雄市,阿蓮區,中路里,218,898,293,112,405,30,435
公投第９案,高雄市,阿蓮區,峯山里,219,1259,425,163,588,86,674
公投第９案,高雄市,阿蓮區,港後里,220,1579,601,158,759,52,811
公投第９案,高雄市,阿蓮區,港後里,221,564,235,70,305,11,316
公投第９案,高雄市,阿蓮區,崗山里,222,768,334,110,444,52,496
公投第９案,高雄市,阿蓮區,阿蓮里,223,1092,446,130,576,61,637
公投第９案,高雄市,阿蓮區,阿蓮里,224,1099,409,155,564,61,625
公投第９案,高雄市,阿蓮區,阿蓮里,225,1134,492,102,594,28,622
公投第９案,高雄市,阿蓮區,阿蓮里,226,1561,555,188,743,31,774
公投第９案,高雄市,阿蓮區,清蓮里,227,1533,571,226,797,103,900
公投第９案,高雄市,阿蓮區,清蓮里,228,1116,377,134,511,40,551
公投第９案,高雄市,阿蓮區,和蓮里,229,1054,389,123,512,41,553
公投第９案,高雄市,阿蓮區,和蓮里,230,1260,476,146,622,60,682
公投第９案,高雄市,阿蓮區,青旗里,231,1504,557,156,713,79,792
公投第９案,高雄市,阿蓮區,復安里,232,848,292,87,379,19,398
公投第９案,高雄市,阿蓮區,復安里,233,823,329,73,402,20,422
公投第９案,高雄市,阿蓮區,玉庫里,234,1021,422,107,529,28,557
公投第９案,高雄市,阿蓮區,南蓮里,235,1715,600,205,805,33,838
公投第９案,高雄市,阿蓮區,南蓮里,236,1300,472,156,628,54,682
公投第９案,高雄市,田寮區,鹿埔里,237,369,100,36,136,6,142
公投第９案,高雄市,田寮區,南安里,238,656,196,45,241,28,269
公投第９案,高雄市,田寮區,南安里,239,406,74,33,107,9,116
公投第９案,高雄市,田寮區,大同里,240,380,117,51,168,20,188
公投第９案,高雄市,田寮區,田寮里,241,379,137,41,178,13,191
公投第９案,高雄市,田寮區,七星里,242,625,207,91,298,58,356
公投第９案,高雄市,田寮區,崇德里,243,946,323,82,405,29,434
公投第９案,高雄市,田寮區,西德里,244,794,241,85,326,49,375
公投第９案,高雄市,田寮區,三和里,245,382,110,39,149,19,168
公投第９案,高雄市,田寮區,古亭里,246,513,105,42,147,51,198
公投第９案,高雄市,田寮區,新興里,247,601,197,72,269,22,291
公投第９案,高雄市,田寮區,新興里,248,620,214,89,303,54,357
公投第９案,高雄市,永安區,永安里,249,756,350,101,451,47,498
公投第９案,高雄市,永安區,永安里,250,818,305,134,439,73,512
公投第９案,高雄市,永安區,永華里,251,866,432,116,548,47,595
公投第９案,高雄市,永安區,永華里,252,951,401,148,549,63,612
公投第９案,高雄市,永安區,新港里,253,992,422,131,553,69,622
公投第９案,高雄市,永安區,新港里,254,682,196,89,285,24,309
公投第９案,高雄市,永安區,新港里,255,665,268,87,355,25,380
公投第９案,高雄市,永安區,鹽田里,256,371,145,43,188,16,204
公投第９案,高雄市,永安區,保寧里,257,1114,461,181,642,87,729
公投第９案,高雄市,永安區,保寧里,258,1418,634,200,834,42,876
公投第９案,高雄市,永安區,維新里,259,1477,680,191,871,86,957
公投第９案,高雄市,永安區,維新里,260,1891,852,233,1085,103,1188
公投第９案,高雄市,岡山區,岡山里,261,1345,646,162,808,64,872
公投第９案,高雄市,岡山區,岡山里,262,1045,327,113,440,27,467
公投第９案,高雄市,岡山區,岡山里,263,1051,473,119,592,46,638
公投第９案,高雄市,岡山區,岡山里,264,917,409,115,524,20,544
公投第９案,高雄市,岡山區,壽天里,265,934,446,121,567,35,602
公投第９案,高雄市,岡山區,壽天里,266,1097,511,123,634,54,688
公投第９案,高雄市,岡山區,壽天里,267,1208,610,146,756,46,802
公投第９案,高雄市,岡山區,平安里,268,1159,515,178,693,74,767
公投第９案,高雄市,岡山區,維仁里,269,1018,416,138,554,69,623
公投第９案,高雄市,岡山區,大遼里,270,1316,471,135,606,44,650
公投第９案,高雄市,岡山區,程香里,271,1345,613,123,736,35,771
公投第９案,高雄市,岡山區,程香里,272,1295,597,153,750,53,803
公投第９案,高雄市,岡山區,程香里,273,1425,621,170,791,49,840
公投第９案,高雄市,岡山區,後紅里,274,1328,533,135,668,39,707
公投第９案,高雄市,岡山區,後紅里,275,1382,614,161,775,25,800
公投第９案,高雄市,岡山區,後紅里,276,1381,652,140,792,33,825
公投第９案,高雄市,岡山區,碧紅里,277,1282,552,145,697,72,769
公投第９案,高雄市,岡山區,碧紅里,278,1240,508,164,672,18,690
公投第９案,高雄市,岡山區,碧紅里,279,1327,590,139,729,65,794
公投第９案,高雄市,岡山區,竹圍里,280,1736,701,182,883,68,951
公投第９案,高雄市,岡山區,竹圍里,281,1566,670,208,878,68,946
公投第９案,高雄市,岡山區,竹圍里,282,1779,648,169,817,50,867
公投第９案,高雄市,岡山區,竹圍里,283,1593,702,182,884,83,967
公投第９案,高雄市,岡山區,台上里,284,1480,660,186,846,72,918
公投第９案,高雄市,岡山區,台上里,285,1364,610,167,777,36,813
公投第９案,高雄市,岡山區,台上里,286,1410,620,184,804,58,862
公投第９案,高雄市,岡山區,台上里,287,1148,564,163,727,61,788
公投第９案,高雄市,岡山區,為隨里,288,625,264,96,360,46,406
公投第９案,高雄市,岡山區,灣裡里,289,969,425,128,553,44,597
公投第９案,高雄市,岡山區,灣裡里,290,861,379,130,509,23,532
公投第９案,高雄市,岡山區,本洲里,291,823,321,93,414,19,433
公投第９案,高雄市,岡山區,本洲里,292,889,397,129,526,68,594
公投第９案,高雄市,岡山區,前峰里,293,1283,566,155,721,55,776
公投第９案,高雄市,岡山區,前峰里,294,1512,625,159,784,43,827
公投第９案,高雄市,岡山區,壽峰里,295,983,462,148,610,62,672
公投第９案,高雄市,岡山區,壽峰里,296,1262,571,140,711,42,753
公投第９案,高雄市,岡山區,仁壽里,297,1096,464,150,614,65,679
公投第９案,高雄市,岡山區,仁壽里,298,1066,471,128,599,49,648
公投第９案,高雄市,岡山區,仁壽里,299,1188,513,115,628,36,664
公投第９案,高雄市,岡山區,後協里,300,1360,592,184,776,59,835
公投第９案,高雄市,岡山區,後協里,301,1363,605,182,787,47,834
公投第９案,高雄市,岡山區,後協里,302,1352,637,172,809,67,876
公投第９案,高雄市,岡山區,後協里,303,1460,635,161,796,73,869
公投第９案,高雄市,岡山區,協和里,304,1272,584,144,728,51,779
公投第９案,高雄市,岡山區,協和里,305,1080,491,145,636,56,692
公投第９案,高雄市,岡山區,協和里,306,1255,519,178,697,83,780
公投第９案,高雄市,岡山區,協榮里,307,938,446,119,565,63,628
公投第９案,高雄市,岡山區,協榮里,308,1237,572,158,730,62,792
公投第９案,高雄市,岡山區,劉厝里,309,1413,505,177,682,24,706
公投第９案,高雄市,岡山區,白米里,310,765,317,102,419,15,434
公投第９案,高雄市,岡山區,白米里,311,1043,497,146,643,35,678
公投第９案,高雄市,岡山區,石潭里,312,844,327,69,396,40,436
公投第９案,高雄市,岡山區,石潭里,313,993,519,168,687,43,730
公投第９案,高雄市,岡山區,福興里,314,1038,460,139,599,71,670
公投第９案,高雄市,岡山區,嘉興里,315,1070,435,145,580,78,658
公投第９案,高雄市,岡山區,嘉興里,316,1023,445,159,604,80,684
公投第９案,高雄市,岡山區,嘉興里,317,1349,559,176,735,31,766
公投第９案,高雄市,岡山區,嘉峰里,318,1452,568,161,729,48,777
公投第９案,高雄市,岡山區,嘉峰里,319,301,127,60,187,16,203
公投第９案,高雄市,岡山區,潭底里,320,756,310,120,430,82,512
公投第９案,高雄市,岡山區,華崗里,321,733,249,86,335,20,355
公投第９案,高雄市,岡山區,華崗里,322,854,385,129,514,98,612
公投第９案,高雄市,岡山區,三和里,323,866,277,79,356,22,378
公投第９案,高雄市,岡山區,大莊里,324,978,398,112,510,58,568
公投第９案,高雄市,岡山區,忠孝里,325,1336,663,116,779,40,819
公投第９案,高雄市,岡山區,忠孝里,326,1218,663,77,740,21,761
公投第９案,高雄市,岡山區,忠孝里,327,341,178,67,245,14,259
公投第９案,高雄市,岡山區,仁義里,328,955,617,65,682,32,714
公投第９案,高雄市,岡山區,仁義里,329,940,576,63,639,11,650
公投第９案,高雄市,岡山區,信義里,330,851,425,105,530,45,575
公投第９案,高雄市,岡山區,信義里,331,762,440,77,517,18,535
公投第９案,高雄市,岡山區,和平里,332,318,176,50,226,14,240
公投第９案,高雄市,燕巢區,尖山里,333,1152,443,130,573,93,666
公投第９案,高雄市,燕巢區,瓊林里,334,1120,465,139,604,30,634
公投第９案,高雄市,燕巢區,瓊林里,335,974,447,130,577,64,641
公投第９案,高雄市,燕巢區,安招里,336,1019,396,118,514,23,537
公投第９案,高雄市,燕巢區,安招里,337,1058,391,124,515,82,597
公投第９案,高雄市,燕巢區,安招里,338,1017,295,102,397,33,430
公投第９案,高雄市,燕巢區,安招里,339,259,30,7,37,4,41
公投第９案,高雄市,燕巢區,角宿里,340,926,421,126,547,66,613
公投第９案,高雄市,燕巢區,角宿里,341,624,207,80,287,19,306
公投第９案,高雄市,燕巢區,角宿里,342,1102,492,157,649,68,717
公投第９案,高雄市,燕巢區,鳳雄里,343,1072,413,116,529,48,577
公投第９案,高雄市,燕巢區,鳳雄里,344,1361,512,193,705,66,771
公投第９案,高雄市,燕巢區,金山里,345,472,193,62,255,31,286
公投第９案,高雄市,燕巢區,東燕里,346,1197,444,134,578,63,641
公投第９案,高雄市,燕巢區,東燕里,347,1134,471,167,638,97,735
公投第９案,高雄市,燕巢區,南燕里,348,1148,423,134,557,48,605
公投第９案,高雄市,燕巢區,南燕里,349,1207,463,114,577,77,654
公投第９案,高雄市,燕巢區,南燕里,350,1402,627,193,820,55,875
公投第９案,高雄市,燕巢區,西燕里,351,1000,397,136,533,73,606
公投第９案,高雄市,燕巢區,西燕里,352,1110,458,143,601,78,679
公投第９案,高雄市,燕巢區,西燕里,353,1291,511,159,670,75,745
公投第９案,高雄市,燕巢區,橫山里,354,797,288,117,405,80,485
公投第９案,高雄市,燕巢區,橫山里,355,1098,378,114,492,75,567
公投第９案,高雄市,燕巢區,深水里,356,1393,524,155,679,73,752
公投第９案,高雄市,燕巢區,深水里,357,1079,353,90,443,23,466
公投第９案,高雄市,彌陀區,光和里,358,1246,494,185,679,70,749
公投第９案,高雄市,彌陀區,彌靖里,359,885,365,125,490,58,548
公投第９案,高雄市,彌陀區,彌靖里,360,955,425,146,571,76,647
公投第９案,高雄市,彌陀區,彌仁里,361,534,188,79,267,48,315
公投第９案,高雄市,彌陀區,彌壽里,362,738,317,98,415,30,445
公投第９案,高雄市,彌陀區,彌陀里,363,855,413,111,524,51,575
公投第９案,高雄市,彌陀區,彌陀里,364,877,30,468,498,57,555
公投第９案,高雄市,彌陀區,舊港里,365,781,324,118,442,61,503
公投第９案,高雄市,彌陀區,舊港里,366,808,317,112,429,36,465
公投第９案,高雄市,彌陀區,文安里,367,904,328,92,420,34,454
公投第９案,高雄市,彌陀區,文安里,368,825,325,112,437,62,499
公投第９案,高雄市,彌陀區,過港里,369,941,325,113,438,81,519
公投第９案,高雄市,彌陀區,鹽埕里,370,1013,393,137,530,40,570
公投第９案,高雄市,彌陀區,鹽埕里,371,1024,425,145,570,74,644
公投第９案,高雄市,彌陀區,海尾里,372,861,320,100,420,26,446
公投第９案,高雄市,彌陀區,漯底里,373,1163,490,156,646,79,725
公投第９案,高雄市,彌陀區,南寮里,374,1216,526,159,685,104,789
公投第９案,高雄市,彌陀區,南寮里,375,861,396,131,527,95,622
公投第９案,高雄市,梓官區,梓信里,376,1061,440,158,598,64,662
公投第９案,高雄市,梓官區,梓信里,377,1063,411,139,550,78,628
公投第９案,高雄市,梓官區,梓義里,378,969,367,140,507,40,547
公投第９案,高雄市,梓官區,梓義里,379,1078,376,134,510,34,544
公投第９案,高雄市,梓官區,梓和里,380,838,328,135,463,57,520
公投第９案,高雄市,梓官區,梓和里,381,611,257,91,348,32,380
公投第９案,高雄市,梓官區,梓和里,382,782,300,102,402,37,439
公投第９案,高雄市,梓官區,梓平里,383,1451,663,208,871,84,955
公投第９案,高雄市,梓官區,中崙里,384,1144,433,141,574,33,607
公投第９案,高雄市,梓官區,同安里,385,975,347,105,452,22,474
公投第９案,高雄市,梓官區,大舍里,386,1317,527,157,684,51,735
公投第９案,高雄市,梓官區,大舍里,387,1218,494,170,664,89,753
公投第９案,高雄市,梓官區,大舍里,388,1073,446,123,569,49,618
公投第９案,高雄市,梓官區,赤崁里,389,1112,410,99,509,43,552
公投第９案,高雄市,梓官區,赤崁里,390,715,259,97,356,45,401
公投第９案,高雄市,梓官區,赤東里,391,1311,488,145,633,62,695
公投第９案,高雄市,梓官區,赤東里,392,939,339,131,470,41,511
公投第９案,高雄市,梓官區,赤西里,393,824,368,108,476,37,513
公投第９案,高雄市,梓官區,禮蚵里,394,1052,430,160,590,104,694
公投第９案,高雄市,梓官區,禮蚵里,395,1020,400,135,535,110,645
公投第９案,高雄市,梓官區,智蚵里,396,1260,423,172,595,51,646
公投第９案,高雄市,梓官區,智蚵里,397,1595,608,184,792,58,850
公投第９案,高雄市,梓官區,信蚵里,398,829,356,97,453,45,498
公投第９案,高雄市,梓官區,信蚵里,399,1532,593,161,754,37,791
公投第９案,高雄市,梓官區,茄苳里,400,1195,507,180,687,76,763
公投第９案,高雄市,梓官區,茄苳里,401,1143,471,150,621,80,701
公投第９案,高雄市,梓官區,典寶里,402,1186,517,143,660,77,737
公投第９案,高雄市,梓官區,典寶里,403,1732,621,149,770,46,816
公投第９案,高雄市,橋頭區,橋頭里,404,1005,431,145,576,79,655
公投第９案,高雄市,橋頭區,橋頭里,405,1073,483,149,632,48,680
公投第９案,高雄市,橋頭區,橋南里,406,1129,427,171,598,50,648
公投第９案,高雄市,橋頭區,仕隆里,407,1244,552,148,700,81,781
公投第９案,高雄市,橋頭區,仕隆里,408,1091,441,130,571,48,619
公投第９案,高雄市,橋頭區,仕豐里,409,1329,634,172,806,52,858
公投第９案,高雄市,橋頭區,仕豐里,410,1140,482,173,655,51,706
公投第９案,高雄市,橋頭區,芋寮里,411,1220,476,188,664,86,750
公投第９案,高雄市,橋頭區,東林里,412,1047,477,162,639,72,711
公投第９案,高雄市,橋頭區,東林里,413,1315,511,166,677,110,787
公投第９案,高雄市,橋頭區,西林里,414,691,263,89,352,37,389
公投第９案,高雄市,橋頭區,西林里,415,720,314,95,409,69,478
公投第９案,高雄市,橋頭區,白樹里,416,1192,471,172,643,98,741
公投第９案,高雄市,橋頭區,白樹里,417,1318,556,179,735,104,839
公投第９案,高雄市,橋頭區,白樹里,418,761,331,98,429,62,491
公投第９案,高雄市,橋頭區,筆秀里,419,973,396,124,520,35,555
公投第９案,高雄市,橋頭區,筆秀里,420,587,248,81,329,34,363
公投第９案,高雄市,橋頭區,新莊里,421,812,346,126,472,55,527
公投第９案,高雄市,橋頭區,新莊里,422,343,139,65,204,9,213
公投第９案,高雄市,橋頭區,新莊里,423,1266,627,158,785,30,815
公投第９案,高雄市,橋頭區,甲北里,424,1128,496,151,647,93,740
公投第９案,高雄市,橋頭區,甲北里,425,884,371,130,501,63,564
公投第９案,高雄市,橋頭區,甲南里,426,1187,474,125,599,91,690
公投第９案,高雄市,橋頭區,甲南里,427,1259,524,165,689,86,775
公投第９案,高雄市,橋頭區,頂鹽里,428,1361,515,156,671,80,751
公投第９案,高雄市,橋頭區,中崎里,429,671,256,64,320,37,357
公投第９案,高雄市,橋頭區,仕和里,430,1215,548,170,718,61,779
公投第９案,高雄市,橋頭區,仕和里,431,1255,530,171,701,93,794
公投第９案,高雄市,橋頭區,仕和里,432,1219,574,154,728,70,798
公投第９案,高雄市,橋頭區,德松里,433,1372,547,166,713,34,747
公投第９案,高雄市,橋頭區,三德里,434,758,210,80,290,11,301
公投第９案,高雄市,楠梓區,清豐里,435,1309,633,140,773,46,819
公投第９案,高雄市,楠梓區,清豐里,436,1408,598,192,790,43,833
公投第９案,高雄市,楠梓區,清豐里,437,1851,815,213,1028,64,1092
公投第９案,高雄市,楠梓區,清豐里,438,1578,706,203,909,66,975
公投第９案,高雄市,楠梓區,清豐里,439,1715,758,178,936,39,975
公投第９案,高雄市,楠梓區,清豐里,440,1611,622,237,859,31,890
公投第９案,高雄市,楠梓區,清豐里,441,2024,852,202,1054,56,1110
公投第９案,高雄市,楠梓區,清豐里,442,1890,747,217,964,42,1006
公投第９案,高雄市,楠梓區,清豐里,443,1762,671,177,848,32,880
公投第９案,高雄市,楠梓區,清豐里,444,1888,771,201,972,59,1031
公投第９案,高雄市,楠梓區,清豐里,445,1822,750,208,958,79,1037
公投第９案,高雄市,楠梓區,清豐里,446,1846,745,234,979,64,1043
公投第９案,高雄市,楠梓區,東寧里,447,1268,576,139,715,77,792
公投第９案,高雄市,楠梓區,東寧里,448,1240,594,154,748,60,808
公投第９案,高雄市,楠梓區,東寧里,449,1432,634,209,843,35,878
公投第９案,高雄市,楠梓區,五常里,450,1490,633,191,824,62,886
公投第９案,高雄市,楠梓區,五常里,451,1464,672,189,861,52,913
公投第９案,高雄市,楠梓區,五常里,452,1435,538,179,717,82,799
公投第９案,高雄市,楠梓區,五常里,453,1602,627,190,817,79,896
公投第９案,高雄市,楠梓區,享平里,454,1500,589,178,767,68,835
公投第９案,高雄市,楠梓區,享平里,455,1591,626,200,826,106,932
公投第９案,高雄市,楠梓區,惠楠里,456,1669,429,175,604,55,659
公投第９案,高雄市,楠梓區,惠楠里,457,1469,543,287,830,64,894
公投第９案,高雄市,楠梓區,中陽里,458,1559,606,191,797,87,884
公投第９案,高雄市,楠梓區,中陽里,459,1638,619,217,836,88,924
公投第９案,高雄市,楠梓區,惠民里,460,1960,823,249,1072,89,1161
公投第９案,高雄市,楠梓區,惠民里,461,1912,752,264,1016,133,1149
公投第９案,高雄市,楠梓區,惠豐里,462,1559,663,173,836,61,897
公投第９案,高雄市,楠梓區,惠豐里,463,1423,613,144,757,47,804
公投第９案,高雄市,楠梓區,惠豐里,464,1696,749,197,946,41,987
公投第９案,高雄市,楠梓區,錦屏里,465,1493,509,210,719,163,882
公投第９案,高雄市,楠梓區,錦屏里,466,1527,601,220,821,101,922
公投第９案,高雄市,楠梓區,玉屏里,467,1020,399,163,562,81,643
公投第９案,高雄市,楠梓區,玉屏里,468,1197,446,168,614,96,710
公投第９案,高雄市,楠梓區,金田里,469,1528,485,193,678,90,768
公投第９案,高雄市,楠梓區,金田里,470,1918,706,202,908,110,1018
公投第９案,高雄市,楠梓區,稔田里,471,1458,550,192,742,100,842
公投第９案,高雄市,楠梓區,瑞屏里,472,1790,767,231,998,108,1106
公投第９案,高雄市,楠梓區,瑞屏里,473,1845,815,232,1047,95,1142
公投第９案,高雄市,楠梓區,翠屏里,474,2037,905,251,1156,73,1229
公投第９案,高雄市,楠梓區,翠屏里,475,1964,842,206,1048,63,1111
公投第９案,高雄市,楠梓區,翠屏里,476,2006,878,189,1067,45,1112
公投第９案,高雄市,楠梓區,翠屏里,477,1951,818,224,1042,61,1103
公投第９案,高雄市,楠梓區,翠屏里,478,1951,813,203,1016,70,1086
公投第９案,高雄市,楠梓區,翠屏里,479,2008,913,186,1099,105,1204
公投第９案,高雄市,楠梓區,翠屏里,480,1923,830,237,1067,93,1160
公投第９案,高雄市,楠梓區,翠屏里,481,1921,878,211,1089,57,1146
公投第９案,高雄市,楠梓區,宏南里,482,832,438,107,545,35,580
公投第９案,高雄市,楠梓區,宏毅里,483,1156,462,171,633,56,689
公投第９案,高雄市,楠梓區,宏毅里,484,1125,467,161,628,69,697
公投第９案,高雄市,楠梓區,宏榮里,485,1060,449,160,609,69,678
公投第９案,高雄市,楠梓區,宏榮里,486,1502,679,167,846,70,916
公投第９案,高雄市,楠梓區,廣昌里,487,1404,555,202,757,101,858
公投第９案,高雄市,楠梓區,廣昌里,488,1552,574,166,740,83,823
公投第９案,高雄市,楠梓區,久昌里,489,1460,568,191,759,82,841
公投第９案,高雄市,楠梓區,久昌里,490,1315,532,118,650,67,717
公投第９案,高雄市,楠梓區,大昌里,491,1062,471,128,599,71,670
公投第９案,高雄市,楠梓區,大昌里,492,1078,484,113,597,64,661
公投第９案,高雄市,楠梓區,福昌里,493,914,409,118,527,84,611
公投第９案,高雄市,楠梓區,福昌里,494,1064,472,137,609,101,710
公投第９案,高雄市,楠梓區,盛昌里,495,1705,728,230,958,83,1041
公投第９案,高雄市,楠梓區,盛昌里,496,1728,776,195,971,76,1047
公投第９案,高雄市,楠梓區,盛昌里,497,1917,898,189,1087,72,1159
公投第９案,高雄市,楠梓區,泰昌里,498,1439,525,184,709,106,815
公投第９案,高雄市,楠梓區,興昌里,499,1287,579,157,736,77,813
公投第９案,高雄市,楠梓區,興昌里,500,1504,712,167,879,76,955
公投第９案,高雄市,楠梓區,興昌里,501,1405,673,174,847,69,916
公投第９案,高雄市,楠梓區,建昌里,502,1287,514,184,698,87,785
公投第９案,高雄市,楠梓區,建昌里,503,1295,584,163,747,63,810
公投第９案,高雄市,楠梓區,宏昌里,504,1483,677,182,859,66,925
公投第９案,高雄市,楠梓區,宏昌里,505,1649,807,214,1021,72,1093
公投第９案,高雄市,楠梓區,和昌里,506,998,424,156,580,67,647
公投第９案,高雄市,楠梓區,和昌里,507,1025,473,132,605,61,666
公投第９案,高雄市,楠梓區,慶昌里,508,1671,809,246,1055,69,1124
公投第９案,高雄市,楠梓區,慶昌里,509,1453,661,196,857,99,956
公投第９案,高雄市,楠梓區,隆昌里,510,1673,691,202,893,107,1000
公投第９案,高雄市,楠梓區,隆昌里,511,1653,732,161,893,61,954
公投第９案,高雄市,楠梓區,秀昌里,512,1034,461,122,583,58,641
公投第９案,高雄市,楠梓區,秀昌里,513,1127,565,151,716,61,777
公投第９案,高雄市,楠梓區,裕昌里,514,1575,605,201,806,96,902
公投第９案,高雄市,楠梓區,裕昌里,515,1559,691,193,884,65,949
公投第９案,高雄市,楠梓區,裕昌里,516,1378,567,173,740,60,800
公投第９案,高雄市,楠梓區,國昌里,517,1714,734,233,967,82,1049
公投第９案,高雄市,楠梓區,國昌里,518,1721,749,215,964,84,1048
公投第９案,高雄市,楠梓區,加昌里,519,1628,704,197,901,74,975
公投第９案,高雄市,楠梓區,加昌里,520,1590,770,204,974,89,1063
公投第９案,高雄市,楠梓區,加昌里,521,1628,733,198,931,65,996
公投第９案,高雄市,楠梓區,加昌里,522,1739,839,244,1083,56,1139
公投第９案,高雄市,楠梓區,加昌里,523,1642,804,190,994,69,1063
公投第９案,高雄市,楠梓區,仁昌里,524,1766,700,199,899,85,984
公投第９案,高雄市,楠梓區,仁昌里,525,1482,601,181,782,79,861
公投第９案,高雄市,楠梓區,仁昌里,526,1749,755,120,875,41,916
公投第９案,高雄市,楠梓區,藍田里,527,1591,745,170,915,49,964
公投第９案,高雄市,楠梓區,藍田里,528,1545,787,160,947,45,992
公投第９案,高雄市,楠梓區,藍田里,529,1651,839,190,1029,41,1070
公投第９案,高雄市,楠梓區,藍田里,530,1646,800,173,973,68,1041
公投第９案,高雄市,楠梓區,中興里,531,1496,677,195,872,94,966
公投第９案,高雄市,楠梓區,中和里,532,1403,519,186,705,103,808
公投第９案,高雄市,楠梓區,中和里,533,1624,697,188,885,53,938
公投第９案,高雄市,左營區,進學里,534,2604,629,182,811,65,876
公投第９案,高雄市,左營區,尾西里,535,1037,422,140,562,82,644
公投第９案,高雄市,左營區,頂北里,536,542,227,79,306,47,353
公投第９案,高雄市,左營區,中北里,537,635,239,91,330,56,386
公投第９案,高雄市,左營區,中南里,538,518,160,64,224,20,244
公投第９案,高雄市,左營區,廟東里,539,813,274,105,379,66,445
公投第９案,高雄市,左營區,廟北里,540,889,298,144,442,91,533
公投第９案,高雄市,左營區,尾南里,541,731,268,121,389,82,471
公投第９案,高雄市,左營區,尾北里,542,1592,165,586,751,56,807
公投第９案,高雄市,左營區,尾北里,543,1709,697,209,906,57,963
公投第９案,高雄市,左營區,屏山里,544,1588,709,150,859,66,925
公投第９案,高雄市,左營區,祥和里,545,358,166,23,189,8,197
公投第９案,高雄市,左營區,永清里,546,666,381,55,436,20,456
公投第９案,高雄市,左營區,莒光里,547,1748,743,178,921,81,1002
公投第９案,高雄市,左營區,光輝里,548,1196,529,165,694,73,767
公投第９案,高雄市,左營區,光輝里,549,1240,558,158,716,68,784
公投第９案,高雄市,左營區,合群里,550,1402,724,96,820,51,871
公投第９案,高雄市,左營區,合群里,551,1173,644,83,727,22,749
公投第９案,高雄市,左營區,明建里,552,641,365,74,439,21,460
公投第９案,高雄市,左營區,頂西里,553,951,327,151,478,45,523
公投第９案,高雄市,左營區,聖后里,554,732,254,108,362,54,416
公投第９案,高雄市,左營區,聖西里,555,339,122,44,166,14,180
公投第９案,高雄市,左營區,聖南里,556,519,205,66,271,18,289
公投第９案,高雄市,左營區,城南里,557,514,191,93,284,58,342
公投第９案,高雄市,左營區,路東里,558,720,296,96,392,66,458
公投第９案,高雄市,左營區,廍北里,559,411,152,64,216,53,269
公投第９案,高雄市,左營區,廍南里,560,603,244,104,348,48,396
公投第９案,高雄市,左營區,埤西里,561,904,389,89,478,77,555
公投第９案,高雄市,左營區,埤北里,562,1318,474,137,611,45,656
公投第９案,高雄市,左營區,埤東里,563,966,338,125,463,29,492
公投第９案,高雄市,左營區,海勝里,564,1440,655,148,803,38,841
公投第９案,高雄市,左營區,海勝里,565,1990,901,201,1102,49,1151
公投第９案,高雄市,左營區,海勝里,566,1090,547,86,633,42,675
公投第９案,高雄市,左營區,海勝里,567,1272,611,106,717,77,794
公投第９案,高雄市,左營區,崇實里,568,1558,750,196,946,32,978
公投第９案,高雄市,左營區,崇實里,569,1501,736,195,931,34,965
公投第９案,高雄市,左營區,自助里,570,360,202,37,239,9,248
公投第９案,高雄市,左營區,果貿里,571,1335,668,79,747,39,786
公投第９案,高雄市,左營區,果貿里,572,1359,659,105,764,28,792
公投第９案,高雄市,左營區,果惠里,573,1487,698,170,868,65,933
公投第９案,高雄市,左營區,果峰里,574,1637,690,165,855,71,926
公投第９案,高雄市,左營區,新下里,575,1553,738,176,914,43,957
公投第９案,高雄市,左營區,新下里,576,1564,720,210,930,72,1002
公投第９案,高雄市,左營區,新下里,577,1788,839,250,1089,60,1149
公投第９案,高雄市,左營區,新下里,578,2028,905,245,1150,93,1243
公投第９案,高雄市,左營區,新下里,579,2037,863,235,1098,101,1199
公投第９案,高雄市,左營區,新下里,580,2101,1001,244,1245,52,1297
公投第９案,高雄市,左營區,新下里,581,2018,966,211,1177,56,1233
公投第９案,高雄市,左營區,新上里,582,1925,845,312,1157,85,1242
公投第９案,高雄市,左營區,新上里,583,1989,838,247,1085,30,1115
公投第９案,高雄市,左營區,新上里,584,1780,679,194,873,43,916
公投第９案,高雄市,左營區,新上里,585,1778,779,240,1019,40,1059
公投第９案,高雄市,左營區,新上里,586,1496,682,188,870,37,907
公投第９案,高雄市,左營區,新上里,587,1538,697,216,913,46,959
公投第９案,高雄市,左營區,新上里,588,2058,898,286,1184,72,1256
公投第９案,高雄市,左營區,新上里,589,1992,864,265,1129,41,1170
公投第９案,高雄市,左營區,新上里,590,2058,911,269,1180,81,1261
公投第９案,高雄市,左營區,新上里,591,2090,901,323,1224,63,1287
公投第９案,高雄市,左營區,新上里,592,2157,890,86,976,39,1015
公投第９案,高雄市,左營區,新上里,593,2096,982,285,1267,45,1312
公投第９案,高雄市,左營區,新上里,594,2101,924,304,1228,85,1313
公投第９案,高雄市,左營區,新中里,595,1649,731,182,913,77,990
公投第９案,高雄市,左營區,新中里,596,1516,596,210,806,89,895
公投第９案,高雄市,左營區,新中里,597,1678,761,210,971,86,1057
公投第９案,高雄市,左營區,新光里,598,1898,800,245,1045,90,1135
公投第９案,高雄市,左營區,新光里,599,1837,782,226,1008,56,1064
公投第９案,高雄市,左營區,新光里,600,1922,806,203,1009,42,1051
公投第９案,高雄市,左營區,新光里,601,1785,792,260,1052,68,1120
公投第９案,高雄市,左營區,新光里,602,1886,821,209,1030,32,1062
公投第９案,高雄市,左營區,新光里,603,1895,891,224,1115,47,1162
公投第９案,高雄市,左營區,新光里,604,1831,854,210,1064,41,1105
公投第９案,高雄市,左營區,菜公里,605,2050,886,224,1110,48,1158
公投第９案,高雄市,左營區,菜公里,606,2251,1130,300,1430,49,1479
公投第９案,高雄市,左營區,菜公里,607,2126,1012,272,1284,38,1322
公投第９案,高雄市,左營區,菜公里,608,1928,806,209,1015,36,1051
公投第９案,高雄市,左營區,菜公里,609,2166,883,293,1176,71,1247
公投第９案,高雄市,左營區,菜公里,610,2031,922,237,1159,55,1214
公投第９案,高雄市,左營區,菜公里,611,1987,917,248,1165,58,1223
公投第９案,高雄市,左營區,菜公里,612,2166,1020,262,1282,37,1319
公投第９案,高雄市,左營區,菜公里,613,1856,827,241,1068,71,1139
公投第９案,高雄市,左營區,菜公里,614,2289,1065,286,1351,49,1400
公投第９案,高雄市,左營區,菜公里,615,1973,895,219,1114,49,1163
公投第９案,高雄市,左營區,菜公里,616,1818,821,213,1034,93,1127
公投第９案,高雄市,左營區,菜公里,617,1565,678,191,869,27,896
公投第９案,高雄市,左營區,菜公里,618,1608,809,183,992,50,1042
公投第９案,高雄市,左營區,福山里,619,1812,845,250,1095,70,1165
公投第９案,高雄市,左營區,福山里,620,1821,766,201,967,24,991
公投第９案,高雄市,左營區,福山里,621,1907,889,236,1125,68,1193
公投第９案,高雄市,左營區,福山里,622,1812,836,252,1088,46,1134
公投第９案,高雄市,左營區,福山里,623,1833,899,208,1107,46,1153
公投第９案,高雄市,左營區,福山里,624,1850,825,252,1077,59,1136
公投第９案,高雄市,左營區,福山里,625,1738,766,196,962,69,1031
公投第９案,高雄市,左營區,福山里,626,1864,921,236,1157,54,1211
公投第９案,高雄市,左營區,福山里,627,1887,913,228,1141,47,1188
公投第９案,高雄市,左營區,福山里,628,1870,825,185,1010,28,1038
公投第９案,高雄市,左營區,福山里,629,1866,867,193,1060,27,1087
公投第９案,高雄市,左營區,福山里,630,1862,826,209,1035,22,1057
公投第９案,高雄市,左營區,福山里,631,1816,840,221,1061,36,1097
公投第９案,高雄市,左營區,福山里,632,1833,851,207,1058,52,1110
公投第９案,高雄市,左營區,福山里,633,1676,761,229,990,64,1054
公投第９案,高雄市,左營區,福山里,634,1843,878,200,1078,54,1132
公投第９案,高雄市,左營區,福山里,635,1872,899,213,1112,40,1152
公投第９案,高雄市,左營區,福山里,636,2259,1043,246,1289,52,1341
公投第９案,高雄市,大社區,嘉誠里,637,950,341,114,455,80,535
公投第９案,高雄市,大社區,保社里,638,1306,482,134,616,45,661
公投第９案,高雄市,大社區,保社里,639,1856,656,132,788,37,825
公投第９案,高雄市,大社區,大社里,640,986,423,148,571,63,634
公投第９案,高雄市,大社區,大社里,641,1116,381,133,514,59,573
公投第９案,高雄市,大社區,大社里,642,1253,518,201,719,87,806
公投第９案,高雄市,大社區,大社里,643,1613,684,193,877,49,926
公投第９案,高雄市,大社區,保安里,644,1455,546,173,719,53,772
公投第９案,高雄市,大社區,保安里,645,1674,688,246,934,48,982
公投第９案,高雄市,大社區,三奶里,646,1004,430,114,544,64,608
公投第９案,高雄市,大社區,三奶里,647,879,349,109,458,42,500
公投第９案,高雄市,大社區,三奶里,648,778,274,107,381,20,401
公投第９案,高雄市,大社區,觀音里,649,1110,438,180,618,58,676
公投第９案,高雄市,大社區,觀音里,650,1432,548,194,742,66,808
公投第９案,高雄市,大社區,觀音里,651,1466,606,191,797,52,849
公投第９案,高雄市,大社區,觀音里,652,1383,569,302,871,100,971
公投第９案,高雄市,大社區,神農里,653,1645,680,212,892,85,977
公投第９案,高雄市,大社區,神農里,654,1555,549,171,720,66,786
公投第９案,高雄市,大社區,神農里,655,1750,711,218,929,79,1008
公投第９案,高雄市,大社區,中里里,656,1111,441,142,583,68,651
公投第９案,高雄市,大社區,中里里,657,1133,460,158,618,75,693
公投第９案,高雄市,大社區,中里里,658,912,375,113,488,48,536
公投第９案,高雄市,大社區,翠屏里,659,745,219,97,316,16,332
公投第９案,高雄市,大社區,翠屏里,660,934,376,126,502,36,538
公投第９案,高雄市,仁武區,大灣里,661,1777,822,229,1051,57,1108
公投第９案,高雄市,仁武區,大灣里,662,2273,1102,197,1299,89,1388
公投第９案,高雄市,仁武區,灣內里,663,1384,634,201,835,75,910
公投第９案,高雄市,仁武區,灣內里,664,1170,477,151,628,60,688
公投第９案,高雄市,仁武區,灣內里,665,1216,558,189,747,67,814
公投第９案,高雄市,仁武區,灣內里,666,1598,674,193,867,21,888
公投第９案,高雄市,仁武區,灣內里,667,2143,1052,234,1286,37,1323
公投第９案,高雄市,仁武區,考潭里,668,1300,528,158,686,60,746
公投第９案,高雄市,仁武區,考潭里,669,1338,551,184,735,78,813
公投第９案,高雄市,仁武區,烏林里,670,1217,455,158,613,27,640
公投第９案,高雄市,仁武區,烏林里,671,1202,423,127,550,65,615
公投第９案,高雄市,仁武區,烏林里,672,1404,531,143,674,46,720
公投第９案,高雄市,仁武區,仁福里,673,830,324,102,426,54,480
公投第９案,高雄市,仁武區,仁武里,674,1802,567,166,733,41,774
公投第９案,高雄市,仁武區,仁武里,675,1877,718,212,930,72,1002
公投第９案,高雄市,仁武區,仁武里,676,1738,578,202,780,48,828
公投第９案,高雄市,仁武區,文武里,677,1549,605,190,795,53,848
公投第９案,高雄市,仁武區,文武里,678,1579,674,177,851,77,928
公投第９案,高雄市,仁武區,文武里,679,1406,550,145,695,51,746
公投第９案,高雄市,仁武區,文武里,680,1461,658,132,790,35,825
公投第９案,高雄市,仁武區,文武里,681,1311,568,205,773,47,820
公投第９案,高雄市,仁武區,文武里,682,1373,553,167,720,27,747
公投第９案,高雄市,仁武區,竹後里,683,1035,325,145,470,22,492
公投第９案,高雄市,仁武區,竹後里,684,1181,405,179,584,47,631
公投第９案,高雄市,仁武區,八卦里,685,1670,658,185,843,53,896
公投第９案,高雄市,仁武區,八卦里,686,1576,624,184,808,42,850
公投第９案,高雄市,仁武區,八卦里,687,1576,714,190,904,74,978
公投第９案,高雄市,仁武區,八卦里,688,1915,882,245,1127,45,1172
公投第９案,高雄市,仁武區,八卦里,689,1758,739,171,910,33,943
公投第９案,高雄市,仁武區,八卦里,690,1892,936,209,1145,48,1193
公投第９案,高雄市,仁武區,八卦里,691,2025,895,250,1145,76,1221
公投第９案,高雄市,仁武區,八卦里,692,2014,939,237,1176,64,1240
公投第９案,高雄市,仁武區,八卦里,693,1473,749,196,945,49,994
公投第９案,高雄市,仁武區,高楠里,694,979,366,106,472,39,511
公投第９案,高雄市,仁武區,高楠里,695,944,394,108,502,27,529
公投第９案,高雄市,仁武區,後安里,696,1153,476,133,609,98,707
公投第９案,高雄市,仁武區,後安里,697,1328,527,139,666,42,708
公投第９案,高雄市,仁武區,中華里,698,1657,699,210,909,85,994
公投第９案,高雄市,仁武區,五和里,699,1545,570,172,742,76,818
公投第９案,高雄市,仁武區,五和里,700,1417,583,211,794,68,862
公投第９案,高雄市,仁武區,五和里,701,1602,751,217,968,59,1027
公投第９案,高雄市,仁武區,仁和里,702,1823,844,248,1092,76,1168
公投第９案,高雄市,仁武區,仁和里,703,1914,763,260,1023,45,1068
公投第９案,高雄市,仁武區,赤山里,704,1992,856,229,1085,60,1145
公投第９案,高雄市,仁武區,赤山里,705,2045,806,216,1022,45,1067
公投第９案,高雄市,仁武區,赤山里,706,1982,905,244,1149,54,1203
公投第９案,高雄市,仁武區,仁慈里,707,2167,850,250,1100,56,1156
公投第９案,高雄市,鳥松區,鳥松里,708,1678,692,228,920,62,982
公投第９案,高雄市,鳥松區,鳥松里,709,1682,648,190,838,75,913
公投第９案,高雄市,鳥松區,鳥松里,710,1225,530,159,689,58,747
公投第９案,高雄市,鳥松區,鳥松里,711,1322,501,168,669,62,731
公投第９案,高雄市,鳥松區,鳥松里,712,1215,528,158,686,47,733
公投第９案,高雄市,鳥松區,鳥松里,713,1779,679,234,913,50,963
公投第９案,高雄市,鳥松區,鳥松里,714,1129,503,206,709,23,732
公投第９案,高雄市,鳥松區,夢裡里,715,1374,625,166,791,64,855
公投第９案,高雄市,鳥松區,夢裡里,716,1089,424,167,591,35,626
公投第９案,高雄市,鳥松區,夢裡里,717,2219,963,334,1297,62,1359
公投第９案,高雄市,鳥松區,大華里,718,1634,662,227,889,35,924
公投第９案,高雄市,鳥松區,大華里,719,1553,713,204,917,69,986
公投第９案,高雄市,鳥松區,大華里,720,1572,729,212,941,53,994
公投第９案,高雄市,鳥松區,大華里,721,1688,752,257,1009,52,1061
公投第９案,高雄市,鳥松區,大華里,722,1626,690,254,944,38,982
公投第９案,高雄市,鳥松區,大華里,723,1744,818,237,1055,66,1121
公投第９案,高雄市,鳥松區,坔埔里,724,1230,471,147,618,61,679
公投第９案,高雄市,鳥松區,坔埔里,725,1201,525,155,680,94,774
公投第９案,高雄市,鳥松區,坔埔里,726,1117,517,153,670,46,716
公投第９案,高雄市,鳥松區,仁美里,727,1255,484,155,639,77,716
公投第９案,高雄市,鳥松區,仁美里,728,1432,527,157,684,49,733
公投第９案,高雄市,鳥松區,仁美里,729,1370,504,161,665,38,703
公投第９案,高雄市,鳥松區,仁美里,730,1364,601,173,774,76,850
公投第９案,高雄市,鳥松區,仁美里,731,1041,445,153,598,56,654
公投第９案,高雄市,鳥松區,大竹里,732,702,360,111,471,40,511
公投第９案,高雄市,鳥松區,華美里,733,1212,469,195,664,67,731
公投第９案,高雄市,鳥松區,華美里,734,1289,563,125,688,63,751
公投第９案,高雄市,鳥松區,華美里,735,1449,697,196,893,32,925
公投第９案,高雄市,大樹區,竹寮里,736,1386,559,166,725,23,748
公投第９案,高雄市,大樹區,竹寮里,737,1315,647,163,810,25,835
公投第９案,高雄市,大樹區,九曲里,738,2461,985,263,1248,69,1317
公投第９案,高雄市,大樹區,九曲里,739,1274,510,127,637,35,672
公投第９案,高雄市,大樹區,九曲里,740,1265,507,129,636,78,714
公投第９案,高雄市,大樹區,久堂里,741,1504,576,201,777,78,855
公投第９案,高雄市,大樹區,久堂里,742,1049,372,119,491,30,521
公投第９案,高雄市,大樹區,久堂里,743,1573,589,195,784,65,849
公投第９案,高雄市,大樹區,水安里,744,1121,376,107,483,41,524
公投第９案,高雄市,大樹區,水安里,745,1207,500,143,643,60,703
公投第９案,高雄市,大樹區,水寮里,746,1134,417,139,556,38,594
公投第９案,高雄市,大樹區,水寮里,747,1124,429,167,596,56,652
公投第９案,高雄市,大樹區,檨腳里,748,1259,463,152,615,102,717
公投第９案,高雄市,大樹區,檨腳里,749,1105,478,149,627,65,692
公投第９案,高雄市,大樹區,檨腳里,750,1128,440,143,583,68,651
公投第９案,高雄市,大樹區,興山里,751,1079,360,128,488,99,587
公投第９案,高雄市,大樹區,和山里,752,1025,339,113,452,52,504
公投第９案,高雄市,大樹區,姑山里,753,950,342,122,464,65,529
公投第９案,高雄市,大樹區,大坑里,754,1433,525,189,714,99,813
公投第９案,高雄市,大樹區,井腳里,755,794,263,90,353,22,375
公投第９案,高雄市,大樹區,井腳里,756,781,208,69,277,17,294
公投第９案,高雄市,大樹區,小坪里,757,1318,421,145,566,24,590
公投第９案,高雄市,大樹區,龍目里,758,736,266,88,354,51,405
公投第９案,高雄市,大樹區,龍目里,759,1047,342,101,443,36,479
公投第９案,高雄市,大樹區,大樹里,760,1271,478,193,671,75,746
公投第９案,高雄市,大樹區,大樹里,761,1186,365,147,512,44,556
公投第９案,高雄市,大樹區,三和里,762,1007,392,133,525,56,581
公投第９案,高雄市,大樹區,溪埔里,763,859,336,122,458,60,518
公投第９案,高雄市,大樹區,溪埔里,764,735,253,60,313,18,331
公投第９案,高雄市,大樹區,興田里,765,1046,421,135,556,82,638
公投第９案,高雄市,大樹區,興田里,766,880,542,60,602,49,651
公投第９案,高雄市,大樹區,統嶺里,767,720,271,66,337,22,359
公投第９案,高雄市,鼓山區,鼓峰里,768,959,359,108,467,23,490
公投第９案,高雄市,鼓山區,鼓峰里,769,1000,470,139,609,50,659
公投第９案,高雄市,鼓山區,雄峰里,770,910,402,89,491,12,503
公投第９案,高雄市,鼓山區,雄峰里,771,1085,531,120,651,62,713
公投第９案,高雄市,鼓山區,前峰里,772,1484,512,147,659,54,713
公投第９案,高雄市,鼓山區,前峰里,773,1393,584,201,785,35,820
公投第９案,高雄市,鼓山區,前峰里,774,1270,627,143,770,61,831
公投第９案,高雄市,鼓山區,光榮里,775,1055,403,139,542,43,585
公投第９案,高雄市,鼓山區,光榮里,776,1172,462,163,625,30,655
公投第９案,高雄市,鼓山區,光榮里,777,1175,515,168,683,52,735
公投第９案,高雄市,鼓山區,民族里,778,1274,515,178,693,52,745
公投第９案,高雄市,鼓山區,內惟里,779,1085,373,132,505,53,558
公投第９案,高雄市,鼓山區,建國里,780,1470,590,176,766,68,834
公投第９案,高雄市,鼓山區,建國里,781,974,424,150,574,60,634
公投第９案,高雄市,鼓山區,忠正里,782,1275,536,171,707,88,795
公投第９案,高雄市,鼓山區,忠正里,783,1206,437,174,611,73,684
公投第９案,高雄市,鼓山區,忠正里,784,1238,499,164,663,32,695
公投第９案,高雄市,鼓山區,自強里,785,721,415,55,470,23,493
公投第９案,高雄市,鼓山區,龍井里,786,1220,478,133,611,34,645
公投第９案,高雄市,鼓山區,正德里,787,1966,650,206,856,56,912
公投第９案,高雄市,鼓山區,平和里,788,1722,611,205,816,92,908
公投第９案,高雄市,鼓山區,平和里,789,1720,638,202,840,29,869
公投第９案,高雄市,鼓山區,民強里,790,1287,538,154,692,109,801
公投第９案,高雄市,鼓山區,民強里,791,1369,434,141,575,47,622
公投第９案,高雄市,鼓山區,厚生里,792,1222,534,152,686,55,741
公投第９案,高雄市,鼓山區,厚生里,793,1770,687,208,895,54,949
公投第９案,高雄市,鼓山區,龍子里,794,1860,799,230,1029,40,1069
公投第９案,高雄市,鼓山區,龍子里,795,1857,729,246,975,60,1035
公投第９案,高雄市,鼓山區,龍子里,796,1841,772,255,1027,52,1079
公投第９案,高雄市,鼓山區,龍子里,797,1830,812,248,1060,65,1125
公投第９案,高雄市,鼓山區,龍子里,798,1809,779,227,1006,66,1072
公投第９案,高雄市,鼓山區,龍子里,799,1894,863,229,1092,43,1135
公投第９案,高雄市,鼓山區,龍子里,800,1882,845,273,1118,30,1148
公投第９案,高雄市,鼓山區,龍子里,801,1894,860,296,1156,53,1209
公投第９案,高雄市,鼓山區,龍水里,802,1745,793,164,957,42,999
公投第９案,高雄市,鼓山區,龍水里,803,1887,792,228,1020,21,1041
公投第９案,高雄市,鼓山區,龍水里,804,1891,900,270,1170,59,1229
公投第９案,高雄市,鼓山區,龍水里,805,1903,901,212,1113,52,1165
公投第９案,高雄市,鼓山區,龍水里,806,1998,907,265,1172,37,1209
公投第９案,高雄市,鼓山區,龍水里,807,1912,894,225,1119,61,1180
公投第９案,高雄市,鼓山區,龍水里,808,1923,863,255,1118,68,1186
公投第９案,高雄市,鼓山區,龍水里,809,1888,865,264,1129,33,1162
公投第９案,高雄市,鼓山區,龍水里,810,1873,892,235,1127,24,1151
公投第９案,高雄市,鼓山區,龍水里,811,1959,974,283,1257,49,1306
公投第９案,高雄市,鼓山區,龍水里,812,1897,943,240,1183,52,1235
公投第９案,高雄市,鼓山區,明誠里,813,2362,1104,305,1409,53,1462
公投第９案,高雄市,鼓山區,明誠里,814,1850,854,214,1068,78,1146
公投第９案,高雄市,鼓山區,明誠里,815,1928,1091,50,1141,35,1176
公投第９案,高雄市,鼓山區,明誠里,816,1937,860,203,1063,33,1096
公投第９案,高雄市,鼓山區,明誠里,817,2123,933,269,1202,60,1262
公投第９案,高雄市,鼓山區,明誠里,818,1861,825,229,1054,38,1092
公投第９案,高雄市,鼓山區,明誠里,819,1892,850,206,1056,30,1086
公投第９案,高雄市,鼓山區,明誠里,820,2147,983,264,1247,54,1301
公投第９案,高雄市,鼓山區,華豐里,821,1897,860,243,1103,54,1157
公投第９案,高雄市,鼓山區,華豐里,822,2041,890,232,1122,40,1162
公投第９案,高雄市,鼓山區,裕興里,823,1309,570,150,720,55,775
公投第９案,高雄市,鼓山區,裕興里,824,1867,844,210,1054,56,1110
公投第９案,高雄市,鼓山區,裕豐里,825,1152,589,143,732,49,781
公投第９案,高雄市,鼓山區,裕豐里,826,1404,659,194,853,53,906
公投第９案,高雄市,鼓山區,鼓岩里,827,1210,341,82,423,29,452
公投第９案,高雄市,鼓山區,樹德里,828,1135,421,154,575,53,628
公投第９案,高雄市,鼓山區,寶樹里,829,1831,437,137,574,89,663
公投第９案,高雄市,鼓山區,興宗里,830,1288,522,162,684,68,752
公投第９案,高雄市,鼓山區,光化里,831,1241,473,134,607,44,651
公投第９案,高雄市,鼓山區,山下里,832,1342,568,184,752,73,825
公投第９案,高雄市,鼓山區,河邊里,833,1422,570,185,755,114,869
公投第９案,高雄市,鼓山區,綠川里,834,1453,613,188,801,112,913
公投第９案,高雄市,鼓山區,登山里,835,616,256,96,352,46,398
公投第９案,高雄市,鼓山區,峰南里,836,834,300,123,423,75,498
公投第９案,高雄市,鼓山區,麗興里,837,969,352,144,496,73,569
公投第９案,高雄市,鼓山區,新民里,838,978,346,139,485,84,569
公投第９案,高雄市,鼓山區,延平里,839,760,286,134,420,65,485
公投第９案,高雄市,鼓山區,維生里,840,1248,500,167,667,76,743
公投第９案,高雄市,鼓山區,惠安里,841,1143,380,164,544,29,573
公投第９案,高雄市,鼓山區,壽山里,842,1358,433,161,594,79,673
公投第９案,高雄市,鼓山區,哨船頭里,843,1036,391,101,492,18,510
公投第９案,高雄市,鼓山區,桃源里,844,580,199,82,281,17,298
公投第９案,高雄市,鹽埕區,藍橋里,845,1304,541,204,745,62,807
公投第９案,高雄市,鹽埕區,慈愛里,846,357,132,61,193,23,216
公投第９案,高雄市,鹽埕區,博愛里,847,651,242,106,348,29,377
公投第９案,高雄市,鹽埕區,壽星里,848,1322,464,151,615,30,645
公投第９案,高雄市,鹽埕區,中山里,849,1056,516,38,554,27,581
公投第９案,高雄市,鹽埕區,教仁里,850,904,359,143,502,21,523
公投第９案,高雄市,鹽埕區,教仁里,851,1130,404,170,574,36,610
公投第９案,高雄市,鹽埕區,新樂里,852,840,378,106,484,19,503
公投第９案,高雄市,鹽埕區,中原里,853,616,290,113,403,32,435
公投第９案,高雄市,鹽埕區,光明里,854,1397,482,195,677,40,717
公投第９案,高雄市,鹽埕區,育仁里,855,766,293,116,409,16,425
公投第９案,高雄市,鹽埕區,河濱里,856,839,355,115,470,42,512
公投第９案,高雄市,鹽埕區,河濱里,857,805,353,102,455,19,474
公投第９案,高雄市,鹽埕區,沙地里,858,750,276,96,372,21,393
公投第９案,高雄市,鹽埕區,南端里,859,986,358,136,494,36,530
公投第９案,高雄市,鹽埕區,港都里,860,1068,359,134,493,11,504
公投第９案,高雄市,鹽埕區,江西里,861,1060,410,172,582,52,634
公投第９案,高雄市,鹽埕區,新豐里,862,805,308,97,405,36,441
公投第９案,高雄市,鹽埕區,府北里,863,1073,383,111,494,21,515
公投第９案,高雄市,鹽埕區,府北里,864,921,294,137,431,35,466
公投第９案,高雄市,鹽埕區,陸橋里,865,1171,448,158,606,22,628
公投第９案,高雄市,鹽埕區,瀨南里,866,594,217,102,319,20,339
公投第９案,高雄市,鹽埕區,新化里,867,592,241,88,329,16,345
公投第９案,高雄市,鹽埕區,江南里,868,610,206,92,298,10,308
公投第９案,高雄市,旗津區,旗下里,869,1177,437,187,624,122,746
公投第９案,高雄市,旗津區,永安里,870,1109,367,133,500,58,558
公投第９案,高雄市,旗津區,振興里,871,1642,485,191,676,31,707
公投第９案,高雄市,旗津區,慈愛里,872,1209,429,119,548,111,659
公投第９案,高雄市,旗津區,慈愛里,873,1112,362,103,465,57,522
公投第９案,高雄市,旗津區,復興里,874,1483,553,200,753,94,847
公投第９案,高雄市,旗津區,復興里,875,1460,465,125,590,34,624
公投第９案,高雄市,旗津區,中華里,876,1572,588,237,825,172,997
公投第９案,高雄市,旗津區,實踐里,877,1384,490,96,586,32,618
公投第９案,高雄市,旗津區,北汕里,878,1390,436,155,591,44,635
公投第９案,高雄市,旗津區,北汕里,879,1239,398,133,531,67,598
公投第９案,高雄市,旗津區,南汕里,880,2045,617,284,901,139,1040
公投第９案,高雄市,旗津區,上竹里,881,893,292,107,399,23,422
公投第９案,高雄市,旗津區,上竹里,882,1866,594,238,832,136,968
公投第９案,高雄市,旗津區,中洲里,883,1874,516,170,686,45,731
公投第９案,高雄市,旗津區,安順里,884,893,277,113,390,68,458
公投第９案,高雄市,旗津區,中興里,885,1215,402,186,588,44,632
公投第９案,高雄市,旗津區,中興里,886,1297,424,133,557,47,604
公投第９案,高雄市,三民區,鼎金里,887,1893,720,265,985,92,1077
公投第９案,高雄市,三民區,鼎金里,888,1982,796,158,954,107,1061
公投第９案,高雄市,三民區,鼎盛里,889,1661,695,195,890,81,971
公投第９案,高雄市,三民區,鼎盛里,890,1894,768,222,990,24,1014
公投第９案,高雄市,三民區,鼎盛里,891,1839,763,221,984,60,1044
公投第９案,高雄市,三民區,鼎盛里,892,2014,841,231,1072,79,1151
公投第９案,高雄市,三民區,鼎強里,893,1897,791,200,991,128,1119
公投第９案,高雄市,三民區,鼎強里,894,2016,729,245,974,61,1035
公投第９案,高雄市,三民區,鼎力里,895,1924,734,241,975,61,1036
公投第９案,高雄市,三民區,鼎力里,896,1749,747,200,947,85,1032
公投第９案,高雄市,三民區,鼎西里,897,1845,1014,79,1093,68,1161
公投第９案,高雄市,三民區,鼎西里,898,1724,663,196,859,40,899
公投第９案,高雄市,三民區,鼎西里,899,1889,835,199,1034,43,1077
公投第９案,高雄市,三民區,鼎西里,900,1622,638,227,865,84,949
公投第９案,高雄市,三民區,鼎中里,901,1870,729,268,997,44,1041
公投第９案,高雄市,三民區,鼎中里,902,1523,656,240,896,60,956
公投第９案,高雄市,三民區,鼎泰里,903,2006,714,243,957,64,1021
公投第９案,高雄市,三民區,鼎泰里,904,2076,959,273,1232,71,1303
公投第９案,高雄市,三民區,鼎泰里,905,2073,877,253,1130,38,1168
公投第９案,高雄市,三民區,鼎泰里,906,2045,908,213,1121,79,1200
公投第９案,高雄市,三民區,鼎泰里,907,2070,750,211,961,74,1035
公投第９案,高雄市,三民區,鼎泰里,908,2035,778,272,1050,72,1122
公投第９案,高雄市,三民區,鼎泰里,909,2075,933,283,1216,56,1272
公投第９案,高雄市,三民區,鼎泰里,910,2053,961,197,1158,43,1201
公投第９案,高雄市,三民區,鼎泰里,911,2063,970,219,1189,67,1256
公投第９案,高雄市,三民區,鼎泰里,912,2143,1018,272,1290,52,1342
公投第９案,高雄市,三民區,本館里,913,1746,741,256,997,87,1084
公投第９案,高雄市,三民區,本館里,914,1735,638,195,833,34,867
公投第９案,高雄市,三民區,本館里,915,1655,696,149,845,69,914
公投第９案,高雄市,三民區,本館里,916,1583,690,184,874,70,944
公投第９案,高雄市,三民區,本館里,917,1800,762,204,966,55,1021
公投第９案,高雄市,三民區,本和里,918,1730,779,193,972,43,1015
公投第９案,高雄市,三民區,本和里,919,1715,730,200,930,28,958
公投第９案,高雄市,三民區,本和里,920,1691,716,233,949,60,1009
公投第９案,高雄市,三民區,本和里,921,1865,819,228,1047,57,1104
公投第９案,高雄市,三民區,本文里,922,1073,510,146,656,38,694
公投第９案,高雄市,三民區,本文里,923,917,438,132,570,64,634
公投第９案,高雄市,三民區,本武里,924,1647,668,239,907,71,978
公投第９案,高雄市,三民區,本元里,925,1654,693,232,925,78,1003
公投第９案,高雄市,三民區,本元里,926,1639,727,211,938,49,987
公投第９案,高雄市,三民區,本元里,927,1833,810,230,1040,69,1109
公投第９案,高雄市,三民區,本安里,928,1362,654,186,840,39,879
公投第９案,高雄市,三民區,本安里,929,1557,720,202,922,66,988
公投第９案,高雄市,三民區,本安里,930,1482,704,168,872,27,899
公投第９案,高雄市,三民區,本上里,931,1563,702,224,926,41,967
公投第９案,高雄市,三民區,本上里,932,1497,650,211,861,34,895
公投第９案,高雄市,三民區,本上里,933,1523,719,204,923,36,959
公投第９案,高雄市,三民區,本揚里,934,1293,628,180,808,55,863
公投第９案,高雄市,三民區,本揚里,935,1662,789,202,991,51,1042
公投第９案,高雄市,三民區,本揚里,936,1441,628,170,798,66,864
公投第９案,高雄市,三民區,本揚里,937,1326,650,191,841,51,892
公投第９案,高雄市,三民區,本揚里,938,1476,699,214,913,34,947
公投第９案,高雄市,三民區,寶獅里,939,1968,762,212,974,26,1000
公投第９案,高雄市,三民區,寶獅里,940,1618,593,209,802,27,829
公投第９案,高雄市,三民區,寶德里,941,1873,794,230,1024,58,1082
公投第９案,高雄市,三民區,寶德里,942,1487,605,212,817,75,892
公投第９案,高雄市,三民區,寶德里,943,1640,645,225,870,21,891
公投第９案,高雄市,三民區,寶泰里,944,1889,719,245,964,32,996
公投第９案,高雄市,三民區,寶泰里,945,1969,802,210,1012,39,1051
公投第９案,高雄市,三民區,寶興里,946,1466,481,220,701,192,893
公投第９案,高雄市,三民區,寶興里,947,1697,740,224,964,63,1027
公投第９案,高雄市,三民區,寶興里,948,1663,723,214,937,68,1005
公投第９案,高雄市,三民區,寶興里,949,1649,680,226,906,53,959
公投第９案,高雄市,三民區,寶中里,950,1486,613,170,783,47,830
公投第９案,高雄市,三民區,寶中里,951,1495,597,169,766,33,799
公投第９案,高雄市,三民區,寶華里,952,1548,745,183,928,35,963
公投第９案,高雄市,三民區,寶華里,953,1493,606,198,804,22,826
公投第９案,高雄市,三民區,寶國里,954,1445,674,183,857,33,890
公投第９案,高雄市,三民區,寶國里,955,1529,656,157,813,45,858
公投第９案,高雄市,三民區,寶國里,956,1506,623,176,799,32,831
公投第９案,高雄市,三民區,寶國里,957,1549,724,180,904,65,969
公投第９案,高雄市,三民區,寶國里,958,1620,755,214,969,63,1032
公投第９案,高雄市,三民區,寶民里,959,1550,710,211,921,61,982
公投第９案,高雄市,三民區,寶民里,960,1488,682,208,890,49,939
公投第９案,高雄市,三民區,寶慶里,961,1335,583,172,755,59,814
公投第９案,高雄市,三民區,寶慶里,962,1332,574,181,755,62,817
公投第９案,高雄市,三民區,寶業里,963,1764,757,240,997,86,1083
公投第９案,高雄市,三民區,寶業里,964,1811,759,228,987,52,1039
公投第９案,高雄市,三民區,寶業里,965,1693,746,253,999,75,1074
公投第９案,高雄市,三民區,寶盛里,966,1684,762,246,1008,81,1089
公投第９案,高雄市,三民區,寶盛里,967,1464,619,157,776,66,842
公投第９案,高雄市,三民區,寶盛里,968,1719,825,247,1072,35,1107
公投第９案,高雄市,三民區,寶安里,969,1749,753,216,969,33,1002
公投第９案,高雄市,三民區,寶安里,970,1908,782,218,1000,38,1038
公投第９案,高雄市,三民區,寶安里,971,1573,715,194,909,68,977
公投第９案,高雄市,三民區,寶安里,972,1628,661,217,878,49,927
公投第９案,高雄市,三民區,寶龍里,973,1377,491,156,647,60,707
公投第９案,高雄市,三民區,寶龍里,974,1530,724,191,915,53,968
公投第９案,高雄市,三民區,寶龍里,975,1188,475,135,610,64,674
公投第９案,高雄市,三民區,寶珠里,976,2791,599,185,784,40,824
公投第９案,高雄市,三民區,寶珠里,977,1840,779,223,1002,82,1084
公投第９案,高雄市,三民區,寶珠里,978,1671,713,232,945,95,1040
公投第９案,高雄市,三民區,寶玉里,979,1624,705,206,911,69,980
公投第９案,高雄市,三民區,寶玉里,980,1555,763,234,997,60,1057
公投第９案,高雄市,三民區,寶玉里,981,1489,717,212,929,54,983
公投第９案,高雄市,三民區,寶玉里,982,1662,737,229,966,70,1036
公投第９案,高雄市,三民區,寶玉里,983,1639,699,193,892,20,912
公投第９案,高雄市,三民區,灣子里,984,1872,780,215,995,93,1088
公投第９案,高雄市,三民區,灣子里,985,1968,799,259,1058,70,1128
公投第９案,高雄市,三民區,灣愛里,986,1471,514,152,666,120,786
公投第９案,高雄市,三民區,灣愛里,987,1534,621,192,813,77,890
公投第９案,高雄市,三民區,灣中里,988,1659,630,185,815,88,903
公投第９案,高雄市,三民區,灣中里,989,1815,665,186,851,46,897
公投第９案,高雄市,三民區,灣中里,990,1808,715,212,927,52,979
公投第９案,高雄市,三民區,灣華里,991,1224,453,149,602,39,641
公投第９案,高雄市,三民區,灣華里,992,1406,578,158,736,34,770
公投第９案,高雄市,三民區,灣勝里,993,945,382,120,502,29,531
公投第９案,高雄市,三民區,灣勝里,994,944,400,149,549,51,600
公投第９案,高雄市,三民區,灣利里,995,1669,671,219,890,79,969
公投第９案,高雄市,三民區,灣利里,996,1473,616,196,812,104,916
公投第９案,高雄市,三民區,灣復里,997,1876,682,211,893,64,957
公投第９案,高雄市,三民區,灣復里,998,1682,440,160,600,60,660
公投第９案,高雄市,三民區,正興里,999,1791,662,254,916,52,968
公投第９案,高雄市,三民區,正興里,1000,1808,779,257,1036,57,1093
公投第９案,高雄市,三民區,正興里,1001,1798,689,242,931,56,987
公投第９案,高雄市,三民區,正興里,1002,2030,856,277,1133,66,1199
公投第９案,高雄市,三民區,正興里,1003,2034,890,225,1115,29,1144
公投第９案,高雄市,三民區,正興里,1004,1998,875,227,1102,39,1141
公投第９案,高雄市,三民區,正順里,1005,1914,715,227,942,41,983
公投第９案,高雄市,三民區,正順里,1006,1965,790,227,1017,41,1058
公投第９案,高雄市,三民區,灣興里,1007,1885,722,276,998,97,1095
公投第９案,高雄市,三民區,灣成里,1008,1220,540,164,704,14,718
公投第９案,高雄市,三民區,灣成里,1009,1057,411,139,550,84,634
公投第９案,高雄市,三民區,安康里,1010,1434,457,159,616,29,645
公投第９案,高雄市,三民區,安康里,1011,1350,466,131,597,46,643
公投第９案,高雄市,三民區,安寧里,1012,872,282,88,370,32,402
公投第９案,高雄市,三民區,安寧里,1013,954,333,129,462,30,492
公投第９案,高雄市,三民區,安吉里,1014,1689,775,196,971,27,998
公投第９案,高雄市,三民區,安吉里,1015,1390,548,198,746,22,768
公投第９案,高雄市,三民區,安吉里,1016,1336,561,183,744,83,827
公投第９案,高雄市,三民區,安發里,1017,1437,657,246,903,51,954
公投第９案,高雄市,三民區,安發里,1018,1452,623,193,816,28,844
公投第９案,高雄市,三民區,安發里,1019,1513,640,209,849,82,931
公投第９案,高雄市,三民區,安東里,1020,1467,641,226,867,89,956
公投第９案,高雄市,三民區,安東里,1021,1381,599,250,849,85,934
公投第９案,高雄市,三民區,安和里,1022,1117,434,172,606,50,656
公投第９案,高雄市,三民區,安和里,1023,1327,578,203,781,37,818
公投第９案,高雄市,三民區,達德里,1024,1304,542,187,729,48,777
公投第９案,高雄市,三民區,達明里,1025,1483,519,208,727,38,765
公投第９案,高雄市,三民區,達仁里,1026,1473,638,214,852,52,904
公投第９案,高雄市,三民區,達勇里,1027,980,419,146,565,32,597
公投第９案,高雄市,三民區,同德里,1028,1409,610,190,800,71,871
公投第９案,高雄市,三民區,同德里,1029,1230,494,204,698,53,751
公投第９案,高雄市,三民區,德智里,1030,1024,458,162,620,63,683
公投第９案,高雄市,三民區,德智里,1031,1130,482,171,653,60,713
公投第９案,高雄市,三民區,德仁里,1032,1889,700,231,931,34,965
公投第９案,高雄市,三民區,安生里,1033,1427,595,191,786,33,819
公投第９案,高雄市,三民區,德東里,1034,791,352,96,448,23,471
公投第９案,高雄市,三民區,德行里,1035,1079,503,168,671,87,758
公投第９案,高雄市,三民區,精華里,1036,1492,594,212,806,87,893
公投第９案,高雄市,三民區,民享里,1037,1020,436,172,608,51,659
公投第９案,高雄市,三民區,民享里,1038,1001,395,163,558,16,574
公投第９案,高雄市,三民區,安宜里,1039,1581,684,174,858,55,913
公投第９案,高雄市,三民區,安宜里,1040,1471,572,209,781,50,831
公投第９案,高雄市,三民區,安泰里,1041,1151,400,229,629,29,658
公投第９案,高雄市,三民區,安泰里,1042,1334,566,201,767,73,840
公投第９案,高雄市,三民區,安泰里,1043,1275,551,170,721,52,773
公投第９案,高雄市,三民區,安邦里,1044,1688,513,206,719,45,764
公投第９案,高雄市,三民區,安邦里,1045,1214,473,184,657,39,696
公投第９案,高雄市,三民區,安邦里,1046,1149,529,165,694,32,726
公投第９案,高雄市,三民區,十全里,1047,1667,675,233,908,96,1004
公投第９案,高雄市,三民區,十美里,1048,1786,641,232,873,40,913
公投第９案,高雄市,三民區,德北里,1049,896,383,138,521,18,539
公投第９案,高雄市,三民區,德北里,1050,925,410,106,516,64,580
公投第９案,高雄市,三民區,立誠里,1051,684,303,109,412,52,464
公投第９案,高雄市,三民區,立業里,1052,981,426,161,587,69,656
公投第９案,高雄市,三民區,港東里,1053,1383,487,180,667,88,755
公投第９案,高雄市,三民區,港新里,1054,1382,556,196,752,49,801
公投第９案,高雄市,三民區,港西里,1055,808,321,104,425,27,452
公投第９案,高雄市,三民區,博愛里,1056,1197,542,190,732,23,755
公投第９案,高雄市,三民區,博惠里,1057,1344,520,177,697,57,754
公投第９案,高雄市,三民區,博惠里,1058,1344,550,209,759,55,814
公投第９案,高雄市,三民區,博惠里,1059,1359,586,185,771,20,791
公投第９案,高雄市,三民區,長明里,1060,1073,467,161,628,53,681
公投第９案,高雄市,三民區,建東里,1061,1186,449,165,614,55,669
公投第９案,高雄市,三民區,興德里,1062,1749,705,220,925,87,1012
公投第９案,高雄市,三民區,鳳南里,1063,877,336,86,422,24,446
公投第９案,高雄市,三民區,鳳北里,1064,1402,599,201,800,112,912
公投第９案,高雄市,三民區,德西里,1065,769,350,117,467,20,487
公投第９案,高雄市,三民區,豐裕里,1066,1207,518,170,688,60,748
公投第９案,高雄市,三民區,豐裕里,1067,1270,438,163,601,50,651
公投第９案,高雄市,三民區,川東里,1068,1248,392,275,667,52,719
公投第９案,高雄市,三民區,裕民里,1069,1263,534,162,696,88,784
公投第９案,高雄市,三民區,力行里,1070,1101,449,154,603,42,645
公投第９案,高雄市,三民區,千歲里,1071,1116,475,159,634,21,655
公投第９案,高雄市,三民區,立德里,1072,1152,479,149,628,42,670
公投第９案,高雄市,三民區,千北里,1073,1057,442,144,586,75,661
公投第９案,高雄市,三民區,千秋里,1074,971,342,125,467,56,523
公投第９案,高雄市,三民區,千秋里,1075,1062,408,156,564,18,582
公投第９案,高雄市,前金區,三川里,1076,673,251,86,337,19,356
公投第９案,高雄市,前金區,草江里,1077,1022,460,125,585,33,618
公投第９案,高雄市,前金區,長城里,1078,1324,521,151,672,38,710
公投第９案,高雄市,前金區,北金里,1079,839,335,117,452,55,507
公投第９案,高雄市,前金區,東金里,1080,975,359,148,507,77,584
公投第９案,高雄市,前金區,新生里,1081,1806,770,223,993,70,1063
公投第９案,高雄市,前金區,新生里,1082,1781,731,250,981,41,1022
公投第９案,高雄市,前金區,後金里,1083,717,291,119,410,41,451
公投第９案,高雄市,前金區,長興里,1084,1097,451,152,603,14,617
公投第９案,高雄市,前金區,青山里,1085,1633,639,248,887,32,919
公投第９案,高雄市,前金區,民生里,1086,759,361,116,477,36,513
公投第９案,高雄市,前金區,復元里,1087,948,395,173,568,54,622
公投第９案,高雄市,前金區,林投里,1088,1009,339,155,494,67,561
公投第９案,高雄市,前金區,國民里,1089,945,388,143,531,37,568
公投第９案,高雄市,前金區,社東里,1090,772,340,106,446,26,472
公投第９案,高雄市,前金區,社東里,1091,757,327,131,458,31,489
公投第９案,高雄市,前金區,社西里,1092,1047,455,152,607,40,647
公投第９案,高雄市,前金區,博孝里,1093,985,424,161,585,41,626
公投第９案,高雄市,前金區,長生里,1094,1674,649,221,870,30,900
公投第９案,高雄市,前金區,榮復里,1095,1088,443,143,586,31,617
公投第９案,高雄市,前金區,文西里,1096,893,412,136,548,52,600
公投第９案,高雄市,前金區,文東里,1097,1184,458,161,619,39,658
公投第９案,高雄市,新興區,浩然里,1098,828,333,125,458,32,490
公投第９案,高雄市,新興區,浩然里,1099,963,419,160,579,57,636
公投第９案,高雄市,新興區,振成里,1100,1075,422,132,554,27,581
公投第９案,高雄市,新興區,德生里,1101,1488,632,200,832,30,862
公投第９案,高雄市,新興區,德生里,1102,1438,631,181,812,30,842
公投第９案,高雄市,新興區,振華里,1103,1049,461,149,610,27,637
公投第９案,高雄市,新興區,正氣里,1104,1378,579,258,837,85,922
公投第９案,高雄市,新興區,德政里,1105,666,314,86,400,36,436
公投第９案,高雄市,新興區,仁聲里,1106,981,375,173,548,28,576
公投第９案,高雄市,新興區,德望里,1107,933,417,150,567,38,605
公投第９案,高雄市,新興區,德望里,1108,987,425,116,541,28,569
公投第９案,高雄市,新興區,華聲里,1109,988,459,117,576,46,622
公投第９案,高雄市,新興區,蕉園里,1110,735,332,118,450,33,483
公投第９案,高雄市,新興區,永寧里,1111,1317,548,202,750,34,784
公投第９案,高雄市,新興區,玉衡里,1112,800,288,111,399,10,409
公投第９案,高雄市,新興區,順昌里,1113,968,417,145,562,37,599
公投第９案,高雄市,新興區,順昌里,1114,913,405,123,528,29,557
公投第９案,高雄市,新興區,文昌里,1115,1389,583,231,814,26,840
公投第９案,高雄市,新興區,文昌里,1116,1228,565,208,773,53,826
公投第９案,高雄市,新興區,光耀里,1117,1211,532,157,689,75,764
公投第９案,高雄市,新興區,光耀里,1118,1101,505,125,630,21,651
公投第９案,高雄市,新興區,興昌里,1119,752,361,96,457,12,469
公投第９案,高雄市,新興區,興昌里,1120,873,421,154,575,41,616
公投第９案,高雄市,新興區,開平里,1121,1609,686,253,939,38,977
公投第９案,高雄市,新興區,開平里,1122,1736,746,278,1024,64,1088
公投第９案,高雄市,新興區,成功里,1123,1258,528,154,682,27,709
公投第９案,高雄市,新興區,新江里,1124,1105,455,174,629,59,688
公投第９案,高雄市,新興區,黎明里,1125,851,317,169,486,47,533
公投第９案,高雄市,新興區,愛平里,1126,1011,432,162,594,42,636
公投第９案,高雄市,新興區,南港里,1127,888,380,166,546,68,614
公投第９案,高雄市,新興區,南港里,1128,1005,420,122,542,29,571
公投第９案,高雄市,新興區,中東里,1129,1375,442,143,585,14,599
公投第９案,高雄市,新興區,中東里,1130,1388,534,254,788,65,853
公投第９案,高雄市,新興區,明莊里,1131,719,274,105,379,50,429
公投第９案,高雄市,新興區,大明里,1132,1077,404,169,573,76,649
公投第９案,高雄市,新興區,秋山里,1133,875,311,98,409,19,428
公投第９案,高雄市,新興區,長驛里,1134,936,369,108,477,27,504
公投第９案,高雄市,新興區,建興里,1135,944,368,124,492,62,554
公投第９案,高雄市,新興區,建華里,1136,833,294,109,403,36,439
公投第９案,高雄市,新興區,漢民里,1137,708,285,107,392,13,405
公投第９案,高雄市,新興區,榮治里,1138,741,315,92,407,16,423
公投第９案,高雄市,新興區,東坡里,1139,1235,420,184,604,29,633
公投第９案,高雄市,苓雅區,博仁里,1140,718,322,101,423,24,447
公投第９案,高雄市,苓雅區,苓洲里,1141,1492,659,150,809,44,853
公投第９案,高雄市,苓雅區,苓昇里,1142,1210,513,162,675,54,729
公投第９案,高雄市,苓雅區,苓中里,1143,1617,606,159,765,33,798
公投第９案,高雄市,苓雅區,苓雅里,1144,1428,613,174,787,93,880
公投第９案,高雄市,苓雅區,苓東里,1145,1444,503,181,684,55,739
公投第９案,高雄市,苓雅區,城北里,1146,1452,580,202,782,80,862
公投第９案,高雄市,苓雅區,城西里,1147,554,228,89,317,38,355
公投第９案,高雄市,苓雅區,城東里,1148,950,361,143,504,19,523
公投第９案,高雄市,苓雅區,城東里,1149,978,363,139,502,15,517
公投第９案,高雄市,苓雅區,意誠里,1150,1673,624,185,809,35,844
公投第９案,高雄市,苓雅區,意誠里,1151,2045,738,252,990,72,1062
公投第９案,高雄市,苓雅區,鼓中里,1152,939,391,120,511,79,590
公投第９案,高雄市,苓雅區,田西里,1153,1284,499,155,654,38,692
公投第９案,高雄市,苓雅區,人和里,1154,908,397,118,515,31,546
公投第９案,高雄市,苓雅區,人和里,1155,838,336,107,443,19,462
公投第９案,高雄市,苓雅區,仁政里,1156,1267,525,185,710,44,754
公投第９案,高雄市,苓雅區,廣澤里,1157,994,420,164,584,64,648
公投第９案,高雄市,苓雅區,廣澤里,1158,774,264,117,381,27,408
公投第９案,高雄市,苓雅區,美田里,1159,1121,480,150,630,28,658
公投第９案,高雄市,苓雅區,華堂里,1160,1474,586,215,801,63,864
公投第９案,高雄市,苓雅區,華堂里,1161,1525,654,212,866,71,937
公投第９案,高雄市,苓雅區,日中里,1162,1147,470,143,613,36,649
公投第９案,高雄市,苓雅區,日中里,1163,1014,444,164,608,42,650
公投第９案,高雄市,苓雅區,普照里,1164,1496,602,246,848,60,908
公投第９案,高雄市,苓雅區,普照里,1165,1499,651,228,879,62,941
公投第９案,高雄市,苓雅區,和煦里,1166,1138,521,143,664,30,694
公投第９案,高雄市,苓雅區,和煦里,1167,839,392,139,531,47,578
公投第９案,高雄市,苓雅區,晴朗里,1168,2088,506,155,661,52,713
公投第９案,高雄市,苓雅區,普天里,1169,1648,710,216,926,43,969
公投第９案,高雄市,苓雅區,普天里,1170,1623,683,195,878,73,951
公投第９案,高雄市,苓雅區,林富里,1171,1932,894,278,1172,62,1234
公投第９案,高雄市,苓雅區,林圍里,1172,1127,576,162,738,28,766
公投第９案,高雄市,苓雅區,林圍里,1173,1156,576,158,734,26,760
公投第９案,高雄市,苓雅區,林安里,1174,1465,648,218,866,39,905
公投第９案,高雄市,苓雅區,光華里,1175,690,255,83,338,25,363
公投第９案,高雄市,苓雅區,林興里,1176,1283,478,165,643,96,739
公投第９案,高雄市,苓雅區,林華里,1177,1432,582,201,783,78,861
公投第９案,高雄市,苓雅區,林華里,1178,1313,513,225,738,36,774
公投第９案,高雄市,苓雅區,林西里,1179,1579,598,213,811,34,845
公投第９案,高雄市,苓雅區,林中里,1180,1385,572,202,774,69,843
公投第９案,高雄市,苓雅區,林中里,1181,1449,660,179,839,62,901
公投第９案,高雄市,苓雅區,林泉里,1182,1834,836,258,1094,53,1147
公投第９案,高雄市,苓雅區,林南里,1183,1436,612,215,827,65,892
公投第９案,高雄市,苓雅區,林南里,1184,1431,649,216,865,51,916
公投第９案,高雄市,苓雅區,中正里,1185,1248,582,187,769,22,791
公投第９案,高雄市,苓雅區,中正里,1186,1470,684,207,891,42,933
公投第９案,高雄市,苓雅區,尚義里,1187,1540,748,192,940,79,1019
公投第９案,高雄市,苓雅區,同慶里,1188,1374,645,185,830,28,858
公投第９案,高雄市,苓雅區,同慶里,1189,839,397,125,522,31,553
公投第９案,高雄市,苓雅區,凱旋里,1190,1022,511,143,654,37,691
公投第９案,高雄市,苓雅區,凱旋里,1191,1062,506,138,644,25,669
公投第９案,高雄市,苓雅區,安祥里,1192,1078,474,154,628,22,650
公投第９案,高雄市,苓雅區,安祥里,1193,1117,497,179,676,33,709
公投第９案,高雄市,苓雅區,奏捷里,1194,1516,687,189,876,60,936
公投第９案,高雄市,苓雅區,福壽里,1195,1440,542,237,779,122,901
公投第９案,高雄市,苓雅區,福南里,1196,839,353,118,471,40,511
公投第９案,高雄市,苓雅區,福南里,1197,888,368,90,458,32,490
公投第９案,高雄市,苓雅區,五權里,1198,1101,491,160,651,42,693
公投第９案,高雄市,苓雅區,五權里,1199,1004,489,160,649,63,712
公投第９案,高雄市,苓雅區,民主里,1200,1427,605,196,801,68,869
公投第９案,高雄市,苓雅區,民主里,1201,1168,508,149,657,32,689
公投第９案,高雄市,苓雅區,民主里,1202,1184,539,197,736,61,797
公投第９案,高雄市,苓雅區,林德里,1203,974,440,144,584,35,619
公投第９案,高雄市,苓雅區,林德里,1204,849,325,101,426,14,440
公投第９案,高雄市,苓雅區,林貴里,1205,1821,833,211,1044,48,1092
公投第９案,高雄市,苓雅區,林榮里,1206,1306,576,202,778,57,835
公投第９案,高雄市,苓雅區,林榮里,1207,1185,523,74,597,29,626
公投第９案,高雄市,苓雅區,林榮里,1208,1415,582,202,784,59,843
公投第９案,高雄市,苓雅區,英明里,1209,962,450,136,586,46,632
公投第９案,高雄市,苓雅區,英明里,1210,964,400,134,534,58,592
公投第９案,高雄市,苓雅區,林靖里,1211,1524,673,186,859,47,906
公投第９案,高雄市,苓雅區,朝陽里,1212,1455,631,196,827,39,866
公投第９案,高雄市,苓雅區,福隆里,1213,1272,463,163,626,42,668
公投第９案,高雄市,苓雅區,福隆里,1214,1256,484,161,645,35,680
公投第９案,高雄市,苓雅區,福祥里,1215,1203,504,138,642,34,676
公投第９案,高雄市,苓雅區,福海里,1216,1062,487,125,612,32,644
公投第９案,高雄市,苓雅區,福康里,1217,850,379,123,502,66,568
公投第９案,高雄市,苓雅區,福康里,1218,1010,442,148,590,92,682
公投第９案,高雄市,苓雅區,福人里,1219,1118,461,142,603,30,633
公投第９案,高雄市,苓雅區,福人里,1220,937,411,135,546,57,603
公投第９案,高雄市,苓雅區,福地里,1221,1493,542,162,704,36,740
公投第９案,高雄市,苓雅區,福地里,1222,1183,534,148,682,37,719
公投第９案,高雄市,苓雅區,福居里,1223,1318,489,129,618,45,663
公投第９案,高雄市,苓雅區,福居里,1224,1362,557,184,741,54,795
公投第９案,高雄市,苓雅區,福東里,1225,1102,418,177,595,76,671
公投第９案,高雄市,苓雅區,福東里,1226,1481,733,78,811,63,874
公投第９案,高雄市,苓雅區,福西里,1227,878,394,119,513,66,579
公投第９案,高雄市,苓雅區,福西里,1228,908,318,109,427,42,469
公投第９案,高雄市,苓雅區,永康里,1229,1056,507,132,639,53,692
公投第９案,高雄市,苓雅區,永康里,1230,1091,420,130,550,42,592
公投第９案,高雄市,苓雅區,正文里,1231,976,419,163,582,32,614
公投第９案,高雄市,苓雅區,正文里,1232,1063,470,183,653,50,703
公投第９案,高雄市,苓雅區,正言里,1233,1484,672,192,864,73,937
公投第９案,高雄市,苓雅區,正言里,1234,1290,515,227,742,37,779
公投第９案,高雄市,苓雅區,正大里,1235,1740,778,216,994,70,1064
公投第９案,高雄市,苓雅區,正大里,1236,1594,670,215,885,59,944
公投第９案,高雄市,苓雅區,正大里,1237,1648,686,206,892,31,923
公投第９案,高雄市,苓雅區,五福里,1238,1236,576,164,740,61,801
公投第９案,高雄市,苓雅區,五福里,1239,1211,511,178,689,54,743
公投第９案,高雄市,苓雅區,五福里,1240,1283,551,157,708,30,738
公投第９案,高雄市,苓雅區,正心里,1241,1804,795,247,1042,89,1131
公投第９案,高雄市,苓雅區,正心里,1242,1718,737,248,985,79,1064
公投第９案,高雄市,苓雅區,正道里,1243,1297,577,171,748,65,813
公投第９案,高雄市,苓雅區,正道里,1244,1449,596,208,804,87,891
公投第９案,高雄市,苓雅區,正道里,1245,1307,575,165,740,55,795
公投第９案,高雄市,苓雅區,正義里,1246,1184,528,166,694,58,752
公投第９案,高雄市,苓雅區,正義里,1247,1250,569,195,764,76,840
公投第９案,高雄市,苓雅區,正仁里,1248,1248,526,149,675,36,711
公投第９案,高雄市,苓雅區,正仁里,1249,1283,576,149,725,33,758
公投第９案,高雄市,苓雅區,文昌里,1250,1121,507,123,630,34,664
公投第９案,高雄市,苓雅區,文昌里,1251,1258,541,162,703,33,736
公投第９案,高雄市,苓雅區,文昌里,1252,1339,561,170,731,39,770
公投第９案,高雄市,苓雅區,建軍里,1253,1986,758,271,1029,80,1109
公投第９案,高雄市,苓雅區,衛武里,1254,1028,447,118,565,34,599
公投第９案,高雄市,苓雅區,衛武里,1255,948,422,125,547,22,569
公投第９案,高雄市,鳳山區,鳳崗里,1256,1080,507,144,651,59,710
公投第９案,高雄市,鳳山區,縣衙里,1257,819,369,111,480,34,514
公投第９案,高雄市,鳳山區,曹公里,1258,851,357,105,462,69,531
公投第９案,高雄市,鳳山區,曹公里,1259,1075,492,141,633,40,673
公投第９案,高雄市,鳳山區,鎮西里,1260,1223,562,151,713,40,753
公投第９案,高雄市,鳳山區,鎮西里,1261,1207,545,161,706,38,744
公投第９案,高雄市,鳳山區,鎮西里,1262,1339,519,172,691,42,733
公投第９案,高雄市,鳳山區,鎮西里,1263,1188,463,111,574,39,613
公投第９案,高雄市,鳳山區,北門里,1264,1055,448,128,576,62,638
公投第９案,高雄市,鳳山區,北門里,1265,1109,455,111,566,69,635
公投第９案,高雄市,鳳山區,北門里,1266,756,366,109,475,44,519
公投第９案,高雄市,鳳山區,北門里,1267,1182,486,121,607,38,645
公投第９案,高雄市,鳳山區,鎮北里,1268,1496,623,185,808,79,887
公投第９案,高雄市,鳳山區,鎮北里,1269,2094,784,203,987,59,1046
公投第９案,高雄市,鳳山區,鎮北里,1270,1672,693,174,867,29,896
公投第９案,高雄市,鳳山區,鎮北里,1271,1761,755,174,929,22,951
公投第９案,高雄市,鳳山區,鎮北里,1272,1450,605,181,786,74,860
公投第９案,高雄市,鳳山區,武松里,1273,1455,558,159,717,33,750
公投第９案,高雄市,鳳山區,武松里,1274,1234,551,125,676,57,733
公投第９案,高雄市,鳳山區,忠誠里,1275,1713,776,116,892,80,972
公投第９案,高雄市,鳳山區,忠誠里,1276,1698,677,164,841,37,878
公投第９案,高雄市,鳳山區,文英里,1277,1247,561,147,708,64,772
公投第９案,高雄市,鳳山區,文英里,1278,1087,466,145,611,47,658
公投第９案,高雄市,鳳山區,文英里,1279,1199,527,162,689,27,716
公投第９案,高雄市,鳳山區,文華里,1280,1559,731,116,847,52,899
公投第９案,高雄市,鳳山區,文華里,1281,1233,537,145,682,43,725
公投第９案,高雄市,鳳山區,文華里,1282,1277,549,157,706,50,756
公投第９案,高雄市,鳳山區,文華里,1283,1481,645,136,781,20,801
公投第９案,高雄市,鳳山區,文華里,1284,1154,574,149,723,13,736
公投第９案,高雄市,鳳山區,文華里,1285,1475,674,203,877,20,897
公投第９案,高雄市,鳳山區,文山里,1286,1247,502,113,615,37,652
公投第９案,高雄市,鳳山區,文山里,1287,1538,604,166,770,72,842
公投第９案,高雄市,鳳山區,文山里,1288,1097,441,134,575,39,614
公投第９案,高雄市,鳳山區,文山里,1289,1221,500,94,594,29,623
公投第９案,高雄市,鳳山區,文山里,1290,1075,529,139,668,60,728
公投第９案,高雄市,鳳山區,文德里,1291,1751,811,203,1014,45,1059
公投第９案,高雄市,鳳山區,文德里,1292,1758,780,219,999,45,1044
公投第９案,高雄市,鳳山區,文德里,1293,1749,729,224,953,82,1035
公投第９案,高雄市,鳳山區,文德里,1294,1746,741,199,940,22,962
公投第９案,高雄市,鳳山區,文德里,1295,1712,740,178,918,46,964
公投第９案,高雄市,鳳山區,文衡里,1296,1247,552,159,711,33,744
公投第９案,高雄市,鳳山區,文衡里,1297,1409,604,199,803,54,857
公投第９案,高雄市,鳳山區,文衡里,1298,1347,561,193,754,60,814
公投第９案,高雄市,鳳山區,文福里,1299,1771,766,195,961,26,987
公投第９案,高雄市,鳳山區,文福里,1300,1537,665,182,847,17,864
公投第９案,高雄市,鳳山區,文福里,1301,1605,740,179,919,28,947
公投第９案,高雄市,鳳山區,文福里,1302,1375,626,153,779,46,825
公投第９案,高雄市,鳳山區,文福里,1303,1393,642,177,819,53,872
公投第９案,高雄市,鳳山區,文福里,1304,1584,675,150,825,33,858
公投第９案,高雄市,鳳山區,成功里,1305,618,254,82,336,25,361
公投第９案,高雄市,鳳山區,縣口里,1306,423,179,55,234,16,250
公投第９案,高雄市,鳳山區,光明里,1307,1312,517,179,696,63,759
公投第９案,高雄市,鳳山區,和德里,1308,769,323,102,425,31,456
公投第９案,高雄市,鳳山區,和德里,1309,1213,636,110,746,27,773
公投第９案,高雄市,鳳山區,和興里,1310,1107,539,133,672,49,721
公投第９案,高雄市,鳳山區,和興里,1311,1188,503,172,675,31,706
公投第９案,高雄市,鳳山區,和興里,1312,1183,539,156,695,40,735
公投第９案,高雄市,鳳山區,和興里,1313,1264,555,174,729,50,779
公投第９案,高雄市,鳳山區,南興里,1314,882,356,130,486,34,520
公投第９案,高雄市,鳳山區,三民里,1315,1007,500,142,642,60,702
公投第９案,高雄市,鳳山區,新興里,1316,853,360,114,474,61,535
公投第９案,高雄市,鳳山區,新興里,1317,1660,299,115,414,58,472
公投第９案,高雄市,鳳山區,興仁里,1318,1124,517,142,659,31,690
公投第９案,高雄市,鳳山區,興仁里,1319,1112,469,159,628,63,691
公投第９案,高雄市,鳳山區,興仁里,1320,1182,491,118,609,43,652
公投第９案,高雄市,鳳山區,興中里,1321,875,445,129,574,49,623
公投第９案,高雄市,鳳山區,協和里,1322,1040,423,157,580,58,638
公投第９案,高雄市,鳳山區,協和里,1323,1094,523,144,667,30,697
公投第９案,高雄市,鳳山區,協和里,1324,1217,568,145,713,62,775
公投第９案,高雄市,鳳山區,忠義里,1325,974,494,136,630,36,666
公投第９案,高雄市,鳳山區,忠義里,1326,987,446,110,556,42,598
公投第９案,高雄市,鳳山區,忠義里,1327,1210,589,169,758,18,776
公投第９案,高雄市,鳳山區,忠義里,1328,1391,587,190,777,57,834
公投第９案,高雄市,鳳山區,忠孝里,1329,1241,448,144,592,25,617
公投第９案,高雄市,鳳山區,忠孝里,1330,1000,494,102,596,48,644
公投第９案,高雄市,鳳山區,忠孝里,1331,1092,490,129,619,44,663
公投第９案,高雄市,鳳山區,忠孝里,1332,1308,603,156,759,46,805
公投第９案,高雄市,鳳山區,忠孝里,1333,1031,465,123,588,58,646
公投第９案,高雄市,鳳山區,中和里,1334,1159,521,152,673,64,737
公投第９案,高雄市,鳳山區,中和里,1335,1127,481,132,613,61,674
公投第９案,高雄市,鳳山區,中和里,1336,1109,565,183,748,48,796
公投第９案,高雄市,鳳山區,誠義里,1337,1879,930,202,1132,60,1192
公投第９案,高雄市,鳳山區,誠義里,1338,1803,944,214,1158,37,1195
公投第９案,高雄市,鳳山區,生明里,1339,2045,823,195,1018,85,1103
公投第９案,高雄市,鳳山區,鎮東里,1340,1432,619,143,762,56,818
公投第９案,高雄市,鳳山區,鎮東里,1341,1033,421,93,514,20,534
公投第９案,高雄市,鳳山區,瑞竹里,1342,1253,530,179,709,89,798
公投第９案,高雄市,鳳山區,瑞竹里,1343,1217,516,155,671,34,705
公投第９案,高雄市,鳳山區,瑞竹里,1344,1267,613,152,765,49,814
公投第９案,高雄市,鳳山區,瑞竹里,1345,1251,502,146,648,40,688
公投第９案,高雄市,鳳山區,瑞興里,1346,1563,696,165,861,85,946
公投第９案,高雄市,鳳山區,瑞興里,1347,1888,882,215,1097,58,1155
公投第９案,高雄市,鳳山區,瑞興里,1348,1368,579,196,775,60,835
公投第９案,高雄市,鳳山區,東門里,1349,1588,638,165,803,47,850
公投第９案,高雄市,鳳山區,東門里,1350,1255,623,108,731,66,797
公投第９案,高雄市,鳳山區,東門里,1351,1264,533,164,697,69,766
公投第９案,高雄市,鳳山區,東門里,1352,1291,553,150,703,86,789
公投第９案,高雄市,鳳山區,誠德里,1353,1224,542,116,658,35,693
公投第９案,高雄市,鳳山區,誠德里,1354,1296,599,129,728,31,759
公投第９案,高雄市,鳳山區,誠信里,1355,826,395,107,502,54,556
公投第９案,高雄市,鳳山區,誠信里,1356,1229,584,116,700,46,746
公投第９案,高雄市,鳳山區,誠智里,1357,1467,702,156,858,43,901
公投第９案,高雄市,鳳山區,誠智里,1358,1218,530,155,685,62,747
公投第９案,高雄市,鳳山區,鳳東里,1359,2173,907,236,1143,86,1229
公投第９案,高雄市,鳳山區,鳳東里,1360,2255,1002,235,1237,74,1311
公投第９案,高雄市,鳳山區,鳳東里,1361,1556,714,172,886,40,926
公投第９案,高雄市,鳳山區,埤頂里,1362,1521,623,173,796,54,850
公投第９案,高雄市,鳳山區,埤頂里,1363,1407,555,141,696,39,735
公投第９案,高雄市,鳳山區,埤頂里,1364,1542,710,165,875,63,938
公投第９案,高雄市,鳳山區,埤頂里,1365,1502,614,148,762,24,786
公投第９案,高雄市,鳳山區,中正里,1366,1320,626,151,777,45,822
公投第９案,高雄市,鳳山區,中正里,1367,1507,701,95,796,38,834
公投第９案,高雄市,鳳山區,中正里,1368,1284,690,89,779,41,820
公投第９案,高雄市,鳳山區,海光里,1369,1441,604,149,753,40,793
公投第９案,高雄市,鳳山區,海光里,1370,1485,689,143,832,83,915
公投第９案,高雄市,鳳山區,國泰里,1371,1205,471,169,640,61,701
公投第９案,高雄市,鳳山區,國泰里,1372,1284,507,151,658,26,684
公投第９案,高雄市,鳳山區,國泰里,1373,1326,573,190,763,62,825
公投第９案,高雄市,鳳山區,國光里,1374,1096,466,149,615,27,642
公投第９案,高雄市,鳳山區,國光里,1375,1182,485,191,676,82,758
公投第９案,高雄市,鳳山區,國光里,1376,1017,476,161,637,56,693
公投第９案,高雄市,鳳山區,國隆里,1377,1198,441,175,616,92,708
公投第９案,高雄市,鳳山區,國隆里,1378,1281,462,157,619,34,653
公投第９案,高雄市,鳳山區,國富里,1379,1358,617,200,817,44,861
公投第９案,高雄市,鳳山區,國富里,1380,1226,592,169,761,48,809
公投第９案,高雄市,鳳山區,武慶里,1381,1098,491,153,644,66,710
公投第９案,高雄市,鳳山區,武慶里,1382,1200,524,158,682,41,723
公投第９案,高雄市,鳳山區,武漢里,1383,942,393,114,507,43,550
公投第９案,高雄市,鳳山區,武漢里,1384,1206,491,144,635,24,659
公投第９案,高雄市,鳳山區,武漢里,1385,1159,534,168,702,43,745
公投第９案,高雄市,鳳山區,武漢里,1386,1401,732,105,837,49,886
公投第９案,高雄市,鳳山區,新甲里,1387,1525,736,62,798,18,816
公投第９案,高雄市,鳳山區,新甲里,1388,1345,535,197,732,36,768
公投第９案,高雄市,鳳山區,新武里,1389,1180,513,177,690,41,731
公投第９案,高雄市,鳳山區,新武里,1390,1106,417,139,556,24,580
公投第９案,高雄市,鳳山區,新泰里,1391,1442,663,187,850,63,913
公投第９案,高雄市,鳳山區,新泰里,1392,1376,621,180,801,54,855
公投第９案,高雄市,鳳山區,新泰里,1393,1243,534,160,694,32,726
公投第９案,高雄市,鳳山區,新樂里,1394,1361,615,139,754,25,779
公投第９案,高雄市,鳳山區,新樂里,1395,1416,626,192,818,64,882
公投第９案,高雄市,鳳山區,新樂里,1396,1536,716,220,936,70,1006
公投第９案,高雄市,鳳山區,新強里,1397,1388,532,162,694,33,727
公投第９案,高雄市,鳳山區,新強里,1398,1241,534,157,691,78,769
公投第９案,高雄市,鳳山區,新強里,1399,1394,640,214,854,17,871
公投第９案,高雄市,鳳山區,新強里,1400,1188,589,155,744,29,773
公投第９案,高雄市,鳳山區,海洋里,1401,1112,477,147,624,39,663
公投第９案,高雄市,鳳山區,海洋里,1402,1198,559,176,735,53,788
公投第９案,高雄市,鳳山區,海洋里,1403,1475,626,185,811,48,859
公投第９案,高雄市,鳳山區,新富里,1404,1216,476,137,613,34,647
公投第９案,高雄市,鳳山區,新富里,1405,1318,462,154,616,36,652
公投第９案,高雄市,鳳山區,新富里,1406,1465,700,82,782,25,807
公投第９案,高雄市,鳳山區,老爺里,1407,1314,488,148,636,46,682
公投第９案,高雄市,鳳山區,老爺里,1408,1649,628,157,785,28,813
公投第９案,高雄市,鳳山區,老爺里,1409,1601,595,197,792,100,892
公投第９案,高雄市,鳳山區,老爺里,1410,1155,472,136,608,29,637
公投第９案,高雄市,鳳山區,老爺里,1411,1050,433,140,573,72,645
公投第９案,高雄市,鳳山區,中民里,1412,1417,543,144,687,28,715
公投第９案,高雄市,鳳山區,中民里,1413,1525,629,187,816,65,881
公投第９案,高雄市,鳳山區,中民里,1414,1514,699,162,861,63,924
公投第９案,高雄市,鳳山區,中崙里,1415,1190,520,137,657,49,706
公投第９案,高雄市,鳳山區,中崙里,1416,1325,540,142,682,24,706
公投第９案,高雄市,鳳山區,中榮里,1417,1049,464,132,596,58,654
公投第９案,高雄市,鳳山區,中榮里,1418,1026,443,122,565,33,598
公投第９案,高雄市,鳳山區,中榮里,1419,1152,492,165,657,63,720
公投第９案,高雄市,鳳山區,中榮里,1420,1254,479,143,622,19,641
公投第９案,高雄市,鳳山區,過埤里,1421,1688,642,183,825,50,875
公投第９案,高雄市,鳳山區,過埤里,1422,1657,733,168,901,58,959
公投第９案,高雄市,鳳山區,過埤里,1423,1729,678,196,874,36,910
公投第９案,高雄市,鳳山區,過埤里,1424,1628,744,185,929,56,985
公投第９案,高雄市,鳳山區,過埤里,1425,1891,733,176,909,19,928
公投第９案,高雄市,鳳山區,過埤里,1426,1594,751,182,933,44,977
公投第９案,高雄市,鳳山區,過埤里,1427,1342,662,157,819,20,839
公投第９案,高雄市,鳳山區,過埤里,1428,1448,723,184,907,40,947
公投第９案,高雄市,鳳山區,正義里,1429,1405,615,187,802,65,867
公投第９案,高雄市,鳳山區,正義里,1430,1097,482,154,636,79,715
公投第９案,高雄市,鳳山區,正義里,1431,1248,504,215,719,98,817
公投第９案,高雄市,鳳山區,正義里,1432,1225,516,176,692,70,762
公投第９案,高雄市,鳳山區,正義里,1433,1214,469,161,630,39,669
公投第９案,高雄市,鳳山區,保安里,1434,2032,894,238,1132,104,1236
公投第９案,高雄市,鳳山區,保安里,1435,1927,855,214,1069,72,1141
公投第９案,高雄市,鳳山區,保安里,1436,2097,966,240,1206,58,1264
公投第９案,高雄市,鳳山區,一甲里,1437,968,387,127,514,54,568
公投第９案,高雄市,鳳山區,一甲里,1438,1200,465,139,604,69,673
公投第９案,高雄市,鳳山區,一甲里,1439,1101,455,143,598,72,670
公投第９案,高雄市,鳳山區,二甲里,1440,1369,539,158,697,42,739
公投第９案,高雄市,鳳山區,二甲里,1441,1542,769,68,837,67,904
公投第９案,高雄市,鳳山區,二甲里,1442,1536,704,184,888,63,951
公投第９案,高雄市,鳳山區,龍成里,1443,1382,502,183,685,33,718
公投第９案,高雄市,鳳山區,龍成里,1444,1452,599,199,798,99,897
公投第９案,高雄市,鳳山區,鎮南里,1445,1058,462,123,585,62,647
公投第９案,高雄市,鳳山區,鎮南里,1446,976,467,111,578,56,634
公投第９案,高雄市,鳳山區,鎮南里,1447,1545,593,165,758,39,797
公投第９案,高雄市,鳳山區,鎮南里,1448,1143,480,187,667,6,673
公投第９案,高雄市,鳳山區,富甲里,1449,1301,241,73,314,24,338
公投第９案,高雄市,鳳山區,富甲里,1450,1250,427,129,556,32,588
公投第９案,高雄市,鳳山區,善美里,1451,1208,512,137,649,58,707
公投第９案,高雄市,鳳山區,善美里,1452,1202,502,149,651,86,737
公投第９案,高雄市,鳳山區,善美里,1453,1499,587,183,770,87,857
公投第９案,高雄市,鳳山區,善美里,1454,1522,591,208,799,55,854
公投第９案,高雄市,鳳山區,富榮里,1455,1125,506,147,653,59,712
公投第９案,高雄市,鳳山區,富榮里,1456,1307,578,168,746,27,773
公投第９案,高雄市,鳳山區,南和里,1457,1405,562,198,760,67,827
公投第９案,高雄市,鳳山區,南和里,1458,1252,546,142,688,64,752
公投第９案,高雄市,鳳山區,南成里,1459,1291,594,152,746,29,775
公投第９案,高雄市,鳳山區,南成里,1460,938,414,112,526,68,594
公投第９案,高雄市,鳳山區,南成里,1461,1783,767,230,997,42,1039
公投第９案,高雄市,鳳山區,南成里,1462,1105,489,133,622,42,664
公投第９案,高雄市,鳳山區,南成里,1463,1392,550,191,741,93,834
公投第９案,高雄市,鳳山區,南成里,1464,1244,613,169,782,48,830
公投第９案,高雄市,鳳山區,天興里,1465,1154,458,147,605,49,654
公投第９案,高雄市,鳳山區,天興里,1466,1153,510,133,643,54,697
公投第９案,高雄市,鳳山區,天興里,1467,1148,435,106,541,19,560
公投第９案,高雄市,鳳山區,大德里,1468,1432,526,185,711,115,826
公投第９案,高雄市,鳳山區,大德里,1469,1429,420,150,570,20,590
公投第９案,高雄市,鳳山區,大德里,1470,1479,623,151,774,35,809
公投第９案,高雄市,鳳山區,五福里,1471,1026,451,127,578,51,629
公投第９案,高雄市,鳳山區,五福里,1472,993,529,52,581,93,674
公投第９案,高雄市,鳳山區,五福里,1473,947,427,120,547,69,616
公投第９案,高雄市,鳳山區,福興里,1474,1042,419,116,535,69,604
公投第９案,高雄市,鳳山區,福興里,1475,1098,459,134,593,68,661
公投第９案,高雄市,鳳山區,福興里,1476,1284,468,156,624,23,647
公投第９案,高雄市,鳳山區,福興里,1477,1242,479,146,625,40,665
公投第９案,高雄市,鳳山區,福興里,1478,1093,477,134,611,77,688
公投第９案,高雄市,鳳山區,福祥里,1479,1353,533,167,700,53,753
公投第９案,高雄市,鳳山區,福祥里,1480,1353,526,141,667,33,700
公投第９案,高雄市,鳳山區,福誠里,1481,1309,556,170,726,75,801
公投第９案,高雄市,鳳山區,福誠里,1482,1627,679,201,880,64,944
公投第９案,高雄市,鳳山區,福誠里,1483,1372,560,179,739,94,833
公投第９案,高雄市,前鎮區,草衙里,1484,1809,630,232,862,140,1002
公投第９案,高雄市,前鎮區,草衙里,1485,1835,667,229,896,95,991
公投第９案,高雄市,前鎮區,草衙里,1486,1890,580,175,755,81,836
公投第９案,高雄市,前鎮區,草衙里,1487,2013,672,235,907,70,977
公投第９案,高雄市,前鎮區,草衙里,1488,1776,671,199,870,75,945
公投第９案,高雄市,前鎮區,明孝里,1489,1705,559,182,741,97,838
公投第９案,高雄市,前鎮區,明孝里,1490,672,272,81,353,69,422
公投第９案,高雄市,前鎮區,明正里,1491,1726,553,192,745,104,849
公投第９案,高雄市,前鎮區,明正里,1492,1597,651,187,838,48,886
公投第９案,高雄市,前鎮區,明正里,1493,1690,662,250,912,91,1003
公投第９案,高雄市,前鎮區,明義里,1494,1080,475,142,617,78,695
公投第９案,高雄市,前鎮區,明義里,1495,1159,512,181,693,72,765
公投第９案,高雄市,前鎮區,仁愛里,1496,1314,478,158,636,77,713
公投第９案,高雄市,前鎮區,德昌里,1497,896,387,104,491,65,556
公投第９案,高雄市,前鎮區,德昌里,1498,1002,417,137,554,39,593
公投第９案,高雄市,前鎮區,平等里,1499,2765,714,242,956,110,1066
公投第９案,高雄市,前鎮區,平昌里,1500,600,230,82,312,65,377
公投第９案,高雄市,前鎮區,明禮里,1501,1466,344,131,475,42,517
公投第９案,高雄市,前鎮區,信義里,1502,1449,544,160,704,57,761
公投第９案,高雄市,前鎮區,信德里,1503,991,374,116,490,58,548
公投第９案,高雄市,前鎮區,信德里,1504,1248,514,151,665,91,756
公投第９案,高雄市,前鎮區,明道里,1505,1066,443,142,585,92,677
公投第９案,高雄市,前鎮區,興化里,1506,706,215,73,288,43,331
公投第９案,高雄市,前鎮區,興仁里,1507,713,241,93,334,39,373
公投第９案,高雄市,前鎮區,前鎮里,1508,1344,468,161,629,50,679
公投第９案,高雄市,前鎮區,鎮東里,1509,856,348,116,464,54,518
公投第９案,高雄市,前鎮區,鎮東里,1510,873,282,118,400,44,444
公投第９案,高雄市,前鎮區,鎮榮里,1511,1114,380,132,512,55,567
公投第９案,高雄市,前鎮區,鎮榮里,1512,1112,356,132,488,19,507
公投第９案,高雄市,前鎮區,鎮昌里,1513,1044,402,123,525,64,589
公投第９案,高雄市,前鎮區,鎮昌里,1514,940,340,120,460,54,514
公投第９案,高雄市,前鎮區,鎮海里,1515,1342,485,147,632,73,705
公投第９案,高雄市,前鎮區,鎮海里,1516,1402,654,210,864,55,919
公投第９案,高雄市,前鎮區,鎮海里,1517,1320,604,173,777,39,816
公投第９案,高雄市,前鎮區,鎮陽里,1518,958,376,135,511,61,572
公投第９案,高雄市,前鎮區,興邦里,1519,1276,652,173,825,44,869
公投第９案,高雄市,前鎮區,興邦里,1520,1459,665,160,825,85,910
公投第９案,高雄市,前鎮區,鎮中里,1521,761,229,110,339,21,360
公投第９案,高雄市,前鎮區,鎮北里,1522,1093,383,147,530,27,557
公投第９案,高雄市,前鎮區,忠純里,1523,1521,782,133,915,46,961
公投第９案,高雄市,前鎮區,忠純里,1524,1557,759,154,913,47,960
公投第９案,高雄市,前鎮區,忠純里,1525,1821,711,167,878,35,913
公投第９案,高雄市,前鎮區,忠誠里,1526,1066,587,106,693,44,737
公投第９案,高雄市,前鎮區,忠誠里,1527,1046,572,89,661,20,681
公投第９案,高雄市,前鎮區,西山里,1528,1709,671,253,924,68,992
公投第９案,高雄市,前鎮區,西山里,1529,1723,743,231,974,90,1064
公投第９案,高雄市,前鎮區,民權里,1530,1202,567,167,734,54,788
公投第９案,高雄市,前鎮區,民權里,1531,1279,590,208,798,38,836
公投第９案,高雄市,前鎮區,民權里,1532,1513,729,196,925,48,973
公投第９案,高雄市,前鎮區,建隆里,1533,1260,516,171,687,23,710
公投第９案,高雄市,前鎮區,振興里,1534,1139,488,173,661,88,749
公投第９案,高雄市,前鎮區,振興里,1535,1140,553,162,715,45,760
公投第９案,高雄市,前鎮區,良和里,1536,1462,561,255,816,92,908
公投第９案,高雄市,前鎮區,良和里,1537,1359,610,190,800,45,845
公投第９案,高雄市,前鎮區,西甲里,1538,2037,703,268,971,91,1062
公投第９案,高雄市,前鎮區,盛興里,1539,1410,586,157,743,27,770
公投第９案,高雄市,前鎮區,盛興里,1540,1307,520,186,706,24,730
公投第９案,高雄市,前鎮區,盛豐里,1541,1512,580,214,794,92,886
公投第９案,高雄市,前鎮區,盛豐里,1542,1491,616,215,831,85,916
公投第９案,高雄市,前鎮區,興中里,1543,1621,656,204,860,90,950
公投第９案,高雄市,前鎮區,興中里,1544,1522,560,172,732,77,809
公投第９案,高雄市,前鎮區,興東里,1545,1593,658,231,889,60,949
公投第９案,高雄市,前鎮區,興東里,1546,1885,807,253,1060,89,1149
公投第９案,高雄市,前鎮區,興東里,1547,1870,818,250,1068,97,1165
公投第９案,高雄市,前鎮區,忠孝里,1548,1388,596,185,781,26,807
公投第９案,高雄市,前鎮區,忠孝里,1549,1348,563,180,743,69,812
公投第９案,高雄市,前鎮區,復國里,1550,1341,519,148,667,106,773
公投第９案,高雄市,前鎮區,復國里,1551,1364,634,179,813,54,867
公投第９案,高雄市,前鎮區,竹內里,1552,1367,552,200,752,76,828
公投第９案,高雄市,前鎮區,竹內里,1553,1326,516,176,692,82,774
公投第９案,高雄市,前鎮區,竹東里,1554,1059,434,136,570,44,614
公投第９案,高雄市,前鎮區,竹東里,1555,1119,520,129,649,20,669
公投第９案,高雄市,前鎮區,竹南里,1556,1565,612,174,786,47,833
公投第９案,高雄市,前鎮區,竹南里,1557,1549,637,198,835,68,903
公投第９案,高雄市,前鎮區,竹南里,1558,1691,800,221,1021,41,1062
公投第９案,高雄市,前鎮區,竹南里,1559,1837,831,232,1063,38,1101
公投第９案,高雄市,前鎮區,竹北里,1560,1092,480,157,637,28,665
公投第９案,高雄市,前鎮區,竹北里,1561,1126,478,167,645,63,708
公投第９案,高雄市,前鎮區,竹西里,1562,1215,472,145,617,89,706
公投第９案,高雄市,前鎮區,竹西里,1563,1443,660,158,818,37,855
公投第９案,高雄市,前鎮區,竹西里,1564,1448,709,214,923,24,947
公投第９案,高雄市,前鎮區,竹中里,1565,1648,709,220,929,85,1014
公投第９案,高雄市,前鎮區,竹中里,1566,1603,593,215,808,85,893
公投第９案,高雄市,前鎮區,瑞竹里,1567,1596,580,165,745,33,778
公投第９案,高雄市,前鎮區,瑞南里,1568,1450,521,152,673,37,710
公投第９案,高雄市,前鎮區,瑞南里,1569,1510,597,155,752,88,840
公投第９案,高雄市,前鎮區,瑞南里,1570,1647,711,224,935,100,1035
公投第９案,高雄市,前鎮區,瑞豐里,1571,1342,557,148,705,69,774
公投第９案,高雄市,前鎮區,瑞豐里,1572,1384,524,161,685,56,741
公投第９案,高雄市,前鎮區,瑞祥里,1573,1479,563,178,741,75,816
公投第９案,高雄市,前鎮區,瑞祥里,1574,1546,667,164,831,44,875
公投第９案,高雄市,前鎮區,瑞祥里,1575,1595,635,256,891,64,955
公投第９案,高雄市,前鎮區,瑞東里,1576,1201,533,138,671,70,741
公投第９案,高雄市,前鎮區,瑞東里,1577,1082,412,135,547,26,573
公投第９案,高雄市,前鎮區,瑞和里,1578,996,379,111,490,46,536
公投第９案,高雄市,前鎮區,瑞和里,1579,932,376,114,490,86,576
公投第９案,高雄市,前鎮區,瑞平里,1580,1146,451,184,635,52,687
公投第９案,高雄市,前鎮區,瑞平里,1581,1096,497,123,620,37,657
公投第９案,高雄市,前鎮區,瑞平里,1582,1332,643,157,800,19,819
公投第９案,高雄市,前鎮區,瑞隆里,1583,1175,503,129,632,41,673
公投第９案,高雄市,前鎮區,瑞隆里,1584,986,407,125,532,67,599
公投第９案,高雄市,前鎮區,瑞隆里,1585,1316,566,186,752,73,825
公投第９案,高雄市,前鎮區,瑞北里,1586,1559,574,163,737,71,808
公投第９案,高雄市,前鎮區,瑞北里,1587,1622,704,199,903,84,987
公投第９案,高雄市,前鎮區,瑞西里,1588,1310,509,175,684,37,721
公投第９案,高雄市,前鎮區,瑞西里,1589,1299,512,182,694,101,795
公投第９案,高雄市,前鎮區,瑞崗里,1590,1191,567,156,723,70,793
公投第９案,高雄市,前鎮區,瑞崗里,1591,1375,564,122,686,32,718
公投第９案,高雄市,前鎮區,瑞興里,1592,1338,565,170,735,25,760
公投第９案,高雄市,前鎮區,瑞興里,1593,1175,435,160,595,38,633
公投第９案,高雄市,前鎮區,瑞誠里,1594,1357,546,158,704,35,739
公投第９案,高雄市,前鎮區,瑞誠里,1595,1187,534,177,711,62,773
公投第９案,高雄市,前鎮區,瑞文里,1596,1164,460,153,613,50,663
公投第９案,高雄市,前鎮區,瑞文里,1597,1219,541,164,705,61,766
公投第９案,高雄市,前鎮區,瑞華里,1598,1428,552,187,739,25,764
公投第９案,高雄市,前鎮區,瑞華里,1599,1495,575,202,777,104,881
公投第９案,高雄市,前鎮區,瑞華里,1600,1531,643,200,843,37,880
公投第９案,高雄市,前鎮區,瑞昌里,1601,1509,613,158,771,83,854
公投第９案,高雄市,前鎮區,瑞昌里,1602,1591,623,198,821,77,898
公投第９案,高雄市,小港區,小港里,1603,1108,508,141,649,45,694
公投第９案,高雄市,小港區,小港里,1604,1171,509,155,664,66,730
公投第９案,高雄市,小港區,港口里,1605,1557,701,236,937,23,960
公投第９案,高雄市,小港區,港口里,1606,1668,667,177,844,21,865
公投第９案,高雄市,小港區,港正里,1607,1183,553,136,689,30,719
公投第９案,高雄市,小港區,港正里,1608,1372,607,146,753,31,784
公投第９案,高雄市,小港區,港墘里,1609,1737,765,206,971,72,1043
公投第９案,高雄市,小港區,港明里,1610,1586,616,216,832,104,936
公投第９案,高雄市,小港區,港明里,1611,1558,595,164,759,74,833
公投第９案,高雄市,小港區,港后里,1612,1284,563,212,775,76,851
公投第９案,高雄市,小港區,港后里,1613,1249,552,157,709,60,769
公投第９案,高雄市,小港區,港南里,1614,2400,800,215,1015,109,1124
公投第９案,高雄市,小港區,港興里,1615,1181,500,168,668,41,709
公投第９案,高雄市,小港區,港興里,1616,1079,448,121,569,36,605
公投第９案,高雄市,小港區,鳳宮里,1617,1335,567,168,735,48,783
公投第９案,高雄市,小港區,鳳宮里,1618,1241,568,133,701,65,766
公投第９案,高雄市,小港區,店鎮里,1619,1513,630,172,802,71,873
公投第９案,高雄市,小港區,店鎮里,1620,1349,594,170,764,71,835
公投第９案,高雄市,小港區,店鎮里,1621,1483,585,189,774,54,828
公投第９案,高雄市,小港區,店鎮里,1622,1451,634,167,801,31,832
公投第９案,高雄市,小港區,大苓里,1623,1241,505,121,626,31,657
公投第９案,高雄市,小港區,大苓里,1624,1262,581,193,774,71,845
公投第９案,高雄市,小港區,二苓里,1625,1813,797,208,1005,93,1098
公投第９案,高雄市,小港區,二苓里,1626,1877,706,165,871,43,914
公投第９案,高雄市,小港區,三苓里,1627,1391,585,170,755,21,776
公投第９案,高雄市,小港區,三苓里,1628,1453,630,198,828,31,859
公投第９案,高雄市,小港區,正苓里,1629,1374,571,191,762,49,811
公投第９案,高雄市,小港區,正苓里,1630,1348,561,167,728,61,789
公投第９案,高雄市,小港區,正苓里,1631,1334,606,161,767,70,837
公投第９案,高雄市,小港區,順苓里,1632,1433,569,194,763,32,795
公投第９案,高雄市,小港區,順苓里,1633,1448,541,170,711,18,729
公投第９案,高雄市,小港區,順苓里,1634,1488,684,203,887,64,951
公投第９案,高雄市,小港區,六苓里,1635,1278,574,146,720,61,781
公投第９案,高雄市,小港區,六苓里,1636,1306,668,180,848,46,894
公投第９案,高雄市,小港區,宏亮里,1637,1625,680,112,792,89,881
公投第９案,高雄市,小港區,宏亮里,1638,1640,724,233,957,88,1045
公投第９案,高雄市,小港區,山東里,1639,1506,651,168,819,53,872
公投第９案,高雄市,小港區,山東里,1640,1438,582,147,729,69,798
公投第９案,高雄市,小港區,青島里,1641,1105,554,145,699,40,739
公投第９案,高雄市,小港區,青島里,1642,1167,517,111,628,17,645
公投第９案,高雄市,小港區,濟南里,1643,1420,662,157,819,33,852
公投第９案,高雄市,小港區,濟南里,1644,1380,678,167,845,67,912
公投第９案,高雄市,小港區,濟南里,1645,1239,545,127,672,32,704
公投第９案,高雄市,小港區,泰山里,1646,1563,743,158,901,59,960
公投第９案,高雄市,小港區,泰山里,1647,1644,773,183,956,22,978
公投第９案,高雄市,小港區,山明里,1648,1895,884,113,997,89,1086
公投第９案,高雄市,小港區,山明里,1649,1748,692,216,908,96,1004
公投第９案,高雄市,小港區,山明里,1650,1579,619,263,882,94,976
公投第９案,高雄市,小港區,山明里,1651,2135,871,231,1102,51,1153
公投第９案,高雄市,小港區,山明里,1652,1728,708,214,922,84,1006
公投第９案,高雄市,小港區,山明里,1653,2022,791,220,1011,46,1057
公投第９案,高雄市,小港區,高松里,1654,1329,465,115,580,30,610
公投第９案,高雄市,小港區,高松里,1655,1320,495,190,685,47,732
公投第９案,高雄市,小港區,高松里,1656,1267,551,138,689,86,775
公投第９案,高雄市,小港區,松金里,1657,1298,555,191,746,78,824
公投第９案,高雄市,小港區,松金里,1658,1289,568,177,745,36,781
公投第９案,高雄市,小港區,松山里,1659,1534,653,197,850,56,906
公投第９案,高雄市,小港區,松山里,1660,1494,637,190,827,52,879
公投第９案,高雄市,小港區,大坪里,1661,1377,566,184,750,79,829
公投第９案,高雄市,小港區,大坪里,1662,1344,639,148,787,84,871
公投第９案,高雄市,小港區,坪頂里,1663,1508,648,155,803,69,872
公投第９案,高雄市,小港區,坪頂里,1664,1400,572,187,759,36,795
公投第９案,高雄市,小港區,坪頂里,1665,1457,673,162,835,61,896
公投第９案,高雄市,小港區,坪頂里,1666,1392,580,163,743,30,773
公投第９案,高雄市,小港區,孔宅里,1667,1983,805,209,1014,70,1084
公投第９案,高雄市,小港區,孔宅里,1668,1204,508,114,622,34,656
公投第９案,高雄市,小港區,孔宅里,1669,1300,538,171,709,45,754
公投第９案,高雄市,小港區,廈莊里,1670,1857,785,276,1061,88,1149
公投第９案,高雄市,小港區,廈莊里,1671,1566,664,177,841,42,883
公投第９案,高雄市,小港區,合作里,1672,1343,634,175,809,83,892
公投第９案,高雄市,小港區,合作里,1673,1236,537,179,716,77,793
公投第９案,高雄市,小港區,桂林里,1674,1564,675,202,877,102,979
公投第９案,高雄市,小港區,桂林里,1675,1484,592,182,774,39,813
公投第９案,高雄市,小港區,桂林里,1676,1477,638,157,795,38,833
公投第９案,高雄市,小港區,桂林里,1677,1482,653,218,871,49,920
公投第９案,高雄市,小港區,桂林里,1678,1708,675,185,860,49,909
公投第９案,高雄市,小港區,中厝里,1679,1867,721,279,1000,68,1068
公投第９案,高雄市,小港區,中厝里,1680,1709,630,179,809,32,841
公投第９案,高雄市,小港區,鳳鳴里,1681,1425,545,159,704,82,786
公投第９案,高雄市,小港區,鳳鳴里,1682,1696,587,162,749,52,801
公投第９案,高雄市,小港區,龍鳳里,1683,1522,505,173,678,45,723
公投第９案,高雄市,小港區,龍鳳里,1684,1531,596,205,801,103,904
公投第９案,高雄市,小港區,鳳森里,1685,2215,818,262,1080,127,1207
公投第９案,高雄市,小港區,鳳林里,1686,1515,565,176,741,41,782
公投第９案,高雄市,小港區,鳳林里,1687,1535,539,164,703,33,736
公投第９案,高雄市,小港區,鳳興里,1688,1276,508,145,653,34,687
公投第９案,高雄市,小港區,鳳興里,1689,1217,432,128,560,40,600
公投第９案,高雄市,小港區,鳳源里,1690,1707,585,175,760,85,845
公投第９案,高雄市,小港區,鳳源里,1691,1920,664,232,896,127,1023
公投第９案,高雄市,大寮區,拷潭里,1692,727,243,87,330,25,355
公投第９案,高雄市,大寮區,拷潭里,1693,718,233,85,318,19,337
公投第９案,高雄市,大寮區,內坑里,1694,1340,468,140,608,46,654
公投第９案,高雄市,大寮區,內坑里,1695,1575,528,163,691,47,738
公投第９案,高雄市,大寮區,內坑里,1696,444,166,66,232,29,261
公投第９案,高雄市,大寮區,內坑里,1697,2374,792,206,998,55,1053
公投第９案,高雄市,大寮區,大寮里,1698,1291,503,140,643,78,721
公投第９案,高雄市,大寮區,大寮里,1699,1400,544,172,716,81,797
公投第９案,高雄市,大寮區,大寮里,1700,1390,539,162,701,37,738
公投第９案,高雄市,大寮區,大寮里,1701,1401,515,178,693,88,781
公投第９案,高雄市,大寮區,大寮里,1702,1199,447,124,571,38,609
公投第９案,高雄市,大寮區,上寮里,1703,1210,420,129,549,34,583
公投第９案,高雄市,大寮區,上寮里,1704,1195,460,156,616,47,663
公投第９案,高雄市,大寮區,三隆里,1705,1166,431,117,548,36,584
公投第９案,高雄市,大寮區,三隆里,1706,1353,527,167,694,45,739
公投第９案,高雄市,大寮區,三隆里,1707,1052,428,140,568,73,641
公投第９案,高雄市,大寮區,三隆里,1708,1024,330,95,425,32,457
公投第９案,高雄市,大寮區,琉球里,1709,1189,484,149,633,26,659
公投第９案,高雄市,大寮區,琉球里,1710,1512,633,191,824,91,915
公投第９案,高雄市,大寮區,琉球里,1711,1633,612,181,793,80,873
公投第９案,高雄市,大寮區,翁園里,1712,1214,506,160,666,53,719
公投第９案,高雄市,大寮區,翁園里,1713,1258,545,180,725,79,804
公投第９案,高雄市,大寮區,翁園里,1714,1323,525,183,708,42,750
公投第９案,高雄市,大寮區,前庄里,1715,1253,556,141,697,57,754
公投第９案,高雄市,大寮區,前庄里,1716,1035,350,229,579,75,654
公投第９案,高雄市,大寮區,中庄里,1717,1106,458,120,578,28,606
公投第９案,高雄市,大寮區,中庄里,1718,1195,494,144,638,46,684
公投第９案,高雄市,大寮區,中庄里,1719,1051,436,149,585,21,606
公投第９案,高雄市,大寮區,中庄里,1720,1425,581,184,765,86,851
公投第９案,高雄市,大寮區,中庄里,1721,1635,648,196,844,65,909
公投第９案,高雄市,大寮區,中庄里,1722,1359,542,196,738,68,806
公投第９案,高雄市,大寮區,中庄里,1723,1361,601,140,741,64,805
公投第９案,高雄市,大寮區,中庄里,1724,1629,681,181,862,51,913
公投第９案,高雄市,大寮區,後庄里,1725,1518,670,161,831,55,886
公投第９案,高雄市,大寮區,後庄里,1726,1620,645,204,849,71,920
公投第９案,高雄市,大寮區,後庄里,1727,1648,645,192,837,29,866
公投第９案,高雄市,大寮區,後庄里,1728,1385,592,146,738,52,790
公投第９案,高雄市,大寮區,後庄里,1729,1435,572,140,712,36,748
公投第９案,高雄市,大寮區,義仁里,1730,1046,426,112,538,28,566
公投第９案,高雄市,大寮區,義仁里,1731,789,272,108,380,37,417
公投第９案,高雄市,大寮區,新厝里,1732,909,333,121,454,38,492
公投第９案,高雄市,大寮區,新厝里,1733,733,284,106,390,43,433
公投第９案,高雄市,大寮區,過溪里,1734,1553,693,77,770,71,841
公投第９案,高雄市,大寮區,過溪里,1735,922,358,110,468,31,499
公投第９案,高雄市,大寮區,潮寮里,1736,1012,385,130,515,71,586
公投第９案,高雄市,大寮區,潮寮里,1737,968,330,132,462,74,536
公投第９案,高雄市,大寮區,潮寮里,1738,1021,362,154,516,38,554
公投第９案,高雄市,大寮區,會結里,1739,1554,517,157,674,79,753
公投第９案,高雄市,大寮區,會社里,1740,1120,474,136,610,75,685
公投第９案,高雄市,大寮區,會社里,1741,1225,572,134,706,56,762
公投第９案,高雄市,大寮區,會社里,1742,1320,383,103,486,25,511
公投第９案,高雄市,大寮區,會社里,1743,1317,514,168,682,61,743
公投第９案,高雄市,大寮區,會社里,1744,1119,446,130,576,21,597
公投第９案,高雄市,大寮區,山頂里,1745,1190,582,80,662,59,721
公投第９案,高雄市,大寮區,山頂里,1746,1229,566,137,703,54,757
公投第９案,高雄市,大寮區,山頂里,1747,1178,557,147,704,51,755
公投第９案,高雄市,大寮區,山頂里,1748,1272,587,170,757,35,792
公投第９案,高雄市,大寮區,山頂里,1749,1413,601,140,741,29,770
公投第９案,高雄市,大寮區,山頂里,1750,1185,535,138,673,66,739
公投第９案,高雄市,大寮區,忠義里,1751,553,237,62,299,5,304
公投第９案,高雄市,大寮區,永芳里,1752,1121,436,119,555,72,627
公投第９案,高雄市,大寮區,永芳里,1753,1227,487,144,631,46,677
公投第９案,高雄市,大寮區,永芳里,1754,1058,520,133,653,63,716
公投第９案,高雄市,大寮區,永芳里,1755,1209,520,141,661,34,695
公投第９案,高雄市,大寮區,永芳里,1756,1100,481,121,602,23,625
公投第９案,高雄市,大寮區,永芳里,1757,1122,442,117,559,25,584
公投第９案,高雄市,大寮區,義和里,1758,983,424,140,564,76,640
公投第９案,高雄市,大寮區,義和里,1759,1192,430,137,567,32,599
公投第９案,高雄市,大寮區,溪寮里,1760,719,249,103,352,37,389
公投第９案,高雄市,大寮區,溪寮里,1761,829,328,124,452,33,485
公投第９案,高雄市,大寮區,江山里,1762,771,346,116,462,71,533
公投第９案,高雄市,大寮區,江山里,1763,1075,414,174,588,90,678
公投第９案,高雄市,大寮區,昭明里,1764,1280,528,163,691,88,779
公投第９案,高雄市,大寮區,昭明里,1765,1179,423,160,583,106,689
公投第９案,高雄市,大寮區,昭明里,1766,1210,462,136,598,36,634
公投第９案,高雄市,大寮區,光武里,1767,189,88,21,109,7,116
公投第９案,高雄市,大寮區,中興里,1768,1228,530,152,682,68,750
公投第９案,高雄市,大寮區,中興里,1769,1170,490,130,620,50,670
公投第９案,高雄市,大寮區,中興里,1770,1416,669,145,814,60,874
公投第９案,高雄市,大寮區,中興里,1771,1482,677,172,849,33,882
公投第９案,高雄市,大寮區,中興里,1772,1478,617,136,753,68,821
公投第９案,高雄市,林園區,東林里,1773,1262,514,156,670,91,761
公投第９案,高雄市,林園區,東林里,1774,1562,562,177,739,81,820
公投第９案,高雄市,林園區,林園里,1775,1078,460,113,573,31,604
公投第９案,高雄市,林園區,林園里,1776,979,428,135,563,61,624
公投第９案,高雄市,林園區,林園里,1777,1195,484,129,613,53,666
公投第９案,高雄市,林園區,溪州里,1778,1380,512,163,675,78,753
公投第９案,高雄市,林園區,溪州里,1779,1280,470,173,643,83,726
公投第９案,高雄市,林園區,溪州里,1780,1269,461,175,636,34,670
公投第９案,高雄市,林園區,潭頭里,1781,1568,486,182,668,26,694
公投第９案,高雄市,林園區,潭頭里,1782,1226,488,185,673,65,738
公投第９案,高雄市,林園區,中厝里,1783,1480,580,158,738,68,806
公投第９案,高雄市,林園區,中厝里,1784,1459,629,159,788,70,858
公投第９案,高雄市,林園區,中門里,1785,1593,570,183,753,59,812
公投第９案,高雄市,林園區,中門里,1786,895,321,127,448,89,537
公投第９案,高雄市,林園區,頂厝里,1787,1110,402,130,532,42,574
公投第９案,高雄市,林園區,頂厝里,1788,1348,514,148,662,69,731
公投第９案,高雄市,林園區,頂厝里,1789,912,347,131,478,64,542
公投第９案,高雄市,林園區,頂厝里,1790,1085,489,142,631,70,701
公投第９案,高雄市,林園區,港埔里,1791,955,373,101,474,35,509
公投第９案,高雄市,林園區,港埔里,1792,879,366,122,488,54,542
公投第９案,高雄市,林園區,西溪里,1793,1103,448,118,566,75,641
公投第９案,高雄市,林園區,西溪里,1794,1054,464,127,591,77,668
公投第９案,高雄市,林園區,西溪里,1795,1292,455,119,574,19,593
公投第９案,高雄市,林園區,港嘴里,1796,1683,565,157,722,36,758
公投第９案,高雄市,林園區,北汕里,1797,607,247,65,312,39,351
公投第９案,高雄市,林園區,北汕里,1798,1012,390,121,511,81,592
公投第９案,高雄市,林園區,林內里,1799,1046,421,119,540,76,616
公投第９案,高雄市,林園區,林內里,1800,914,311,82,393,26,419
公投第９案,高雄市,林園區,王公里,1801,1405,584,163,747,72,819
公投第９案,高雄市,林園區,王公里,1802,1299,542,176,718,74,792
公投第９案,高雄市,林園區,王公里,1803,1170,483,105,588,35,623
公投第９案,高雄市,林園區,林家里,1804,1299,406,140,546,44,590
公投第９案,高雄市,林園區,龔厝里,1805,1031,400,150,550,34,584
公投第９案,高雄市,林園區,龔厝里,1806,849,315,92,407,25,432
公投第９案,高雄市,林園區,鳳芸里,1807,838,276,119,395,56,451
公投第９案,高雄市,林園區,鳳芸里,1808,938,385,103,488,35,523
公投第９案,高雄市,林園區,中芸里,1809,1051,358,102,460,47,507
公投第９案,高雄市,林園區,中芸里,1810,786,314,105,419,58,477
公投第９案,高雄市,林園區,東汕里,1811,894,366,107,473,80,553
公投第９案,高雄市,林園區,西汕里,1812,749,198,58,256,22,278
公投第９案,高雄市,林園區,仁愛里,1813,1485,653,167,820,44,864
公投第９案,高雄市,林園區,仁愛里,1814,1478,602,187,789,105,894
公投第９案,高雄市,林園區,文賢里,1815,1345,559,205,764,84,848
公投第９案,高雄市,林園區,文賢里,1816,1038,344,167,511,62,573
公投第９案,高雄市,林園區,廣應里,1817,1203,521,144,665,29,694
公投第９案,高雄市,林園區,廣應里,1818,1138,455,129,584,37,621
公投第９案,高雄市,林園區,廣應里,1819,1025,397,88,485,18,503
公投第９案,高雄市,林園區,五福里,1820,1341,543,159,702,87,789
公投第９案,高雄市,林園區,五福里,1821,1218,404,120,524,24,548
公投第９案,高雄市,林園區,中汕里,1822,1147,360,90,450,32,482
公投第９案,高雄市,林園區,中汕里,1823,1176,353,116,469,22,491
公投第９案,新北市,石門區,德茂里,1,1121,366,159,525,54,579
公投第９案,新北市,石門區,富基里,2,1389,459,134,593,76,669
公投第９案,新北市,石門區,老梅里,3,933,337,94,431,58,489
公投第９案,新北市,石門區,老梅里,4,1244,426,122,548,70,618
公投第９案,新北市,石門區,山溪里,5,883,325,92,417,68,485
公投第９案,新北市,石門區,石門里,6,1564,619,159,778,50,828
公投第９案,新北市,石門區,尖鹿里,7,1500,546,185,731,64,795
公投第９案,新北市,石門區,乾華里,8,328,114,18,132,19,151
公投第９案,新北市,石門區,茂林里,9,651,281,86,367,36,403
公投第９案,新北市,石門區,草里里,10,915,290,81,371,40,411
公投第９案,新北市,三芝區,八賢里,11,312,102,34,136,12,148
公投第９案,新北市,三芝區,埔頭里,12,1421,513,126,639,30,669
公投第９案,新北市,三芝區,埔頭里,13,1557,561,186,747,54,801
公投第９案,新北市,三芝區,埔頭里,14,1828,653,198,851,72,923
公投第９案,新北市,三芝區,古庄里,15,1060,377,118,495,45,540
公投第９案,新北市,三芝區,新庄里,16,819,238,78,316,40,356
公投第９案,新北市,三芝區,埔坪里,17,1701,511,162,673,42,715
公投第９案,新北市,三芝區,埔坪里,18,1740,569,196,765,72,837
公投第９案,新北市,三芝區,埔坪里,19,1451,389,139,528,43,571
公投第９案,新北市,三芝區,埔坪里,20,1248,395,119,514,61,575
公投第９案,新北市,三芝區,茂長里,21,629,227,78,305,15,320
公投第９案,新北市,三芝區,橫山里,22,504,166,49,215,19,234
公投第９案,新北市,三芝區,錫板里,23,698,221,73,294,13,307
公投第９案,新北市,三芝區,後厝里,24,2069,733,172,905,52,957
公投第９案,新北市,三芝區,福德里,25,784,282,98,380,34,414
公投第９案,新北市,三芝區,圓山里,26,522,157,76,233,30,263
公投第９案,新北市,三芝區,店子里,27,587,176,62,238,65,303
公投第９案,新北市,三芝區,興華里,28,1189,408,145,553,50,603
公投第９案,新北市,淡水區,中和里,29,544,173,78,251,37,288
公投第９案,新北市,淡水區,屯山里,30,1044,376,142,518,58,576
公投第９案,新北市,淡水區,賢孝里,31,1462,513,173,686,39,725
公投第９案,新北市,淡水區,興仁里,32,1525,535,186,721,71,792
公投第９案,新北市,淡水區,蕃薯里,33,986,324,97,421,46,467
公投第９案,新北市,淡水區,忠山里,34,806,332,82,414,33,447
公投第９案,新北市,淡水區,義山里,35,1173,447,136,583,73,656
公投第９案,新北市,淡水區,義山里,36,1343,460,116,576,49,625
公投第９案,新北市,淡水區,水源里,37,1153,342,115,457,33,490
公投第９案,新北市,淡水區,水源里,38,874,263,119,382,36,418
公投第９案,新北市,淡水區,忠寮里,39,1063,360,136,496,89,585
公投第９案,新北市,淡水區,樹興里,40,1309,448,134,582,43,625
公投第９案,新北市,淡水區,坪頂里,41,1290,487,156,643,48,691
公投第９案,新北市,淡水區,福德里,42,1675,716,187,903,34,937
公投第９案,新北市,淡水區,福德里,43,1589,636,202,838,42,880
公投第９案,新北市,淡水區,福德里,44,1624,693,199,892,48,940
公投第９案,新北市,淡水區,福德里,45,1241,481,137,618,36,654
公投第９案,新北市,淡水區,竹圍里,46,1317,493,149,642,62,704
公投第９案,新北市,淡水區,竹圍里,47,1225,588,82,670,22,692
公投第９案,新北市,淡水區,竹圍里,48,1426,596,151,747,41,788
公投第９案,新北市,淡水區,竹圍里,49,1610,690,197,887,49,936
公投第９案,新北市,淡水區,民權里,50,1982,797,243,1040,36,1076
公投第９案,新北市,淡水區,民權里,51,1924,642,203,845,50,895
公投第９案,新北市,淡水區,民生里,52,1822,652,218,870,52,922
公投第９案,新北市,淡水區,民生里,53,1232,496,171,667,71,738
公投第９案,新北市,淡水區,民生里,54,1588,655,177,832,71,903
公投第９案,新北市,淡水區,民生里,55,1784,684,180,864,33,897
公投第９案,新北市,淡水區,八勢里,56,1762,639,218,857,68,925
公投第９案,新北市,淡水區,八勢里,57,1546,595,183,778,41,819
公投第９案,新北市,淡水區,八勢里,58,1897,802,168,970,43,1013
公投第９案,新北市,淡水區,竿蓁里,59,1489,606,151,757,41,798
公投第９案,新北市,淡水區,竿蓁里,60,1679,640,172,812,43,855
公投第９案,新北市,淡水區,竿蓁里,61,1693,622,179,801,39,840
公投第９案,新北市,淡水區,竿蓁里,62,1674,628,151,779,23,802
公投第９案,新北市,淡水區,竿蓁里,63,1330,547,149,696,28,724
公投第９案,新北市,淡水區,竿蓁里,64,1467,597,146,743,23,766
公投第９案,新北市,淡水區,崁頂里,65,1837,774,158,932,46,978
公投第９案,新北市,淡水區,崁頂里,66,1924,501,128,629,22,651
公投第９案,新北市,淡水區,崁頂里,67,2340,904,218,1122,35,1157
公投第９案,新北市,淡水區,崁頂里,68,1704,596,142,738,51,789
公投第９案,新北市,淡水區,崁頂里,69,1363,536,146,682,36,718
公投第９案,新北市,淡水區,崁頂里,70,3068,1122,233,1355,46,1401
公投第９案,新北市,淡水區,埤島里,71,1528,560,143,703,40,743
公投第９案,新北市,淡水區,水碓里,72,1600,568,175,743,59,802
公投第９案,新北市,淡水區,水碓里,73,1874,787,198,985,60,1045
公投第９案,新北市,淡水區,水碓里,74,1567,613,156,769,65,834
公投第９案,新北市,淡水區,北新里,75,1245,506,142,648,50,698
公投第９案,新北市,淡水區,北新里,76,1211,463,140,603,26,629
公投第９案,新北市,淡水區,正德里,77,1992,857,191,1048,44,1092
公投第９案,新北市,淡水區,正德里,78,2028,823,196,1019,47,1066
公投第９案,新北市,淡水區,新興里,79,1373,566,144,710,71,781
公投第９案,新北市,淡水區,新興里,80,1732,735,150,885,35,920
公投第９案,新北市,淡水區,新興里,81,1519,548,163,711,51,762
公投第９案,新北市,淡水區,新興里,82,1727,598,183,781,34,815
公投第９案,新北市,淡水區,新義里,83,1297,541,137,678,32,710
公投第９案,新北市,淡水區,新義里,84,1066,398,118,516,53,569
公投第９案,新北市,淡水區,新義里,85,1387,565,146,711,57,768
公投第９案,新北市,淡水區,新春里,86,1909,742,243,985,51,1036
公投第９案,新北市,淡水區,新春里,87,1770,685,215,900,47,947
公投第９案,新北市,淡水區,新春里,88,2049,768,152,920,57,977
公投第９案,新北市,淡水區,新春里,89,1680,683,183,866,39,905
公投第９案,新北市,淡水區,新民里,90,1433,602,183,785,60,845
公投第９案,新北市,淡水區,新民里,91,1365,534,155,689,32,721
公投第９案,新北市,淡水區,新民里,92,1452,652,156,808,49,857
公投第９案,新北市,淡水區,北投里,93,1804,753,165,918,45,963
公投第９案,新北市,淡水區,北投里,94,1322,500,160,660,41,701
公投第９案,新北市,淡水區,北投里,95,2019,798,203,1001,31,1032
公投第９案,新北市,淡水區,北投里,96,1696,737,197,934,48,982
公投第９案,新北市,淡水區,北投里,97,1576,655,191,846,32,878
公投第９案,新北市,淡水區,鄧公里,98,1781,747,203,950,43,993
公投第９案,新北市,淡水區,鄧公里,99,1665,706,216,922,48,970
公投第９案,新北市,淡水區,鄧公里,100,2013,768,238,1006,63,1069
公投第９案,新北市,淡水區,幸福里,101,1108,411,147,558,36,594
公投第９案,新北市,淡水區,幸福里,102,1305,531,133,664,49,713
公投第９案,新北市,淡水區,幸福里,103,1199,463,150,613,16,629
公投第９案,新北市,淡水區,學府里,104,2017,767,237,1004,60,1064
公投第９案,新北市,淡水區,學府里,105,2125,743,227,970,62,1032
公投第９案,新北市,淡水區,中興里,106,1289,436,133,569,29,598
公投第９案,新北市,淡水區,中興里,107,1319,583,151,734,49,783
公投第９案,新北市,淡水區,中興里,108,1051,435,109,544,24,568
公投第９案,新北市,淡水區,長庚里,109,1348,537,145,682,35,717
公投第９案,新北市,淡水區,清文里,110,1106,400,127,527,37,564
公投第９案,新北市,淡水區,草東里,111,717,301,89,390,28,418
公投第９案,新北市,淡水區,協元里,112,1385,517,163,680,34,714
公投第９案,新北市,淡水區,永吉里,113,841,342,124,466,36,502
公投第９案,新北市,淡水區,民安里,114,665,272,79,351,27,378
公投第９案,新北市,淡水區,新生里,115,419,173,58,231,19,250
公投第９案,新北市,淡水區,文化里,116,1599,660,185,845,29,874
公投第９案,新北市,淡水區,油車里,117,1670,642,188,830,50,880
公投第９案,新北市,淡水區,油車里,118,1683,689,207,896,55,951
公投第９案,新北市,淡水區,油車里,119,1577,565,167,732,59,791
公投第９案,新北市,淡水區,沙崙里,120,1618,598,167,765,51,816
公投第９案,新北市,淡水區,沙崙里,121,2214,785,198,983,45,1028
公投第９案,新北市,淡水區,大庄里,122,1832,694,198,892,55,947
公投第９案,新北市,淡水區,大庄里,123,2123,824,218,1042,66,1108
公投第９案,新北市,淡水區,大庄里,124,2998,1070,194,1264,27,1291
公投第９案,新北市,八里區,龍源里,125,1498,524,157,681,65,746
公投第９案,新北市,八里區,龍源里,126,1939,663,190,853,38,891
公投第９案,新北市,八里區,龍源里,127,1516,591,151,742,67,809
公投第９案,新北市,八里區,龍源里,128,1642,670,205,875,60,935
公投第９案,新北市,八里區,米倉里,129,1927,639,201,840,99,939
公投第９案,新北市,八里區,米倉里,130,1276,482,147,629,62,691
公投第９案,新北市,八里區,大崁里,131,1349,572,165,737,48,785
公投第９案,新北市,八里區,大崁里,132,1403,556,173,729,54,783
公投第９案,新北市,八里區,埤頭里,133,1644,644,193,837,50,887
公投第９案,新北市,八里區,埤頭里,134,1853,726,193,919,62,981
公投第９案,新北市,八里區,頂罟里,135,1793,753,210,963,80,1043
公投第９案,新北市,八里區,舊城里,136,1644,645,190,835,47,882
公投第９案,新北市,八里區,舊城里,137,1846,681,211,892,72,964
公投第９案,新北市,八里區,舊城里,138,1346,506,153,659,58,717
公投第９案,新北市,八里區,舊城里,139,1621,632,186,818,52,870
公投第９案,新北市,八里區,訊塘里,140,2110,670,197,867,74,941
公投第９案,新北市,八里區,訊塘里,141,1967,692,236,928,74,1002
公投第９案,新北市,八里區,荖阡里,142,1626,664,164,828,69,897
公投第９案,新北市,八里區,長坑里,143,1514,581,170,751,81,832
公投第９案,新北市,八里區,下罟里,144,1456,588,143,731,101,832
公投第９案,新北市,林口區,東林里,145,1268,439,174,613,63,676
公投第９案,新北市,林口區,東林里,146,1171,417,139,556,51,607
公投第９案,新北市,林口區,東林里,147,1218,512,134,646,52,698
公投第９案,新北市,林口區,林口里,148,1788,660,195,855,55,910
公投第９案,新北市,林口區,林口里,149,1625,554,198,752,69,821
公投第９案,新北市,林口區,林口里,150,1448,530,157,687,67,754
公投第９案,新北市,林口區,西林里,151,1328,467,135,602,81,683
公投第９案,新北市,林口區,西林里,152,1523,494,150,644,63,707
公投第９案,新北市,林口區,西林里,153,1245,521,123,644,40,684
公投第９案,新北市,林口區,西林里,154,1329,649,146,795,36,831
公投第９案,新北市,林口區,西林里,155,1465,642,173,815,42,857
公投第９案,新北市,林口區,西林里,156,1369,616,161,777,31,808
公投第９案,新北市,林口區,菁湖里,157,1346,559,172,731,57,788
公投第９案,新北市,林口區,菁湖里,158,1181,432,153,585,64,649
公投第９案,新北市,林口區,菁湖里,159,1291,671,98,769,27,796
公投第９案,新北市,林口區,中湖里,160,1213,494,131,625,48,673
公投第９案,新北市,林口區,中湖里,161,1256,577,122,699,35,734
公投第９案,新北市,林口區,中湖里,162,1185,435,157,592,52,644
公投第９案,新北市,林口區,湖北里,163,1361,514,166,680,56,736
公投第９案,新北市,林口區,湖南里,164,1756,733,133,866,29,895
公投第９案,新北市,林口區,湖南里,165,1676,683,142,825,40,865
公投第９案,新北市,林口區,湖南里,166,1540,694,150,844,25,869
公投第９案,新北市,林口區,湖南里,167,1569,695,116,811,37,848
公投第９案,新北市,林口區,湖南里,168,1514,643,159,802,35,837
公投第９案,新北市,林口區,湖南里,169,1193,538,128,666,26,692
公投第９案,新北市,林口區,湖南里,170,1610,713,174,887,29,916
公投第９案,新北市,林口區,湖南里,171,1338,604,130,734,39,773
公投第９案,新北市,林口區,湖南里,172,1141,480,136,616,35,651
公投第９案,新北市,林口區,湖南里,173,1307,559,146,705,33,738
公投第９案,新北市,林口區,湖南里,174,1327,587,146,733,29,762
公投第９案,新北市,林口區,湖南里,175,1285,577,133,710,34,744
公投第９案,新北市,林口區,南勢里,176,1481,638,153,791,38,829
公投第９案,新北市,林口區,南勢里,177,1510,685,152,837,23,860
公投第９案,新北市,林口區,南勢里,178,1785,717,191,908,42,950
公投第９案,新北市,林口區,南勢里,179,1792,750,191,941,29,970
公投第９案,新北市,林口區,南勢里,180,1517,678,147,825,31,856
公投第９案,新北市,林口區,南勢里,181,1564,703,165,868,31,899
公投第９案,新北市,林口區,南勢里,182,1560,725,140,865,30,895
公投第９案,新北市,林口區,南勢里,183,1544,643,158,801,38,839
公投第９案,新北市,林口區,南勢里,184,1593,673,147,820,38,858
公投第９案,新北市,林口區,南勢里,185,1431,629,138,767,35,802
公投第９案,新北市,林口區,仁愛里,186,1571,620,186,806,41,847
公投第９案,新北市,林口區,仁愛里,187,1439,628,165,793,35,828
公投第９案,新北市,林口區,仁愛里,188,1451,619,175,794,47,841
公投第９案,新北市,林口區,仁愛里,189,1391,625,172,797,43,840
公投第９案,新北市,林口區,麗林里,190,1461,634,153,787,24,811
公投第９案,新北市,林口區,麗林里,191,1691,697,177,874,20,894
公投第９案,新北市,林口區,麗林里,192,1524,629,170,799,49,848
公投第９案,新北市,林口區,麗林里,193,1343,658,147,805,33,838
公投第９案,新北市,林口區,麗林里,194,1398,648,159,807,32,839
公投第９案,新北市,林口區,東勢里,195,1380,613,165,778,40,818
公投第９案,新北市,林口區,東勢里,196,1367,551,161,712,53,765
公投第９案,新北市,林口區,東勢里,197,1350,565,159,724,42,766
公投第９案,新北市,林口區,東勢里,198,1194,526,130,656,43,699
公投第９案,新北市,林口區,麗園里,199,1344,543,134,677,60,737
公投第９案,新北市,林口區,麗園里,200,1154,486,130,616,35,651
公投第９案,新北市,林口區,麗園里,201,1119,525,132,657,37,694
公投第９案,新北市,林口區,頂福里,202,1026,329,129,458,44,502
公投第９案,新北市,林口區,下福里,203,1210,466,153,619,52,671
公投第９案,新北市,林口區,嘉寶里,204,912,335,112,447,66,513
公投第９案,新北市,林口區,瑞平里,205,824,324,115,439,36,475
公投第９案,新北市,林口區,太平里,206,1411,579,169,748,84,832
公投第９案,新北市,五股區,興珍里,207,1456,509,182,691,103,794
公投第９案,新北市,五股區,興珍里,208,1482,555,152,707,77,784
公投第９案,新北市,五股區,興珍里,209,1287,494,177,671,51,722
公投第９案,新北市,五股區,更寮里,210,1106,365,147,512,44,556
公投第９案,新北市,五股區,觀音里,211,1283,443,150,593,87,680
公投第９案,新北市,五股區,集福里,212,1833,752,107,859,63,922
公投第９案,新北市,五股區,集福里,213,1141,464,139,603,52,655
公投第９案,新北市,五股區,集福里,214,463,168,75,243,40,283
公投第９案,新北市,五股區,集賢里,215,1786,729,162,891,58,949
公投第９案,新北市,五股區,集賢里,216,1660,580,228,808,38,846
公投第９案,新北市,五股區,成德里,217,1534,556,202,758,84,842
公投第９案,新北市,五股區,成德里,218,1285,479,157,636,88,724
公投第９案,新北市,五股區,成州里,219,1832,623,217,840,125,965
公投第９案,新北市,五股區,成州里,220,1542,568,194,762,35,797
公投第９案,新北市,五股區,成州里,221,1897,625,181,806,51,857
公投第９案,新北市,五股區,成功里,222,1964,664,189,853,104,957
公投第９案,新北市,五股區,成功里,223,1779,587,211,798,87,885
公投第９案,新北市,五股區,成功里,224,1735,503,295,798,97,895
公投第９案,新北市,五股區,成泰里,225,2299,863,207,1070,55,1125
公投第９案,新北市,五股區,成泰里,226,1755,599,185,784,60,844
公投第９案,新北市,五股區,成泰里,227,1674,660,195,855,66,921
公投第９案,新北市,五股區,成泰里,228,1661,652,184,836,81,917
公投第９案,新北市,五股區,五龍里,229,1281,409,149,558,37,595
公投第９案,新北市,五股區,五福里,230,1566,579,189,768,75,843
公投第９案,新北市,五股區,五福里,231,1560,517,144,661,33,694
公投第９案,新北市,五股區,六福里,232,1622,642,170,812,49,861
公投第９案,新北市,五股區,六福里,233,1779,696,202,898,52,950
公投第９案,新北市,五股區,民義里,234,1487,526,170,696,74,770
公投第９案,新北市,五股區,民義里,235,1567,632,175,807,51,858
公投第９案,新北市,五股區,五股里,236,1333,353,125,478,41,519
公投第９案,新北市,五股區,五股里,237,1263,532,164,696,54,750
公投第９案,新北市,五股區,五股里,238,1314,507,175,682,80,762
公投第９案,新北市,五股區,德音里,239,1513,544,184,728,36,764
公投第９案,新北市,五股區,德音里,240,1517,599,174,773,46,819
公投第９案,新北市,五股區,德音里,241,1613,617,178,795,80,875
公投第９案,新北市,五股區,水碓里,242,1616,621,173,794,76,870
公投第９案,新北市,五股區,水碓里,243,1616,597,194,791,74,865
公投第９案,新北市,五股區,水碓里,244,1689,654,246,900,12,912
公投第９案,新北市,五股區,水碓里,245,1894,720,198,918,27,945
公投第９案,新北市,五股區,福德里,246,1210,531,166,697,65,762
公投第９案,新北市,五股區,福德里,247,1643,632,161,793,55,848
公投第９案,新北市,五股區,德泰里,248,1441,571,144,715,27,742
公投第９案,新北市,五股區,德泰里,249,1305,574,119,693,58,751
公投第９案,新北市,五股區,德泰里,250,1170,501,164,665,55,720
公投第９案,新北市,五股區,貿商里,251,1397,655,133,788,63,851
公投第９案,新北市,五股區,貿商里,252,1312,618,110,728,60,788
公投第９案,新北市,五股區,陸一里,253,1127,460,88,548,25,573
公投第９案,新北市,五股區,陸一里,254,1154,478,83,561,40,601
公投第９案,新北市,泰山區,大科里,255,643,218,77,295,33,328
公投第９案,新北市,泰山區,大科里,256,186,88,19,107,7,114
公投第９案,新北市,泰山區,黎明里,257,1457,540,144,684,44,728
公投第９案,新北市,泰山區,黎明里,258,1594,644,181,825,65,890
公投第９案,新北市,泰山區,山腳里,259,1598,606,136,742,60,802
公投第９案,新北市,泰山區,山腳里,260,1503,574,140,714,37,751
公投第９案,新北市,泰山區,山腳里,261,1436,541,137,678,70,748
公投第９案,新北市,泰山區,山腳里,262,1384,549,160,709,53,762
公投第９案,新北市,泰山區,福泰里,263,1231,486,147,633,55,688
公投第９案,新北市,泰山區,福泰里,264,1295,500,132,632,30,662
公投第９案,新北市,泰山區,福興里,265,1563,654,181,835,62,897
公投第９案,新北市,泰山區,福興里,266,1610,700,169,869,64,933
公投第９案,新北市,泰山區,楓樹里,267,1253,512,133,645,32,677
公投第９案,新北市,泰山區,楓樹里,268,1294,484,134,618,46,664
公投第９案,新北市,泰山區,楓樹里,269,1354,558,193,751,38,789
公投第９案,新北市,泰山區,同榮里,270,1259,503,135,638,38,676
公投第９案,新北市,泰山區,同榮里,271,1252,520,153,673,22,695
公投第９案,新北市,泰山區,同榮里,272,1094,406,131,537,27,564
公投第９案,新北市,泰山區,同興里,273,1590,642,191,833,57,890
公投第９案,新北市,泰山區,同興里,274,1634,616,222,838,69,907
公投第９案,新北市,泰山區,全興里,275,1536,535,154,689,40,729
公投第９案,新北市,泰山區,全興里,276,1534,669,169,838,45,883
公投第９案,新北市,泰山區,全興里,277,1545,751,139,890,58,948
公投第９案,新北市,泰山區,全興里,278,1399,608,125,733,49,782
公投第９案,新北市,泰山區,全興里,279,1315,522,145,667,29,696
公投第９案,新北市,泰山區,義學里,280,1201,510,161,671,59,730
公投第９案,新北市,泰山區,義學里,281,1182,427,163,590,65,655
公投第９案,新北市,泰山區,義學里,282,1665,644,154,798,75,873
公投第９案,新北市,泰山區,義仁里,283,1855,701,233,934,75,1009
公投第９案,新北市,泰山區,義仁里,284,1866,719,219,938,89,1027
公投第９案,新北市,泰山區,義仁里,285,1935,768,209,977,54,1031
公投第９案,新北市,泰山區,義仁里,286,1589,618,151,769,49,818
公投第９案,新北市,泰山區,明志里,287,1152,439,119,558,41,599
公投第９案,新北市,泰山區,明志里,288,1114,432,148,580,45,625
公投第９案,新北市,泰山區,明志里,289,1040,454,145,599,48,647
公投第９案,新北市,泰山區,泰友里,290,1003,437,118,555,43,598
公投第９案,新北市,泰山區,泰友里,291,975,417,129,546,24,570
公投第９案,新北市,泰山區,新明里,292,1440,571,175,746,40,786
公投第９案,新北市,泰山區,新明里,293,1480,580,161,741,22,763
公投第９案,新北市,泰山區,貴子里,294,1211,480,153,633,41,674
公投第９案,新北市,泰山區,貴子里,295,1237,503,143,646,23,669
公投第９案,新北市,泰山區,貴子里,296,1069,428,111,539,38,577
公投第９案,新北市,泰山區,貴賢里,297,1680,734,180,914,72,986
公投第９案,新北市,泰山區,貴賢里,298,1651,678,188,866,45,911
公投第９案,新北市,泰山區,貴和里,299,1420,568,124,692,35,727
公投第９案,新北市,泰山區,貴和里,300,1337,567,153,720,39,759
公投第９案,新北市,泰山區,貴和里,301,1591,650,93,743,43,786
公投第９案,新北市,新莊區,海山里,302,1123,452,142,594,66,660
公投第９案,新北市,新莊區,海山里,303,1278,513,180,693,73,766
公投第９案,新北市,新莊區,海山里,304,1163,524,150,674,62,736
公投第９案,新北市,新莊區,海山里,305,1228,523,178,701,55,756
公投第９案,新北市,新莊區,全安里,306,1211,468,187,655,55,710
公投第９案,新北市,新莊區,全安里,307,1176,492,158,650,55,705
公投第９案,新北市,新莊區,全安里,308,1536,681,195,876,55,931
公投第９案,新北市,新莊區,全泰里,309,1486,707,165,872,59,931
公投第９案,新北市,新莊區,全泰里,310,1513,692,206,898,75,973
公投第９案,新北市,新莊區,全泰里,311,1395,613,202,815,74,889
公投第９案,新北市,新莊區,忠孝里,312,1353,560,132,692,82,774
公投第９案,新北市,新莊區,忠孝里,313,1409,612,195,807,64,871
公投第９案,新北市,新莊區,忠孝里,314,1478,614,147,761,42,803
公投第９案,新北市,新莊區,文衡里,315,921,379,143,522,53,575
公投第９案,新北市,新莊區,文衡里,316,971,417,146,563,48,611
公投第９案,新北市,新莊區,文聖里,317,1534,709,170,879,84,963
公投第９案,新北市,新莊區,文聖里,318,1516,620,162,782,47,829
公投第９案,新北市,新莊區,興漢里,319,697,265,105,370,38,408
公投第９案,新北市,新莊區,興漢里,320,1235,547,119,666,37,703
公投第９案,新北市,新莊區,興漢里,321,1138,454,146,600,45,645
公投第９案,新北市,新莊區,榮和里,322,1063,392,135,527,27,554
公投第９案,新北市,新莊區,榮和里,323,3399,587,190,777,65,842
公投第９案,新北市,新莊區,文德里,324,1575,660,190,850,83,933
公投第９案,新北市,新莊區,文明里,325,1615,690,234,924,73,997
公投第９案,新北市,新莊區,化成里,326,1612,569,200,769,81,850
公投第９案,新北市,新莊區,化成里,327,1514,582,174,756,81,837
公投第９案,新北市,新莊區,頭前里,328,1382,482,167,649,36,685
公投第９案,新北市,新莊區,頭前里,329,1475,598,177,775,51,826
公投第９案,新北市,新莊區,頭前里,330,1462,626,170,796,31,827
公投第９案,新北市,新莊區,頭前里,331,1426,587,159,746,42,788
公投第９案,新北市,新莊區,頭前里,332,1421,540,189,729,60,789
公投第９案,新北市,新莊區,福基里,333,1536,632,171,803,48,851
公投第９案,新北市,新莊區,福基里,334,1587,671,198,869,46,915
公投第９案,新北市,新莊區,福基里,335,749,285,85,370,18,388
公投第９案,新北市,新莊區,福興里,336,1276,567,153,720,47,767
公投第９案,新北市,新莊區,福興里,337,1303,493,159,652,47,699
公投第９案,新北市,新莊區,福興里,338,1259,555,168,723,57,780
公投第９案,新北市,新莊區,福興里,339,1291,568,154,722,56,778
公投第９案,新北市,新莊區,昌平里,340,1493,660,158,818,30,848
公投第９案,新北市,新莊區,昌平里,341,1507,628,195,823,53,876
公投第９案,新北市,新莊區,昌平里,342,1456,604,174,778,17,795
公投第９案,新北市,新莊區,昌平里,343,1396,579,177,756,27,783
公投第９案,新北市,新莊區,和平里,344,1351,503,126,629,56,685
公投第９案,新北市,新莊區,和平里,345,1403,546,182,728,69,797
公投第９案,新北市,新莊區,和平里,346,1497,587,172,759,74,833
公投第９案,新北市,新莊區,幸福里,347,1272,529,148,677,94,771
公投第９案,新北市,新莊區,幸福里,348,1269,447,130,577,47,624
公投第９案,新北市,新莊區,幸福里,349,1335,532,187,719,69,788
公投第９案,新北市,新莊區,昌隆里,350,1300,574,146,720,38,758
公投第９案,新北市,新莊區,昌隆里,351,1286,587,156,743,39,782
公投第９案,新北市,新莊區,昌隆里,352,1255,619,160,779,49,828
公投第９案,新北市,新莊區,信義里,353,1558,611,194,805,96,901
公投第９案,新北市,新莊區,信義里,354,1567,620,159,779,73,852
公投第９案,新北市,新莊區,信義里,355,1603,692,174,866,0,866
公投第９案,新北市,新莊區,昌信里,356,1538,641,170,811,43,854
公投第９案,新北市,新莊區,昌信里,357,1671,700,193,893,58,951
公投第９案,新北市,新莊區,昌明里,358,1698,651,186,837,39,876
公投第９案,新北市,新莊區,昌明里,359,1545,667,213,880,57,937
公投第９案,新北市,新莊區,仁義里,360,1696,696,207,903,127,1030
公投第９案,新北市,新莊區,仁義里,361,1626,623,179,802,87,889
公投第９案,新北市,新莊區,仁愛里,362,1170,428,168,596,76,672
公投第９案,新北市,新莊區,仁愛里,363,1236,473,145,618,100,718
公投第９案,新北市,新莊區,自信里,364,1071,419,118,537,62,599
公投第９案,新北市,新莊區,自信里,365,1129,437,152,589,56,645
公投第９案,新北市,新莊區,自立里,366,1586,647,222,869,50,919
公投第９案,新北市,新莊區,自立里,367,1597,573,185,758,68,826
公投第９案,新北市,新莊區,自立里,368,1573,536,173,709,107,816
公投第９案,新北市,新莊區,自強里,369,1225,456,138,594,45,639
公投第９案,新北市,新莊區,自強里,370,1217,450,116,566,45,611
公投第９案,新北市,新莊區,思源里,371,1571,613,189,802,84,886
公投第９案,新北市,新莊區,思源里,372,1594,627,169,796,64,860
公投第９案,新北市,新莊區,思源里,373,1583,626,174,800,62,862
公投第９案,新北市,新莊區,思賢里,374,1245,551,145,696,58,754
公投第９案,新北市,新莊區,思賢里,375,1203,370,163,533,47,580
公投第９案,新北市,新莊區,思賢里,376,1265,592,156,748,53,801
公投第９案,新北市,新莊區,中華里,377,1255,529,149,678,72,750
公投第９案,新北市,新莊區,中華里,378,1287,559,149,708,38,746
公投第９案,新北市,新莊區,中美里,379,1167,500,178,678,54,732
公投第９案,新北市,新莊區,中美里,380,1299,502,169,671,70,741
公投第９案,新北市,新莊區,中美里,381,1207,497,151,648,50,698
公投第９案,新北市,新莊區,中美里,382,1415,612,152,764,62,826
公投第９案,新北市,新莊區,恆安里,383,1342,537,173,710,72,782
公投第９案,新北市,新莊區,恆安里,384,1341,515,186,701,79,780
公投第９案,新北市,新莊區,恆安里,385,1247,476,161,637,78,715
公投第９案,新北市,新莊區,立人里,386,984,506,108,614,34,648
公投第９案,新北市,新莊區,立人里,387,1043,467,125,592,52,644
公投第９案,新北市,新莊區,立德里,388,1135,538,171,709,45,754
公投第９案,新北市,新莊區,立德里,389,1185,502,142,644,43,687
公投第９案,新北市,新莊區,中和里,390,1346,553,171,724,51,775
公投第９案,新北市,新莊區,中和里,391,1372,575,168,743,75,818
公投第９案,新北市,新莊區,中和里,392,1350,566,193,759,69,828
公投第９案,新北市,新莊區,中泰里,393,1307,479,159,638,82,720
公投第９案,新北市,新莊區,中泰里,394,1353,533,151,684,89,773
公投第９案,新北市,新莊區,中泰里,395,1287,491,187,678,83,761
公投第９案,新北市,新莊區,中宏里,396,1567,516,144,660,33,693
公投第９案,新北市,新莊區,中宏里,397,1709,624,203,827,85,912
公投第９案,新北市,新莊區,中全里,398,1616,595,147,742,43,785
公投第９案,新北市,新莊區,中全里,399,1628,583,162,745,69,814
公投第９案,新北市,新莊區,立志里,400,1148,474,166,640,71,711
公投第９案,新北市,新莊區,立志里,401,1201,492,150,642,10,652
公投第９案,新北市,新莊區,立志里,402,1135,527,147,674,56,730
公投第９案,新北市,新莊區,立廷里,403,1495,647,205,852,69,921
公投第９案,新北市,新莊區,立廷里,404,1486,663,190,853,63,916
公投第９案,新北市,新莊區,立廷里,405,1483,696,174,870,45,915
公投第９案,新北市,新莊區,立廷里,406,1553,643,156,799,52,851
公投第９案,新北市,新莊區,立廷里,407,1625,781,181,962,38,1000
公投第９案,新北市,新莊區,立廷里,408,1671,723,181,904,27,931
公投第９案,新北市,新莊區,立基里,409,1389,623,180,803,64,867
公投第９案,新北市,新莊區,立基里,410,1272,548,144,692,41,733
公投第９案,新北市,新莊區,立基里,411,1409,681,149,830,48,878
公投第９案,新北市,新莊區,立基里,412,1372,596,206,802,40,842
公投第９案,新北市,新莊區,中誠里,413,955,382,122,504,56,560
公投第９案,新北市,新莊區,中誠里,414,952,341,130,471,68,539
公投第９案,新北市,新莊區,中港里,415,1412,569,174,743,37,780
公投第９案,新北市,新莊區,中港里,416,1415,568,182,750,73,823
公投第９案,新北市,新莊區,中港里,417,1421,602,190,792,61,853
公投第９案,新北市,新莊區,中港里,418,1293,595,164,759,54,813
公投第９案,新北市,新莊區,中信里,419,1475,541,181,722,30,752
公投第９案,新北市,新莊區,中信里,420,1429,595,143,738,78,816
公投第９案,新北市,新莊區,中信里,421,1481,620,158,778,66,844
公投第９案,新北市,新莊區,中信里,422,1472,643,155,798,78,876
公投第９案,新北市,新莊區,中信里,423,1474,647,178,825,39,864
公投第９案,新北市,新莊區,中平里,424,1462,631,185,816,22,838
公投第９案,新北市,新莊區,中平里,425,1484,660,184,844,37,881
公投第９案,新北市,新莊區,中平里,426,1461,627,165,792,47,839
公投第９案,新北市,新莊區,中平里,427,1444,656,162,818,34,852
公投第９案,新北市,新莊區,中平里,428,1437,649,162,811,29,840
公投第９案,新北市,新莊區,中原里,429,1641,615,170,785,45,830
公投第９案,新北市,新莊區,中原里,430,1633,618,185,803,41,844
公投第９案,新北市,新莊區,中原里,431,1531,668,162,830,27,857
公投第９案,新北市,新莊區,中原里,432,1517,674,176,850,55,905
公投第９案,新北市,新莊區,中原里,433,1487,602,170,772,47,819
公投第９案,新北市,新莊區,中原里,434,1560,656,183,839,46,885
公投第９案,新北市,新莊區,中隆里,435,1584,620,193,813,75,888
公投第９案,新北市,新莊區,中隆里,436,1602,666,165,831,34,865
公投第９案,新北市,新莊區,中隆里,437,818,316,117,433,53,486
公投第９案,新北市,新莊區,立功里,438,1633,552,162,714,64,778
公投第９案,新北市,新莊區,立功里,439,1652,613,203,816,68,884
公投第９案,新北市,新莊區,立泰里,440,1498,603,161,764,66,830
公投第９案,新北市,新莊區,立泰里,441,1379,529,155,684,47,731
公投第９案,新北市,新莊區,立泰里,442,1381,587,169,756,50,806
公投第９案,新北市,新莊區,立言里,443,1535,661,168,829,76,905
公投第９案,新北市,新莊區,立言里,444,1492,742,193,935,61,996
公投第９案,新北市,新莊區,立言里,445,1450,646,173,819,94,913
公投第９案,新北市,新莊區,豐年里,446,1107,438,150,588,66,654
公投第９案,新北市,新莊區,豐年里,447,1063,465,151,616,53,669
公投第９案,新北市,新莊區,豐年里,448,1143,455,155,610,56,666
公投第９案,新北市,新莊區,國泰里,449,1341,496,139,635,118,753
公投第９案,新北市,新莊區,泰豐里,450,1063,439,134,573,50,623
公投第９案,新北市,新莊區,泰豐里,451,1096,445,163,608,50,658
公投第９案,新北市,新莊區,瓊林里,452,1309,540,167,707,41,748
公投第９案,新北市,新莊區,瓊林里,453,1216,509,174,683,49,732
公投第９案,新北市,新莊區,瓊林里,454,1278,503,137,640,48,688
公投第９案,新北市,新莊區,瓊林里,455,1352,502,198,700,74,774
公投第９案,新北市,新莊區,福營里,456,1298,462,157,619,59,678
公投第９案,新北市,新莊區,福營里,457,1042,425,128,553,59,612
公投第９案,新北市,新莊區,營盤里,458,881,329,113,442,25,467
公投第９案,新北市,新莊區,營盤里,459,1109,491,183,674,43,717
公投第９案,新北市,新莊區,丹鳳里,460,1291,476,177,653,64,717
公投第９案,新北市,新莊區,丹鳳里,461,1293,519,139,658,29,687
公投第９案,新北市,新莊區,丹鳳里,462,1336,533,186,719,68,787
公投第９案,新北市,新莊區,丹鳳里,463,1384,556,137,693,46,739
公投第９案,新北市,新莊區,丹鳳里,464,1231,476,105,581,29,610
公投第９案,新北市,新莊區,丹鳳里,465,940,399,92,491,31,522
公投第９案,新北市,新莊區,合鳳里,466,1369,474,182,656,110,766
公投第９案,新北市,新莊區,合鳳里,467,1384,546,164,710,66,776
公投第９案,新北市,新莊區,合鳳里,468,1272,509,159,668,73,741
公投第９案,新北市,新莊區,祥鳳里,469,1073,471,128,599,38,637
公投第９案,新北市,新莊區,祥鳳里,470,1058,440,122,562,37,599
公投第９案,新北市,新莊區,雙鳳里,471,1528,635,166,801,26,827
公投第９案,新北市,新莊區,雙鳳里,472,1244,513,119,632,46,678
公投第９案,新北市,新莊區,雙鳳里,473,1356,536,135,671,54,725
公投第９案,新北市,新莊區,雙鳳里,474,1164,487,93,580,30,610
公投第９案,新北市,新莊區,雙鳳里,475,1423,612,159,771,69,840
公投第９案,新北市,新莊區,雙鳳里,476,1250,566,170,736,38,774
公投第９案,新北市,新莊區,雙鳳里,477,1252,508,148,656,30,686
公投第９案,新北市,新莊區,龍福里,478,1022,422,121,543,21,564
公投第９案,新北市,新莊區,龍福里,479,959,392,126,518,44,562
公投第９案,新北市,新莊區,龍鳳里,480,1646,689,215,904,52,956
公投第９案,新北市,新莊區,龍鳳里,481,1551,609,169,778,66,844
公投第９案,新北市,新莊區,龍鳳里,482,1526,639,203,842,60,902
公投第９案,新北市,新莊區,龍鳳里,483,1518,630,184,814,36,850
公投第９案,新北市,新莊區,龍鳳里,484,1547,697,164,861,42,903
公投第９案,新北市,新莊區,裕民里,485,1505,564,170,734,93,827
公投第９案,新北市,新莊區,裕民里,486,1527,553,186,739,84,823
公投第９案,新北市,新莊區,裕民里,487,1482,532,189,721,59,780
公投第９案,新北市,新莊區,裕民里,488,1586,571,173,744,76,820
公投第９案,新北市,新莊區,龍安里,489,1065,392,140,532,89,621
公投第９案,新北市,新莊區,龍安里,490,1040,476,138,614,56,670
公投第９案,新北市,新莊區,富國里,491,1090,408,151,559,52,611
公投第９案,新北市,新莊區,富國里,492,1071,437,137,574,50,624
公投第９案,新北市,新莊區,富民里,493,1704,632,177,809,40,849
公投第９案,新北市,新莊區,富民里,494,1698,666,141,807,36,843
公投第９案,新北市,新莊區,後德里,495,1362,612,176,788,63,851
公投第９案,新北市,新莊區,後德里,496,1350,570,171,741,42,783
公投第９案,新北市,新莊區,萬安里,497,1689,690,189,879,82,961
公投第９案,新北市,新莊區,萬安里,498,1612,631,201,832,101,933
公投第９案,新北市,新莊區,建福里,499,1130,473,140,613,58,671
公投第９案,新北市,新莊區,建福里,500,1111,461,162,623,72,695
公投第９案,新北市,新莊區,後港里,501,1539,626,155,781,44,825
公投第９案,新北市,新莊區,後港里,502,1586,629,213,842,43,885
公投第９案,新北市,新莊區,後港里,503,1631,673,186,859,73,932
公投第９案,新北市,新莊區,後港里,504,1540,616,180,796,59,855
公投第９案,新北市,新莊區,四維里,505,1388,473,166,639,57,696
公投第９案,新北市,新莊區,四維里,506,1388,461,165,626,89,715
公投第９案,新北市,新莊區,四維里,507,1387,485,143,628,63,691
公投第９案,新北市,新莊區,南港里,508,1181,467,120,587,44,631
公投第９案,新北市,新莊區,南港里,509,1135,432,169,601,62,663
公投第９案,新北市,新莊區,南港里,510,1173,452,162,614,58,672
公投第９案,新北市,新莊區,南港里,511,1215,524,139,663,41,704
公投第９案,新北市,新莊區,建安里,512,1488,636,183,819,47,866
公投第９案,新北市,新莊區,建安里,513,1444,623,163,786,47,833
公投第９案,新北市,新莊區,建安里,514,1499,604,179,783,44,827
公投第９案,新北市,新莊區,建安里,515,1449,601,168,769,31,800
公投第９案,新北市,新莊區,民全里,516,1640,646,192,838,81,919
公投第９案,新北市,新莊區,民全里,517,1648,647,182,829,73,902
公投第９案,新北市,新莊區,八德里,518,1371,513,148,661,61,722
公投第９案,新北市,新莊區,八德里,519,1400,517,188,705,66,771
公投第９案,新北市,新莊區,成德里,520,1457,578,163,741,77,818
公投第９案,新北市,新莊區,成德里,521,1502,549,190,739,83,822
公投第９案,新北市,新莊區,成德里,522,1412,539,168,707,78,785
公投第９案,新北市,新莊區,民安里,523,1318,509,146,655,76,731
公投第９案,新北市,新莊區,民安里,524,1411,626,146,772,49,821
公投第９案,新北市,新莊區,民安里,525,1262,540,153,693,35,728
公投第９案,新北市,新莊區,民安里,526,1228,583,123,706,38,744
公投第９案,新北市,新莊區,民有里,527,1748,760,176,936,73,1009
公投第９案,新北市,新莊區,民有里,528,1761,742,209,951,76,1027
公投第９案,新北市,新莊區,民本里,529,1326,495,147,642,61,703
公投第９案,新北市,新莊區,民本里,530,1344,471,147,618,52,670
公投第９案,新北市,新莊區,光明里,531,1355,552,157,709,56,765
公投第９案,新北市,新莊區,光明里,532,1306,521,163,684,73,757
公投第９案,新北市,新莊區,光明里,533,1349,598,162,760,38,798
公投第９案,新北市,新莊區,光正里,534,1265,528,139,667,42,709
公投第９案,新北市,新莊區,光正里,535,1282,565,147,712,63,775
公投第９案,新北市,新莊區,光正里,536,1237,562,118,680,65,745
公投第９案,新北市,新莊區,光榮里,537,1301,556,129,685,27,712
公投第９案,新北市,新莊區,光榮里,538,1262,539,135,674,50,724
公投第９案,新北市,新莊區,光榮里,539,1270,546,141,687,45,732
公投第９案,新北市,新莊區,光和里,540,1245,479,181,660,64,724
公投第９案,新北市,新莊區,光和里,541,1220,459,152,611,74,685
公投第９案,新北市,新莊區,光華里,542,1245,443,162,605,44,649
公投第９案,新北市,新莊區,光華里,543,1212,462,130,592,50,642
公投第９案,新北市,新莊區,光華里,544,1253,457,160,617,69,686
公投第９案,新北市,新莊區,光華里,545,1272,476,145,621,56,677
公投第９案,新北市,新莊區,光華里,546,1227,553,130,683,41,724
公投第９案,新北市,新莊區,西盛里,547,1126,489,139,628,46,674
公投第９案,新北市,新莊區,西盛里,548,1240,530,147,677,42,719
公投第９案,新北市,新莊區,西盛里,549,1460,610,175,785,45,830
公投第９案,新北市,新莊區,西盛里,550,1072,435,122,557,43,600
公投第９案,新北市,新莊區,西盛里,551,1127,404,123,527,38,565
公投第９案,新北市,新莊區,西盛里,552,1332,584,158,742,31,773
公投第９案,新北市,新莊區,西盛里,553,1341,527,134,661,21,682
公投第９案,新北市,新莊區,西盛里,554,1140,349,102,451,27,478
公投第９案,新北市,蘆洲區,光華里,555,1600,612,216,828,90,918
公投第９案,新北市,蘆洲區,光華里,556,1549,603,186,789,71,860
公投第９案,新北市,蘆洲區,光華里,557,1516,597,191,788,99,887
公投第９案,新北市,蘆洲區,光明里,558,1404,536,148,684,90,774
公投第９案,新北市,蘆洲區,光明里,559,1381,506,161,667,87,754
公投第９案,新北市,蘆洲區,光明里,560,1485,639,149,788,50,838
公投第９案,新北市,蘆洲區,中路里,561,1779,504,139,643,31,674
公投第９案,新北市,蘆洲區,中路里,562,1797,687,202,889,58,947
公投第９案,新北市,蘆洲區,永安里,563,1364,533,179,712,78,790
公投第９案,新北市,蘆洲區,永安里,564,1635,665,186,851,59,910
公投第９案,新北市,蘆洲區,永安里,565,1567,548,151,699,45,744
公投第９案,新北市,蘆洲區,九芎里,566,1524,590,164,754,56,810
公投第９案,新北市,蘆洲區,九芎里,567,1612,592,169,761,66,827
公投第９案,新北市,蘆洲區,九芎里,568,1674,613,189,802,53,855
公投第９案,新北市,蘆洲區,延平里,569,1838,639,217,856,62,918
公投第９案,新北市,蘆洲區,延平里,570,1814,599,180,779,52,831
公投第９案,新北市,蘆洲區,中華里,571,1473,525,237,762,46,808
公投第９案,新北市,蘆洲區,中華里,572,1465,588,141,729,56,785
公投第９案,新北市,蘆洲區,中原里,573,1652,660,216,876,75,951
公投第９案,新北市,蘆洲區,中原里,574,1650,619,192,811,100,911
公投第９案,新北市,蘆洲區,中原里,575,1656,727,152,879,39,918
公投第９案,新北市,蘆洲區,長安里,576,1571,556,206,762,59,821
公投第９案,新北市,蘆洲區,長安里,577,1523,551,189,740,79,819
公投第９案,新北市,蘆洲區,長安里,578,1475,575,163,738,51,789
公投第９案,新北市,蘆洲區,忠義里,579,1367,505,149,654,66,720
公投第９案,新北市,蘆洲區,忠義里,580,1514,609,189,798,63,861
公投第９案,新北市,蘆洲區,正義里,581,1791,748,244,992,56,1048
公投第９案,新北市,蘆洲區,正義里,582,1714,790,190,980,61,1041
公投第９案,新北市,蘆洲區,正義里,583,1780,780,189,969,41,1010
公投第９案,新北市,蘆洲區,正義里,584,1713,718,192,910,43,953
公投第９案,新北市,蘆洲區,正義里,585,1720,749,186,935,53,988
公投第９案,新北市,蘆洲區,正義里,586,1766,744,185,929,42,971
公投第９案,新北市,蘆洲區,南港里,587,1623,639,167,806,73,879
公投第９案,新北市,蘆洲區,南港里,588,1740,681,216,897,52,949
公投第９案,新北市,蘆洲區,南港里,589,1759,721,219,940,76,1016
公投第９案,新北市,蘆洲區,永樂里,590,1775,704,236,940,86,1026
公投第９案,新北市,蘆洲區,永樂里,591,1909,789,231,1020,69,1089
公投第９案,新北市,蘆洲區,永樂里,592,1805,720,237,957,95,1052
公投第９案,新北市,蘆洲區,成功里,593,1642,635,179,814,55,869
公投第９案,新北市,蘆洲區,成功里,594,1713,669,197,866,50,916
公投第９案,新北市,蘆洲區,成功里,595,1746,630,189,819,80,899
公投第９案,新北市,蘆洲區,成功里,596,1596,617,198,815,59,874
公投第９案,新北市,蘆洲區,永康里,597,1434,557,141,698,58,756
公投第９案,新北市,蘆洲區,永康里,598,1450,542,180,722,76,798
公投第９案,新北市,蘆洲區,永康里,599,1543,576,171,747,25,772
公投第９案,新北市,蘆洲區,永康里,600,1525,602,172,774,45,819
公投第９案,新北市,蘆洲區,永德里,601,1419,480,177,657,77,734
公投第９案,新北市,蘆洲區,永德里,602,1298,530,160,690,50,740
公投第９案,新北市,蘆洲區,永德里,603,1304,483,149,632,74,706
公投第９案,新北市,蘆洲區,樓厝里,604,1806,670,217,887,74,961
公投第９案,新北市,蘆洲區,樓厝里,605,1910,675,235,910,85,995
公投第９案,新北市,蘆洲區,樓厝里,606,1873,620,180,800,63,863
公投第９案,新北市,蘆洲區,信義里,607,1785,621,178,799,49,848
公投第９案,新北市,蘆洲區,信義里,608,1760,578,223,801,69,870
公投第９案,新北市,蘆洲區,玉清里,609,1841,755,204,959,68,1027
公投第９案,新北市,蘆洲區,玉清里,610,1855,682,187,869,48,917
公投第９案,新北市,蘆洲區,玉清里,611,1450,480,173,653,77,730
公投第９案,新北市,蘆洲區,復興里,612,1585,555,195,750,81,831
公投第９案,新北市,蘆洲區,復興里,613,1541,498,151,649,127,776
公投第９案,新北市,蘆洲區,福安里,614,1626,605,190,795,74,869
公投第９案,新北市,蘆洲區,福安里,615,1241,500,144,644,71,715
公投第９案,新北市,蘆洲區,鷺江里,616,1634,611,201,812,71,883
公投第９案,新北市,蘆洲區,鷺江里,617,1573,597,198,795,70,865
公投第９案,新北市,蘆洲區,鷺江里,618,1619,638,221,859,52,911
公投第９案,新北市,蘆洲區,恆德里,619,1878,664,200,864,90,954
公投第９案,新北市,蘆洲區,恆德里,620,1797,645,224,869,95,964
公投第９案,新北市,蘆洲區,恆德里,621,1816,747,224,971,40,1011
公投第９案,新北市,蘆洲區,溪墘里,622,1344,523,196,719,77,796
公投第９案,新北市,蘆洲區,溪墘里,623,1492,579,235,814,62,876
公投第９案,新北市,蘆洲區,仁復里,624,1959,690,233,923,124,1047
公投第９案,新北市,蘆洲區,仁德里,625,1611,563,216,779,104,883
公投第９案,新北市,蘆洲區,仁德里,626,1574,669,57,726,77,803
公投第９案,新北市,蘆洲區,仁德里,627,1653,647,203,850,79,929
公投第９案,新北市,蘆洲區,仁義里,628,3085,753,240,993,61,1054
公投第９案,新北市,蘆洲區,仁義里,629,1812,647,249,896,71,967
公投第９案,新北市,蘆洲區,得勝里,630,1332,501,169,670,63,733
公投第９案,新北市,蘆洲區,得勝里,631,1648,541,168,709,88,797
公投第９案,新北市,蘆洲區,得仁里,632,1355,514,147,661,30,691
公投第９案,新北市,蘆洲區,得仁里,633,1371,497,160,657,50,707
公投第９案,新北市,蘆洲區,保和里,634,1111,417,160,577,63,640
公投第９案,新北市,蘆洲區,保和里,635,1176,438,155,593,103,696
公投第９案,新北市,蘆洲區,樹德里,636,1602,624,200,824,64,888
公投第９案,新北市,蘆洲區,樹德里,637,1361,476,161,637,56,693
公投第９案,新北市,蘆洲區,民和里,638,1530,584,174,758,66,824
公投第９案,新北市,蘆洲區,民和里,639,925,340,115,455,72,527
公投第９案,新北市,蘆洲區,水湳里,640,1851,694,213,907,85,992
公投第９案,新北市,蘆洲區,水湳里,641,1791,620,189,809,67,876
公投第９案,新北市,蘆洲區,水湳里,642,1853,631,208,839,81,920
公投第９案,新北市,蘆洲區,水湳里,643,1758,628,181,809,49,858
公投第９案,新北市,蘆洲區,水湳里,644,1798,700,198,898,70,968
公投第９案,新北市,蘆洲區,水河里,645,1645,660,184,844,66,910
公投第９案,新北市,蘆洲區,水河里,646,1612,548,180,728,64,792
公投第９案,新北市,蘆洲區,水河里,647,1784,591,171,762,93,855
公投第９案,新北市,蘆洲區,水河里,648,1701,538,177,715,73,788
公投第９案,新北市,蘆洲區,水河里,649,1581,587,171,758,51,809
公投第９案,新北市,蘆洲區,仁愛里,650,1534,568,204,772,71,843
公投第９案,新北市,蘆洲區,仁愛里,651,1620,640,218,858,70,928
公投第９案,新北市,蘆洲區,仁愛里,652,1494,635,176,811,76,887
公投第９案,新北市,蘆洲區,忠孝里,653,1183,471,143,614,42,656
公投第９案,新北市,蘆洲區,忠孝里,654,985,387,131,518,52,570
公投第９案,新北市,蘆洲區,保佑里,655,1673,607,182,789,77,866
公投第９案,新北市,蘆洲區,保佑里,656,1688,640,206,846,96,942
公投第９案,新北市,蘆洲區,保新里,657,1249,483,150,633,49,682
公投第９案,新北市,蘆洲區,保新里,658,1476,541,161,702,76,778
公投第９案,新北市,三重區,大有里,659,1509,564,168,732,75,807
公投第９案,新北市,三重區,大有里,660,1591,663,198,861,68,929
公投第９案,新北市,三重區,大有里,661,1653,640,238,878,70,948
公投第９案,新北市,三重區,博愛里,662,1392,558,185,743,81,824
公投第９案,新北市,三重區,博愛里,663,1451,594,186,780,99,879
公投第９案,新北市,三重區,博愛里,664,1329,479,199,678,87,765
公投第９案,新北市,三重區,二重里,665,1459,589,196,785,47,832
公投第９案,新北市,三重區,頂崁里,666,1024,418,131,549,68,617
公投第９案,新北市,三重區,頂崁里,667,1066,427,152,579,62,641
公投第９案,新北市,三重區,谷王里,668,856,360,136,496,70,566
公投第９案,新北市,三重區,五谷里,669,764,299,101,400,40,440
公投第９案,新北市,三重區,五谷里,670,821,327,134,461,47,508
公投第９案,新北市,三重區,中興里,671,1887,703,210,913,70,983
公投第９案,新北市,三重區,中興里,672,1646,598,217,815,51,866
公投第９案,新北市,三重區,德厚里,673,358,143,51,194,19,213
公投第９案,新北市,三重區,成功里,674,1039,452,118,570,52,622
公投第９案,新北市,三重區,成功里,675,1114,445,188,633,42,675
公投第９案,新北市,三重區,成功里,676,1588,676,214,890,41,931
公投第９案,新北市,三重區,成功里,677,1702,652,215,867,43,910
公投第９案,新北市,三重區,福祉里,678,1288,538,191,729,61,790
公投第９案,新北市,三重區,福祉里,679,1629,667,236,903,74,977
公投第９案,新北市,三重區,福祉里,680,1861,768,199,967,78,1045
公投第９案,新北市,三重區,福德里,681,1727,661,182,843,42,885
公投第９案,新北市,三重區,福德里,682,1813,733,216,949,55,1004
公投第９案,新北市,三重區,福民里,683,1595,647,179,826,74,900
公投第９案,新北市,三重區,福民里,684,1513,602,207,809,75,884
公投第９案,新北市,三重區,過田里,685,4433,533,231,764,57,821
公投第９案,新北市,三重區,過田里,686,1283,535,167,702,43,745
公投第９案,新北市,三重區,過田里,687,1430,647,177,824,48,872
公投第９案,新北市,三重區,過田里,688,1357,609,167,776,40,816
公投第９案,新北市,三重區,錦田里,689,963,401,128,529,41,570
公投第９案,新北市,三重區,錦田里,690,883,344,129,473,52,525
公投第９案,新北市,三重區,重明里,691,1494,569,206,775,99,874
公投第９案,新北市,三重區,重明里,692,1616,636,197,833,96,929
公投第９案,新北市,三重區,光田里,693,1329,529,153,682,77,759
公投第９案,新北市,三重區,光田里,694,1289,557,191,748,58,806
公投第９案,新北市,三重區,光田里,695,1380,535,186,721,85,806
公投第９案,新北市,三重區,光陽里,696,1668,714,180,894,46,940
公投第９案,新北市,三重區,光陽里,697,1226,541,161,702,74,776
公投第９案,新北市,三重區,光陽里,698,1421,578,198,776,99,875
公投第９案,新北市,三重區,光陽里,699,1364,570,176,746,55,801
公投第９案,新北市,三重區,田心里,700,1232,515,161,676,56,732
公投第９案,新北市,三重區,田心里,701,1248,549,163,712,67,779
公投第９案,新北市,三重區,田心里,702,1256,491,196,687,64,751
公投第９案,新北市,三重區,福田里,703,1506,636,227,863,68,931
公投第９案,新北市,三重區,福田里,704,1669,695,220,915,72,987
公投第９案,新北市,三重區,田中里,705,1308,500,163,663,102,765
公投第９案,新北市,三重區,田中里,706,1263,594,167,761,68,829
公投第９案,新北市,三重區,田中里,707,1471,565,184,749,88,837
公投第９案,新北市,三重區,田中里,708,1447,581,182,763,110,873
公投第９案,新北市,三重區,田安里,709,1693,564,196,760,71,831
公投第９案,新北市,三重區,田安里,710,2015,792,241,1033,53,1086
公投第９案,新北市,三重區,田安里,711,1812,651,191,842,105,947
公投第９案,新北市,三重區,三民里,712,1509,525,188,713,41,754
公投第９案,新北市,三重區,三民里,713,1439,580,175,755,63,818
公投第９案,新北市,三重區,光明里,714,1437,559,192,751,59,810
公投第９案,新北市,三重區,光明里,715,1697,644,209,853,66,919
公投第９案,新北市,三重區,光明里,716,1793,751,115,866,47,913
公投第９案,新北市,三重區,光明里,717,1603,689,214,903,56,959
公投第９案,新北市,三重區,光正里,718,1166,445,146,591,44,635
公投第９案,新北市,三重區,光正里,719,1126,468,151,619,45,664
公投第９案,新北市,三重區,同安里,720,1291,447,136,583,64,647
公投第９案,新北市,三重區,同慶里,721,1597,615,110,725,81,806
公投第９案,新北市,三重區,菜寮里,722,1081,439,155,594,68,662
公投第９案,新北市,三重區,菜寮里,723,911,403,125,528,60,588
公投第９案,新北市,三重區,永春里,724,1719,581,201,782,57,839
公投第９案,新北市,三重區,中正里,725,1289,482,152,634,90,724
公投第９案,新北市,三重區,吉利里,726,1318,547,164,711,93,804
公投第９案,新北市,三重區,大同里,727,1822,643,224,867,75,942
公投第９案,新北市,三重區,中民里,728,1185,440,151,591,100,691
公投第９案,新北市,三重區,平和里,729,1369,466,164,630,92,722
公投第９案,新北市,三重區,大安里,730,1507,587,197,784,73,857
公投第９案,新北市,三重區,仁德里,731,926,371,113,484,69,553
公投第９案,新北市,三重區,仁德里,732,950,329,114,443,24,467
公投第９案,新北市,三重區,忠孝里,733,1678,605,200,805,83,888
公投第９案,新北市,三重區,仁義里,734,1117,412,150,562,76,638
公投第９案,新北市,三重區,光榮里,735,1318,483,151,634,66,700
公投第９案,新北市,三重區,光輝里,736,1388,516,198,714,40,754
公投第９案,新北市,三重區,福星里,737,1026,386,139,525,74,599
公投第９案,新北市,三重區,福利里,738,1096,483,154,637,48,685
公投第９案,新北市,三重區,福利里,739,967,411,123,534,37,571
公投第９案,新北市,三重區,清和里,740,1871,660,241,901,71,972
公投第９案,新北市,三重區,清和里,741,1663,628,212,840,96,936
公投第９案,新北市,三重區,永興里,742,1208,477,130,607,30,637
公投第９案,新北市,三重區,中山里,743,1398,490,165,655,67,722
公投第９案,新北市,三重區,中山里,744,1078,411,128,539,31,570
公投第９案,新北市,三重區,大園里,745,1102,413,121,534,70,604
公投第９案,新北市,三重區,大園里,746,1393,503,187,690,77,767
公投第９案,新北市,三重區,國隆里,747,1251,490,182,672,67,739
公投第９案,新北市,三重區,國隆里,748,1234,545,166,711,75,786
公投第９案,新北市,三重區,重陽里,749,1661,657,219,876,84,960
公投第９案,新北市,三重區,重陽里,750,1590,615,207,822,85,907
公投第９案,新北市,三重區,民生里,751,1182,474,166,640,64,704
公投第９案,新北市,三重區,民生里,752,1369,547,201,748,70,818
公投第９案,新北市,三重區,民生里,753,1222,521,181,702,56,758
公投第９案,新北市,三重區,重新里,754,1304,484,160,644,97,741
公投第９案,新北市,三重區,正德里,755,1054,398,119,517,48,565
公投第９案,新北市,三重區,正義里,756,1635,623,223,846,70,916
公投第９案,新北市,三重區,正安里,757,1779,650,208,858,78,936
公投第９案,新北市,三重區,自強里,758,1633,624,213,837,97,934
公投第９案,新北市,三重區,文化里,759,1107,444,137,581,59,640
公投第９案,新北市,三重區,文化里,760,1021,427,154,581,52,633
公投第９案,新北市,三重區,中央里,761,1649,538,208,746,105,851
公投第９案,新北市,三重區,雙園里,762,874,378,103,481,37,518
公投第９案,新北市,三重區,錦通里,763,1402,540,176,716,104,820
公投第９案,新北市,三重區,錦安里,764,1713,570,192,762,101,863
公投第９案,新北市,三重區,長安里,765,973,323,108,431,59,490
公投第９案,新北市,三重區,長安里,766,1038,417,141,558,56,614
公投第９案,新北市,三重區,光華里,767,1833,615,201,816,123,939
公投第９案,新北市,三重區,長生里,768,817,311,105,416,32,448
公投第９案,新北市,三重區,開元里,769,1387,637,170,807,66,873
公投第９案,新北市,三重區,大德里,770,784,336,100,436,37,473
公投第９案,新北市,三重區,長元里,771,1096,400,145,545,35,580
公投第９案,新北市,三重區,長元里,772,1163,452,162,614,74,688
公投第９案,新北市,三重區,長江里,773,1868,719,190,909,63,972
公投第９案,新北市,三重區,長泰里,774,1117,397,144,541,74,615
公投第９案,新北市,三重區,長泰里,775,934,330,122,452,49,501
公投第９案,新北市,三重區,長福里,776,1412,485,179,664,76,740
公投第９案,新北市,三重區,介壽里,777,1062,482,138,620,50,670
公投第９案,新北市,三重區,萬壽里,778,891,328,100,428,85,513
公投第９案,新北市,三重區,萬壽里,779,936,455,123,578,67,645
公投第９案,新北市,三重區,錦江里,780,1085,390,141,531,69,600
公投第９案,新北市,三重區,錦江里,781,1065,337,151,488,21,509
公投第９案,新北市,三重區,龍濱里,782,1398,567,166,733,68,801
公投第９案,新北市,三重區,龍濱里,783,1550,652,168,820,65,885
公投第９案,新北市,三重區,龍門里,784,1674,626,185,811,96,907
公投第９案,新北市,三重區,秀江里,785,1215,475,162,637,72,709
公投第９案,新北市,三重區,奕壽里,786,1606,581,221,802,77,879
公投第９案,新北市,三重區,三安里,787,1182,467,140,607,56,663
公投第９案,新北市,三重區,三安里,788,1238,481,161,642,86,728
公投第９案,新北市,三重區,福安里,789,1342,559,179,738,59,797
公投第９案,新北市,三重區,福安里,790,1408,570,185,755,64,819
公投第９案,新北市,三重區,信安里,791,1770,663,230,893,98,991
公投第９案,新北市,三重區,安慶里,792,940,362,134,496,54,550
公投第９案,新北市,三重區,安慶里,793,975,365,125,490,21,511
公投第９案,新北市,三重區,幸福里,794,1507,584,174,758,43,801
公投第９案,新北市,三重區,幸福里,795,1419,521,212,733,80,813
公投第９案,新北市,三重區,幸福里,796,1257,515,145,660,58,718
公投第９案,新北市,三重區,六合里,797,1619,631,199,830,90,920
公投第９案,新北市,三重區,六合里,798,1745,688,180,868,85,953
公投第９案,新北市,三重區,六福里,799,1519,578,197,775,79,854
公投第９案,新北市,三重區,六福里,800,1682,605,204,809,80,889
公投第９案,新北市,三重區,六福里,801,1697,703,220,923,71,994
公投第９案,新北市,三重區,順德里,802,1073,367,143,510,72,582
公投第９案,新北市,三重區,順德里,803,924,350,109,459,51,510
公投第９案,新北市,三重區,承德里,804,1613,524,173,697,60,757
公投第９案,新北市,三重區,瑞德里,805,1034,378,113,491,64,555
公投第９案,新北市,三重區,瑞德里,806,1118,430,151,581,62,643
公投第９案,新北市,三重區,崇德里,807,1269,454,165,619,86,705
公投第９案,新北市,三重區,崇德里,808,990,339,136,475,77,552
公投第９案,新北市,三重區,崇德里,809,1336,507,158,665,91,756
公投第９案,新北市,三重區,厚德里,810,1601,637,186,823,76,899
公投第９案,新北市,三重區,厚德里,811,1581,649,217,866,87,953
公投第９案,新北市,三重區,維德里,812,1345,556,157,713,70,783
公投第９案,新北市,三重區,維德里,813,1226,502,186,688,65,753
公投第９案,新北市,三重區,尚德里,814,1650,606,162,768,93,861
公投第９案,新北市,三重區,尚德里,815,1140,458,123,581,73,654
公投第９案,新北市,三重區,培德里,816,1639,635,176,811,43,854
公投第９案,新北市,三重區,培德里,817,1699,692,178,870,80,950
公投第９案,新北市,三重區,立德里,818,1501,711,189,900,94,994
公投第９案,新北市,三重區,立德里,819,1538,605,187,792,76,868
公投第９案,新北市,三重區,永德里,820,1540,580,176,756,88,844
公投第９案,新北市,三重區,永德里,821,1276,513,146,659,56,715
公投第９案,新北市,三重區,永德里,822,1539,547,210,757,78,835
公投第９案,新北市,三重區,永煇里,823,1170,468,180,648,55,703
公投第９案,新北市,三重區,永煇里,824,1120,433,150,583,55,638
公投第９案,新北市,三重區,永發里,825,1789,669,238,907,97,1004
公投第９案,新北市,三重區,永發里,826,1520,553,180,733,77,810
公投第９案,新北市,三重區,永發里,827,1821,700,231,931,85,1016
公投第９案,新北市,三重區,永盛里,828,1407,541,178,719,74,793
公投第９案,新北市,三重區,永盛里,829,1491,584,178,762,73,835
公投第９案,新北市,三重區,永吉里,830,1381,570,179,749,71,820
公投第９案,新北市,三重區,永吉里,831,1222,450,173,623,85,708
公投第９案,新北市,三重區,永安里,832,1938,752,202,954,65,1019
公投第９案,新北市,三重區,永安里,833,1639,613,199,812,52,864
公投第９案,新北市,三重區,永豐里,834,1614,660,162,822,83,905
公投第９案,新北市,三重區,永豐里,835,1709,729,145,874,57,931
公投第９案,新北市,三重區,永豐里,836,1753,659,173,832,79,911
公投第９案,新北市,三重區,永福里,837,1398,546,195,741,77,818
公投第９案,新北市,三重區,永福里,838,1706,613,216,829,88,917
公投第９案,新北市,三重區,永福里,839,1614,639,218,857,67,924
公投第９案,新北市,三重區,永清里,840,1591,605,223,828,98,926
公投第９案,新北市,三重區,永清里,841,1627,601,204,805,64,869
公投第９案,新北市,三重區,永清里,842,1505,610,186,796,81,877
公投第９案,新北市,三重區,永順里,843,1331,554,142,696,56,752
公投第９案,新北市,三重區,永順里,844,1678,624,181,805,58,863
公投第９案,新北市,三重區,永順里,845,1498,585,192,777,69,846
公投第９案,新北市,三重區,溪美里,846,1800,726,251,977,74,1051
公投第９案,新北市,三重區,溪美里,847,1703,630,157,787,49,836
公投第９案,新北市,三重區,溪美里,848,1975,714,208,922,55,977
公投第９案,新北市,三重區,溪美里,849,1894,687,231,918,64,982
公投第９案,新北市,三重區,福隆里,850,1405,591,179,770,54,824
公投第９案,新北市,三重區,福隆里,851,1293,600,100,700,42,742
公投第９案,新北市,三重區,福隆里,852,1259,473,195,668,57,725
公投第９案,新北市,三重區,五常里,853,1144,478,147,625,83,708
公投第９案,新北市,三重區,五常里,854,1254,527,155,682,85,767
公投第９案,新北市,三重區,五常里,855,1313,510,170,680,63,743
公投第９案,新北市,三重區,五福里,856,1594,596,192,788,86,874
公投第９案,新北市,三重區,五福里,857,1775,697,205,902,70,972
公投第９案,新北市,三重區,仁忠里,858,1516,562,184,746,103,849
公投第９案,新北市,三重區,仁忠里,859,1315,548,178,726,94,820
公投第９案,新北市,三重區,慈福里,860,843,325,126,451,68,519
公投第９案,新北市,三重區,慈福里,861,1160,429,127,556,66,622
公投第９案,新北市,三重區,慈生里,862,1052,416,138,554,63,617
公投第９案,新北市,三重區,慈生里,863,1054,434,170,604,62,666
公投第９案,新北市,三重區,慈惠里,864,997,370,149,519,68,587
公投第９案,新北市,三重區,慈惠里,865,936,339,117,456,45,501
公投第９案,新北市,三重區,慈愛里,866,1658,630,197,827,81,908
公投第９案,新北市,三重區,慈愛里,867,1496,552,185,737,78,815
公投第９案,新北市,三重區,慈化里,868,1064,453,143,596,59,655
公投第９案,新北市,三重區,慈化里,869,1152,492,149,641,63,704
公投第９案,新北市,三重區,慈祐里,870,1532,595,141,736,50,786
公投第９案,新北市,三重區,慈祐里,871,1338,475,124,599,39,638
公投第９案,新北市,三重區,慈祐里,872,1303,528,162,690,68,758
公投第９案,新北市,三重區,富華里,873,1369,574,194,768,88,856
公投第９案,新北市,三重區,富華里,874,1491,575,169,744,89,833
公投第９案,新北市,三重區,富貴里,875,1821,626,216,842,106,948
公投第９案,新北市,三重區,富貴里,876,1906,705,202,907,58,965
公投第９案,新北市,三重區,富貴里,877,1842,732,249,981,62,1043
公投第９案,新北市,三重區,富福里,878,878,320,105,425,48,473
公投第９案,新北市,三重區,富福里,879,963,412,143,555,58,613
公投第９案,新北市,三重區,五華里,880,1381,471,148,619,30,649
公投第９案,新北市,三重區,五華里,881,1681,557,204,761,75,836
公投第９案,新北市,三重區,五華里,882,1548,565,183,748,43,791
公投第９案,新北市,三重區,碧華里,883,1542,632,199,831,63,894
公投第９案,新北市,三重區,碧華里,884,1557,567,186,753,71,824
公投第９案,新北市,三重區,碧華里,885,1661,667,172,839,61,900
公投第９案,新北市,三重區,碧華里,886,2024,830,217,1047,34,1081
公投第９案,新北市,三重區,福樂里,887,1588,541,176,717,78,795
公投第９案,新北市,三重區,福樂里,888,1706,545,293,838,127,965
公投第９案,新北市,三重區,仁華里,889,1341,550,183,733,49,782
公投第９案,新北市,三重區,仁華里,890,1025,376,115,491,42,533
公投第９案,新北市,三重區,仁華里,891,1339,546,139,685,78,763
公投第９案,新北市,三重區,五順里,892,1725,628,224,852,107,959
公投第９案,新北市,三重區,五順里,893,1826,694,222,916,82,998
公投第９案,新北市,板橋區,留侯里,894,1388,528,187,715,72,787
公投第９案,新北市,板橋區,流芳里,895,1294,525,185,710,47,757
公投第９案,新北市,板橋區,赤松里,896,667,269,101,370,23,393
公投第９案,新北市,板橋區,黃石里,897,898,327,108,435,40,475
公投第９案,新北市,板橋區,挹秀里,898,829,362,107,469,34,503
公投第９案,新北市,板橋區,挹秀里,899,739,344,83,427,34,461
公投第９案,新北市,板橋區,湳興里,900,1035,422,157,579,50,629
公投第９案,新北市,板橋區,湳興里,901,1713,545,178,723,38,761
公投第９案,新北市,板橋區,湳興里,902,658,230,78,308,18,326
公投第９案,新北市,板橋區,湳興里,903,1312,489,156,645,89,734
公投第９案,新北市,板橋區,新興里,904,1492,551,148,699,62,761
公投第９案,新北市,板橋區,新興里,905,1393,486,170,656,63,719
公投第９案,新北市,板橋區,社後里,906,4742,601,221,822,61,883
公投第９案,新北市,板橋區,社後里,907,1439,548,167,715,39,754
公投第９案,新北市,板橋區,社後里,908,1187,471,146,617,71,688
公投第９案,新北市,板橋區,社後里,909,1122,447,123,570,40,610
公投第９案,新北市,板橋區,香社里,910,1363,564,153,717,65,782
公投第９案,新北市,板橋區,香社里,911,1093,440,157,597,51,648
公投第９案,新北市,板橋區,香社里,912,1331,539,188,727,46,773
公投第９案,新北市,板橋區,香雅里,913,1026,456,139,595,45,640
公投第９案,新北市,板橋區,香雅里,914,1244,494,128,622,90,712
公投第９案,新北市,板橋區,中正里,915,1268,455,143,598,85,683
公投第９案,新北市,板橋區,中正里,916,1313,466,144,610,39,649
公投第９案,新北市,板橋區,中正里,917,1196,520,161,681,49,730
公投第９案,新北市,板橋區,自強里,918,1137,541,187,728,46,774
公投第９案,新北市,板橋區,自強里,919,1269,559,195,754,50,804
公投第９案,新北市,板橋區,自強里,920,1117,495,140,635,34,669
公投第９案,新北市,板橋區,自強里,921,1042,462,147,609,52,661
公投第９案,新北市,板橋區,自立里,922,1257,510,169,679,80,759
公投第９案,新北市,板橋區,自立里,923,1216,505,150,655,66,721
公投第９案,新北市,板橋區,光華里,924,1126,437,150,587,70,657
公投第９案,新北市,板橋區,光華里,925,1290,605,180,785,58,843
公投第９案,新北市,板橋區,光榮里,926,1215,467,116,583,16,599
公投第９案,新北市,板橋區,光榮里,927,1099,424,121,545,26,571
公投第９案,新北市,板橋區,國光里,928,1329,678,100,778,40,818
公投第９案,新北市,板橋區,國光里,929,996,491,85,576,34,610
公投第９案,新北市,板橋區,國光里,930,1047,473,114,587,39,626
公投第９案,新北市,板橋區,港尾里,931,1272,520,178,698,67,765
公投第９案,新北市,板橋區,港尾里,932,1252,587,144,731,49,780
公投第９案,新北市,板橋區,新生里,933,1238,502,162,664,67,731
公投第９案,新北市,板橋區,新生里,934,1389,635,184,819,64,883
公投第９案,新北市,板橋區,新生里,935,1194,528,165,693,59,752
公投第９案,新北市,板橋區,金華里,936,1093,417,105,522,62,584
公投第９案,新北市,板橋區,金華里,937,1148,443,139,582,76,658
公投第９案,新北市,板橋區,金華里,938,1268,524,163,687,49,736
公投第９案,新北市,板橋區,港德里,939,1230,467,183,650,68,718
公投第９案,新北市,板橋區,港德里,940,1012,410,117,527,49,576
公投第９案,新北市,板橋區,港德里,941,811,341,103,444,42,486
公投第９案,新北市,板橋區,港德里,942,1197,500,178,678,72,750
公投第９案,新北市,板橋區,民權里,943,1142,459,121,580,37,617
公投第９案,新北市,板橋區,民權里,944,1222,505,144,649,48,697
公投第９案,新北市,板橋區,民安里,945,796,363,96,459,43,502
公投第９案,新北市,板橋區,民安里,946,997,459,112,571,75,646
公投第９案,新北市,板橋區,建國里,947,1011,365,184,549,39,588
公投第９案,新北市,板橋區,建國里,948,1157,441,159,600,68,668
公投第９案,新北市,板橋區,建國里,949,1040,441,130,571,63,634
公投第９案,新北市,板橋區,漢生里,950,1173,539,134,673,38,711
公投第９案,新北市,板橋區,漢生里,951,1193,498,127,625,27,652
公投第９案,新北市,板橋區,漢生里,952,1255,533,157,690,43,733
公投第９案,新北市,板橋區,公舘里,953,1306,516,185,701,51,752
公投第９案,新北市,板橋區,公舘里,954,1050,423,141,564,17,581
公投第９案,新北市,板橋區,公舘里,955,942,387,118,505,38,543
公投第９案,新北市,板橋區,新民里,956,1133,521,143,664,50,714
公投第９案,新北市,板橋區,新民里,957,1251,512,169,681,46,727
公投第９案,新北市,板橋區,新民里,958,1293,557,157,714,40,754
公投第９案,新北市,板橋區,幸福里,959,1208,441,153,594,64,658
公投第９案,新北市,板橋區,幸福里,960,1223,474,166,640,72,712
公投第９案,新北市,板橋區,幸福里,961,1061,512,37,549,55,604
公投第９案,新北市,板橋區,文德里,962,1515,632,179,811,44,855
公投第９案,新北市,板橋區,文德里,963,1225,548,140,688,67,755
公投第９案,新北市,板橋區,忠誠里,964,1120,555,127,682,30,712
公投第９案,新北市,板橋區,忠誠里,965,1091,510,134,644,43,687
公投第９案,新北市,板橋區,忠誠里,966,1385,693,111,804,39,843
公投第９案,新北市,板橋區,陽明里,967,1283,533,184,717,75,792
公投第９案,新北市,板橋區,陽明里,968,1204,479,153,632,91,723
公投第９案,新北市,板橋區,百壽里,969,1191,548,154,702,54,756
公投第９案,新北市,板橋區,百壽里,970,1078,463,157,620,65,685
公投第９案,新北市,板橋區,介壽里,971,1351,545,172,717,79,796
公投第９案,新北市,板橋區,介壽里,972,1322,542,160,702,73,775
公投第９案,新北市,板橋區,新埔里,973,868,364,101,465,58,523
公投第９案,新北市,板橋區,新埔里,974,1029,447,161,608,81,689
公投第９案,新北市,板橋區,華江里,975,1602,705,193,898,43,941
公投第９案,新北市,板橋區,華江里,976,1362,584,165,749,71,820
公投第９案,新北市,板橋區,華江里,977,1698,680,208,888,74,962
公投第９案,新北市,板橋區,華江里,978,1495,679,137,816,35,851
公投第９案,新北市,板橋區,江翠里,979,1522,545,220,765,78,843
公投第９案,新北市,板橋區,江翠里,980,1279,562,129,691,62,753
公投第９案,新北市,板橋區,江翠里,981,1559,512,162,674,59,733
公投第９案,新北市,板橋區,純翠里,982,1537,552,169,721,106,827
公投第９案,新北市,板橋區,純翠里,983,1531,530,190,720,75,795
公投第９案,新北市,板橋區,純翠里,984,1720,740,110,850,39,889
公投第９案,新北市,板橋區,溪頭里,985,1165,445,117,562,39,601
公投第９案,新北市,板橋區,溪頭里,986,1857,789,213,1002,18,1020
公投第９案,新北市,板橋區,溪頭里,987,1078,410,135,545,73,618
公投第９案,新北市,板橋區,溪頭里,988,1177,449,138,587,22,609
公投第９案,新北市,板橋區,聯翠里,989,1798,747,228,975,53,1028
公投第９案,新北市,板橋區,聯翠里,990,1455,592,175,767,113,880
公投第９案,新北市,板橋區,文化里,991,1245,521,179,700,72,772
公投第９案,新北市,板橋區,文化里,992,1704,591,252,843,93,936
公投第９案,新北市,板橋區,宏翠里,993,1600,702,181,883,37,920
公投第９案,新北市,板橋區,宏翠里,994,1409,507,169,676,34,710
公投第９案,新北市,板橋區,宏翠里,995,1286,498,184,682,56,738
公投第９案,新北市,板橋區,仁翠里,996,1359,393,156,549,120,669
公投第９案,新北市,板橋區,仁翠里,997,1188,433,148,581,48,629
公投第９案,新北市,板橋區,新翠里,998,1627,596,189,785,57,842
公投第９案,新北市,板橋區,新翠里,999,1633,555,164,719,36,755
公投第９案,新北市,板橋區,新翠里,1000,1814,700,331,1031,80,1111
公投第９案,新北市,板橋區,新翠里,1001,1810,713,222,935,92,1027
公投第９案,新北市,板橋區,朝陽里,1002,1133,429,150,579,80,659
公投第９案,新北市,板橋區,朝陽里,1003,841,324,108,432,41,473
公投第９案,新北市,板橋區,朝陽里,1004,1050,465,135,600,55,655
公投第９案,新北市,板橋區,吉翠里,1005,1130,422,138,560,77,637
公投第９案,新北市,板橋區,吉翠里,1006,1056,438,155,593,67,660
公投第９案,新北市,板橋區,吉翠里,1007,1129,410,132,542,32,574
公投第９案,新北市,板橋區,德翠里,1008,1713,678,201,879,92,971
公投第９案,新北市,板橋區,德翠里,1009,1622,653,221,874,71,945
公投第９案,新北市,板橋區,德翠里,1010,1427,658,183,841,51,892
公投第９案,新北市,板橋區,德翠里,1011,1471,685,183,868,29,897
公投第９案,新北市,板橋區,新海里,1012,1076,402,128,530,23,553
公投第９案,新北市,板橋區,新海里,1013,979,341,98,439,14,453
公投第９案,新北市,板橋區,新海里,1014,1079,501,121,622,37,659
公投第９案,新北市,板橋區,滿翠里,1015,828,304,107,411,61,472
公投第９案,新北市,板橋區,滿翠里,1016,820,313,134,447,68,515
公投第９案,新北市,板橋區,滿翠里,1017,989,408,125,533,49,582
公投第９案,新北市,板橋區,明翠里,1018,1023,366,162,528,73,601
公投第９案,新北市,板橋區,明翠里,1019,1044,382,136,518,35,553
公投第９案,新北市,板橋區,明翠里,1020,968,376,135,511,60,571
公投第９案,新北市,板橋區,明翠里,1021,1222,501,163,664,34,698
公投第９案,新北市,板橋區,松翠里,1022,1385,555,159,714,45,759
公投第９案,新北市,板橋區,松翠里,1023,1585,574,207,781,78,859
公投第９案,新北市,板橋區,柏翠里,1024,1840,701,234,935,73,1008
公投第９案,新北市,板橋區,柏翠里,1025,1806,744,265,1009,109,1118
公投第９案,新北市,板橋區,龍翠里,1026,1506,570,203,773,89,862
公投第９案,新北市,板橋區,龍翠里,1027,1476,544,186,730,96,826
公投第９案,新北市,板橋區,龍翠里,1028,1500,619,183,802,71,873
公投第９案,新北市,板橋區,松柏里,1029,1096,489,130,619,66,685
公投第９案,新北市,板橋區,松柏里,1030,963,388,145,533,70,603
公投第９案,新北市,板橋區,華翠里,1031,1601,628,168,796,45,841
公投第９案,新北市,板橋區,華翠里,1032,1507,672,187,859,69,928
公投第９案,新北市,板橋區,莒光里,1033,1315,550,191,741,77,818
公投第９案,新北市,板橋區,莒光里,1034,1178,431,167,598,37,635
公投第９案,新北市,板橋區,忠翠里,1035,1822,776,225,1001,91,1092
公投第９案,新北市,板橋區,忠翠里,1036,1605,683,243,926,74,1000
公投第９案,新北市,板橋區,忠翠里,1037,1549,690,185,875,23,898
公投第９案,新北市,板橋區,忠翠里,1038,1948,893,205,1098,55,1153
公投第９案,新北市,板橋區,忠翠里,1039,1935,771,221,992,40,1032
公投第９案,新北市,板橋區,嵐翠里,1040,1097,410,120,530,46,576
公投第９案,新北市,板橋區,嵐翠里,1041,1095,394,149,543,54,597
公投第９案,新北市,板橋區,文聖里,1042,1678,603,208,811,110,921
公投第９案,新北市,板橋區,文聖里,1043,1750,637,219,856,109,965
公投第９案,新北市,板橋區,文翠里,1044,1187,446,159,605,59,664
公投第９案,新北市,板橋區,文翠里,1045,1154,492,144,636,29,665
公投第９案,新北市,板橋區,文翠里,1046,1262,517,158,675,34,709
公投第９案,新北市,板橋區,青翠里,1047,1271,474,146,620,95,715
公投第９案,新北市,板橋區,青翠里,1048,1410,499,199,698,108,806
公投第９案,新北市,板橋區,懷翠里,1049,1745,643,166,809,92,901
公投第９案,新北市,板橋區,懷翠里,1050,1867,574,236,810,130,940
公投第９案,新北市,板橋區,懷翠里,1051,1753,724,208,932,92,1024
公投第９案,新北市,板橋區,福翠里,1052,1204,487,170,657,66,723
公投第９案,新北市,板橋區,港嘴里,1053,1614,619,190,809,77,886
公投第９案,新北市,板橋區,港嘴里,1054,1237,521,169,690,50,740
公投第９案,新北市,板橋區,港嘴里,1055,1361,532,190,722,76,798
公投第９案,新北市,板橋區,港嘴里,1056,1243,482,176,658,31,689
公投第９案,新北市,板橋區,振興里,1057,1515,556,161,717,38,755
公投第９案,新北市,板橋區,振興里,1058,1515,618,202,820,87,907
公投第９案,新北市,板橋區,振興里,1059,949,393,126,519,63,582
公投第９案,新北市,板橋區,振義里,1060,1629,639,208,847,78,925
公投第９案,新北市,板橋區,振義里,1061,1238,494,169,663,46,709
公投第９案,新北市,板橋區,振義里,1062,901,277,76,353,38,391
公投第９案,新北市,板橋區,光復里,1063,1475,576,178,754,90,844
公投第９案,新北市,板橋區,光復里,1064,1481,549,194,743,84,827
公投第９案,新北市,板橋區,埔墘里,1065,1800,626,208,834,90,924
公投第９案,新北市,板橋區,埔墘里,1066,1630,636,202,838,61,899
公投第９案,新北市,板橋區,埔墘里,1067,1298,552,170,722,51,773
公投第９案,新北市,板橋區,埔墘里,1068,874,376,104,480,42,522
公投第９案,新北市,板橋區,富貴里,1069,992,377,120,497,21,518
公投第９案,新北市,板橋區,富貴里,1070,1034,459,153,612,20,632
公投第９案,新北市,板橋區,長壽里,1071,1451,585,209,794,76,870
公投第９案,新北市,板橋區,長壽里,1072,1130,485,136,621,54,675
公投第９案,新北市,板橋區,福壽里,1073,1440,614,173,787,60,847
公投第９案,新北市,板橋區,福壽里,1074,1531,599,214,813,95,908
公投第９案,新北市,板橋區,居仁里,1075,1349,599,194,793,76,869
公投第９案,新北市,板橋區,居仁里,1076,1593,564,203,767,45,812
公投第９案,新北市,板橋區,海山里,1077,1174,497,120,617,33,650
公投第９案,新北市,板橋區,海山里,1078,1228,499,143,642,53,695
公投第９案,新北市,板橋區,海山里,1079,1187,484,147,631,39,670
公投第９案,新北市,板橋區,海山里,1080,870,364,117,481,54,535
公投第９案,新北市,板橋區,海山里,1081,2033,918,251,1169,41,1210
公投第９案,新北市,板橋區,九如里,1082,1418,523,197,720,50,770
公投第９案,新北市,板橋區,九如里,1083,1075,398,161,559,59,618
公投第９案,新北市,板橋區,正泰里,1084,1515,585,157,742,44,786
公投第９案,新北市,板橋區,正泰里,1085,1182,528,162,690,49,739
公投第９案,新北市,板橋區,玉光里,1086,1893,740,228,968,77,1045
公投第９案,新北市,板橋區,玉光里,1087,1302,497,159,656,67,723
公投第９案,新北市,板橋區,玉光里,1088,1366,490,172,662,47,709
公投第９案,新北市,板橋區,光仁里,1089,1318,566,180,746,78,824
公投第９案,新北市,板橋區,光仁里,1090,1200,488,141,629,40,669
公投第９案,新北市,板橋區,埤墘里,1091,2028,825,262,1087,48,1135
公投第９案,新北市,板橋區,埤墘里,1092,1746,668,241,909,113,1022
公投第９案,新北市,板橋區,莊敬里,1093,1954,760,180,940,31,971
公投第９案,新北市,板橋區,莊敬里,1094,1474,595,166,761,65,826
公投第９案,新北市,板橋區,永安里,1095,1418,544,184,728,60,788
公投第９案,新北市,板橋區,永安里,1096,1563,665,232,897,66,963
公投第９案,新北市,板橋區,雙玉里,1097,1780,697,206,903,101,1004
公投第９案,新北市,板橋區,雙玉里,1098,1707,667,209,876,56,932
公投第９案,新北市,板橋區,廣新里,1099,906,248,61,309,9,318
公投第９案,新北市,板橋區,廣新里,1100,1030,397,129,526,64,590
公投第９案,新北市,板橋區,廣新里,1101,1115,446,157,603,46,649
公投第９案,新北市,板橋區,深丘里,1102,1836,731,199,930,27,957
公投第９案,新北市,板橋區,深丘里,1103,1881,695,244,939,86,1025
公投第９案,新北市,板橋區,深丘里,1104,1688,695,180,875,41,916
公投第９案,新北市,板橋區,深丘里,1105,1760,816,176,992,44,1036
公投第９案,新北市,板橋區,香丘里,1106,1044,450,146,596,54,650
公投第９案,新北市,板橋區,香丘里,1107,1043,469,141,610,41,651
公投第９案,新北市,板橋區,香丘里,1108,1099,490,137,627,59,686
公投第９案,新北市,板橋區,西安里,1109,1260,508,163,671,53,724
公投第９案,新北市,板橋區,西安里,1110,1131,470,143,613,40,653
公投第９案,新北市,板橋區,東丘里,1111,1225,497,165,662,56,718
公投第９案,新北市,板橋區,東丘里,1112,1455,660,182,842,56,898
公投第９案,新北市,板橋區,東丘里,1113,1267,468,184,652,66,718
公投第９案,新北市,板橋區,民生里,1114,972,392,139,531,63,594
公投第９案,新北市,板橋區,民生里,1115,994,403,138,541,41,582
公投第９案,新北市,板橋區,長安里,1116,1111,479,142,621,20,641
公投第９案,新北市,板橋區,長安里,1117,1177,530,176,706,72,778
公投第９案,新北市,板橋區,長安里,1118,1544,615,172,787,69,856
公投第９案,新北市,板橋區,東安里,1119,1021,395,118,513,78,591
公投第９案,新北市,板橋區,東安里,1120,1040,417,114,531,57,588
公投第９案,新北市,板橋區,福丘里,1121,1504,603,179,782,35,817
公投第９案,新北市,板橋區,福丘里,1122,1373,580,124,704,39,743
公投第９案,新北市,板橋區,福丘里,1123,1210,519,154,673,32,705
公投第９案,新北市,板橋區,福祿里,1124,1809,547,350,897,65,962
公投第９案,新北市,板橋區,福祿里,1125,1551,659,173,832,85,917
公投第９案,新北市,板橋區,民族里,1126,1408,610,170,780,29,809
公投第９案,新北市,板橋區,民族里,1127,1285,586,125,711,32,743
公投第９案,新北市,板橋區,民族里,1128,1102,475,173,648,37,685
公投第９案,新北市,板橋區,國泰里,1129,1399,542,135,677,35,712
公投第９案,新北市,板橋區,國泰里,1130,1692,683,173,856,99,955
公投第９案,新北市,板橋區,後埔里,1131,1625,709,215,924,35,959
公投第９案,新北市,板橋區,後埔里,1132,1712,693,225,918,74,992
公投第９案,新北市,板橋區,福德里,1133,1246,509,150,659,38,697
公投第９案,新北市,板橋區,福德里,1134,1471,612,180,792,32,824
公投第９案,新北市,板橋區,福德里,1135,1761,728,196,924,70,994
公投第９案,新北市,板橋區,景星里,1136,1499,612,181,793,72,865
公投第９案,新北市,板橋區,景星里,1137,1528,561,187,748,52,800
公投第９案,新北市,板橋區,福星里,1138,1536,624,191,815,63,878
公投第９案,新北市,板橋區,福星里,1139,1550,647,190,837,50,887
公投第９案,新北市,板橋區,鄉雲里,1140,2050,839,263,1102,85,1187
公投第９案,新北市,板橋區,鄉雲里,1141,1300,548,161,709,59,768
公投第９案,新北市,板橋區,廣德里,1142,1537,662,169,831,37,868
公投第９案,新北市,板橋區,廣德里,1143,1341,491,142,633,25,658
公投第９案,新北市,板橋區,廣德里,1144,1606,662,207,869,31,900
公投第９案,新北市,板橋區,廣德里,1145,1433,546,139,685,44,729
公投第９案,新北市,板橋區,大豐里,1146,1685,611,176,787,42,829
公投第９案,新北市,板橋區,大豐里,1147,1248,542,166,708,57,765
公投第９案,新北市,板橋區,大豐里,1148,1172,484,110,594,52,646
公投第９案,新北市,板橋區,重慶里,1149,1640,558,161,719,29,748
公投第９案,新北市,板橋區,重慶里,1150,1428,535,154,689,42,731
公投第９案,新北市,板橋區,重慶里,1151,1527,603,200,803,74,877
公投第９案,新北市,板橋區,重慶里,1152,1350,596,163,759,31,790
公投第９案,新北市,板橋區,重慶里,1153,1582,673,159,832,62,894
公投第９案,新北市,板橋區,仁愛里,1154,919,434,115,549,48,597
公投第９案,新北市,板橋區,仁愛里,1155,930,397,103,500,23,523
公投第９案,新北市,板橋區,仁愛里,1156,974,442,125,567,27,594
公投第９案,新北市,板橋區,和平里,1157,1732,786,148,934,37,971
公投第９案,新北市,板橋區,和平里,1158,1438,605,148,753,55,808
公投第９案,新北市,板橋區,廣福里,1159,1777,600,261,861,106,967
公投第９案,新北市,板橋區,廣福里,1160,1764,620,195,815,63,878
公投第９案,新北市,板橋區,五權里,1161,1289,515,155,670,20,690
公投第９案,新北市,板橋區,五權里,1162,1182,508,110,618,53,671
公投第９案,新北市,板橋區,五權里,1163,1174,486,160,646,65,711
公投第９案,新北市,板橋區,華興里,1164,1870,700,203,903,105,1008
公投第９案,新北市,板橋區,華興里,1165,1842,796,216,1012,60,1072
公投第９案,新北市,板橋區,華貴里,1166,1094,457,122,579,54,633
公投第９案,新北市,板橋區,華貴里,1167,1228,473,155,628,50,678
公投第９案,新北市,板橋區,華福里,1168,998,453,145,598,49,647
公投第９案,新北市,板橋區,華福里,1169,862,456,118,574,40,614
公投第９案,新北市,板橋區,華德里,1170,1622,583,204,787,66,853
公投第９案,新北市,板橋區,華德里,1171,1205,496,158,654,67,721
公投第９案,新北市,板橋區,華德里,1172,1787,658,193,851,57,908
公投第９案,新北市,板橋區,華德里,1173,1610,712,159,871,45,916
公投第９案,新北市,板橋區,華東里,1174,2216,950,290,1240,39,1279
公投第９案,新北市,板橋區,華東里,1175,2294,931,281,1212,56,1268
公投第９案,新北市,板橋區,華東里,1176,2090,790,218,1008,87,1095
公投第９案,新北市,板橋區,信義里,1177,1356,513,116,629,39,668
公投第９案,新北市,板橋區,信義里,1178,1067,446,135,581,41,622
公投第９案,新北市,板橋區,信義里,1179,1319,531,184,715,51,766
公投第９案,新北市,板橋區,浮洲里,1180,1316,450,155,605,55,660
公投第９案,新北市,板橋區,浮洲里,1181,1195,435,145,580,70,650
公投第９案,新北市,板橋區,浮洲里,1182,857,325,114,439,34,473
公投第９案,新北市,板橋區,華中里,1183,1417,524,170,694,78,772
公投第９案,新北市,板橋區,華中里,1184,1560,595,223,818,80,898
公投第９案,新北市,板橋區,華中里,1185,1747,688,248,936,93,1029
公投第９案,新北市,板橋區,僑中里,1186,1176,528,175,703,53,756
公投第９案,新北市,板橋區,僑中里,1187,1101,469,147,616,28,644
公投第９案,新北市,板橋區,僑中里,1188,1458,606,178,784,30,814
公投第９案,新北市,板橋區,大觀里,1189,1630,605,147,752,48,800
公投第９案,新北市,板橋區,大觀里,1190,1611,615,173,788,100,888
公投第９案,新北市,板橋區,歡園里,1191,1139,428,126,554,42,596
公投第９案,新北市,板橋區,中山里,1192,1120,456,110,566,33,599
公投第９案,新北市,板橋區,中山里,1193,1022,419,147,566,88,654
公投第９案,新北市,板橋區,中山里,1194,1049,393,162,555,82,637
公投第９案,新北市,板橋區,中山里,1195,1007,449,113,562,23,585
公投第９案,新北市,板橋區,中山里,1196,1393,610,134,744,36,780
公投第９案,新北市,板橋區,復興里,1197,474,126,39,165,35,200
公投第９案,新北市,板橋區,復興里,1198,500,206,69,275,27,302
公投第９案,新北市,板橋區,大安里,1199,1177,441,160,601,44,645
公投第９案,新北市,板橋區,大安里,1200,1186,472,131,603,33,636
公投第９案,新北市,板橋區,大安里,1201,1139,506,147,653,58,711
公投第９案,新北市,板橋區,福安里,1202,1750,681,205,886,69,955
公投第９案,新北市,板橋區,福安里,1203,3451,914,229,1143,30,1173
公投第９案,新北市,板橋區,聚安里,1204,1620,595,184,779,79,858
公投第９案,新北市,板橋區,聚安里,1205,903,328,82,410,23,433
公投第９案,新北市,板橋區,聚安里,1206,1232,513,162,675,44,719
公投第９案,新北市,板橋區,聚安里,1207,975,344,106,450,21,471
公投第９案,新北市,板橋區,龍安里,1208,1224,462,139,601,42,643
公投第９案,新北市,板橋區,龍安里,1209,1291,525,144,669,39,708
公投第９案,新北市,板橋區,崑崙里,1210,1828,655,204,859,42,901
公投第９案,新北市,板橋區,崑崙里,1211,1725,629,178,807,52,859
公投第９案,新北市,板橋區,崑崙里,1212,1085,387,114,501,29,530
公投第９案,新北市,板橋區,崑崙里,1213,2357,911,225,1136,71,1207
公投第９案,新北市,板橋區,崑崙里,1214,1560,612,174,786,35,821
公投第９案,新北市,板橋區,成和里,1215,2201,740,152,892,32,924
公投第９案,新北市,板橋區,成和里,1216,1626,605,187,792,115,907
公投第９案,新北市,板橋區,成和里,1217,1786,598,161,759,54,813
公投第９案,新北市,板橋區,溪洲里,1218,1763,666,203,869,54,923
公投第９案,新北市,板橋區,溪洲里,1219,1744,645,157,802,34,836
公投第９案,新北市,板橋區,溪洲里,1220,1645,639,163,802,53,855
公投第９案,新北市,板橋區,溪福里,1221,1861,699,154,853,47,900
公投第９案,新北市,板橋區,溪福里,1222,1596,586,159,745,31,776
公投第９案,新北市,板橋區,溪福里,1223,1871,713,237,950,61,1011
公投第９案,新北市,板橋區,溪福里,1224,1938,883,213,1096,69,1165
公投第９案,新北市,板橋區,溪福里,1225,1827,760,206,966,47,1013
公投第９案,新北市,板橋區,溪福里,1226,1359,566,119,685,29,714
公投第９案,新北市,板橋區,溪福里,1227,1613,675,148,823,60,883
公投第９案,新北市,板橋區,溪北里,1228,1566,599,202,801,81,882
公投第９案,新北市,板橋區,溪北里,1229,1552,695,184,879,47,926
公投第９案,新北市,板橋區,堂春里,1230,1885,698,239,937,34,971
公投第９案,新北市,板橋區,堂春里,1231,1893,684,238,922,66,988
公投第９案,新北市,中和區,中原里,1232,1630,601,177,778,67,845
公投第９案,新北市,中和區,中原里,1233,1775,731,202,933,59,992
公投第９案,新北市,中和區,中原里,1234,1844,722,159,881,36,917
公投第９案,新北市,中和區,連和里,1235,1019,494,148,642,32,674
公投第９案,新北市,中和區,連和里,1236,1138,539,118,657,35,692
公投第９案,新北市,中和區,連城里,1237,1878,761,140,901,48,949
公投第９案,新北市,中和區,連城里,1238,1980,911,171,1082,47,1129
公投第９案,新北市,中和區,連城里,1239,1844,761,201,962,74,1036
公投第９案,新北市,中和區,力行里,1240,2085,902,193,1095,37,1132
公投第９案,新北市,中和區,力行里,1241,1498,603,176,779,54,833
公投第９案,新北市,中和區,力行里,1242,1761,708,193,901,34,935
公投第９案,新北市,中和區,正行里,1243,1254,486,164,650,27,677
公投第９案,新北市,中和區,正行里,1244,1343,607,138,745,39,784
公投第９案,新北市,中和區,德行里,1245,1789,736,192,928,37,965
公投第９案,新北市,中和區,德行里,1246,2000,855,204,1059,35,1094
公投第９案,新北市,中和區,德行里,1247,1953,572,326,898,44,942
公投第９案,新北市,中和區,枋寮里,1248,1712,688,205,893,57,950
公投第９案,新北市,中和區,枋寮里,1249,1582,690,147,837,64,901
公投第９案,新北市,中和區,漳和里,1250,1742,705,183,888,63,951
公投第９案,新北市,中和區,漳和里,1251,1493,659,206,865,51,916
公投第９案,新北市,中和區,廟美里,1252,1352,519,142,661,77,738
公投第９案,新北市,中和區,廟美里,1253,1244,560,131,691,42,733
公投第９案,新北市,中和區,廟美里,1254,1394,592,160,752,64,816
公投第９案,新北市,中和區,福真里,1255,1917,661,153,814,27,841
公投第９案,新北市,中和區,福真里,1256,1830,664,204,868,84,952
公投第９案,新北市,中和區,福善里,1257,1124,476,140,616,46,662
公投第９案,新北市,中和區,福善里,1258,1412,497,161,658,38,696
公投第９案,新北市,中和區,福善里,1259,1356,531,155,686,56,742
公投第９案,新北市,中和區,福美里,1260,1425,547,156,703,49,752
公投第９案,新北市,中和區,福美里,1261,1259,519,160,679,78,757
公投第９案,新北市,中和區,福美里,1262,1256,505,154,659,69,728
公投第９案,新北市,中和區,福祥里,1263,1423,594,169,763,44,807
公投第９案,新北市,中和區,福祥里,1264,1221,524,125,649,58,707
公投第９案,新北市,中和區,福祥里,1265,1858,720,168,888,56,944
公投第９案,新北市,中和區,瓦磘里,1266,1804,688,189,877,53,930
公投第９案,新北市,中和區,瓦磘里,1267,1669,723,193,916,31,947
公投第９案,新北市,中和區,瓦磘里,1268,1485,634,159,793,43,836
公投第９案,新北市,中和區,福和里,1269,1005,438,120,558,49,607
公投第９案,新北市,中和區,福和里,1270,1175,547,155,702,59,761
公投第９案,新北市,中和區,福和里,1271,1171,516,132,648,41,689
公投第９案,新北市,中和區,佳和里,1272,1746,655,164,819,34,853
公投第９案,新北市,中和區,佳和里,1273,1555,574,159,733,43,776
公投第９案,新北市,中和區,佳和里,1274,1112,453,122,575,57,632
公投第９案,新北市,中和區,新南里,1275,1780,794,210,1004,47,1051
公投第９案,新北市,中和區,新南里,1276,1918,806,191,997,34,1031
公投第９案,新北市,中和區,新南里,1277,1689,575,150,725,37,762
公投第９案,新北市,中和區,新南里,1278,1781,775,194,969,32,1001
公投第９案,新北市,中和區,南山里,1279,1419,570,172,742,55,797
公投第９案,新北市,中和區,南山里,1280,1344,548,142,690,37,727
公投第９案,新北市,中和區,南山里,1281,1804,851,224,1075,49,1124
公投第９案,新北市,中和區,平河里,1282,1788,661,218,879,77,956
公投第９案,新北市,中和區,平河里,1283,1793,752,182,934,62,996
公投第９案,新北市,中和區,平河里,1284,1352,580,145,725,61,786
公投第９案,新北市,中和區,平河里,1285,1813,781,187,968,53,1021
公投第９案,新北市,中和區,平河里,1286,1288,644,131,775,41,816
公投第９案,新北市,中和區,信和里,1287,1186,470,157,627,35,662
公投第９案,新北市,中和區,信和里,1288,1237,451,156,607,9,616
公投第９案,新北市,中和區,信和里,1289,1406,569,155,724,42,766
公投第９案,新北市,中和區,仁和里,1290,1442,567,162,729,80,809
公投第９案,新北市,中和區,仁和里,1291,1040,457,127,584,51,635
公投第９案,新北市,中和區,仁和里,1292,1292,563,176,739,50,789
公投第９案,新北市,中和區,中正里,1293,1811,722,198,920,61,981
公投第９案,新北市,中和區,中正里,1294,1789,711,206,917,104,1021
公投第９案,新北市,中和區,建和里,1295,859,444,93,537,30,567
公投第９案,新北市,中和區,建和里,1296,972,506,87,593,33,626
公投第９案,新北市,中和區,建和里,1297,1346,530,191,721,46,767
公投第９案,新北市,中和區,中山里,1298,1034,428,135,563,38,601
公投第９案,新北市,中和區,中山里,1299,1387,600,142,742,54,796
公投第９案,新北市,中和區,碧河里,1300,2067,858,228,1086,88,1174
公投第９案,新北市,中和區,碧河里,1301,1670,668,180,848,54,902
公投第９案,新北市,中和區,正南里,1302,1166,481,130,611,51,662
公投第９案,新北市,中和區,正南里,1303,963,417,108,525,49,574
公投第９案,新北市,中和區,正南里,1304,1070,413,109,522,37,559
公投第９案,新北市,中和區,頂南里,1305,1319,560,138,698,47,745
公投第９案,新北市,中和區,頂南里,1306,1438,649,158,807,62,869
公投第９案,新北市,中和區,華新里,1307,1808,729,157,886,31,917
公投第９案,新北市,中和區,華新里,1308,1191,498,89,587,22,609
公投第９案,新北市,中和區,華新里,1309,1632,667,168,835,64,899
公投第９案,新北市,中和區,華新里,1310,1765,705,155,860,41,901
公投第９案,新北市,中和區,東南里,1311,1168,581,94,675,28,703
公投第９案,新北市,中和區,東南里,1312,1176,506,100,606,31,637
公投第９案,新北市,中和區,東南里,1313,1565,793,135,928,55,983
公投第９案,新北市,中和區,華南里,1314,1578,597,166,763,47,810
公投第９案,新北市,中和區,華南里,1315,2029,865,165,1030,43,1073
公投第９案,新北市,中和區,華南里,1316,905,390,99,489,32,521
公投第９案,新北市,中和區,忠孝里,1317,839,302,104,406,37,443
公投第９案,新北市,中和區,忠孝里,1318,762,312,98,410,28,438
公投第９案,新北市,中和區,忠孝里,1319,1420,590,145,735,66,801
公投第９案,新北市,中和區,忠孝里,1320,1272,512,126,638,55,693
公投第９案,新北市,中和區,崇南里,1321,1976,774,202,976,72,1048
公投第９案,新北市,中和區,崇南里,1322,1779,763,146,909,48,957
公投第９案,新北市,中和區,興南里,1323,1454,504,147,651,51,702
公投第９案,新北市,中和區,興南里,1324,1374,563,101,664,39,703
公投第９案,新北市,中和區,景南里,1325,1369,561,88,649,45,694
公投第９案,新北市,中和區,景南里,1326,1501,605,158,763,64,827
公投第９案,新北市,中和區,景本里,1327,920,429,114,543,56,599
公投第９案,新北市,中和區,景本里,1328,1050,467,123,590,61,651
公投第９案,新北市,中和區,橫路里,1329,321,145,34,179,19,198
公投第９案,新北市,中和區,內南里,1330,1474,603,117,720,62,782
公投第９案,新北市,中和區,內南里,1331,1461,616,154,770,68,838
公投第９案,新北市,中和區,內南里,1332,1621,653,148,801,58,859
公投第９案,新北市,中和區,壽南里,1333,1327,565,188,753,68,821
公投第９案,新北市,中和區,壽南里,1334,775,312,101,413,33,446
公投第９案,新北市,中和區,福南里,1335,1916,723,192,915,41,956
公投第９案,新北市,中和區,福南里,1336,1901,751,166,917,69,986
公投第９案,新北市,中和區,外南里,1337,4411,554,155,709,44,753
公投第９案,新北市,中和區,外南里,1338,1212,484,142,626,41,667
公投第９案,新北市,中和區,外南里,1339,1126,468,139,607,42,649
公投第９案,新北市,中和區,中興里,1340,1507,593,155,748,27,775
公投第９案,新北市,中和區,中興里,1341,1519,646,144,790,27,817
公投第９案,新北市,中和區,中興里,1342,1467,624,167,791,46,837
公投第９案,新北市,中和區,中興里,1343,1453,631,181,812,72,884
公投第９案,新北市,中和區,吉興里,1344,1364,619,149,768,53,821
公投第９案,新北市,中和區,吉興里,1345,1302,555,127,682,47,729
公投第９案,新北市,中和區,復興里,1346,1627,559,149,708,35,743
公投第９案,新北市,中和區,復興里,1347,1503,562,162,724,39,763
公投第９案,新北市,中和區,復興里,1348,1392,545,139,684,21,705
公投第９案,新北市,中和區,和興里,1349,1067,499,103,602,36,638
公投第９案,新北市,中和區,和興里,1350,1623,632,176,808,50,858
公投第９案,新北市,中和區,和興里,1351,1208,555,132,687,21,708
公投第９案,新北市,中和區,景平里,1352,1991,670,170,840,50,890
公投第９案,新北市,中和區,景平里,1353,1932,698,152,850,46,896
公投第９案,新北市,中和區,景平里,1354,947,468,119,587,35,622
公投第９案,新北市,中和區,景新里,1355,1660,707,187,894,58,952
公投第９案,新北市,中和區,景新里,1356,1574,580,139,719,66,785
公投第９案,新北市,中和區,景福里,1357,2136,800,205,1005,57,1062
公投第９案,新北市,中和區,景福里,1358,1462,538,166,704,76,780
公投第９案,新北市,中和區,景福里,1359,1548,593,144,737,71,808
公投第９案,新北市,中和區,景安里,1360,692,349,86,435,22,457
公投第９案,新北市,中和區,景安里,1361,1221,604,117,721,49,770
公投第９案,新北市,中和區,景安里,1362,1331,552,186,738,53,791
公投第９案,新北市,中和區,景安里,1363,984,444,118,562,41,603
公投第９案,新北市,中和區,景文里,1364,1871,720,174,894,51,945
公投第９案,新北市,中和區,景文里,1365,1279,512,128,640,36,676
公投第９案,新北市,中和區,錦和里,1366,1629,679,199,878,44,922
公投第９案,新北市,中和區,錦和里,1367,1482,638,167,805,36,841
公投第９案,新北市,中和區,錦和里,1368,1715,729,205,934,64,998
公投第９案,新北市,中和區,錦昌里,1369,1952,835,189,1024,65,1089
公投第９案,新北市,中和區,灰磘里,1370,686,277,89,366,34,400
公投第９案,新北市,中和區,積穗里,1371,1577,549,174,723,32,755
公投第９案,新北市,中和區,積穗里,1372,1158,496,151,647,32,679
公投第９案,新北市,中和區,積穗里,1373,1195,589,128,717,22,739
公投第９案,新北市,中和區,積穗里,1374,1054,516,124,640,34,674
公投第９案,新北市,中和區,積穗里,1375,612,296,74,370,21,391
公投第９案,新北市,中和區,積穗里,1376,1668,742,158,900,36,936
公投第９案,新北市,中和區,民享里,1377,1071,454,154,608,72,680
公投第９案,新北市,中和區,民享里,1378,1169,580,158,738,59,797
公投第９案,新北市,中和區,員山里,1379,1370,525,158,683,49,732
公投第９案,新北市,中和區,員山里,1380,1574,672,186,858,89,947
公投第９案,新北市,中和區,員山里,1381,2614,892,233,1125,32,1157
公投第９案,新北市,中和區,嘉穗里,1382,1477,646,179,825,40,865
公投第９案,新北市,中和區,嘉穗里,1383,1041,394,158,552,59,611
公投第９案,新北市,中和區,文元里,1384,1538,563,163,726,62,788
公投第９案,新北市,中和區,文元里,1385,1599,600,193,793,53,846
公投第９案,新北市,中和區,文元里,1386,1586,669,196,865,79,944
公投第９案,新北市,中和區,嘉新里,1387,1726,676,246,922,97,1019
公投第９案,新北市,中和區,嘉新里,1388,1854,791,250,1041,85,1126
公投第９案,新北市,中和區,民安里,1389,1472,627,207,834,60,894
公投第９案,新北市,中和區,民安里,1390,1430,631,172,803,67,870
公投第９案,新北市,中和區,民安里,1391,1488,651,185,836,57,893
公投第９案,新北市,中和區,安穗里,1392,1251,499,154,653,29,682
公投第９案,新北市,中和區,安穗里,1393,1487,650,168,818,47,865
公投第９案,新北市,中和區,安穗里,1394,1328,476,170,646,98,744
公投第９案,新北市,中和區,瑞穗里,1395,1128,505,140,645,52,697
公投第９案,新北市,中和區,瑞穗里,1396,1008,505,123,628,28,656
公投第９案,新北市,中和區,明穗里,1397,1786,763,213,976,33,1009
公投第９案,新北市,中和區,明穗里,1398,2219,885,239,1124,55,1179
公投第９案,新北市,中和區,清穗里,1399,1322,458,170,628,37,665
公投第９案,新北市,中和區,清穗里,1400,1495,702,140,842,26,868
公投第９案,新北市,中和區,自強里,1401,1414,550,154,704,57,761
公投第９案,新北市,中和區,自強里,1402,1681,675,216,891,76,967
公投第９案,新北市,中和區,自強里,1403,1361,535,157,692,59,751
公投第９案,新北市,中和區,德穗里,1404,1442,574,170,744,58,802
公投第９案,新北市,中和區,德穗里,1405,1383,527,163,690,24,714
公投第９案,新北市,中和區,德穗里,1406,1264,530,142,672,39,711
公投第９案,新北市,中和區,民生里,1407,1810,731,226,957,105,1062
公投第９案,新北市,中和區,民生里,1408,1951,705,200,905,47,952
公投第９案,新北市,中和區,國光里,1409,1582,591,133,724,51,775
公投第９案,新北市,中和區,國光里,1410,1945,827,237,1064,88,1152
公投第９案,新北市,中和區,壽德里,1411,1390,605,152,757,47,804
公投第９案,新北市,中和區,壽德里,1412,1161,490,142,632,23,655
公投第９案,新北市,中和區,壽德里,1413,1399,657,97,754,31,785
公投第９案,新北市,中和區,明德里,1414,1070,430,124,554,28,582
公投第９案,新北市,中和區,明德里,1415,1169,463,127,590,33,623
公投第９案,新北市,中和區,明德里,1416,1214,562,139,701,64,765
公投第９案,新北市,中和區,錦中里,1417,1398,643,134,777,57,834
公投第９案,新北市,中和區,錦中里,1418,1049,436,128,564,37,601
公投第９案,新北市,中和區,錦中里,1419,1324,610,155,765,43,808
公投第９案,新北市,中和區,錦盛里,1420,1765,619,161,780,36,816
公投第９案,新北市,中和區,錦盛里,1421,1709,655,162,817,56,873
公投第９案,新北市,中和區,民有里,1422,1186,486,148,634,62,696
公投第９案,新北市,中和區,民有里,1423,1318,549,170,719,51,770
公投第９案,新北市,中和區,員富里,1424,1430,586,189,775,55,830
公投第９案,新北市,中和區,員富里,1425,1637,519,149,668,61,729
公投第９案,新北市,中和區,嘉慶里,1426,1283,498,169,667,50,717
公投第９案,新北市,中和區,嘉慶里,1427,1310,543,157,700,39,739
公投第９案,新北市,中和區,嘉慶里,1428,1301,554,156,710,52,762
公投第９案,新北市,中和區,冠穗里,1429,1681,717,179,896,69,965
公投第９案,新北市,中和區,冠穗里,1430,1384,592,146,738,43,781
公投第９案,新北市,中和區,國華里,1431,1187,481,145,626,57,683
公投第９案,新北市,中和區,國華里,1432,1779,602,172,774,7,781
公投第９案,新北市,中和區,宜安里,1433,1712,742,173,915,50,965
公投第９案,新北市,中和區,安樂里,1434,1462,582,164,746,51,797
公投第９案,新北市,中和區,安樂里,1435,1824,723,211,934,34,968
公投第９案,新北市,中和區,安和里,1436,1389,546,153,699,70,769
公投第９案,新北市,中和區,安和里,1437,1434,634,169,803,40,843
公投第９案,新北市,中和區,安順里,1438,1953,788,187,975,61,1036
公投第９案,新北市,中和區,安順里,1439,2002,838,230,1068,61,1129
公投第９案,新北市,中和區,安平里,1440,1858,756,170,926,36,962
公投第９案,新北市,中和區,安平里,1441,1801,755,168,923,34,957
公投第９案,新北市,中和區,安平里,1442,1691,732,176,908,57,965
公投第９案,新北市,中和區,中安里,1443,1363,606,151,757,51,808
公投第９案,新北市,中和區,中安里,1444,1220,602,123,725,26,751
公投第９案,新北市,中和區,中安里,1445,1365,660,146,806,29,835
公投第９案,新北市,中和區,泰安里,1446,1178,518,120,638,27,665
公投第９案,新北市,中和區,泰安里,1447,830,360,108,468,36,504
公投第９案,新北市,中和區,泰安里,1448,1197,457,126,583,51,634
公投第９案,新北市,中和區,秀山里,1449,1369,580,167,747,54,801
公投第９案,新北市,中和區,秀山里,1450,1336,612,136,748,50,798
公投第９案,新北市,中和區,秀山里,1451,1377,658,147,805,57,862
公投第９案,新北市,中和區,秀成里,1452,1499,659,162,821,62,883
公投第９案,新北市,中和區,秀成里,1453,1689,767,166,933,45,978
公投第９案,新北市,中和區,秀義里,1454,1323,599,159,758,54,812
公投第９案,新北市,中和區,秀義里,1455,1079,492,136,628,49,677
公投第９案,新北市,中和區,秀福里,1456,1545,659,175,834,67,901
公投第９案,新北市,中和區,秀福里,1457,1326,590,89,679,60,739
公投第９案,新北市,中和區,秀福里,1458,1443,592,153,745,36,781
公投第９案,新北市,中和區,秀景里,1459,1712,730,177,907,30,937
公投第９案,新北市,中和區,秀景里,1460,1916,785,202,987,55,1042
公投第９案,新北市,中和區,秀景里,1461,863,384,116,500,41,541
公投第９案,新北市,中和區,秀景里,1462,1203,583,139,722,14,736
公投第９案,新北市,中和區,秀明里,1463,1483,646,128,774,17,791
公投第９案,新北市,中和區,秀明里,1464,1575,682,123,805,33,838
公投第９案,新北市,中和區,秀明里,1465,1432,533,136,669,57,726
公投第９案,新北市,中和區,秀峰里,1466,1441,620,134,754,58,812
公投第９案,新北市,中和區,秀峰里,1467,1269,573,136,709,51,760
公投第９案,新北市,中和區,秀峰里,1468,1363,670,110,780,31,811
公投第９案,新北市,中和區,秀士里,1469,1089,507,88,595,29,624
公投第９案,新北市,中和區,秀士里,1470,1171,436,136,572,33,605
公投第９案,新北市,中和區,秀水里,1471,1150,486,119,605,40,645
公投第９案,新北市,中和區,秀水里,1472,1154,549,153,702,47,749
公投第９案,新北市,中和區,秀水里,1473,1067,517,100,617,40,657
公投第９案,新北市,中和區,秀仁里,1474,1526,625,152,777,45,822
公投第９案,新北市,中和區,秀仁里,1475,1447,645,154,799,41,840
公投第９案,新北市,永和區,光復里,1476,1554,650,187,837,82,919
公投第９案,新北市,永和區,網溪里,1477,1065,464,109,573,22,595
公投第９案,新北市,永和區,復興里,1478,854,403,97,500,38,538
公投第９案,新北市,永和區,復興里,1479,1253,553,133,686,53,739
公投第９案,新北市,永和區,竹林里,1480,1733,755,179,934,40,974
公投第９案,新北市,永和區,竹林里,1481,1581,690,149,839,55,894
公投第９案,新北市,永和區,桂林里,1482,1735,713,176,889,52,941
公投第９案,新北市,永和區,桂林里,1483,1563,662,146,808,22,830
公投第９案,新北市,永和區,上林里,1484,1650,714,207,921,56,977
公投第９案,新北市,永和區,上林里,1485,1454,659,127,786,39,825
公投第９案,新北市,永和區,福林里,1486,1568,607,163,770,53,823
公投第９案,新北市,永和區,福林里,1487,1444,616,148,764,39,803
公投第９案,新北市,永和區,勵行里,1488,1140,422,150,572,51,623
公投第９案,新北市,永和區,中興里,1489,1188,548,138,686,49,735
公投第９案,新北市,永和區,中興里,1490,1516,611,181,792,59,851
公投第９案,新北市,永和區,永興里,1491,1397,590,129,719,61,780
公投第９案,新北市,永和區,永興里,1492,1438,593,170,763,44,807
公投第９案,新北市,永和區,正興里,1493,1084,482,127,609,40,649
公投第９案,新北市,永和區,正興里,1494,941,407,104,511,33,544
公投第９案,新北市,永和區,豫溪里,1495,1598,575,141,716,50,766
公投第９案,新北市,永和區,豫溪里,1496,2842,645,161,806,32,838
公投第９案,新北市,永和區,光明里,1497,1261,567,172,739,49,788
公投第９案,新北市,永和區,光明里,1498,1449,692,187,879,47,926
公投第９案,新北市,永和區,福和里,1499,1511,644,197,841,43,884
公投第９案,新北市,永和區,福和里,1500,1470,730,163,893,50,943
公投第９案,新北市,永和區,福和里,1501,1580,696,164,860,41,901
公投第９案,新北市,永和區,得和里,1502,1438,701,160,861,44,905
公投第９案,新北市,永和區,得和里,1503,1305,641,137,778,32,810
公投第９案,新北市,永和區,得和里,1504,1046,486,118,604,28,632
公投第９案,新北市,永和區,永貞里,1505,1566,674,189,863,28,891
公投第９案,新北市,永和區,永貞里,1506,1468,636,190,826,35,861
公投第９案,新北市,永和區,永福里,1507,1305,700,156,856,41,897
公投第９案,新北市,永和區,永福里,1508,1181,521,144,665,40,705
公投第９案,新北市,永和區,河濱里,1509,1720,675,204,879,57,936
公投第９案,新北市,永和區,河濱里,1510,1103,505,145,650,30,680
公投第９案,新北市,永和區,秀和里,1511,1649,698,161,859,103,962
公投第９案,新北市,永和區,秀和里,1512,1206,565,158,723,33,756
公投第９案,新北市,永和區,秀和里,1513,1506,664,195,859,48,907
公投第９案,新北市,永和區,永元里,1514,1488,627,165,792,63,855
公投第９案,新北市,永和區,永元里,1515,1288,592,152,744,51,795
公投第９案,新北市,永和區,永元里,1516,1413,574,127,701,34,735
公投第９案,新北市,永和區,民權里,1517,1329,597,120,717,55,772
公投第９案,新北市,永和區,民權里,1518,1436,695,158,853,34,887
公投第９案,新北市,永和區,民權里,1519,1112,479,137,616,48,664
公投第９案,新北市,永和區,民族里,1520,1100,589,111,700,42,742
公投第９案,新北市,永和區,民族里,1521,1545,730,172,902,52,954
公投第９案,新北市,永和區,民族里,1522,1436,626,146,772,29,801
公投第９案,新北市,永和區,秀朗里,1523,1731,831,180,1011,61,1072
公投第９案,新北市,永和區,秀朗里,1524,1762,782,231,1013,72,1085
公投第９案,新北市,永和區,秀成里,1525,1320,533,161,694,47,741
公投第９案,新北市,永和區,秀成里,1526,1297,478,124,602,22,624
公投第９案,新北市,永和區,秀林里,1527,1798,739,196,935,62,997
公投第９案,新北市,永和區,秀林里,1528,1491,639,193,832,71,903
公投第９案,新北市,永和區,秀得里,1529,1223,545,116,661,24,685
公投第９案,新北市,永和區,秀得里,1530,1108,471,141,612,52,664
公投第９案,新北市,永和區,秀元里,1531,1408,622,174,796,64,860
公投第９案,新北市,永和區,秀元里,1532,1265,565,156,721,53,774
公投第９案,新北市,永和區,民生里,1533,1115,459,122,581,22,603
公投第９案,新北市,永和區,民生里,1534,1133,509,154,663,64,727
公投第９案,新北市,永和區,民生里,1535,1217,529,144,673,52,725
公投第９案,新北市,永和區,民本里,1536,1713,693,202,895,59,954
公投第９案,新北市,永和區,民本里,1537,1721,701,184,885,57,942
公投第９案,新北市,永和區,民富里,1538,1327,550,137,687,61,748
公投第９案,新北市,永和區,民富里,1539,1257,595,153,748,32,780
公投第９案,新北市,永和區,民樂里,1540,1348,671,139,810,42,852
公投第９案,新北市,永和區,民樂里,1541,1461,728,156,884,41,925
公投第９案,新北市,永和區,民樂里,1542,1368,588,157,745,70,815
公投第９案,新北市,永和區,民治里,1543,1234,541,111,652,70,722
公投第９案,新北市,永和區,民治里,1544,1303,574,137,711,51,762
公投第９案,新北市,永和區,智光里,1545,1516,656,133,789,30,819
公投第９案,新北市,永和區,智光里,1546,1422,672,141,813,54,867
公投第９案,新北市,永和區,潭安里,1547,991,460,128,588,31,619
公投第９案,新北市,永和區,潭安里,1548,1016,481,117,598,35,633
公投第９案,新北市,永和區,潭安里,1549,1146,534,121,655,38,693
公投第９案,新北市,永和區,潭安里,1550,1043,478,118,596,24,620
公投第９案,新北市,永和區,潭墘里,1551,1210,560,137,697,23,720
公投第９案,新北市,永和區,潭墘里,1552,1630,732,166,898,28,926
公投第９案,新北市,永和區,潭墘里,1553,1092,508,116,624,22,646
公投第９案,新北市,永和區,店街里,1554,1872,830,214,1044,57,1101
公投第９案,新北市,永和區,店街里,1555,1781,788,164,952,43,995
公投第９案,新北市,永和區,大新里,1556,1049,471,127,598,46,644
公投第９案,新北市,永和區,大新里,1557,1285,606,162,768,38,806
公投第９案,新北市,永和區,永安里,1558,1209,562,139,701,36,737
公投第９案,新北市,永和區,永安里,1559,1132,537,141,678,31,709
公投第９案,新北市,永和區,永安里,1560,1287,634,154,788,49,837
公投第９案,新北市,永和區,永樂里,1561,1068,502,121,623,45,668
公投第９案,新北市,永和區,永樂里,1562,1098,512,141,653,45,698
公投第９案,新北市,永和區,水源里,1563,1222,587,124,711,49,760
公投第９案,新北市,永和區,水源里,1564,1157,510,138,648,64,712
公投第９案,新北市,永和區,水源里,1565,1168,548,170,718,57,775
公投第９案,新北市,永和區,協和里,1566,1283,531,162,693,56,749
公投第９案,新北市,永和區,協和里,1567,1372,601,151,752,43,795
公投第９案,新北市,永和區,雙和里,1568,1876,869,191,1060,52,1112
公投第９案,新北市,永和區,雙和里,1569,1576,734,192,926,72,998
公投第９案,新北市,永和區,安和里,1570,1661,858,92,950,44,994
公投第９案,新北市,永和區,安和里,1571,1808,797,183,980,28,1008
公投第９案,新北市,永和區,前溪里,1572,1898,831,217,1048,39,1087
公投第９案,新北市,永和區,和平里,1573,1508,684,187,871,52,923
公投第９案,新北市,永和區,和平里,1574,1341,610,147,757,67,824
公投第９案,新北市,永和區,和平里,1575,1422,638,140,778,49,827
公投第９案,新北市,永和區,保平里,1576,1177,515,136,651,34,685
公投第９案,新北市,永和區,保平里,1577,1557,671,177,848,64,912
公投第９案,新北市,永和區,保平里,1578,1491,568,207,775,50,825
公投第９案,新北市,永和區,中溪里,1579,1586,670,181,851,48,899
公投第９案,新北市,永和區,中溪里,1580,1313,544,137,681,20,701
公投第９案,新北市,永和區,中溪里,1581,1636,671,198,869,67,936
公投第９案,新北市,永和區,保安里,1582,1598,680,177,857,60,917
公投第９案,新北市,永和區,保安里,1583,1609,736,181,917,58,975
公投第９案,新北市,永和區,保安里,1584,1375,635,176,811,40,851
公投第９案,新北市,永和區,保安里,1585,1648,814,169,983,54,1037
公投第９案,新北市,永和區,保順里,1586,1077,482,124,606,42,648
公投第９案,新北市,永和區,保順里,1587,1157,507,168,675,33,708
公投第９案,新北市,永和區,保順里,1588,1339,658,165,823,30,853
公投第９案,新北市,永和區,保順里,1589,1306,629,150,779,18,797
公投第９案,新北市,永和區,保順里,1590,1236,623,131,754,22,776
公投第９案,新北市,永和區,保順里,1591,1133,563,119,682,21,703
公投第９案,新北市,永和區,保順里,1592,1425,695,137,832,34,866
公投第９案,新北市,永和區,下溪里,1593,1938,817,214,1031,80,1111
公投第９案,新北市,永和區,下溪里,1594,1607,697,198,895,62,957
公投第９案,新北市,永和區,大同里,1595,853,407,84,491,37,528
公投第９案,新北市,永和區,新生里,1596,768,310,70,380,46,426
公投第９案,新北市,永和區,永成里,1597,893,303,75,378,31,409
公投第９案,新北市,永和區,忠義里,1598,743,332,70,402,34,436
公投第９案,新北市,永和區,仁愛里,1599,1155,529,145,674,42,716
公投第９案,新北市,永和區,仁愛里,1600,1263,585,153,738,43,781
公投第９案,新北市,永和區,文化里,1601,1189,591,108,699,28,727
公投第９案,新北市,永和區,文化里,1602,1346,569,134,703,35,738
公投第９案,新北市,永和區,信義里,1603,1368,562,171,733,49,782
公投第９案,新北市,永和區,信義里,1604,1043,478,114,592,21,613
公投第９案,新北市,永和區,後溪里,1605,1709,743,232,975,46,1021
公投第９案,新北市,永和區,上溪里,1606,879,364,92,456,23,479
公投第９案,新北市,永和區,上溪里,1607,904,372,133,505,36,541
公投第９案,新北市,永和區,頂溪里,1608,1221,581,135,716,55,771
公投第９案,新北市,永和區,頂溪里,1609,1018,467,113,580,48,628
公投第９案,新北市,永和區,河堤里,1610,1551,654,173,827,35,862
公投第９案,新北市,永和區,河堤里,1611,1428,645,165,810,49,859
公投第９案,新北市,永和區,新廍里,1612,1044,468,126,594,56,650
公投第９案,新北市,永和區,新廍里,1613,967,448,114,562,40,602
公投第９案,新北市,樹林區,三興里,1614,1408,506,163,669,72,741
公投第９案,新北市,樹林區,三興里,1615,1310,491,149,640,32,672
公投第９案,新北市,樹林區,三興里,1616,1534,530,162,692,50,742
公投第９案,新北市,樹林區,三福里,1617,1211,457,154,611,60,671
公投第９案,新北市,樹林區,三福里,1618,1125,466,150,616,44,660
公投第９案,新北市,樹林區,三福里,1619,1134,486,159,645,37,682
公投第９案,新北市,樹林區,三多里,1620,1897,577,230,807,84,891
公投第９案,新北市,樹林區,三多里,1621,1716,616,220,836,78,914
公投第９案,新北市,樹林區,三龍里,1622,736,299,121,420,38,458
公投第９案,新北市,樹林區,三龍里,1623,1137,503,151,654,35,689
公投第９案,新北市,樹林區,獇寮里,1624,1542,563,185,748,51,799
公投第９案,新北市,樹林區,獇寮里,1625,1470,569,169,738,64,802
公投第９案,新北市,樹林區,獇寮里,1626,1456,498,149,647,32,679
公投第９案,新北市,樹林區,光興里,1627,1124,467,127,594,22,616
公投第９案,新北市,樹林區,光興里,1628,1235,470,154,624,32,656
公投第９案,新北市,樹林區,光興里,1629,1212,463,173,636,32,668
公投第９案,新北市,樹林區,金寮里,1630,1223,424,136,560,35,595
公投第９案,新北市,樹林區,金寮里,1631,1335,483,179,662,73,735
公投第９案,新北市,樹林區,金寮里,1632,1206,467,159,626,37,663
公投第９案,新北市,樹林區,潭底里,1633,1927,465,171,636,79,715
公投第９案,新北市,樹林區,潭底里,1634,914,361,113,474,46,520
公投第９案,新北市,樹林區,潭底里,1635,1456,599,179,778,58,836
公投第９案,新北市,樹林區,文林里,1636,1409,522,171,693,47,740
公投第９案,新北市,樹林區,文林里,1637,1500,614,222,836,63,899
公投第９案,新北市,樹林區,文林里,1638,1545,624,186,810,59,869
公投第９案,新北市,樹林區,保安里,1639,1483,569,178,747,25,772
公投第９案,新北市,樹林區,保安里,1640,1524,592,157,749,42,791
公投第９案,新北市,樹林區,保安里,1641,1431,593,166,759,38,797
公投第９案,新北市,樹林區,保安里,1642,1181,432,155,587,69,656
公投第９案,新北市,樹林區,圳安里,1643,1116,453,142,595,58,653
公投第９案,新北市,樹林區,圳安里,1644,1077,361,169,530,35,565
公投第９案,新北市,樹林區,圳安里,1645,1103,384,135,519,15,534
公投第９案,新北市,樹林區,圳福里,1646,1385,563,154,717,55,772
公投第９案,新北市,樹林區,圳福里,1647,1266,472,148,620,44,664
公投第９案,新北市,樹林區,圳福里,1648,1195,442,162,604,45,649
公投第９案,新北市,樹林區,圳民里,1649,1254,462,163,625,54,679
公投第９案,新北市,樹林區,圳民里,1650,1263,515,168,683,46,729
公投第９案,新北市,樹林區,圳生里,1651,1473,594,224,818,78,896
公投第９案,新北市,樹林區,樹德里,1652,870,375,95,470,26,496
公投第９案,新北市,樹林區,樹德里,1653,1338,560,185,745,74,819
公投第９案,新北市,樹林區,樹德里,1654,1010,400,99,499,35,534
公投第９案,新北市,樹林區,樹福里,1655,1658,682,224,906,53,959
公投第９案,新北市,樹林區,樹福里,1656,1538,676,225,901,60,961
公投第９案,新北市,樹林區,樹西里,1657,1405,646,156,802,81,883
公投第９案,新北市,樹林區,樹西里,1658,1587,607,221,828,60,888
公投第９案,新北市,樹林區,樹西里,1659,1566,614,210,824,48,872
公投第９案,新北市,樹林區,樹興里,1660,997,401,94,495,14,509
公投第９案,新北市,樹林區,樹興里,1661,1187,480,141,621,52,673
公投第９案,新北市,樹林區,樹興里,1662,1061,417,112,529,50,579
公投第９案,新北市,樹林區,樹人里,1663,1701,730,176,906,48,954
公投第９案,新北市,樹林區,樹人里,1664,1278,527,139,666,57,723
公投第９案,新北市,樹林區,育英里,1665,1433,628,178,806,59,865
公投第９案,新北市,樹林區,育英里,1666,1306,561,168,729,70,799
公投第９案,新北市,樹林區,樹南里,1667,1268,528,178,706,66,772
公投第９案,新北市,樹林區,樹南里,1668,1281,535,167,702,27,729
公投第９案,新北市,樹林區,樹南里,1669,1200,492,172,664,50,714
公投第９案,新北市,樹林區,坡內里,1670,1491,553,182,735,33,768
公投第９案,新北市,樹林區,樹東里,1671,1066,400,130,530,23,553
公投第９案,新北市,樹林區,樹北里,1672,877,389,110,499,59,558
公投第９案,新北市,樹林區,彭福里,1673,1616,629,180,809,66,875
公投第９案,新北市,樹林區,彭福里,1674,1589,527,152,679,64,743
公投第９案,新北市,樹林區,彭福里,1675,1367,583,148,731,65,796
公投第９案,新北市,樹林區,和平里,1676,1144,485,155,640,46,686
公投第９案,新北市,樹林區,和平里,1677,1059,398,123,521,33,554
公投第９案,新北市,樹林區,和平里,1678,1224,446,167,613,67,680
公投第９案,新北市,樹林區,彭興里,1679,1141,425,123,548,42,590
公投第９案,新北市,樹林區,彭興里,1680,1396,457,116,573,25,598
公投第９案,新北市,樹林區,彭興里,1681,1157,435,162,597,37,634
公投第９案,新北市,樹林區,彭興里,1682,1498,498,196,694,81,775
公投第９案,新北市,樹林區,彭厝里,1683,1514,585,176,761,71,832
公投第９案,新北市,樹林區,彭厝里,1684,1546,561,168,729,51,780
公投第９案,新北市,樹林區,彭厝里,1685,1392,554,168,722,50,772
公投第９案,新北市,樹林區,大同里,1686,1566,685,138,823,49,872
公投第９案,新北市,樹林區,大同里,1687,1566,648,169,817,24,841
公投第９案,新北市,樹林區,中華里,1688,1517,601,168,769,53,822
公投第９案,新北市,樹林區,中華里,1689,1481,617,161,778,37,815
公投第９案,新北市,樹林區,太順里,1690,1261,488,143,631,50,681
公投第９案,新北市,樹林區,太順里,1691,1163,459,119,578,30,608
公投第９案,新北市,樹林區,東昇里,1692,1661,669,251,920,74,994
公投第９案,新北市,樹林區,東昇里,1693,1585,649,197,846,48,894
公投第９案,新北市,樹林區,東昇里,1694,1018,460,120,580,37,617
公投第９案,新北市,樹林區,東陽里,1695,1247,482,148,630,70,700
公投第９案,新北市,樹林區,東陽里,1696,1390,535,140,675,78,753
公投第９案,新北市,樹林區,東陽里,1697,1293,539,159,698,44,742
公投第９案,新北市,樹林區,東陽里,1698,1301,480,138,618,32,650
公投第９案,新北市,樹林區,東山里,1699,1606,620,166,786,63,849
公投第９案,新北市,樹林區,東山里,1700,1277,445,182,627,71,698
公投第９案,新北市,樹林區,山佳里,1701,1219,459,173,632,63,695
公投第９案,新北市,樹林區,山佳里,1702,1454,558,139,697,36,733
公投第９案,新北市,樹林區,山佳里,1703,1314,514,144,658,42,700
公投第９案,新北市,樹林區,山佳里,1704,1008,468,144,612,26,638
公投第９案,新北市,樹林區,中山里,1705,1574,603,173,776,70,846
公投第９案,新北市,樹林區,中山里,1706,1364,586,144,730,37,767
公投第９案,新北市,樹林區,中山里,1707,1677,581,185,766,84,850
公投第９案,新北市,樹林區,樂山里,1708,1683,523,158,681,40,721
公投第９案,新北市,樹林區,柑園里,1709,1452,628,171,799,46,845
公投第９案,新北市,樹林區,柑園里,1710,1592,721,168,889,31,920
公投第９案,新北市,樹林區,柑園里,1711,1619,731,167,898,37,935
公投第９案,新北市,樹林區,柑園里,1712,1642,785,197,982,32,1014
公投第９案,新北市,樹林區,柑園里,1713,1357,593,138,731,24,755
公投第９案,新北市,樹林區,西園里,1714,1638,604,250,854,88,942
公投第９案,新北市,樹林區,南園里,1715,1592,647,166,813,47,860
公投第９案,新北市,樹林區,南園里,1716,1521,665,168,833,52,885
公投第９案,新北市,樹林區,南園里,1717,1707,755,212,967,60,1027
公投第９案,新北市,樹林區,南園里,1718,1741,741,232,973,64,1037
公投第９案,新北市,樹林區,南園里,1719,1655,703,165,868,41,909
公投第９案,新北市,樹林區,南園里,1720,1775,650,174,824,79,903
公投第９案,新北市,樹林區,南園里,1721,1781,756,173,929,60,989
公投第９案,新北市,樹林區,東園里,1722,1565,488,175,663,48,711
公投第９案,新北市,樹林區,北園里,1723,936,330,129,459,45,504
公投第９案,新北市,樹林區,北園里,1724,1030,396,141,537,21,558
公投第９案,新北市,鶯歌區,建德里,1725,515,215,57,272,21,293
公投第９案,新北市,鶯歌區,東鶯里,1726,965,407,129,536,43,579
公投第９案,新北市,鶯歌區,北鶯里,1727,1931,746,231,977,88,1065
公投第９案,新北市,鶯歌區,北鶯里,1728,1797,598,198,796,92,888
公投第９案,新北市,鶯歌區,西鶯里,1729,1057,427,118,545,45,590
公投第９案,新北市,鶯歌區,西鶯里,1730,962,365,100,465,15,480
公投第９案,新北市,鶯歌區,中鶯里,1731,934,415,130,545,39,584
公投第９案,新北市,鶯歌區,南鶯里,1732,1742,769,207,976,76,1052
公投第９案,新北市,鶯歌區,南鶯里,1733,1634,602,197,799,61,860
公投第９案,新北市,鶯歌區,南鶯里,1734,1676,626,149,775,48,823
公投第９案,新北市,鶯歌區,建國里,1735,2052,783,237,1020,100,1120
公投第９案,新北市,鶯歌區,建國里,1736,1977,679,187,866,39,905
公投第９案,新北市,鶯歌區,建國里,1737,1957,759,230,989,31,1020
公投第９案,新北市,鶯歌區,二甲里,1738,850,272,78,350,29,379
公投第９案,新北市,鶯歌區,二橋里,1739,1782,673,186,859,52,911
公投第９案,新北市,鶯歌區,二橋里,1740,1496,591,155,746,45,791
公投第９案,新北市,鶯歌區,二橋里,1741,2071,719,226,945,47,992
公投第９案,新北市,鶯歌區,二橋里,1742,1753,559,169,728,61,789
公投第９案,新北市,鶯歌區,尖山里,1743,1737,676,142,818,47,865
公投第９案,新北市,鶯歌區,尖山里,1744,1669,621,157,778,57,835
公投第９案,新北市,鶯歌區,尖山里,1745,1842,603,179,782,43,825
公投第９案,新北市,鶯歌區,尖山里,1746,1454,508,172,680,56,736
公投第９案,新北市,鶯歌區,南靖里,1747,942,350,115,465,35,500
公投第９案,新北市,鶯歌區,南靖里,1748,1317,475,168,643,57,700
公投第９案,新北市,鶯歌區,南靖里,1749,949,312,87,399,24,423
公投第９案,新北市,鶯歌區,同慶里,1750,1440,614,183,797,51,848
公投第９案,新北市,鶯歌區,永昌里,1751,1809,695,224,919,70,989
公投第９案,新北市,鶯歌區,永昌里,1752,1758,728,192,920,65,985
公投第９案,新北市,鶯歌區,永昌里,1753,1589,626,191,817,47,864
公投第９案,新北市,鶯歌區,永昌里,1754,1067,457,140,597,34,631
公投第９案,新北市,鶯歌區,永昌里,1755,1092,473,134,607,36,643
公投第９案,新北市,鶯歌區,永吉里,1756,1730,739,161,900,51,951
公投第９案,新北市,鶯歌區,永吉里,1757,1281,533,127,660,53,713
公投第９案,新北市,鶯歌區,永吉里,1758,1238,553,161,714,53,767
公投第９案,新北市,鶯歌區,鳳祥里,1759,1568,604,192,796,73,869
公投第９案,新北市,鶯歌區,鳳祥里,1760,1271,504,128,632,53,685
公投第９案,新北市,鶯歌區,鳳祥里,1761,1183,342,118,460,30,490
公投第９案,新北市,鶯歌區,鳳鳴里,1762,1026,364,91,455,28,483
公投第９案,新北市,鶯歌區,鳳鳴里,1763,1721,634,164,798,44,842
公投第９案,新北市,鶯歌區,鳳鳴里,1764,1317,469,149,618,71,689
公投第９案,新北市,鶯歌區,鳳福里,1765,1046,445,129,574,52,626
公投第９案,新北市,鶯歌區,鳳福里,1766,1144,457,174,631,56,687
公投第９案,新北市,鶯歌區,鳳福里,1767,1336,459,161,620,60,680
公投第９案,新北市,鶯歌區,大湖里,1768,1479,481,131,612,66,678
公投第９案,新北市,鶯歌區,大湖里,1769,1736,642,190,832,59,891
公投第９案,新北市,鶯歌區,大湖里,1770,1389,576,173,749,58,807
公投第９案,新北市,鶯歌區,中湖里,1771,1956,765,83,848,82,930
公投第９案,新北市,鶯歌區,中湖里,1772,1371,492,203,695,49,744
公投第９案,新北市,鶯歌區,中湖里,1773,1810,543,143,686,46,732
公投第９案,新北市,鶯歌區,東湖里,1774,227,76,21,97,5,102
公投第９案,新北市,土城區,祖田里,1775,1505,546,187,733,68,801
公投第９案,新北市,土城區,頂新里,1776,1242,573,134,707,39,746
公投第９案,新北市,土城區,頂新里,1777,1206,542,141,683,31,714
公投第９案,新北市,土城區,頂福里,1778,1474,536,185,721,80,801
公投第９案,新北市,土城區,頂福里,1779,1489,537,163,700,54,754
公投第９案,新北市,土城區,頂福里,1780,1675,627,174,801,57,858
公投第９案,新北市,土城區,頂埔里,1781,1499,578,182,760,60,820
公投第９案,新北市,土城區,頂埔里,1782,1495,570,156,726,49,775
公投第９案,新北市,土城區,頂埔里,1783,1411,511,179,690,70,760
公投第９案,新北市,土城區,沛陂里,1784,1378,517,141,658,47,705
公投第９案,新北市,土城區,沛陂里,1785,1256,465,153,618,48,666
公投第９案,新北市,土城區,沛陂里,1786,1379,553,176,729,61,790
公投第９案,新北市,土城區,永寧里,1787,1424,507,177,684,59,743
公投第９案,新北市,土城區,永寧里,1788,1455,546,168,714,70,784
公投第９案,新北市,土城區,永寧里,1789,1419,515,164,679,55,734
公投第９案,新北市,土城區,永寧里,1790,1357,612,153,765,46,811
公投第９案,新北市,土城區,永寧里,1791,1501,607,150,757,45,802
公投第９案,新北市,土城區,大安里,1792,1206,462,158,620,73,693
公投第９案,新北市,土城區,大安里,1793,1255,492,198,690,37,727
公投第９案,新北市,土城區,大安里,1794,1869,718,177,895,74,969
公投第９案,新北市,土城區,員仁里,1795,1292,509,153,662,35,697
公投第９案,新北市,土城區,員仁里,1796,1324,486,128,614,32,646
公投第９案,新北市,土城區,員仁里,1797,1155,420,132,552,61,613
公投第９案,新北市,土城區,員仁里,1798,1183,469,127,596,59,655
公投第９案,新北市,土城區,埤塘里,1799,2518,378,120,498,51,549
公投第９案,新北市,土城區,埤塘里,1800,1218,478,141,619,43,662
公投第９案,新北市,土城區,埤塘里,1801,1133,469,115,584,64,648
公投第９案,新北市,土城區,土城里,1802,894,336,119,455,39,494
公投第９案,新北市,土城區,土城里,1803,931,355,135,490,58,548
公投第９案,新北市,土城區,長風里,1804,1820,937,174,1111,41,1152
公投第９案,新北市,土城區,員信里,1805,1320,525,127,652,33,685
公投第９案,新北市,土城區,員信里,1806,1241,464,146,610,42,652
公投第９案,新北市,土城區,員信里,1807,1414,537,185,722,53,775
公投第９案,新北市,土城區,員林里,1808,1378,564,162,726,54,780
公投第９案,新北市,土城區,員林里,1809,1421,571,196,767,60,827
公投第９案,新北市,土城區,員林里,1810,1340,567,117,684,37,721
公投第９案,新北市,土城區,員林里,1811,1144,484,152,636,42,678
公投第９案,新北市,土城區,員福里,1812,1268,497,169,666,60,726
公投第９案,新北市,土城區,員福里,1813,1196,468,138,606,83,689
公投第９案,新北市,土城區,員福里,1814,1308,577,158,735,43,778
公投第９案,新北市,土城區,員福里,1815,1175,489,122,611,60,671
公投第９案,新北市,土城區,日和里,1816,1230,476,157,633,67,700
公投第９案,新北市,土城區,日和里,1817,1342,516,180,696,74,770
公投第９案,新北市,土城區,日和里,1818,1268,492,192,684,60,744
公投第９案,新北市,土城區,日和里,1819,1227,529,173,702,72,774
公投第９案,新北市,土城區,日新里,1820,1356,525,161,686,93,779
公投第９案,新北市,土城區,日新里,1821,1496,599,163,762,77,839
公投第９案,新北市,土城區,日新里,1822,1309,506,164,670,75,745
公投第９案,新北市,土城區,裕生里,1823,1175,472,157,629,67,696
公投第９案,新北市,土城區,裕生里,1824,1237,484,140,624,73,697
公投第９案,新北市,土城區,裕生里,1825,1256,522,131,653,64,717
公投第９案,新北市,土城區,裕生里,1826,1228,490,137,627,33,660
公投第９案,新北市,土城區,貨饒里,1827,1182,437,153,590,75,665
公投第９案,新北市,土城區,貨饒里,1828,1558,627,156,783,54,837
公投第９案,新北市,土城區,貨饒里,1829,1160,487,132,619,44,663
公投第９案,新北市,土城區,瑞興里,1830,1357,530,168,698,66,764
公投第９案,新北市,土城區,瑞興里,1831,1464,537,163,700,92,792
公投第９案,新北市,土城區,復興里,1832,1335,444,181,625,71,696
公投第９案,新北市,土城區,復興里,1833,1346,507,167,674,75,749
公投第９案,新北市,土城區,復興里,1834,1435,605,203,808,54,862
公投第９案,新北市,土城區,廣福里,1835,1639,652,182,834,68,902
公投第９案,新北市,土城區,廣福里,1836,1728,698,221,919,60,979
公投第９案,新北市,土城區,廣福里,1837,1665,569,154,723,32,755
公投第９案,新北市,土城區,學成里,1838,1333,544,190,734,74,808
公投第９案,新北市,土城區,學成里,1839,1567,650,209,859,52,911
公投第９案,新北市,土城區,埤林里,1840,1576,606,173,779,81,860
公投第９案,新北市,土城區,埤林里,1841,1458,587,186,773,62,835
公投第９案,新北市,土城區,埤林里,1842,1517,612,183,795,75,870
公投第９案,新北市,土城區,埤林里,1843,1489,647,163,810,41,851
公投第９案,新北市,土城區,埤林里,1844,1463,638,165,803,37,840
公投第９案,新北市,土城區,廣興里,1845,1584,660,167,827,24,851
公投第９案,新北市,土城區,廣興里,1846,1464,598,160,758,41,799
公投第９案,新北市,土城區,樂利里,1847,1598,634,192,826,74,900
公投第９案,新北市,土城區,樂利里,1848,1500,540,169,709,87,796
公投第９案,新北市,土城區,樂利里,1849,1542,637,166,803,39,842
公投第９案,新北市,土城區,學府里,1850,1619,711,184,895,64,959
公投第９案,新北市,土城區,學府里,1851,1521,558,161,719,35,754
公投第９案,新北市,土城區,明德里,1852,1691,656,213,869,38,907
公投第９案,新北市,土城區,明德里,1853,1657,642,187,829,52,881
公投第９案,新北市,土城區,明德里,1854,1772,775,212,987,38,1025
公投第９案,新北市,土城區,學士里,1855,1423,629,134,763,25,788
公投第９案,新北市,土城區,學士里,1856,1321,549,203,752,57,809
公投第９案,新北市,土城區,學士里,1857,1429,654,164,818,57,875
公投第９案,新北市,土城區,柑林里,1858,1445,553,167,720,53,773
公投第９案,新北市,土城區,柑林里,1859,1520,638,183,821,59,880
公投第９案,新北市,土城區,中正里,1860,1484,519,131,650,29,679
公投第９案,新北市,土城區,中正里,1861,1362,531,162,693,33,726
公投第９案,新北市,土城區,青雲里,1862,1262,503,139,642,34,676
公投第９案,新北市,土城區,青雲里,1863,1343,584,143,727,44,771
公投第９案,新北市,土城區,清和里,1864,1337,427,176,603,51,654
公投第９案,新北市,土城區,清和里,1865,1325,389,133,522,60,582
公投第９案,新北市,土城區,清和里,1866,1390,494,165,659,48,707
公投第９案,新北市,土城區,清和里,1867,1534,615,152,767,64,831
公投第９案,新北市,土城區,清化里,1868,1484,530,177,707,79,786
公投第９案,新北市,土城區,清溪里,1869,1532,537,152,689,105,794
公投第９案,新北市,土城區,清溪里,1870,1507,611,164,775,71,846
公投第９案,新北市,土城區,清溪里,1871,1550,648,172,820,51,871
公投第９案,新北市,土城區,清溪里,1872,1567,630,168,798,59,857
公投第９案,新北市,土城區,青山里,1873,1367,565,179,744,38,782
公投第９案,新北市,土城區,青山里,1874,1293,493,143,636,57,693
公投第９案,新北市,土城區,清水里,1875,1402,534,187,721,60,781
公投第９案,新北市,土城區,清水里,1876,1379,541,164,705,51,756
公投第９案,新北市,土城區,清水里,1877,1471,557,149,706,49,755
公投第９案,新北市,土城區,清水里,1878,1410,575,134,709,36,745
公投第９案,新北市,土城區,清水里,1879,1542,570,187,757,71,828
公投第９案,新北市,土城區,永豐里,1880,1238,472,153,625,58,683
公投第９案,新北市,土城區,永豐里,1881,1301,497,119,616,57,673
公投第９案,新北市,土城區,永豐里,1882,1311,648,160,808,34,842
公投第９案,新北市,土城區,永富里,1883,1511,553,142,695,32,727
公投第９案,新北市,土城區,永富里,1884,1531,564,180,744,70,814
公投第９案,新北市,土城區,永富里,1885,1638,596,182,778,69,847
公投第９案,新北市,土城區,廷寮里,1886,1335,599,154,753,36,789
公投第９案,新北市,土城區,廷寮里,1887,1459,609,147,756,49,805
公投第９案,新北市,土城區,廷寮里,1888,1489,608,158,766,36,802
公投第９案,新北市,土城區,金城里,1889,1774,725,196,921,38,959
公投第９案,新北市,土城區,金城里,1890,1792,754,172,926,52,978
公投第９案,新北市,土城區,金城里,1891,1798,745,166,911,68,979
公投第９案,新北市,土城區,峯廷里,1892,1312,475,160,635,68,703
公投第９案,新北市,土城區,峯廷里,1893,1301,494,121,615,60,675
公投第９案,新北市,土城區,峯廷里,1894,1254,449,159,608,57,665
公投第９案,新北市,土城區,峯廷里,1895,1215,445,133,578,45,623
公投第９案,新北市,土城區,峯廷里,1896,1448,574,165,739,55,794
公投第９案,新北市,土城區,延吉里,1897,1321,508,154,662,65,727
公投第９案,新北市,土城區,延吉里,1898,1150,397,143,540,62,602
公投第９案,新北市,土城區,延吉里,1899,1425,472,174,646,53,699
公投第９案,新北市,土城區,延壽里,1900,1366,561,179,740,71,811
公投第９案,新北市,土城區,延壽里,1901,1292,508,163,671,59,730
公投第９案,新北市,土城區,延壽里,1902,1317,505,145,650,66,716
公投第９案,新北市,土城區,延祿里,1903,1324,538,161,699,54,753
公投第９案,新北市,土城區,延祿里,1904,1189,460,113,573,61,634
公投第９案,新北市,土城區,延祿里,1905,1223,484,147,631,77,708
公投第９案,新北市,土城區,平和里,1906,1550,584,182,766,58,824
公投第９案,新北市,土城區,平和里,1907,1606,626,211,837,74,911
公投第９案,新北市,土城區,平和里,1908,1509,595,184,779,48,827
公投第９案,新北市,土城區,平和里,1909,1529,599,162,761,66,827
公投第９案,新北市,土城區,安和里,1910,1458,537,145,682,79,761
公投第９案,新北市,土城區,安和里,1911,1468,578,178,756,90,846
公投第９案,新北市,土城區,安和里,1912,1495,578,183,761,46,807
公投第９案,新北市,土城區,延和里,1913,1303,486,173,659,80,739
公投第９案,新北市,土城區,延和里,1914,1365,549,165,714,49,763
公投第９案,新北市,土城區,延和里,1915,1476,553,188,741,79,820
公投第９案,新北市,土城區,延和里,1916,1519,650,160,810,37,847
公投第９案,新北市,三峽區,三峽里,1917,274,115,49,164,22,186
公投第９案,新北市,三峽區,秀川里,1918,583,213,77,290,32,322
公投第９案,新北市,三峽區,八張里,1919,1765,547,193,740,22,762
公投第９案,新北市,三峽區,八張里,1920,1714,630,218,848,56,904
公投第９案,新北市,三峽區,中埔里,1921,1355,517,127,644,33,677
公投第９案,新北市,三峽區,中埔里,1922,1329,557,144,701,44,745
公投第９案,新北市,三峽區,弘道里,1923,1059,372,133,505,49,554
公投第９案,新北市,三峽區,永舘里,1924,1364,536,187,723,59,782
公投第９案,新北市,三峽區,永舘里,1925,1098,416,177,593,53,646
公投第９案,新北市,三峽區,永舘里,1926,1296,526,127,653,56,709
公投第９案,新北市,三峽區,永舘里,1927,1240,450,149,599,63,662
公投第９案,新北市,三峽區,永舘里,1928,1531,576,183,759,49,808
公投第９案,新北市,三峽區,鳶山里,1929,1444,525,127,652,42,694
公投第９案,新北市,三峽區,鳶山里,1930,1347,509,152,661,69,730
公投第９案,新北市,三峽區,鳶山里,1931,1455,525,200,725,53,778
公投第９案,新北市,三峽區,鳶山里,1932,1556,523,144,667,38,705
公投第９案,新北市,三峽區,鳶山里,1933,1390,407,150,557,39,596
公投第９案,新北市,三峽區,鳶山里,1934,1532,598,168,766,54,820
公投第９案,新北市,三峽區,龍埔里,1935,1377,466,144,610,64,674
公投第９案,新北市,三峽區,龍埔里,1936,1731,663,172,835,59,894
公投第９案,新北市,三峽區,龍埔里,1937,1705,635,183,818,31,849
公投第９案,新北市,三峽區,龍埔里,1938,1590,666,162,828,33,861
公投第９案,新北市,三峽區,龍埔里,1939,1650,729,169,898,25,923
公投第９案,新北市,三峽區,龍恩里,1940,1441,601,152,753,29,782
公投第９案,新北市,三峽區,龍恩里,1941,1404,629,164,793,23,816
公投第９案,新北市,三峽區,龍恩里,1942,1295,592,145,737,33,770
公投第９案,新北市,三峽區,龍恩里,1943,1348,496,130,626,25,651
公投第９案,新北市,三峽區,龍學里,1944,1579,678,155,833,24,857
公投第９案,新北市,三峽區,龍學里,1945,1435,601,140,741,21,762
公投第９案,新北市,三峽區,龍學里,1946,1659,769,168,937,32,969
公投第９案,新北市,三峽區,龍學里,1947,1512,723,158,881,34,915
公投第９案,新北市,三峽區,龍學里,1948,1463,654,151,805,42,847
公投第９案,新北市,三峽區,龍學里,1949,1465,669,141,810,24,834
公投第９案,新北市,三峽區,龍學里,1950,1463,679,135,814,21,835
公投第９案,新北市,三峽區,龍學里,1951,1443,653,141,794,31,825
公投第９案,新北市,三峽區,礁溪里,1952,1634,604,158,762,61,823
公投第９案,新北市,三峽區,礁溪里,1953,1716,656,197,853,58,911
公投第９案,新北市,三峽區,礁溪里,1954,1675,630,170,800,64,864
公投第９案,新北市,三峽區,安溪里,1955,1649,513,155,668,51,719
公投第９案,新北市,三峽區,安溪里,1956,1489,537,176,713,73,786
公投第９案,新北市,三峽區,安溪里,1957,1771,650,164,814,50,864
公投第９案,新北市,三峽區,安溪里,1958,1726,679,207,886,52,938
公投第９案,新北市,三峽區,介壽里,1959,1363,509,149,658,70,728
公投第９案,新北市,三峽區,介壽里,1960,1624,630,165,795,45,840
公投第９案,新北市,三峽區,介壽里,1961,1352,541,162,703,52,755
公投第９案,新北市,三峽區,介壽里,1962,1608,426,156,582,24,606
公投第９案,新北市,三峽區,中正里,1963,1458,561,154,715,63,778
公投第９案,新北市,三峽區,中正里,1964,1641,578,165,743,46,789
公投第９案,新北市,三峽區,中正里,1965,1530,523,181,704,106,810
公投第９案,新北市,三峽區,大埔里,1966,1389,424,132,556,74,630
公投第９案,新北市,三峽區,大埔里,1967,1315,447,145,592,75,667
公投第９案,新北市,三峽區,大埔里,1968,934,444,90,534,35,569
公投第９案,新北市,三峽區,嘉添里,1969,1270,423,136,559,35,594
公投第９案,新北市,三峽區,嘉添里,1970,929,296,113,409,48,457
公投第９案,新北市,三峽區,添福里,1971,1035,372,112,484,19,503
公投第９案,新北市,三峽區,金圳里,1972,502,158,38,196,24,220
公投第９案,新北市,三峽區,五寮里,1973,836,263,89,352,55,407
公投第９案,新北市,三峽區,插角里,1974,669,204,68,272,55,327
公投第９案,新北市,三峽區,有木里,1975,733,260,100,360,71,431
公投第９案,新北市,三峽區,二鬮里,1976,1560,677,195,872,67,939
公投第９案,新北市,三峽區,二鬮里,1977,1638,623,177,800,43,843
公投第９案,新北市,三峽區,溪南里,1978,1394,469,142,611,48,659
公投第９案,新北市,三峽區,溪北里,1979,771,293,108,401,43,444
公投第９案,新北市,三峽區,溪北里,1980,1367,467,164,631,32,663
公投第９案,新北市,三峽區,溪東里,1981,1241,449,136,585,59,644
公投第９案,新北市,三峽區,溪東里,1982,1520,525,150,675,37,712
公投第９案,新北市,三峽區,成福里,1983,873,387,118,505,52,557
公投第９案,新北市,三峽區,竹崙里,1984,768,207,89,296,77,373
公投第９案,新北市,三峽區,竹崙里,1985,1097,360,113,473,38,511
公投第９案,新北市,三峽區,安坑里,1986,1322,390,115,505,66,571
公投第９案,新北市,新店區,新店里,1987,1603,650,172,822,56,878
公投第９案,新北市,新店區,張南里,1988,1921,814,172,986,42,1028
公投第９案,新北市,新店區,國校里,1989,1082,432,125,557,23,580
公投第９案,新北市,新店區,國校里,1990,1235,516,159,675,44,719
公投第９案,新北市,新店區,文中里,1991,1568,717,154,871,37,908
公投第９案,新北市,新店區,廣明里,1992,771,324,103,427,30,457
公投第９案,新北市,新店區,文明里,1993,1256,488,164,652,44,696
公投第９案,新北市,新店區,文明里,1994,1008,436,125,561,39,600
公投第９案,新北市,新店區,中興里,1995,1515,707,131,838,52,890
公投第９案,新北市,新店區,中興里,1996,1637,795,183,978,40,1018
公投第９案,新北市,新店區,中興里,1997,1549,671,179,850,51,901
公投第９案,新北市,新店區,新生里,1998,2011,983,216,1199,51,1250
公投第９案,新北市,新店區,新生里,1999,1554,649,175,824,75,899
公投第９案,新北市,新店區,新生里,2000,1770,721,191,912,71,983
公投第９案,新北市,新店區,新德里,2001,1316,590,145,735,47,782
公投第９案,新北市,新店區,新德里,2002,1126,461,122,583,62,645
公投第９案,新北市,新店區,張北里,2003,1460,579,170,749,46,795
公投第９案,新北市,新店區,張北里,2004,1584,699,185,884,54,938
公投第９案,新北市,新店區,張北里,2005,1449,611,163,774,51,825
公投第９案,新北市,新店區,張北里,2006,1520,744,162,906,47,953
公投第９案,新北市,新店區,張北里,2007,1821,856,190,1046,24,1070
公投第９案,新北市,新店區,五峯里,2008,1956,836,210,1046,44,1090
公投第９案,新北市,新店區,五峯里,2009,1665,755,169,924,51,975
公投第９案,新北市,新店區,五峯里,2010,1588,768,159,927,39,966
公投第９案,新北市,新店區,五峯里,2011,1519,679,144,823,20,843
公投第９案,新北市,新店區,長春里,2012,1185,548,164,712,31,743
公投第９案,新北市,新店區,長春里,2013,1095,535,137,672,22,694
公投第９案,新北市,新店區,新安里,2014,1106,506,128,634,55,689
公投第９案,新北市,新店區,新安里,2015,2700,288,104,392,18,410
公投第９案,新北市,新店區,新安里,2016,995,461,106,567,23,590
公投第９案,新北市,新店區,新安里,2017,1168,516,117,633,38,671
公投第９案,新北市,新店區,忠誠里,2018,1123,582,125,707,53,760
公投第９案,新北市,新店區,忠誠里,2019,1085,518,144,662,40,702
公投第９案,新北市,新店區,中正里,2020,1412,663,170,833,50,883
公投第９案,新北市,新店區,中正里,2021,1659,730,182,912,48,960
公投第９案,新北市,新店區,中正里,2022,1198,608,111,719,44,763
公投第９案,新北市,新店區,中正里,2023,1376,566,143,709,35,744
公投第９案,新北市,新店區,中華里,2024,1300,559,119,678,32,710
公投第９案,新北市,新店區,中華里,2025,1238,546,142,688,35,723
公投第９案,新北市,新店區,中華里,2026,1388,568,144,712,24,736
公投第９案,新北市,新店區,仁愛里,2027,933,433,117,550,37,587
公投第９案,新北市,新店區,仁愛里,2028,908,438,117,555,26,581
公投第９案,新北市,新店區,建國里,2029,1582,667,180,847,64,911
公投第９案,新北市,新店區,建國里,2030,1247,589,142,731,45,776
公投第９案,新北市,新店區,百忍里,2031,971,442,108,550,51,601
公投第９案,新北市,新店區,百忍里,2032,1145,555,107,662,50,712
公投第９案,新北市,新店區,百忍里,2033,1392,645,143,788,49,837
公投第９案,新北市,新店區,百和里,2034,1452,724,139,863,53,916
公投第９案,新北市,新店區,百和里,2035,1440,631,148,779,56,835
公投第９案,新北市,新店區,福德里,2036,1786,745,196,941,77,1018
公投第９案,新北市,新店區,福德里,2037,1825,838,168,1006,54,1060
公投第９案,新北市,新店區,百福里,2038,1477,676,177,853,33,886
公投第９案,新北市,新店區,百福里,2039,1750,783,203,986,44,1030
公投第９案,新北市,新店區,福民里,2040,1792,780,172,952,72,1024
公投第９案,新北市,新店區,福民里,2041,1979,890,169,1059,59,1118
公投第９案,新北市,新店區,中山里,2042,826,393,77,470,29,499
公投第９案,新北市,新店區,中山里,2043,1924,919,180,1099,38,1137
公投第９案,新北市,新店區,中山里,2044,1383,695,131,826,22,848
公投第９案,新北市,新店區,和平里,2045,830,299,83,382,42,424
公投第９案,新北市,新店區,中央里,2046,1759,854,189,1043,33,1076
公投第９案,新北市,新店區,中央里,2047,1957,939,197,1136,50,1186
公投第９案,新北市,新店區,中央里,2048,1481,705,161,866,31,897
公投第９案,新北市,新店區,國豐里,2049,1552,672,178,850,73,923
公投第９案,新北市,新店區,國豐里,2050,1467,615,154,769,74,843
公投第９案,新北市,新店區,明德里,2051,1371,587,164,751,49,800
公投第９案,新北市,新店區,明德里,2052,991,452,112,564,35,599
公投第９案,新北市,新店區,明德里,2053,1231,562,128,690,49,739
公投第９案,新北市,新店區,大豐里,2054,1701,728,207,935,59,994
公投第９案,新北市,新店區,大豐里,2055,1707,759,173,932,53,985
公投第９案,新北市,新店區,大同里,2056,1773,779,175,954,34,988
公投第９案,新北市,新店區,大同里,2057,1866,756,184,940,46,986
公投第９案,新北市,新店區,江陵里,2058,1735,781,198,979,52,1031
公投第９案,新北市,新店區,江陵里,2059,1632,806,198,1004,41,1045
公投第９案,新北市,新店區,江陵里,2060,1591,736,149,885,55,940
公投第９案,新北市,新店區,復興里,2061,1495,603,151,754,62,816
公投第９案,新北市,新店區,復興里,2062,1511,613,122,735,23,758
公投第９案,新北市,新店區,寶興里,2063,1260,544,135,679,56,735
公投第９案,新北市,新店區,寶興里,2064,1948,916,198,1114,50,1164
公投第９案,新北市,新店區,寶興里,2065,1582,743,189,932,48,980
公投第９案,新北市,新店區,寶福里,2066,1315,544,175,719,46,765
公投第９案,新北市,新店區,寶福里,2067,1562,640,152,792,54,846
公投第９案,新北市,新店區,寶福里,2068,1982,975,165,1140,28,1168
公投第９案,新北市,新店區,寶福里,2069,1518,662,177,839,60,899
公投第９案,新北市,新店區,寶安里,2070,1735,762,174,936,35,971
公投第９案,新北市,新店區,寶安里,2071,1716,756,153,909,52,961
公投第９案,新北市,新店區,寶安里,2072,1580,712,152,864,51,915
公投第９案,新北市,新店區,信義里,2073,1358,640,160,800,45,845
公投第９案,新北市,新店區,信義里,2074,1610,735,188,923,79,1002
公投第９案,新北市,新店區,信義里,2075,1383,571,171,742,33,775
公投第９案,新北市,新店區,信義里,2076,1596,715,158,873,36,909
公投第９案,新北市,新店區,忠孝里,2077,1360,556,123,679,41,720
公投第９案,新北市,新店區,忠孝里,2078,1160,493,83,576,19,595
公投第９案,新北市,新店區,大鵬里,2079,1236,668,109,777,40,817
公投第９案,新北市,新店區,大鵬里,2080,1234,647,119,766,29,795
公投第９案,新北市,新店區,太平里,2081,1579,656,193,849,65,914
公投第９案,新北市,新店區,太平里,2082,1241,534,130,664,45,709
公投第９案,新北市,新店區,美城里,2083,1275,555,126,681,22,703
公投第９案,新北市,新店區,美城里,2084,1214,471,126,597,49,646
公投第９案,新北市,新店區,頂城里,2085,1578,540,187,727,61,788
公投第９案,新北市,新店區,下城里,2086,1442,580,170,750,46,796
公投第９案,新北市,新店區,下城里,2087,1475,513,169,682,88,770
公投第９案,新北市,新店區,柴埕里,2088,1580,685,190,875,51,926
公投第９案,新北市,新店區,柴埕里,2089,1585,620,179,799,39,838
公投第９案,新北市,新店區,柴埕里,2090,1586,647,186,833,60,893
公投第９案,新北市,新店區,柴埕里,2091,1931,802,209,1011,62,1073
公投第９案,新北市,新店區,柴埕里,2092,1239,524,123,647,36,683
公投第９案,新北市,新店區,安和里,2093,1892,823,164,987,58,1045
公投第９案,新北市,新店區,安和里,2094,1529,599,152,751,47,798
公投第９案,新北市,新店區,安和里,2095,1358,631,106,737,51,788
公投第９案,新北市,新店區,安和里,2096,1905,739,195,934,41,975
公投第９案,新北市,新店區,永安里,2097,1885,769,179,948,45,993
公投第９案,新北市,新店區,永安里,2098,1345,538,138,676,55,731
公投第９案,新北市,新店區,永安里,2099,1387,570,153,723,70,793
公投第９案,新北市,新店區,新和里,2100,1960,818,199,1017,64,1081
公投第９案,新北市,新店區,新和里,2101,1837,784,171,955,72,1027
公投第９案,新北市,新店區,永平里,2102,1662,716,175,891,54,945
公投第９案,新北市,新店區,永平里,2103,1617,749,187,936,59,995
公投第９案,新北市,新店區,永平里,2104,1704,730,197,927,31,958
公投第９案,新北市,新店區,公崙里,2105,1835,694,225,919,69,988
公投第９案,新北市,新店區,公崙里,2106,2009,811,197,1008,76,1084
公投第９案,新北市,新店區,公崙里,2107,1450,578,173,751,61,812
公投第９案,新北市,新店區,公崙里,2108,1726,734,176,910,49,959
公投第９案,新北市,新店區,公崙里,2109,1797,735,174,909,57,966
公投第９案,新北市,新店區,公崙里,2110,1739,730,184,914,38,952
公投第９案,新北市,新店區,安昌里,2111,1523,680,137,817,30,847
公投第９案,新北市,新店區,安昌里,2112,1642,707,136,843,30,873
公投第９案,新北市,新店區,安昌里,2113,1644,710,168,878,19,897
公投第９案,新北市,新店區,德安里,2114,1662,599,192,791,43,834
公投第９案,新北市,新店區,德安里,2115,2067,903,221,1124,55,1179
公投第９案,新北市,新店區,德安里,2116,1870,604,182,786,47,833
公投第９案,新北市,新店區,達觀里,2117,1982,800,208,1008,54,1062
公投第９案,新北市,新店區,達觀里,2118,1546,689,152,841,33,874
公投第９案,新北市,新店區,明城里,2119,1712,792,204,996,37,1033
公投第９案,新北市,新店區,明城里,2120,1423,719,142,861,23,884
公投第９案,新北市,新店區,小城里,2121,1666,747,195,942,56,998
公投第９案,新北市,新店區,小城里,2122,1769,846,200,1046,49,1095
公投第９案,新北市,新店區,雙城里,2123,1079,356,142,498,44,542
公投第９案,新北市,新店區,雙城里,2124,1140,422,141,563,23,586
公投第９案,新北市,新店區,雙城里,2125,1825,789,151,940,59,999
公投第９案,新北市,新店區,雙城里,2126,1178,523,155,678,33,711
公投第９案,新北市,新店區,香坡里,2127,1463,613,142,755,42,797
公投第９案,新北市,新店區,香坡里,2128,1152,507,123,630,28,658
公投第９案,新北市,新店區,香坡里,2129,2008,738,163,901,36,937
公投第９案,新北市,新店區,香坡里,2130,2120,779,154,933,50,983
公投第９案,新北市,新店區,香坡里,2131,1153,534,119,653,22,675
公投第９案,新北市,新店區,香坡里,2132,1573,625,162,787,43,830
公投第９案,新北市,新店區,日興里,2133,1992,678,207,885,78,963
公投第９案,新北市,新店區,日興里,2134,1668,596,161,757,60,817
公投第９案,新北市,新店區,日興里,2135,1617,600,148,748,54,802
公投第９案,新北市,新店區,玫瑰里,2136,2013,751,200,951,125,1076
公投第９案,新北市,新店區,玫瑰里,2137,1791,800,172,972,59,1031
公投第９案,新北市,新店區,玫瑰里,2138,1624,697,174,871,49,920
公投第９案,新北市,新店區,吉祥里,2139,1178,571,110,681,32,713
公投第９案,新北市,新店區,吉祥里,2140,1277,600,119,719,29,748
公投第９案,新北市,新店區,吉祥里,2141,1879,828,180,1008,55,1063
公投第９案,新北市,新店區,塗潭里,2142,939,302,104,406,33,439
公投第９案,新北市,新店區,華城里,2143,960,396,121,517,30,547
公投第９案,新北市,新店區,華城里,2144,1434,673,178,851,20,871
公投第９案,新北市,新店區,青潭里,2145,1838,718,184,902,53,955
公投第９案,新北市,新店區,青潭里,2146,1453,608,158,766,50,816
公投第９案,新北市,新店區,青潭里,2147,1549,602,181,783,48,831
公投第９案,新北市,新店區,美潭里,2148,1860,805,227,1032,44,1076
公投第９案,新北市,新店區,美潭里,2149,1743,687,157,844,31,875
公投第９案,新北市,新店區,美潭里,2150,1122,566,127,693,41,734
公投第９案,新北市,新店區,員潭里,2151,1468,628,140,768,44,812
公投第９案,新北市,新店區,員潭里,2152,1763,746,187,933,35,968
公投第９案,新北市,新店區,員潭里,2153,1344,545,131,676,40,716
公投第９案,新北市,新店區,雙坑里,2154,753,273,86,359,46,405
公投第９案,新北市,新店區,粗坑里,2155,602,201,83,284,14,298
公投第９案,新北市,新店區,粗坑里,2156,2237,834,269,1103,61,1164
公投第９案,新北市,新店區,屈尺里,2157,1096,430,125,555,31,586
公投第９案,新北市,新店區,屈尺里,2158,1143,362,125,487,47,534
公投第９案,新北市,新店區,龜山里,2159,1569,560,181,741,83,824
公投第９案,新北市,新店區,廣興里,2160,1284,463,155,618,68,686
公投第９案,新北市,新店區,直潭里,2161,439,89,35,124,13,137
公投第９案,新北市,新店區,直潭里,2162,750,280,117,397,39,436
公投第９案,新北市,深坑區,萬順里,2163,1142,417,135,552,33,585
公投第９案,新北市,深坑區,萬順里,2164,1139,489,133,622,48,670
公投第９案,新北市,深坑區,萬福里,2165,1065,380,142,522,51,573
公投第９案,新北市,深坑區,萬福里,2166,1400,531,136,667,49,716
公投第９案,新北市,深坑區,土庫里,2167,1330,483,140,623,53,676
公投第９案,新北市,深坑區,土庫里,2168,1380,496,138,634,38,672
公投第９案,新北市,深坑區,深坑里,2169,1496,505,133,638,20,658
公投第９案,新北市,深坑區,深坑里,2170,1508,617,173,790,71,861
公投第９案,新北市,深坑區,埔新里,2171,1624,653,198,851,76,927
公投第９案,新北市,深坑區,埔新里,2172,2165,853,256,1109,56,1165
公投第９案,新北市,深坑區,埔新里,2173,1790,757,235,992,60,1052
公投第９案,新北市,深坑區,昇高里,2174,782,274,88,362,23,385
公投第９案,新北市,深坑區,昇高里,2175,1164,531,117,648,20,668
公投第９案,新北市,深坑區,賴仲里,2176,1344,582,163,745,55,800
公投第９案,新北市,深坑區,賴仲里,2177,739,325,103,428,27,455
公投第９案,新北市,深坑區,阿柔里,2178,556,245,64,309,29,338
公投第９案,新北市,石碇區,石碇里,2179,391,161,59,220,23,243
公投第９案,新北市,石碇區,潭邊里,2180,789,271,83,354,43,397
公投第９案,新北市,石碇區,烏塗里,2181,662,185,68,253,23,276
公投第９案,新北市,石碇區,彭山里,2182,310,103,39,142,13,155
公投第９案,新北市,石碇區,豐田里,2183,280,103,28,131,17,148
公投第９案,新北市,石碇區,豐田里,2184,93,18,15,33,5,38
公投第９案,新北市,石碇區,隆盛里,2185,683,204,90,294,15,309
公投第９案,新北市,石碇區,豐林里,2186,323,148,46,194,10,204
公投第９案,新北市,石碇區,中民里,2187,726,192,53,245,13,258
公投第９案,新北市,石碇區,永定里,2188,591,210,71,281,34,315
公投第９案,新北市,石碇區,光明里,2189,282,115,44,159,30,189
公投第９案,新北市,石碇區,永安里,2190,788,230,64,294,20,314
公投第９案,新北市,石碇區,格頭里,2191,943,355,141,496,59,555
公投第９案,新北市,坪林區,坪林里,2192,1248,442,137,579,57,636
公投第９案,新北市,坪林區,水德里,2193,612,197,54,251,41,292
公投第９案,新北市,坪林區,大林里,2194,1141,419,128,547,103,650
公投第９案,新北市,坪林區,石𥕢里,2195,417,110,39,149,11,160
公投第９案,新北市,坪林區,粗窟里,2196,595,213,68,281,50,331
公投第９案,新北市,坪林區,粗窟里,2197,248,100,32,132,20,152
公投第９案,新北市,坪林區,上德里,2198,338,115,33,148,14,162
公投第９案,新北市,坪林區,上德里,2199,478,144,44,188,18,206
公投第９案,新北市,坪林區,漁光里,2200,390,93,41,134,12,146
公投第９案,新北市,坪林區,漁光里,2201,424,120,45,165,28,193
公投第９案,新北市,烏來區,忠治里,2202,1568,671,188,859,60,919
公投第９案,新北市,烏來區,烏來里,2203,1198,441,120,561,20,581
公投第９案,新北市,烏來區,烏來里,2204,1169,414,101,515,32,547
公投第９案,新北市,烏來區,孝義里,2205,228,91,17,108,4,112
公投第９案,新北市,烏來區,信賢里,2206,486,187,48,235,28,263
公投第９案,新北市,烏來區,福山里,2207,615,194,57,251,23,274
公投第９案,新北市,平溪區,薯榔里,2208,384,125,36,161,26,187
公投第９案,新北市,平溪區,菁桐里,2209,232,73,17,90,5,95
公投第９案,新北市,平溪區,白石里,2210,249,95,32,127,13,140
公投第９案,新北市,平溪區,石底里,2211,458,155,60,215,37,252
公投第９案,新北市,平溪區,平溪里,2212,232,82,29,111,18,129
公投第９案,新北市,平溪區,嶺腳里,2213,635,180,55,235,20,255
公投第９案,新北市,平溪區,東勢里,2214,427,147,51,198,38,236
公投第９案,新北市,平溪區,十分里,2215,862,242,68,310,33,343
公投第９案,新北市,平溪區,望古里,2216,147,52,18,70,3,73
公投第９案,新北市,平溪區,南山里,2217,365,98,25,123,12,135
公投第９案,新北市,平溪區,新寮里,2218,153,39,26,65,8,73
公投第９案,新北市,平溪區,平湖里,2219,177,68,23,91,18,109
公投第９案,新北市,瑞芳區,龍潭里,2220,725,311,74,385,35,420
公投第９案,新北市,瑞芳區,龍興里,2221,1074,440,112,552,52,604
公投第９案,新北市,瑞芳區,龍興里,2222,825,314,81,395,22,417
公投第９案,新北市,瑞芳區,龍鎮里,2223,1242,502,141,643,32,675
公投第９案,新北市,瑞芳區,龍安里,2224,598,225,74,299,25,324
公投第９案,新北市,瑞芳區,龍川里,2225,872,330,98,428,39,467
公投第９案,新北市,瑞芳區,龍川里,2226,760,238,86,324,42,366
公投第９案,新北市,瑞芳區,龍山里,2227,1330,459,130,589,37,626
公投第９案,新北市,瑞芳區,爪峯里,2228,1683,561,157,718,67,785
公投第９案,新北市,瑞芳區,爪峯里,2229,980,386,90,476,50,526
公投第９案,新北市,瑞芳區,爪峯里,2230,946,352,107,459,41,500
公投第９案,新北市,瑞芳區,新峰里,2231,1375,483,120,603,20,623
公投第９案,新北市,瑞芳區,新峰里,2232,1671,595,173,768,54,822
公投第９案,新北市,瑞芳區,東和里,2233,978,308,88,396,24,420
公投第９案,新北市,瑞芳區,東和里,2234,645,206,79,285,29,314
公投第９案,新北市,瑞芳區,柑坪里,2235,1089,358,136,494,63,557
公投第９案,新北市,瑞芳區,弓橋里,2236,286,87,23,110,11,121
公投第９案,新北市,瑞芳區,猴硐里,2237,461,134,63,197,33,230
公投第９案,新北市,瑞芳區,光復里,2238,274,86,33,119,18,137
公投第９案,新北市,瑞芳區,碩仁里,2239,155,59,21,80,13,93
公投第９案,新北市,瑞芳區,吉慶里,2240,817,319,88,407,41,448
公投第９案,新北市,瑞芳區,吉慶里,2241,884,293,99,392,68,460
公投第９案,新北市,瑞芳區,吉安里,2242,1333,442,130,572,42,614
公投第９案,新北市,瑞芳區,吉安里,2243,607,191,35,226,7,233
公投第９案,新北市,瑞芳區,吉安里,2244,1045,385,110,495,44,539
公投第９案,新北市,瑞芳區,上天里,2245,673,258,59,317,46,363
公投第９案,新北市,瑞芳區,上天里,2246,618,167,53,220,11,231
公投第９案,新北市,瑞芳區,傑魚里,2247,1063,371,90,461,31,492
公投第９案,新北市,瑞芳區,傑魚里,2248,860,321,102,423,42,465
公投第９案,新北市,瑞芳區,基山里,2249,432,93,32,125,2,127
公投第９案,新北市,瑞芳區,永慶里,2250,445,121,41,162,8,170
公投第９案,新北市,瑞芳區,崇文里,2251,318,104,16,120,12,132
公投第９案,新北市,瑞芳區,福住里,2252,159,48,17,65,12,77
公投第９案,新北市,瑞芳區,頌德里,2253,337,93,38,131,14,145
公投第９案,新北市,瑞芳區,瓜山里,2254,180,70,20,90,8,98
公投第９案,新北市,瑞芳區,銅山里,2255,187,50,18,68,14,82
公投第９案,新北市,瑞芳區,新山里,2256,369,132,39,171,20,191
公投第９案,新北市,瑞芳區,石山里,2257,335,114,51,165,22,187
公投第９案,新北市,瑞芳區,濓洞里,2258,470,141,41,182,18,200
公投第９案,新北市,瑞芳區,濓新里,2259,297,85,24,109,6,115
公投第９案,新北市,瑞芳區,南雅里,2260,267,132,24,156,8,164
公投第９案,新北市,瑞芳區,鼻頭里,2261,876,167,52,219,6,225
公投第９案,新北市,瑞芳區,海濱里,2262,1241,332,94,426,26,452
公投第９案,新北市,瑞芳區,瑞濱里,2263,998,321,130,451,81,532
公投第９案,新北市,瑞芳區,瑞濱里,2264,948,325,112,437,61,498
公投第９案,新北市,瑞芳區,深澳里,2265,1308,380,98,478,32,510
公投第９案,新北市,雙溪區,雙溪里,2266,455,146,40,186,28,214
公投第９案,新北市,雙溪區,新基里,2267,286,107,28,135,13,148
公投第９案,新北市,雙溪區,新基里,2268,496,205,49,254,21,275
公投第９案,新北市,雙溪區,三港里,2269,383,124,24,148,12,160
公投第９案,新北市,雙溪區,牡丹里,2270,887,256,81,337,40,377
公投第９案,新北市,雙溪區,牡丹里,2271,652,174,71,245,33,278
公投第９案,新北市,雙溪區,三貂里,2272,333,114,38,152,15,167
公投第９案,新北市,雙溪區,平林里,2273,642,224,61,285,35,320
公投第９案,新北市,雙溪區,平林里,2274,282,93,28,121,14,135
公投第９案,新北市,雙溪區,上林里,2275,621,187,55,242,26,268
公投第９案,新北市,雙溪區,外柑里,2276,422,115,36,151,17,168
公投第９案,新北市,雙溪區,長源里,2277,369,81,26,107,27,134
公投第９案,新北市,雙溪區,共和里,2278,120,45,13,58,7,65
公投第９案,新北市,雙溪區,共和里,2279,271,98,20,118,16,134
公投第９案,新北市,雙溪區,魚行里,2280,362,142,38,180,32,212
公投第９案,新北市,雙溪區,魚行里,2281,371,128,35,163,30,193
公投第９案,新北市,雙溪區,泰平里,2282,1047,445,120,565,49,614
公投第９案,新北市,貢寮區,貢寮里,2283,876,290,96,386,49,435
公投第９案,新北市,貢寮區,龍崗里,2284,433,140,53,193,25,218
公投第９案,新北市,貢寮區,吉林里,2285,516,146,38,184,17,201
公投第９案,新北市,貢寮區,雙玉里,2286,373,90,35,125,26,151
公投第９案,新北市,貢寮區,雙玉里,2287,313,85,32,117,32,149
公投第９案,新北市,貢寮區,福連里,2288,485,163,56,219,16,235
公投第９案,新北市,貢寮區,福連里,2289,415,114,60,174,36,210
公投第９案,新北市,貢寮區,福隆里,2290,812,230,67,297,25,322
公投第９案,新北市,貢寮區,福隆里,2291,861,257,106,363,49,412
公投第９案,新北市,貢寮區,龍門里,2292,676,159,72,231,32,263
公投第９案,新北市,貢寮區,真理里,2293,1091,279,85,364,23,387
公投第９案,新北市,貢寮區,真理里,2294,955,260,77,337,49,386
公投第９案,新北市,貢寮區,仁里里,2295,769,209,61,270,10,280
公投第９案,新北市,貢寮區,仁里里,2296,962,310,113,423,40,463
公投第９案,新北市,貢寮區,美豐里,2297,390,148,34,182,9,191
公投第９案,新北市,貢寮區,美豐里,2298,349,112,31,143,2,145
公投第９案,新北市,貢寮區,和美里,2299,508,111,49,160,37,197
公投第９案,新北市,貢寮區,和美里,2300,495,109,38,147,14,161
公投第９案,新北市,金山區,和平里,2301,481,129,103,232,30,262
公投第９案,新北市,金山區,大同里,2302,715,241,105,346,33,379
公投第９案,新北市,金山區,豐漁里,2303,481,143,44,187,27,214
公投第９案,新北市,金山區,磺港里,2304,1792,581,161,742,84,826
公投第９案,新北市,金山區,美田里,2305,1781,634,205,839,73,912
公投第９案,新北市,金山區,美田里,2306,2010,779,208,987,87,1074
公投第９案,新北市,金山區,金美里,2307,1572,530,170,700,63,763
公投第９案,新北市,金山區,金美里,2308,1777,653,174,827,81,908
公投第９案,新北市,金山區,金美里,2309,1631,554,155,709,64,773
公投第９案,新北市,金山區,五湖里,2310,828,312,84,396,38,434
公投第９案,新北市,金山區,五湖里,2311,888,317,104,421,29,450
公投第９案,新北市,金山區,重和里,2312,1211,399,134,533,79,612
公投第９案,新北市,金山區,兩湖里,2313,416,171,53,224,15,239
公投第９案,新北市,金山區,六股里,2314,682,267,86,353,46,399
公投第９案,新北市,金山區,三界里,2315,644,234,57,291,57,348
公投第９案,新北市,金山區,清泉里,2316,830,283,78,361,48,409
公投第９案,新北市,金山區,西湖里,2317,188,62,26,88,11,99
公投第９案,新北市,金山區,萬壽里,2318,469,161,70,231,28,259
公投第９案,新北市,金山區,永興里,2319,582,142,35,177,36,213
公投第９案,新北市,萬里區,萬里里,2320,1286,506,143,649,47,696
公投第９案,新北市,萬里區,萬里里,2321,1576,634,165,799,60,859
公投第９案,新北市,萬里區,萬里里,2322,1447,487,152,639,46,685
公投第９案,新北市,萬里區,北基里,2323,1466,475,128,603,66,669
公投第９案,新北市,萬里區,北基里,2324,1369,407,123,530,55,585
公投第９案,新北市,萬里區,龜吼里,2325,1215,333,96,429,46,475
公投第９案,新北市,萬里區,龜吼里,2326,1317,497,131,628,61,689
公投第９案,新北市,萬里區,野柳里,2327,1676,513,139,652,71,723
公投第９案,新北市,萬里區,野柳里,2328,1550,506,155,661,79,740
公投第９案,新北市,萬里區,大鵬里,2329,945,421,104,525,59,584
公投第９案,新北市,萬里區,大鵬里,2330,1760,675,197,872,86,958
公投第９案,新北市,萬里區,磺潭里,2331,570,201,60,261,26,287
公投第９案,新北市,萬里區,雙興里,2332,952,282,129,411,35,446
公投第９案,新北市,萬里區,溪底里,2333,674,261,74,335,60,395
公投第９案,新北市,萬里區,崁脚里,2334,405,138,51,189,19,208
公投第９案,新北市,萬里區,中幅里,2335,1089,370,113,483,65,548
公投第９案,新北市,汐止區,仁德里,2336,1595,592,182,774,85,859
公投第９案,新北市,汐止區,義民里,2337,1262,531,131,662,44,706
公投第９案,新北市,汐止區,禮門里,2338,917,350,127,477,64,541
公投第９案,新北市,汐止區,智慧里,2339,1929,800,206,1006,61,1067
公投第９案,新北市,汐止區,智慧里,2340,2227,859,258,1117,67,1184
公投第９案,新北市,汐止區,大同里,2341,1143,444,94,538,59,597
公投第９案,新北市,汐止區,大同里,2342,1367,569,151,720,37,757
公投第９案,新北市,汐止區,信望里,2343,322,113,40,153,20,173
公投第９案,新北市,汐止區,新昌里,2344,1460,584,193,777,7,784
公投第９案,新北市,汐止區,新昌里,2345,1719,618,196,814,63,877
公投第９案,新北市,汐止區,新昌里,2346,1661,622,151,773,55,828
公投第９案,新北市,汐止區,福安里,2347,1590,671,175,846,53,899
公投第９案,新北市,汐止區,福安里,2348,1599,647,163,810,61,871
公投第９案,新北市,汐止區,福安里,2349,1749,765,152,917,52,969
公投第９案,新北市,汐止區,秀峰里,2350,1809,240,88,328,28,356
公投第９案,新北市,汐止區,秀峰里,2351,1601,520,174,694,36,730
公投第９案,新北市,汐止區,秀峰里,2352,1387,528,143,671,66,737
公投第９案,新北市,汐止區,秀山里,2353,1779,691,222,913,85,998
公投第９案,新北市,汐止區,秀山里,2354,2074,834,259,1093,71,1164
公投第９案,新北市,汐止區,復興里,2355,2072,830,237,1067,44,1111
公投第９案,新北市,汐止區,復興里,2356,2120,942,233,1175,56,1231
公投第９案,新北市,汐止區,復興里,2357,1952,800,193,993,40,1033
公投第９案,新北市,汐止區,自強里,2358,1654,636,171,807,71,878
公投第９案,新北市,汐止區,自強里,2359,1444,536,160,696,62,758
公投第９案,新北市,汐止區,自強里,2360,1627,720,195,915,47,962
公投第９案,新北市,汐止區,文化里,2361,1751,643,196,839,68,907
公投第９案,新北市,汐止區,文化里,2362,2066,832,208,1040,44,1084
公投第９案,新北市,汐止區,白雲里,2363,1941,633,180,813,55,868
公投第９案,新北市,汐止區,白雲里,2364,1906,667,191,858,51,909
公投第９案,新北市,汐止區,茄苳里,2365,1363,509,132,641,77,718
公投第９案,新北市,汐止區,茄苳里,2366,1368,470,175,645,52,697
公投第９案,新北市,汐止區,茄苳里,2367,1233,407,144,551,54,605
公投第９案,新北市,汐止區,崇德里,2368,1554,578,151,729,37,766
公投第９案,新北市,汐止區,崇德里,2369,1700,628,180,808,36,844
公投第９案,新北市,汐止區,崇德里,2370,1124,481,123,604,24,628
公投第９案,新北市,汐止區,城中里,2371,1900,785,230,1015,67,1082
公投第９案,新北市,汐止區,城中里,2372,2050,829,201,1030,62,1092
公投第９案,新北市,汐止區,橋東里,2373,1244,475,135,610,56,666
公投第９案,新北市,汐止區,橋東里,2374,1320,488,134,622,41,663
公投第９案,新北市,汐止區,建成里,2375,1473,608,180,788,45,833
公投第９案,新北市,汐止區,建成里,2376,1802,764,170,934,56,990
公投第９案,新北市,汐止區,建成里,2377,1266,570,132,702,38,740
公投第９案,新北市,汐止區,長安里,2378,1481,535,151,686,51,737
公投第９案,新北市,汐止區,保安里,2379,1497,541,162,703,66,769
公投第９案,新北市,汐止區,東山里,2380,556,223,64,287,17,304
公投第９案,新北市,汐止區,保長里,2381,1913,721,172,893,55,948
公投第９案,新北市,汐止區,保長里,2382,2027,777,196,973,41,1014
公投第９案,新北市,汐止區,保新里,2383,1927,714,185,899,45,944
公投第９案,新北市,汐止區,保新里,2384,696,261,83,344,44,388
公投第９案,新北市,汐止區,鄉長里,2385,2127,765,216,981,70,1051
公投第９案,新北市,汐止區,江北里,2386,1642,545,174,719,56,775
公投第９案,新北市,汐止區,江北里,2387,1912,724,200,924,73,997
公投第９案,新北市,汐止區,江北里,2388,1893,609,202,811,62,873
公投第９案,新北市,汐止區,拱北里,2389,1466,482,163,645,69,714
公投第９案,新北市,汐止區,拱北里,2390,1538,568,137,705,87,792
公投第９案,新北市,汐止區,拱北里,2391,1550,572,164,736,45,781
公投第９案,新北市,汐止區,烘內里,2392,1456,492,172,664,68,732
公投第９案,新北市,汐止區,八連里,2393,947,395,119,514,58,572
公投第９案,新北市,汐止區,長青里,2394,923,357,128,485,20,505
公投第９案,新北市,汐止區,北峰里,2395,2043,661,247,908,118,1026
公投第９案,新北市,汐止區,北峰里,2396,2012,630,247,877,83,960
公投第９案,新北市,汐止區,金龍里,2397,1471,515,117,632,38,670
公投第９案,新北市,汐止區,金龍里,2398,1603,594,173,767,47,814
公投第９案,新北市,汐止區,金龍里,2399,1530,618,152,770,54,824
公投第９案,新北市,汐止區,樟樹里,2400,1988,627,203,830,28,858
公投第９案,新北市,汐止區,忠孝里,2401,2198,831,210,1041,50,1091
公投第９案,新北市,汐止區,忠孝里,2402,1712,619,193,812,58,870
公投第９案,新北市,汐止區,忠孝里,2403,1806,742,199,941,68,1009
公投第９案,新北市,汐止區,忠孝里,2404,1576,594,156,750,88,838
公投第９案,新北市,汐止區,厚德里,2405,1511,606,142,748,28,776
公投第９案,新北市,汐止區,厚德里,2406,1691,608,161,769,35,804
公投第９案,新北市,汐止區,厚德里,2407,1636,654,168,822,44,866
公投第９案,新北市,汐止區,厚德里,2408,1676,632,166,798,58,856
公投第９案,新北市,汐止區,山光里,2409,1264,469,146,615,39,654
公投第９案,新北市,汐止區,山光里,2410,1165,443,123,566,35,601
公投第９案,新北市,汐止區,中興里,2411,1765,651,187,838,49,887
公投第９案,新北市,汐止區,中興里,2412,1815,587,172,759,36,795
公投第９案,新北市,汐止區,中興里,2413,1778,605,207,812,63,875
公投第９案,新北市,汐止區,中興里,2414,1580,620,171,791,82,873
公投第９案,新北市,汐止區,福德里,2415,1516,588,159,747,59,806
公投第９案,新北市,汐止區,福德里,2416,1425,520,143,663,42,705
公投第９案,新北市,汐止區,興福里,2417,1388,578,146,724,34,758
公投第９案,新北市,汐止區,興福里,2418,1436,563,161,724,54,778
公投第９案,新北市,汐止區,康福里,2419,1591,627,161,788,51,839
公投第９案,新北市,汐止區,康福里,2420,1639,596,183,779,32,811
公投第９案,新北市,汐止區,康福里,2421,1394,532,125,657,24,681
公投第９案,新北市,汐止區,湖光里,2422,2035,708,224,932,52,984
公投第９案,新北市,汐止區,湖光里,2423,1895,709,214,923,57,980
公投第９案,新北市,汐止區,湖光里,2424,1374,617,139,756,20,776
公投第９案,新北市,汐止區,湖蓮里,2425,1061,482,120,602,20,622
公投第９案,新北市,汐止區,湖蓮里,2426,1312,645,149,794,28,822
公投第９案,新北市,汐止區,湖興里,2427,1548,661,148,809,42,851
公投第９案,新北市,汐止區,湖興里,2428,1350,595,149,744,29,773
公投第９案,新北市,汐止區,湖興里,2429,1499,616,164,780,34,814
公投第９案,新北市,汐止區,湖興里,2430,1366,585,137,722,65,787
公投第９案,新北市,汐止區,北山里,2431,1335,551,155,706,59,765
公投第９案,新北市,汐止區,北山里,2432,1324,601,149,750,56,806
公投第９案,新北市,汐止區,北山里,2433,1286,564,142,706,75,781
公投第９案,新北市,汐止區,北山里,2434,1155,452,141,593,43,636
公投第９案,新北市,汐止區,忠山里,2435,1682,776,214,990,41,1031
公投第９案,新北市,汐止區,忠山里,2436,1494,694,170,864,59,923
公投第９案,新北市,汐止區,環河里,2437,1166,463,163,626,73,699
公投第９案,新北市,汐止區,橫科里,2438,2184,832,262,1094,110,1204
公投第９案,新北市,汐止區,橫科里,2439,2031,810,230,1040,77,1117
公投第９案,新北市,汐止區,福山里,2440,1759,700,201,901,77,978
公投第９案,新北市,汐止區,福山里,2441,1577,643,187,830,64,894
公投第９案,新北市,汐止區,宜興里,2442,1364,542,142,684,24,708
公投第９案,新北市,汐止區,宜興里,2443,1401,594,145,739,45,784
公投第９案,新北市,汐止區,東勢里,2444,1173,481,170,651,42,693
公投第９案,新北市,汐止區,東勢里,2445,993,453,101,554,25,579
公投第９案,新北市,汐止區,東勢里,2446,1587,652,157,809,26,835
公投第９案,臺中市,大甲區,朝陽里,1,1356,592,134,726,79,805
公投第９案,臺中市,大甲區,大甲里,2,1059,496,123,619,41,660
公投第９案,臺中市,大甲區,順天里,3,694,295,105,400,41,441
公投第９案,臺中市,大甲區,順天里,4,874,365,121,486,30,516
公投第９案,臺中市,大甲區,孔門里,5,763,315,93,408,21,429
公投第９案,臺中市,大甲區,平安里,6,856,402,102,504,43,547
公投第９案,臺中市,大甲區,平安里,7,1249,557,130,687,42,729
公投第９案,臺中市,大甲區,庄美里,8,922,363,103,466,32,498
公投第９案,臺中市,大甲區,庄美里,9,1189,502,146,648,47,695
公投第９案,臺中市,大甲區,新美里,10,1065,503,113,616,67,683
公投第９案,臺中市,大甲區,新美里,11,1252,578,143,721,80,801
公投第９案,臺中市,大甲區,新美里,12,1057,432,124,556,47,603
公投第９案,臺中市,大甲區,岷山里,13,1031,447,113,560,28,588
公投第９案,臺中市,大甲區,岷山里,14,1060,473,146,619,48,667
公投第９案,臺中市,大甲區,中山里,15,1311,566,145,711,55,766
公投第９案,臺中市,大甲區,中山里,16,1424,624,143,767,53,820
公投第９案,臺中市,大甲區,中山里,17,1670,742,79,821,57,878
公投第９案,臺中市,大甲區,南陽里,18,812,346,84,430,46,476
公投第９案,臺中市,大甲區,薰風里,19,863,386,91,477,30,507
公投第９案,臺中市,大甲區,義和里,20,1598,714,190,904,44,948
公投第９案,臺中市,大甲區,義和里,21,1588,707,145,852,48,900
公投第９案,臺中市,大甲區,武陵里,22,1197,512,127,639,55,694
公投第９案,臺中市,大甲區,文曲里,23,1106,385,137,522,90,612
公投第９案,臺中市,大甲區,武曲里,24,903,413,104,517,50,567
公投第９案,臺中市,大甲區,武曲里,25,869,394,105,499,42,541
公投第９案,臺中市,大甲區,文武里,26,1350,544,194,738,36,774
公投第９案,臺中市,大甲區,文武里,27,1144,463,133,596,92,688
公投第９案,臺中市,大甲區,文武里,28,1208,533,150,683,49,732
公投第９案,臺中市,大甲區,文武里,29,1567,663,196,859,37,896
公投第９案,臺中市,大甲區,奉化里,30,1246,611,139,750,36,786
公投第９案,臺中市,大甲區,奉化里,31,767,388,91,479,37,516
公投第９案,臺中市,大甲區,德化里,32,790,332,101,433,47,480
公投第９案,臺中市,大甲區,德化里,33,972,464,79,543,37,580
公投第９案,臺中市,大甲區,江南里,34,1388,561,147,708,56,764
公投第９案,臺中市,大甲區,頂店里,35,1331,523,137,660,41,701
公投第９案,臺中市,大甲區,頂店里,36,1167,547,133,680,43,723
公投第９案,臺中市,大甲區,頂店里,37,1934,836,208,1044,50,1094
公投第９案,臺中市,大甲區,太白里,38,1263,477,128,605,49,654
公投第９案,臺中市,大甲區,孟春里,39,1390,583,160,743,50,793
公投第９案,臺中市,大甲區,孟春里,40,1186,406,114,520,40,560
公投第９案,臺中市,大甲區,孟春里,41,1397,570,162,732,39,771
公投第９案,臺中市,大甲區,幸福里,42,1173,389,87,476,20,496
公投第９案,臺中市,大甲區,幸福里,43,1398,528,158,686,86,772
公投第９案,臺中市,大甲區,日南里,44,1228,456,134,590,49,639
公投第９案,臺中市,大甲區,日南里,45,1258,487,141,628,53,681
公投第９案,臺中市,大甲區,日南里,46,1435,609,47,656,29,685
公投第９案,臺中市,大甲區,日南里,47,1532,596,190,786,50,836
公投第９案,臺中市,大甲區,龍泉里,48,652,280,55,335,41,376
公投第９案,臺中市,大甲區,龍泉里,49,870,301,89,390,34,424
公投第９案,臺中市,大甲區,西岐里,50,891,328,99,427,31,458
公投第９案,臺中市,大甲區,西岐里,51,784,307,115,422,31,453
公投第９案,臺中市,大甲區,銅安里,52,1368,532,124,656,88,744
公投第９案,臺中市,大甲區,福德里,53,1126,437,113,550,53,603
公投第９案,臺中市,大甲區,建興里,54,1486,498,153,651,81,732
公投第９案,臺中市,大安區,南埔里,55,1068,405,98,503,67,570
公投第９案,臺中市,大安區,南庄里,56,1050,419,122,541,72,613
公投第９案,臺中市,大安區,中庄里,57,1246,515,150,665,85,750
公投第９案,臺中市,大安區,中庄里,58,1397,557,169,726,56,782
公投第９案,臺中市,大安區,東安里,59,1227,558,134,692,67,759
公投第９案,臺中市,大安區,福興里,60,1170,481,133,614,73,687
公投第９案,臺中市,大安區,龜壳里,61,914,419,122,541,55,596
公投第９案,臺中市,大安區,龜壳里,62,667,244,61,305,40,345
公投第９案,臺中市,大安區,頂安里,63,890,341,93,434,49,483
公投第９案,臺中市,大安區,永安里,64,1289,515,146,661,67,728
公投第９案,臺中市,大安區,永安里,65,455,165,49,214,27,241
公投第９案,臺中市,大安區,福住里,66,1028,418,121,539,43,582
公投第９案,臺中市,大安區,海墘里,67,1446,623,159,782,79,861
公投第９案,臺中市,大安區,西安里,68,688,340,69,409,37,446
公投第９案,臺中市,大安區,西安里,69,1062,465,125,590,56,646
公投第９案,臺中市,大安區,松雅里,70,923,412,153,565,34,599
公投第９案,臺中市,外埔區,永豐里,71,1059,434,125,559,43,602
公投第９案,臺中市,外埔區,六分里,72,1013,463,111,574,19,593
公投第９案,臺中市,外埔區,六分里,73,1150,538,126,664,48,712
公投第９案,臺中市,外埔區,大同里,74,1855,920,189,1109,68,1177
公投第９案,臺中市,外埔區,大同里,75,1327,628,139,767,28,795
公投第９案,臺中市,外埔區,大同里,76,1453,690,145,835,45,880
公投第９案,臺中市,外埔區,大東里,77,1653,805,54,859,72,931
公投第９案,臺中市,外埔區,大東里,78,1615,682,152,834,40,874
公投第９案,臺中市,外埔區,大東里,79,1470,622,118,740,36,776
公投第９案,臺中市,外埔區,大東里,80,1559,670,193,863,53,916
公投第９案,臺中市,外埔區,三崁里,81,1902,778,204,982,88,1070
公投第９案,臺中市,外埔區,水美里,82,1138,550,132,682,49,731
公投第９案,臺中市,外埔區,水美里,83,1065,471,136,607,73,680
公投第９案,臺中市,外埔區,水美里,84,1243,569,161,730,46,776
公投第９案,臺中市,外埔區,鐵山里,85,962,380,108,488,41,529
公投第９案,臺中市,外埔區,鐵山里,86,1169,492,114,606,46,652
公投第９案,臺中市,外埔區,中山里,87,1216,590,131,721,59,780
公投第９案,臺中市,外埔區,馬鳴里,88,1391,622,129,751,44,795
公投第９案,臺中市,外埔區,土城里,89,1616,622,201,823,84,907
公投第９案,臺中市,外埔區,廍子里,90,1203,414,106,520,35,555
公投第９案,臺中市,清水區,鰲峰里,91,1076,430,121,551,30,581
公投第９案,臺中市,清水區,靈泉里,92,953,448,127,575,50,625
公投第９案,臺中市,清水區,清水里,93,914,384,129,513,54,567
公投第９案,臺中市,清水區,清水里,94,1143,551,125,676,54,730
公投第９案,臺中市,清水區,文昌里,95,680,303,96,399,26,425
公投第９案,臺中市,清水區,南寧里,96,904,419,105,524,38,562
公投第９案,臺中市,清水區,南寧里,97,893,413,115,528,47,575
公投第９案,臺中市,清水區,西寧里,98,1577,682,195,877,42,919
公投第９案,臺中市,清水區,北寧里,99,690,310,71,381,25,406
公投第９案,臺中市,清水區,中興里,100,403,169,51,220,26,246
公投第９案,臺中市,清水區,西社里,101,1413,609,162,771,70,841
公投第９案,臺中市,清水區,西社里,102,777,309,104,413,45,458
公投第９案,臺中市,清水區,南社里,103,1313,592,145,737,50,787
公投第９案,臺中市,清水區,南社里,104,1439,579,243,822,51,873
公投第９案,臺中市,清水區,南社里,105,1265,527,126,653,27,680
公投第９案,臺中市,清水區,南社里,106,1277,626,133,759,40,799
公投第９案,臺中市,清水區,南社里,107,1276,612,106,718,49,767
公投第９案,臺中市,清水區,南社里,108,1376,688,141,829,37,866
公投第９案,臺中市,清水區,南社里,109,1291,650,128,778,27,805
公投第９案,臺中市,清水區,裕嘉里,110,1510,669,189,858,61,919
公投第９案,臺中市,清水區,臨江里,111,1524,764,70,834,74,908
公投第９案,臺中市,清水區,秀水里,112,1474,602,145,747,36,783
公投第９案,臺中市,清水區,秀水里,113,1507,661,146,807,53,860
公投第９案,臺中市,清水區,秀水里,114,1321,628,161,789,72,861
公投第９案,臺中市,清水區,武鹿里,115,1157,437,133,570,36,606
公投第９案,臺中市,清水區,武鹿里,116,1255,583,123,706,44,750
公投第９案,臺中市,清水區,武鹿里,117,881,347,115,462,35,497
公投第９案,臺中市,清水區,海濱里,118,1083,507,110,617,52,669
公投第９案,臺中市,清水區,海濱里,119,951,437,110,547,31,578
公投第９案,臺中市,清水區,槺榔里,120,1424,587,153,740,41,781
公投第９案,臺中市,清水區,槺榔里,121,1233,455,155,610,65,675
公投第９案,臺中市,清水區,槺榔里,122,1288,448,126,574,54,628
公投第９案,臺中市,清水區,槺榔里,123,1200,600,126,726,50,776
公投第９案,臺中市,清水區,中社里,124,1609,782,132,914,45,959
公投第９案,臺中市,清水區,中社里,125,1136,547,139,686,22,708
公投第９案,臺中市,清水區,高西里,126,1302,526,141,667,56,723
公投第９案,臺中市,清水區,高南里,127,1373,538,159,697,71,768
公投第９案,臺中市,清水區,高東里,128,1257,443,144,587,69,656
公投第９案,臺中市,清水區,高北里,129,1184,449,102,551,64,615
公投第９案,臺中市,清水區,高美里,130,1322,554,133,687,62,749
公投第９案,臺中市,清水區,國姓里,131,1193,448,134,582,50,632
公投第９案,臺中市,清水區,國姓里,132,927,357,118,475,67,542
公投第９案,臺中市,清水區,菁埔里,133,1073,469,150,619,50,669
公投第９案,臺中市,清水區,菁埔里,134,1163,494,156,650,68,718
公投第９案,臺中市,清水區,頂湳里,135,855,319,106,425,52,477
公投第９案,臺中市,清水區,頂湳里,136,902,324,114,438,66,504
公投第９案,臺中市,清水區,田寮里,137,1415,605,152,757,59,816
公投第９案,臺中市,清水區,田寮里,138,1066,419,124,543,35,578
公投第９案,臺中市,清水區,橋頭里,139,1391,555,160,715,68,783
公投第９案,臺中市,清水區,橋頭里,140,1449,593,127,720,43,763
公投第９案,臺中市,清水區,橋頭里,141,1377,598,165,763,63,826
公投第９案,臺中市,清水區,橋頭里,142,1423,640,141,781,59,840
公投第９案,臺中市,清水區,橋頭里,143,1624,724,168,892,44,936
公投第９案,臺中市,清水區,下湳里,144,1358,327,356,683,72,755
公投第９案,臺中市,清水區,下湳里,145,1464,618,133,751,102,853
公投第９案,臺中市,清水區,東山里,146,1211,523,156,679,68,747
公投第９案,臺中市,清水區,吳厝里,147,1456,593,139,732,28,760
公投第９案,臺中市,清水區,楊厝里,148,1162,538,106,644,83,727
公投第９案,臺中市,清水區,海風里,149,1368,682,140,822,60,882
公投第９案,臺中市,梧棲區,頂寮里,150,1541,629,177,806,63,869
公投第９案,臺中市,梧棲區,頂寮里,151,1581,541,289,830,51,881
公投第９案,臺中市,梧棲區,下寮里,152,1083,464,129,593,43,636
公投第９案,臺中市,梧棲區,下寮里,153,876,401,95,496,32,528
公投第９案,臺中市,梧棲區,中正里,154,1043,412,137,549,69,618
公投第９案,臺中市,梧棲區,中正里,155,1502,609,138,747,33,780
公投第９案,臺中市,梧棲區,中正里,156,1384,599,137,736,53,789
公投第９案,臺中市,梧棲區,中和里,157,517,244,69,313,32,345
公投第９案,臺中市,梧棲區,文化里,158,1169,574,115,689,59,748
公投第９案,臺中市,梧棲區,安仁里,159,863,363,129,492,32,524
公投第９案,臺中市,梧棲區,草湳里,160,1277,477,126,603,40,643
公投第９案,臺中市,梧棲區,草湳里,161,1742,623,267,890,49,939
公投第９案,臺中市,梧棲區,草湳里,162,1342,582,158,740,49,789
公投第９案,臺中市,梧棲區,草湳里,163,1767,713,227,940,83,1023
公投第９案,臺中市,梧棲區,南簡里,164,1542,564,162,726,56,782
公投第９案,臺中市,梧棲區,南簡里,165,1636,682,168,850,47,897
公投第９案,臺中市,梧棲區,南簡里,166,1796,702,170,872,67,939
公投第９案,臺中市,梧棲區,福德里,167,1450,579,161,740,57,797
公投第９案,臺中市,梧棲區,福德里,168,1548,570,157,727,122,849
公投第９案,臺中市,梧棲區,福德里,169,1366,636,130,766,37,803
公投第９案,臺中市,梧棲區,大庄里,170,955,474,97,571,41,612
公投第９案,臺中市,梧棲區,大庄里,171,1305,517,146,663,54,717
公投第９案,臺中市,梧棲區,大庄里,172,1239,552,136,688,39,727
公投第９案,臺中市,梧棲區,大庄里,173,1079,485,120,605,62,667
公投第９案,臺中市,梧棲區,大庄里,174,1220,531,113,644,35,679
公投第９案,臺中市,梧棲區,大庄里,175,1544,703,166,869,62,931
公投第９案,臺中市,梧棲區,大村里,176,1460,634,188,822,57,879
公投第９案,臺中市,梧棲區,大村里,177,1292,586,142,728,57,785
公投第９案,臺中市,梧棲區,大村里,178,1300,542,132,674,65,739
公投第９案,臺中市,梧棲區,大村里,179,1555,625,163,788,47,835
公投第９案,臺中市,梧棲區,興農里,180,1031,421,107,528,45,573
公投第９案,臺中市,梧棲區,興農里,181,1277,573,128,701,65,766
公投第９案,臺中市,梧棲區,永寧里,182,1037,409,125,534,41,575
公投第９案,臺中市,梧棲區,永寧里,183,1187,515,133,648,57,705
公投第９案,臺中市,梧棲區,永安里,184,1399,573,137,710,42,752
公投第９案,臺中市,梧棲區,永安里,185,1135,500,93,593,45,638
公投第９案,臺中市,沙鹿區,居仁里,186,1380,677,23,700,38,738
公投第９案,臺中市,沙鹿區,洛泉里,187,852,371,108,479,41,520
公投第９案,臺中市,沙鹿區,洛泉里,188,1176,564,119,683,40,723
公投第９案,臺中市,沙鹿區,沙鹿里,189,958,414,166,580,67,647
公投第９案,臺中市,沙鹿區,美仁里,190,488,241,68,309,30,339
公投第９案,臺中市,沙鹿區,興仁里,191,1177,494,152,646,43,689
公投第９案,臺中市,沙鹿區,興仁里,192,1285,523,162,685,55,740
公投第９案,臺中市,沙鹿區,興安里,193,1736,652,198,850,82,932
公投第９案,臺中市,沙鹿區,興安里,194,1628,691,232,923,74,997
公投第９案,臺中市,沙鹿區,斗抵里,195,1469,615,143,758,36,794
公投第９案,臺中市,沙鹿區,斗抵里,196,1423,656,173,829,43,872
公投第９案,臺中市,沙鹿區,斗抵里,197,1444,622,156,778,82,860
公投第９案,臺中市,沙鹿區,鹿峰里,198,1469,641,138,779,78,857
公投第９案,臺中市,沙鹿區,鹿峰里,199,1902,815,193,1008,89,1097
公投第９案,臺中市,沙鹿區,鹿峰里,200,1675,745,192,937,48,985
公投第９案,臺中市,沙鹿區,鹿寮里,201,1098,444,143,587,48,635
公投第９案,臺中市,沙鹿區,鹿寮里,202,1539,659,202,861,74,935
公投第９案,臺中市,沙鹿區,鹿寮里,203,1329,595,153,748,38,786
公投第９案,臺中市,沙鹿區,鹿寮里,204,1255,523,135,658,48,706
公投第９案,臺中市,沙鹿區,鹿寮里,205,1507,742,90,832,69,901
公投第９案,臺中市,沙鹿區,竹林里,206,1463,604,201,805,86,891
公投第９案,臺中市,沙鹿區,竹林里,207,1279,509,127,636,70,706
公投第９案,臺中市,沙鹿區,竹林里,208,1024,405,90,495,39,534
公投第９案,臺中市,沙鹿區,竹林里,209,1388,565,114,679,74,753
公投第９案,臺中市,沙鹿區,竹林里,210,1074,477,141,618,36,654
公投第９案,臺中市,沙鹿區,竹林里,211,1072,501,115,616,34,650
公投第９案,臺中市,沙鹿區,犁分里,212,1107,505,118,623,64,687
公投第９案,臺中市,沙鹿區,福興里,213,1947,775,165,940,45,985
公投第９案,臺中市,沙鹿區,福興里,214,1682,671,161,832,70,902
公投第９案,臺中市,沙鹿區,北勢里,215,1633,728,170,898,54,952
公投第９案,臺中市,沙鹿區,北勢里,216,1533,595,148,743,59,802
公投第９案,臺中市,沙鹿區,北勢里,217,1605,557,151,708,43,751
公投第９案,臺中市,沙鹿區,晉江里,218,1694,674,163,837,27,864
公投第９案,臺中市,沙鹿區,六路里,219,1628,666,158,824,50,874
公投第９案,臺中市,沙鹿區,六路里,220,1665,771,172,943,21,964
公投第９案,臺中市,沙鹿區,六路里,221,1651,680,175,855,51,906
公投第９案,臺中市,沙鹿區,南勢里,222,1108,531,131,662,11,673
公投第９案,臺中市,沙鹿區,南勢里,223,1142,548,121,669,36,705
公投第９案,臺中市,沙鹿區,南勢里,224,1039,457,110,567,31,598
公投第９案,臺中市,沙鹿區,埔子里,225,1840,780,167,947,66,1013
公投第９案,臺中市,沙鹿區,埔子里,226,1872,801,191,992,45,1037
公投第９案,臺中市,沙鹿區,埔子里,227,1558,622,159,781,60,841
公投第９案,臺中市,沙鹿區,三鹿里,228,1739,698,155,853,45,898
公投第９案,臺中市,沙鹿區,三鹿里,229,1672,633,163,796,46,842
公投第９案,臺中市,沙鹿區,三鹿里,230,1634,701,163,864,47,911
公投第９案,臺中市,沙鹿區,三鹿里,231,1616,631,149,780,46,826
公投第９案,臺中市,沙鹿區,公明里,232,1593,666,193,859,46,905
公投第９案,臺中市,沙鹿區,公明里,233,981,387,110,497,28,525
公投第９案,臺中市,沙鹿區,公明里,234,1740,801,167,968,54,1022
公投第９案,臺中市,沙鹿區,清泉里,235,1247,542,161,703,60,763
公投第９案,臺中市,沙鹿區,清泉里,236,1047,485,99,584,20,604
公投第９案,臺中市,沙鹿區,西勢里,237,1119,453,139,592,74,666
公投第９案,臺中市,沙鹿區,西勢里,238,1025,421,102,523,21,544
公投第９案,臺中市,龍井區,竹坑里,239,1758,730,207,937,89,1026
公投第９案,臺中市,龍井區,竹坑里,240,1275,535,155,690,36,726
公投第９案,臺中市,龍井區,龍東里,241,1379,500,133,633,32,665
公投第９案,臺中市,龍井區,龍東里,242,1403,549,142,691,57,748
公投第９案,臺中市,龍井區,龍西里,243,974,397,122,519,42,561
公投第９案,臺中市,龍井區,龍西里,244,901,398,97,495,40,535
公投第９案,臺中市,龍井區,田中里,245,1779,713,200,913,70,983
公投第９案,臺中市,龍井區,田中里,246,1609,711,177,888,69,957
公投第９案,臺中市,龍井區,福田里,247,1038,400,108,508,29,537
公投第９案,臺中市,龍井區,麗水里,248,1328,583,162,745,60,805
公投第９案,臺中市,龍井區,麗水里,249,921,401,126,527,35,562
公投第９案,臺中市,龍井區,龍津里,250,1609,625,154,779,64,843
公投第９案,臺中市,龍井區,龍津里,251,1227,432,119,551,23,574
公投第９案,臺中市,龍井區,龍津里,252,1278,528,135,663,60,723
公投第９案,臺中市,龍井區,龍津里,253,914,288,92,380,26,406
公投第９案,臺中市,龍井區,三德里,254,1678,596,154,750,44,794
公投第９案,臺中市,龍井區,三德里,255,1233,455,120,575,49,624
公投第９案,臺中市,龍井區,忠和里,256,1520,624,160,784,76,860
公投第９案,臺中市,龍井區,忠和里,257,1905,736,193,929,38,967
公投第９案,臺中市,龍井區,忠和里,258,1520,643,193,836,61,897
公投第９案,臺中市,龍井區,山腳里,259,1385,538,153,691,59,750
公投第９案,臺中市,龍井區,山腳里,260,1212,505,145,650,36,686
公投第９案,臺中市,龍井區,山腳里,261,1432,652,134,786,23,809
公投第９案,臺中市,龍井區,山腳里,262,1663,656,160,816,41,857
公投第９案,臺中市,龍井區,龍泉里,263,1422,558,154,712,40,752
公投第９案,臺中市,龍井區,龍泉里,264,1616,596,157,753,60,813
公投第９案,臺中市,龍井區,龍泉里,265,1422,633,146,779,59,838
公投第９案,臺中市,龍井區,龍泉里,266,1165,555,108,663,25,688
公投第９案,臺中市,龍井區,龍泉里,267,1624,714,166,880,20,900
公投第９案,臺中市,龍井區,龍崗里,268,1613,691,168,859,46,905
公投第９案,臺中市,龍井區,龍崗里,269,943,425,113,538,48,586
公投第９案,臺中市,龍井區,新庄里,270,1595,591,171,762,90,852
公投第９案,臺中市,龍井區,新庄里,271,1508,661,149,810,78,888
公投第９案,臺中市,龍井區,新庄里,272,1479,594,151,745,43,788
公投第９案,臺中市,龍井區,新庄里,273,1509,643,178,821,51,872
公投第９案,臺中市,龍井區,南寮里,274,1582,693,175,868,68,936
公投第９案,臺中市,龍井區,東海里,275,1725,737,182,919,56,975
公投第９案,臺中市,龍井區,東海里,276,1616,712,146,858,46,904
公投第９案,臺中市,龍井區,東海里,277,1657,738,187,925,49,974
公投第９案,臺中市,龍井區,東海里,278,1774,781,196,977,59,1036
公投第９案,臺中市,龍井區,東海里,279,1701,724,253,977,57,1034
公投第９案,臺中市,龍井區,新東里,280,1121,480,143,623,39,662
公投第９案,臺中市,龍井區,新東里,281,987,437,140,577,38,615
公投第９案,臺中市,龍井區,新東里,282,1206,461,180,641,56,697
公投第９案,臺中市,龍井區,新東里,283,1378,648,154,802,42,844
公投第９案,臺中市,大肚區,王田里,284,1415,589,158,747,42,789
公投第９案,臺中市,大肚區,王田里,285,1392,528,154,682,64,746
公投第９案,臺中市,大肚區,王田里,286,1520,663,184,847,74,921
公投第９案,臺中市,大肚區,中和里,287,862,402,118,520,63,583
公投第９案,臺中市,大肚區,福山里,288,1256,581,144,725,52,777
公投第９案,臺中市,大肚區,福山里,289,1292,529,152,681,66,747
公投第９案,臺中市,大肚區,福山里,290,1010,437,135,572,44,616
公投第９案,臺中市,大肚區,營埔里,291,1485,644,186,830,88,918
公投第９案,臺中市,大肚區,社腳里,292,1190,572,114,686,71,757
公投第９案,臺中市,大肚區,社腳里,293,1250,550,130,680,62,742
公投第９案,臺中市,大肚區,新興里,294,1310,587,139,726,51,777
公投第９案,臺中市,大肚區,新興里,295,1294,551,137,688,48,736
公投第９案,臺中市,大肚區,大東里,296,1734,807,212,1019,64,1083
公投第９案,臺中市,大肚區,大東里,297,1316,530,153,683,63,746
公投第９案,臺中市,大肚區,大肚里,298,854,353,117,470,41,511
公投第９案,臺中市,大肚區,大肚里,299,1273,609,142,751,43,794
公投第９案,臺中市,大肚區,永和里,300,851,409,90,499,32,531
公投第９案,臺中市,大肚區,磺溪里,301,1629,709,156,865,38,903
公投第９案,臺中市,大肚區,永順里,302,1709,670,182,852,104,956
公投第９案,臺中市,大肚區,成功里,303,953,383,93,476,34,510
公投第９案,臺中市,大肚區,山陽里,304,1336,594,167,761,51,812
公投第９案,臺中市,大肚區,頂街里,305,2113,824,245,1069,74,1143
公投第９案,臺中市,大肚區,頂街里,306,1730,716,201,917,100,1017
公投第９案,臺中市,大肚區,頂街里,307,1692,740,160,900,43,943
公投第９案,臺中市,大肚區,頂街里,308,1747,770,159,929,54,983
公投第９案,臺中市,大肚區,瑞井里,309,1672,743,151,894,67,961
公投第９案,臺中市,大肚區,瑞井里,310,1675,649,178,827,51,878
公投第９案,臺中市,大肚區,瑞井里,311,1673,694,185,879,59,938
公投第９案,臺中市,大肚區,蔗廍里,312,1636,732,178,910,49,959
公投第９案,臺中市,大肚區,蔗廍里,313,1753,646,202,848,97,945
公投第９案,臺中市,大肚區,蔗廍里,314,1343,509,133,642,38,680
公投第９案,臺中市,大肚區,自強里,315,1822,733,193,926,65,991
公投第９案,臺中市,大肚區,自強里,316,1670,755,177,932,101,1033
公投第９案,臺中市,烏日區,烏日里,317,1480,631,218,849,79,928
公投第９案,臺中市,烏日區,烏日里,318,1841,840,219,1059,72,1131
公投第９案,臺中市,烏日區,烏日里,319,1751,720,209,929,69,998
公投第９案,臺中市,烏日區,烏日里,320,1547,680,207,887,62,949
公投第９案,臺中市,烏日區,烏日里,321,1836,821,188,1009,48,1057
公投第９案,臺中市,烏日區,湖日里,322,1239,542,192,734,94,828
公投第９案,臺中市,烏日區,湖日里,323,1295,530,149,679,63,742
公投第９案,臺中市,烏日區,三和里,324,1263,510,142,652,57,709
公投第９案,臺中市,烏日區,三和里,325,1622,677,191,868,39,907
公投第９案,臺中市,烏日區,三和里,326,1822,771,176,947,83,1030
公投第９案,臺中市,烏日區,榮泉里,327,1966,828,206,1034,65,1099
公投第９案,臺中市,烏日區,榮泉里,328,1615,731,164,895,56,951
公投第９案,臺中市,烏日區,榮泉里,329,1232,568,144,712,35,747
公投第９案,臺中市,烏日區,學田里,330,1347,569,120,689,37,726
公投第９案,臺中市,烏日區,學田里,331,1165,461,125,586,42,628
公投第９案,臺中市,烏日區,九德里,332,1664,734,195,929,54,983
公投第９案,臺中市,烏日區,九德里,333,1230,547,167,714,57,771
公投第９案,臺中市,烏日區,九德里,334,1574,687,218,905,75,980
公投第９案,臺中市,烏日區,九德里,335,1452,679,189,868,51,919
公投第９案,臺中市,烏日區,九德里,336,1879,736,163,899,75,974
公投第９案,臺中市,烏日區,九德里,337,1601,672,169,841,53,894
公投第９案,臺中市,烏日區,九德里,338,1546,700,197,897,57,954
公投第９案,臺中市,烏日區,九德里,339,1866,790,95,885,44,929
公投第９案,臺中市,烏日區,仁德里,340,1938,851,230,1081,76,1157
公投第９案,臺中市,烏日區,仁德里,341,1759,736,212,948,75,1023
公投第９案,臺中市,烏日區,仁德里,342,2061,836,214,1050,79,1129
公投第９案,臺中市,烏日區,仁德里,343,1691,762,191,953,48,1001
公投第９案,臺中市,烏日區,前竹里,344,1039,486,146,632,38,670
公投第９案,臺中市,烏日區,前竹里,345,1221,553,135,688,39,727
公投第９案,臺中市,烏日區,五光里,346,1650,695,212,907,89,996
公投第９案,臺中市,烏日區,光明里,347,937,409,128,537,42,579
公投第９案,臺中市,烏日區,光明里,348,1220,544,142,686,43,729
公投第９案,臺中市,烏日區,東園里,349,2139,783,234,1017,128,1145
公投第９案,臺中市,烏日區,溪埧里,350,1371,633,169,802,74,876
公投第９案,臺中市,烏日區,溪埧里,351,1277,557,144,701,50,751
公投第９案,臺中市,烏日區,溪埧里,352,1708,669,182,851,85,936
公投第９案,臺中市,烏日區,螺潭里,353,2048,848,220,1068,77,1145
公投第９案,臺中市,烏日區,北里里,354,1632,630,223,853,62,915
公投第９案,臺中市,烏日區,南里里,355,1327,576,165,741,64,805
公投第９案,臺中市,烏日區,溪尾里,356,854,327,100,427,70,497
公投第９案,臺中市,后里區,廣福里,357,852,398,100,498,45,543
公投第９案,臺中市,后里區,廣福里,358,1135,455,133,588,60,648
公投第９案,臺中市,后里區,仁里里,359,1079,406,118,524,52,576
公投第９案,臺中市,后里區,義里里,360,1539,680,168,848,62,910
公投第９案,臺中市,后里區,義里里,361,1591,669,189,858,67,925
公投第９案,臺中市,后里區,義德里,362,1376,561,112,673,41,714
公投第９案,臺中市,后里區,義德里,363,1298,538,142,680,34,714
公投第９案,臺中市,后里區,后里里,364,1428,619,148,767,83,850
公投第９案,臺中市,后里區,后里里,365,1178,581,145,726,57,783
公投第９案,臺中市,后里區,后里里,366,1095,463,147,610,47,657
公投第９案,臺中市,后里區,厚里里,367,963,394,114,508,25,533
公投第９案,臺中市,后里區,厚里里,368,1163,485,127,612,46,658
公投第９案,臺中市,后里區,墩東里,369,1018,461,119,580,39,619
公投第９案,臺中市,后里區,墩東里,370,854,415,95,510,40,550
公投第９案,臺中市,后里區,墩東里,371,1485,614,150,764,49,813
公投第９案,臺中市,后里區,墩東里,372,1355,669,133,802,56,858
公投第９案,臺中市,后里區,墩西里,373,840,325,91,416,50,466
公投第９案,臺中市,后里區,墩西里,374,1146,517,122,639,48,687
公投第９案,臺中市,后里區,墩南里,375,1669,754,201,955,66,1021
公投第９案,臺中市,后里區,墩南里,376,1673,539,406,945,96,1041
公投第９案,臺中市,后里區,墩北里,377,1493,661,156,817,48,865
公投第９案,臺中市,后里區,墩北里,378,1052,458,128,586,65,651
公投第９案,臺中市,后里區,墩北里,379,909,364,94,458,21,479
公投第９案,臺中市,后里區,中和里,380,1091,466,135,601,68,669
公投第９案,臺中市,后里區,中和里,381,1342,602,152,754,65,819
公投第９案,臺中市,后里區,舊社里,382,1138,444,136,580,60,640
公投第９案,臺中市,后里區,舊社里,383,977,434,115,549,41,590
公投第９案,臺中市,后里區,聯合里,384,1584,577,133,710,35,745
公投第９案,臺中市,后里區,太平里,385,915,390,103,493,30,523
公投第９案,臺中市,后里區,太平里,386,1225,529,149,678,59,737
公投第９案,臺中市,后里區,眉山里,387,1552,669,144,813,41,854
公投第９案,臺中市,后里區,眉山里,388,1600,699,150,849,26,875
公投第９案,臺中市,后里區,月眉里,389,942,396,105,501,31,532
公投第９案,臺中市,后里區,月眉里,390,943,383,110,493,31,524
公投第９案,臺中市,后里區,公館里,391,1055,407,112,519,40,559
公投第９案,臺中市,后里區,公館里,392,1067,439,132,571,59,630
公投第９案,臺中市,后里區,泰安里,393,1340,517,150,667,59,726
公投第９案,臺中市,豐原區,豐原里,394,983,402,104,506,50,556
公投第９案,臺中市,豐原區,豐原里,395,1309,539,193,732,46,778
公投第９案,臺中市,豐原區,豐榮里,396,1116,465,177,642,53,695
公投第９案,臺中市,豐原區,頂街里,397,945,423,134,557,44,601
公投第９案,臺中市,豐原區,中山里,398,850,364,125,489,63,552
公投第９案,臺中市,豐原區,下街里,399,760,362,91,453,35,488
公投第９案,臺中市,豐原區,中陽里,400,1617,706,189,895,9,904
公投第９案,臺中市,豐原區,中陽里,401,1677,675,150,825,59,884
公投第９案,臺中市,豐原區,中陽里,402,1771,868,209,1077,41,1118
公投第９案,臺中市,豐原區,大湳里,403,1145,435,176,611,49,660
公投第９案,臺中市,豐原區,大湳里,404,1362,573,160,733,35,768
公投第９案,臺中市,豐原區,北湳里,405,1389,641,152,793,44,837
公投第９案,臺中市,豐原區,北湳里,406,1530,698,197,895,46,941
公投第９案,臺中市,豐原區,東湳里,407,1471,619,175,794,89,883
公投第９案,臺中市,豐原區,東湳里,408,1410,608,178,786,81,867
公投第９案,臺中市,豐原區,東湳里,409,1162,478,136,614,58,672
公投第９案,臺中市,豐原區,西湳里,410,1656,701,194,895,40,935
公投第９案,臺中市,豐原區,西湳里,411,1838,816,179,995,49,1044
公投第９案,臺中市,豐原區,西湳里,412,1666,696,195,891,56,947
公投第９案,臺中市,豐原區,西湳里,413,1821,847,207,1054,45,1099
公投第９案,臺中市,豐原區,西湳里,414,1821,918,228,1146,66,1212
公投第９案,臺中市,豐原區,豐西里,415,1647,665,210,875,38,913
公投第９案,臺中市,豐原區,圳寮里,416,1256,597,163,760,78,838
公投第９案,臺中市,豐原區,豐圳里,417,1552,733,204,937,61,998
公投第９案,臺中市,豐原區,豐圳里,418,1793,795,199,994,52,1046
公投第９案,臺中市,豐原區,富春里,419,759,364,124,488,46,534
公投第９案,臺中市,豐原區,葫蘆里,420,642,266,114,380,42,422
公投第９案,臺中市,豐原區,西安里,421,1528,664,201,865,34,899
公投第９案,臺中市,豐原區,西安里,422,1788,855,217,1072,65,1137
公投第９案,臺中市,豐原區,西安里,423,1663,815,186,1001,76,1077
公投第９案,臺中市,豐原區,西勢里,424,1260,646,164,810,59,869
公投第９案,臺中市,豐原區,西勢里,425,902,389,96,485,33,518
公投第９案,臺中市,豐原區,中興里,426,1357,571,133,704,25,729
公投第９案,臺中市,豐原區,中興里,427,1592,738,188,926,40,966
公投第９案,臺中市,豐原區,社皮里,428,1873,824,204,1028,76,1104
公投第９案,臺中市,豐原區,社皮里,429,1867,826,167,993,70,1063
公投第９案,臺中市,豐原區,社皮里,430,1823,756,214,970,90,1060
公投第９案,臺中市,豐原區,社皮里,431,1962,759,208,967,67,1034
公投第９案,臺中市,豐原區,社皮里,432,2313,1059,269,1328,88,1416
公投第９案,臺中市,豐原區,三村里,433,1510,687,185,872,63,935
公投第９案,臺中市,豐原區,三村里,434,1824,842,198,1040,61,1101
公投第９案,臺中市,豐原區,三村里,435,1363,600,163,763,48,811
公投第９案,臺中市,豐原區,三村里,436,1535,721,188,909,62,971
公投第９案,臺中市,豐原區,東勢里,437,1457,642,213,855,56,911
公投第９案,臺中市,豐原區,民生里,438,1184,521,168,689,44,733
公投第９案,臺中市,豐原區,田心里,439,2299,838,217,1055,63,1118
公投第９案,臺中市,豐原區,田心里,440,1940,863,211,1074,79,1153
公投第９案,臺中市,豐原區,田心里,441,2067,881,213,1094,44,1138
公投第９案,臺中市,豐原區,豐田里,442,2038,831,234,1065,88,1153
公投第９案,臺中市,豐原區,豐田里,443,1835,676,6,682,67,749
公投第９案,臺中市,豐原區,豐田里,444,1979,845,235,1080,95,1175
公投第９案,臺中市,豐原區,豐田里,445,2014,859,190,1049,94,1143
公投第９案,臺中市,豐原區,豐田里,446,2257,948,269,1217,98,1315
公投第９案,臺中市,豐原區,鎌村里,447,1406,624,197,821,66,887
公投第９案,臺中市,豐原區,鎌村里,448,1418,648,154,802,51,853
公投第９案,臺中市,豐原區,鎌村里,449,1772,852,203,1055,59,1114
公投第９案,臺中市,豐原區,陽明里,450,1202,553,171,724,38,762
公投第９案,臺中市,豐原區,陽明里,451,1447,696,158,854,40,894
公投第９案,臺中市,豐原區,南陽里,452,1758,785,218,1003,80,1083
公投第９案,臺中市,豐原區,南陽里,453,1546,753,185,938,57,995
公投第９案,臺中市,豐原區,南陽里,454,1815,886,184,1070,53,1123
公投第９案,臺中市,豐原區,南陽里,455,1932,867,226,1093,62,1155
公投第９案,臺中市,豐原區,南陽里,456,1770,878,206,1084,54,1138
公投第９案,臺中市,豐原區,南陽里,457,1560,669,153,822,45,867
公投第９案,臺中市,豐原區,北陽里,458,1810,805,198,1003,42,1045
公投第９案,臺中市,豐原區,北陽里,459,1653,797,189,986,49,1035
公投第９案,臺中市,豐原區,北陽里,460,1444,648,152,800,61,861
公投第９案,臺中市,豐原區,北陽里,461,1318,637,153,790,47,837
公投第９案,臺中市,豐原區,北陽里,462,1566,670,195,865,83,948
公投第９案,臺中市,豐原區,北陽里,463,1748,754,201,955,65,1020
公投第９案,臺中市,豐原區,北陽里,464,1772,686,206,892,87,979
公投第９案,臺中市,豐原區,北陽里,465,1721,715,210,925,87,1012
公投第９案,臺中市,豐原區,東陽里,466,1578,689,204,893,55,948
公投第９案,臺中市,豐原區,南村里,467,1859,727,258,985,81,1066
公投第９案,臺中市,豐原區,南村里,468,1479,632,193,825,51,876
公投第９案,臺中市,豐原區,南村里,469,1889,822,222,1044,55,1099
公投第９案,臺中市,豐原區,南田里,470,1803,789,199,988,45,1033
公投第９案,臺中市,豐原區,南田里,471,1421,571,179,750,66,816
公投第９案,臺中市,豐原區,南嵩里,472,1585,720,197,917,83,1000
公投第９案,臺中市,豐原區,南嵩里,473,1774,821,207,1028,82,1110
公投第９案,臺中市,豐原區,翁明里,474,2132,942,239,1181,74,1255
公投第９案,臺中市,豐原區,翁子里,475,1515,655,191,846,59,905
公投第９案,臺中市,豐原區,翁子里,476,1359,548,131,679,26,705
公投第９案,臺中市,豐原區,翁社里,477,948,390,155,545,50,595
公投第９案,臺中市,豐原區,翁社里,478,1134,487,166,653,57,710
公投第９案,臺中市,豐原區,朴子里,479,1114,545,148,693,56,749
公投第９案,臺中市,豐原區,朴子里,480,1050,438,149,587,50,637
公投第９案,臺中市,豐原區,朴子里,481,1182,579,144,723,51,774
公投第９案,臺中市,神岡區,神岡里,482,1684,771,166,937,61,998
公投第９案,臺中市,神岡區,神岡里,483,1559,676,194,870,49,919
公投第９案,臺中市,神岡區,庄前里,484,1095,466,116,582,34,616
公投第９案,臺中市,神岡區,庄前里,485,1044,526,133,659,50,709
公投第９案,臺中市,神岡區,北庄里,486,1310,609,175,784,69,853
公投第９案,臺中市,神岡區,北庄里,487,1294,556,181,737,91,828
公投第９案,臺中市,神岡區,庄後里,488,1143,493,138,631,56,687
公投第９案,臺中市,神岡區,庄後里,489,1022,437,145,582,51,633
公投第９案,臺中市,神岡區,圳前里,490,1269,494,148,642,51,693
公投第９案,臺中市,神岡區,圳前里,491,1085,393,95,488,21,509
公投第９案,臺中市,神岡區,圳堵里,492,942,395,130,525,67,592
公投第９案,臺中市,神岡區,圳堵里,493,1154,467,143,610,32,642
公投第９案,臺中市,神岡區,新庄里,494,1390,534,183,717,55,772
公投第９案,臺中市,神岡區,新庄里,495,1372,594,185,779,89,868
公投第９案,臺中市,神岡區,新庄里,496,1328,481,160,641,42,683
公投第９案,臺中市,神岡區,山皮里,497,1038,412,130,542,23,565
公投第９案,臺中市,神岡區,社口里,498,1452,582,167,749,39,788
公投第９案,臺中市,神岡區,社口里,499,1551,697,180,877,76,953
公投第９案,臺中市,神岡區,社口里,500,1567,653,139,792,66,858
公投第９案,臺中市,神岡區,社口里,501,1449,634,167,801,42,843
公投第９案,臺中市,神岡區,社口里,502,1246,481,132,613,29,642
公投第９案,臺中市,神岡區,社南里,503,1431,638,142,780,66,846
公投第９案,臺中市,神岡區,社南里,504,1163,540,135,675,60,735
公投第９案,臺中市,神岡區,社南里,505,1402,644,188,832,63,895
公投第９案,臺中市,神岡區,社南里,506,1271,556,150,706,43,749
公投第９案,臺中市,神岡區,三角里,507,1198,536,137,673,51,724
公投第９案,臺中市,神岡區,三角里,508,1312,601,135,736,69,805
公投第９案,臺中市,神岡區,大社里,509,1590,651,184,835,69,904
公投第９案,臺中市,神岡區,大社里,510,1324,536,159,695,29,724
公投第９案,臺中市,神岡區,大社里,511,1415,585,133,718,41,759
公投第９案,臺中市,神岡區,岸裡里,512,1483,687,199,886,54,940
公投第９案,臺中市,神岡區,岸裡里,513,1402,550,145,695,38,733
公投第９案,臺中市,神岡區,豐洲里,514,1275,529,137,666,44,710
公投第９案,臺中市,神岡區,豐洲里,515,1288,480,167,647,58,705
公投第９案,臺中市,神岡區,豐洲里,516,1080,431,131,562,53,615
公投第９案,臺中市,神岡區,豐洲里,517,1344,550,140,690,28,718
公投第９案,臺中市,神岡區,豐洲里,518,1061,478,127,605,60,665
公投第９案,臺中市,神岡區,豐洲里,519,1176,530,164,694,50,744
公投第９案,臺中市,神岡區,神洲里,520,1244,534,181,715,62,777
公投第９案,臺中市,神岡區,神洲里,521,1318,632,159,791,61,852
公投第９案,臺中市,神岡區,溪洲里,522,1471,587,163,750,51,801
公投第９案,臺中市,神岡區,溪洲里,523,1323,619,168,787,88,875
公投第９案,臺中市,大雅區,上雅里,524,2027,878,221,1099,73,1172
公投第９案,臺中市,大雅區,上雅里,525,1967,752,199,951,36,987
公投第９案,臺中市,大雅區,上雅里,526,1912,798,179,977,48,1025
公投第９案,臺中市,大雅區,大雅里,527,1537,720,179,899,43,942
公投第９案,臺中市,大雅區,大雅里,528,1439,637,177,814,59,873
公投第９案,臺中市,大雅區,大雅里,529,1402,624,166,790,48,838
公投第９案,臺中市,大雅區,文雅里,530,2013,842,202,1044,71,1115
公投第９案,臺中市,大雅區,文雅里,531,1917,834,211,1045,74,1119
公投第９案,臺中市,大雅區,文雅里,532,2011,830,216,1046,52,1098
公投第９案,臺中市,大雅區,三和里,533,1887,877,159,1036,47,1083
公投第９案,臺中市,大雅區,三和里,534,1480,668,179,847,58,905
公投第９案,臺中市,大雅區,三和里,535,1816,771,204,975,57,1032
公投第９案,臺中市,大雅區,二和里,536,1898,718,176,894,93,987
公投第９案,臺中市,大雅區,二和里,537,2008,952,128,1080,68,1148
公投第９案,臺中市,大雅區,二和里,538,1976,892,200,1092,54,1146
公投第９案,臺中市,大雅區,四德里,539,1673,743,181,924,50,974
公投第９案,臺中市,大雅區,四德里,540,1409,658,171,829,39,868
公投第９案,臺中市,大雅區,四德里,541,1382,754,25,779,25,804
公投第９案,臺中市,大雅區,西寶里,542,1635,693,168,861,70,931
公投第９案,臺中市,大雅區,西寶里,543,1565,717,163,880,51,931
公投第９案,臺中市,大雅區,西寶里,544,1528,606,179,785,52,837
公投第９案,臺中市,大雅區,上楓里,545,1963,773,181,954,35,989
公投第９案,臺中市,大雅區,上楓里,546,2073,808,203,1011,49,1060
公投第９案,臺中市,大雅區,上楓里,547,1984,817,215,1032,64,1096
公投第９案,臺中市,大雅區,大楓里,548,1688,712,170,882,59,941
公投第９案,臺中市,大雅區,大楓里,549,1387,603,172,775,52,827
公投第９案,臺中市,大雅區,大楓里,550,1701,771,176,947,85,1032
公投第９案,臺中市,大雅區,雅楓里,551,1721,739,170,909,59,968
公投第９案,臺中市,大雅區,雅楓里,552,1879,658,150,808,56,864
公投第９案,臺中市,大雅區,員林里,553,1568,754,182,936,69,1005
公投第９案,臺中市,大雅區,員林里,554,1761,710,219,929,81,1010
公投第９案,臺中市,大雅區,員林里,555,1752,781,185,966,103,1069
公投第９案,臺中市,大雅區,員林里,556,1264,578,136,714,46,760
公投第９案,臺中市,大雅區,員林里,557,1302,613,133,746,40,786
公投第９案,臺中市,大雅區,員林里,558,1449,626,152,778,55,833
公投第９案,臺中市,大雅區,六寶里,559,1621,724,190,914,82,996
公投第９案,臺中市,大雅區,六寶里,560,1647,668,170,838,81,919
公投第９案,臺中市,大雅區,六寶里,561,1441,609,135,744,39,783
公投第９案,臺中市,大雅區,六寶里,562,1460,617,147,764,30,794
公投第９案,臺中市,大雅區,秀山里,563,1832,836,224,1060,66,1126
公投第９案,臺中市,大雅區,秀山里,564,1371,631,171,802,69,871
公投第９案,臺中市,大雅區,橫山里,565,1418,534,142,676,11,687
公投第９案,臺中市,大雅區,橫山里,566,1473,681,148,829,34,863
公投第９案,臺中市,大雅區,橫山里,567,1335,582,148,730,63,793
公投第９案,臺中市,大雅區,忠義里,568,1733,750,163,913,66,979
公投第９案,臺中市,大雅區,忠義里,569,1884,695,165,860,103,963
公投第９案,臺中市,潭子區,潭秀里,570,1306,593,142,735,51,786
公投第９案,臺中市,潭子區,潭北里,571,1128,502,143,645,43,688
公投第９案,臺中市,潭子區,潭北里,572,1159,557,131,688,58,746
公投第９案,臺中市,潭子區,潭陽里,573,1630,745,191,936,67,1003
公投第９案,臺中市,潭子區,潭陽里,574,1532,691,146,837,39,876
公投第９案,臺中市,潭子區,潭陽里,575,1677,637,192,829,39,868
公投第９案,臺中市,潭子區,潭陽里,576,1744,704,165,869,55,924
公投第９案,臺中市,潭子區,潭陽里,577,1795,854,122,976,57,1033
公投第９案,臺中市,潭子區,潭陽里,578,1171,501,129,630,41,671
公投第９案,臺中市,潭子區,潭陽里,579,1427,628,150,778,38,816
公投第９案,臺中市,潭子區,福仁里,580,1709,724,218,942,63,1005
公投第９案,臺中市,潭子區,福仁里,581,1723,751,187,938,40,978
公投第９案,臺中市,潭子區,福仁里,582,1782,730,203,933,51,984
公投第９案,臺中市,潭子區,福仁里,583,1407,593,136,729,39,768
公投第９案,臺中市,潭子區,福仁里,584,1771,771,199,970,35,1005
公投第９案,臺中市,潭子區,福仁里,585,1795,794,200,994,90,1084
公投第９案,臺中市,潭子區,頭家里,586,1612,762,193,955,54,1009
公投第９案,臺中市,潭子區,頭家里,587,1894,692,207,899,40,939
公投第９案,臺中市,潭子區,頭家里,588,1689,611,191,802,47,849
公投第９案,臺中市,潭子區,頭家東里,589,1525,579,162,741,51,792
公投第９案,臺中市,潭子區,頭家東里,590,1622,700,179,879,45,924
公投第９案,臺中市,潭子區,頭家東里,591,1200,537,128,665,60,725
公投第９案,臺中市,潭子區,家興里,592,1355,567,138,705,16,721
公投第９案,臺中市,潭子區,家興里,593,1777,732,194,926,36,962
公投第９案,臺中市,潭子區,家興里,594,1923,850,200,1050,34,1084
公投第９案,臺中市,潭子區,家興里,595,1674,697,160,857,64,921
公投第９案,臺中市,潭子區,家福里,596,1451,694,160,854,53,907
公投第９案,臺中市,潭子區,家福里,597,1486,649,169,818,55,873
公投第９案,臺中市,潭子區,家福里,598,1511,660,191,851,56,907
公投第９案,臺中市,潭子區,甘蔗里,599,1666,791,155,946,48,994
公投第９案,臺中市,潭子區,甘蔗里,600,1750,722,202,924,63,987
公投第９案,臺中市,潭子區,甘蔗里,601,1437,639,124,763,47,810
公投第９案,臺中市,潭子區,甘蔗里,602,1735,765,163,928,45,973
公投第９案,臺中市,潭子區,甘蔗里,603,1612,632,225,857,54,911
公投第９案,臺中市,潭子區,甘蔗里,604,1143,557,112,669,37,706
公投第９案,臺中市,潭子區,東寶里,605,2096,857,216,1073,47,1120
公投第９案,臺中市,潭子區,東寶里,606,1549,679,194,873,63,936
公投第９案,臺中市,潭子區,東寶里,607,1573,685,175,860,33,893
公投第９案,臺中市,潭子區,東寶里,608,1585,649,150,799,40,839
公投第９案,臺中市,潭子區,東寶里,609,1572,678,167,845,40,885
公投第９案,臺中市,潭子區,東寶里,610,1738,830,166,996,42,1038
公投第９案,臺中市,潭子區,東寶里,611,1883,776,201,977,71,1048
公投第９案,臺中市,潭子區,大富里,612,1401,598,178,776,31,807
公投第９案,臺中市,潭子區,大富里,613,1352,611,168,779,53,832
公投第９案,臺中市,潭子區,大豐里,614,2085,914,235,1149,87,1236
公投第９案,臺中市,潭子區,大豐里,615,2047,941,216,1157,84,1241
公投第９案,臺中市,潭子區,大豐里,616,1673,667,181,848,31,879
公投第９案,臺中市,潭子區,栗林里,617,1874,785,233,1018,98,1116
公投第９案,臺中市,潭子區,栗林里,618,1051,423,146,569,65,634
公投第９案,臺中市,潭子區,栗林里,619,1674,659,180,839,43,882
公投第９案,臺中市,潭子區,嘉仁里,620,1831,779,230,1009,71,1080
公投第９案,臺中市,潭子區,嘉仁里,621,2003,787,229,1016,66,1082
公投第９案,臺中市,潭子區,新田里,622,1535,654,161,815,48,863
公投第９案,臺中市,潭子區,聚興里,623,2286,842,223,1065,105,1170
公投第９案,臺中市,潭子區,聚興里,624,1861,759,181,940,57,997
公投第９案,臺中市,西屯區,西安里,625,1638,739,220,959,60,1019
公投第９案,臺中市,西屯區,西安里,626,1335,544,145,689,42,731
公投第９案,臺中市,西屯區,西安里,627,1776,792,202,994,51,1045
公投第９案,臺中市,西屯區,至善里,628,1351,581,167,748,25,773
公投第９案,臺中市,西屯區,至善里,629,1338,598,168,766,51,817
公投第９案,臺中市,西屯區,至善里,630,1582,687,172,859,51,910
公投第９案,臺中市,西屯區,西平里,631,1710,700,157,857,32,889
公投第９案,臺中市,西屯區,西平里,632,1595,592,177,769,54,823
公投第９案,臺中市,西屯區,西平里,633,1585,739,144,883,56,939
公投第９案,臺中市,西屯區,西墩里,634,1749,709,194,903,73,976
公投第９案,臺中市,西屯區,西墩里,635,1877,844,183,1027,61,1088
公投第９案,臺中市,西屯區,西墩里,636,1697,692,188,880,44,924
公投第９案,臺中市,西屯區,潮洋里,637,1480,687,175,862,40,902
公投第９案,臺中市,西屯區,潮洋里,638,1483,723,196,919,53,972
公投第９案,臺中市,西屯區,潮洋里,639,2484,660,191,851,43,894
公投第９案,臺中市,西屯區,龍潭里,640,781,370,108,478,44,522
公投第９案,臺中市,西屯區,惠來里,641,1477,666,171,837,50,887
公投第９案,臺中市,西屯區,惠來里,642,1784,763,191,954,33,987
公投第９案,臺中市,西屯區,惠來里,643,1686,772,163,935,33,968
公投第９案,臺中市,西屯區,惠來里,644,1692,718,197,915,39,954
公投第９案,臺中市,西屯區,惠來里,645,1659,725,152,877,18,895
公投第９案,臺中市,西屯區,惠來里,646,1648,723,178,901,38,939
公投第９案,臺中市,西屯區,惠來里,647,1536,683,203,886,39,925
公投第９案,臺中市,西屯區,惠來里,648,1666,741,212,953,46,999
公投第９案,臺中市,西屯區,上石里,649,1428,658,143,801,49,850
公投第９案,臺中市,西屯區,上石里,650,1810,777,161,938,52,990
公投第９案,臺中市,西屯區,上石里,651,1574,708,153,861,33,894
公投第９案,臺中市,西屯區,上安里,652,1650,753,164,917,17,934
公投第９案,臺中市,西屯區,上安里,653,1681,708,191,899,72,971
公投第９案,臺中市,西屯區,上安里,654,1656,673,212,885,44,929
公投第９案,臺中市,西屯區,上德里,655,1243,579,136,715,50,765
公投第９案,臺中市,西屯區,上德里,656,1471,698,171,869,62,931
公投第９案,臺中市,西屯區,上德里,657,1431,677,178,855,39,894
公投第９案,臺中市,西屯區,逢甲里,658,1714,747,197,944,32,976
公投第９案,臺中市,西屯區,逢甲里,659,1424,646,152,798,48,846
公投第９案,臺中市,西屯區,逢甲里,660,1176,539,119,658,43,701
公投第９案,臺中市,西屯區,逢福里,661,1456,630,177,807,69,876
公投第９案,臺中市,西屯區,逢福里,662,1451,710,153,863,47,910
公投第９案,臺中市,西屯區,逢福里,663,1063,551,113,664,31,695
公投第９案,臺中市,西屯區,逢福里,664,1357,637,134,771,62,833
公投第９案,臺中市,西屯區,鵬程里,665,1355,690,93,783,58,841
公投第９案,臺中市,西屯區,鵬程里,666,1384,721,108,829,22,851
公投第９案,臺中市,西屯區,何厝里,667,1613,715,203,918,48,966
公投第９案,臺中市,西屯區,何厝里,668,1562,658,195,853,55,908
公投第９案,臺中市,西屯區,何明里,669,1219,563,169,732,63,795
公投第９案,臺中市,西屯區,何明里,670,1235,521,161,682,39,721
公投第９案,臺中市,西屯區,何明里,671,1131,496,136,632,47,679
公投第９案,臺中市,西屯區,何南里,672,1494,709,173,882,51,933
公投第９案,臺中市,西屯區,何南里,673,1325,574,138,712,32,744
公投第９案,臺中市,西屯區,何南里,674,1386,589,202,791,34,825
公投第９案,臺中市,西屯區,何成里,675,1816,775,224,999,75,1074
公投第９案,臺中市,西屯區,何成里,676,1734,717,178,895,36,931
公投第９案,臺中市,西屯區,何成里,677,1777,808,188,996,71,1067
公投第９案,臺中市,西屯區,何成里,678,1818,746,187,933,67,1000
公投第９案,臺中市,西屯區,何安里,679,1699,693,197,890,72,962
公投第９案,臺中市,西屯區,何安里,680,1715,663,177,840,45,885
公投第９案,臺中市,西屯區,何安里,681,1654,670,183,853,39,892
公投第９案,臺中市,西屯區,何仁里,682,1636,714,162,876,24,900
公投第９案,臺中市,西屯區,何仁里,683,1298,525,159,684,34,718
公投第９案,臺中市,西屯區,何仁里,684,1391,596,193,789,48,837
公投第９案,臺中市,西屯區,何仁里,685,1853,802,218,1020,63,1083
公投第９案,臺中市,西屯區,何德里,686,1820,760,86,846,64,910
公投第９案,臺中市,西屯區,何德里,687,1809,803,188,991,47,1038
公投第９案,臺中市,西屯區,何福里,688,1352,625,168,793,49,842
公投第９案,臺中市,西屯區,何福里,689,1521,644,174,818,65,883
公投第９案,臺中市,西屯區,何福里,690,1486,668,187,855,46,901
公投第９案,臺中市,西屯區,何源里,691,1674,729,208,937,45,982
公投第９案,臺中市,西屯區,何源里,692,1610,741,211,952,53,1005
公投第９案,臺中市,西屯區,何源里,693,1695,755,190,945,45,990
公投第９案,臺中市,西屯區,何源里,694,1684,700,198,898,47,945
公投第９案,臺中市,西屯區,大河里,695,1221,547,159,706,29,735
公投第９案,臺中市,西屯區,大河里,696,1252,613,167,780,63,843
公投第９案,臺中市,西屯區,大河里,697,1301,574,184,758,53,811
公投第９案,臺中市,西屯區,大石里,698,1049,535,92,627,40,667
公投第９案,臺中市,西屯區,大石里,699,1113,534,80,614,63,677
公投第９案,臺中市,西屯區,大福里,700,1557,661,140,801,54,855
公投第９案,臺中市,西屯區,大福里,701,1640,706,189,895,50,945
公投第９案,臺中市,西屯區,大鵬里,702,1402,688,182,870,70,940
公投第９案,臺中市,西屯區,大鵬里,703,1717,675,161,836,70,906
公投第９案,臺中市,西屯區,大鵬里,704,1688,697,194,891,68,959
公投第９案,臺中市,西屯區,港尾里,705,1168,480,146,626,91,717
公投第９案,臺中市,西屯區,港尾里,706,1729,716,181,897,49,946
公投第９案,臺中市,西屯區,港尾里,707,2007,807,209,1016,48,1064
公投第９案,臺中市,西屯區,廣福里,708,1296,556,158,714,81,795
公投第９案,臺中市,西屯區,廣福里,709,1068,412,101,513,26,539
公投第９案,臺中市,西屯區,林厝里,710,1707,664,163,827,78,905
公投第９案,臺中市,西屯區,林厝里,711,1636,732,190,922,49,971
公投第９案,臺中市,西屯區,永安里,712,1761,657,132,789,49,838
公投第９案,臺中市,西屯區,永安里,713,1314,559,164,723,47,770
公投第９案,臺中市,西屯區,永安里,714,1233,601,144,745,43,788
公投第９案,臺中市,西屯區,永安里,715,1549,636,172,808,48,856
公投第９案,臺中市,西屯區,永安里,716,1639,691,151,842,29,871
公投第９案,臺中市,西屯區,永安里,717,1486,626,142,768,44,812
公投第９案,臺中市,西屯區,永安里,718,1806,775,187,962,21,983
公投第９案,臺中市,西屯區,永安里,719,1451,625,150,775,22,797
公投第９案,臺中市,西屯區,福安里,720,1302,617,114,731,36,767
公投第９案,臺中市,西屯區,福安里,721,1353,614,177,791,51,842
公投第９案,臺中市,西屯區,福雅里,722,2162,973,226,1199,53,1252
公投第９案,臺中市,西屯區,福雅里,723,1520,626,194,820,45,865
公投第９案,臺中市,西屯區,福雅里,724,1935,842,171,1013,40,1053
公投第９案,臺中市,西屯區,福林里,725,1847,782,206,988,45,1033
公投第９案,臺中市,西屯區,福林里,726,1738,764,195,959,45,1004
公投第９案,臺中市,西屯區,福林里,727,1640,750,213,963,42,1005
公投第９案,臺中市,西屯區,福林里,728,1908,811,221,1032,38,1070
公投第９案,臺中市,西屯區,福瑞里,729,1402,640,146,786,27,813
公投第９案,臺中市,西屯區,福瑞里,730,1515,633,155,788,24,812
公投第９案,臺中市,西屯區,福聯里,731,1541,565,144,709,34,743
公投第９案,臺中市,西屯區,福聯里,732,1502,630,166,796,39,835
公投第９案,臺中市,西屯區,福和里,733,1526,651,206,857,51,908
公投第９案,臺中市,西屯區,福和里,734,1425,631,172,803,61,864
公投第９案,臺中市,西屯區,福和里,735,1334,571,216,787,33,820
公投第９案,臺中市,西屯區,福中里,736,1649,755,190,945,34,979
公投第９案,臺中市,西屯區,福中里,737,1566,654,160,814,40,854
公投第９案,臺中市,西屯區,福恩里,738,1629,768,177,945,46,991
公投第９案,臺中市,西屯區,福恩里,739,1628,724,203,927,40,967
公投第９案,臺中市,西屯區,福恩里,740,1442,689,153,842,40,882
公投第９案,臺中市,西屯區,協和里,741,1206,482,133,615,57,672
公投第９案,臺中市,西屯區,協和里,742,1086,469,163,632,51,683
公投第９案,臺中市,西屯區,協和里,743,1088,510,127,637,41,678
公投第９案,臺中市,西屯區,協和里,744,1140,499,143,642,34,676
公投第９案,臺中市,南屯區,南屯里,745,1321,581,162,743,64,807
公投第９案,臺中市,南屯區,南屯里,746,1346,588,193,781,63,844
公投第９案,臺中市,南屯區,南屯里,747,1428,625,185,810,48,858
公投第９案,臺中市,南屯區,南屯里,748,1442,653,145,798,36,834
公投第９案,臺中市,南屯區,南屯里,749,1408,719,163,882,27,909
公投第９案,臺中市,南屯區,南屯里,750,1404,683,146,829,30,859
公投第９案,臺中市,南屯區,豐樂里,751,1354,664,148,812,48,860
公投第９案,臺中市,南屯區,豐樂里,752,1332,614,170,784,53,837
公投第９案,臺中市,南屯區,豐樂里,753,1463,663,212,875,49,924
公投第９案,臺中市,南屯區,豐樂里,754,1413,588,223,811,41,852
公投第９案,臺中市,南屯區,豐樂里,755,1218,588,161,749,25,774
公投第９案,臺中市,南屯區,豐樂里,756,1308,561,167,728,33,761
公投第９案,臺中市,南屯區,豐樂里,757,1527,735,197,932,40,972
公投第９案,臺中市,南屯區,豐樂里,758,1294,608,168,776,33,809
公投第９案,臺中市,南屯區,楓樹里,759,1516,571,194,765,51,816
公投第９案,臺中市,南屯區,楓樹里,760,1529,664,198,862,86,948
公投第９案,臺中市,南屯區,楓樹里,761,1397,616,180,796,63,859
公投第９案,臺中市,南屯區,楓樹里,762,1406,611,136,747,40,787
公投第９案,臺中市,南屯區,中和里,763,1497,613,165,778,50,828
公投第９案,臺中市,南屯區,中和里,764,1424,578,170,748,70,818
公投第９案,臺中市,南屯區,中和里,765,1488,532,148,680,47,727
公投第９案,臺中市,南屯區,鎮平里,766,608,285,77,362,46,408
公投第９案,臺中市,南屯區,鎮平里,767,813,324,140,464,64,528
公投第９案,臺中市,南屯區,春社里,768,1190,520,147,667,65,732
公投第９案,臺中市,南屯區,春社里,769,1174,507,121,628,35,663
公投第９案,臺中市,南屯區,春社里,770,1224,574,124,698,17,715
公投第９案,臺中市,南屯區,春社里,771,1466,535,120,655,43,698
公投第９案,臺中市,南屯區,春社里,772,1333,442,102,544,31,575
公投第９案,臺中市,南屯區,春安里,773,814,347,111,458,62,520
公投第９案,臺中市,南屯區,文山里,774,1436,572,157,729,61,790
公投第９案,臺中市,南屯區,文山里,775,1515,657,189,846,59,905
公投第９案,臺中市,南屯區,文山里,776,1545,572,148,720,81,801
公投第９案,臺中市,南屯區,文山里,777,1383,626,151,777,37,814
公投第９案,臺中市,南屯區,文山里,778,1433,667,155,822,39,861
公投第９案,臺中市,南屯區,文山里,779,1134,457,137,594,28,622
公投第９案,臺中市,南屯區,文山里,780,1216,585,138,723,39,762
公投第９案,臺中市,南屯區,寶山里,781,1271,510,154,664,71,735
公投第９案,臺中市,南屯區,寶山里,782,1203,522,116,638,24,662
公投第９案,臺中市,南屯區,寶山里,783,1268,552,158,710,33,743
公投第９案,臺中市,南屯區,寶山里,784,1390,608,176,784,50,834
公投第９案,臺中市,南屯區,新生里,785,1397,522,238,760,50,810
公投第９案,臺中市,南屯區,永定里,786,1607,646,208,854,71,925
公投第９案,臺中市,南屯區,永定里,787,1582,720,176,896,48,944
公投第９案,臺中市,南屯區,永定里,788,1611,743,176,919,49,968
公投第９案,臺中市,南屯區,三厝里,789,1322,616,179,795,46,841
公投第９案,臺中市,南屯區,三厝里,790,1321,641,178,819,38,857
公投第９案,臺中市,南屯區,三厝里,791,1360,622,145,767,45,812
公投第９案,臺中市,南屯區,三厝里,792,1361,631,171,802,15,817
公投第９案,臺中市,南屯區,三厝里,793,1257,570,176,746,40,786
公投第９案,臺中市,南屯區,三義里,794,1207,612,142,754,27,781
公投第９案,臺中市,南屯區,三義里,795,1282,640,138,778,34,812
公投第９案,臺中市,南屯區,三義里,796,1248,637,152,789,30,819
公投第９案,臺中市,南屯區,三義里,797,1304,629,183,812,40,852
公投第９案,臺中市,南屯區,三義里,798,1214,566,146,712,31,743
公投第９案,臺中市,南屯區,三和里,799,1102,536,129,665,50,715
公投第９案,臺中市,南屯區,三和里,800,1630,847,174,1021,37,1058
公投第９案,臺中市,南屯區,三和里,801,1333,635,156,791,41,832
公投第９案,臺中市,南屯區,三和里,802,1292,611,167,778,36,814
公投第９案,臺中市,南屯區,三和里,803,1272,602,144,746,40,786
公投第９案,臺中市,南屯區,三和里,804,1345,652,134,786,38,824
公投第９案,臺中市,南屯區,黎明里,805,981,494,137,631,59,690
公投第９案,臺中市,南屯區,黎明里,806,1097,532,121,653,53,706
公投第９案,臺中市,南屯區,黎明里,807,991,506,116,622,25,647
公投第９案,臺中市,南屯區,黎明里,808,1170,540,150,690,23,713
公投第９案,臺中市,南屯區,溝墘里,809,1171,552,166,718,33,751
公投第９案,臺中市,南屯區,溝墘里,810,1349,575,178,753,56,809
公投第９案,臺中市,南屯區,溝墘里,811,1368,657,184,841,33,874
公投第９案,臺中市,南屯區,溝墘里,812,1263,641,135,776,42,818
公投第９案,臺中市,南屯區,大業里,813,1547,705,216,921,41,962
公投第９案,臺中市,南屯區,大業里,814,1649,714,219,933,53,986
公投第９案,臺中市,南屯區,大業里,815,1629,706,174,880,36,916
公投第９案,臺中市,南屯區,大業里,816,1580,621,190,811,43,854
公投第９案,臺中市,南屯區,惠中里,817,1444,745,166,911,36,947
公投第９案,臺中市,南屯區,惠中里,818,1413,654,137,791,25,816
公投第９案,臺中市,南屯區,惠中里,819,1377,625,146,771,38,809
公投第９案,臺中市,南屯區,惠中里,820,1527,658,229,887,44,931
公投第９案,臺中市,南屯區,惠中里,821,1335,618,171,789,52,841
公投第９案,臺中市,南屯區,田心里,822,1544,781,209,990,44,1034
公投第９案,臺中市,南屯區,田心里,823,1482,682,253,935,47,982
公投第９案,臺中市,南屯區,田心里,824,1488,663,197,860,68,928
公投第９案,臺中市,南屯區,田心里,825,1538,602,168,770,45,815
公投第９案,臺中市,南屯區,向心里,826,1674,773,209,982,74,1056
公投第９案,臺中市,南屯區,向心里,827,1996,645,181,826,36,862
公投第９案,臺中市,南屯區,向心里,828,1514,681,176,857,65,922
公投第９案,臺中市,南屯區,文心里,829,1217,599,133,732,51,783
公投第９案,臺中市,南屯區,文心里,830,1347,589,161,750,53,803
公投第９案,臺中市,南屯區,文心里,831,1109,517,127,644,34,678
公投第９案,臺中市,南屯區,同心里,832,1546,701,157,858,37,895
公投第９案,臺中市,南屯區,同心里,833,1408,701,168,869,39,908
公投第９案,臺中市,南屯區,同心里,834,1057,448,113,561,20,581
公投第９案,臺中市,南屯區,同心里,835,1133,485,158,643,50,693
公投第９案,臺中市,南屯區,大同里,836,1278,588,151,739,27,766
公投第９案,臺中市,南屯區,大同里,837,1144,557,151,708,46,754
公投第９案,臺中市,南屯區,大同里,838,1140,508,160,668,32,700
公投第９案,臺中市,南屯區,大同里,839,1171,547,153,700,42,742
公投第９案,臺中市,南屯區,大興里,840,1303,614,181,795,42,837
公投第９案,臺中市,南屯區,大興里,841,1402,590,143,733,43,776
公投第９案,臺中市,南屯區,大興里,842,1571,688,179,867,49,916
公投第９案,臺中市,南屯區,大誠里,843,1139,524,168,692,42,734
公投第９案,臺中市,南屯區,大誠里,844,1216,563,163,726,54,780
公投第９案,臺中市,南屯區,大誠里,845,1162,568,133,701,35,736
公投第９案,臺中市,北屯區,北屯里,846,1670,784,193,977,61,1038
公投第９案,臺中市,北屯區,北屯里,847,1706,700,179,879,57,936
公投第９案,臺中市,北屯區,北京里,848,1507,616,171,787,76,863
公投第９案,臺中市,北屯區,北京里,849,1652,723,207,930,55,985
公投第９案,臺中市,北屯區,北興里,850,1107,462,108,570,17,587
公投第９案,臺中市,北屯區,北興里,851,2151,850,216,1066,90,1156
公投第９案,臺中市,北屯區,三光里,852,1612,751,174,925,28,953
公投第９案,臺中市,北屯區,三光里,853,1743,743,186,929,46,975
公投第９案,臺中市,北屯區,三光里,854,2099,817,201,1018,55,1073
公投第９案,臺中市,北屯區,三光里,855,1595,692,163,855,32,887
公投第９案,臺中市,北屯區,三和里,856,1923,763,189,952,64,1016
公投第９案,臺中市,北屯區,三和里,857,1641,688,152,840,64,904
公投第９案,臺中市,北屯區,三和里,858,1157,572,124,696,36,732
公投第９案,臺中市,北屯區,三和里,859,1041,514,110,624,40,664
公投第９案,臺中市,北屯區,東光里,860,1563,641,159,800,48,848
公投第９案,臺中市,北屯區,東光里,861,1559,633,151,784,56,840
公投第９案,臺中市,北屯區,東光里,862,1411,570,104,674,22,696
公投第９案,臺中市,北屯區,水景里,863,1761,831,159,990,39,1029
公投第９案,臺中市,北屯區,水景里,864,1361,634,156,790,66,856
公投第９案,臺中市,北屯區,水景里,865,1852,771,178,949,85,1034
公投第９案,臺中市,北屯區,水景里,866,1928,824,229,1053,53,1106
公投第９案,臺中市,北屯區,水景里,867,1492,756,164,920,39,959
公投第９案,臺中市,北屯區,水景里,868,1998,815,211,1026,69,1095
公投第９案,臺中市,北屯區,水景里,869,1272,643,144,787,40,827
公投第９案,臺中市,北屯區,水景里,870,1317,644,138,782,38,820
公投第９案,臺中市,北屯區,軍功里,871,1327,510,131,641,58,699
公投第９案,臺中市,北屯區,軍功里,872,1280,518,129,647,28,675
公投第９案,臺中市,北屯區,軍功里,873,1865,739,83,822,58,880
公投第９案,臺中市,北屯區,軍功里,874,1230,652,68,720,63,783
公投第９案,臺中市,北屯區,軍功里,875,1356,549,130,679,48,727
公投第９案,臺中市,北屯區,軍功里,876,1732,771,162,933,57,990
公投第９案,臺中市,北屯區,軍功里,877,1586,730,166,896,42,938
公投第９案,臺中市,北屯區,軍功里,878,1441,609,172,781,32,813
公投第９案,臺中市,北屯區,和平里,879,2045,907,119,1026,80,1106
公投第９案,臺中市,北屯區,和平里,880,1914,729,209,938,69,1007
公投第９案,臺中市,北屯區,和平里,881,1918,862,163,1025,50,1075
公投第９案,臺中市,北屯區,和平里,882,2079,890,164,1054,30,1084
公投第９案,臺中市,北屯區,和平里,883,2040,872,217,1089,58,1147
公投第９案,臺中市,北屯區,廍子里,884,2027,746,209,955,54,1009
公投第９案,臺中市,北屯區,廍子里,885,1402,597,144,741,46,787
公投第９案,臺中市,北屯區,廍子里,886,1826,805,195,1000,67,1067
公投第９案,臺中市,北屯區,廍子里,887,2162,1047,156,1203,40,1243
公投第９案,臺中市,北屯區,廍子里,888,2332,875,213,1088,26,1114
公投第９案,臺中市,北屯區,民政里,889,985,435,96,531,49,580
公投第９案,臺中市,北屯區,東山里,890,2037,742,196,938,54,992
公投第９案,臺中市,北屯區,大坑里,891,1032,465,124,589,40,629
公投第９案,臺中市,北屯區,大坑里,892,1062,469,104,573,45,618
公投第９案,臺中市,北屯區,民德里,893,909,377,84,461,61,522
公投第９案,臺中市,北屯區,舊社里,894,1445,646,167,813,54,867
公投第９案,臺中市,北屯區,舊社里,895,1842,755,191,946,37,983
公投第９案,臺中市,北屯區,舊社里,896,1187,536,133,669,46,715
公投第９案,臺中市,北屯區,舊社里,897,1456,636,153,789,52,841
公投第９案,臺中市,北屯區,松茂里,898,1866,885,127,1012,58,1070
公投第９案,臺中市,北屯區,松茂里,899,1667,695,151,846,56,902
公投第９案,臺中市,北屯區,松茂里,900,1683,753,169,922,32,954
公投第９案,臺中市,北屯區,松強里,901,1642,695,183,878,31,909
公投第９案,臺中市,北屯區,松強里,902,1475,646,179,825,23,848
公投第９案,臺中市,北屯區,松強里,903,1644,732,130,862,28,890
公投第９案,臺中市,北屯區,松強里,904,1603,766,157,923,28,951
公投第９案,臺中市,北屯區,松勇里,905,1949,891,196,1087,65,1152
公投第９案,臺中市,北屯區,松勇里,906,1790,900,200,1100,34,1134
公投第９案,臺中市,北屯區,松勇里,907,1440,631,176,807,42,849
公投第９案,臺中市,北屯區,松安里,908,1601,717,193,910,62,972
公投第９案,臺中市,北屯區,松安里,909,1527,646,151,797,59,856
公投第９案,臺中市,北屯區,松安里,910,1675,664,167,831,59,890
公投第９案,臺中市,北屯區,松和里,911,1579,583,150,733,49,782
公投第９案,臺中市,北屯區,松和里,912,1524,638,165,803,82,885
公投第９案,臺中市,北屯區,松和里,913,1677,695,168,863,53,916
公投第９案,臺中市,北屯區,松和里,914,1599,688,160,848,47,895
公投第９案,臺中市,北屯區,松竹里,915,1458,633,194,827,58,885
公投第９案,臺中市,北屯區,松竹里,916,1571,774,196,970,60,1030
公投第９案,臺中市,北屯區,松竹里,917,1579,642,217,859,79,938
公投第９案,臺中市,北屯區,松竹里,918,1849,845,197,1042,47,1089
公投第９案,臺中市,北屯區,松竹里,919,1682,744,175,919,44,963
公投第９案,臺中市,北屯區,平興里,920,1760,753,172,925,41,966
公投第９案,臺中市,北屯區,平興里,921,1699,727,197,924,66,990
公投第９案,臺中市,北屯區,平興里,922,1626,749,213,962,50,1012
公投第９案,臺中市,北屯區,平興里,923,1491,666,202,868,8,876
公投第９案,臺中市,北屯區,平田里,924,1640,687,187,874,34,908
公投第９案,臺中市,北屯區,平田里,925,2052,872,207,1079,58,1137
公投第９案,臺中市,北屯區,平田里,926,1875,820,196,1016,54,1070
公投第９案,臺中市,北屯區,平昌里,927,1559,655,161,816,32,848
公投第９案,臺中市,北屯區,平昌里,928,1480,640,164,804,77,881
公投第９案,臺中市,北屯區,平昌里,929,1397,576,190,766,63,829
公投第９案,臺中市,北屯區,平安里,930,1889,841,195,1036,53,1089
公投第９案,臺中市,北屯區,平安里,931,1728,693,203,896,70,966
公投第９案,臺中市,北屯區,平安里,932,1592,650,177,827,67,894
公投第９案,臺中市,北屯區,平順里,933,1656,659,186,845,72,917
公投第９案,臺中市,北屯區,平順里,934,1524,610,163,773,61,834
公投第９案,臺中市,北屯區,平心里,935,1502,628,202,830,43,873
公投第９案,臺中市,北屯區,平心里,936,1772,787,167,954,43,997
公投第９案,臺中市,北屯區,平心里,937,1461,655,163,818,55,873
公投第９案,臺中市,北屯區,平福里,938,1769,689,160,849,33,882
公投第９案,臺中市,北屯區,平福里,939,1894,812,249,1061,63,1124
公投第９案,臺中市,北屯區,平德里,940,2033,807,199,1006,60,1066
公投第９案,臺中市,北屯區,平德里,941,1947,803,214,1017,49,1066
公投第９案,臺中市,北屯區,平德里,942,2188,908,274,1182,73,1255
公投第９案,臺中市,北屯區,平和里,943,1661,757,187,944,64,1008
公投第９案,臺中市,北屯區,平和里,944,1667,715,208,923,43,966
公投第９案,臺中市,北屯區,平和里,945,1728,729,201,930,47,977
公投第９案,臺中市,北屯區,平陽里,946,1688,700,162,862,41,903
公投第９案,臺中市,北屯區,平陽里,947,1475,660,166,826,28,854
公投第９案,臺中市,北屯區,平陽里,948,1681,786,198,984,38,1022
公投第９案,臺中市,北屯區,仁和里,949,2078,965,197,1162,53,1215
公投第９案,臺中市,北屯區,仁和里,950,2059,902,206,1108,56,1164
公投第９案,臺中市,北屯區,仁和里,951,1792,806,171,977,43,1020
公投第９案,臺中市,北屯區,仁和里,952,2974,807,199,1006,38,1044
公投第９案,臺中市,北屯區,仁愛里,953,1072,465,111,576,53,629
公投第９案,臺中市,北屯區,仁美里,954,2099,926,203,1129,54,1183
公投第９案,臺中市,北屯區,仁美里,955,1823,896,230,1126,51,1177
公投第９案,臺中市,北屯區,仁美里,956,2022,938,220,1158,75,1233
公投第９案,臺中市,北屯區,仁美里,957,1992,893,204,1097,35,1132
公投第９案,臺中市,北屯區,四民里,958,1585,714,199,913,59,972
公投第９案,臺中市,北屯區,同榮里,959,1565,728,182,910,54,964
公投第９案,臺中市,北屯區,同榮里,960,1780,663,189,852,42,894
公投第９案,臺中市,北屯區,同榮里,961,1874,867,223,1090,57,1147
公投第９案,臺中市,北屯區,后庄里,962,1755,861,149,1010,38,1048
公投第９案,臺中市,北屯區,后庄里,963,1497,783,172,955,44,999
公投第９案,臺中市,北屯區,后庄里,964,1567,775,138,913,65,978
公投第９案,臺中市,北屯區,后庄里,965,1624,730,135,865,42,907
公投第９案,臺中市,北屯區,后庄里,966,1614,773,169,942,44,986
公投第９案,臺中市,北屯區,后庄里,967,1595,721,156,877,34,911
公投第９案,臺中市,北屯區,新平里,968,1782,701,186,887,67,954
公投第９案,臺中市,北屯區,新平里,969,1357,511,141,652,39,691
公投第９案,臺中市,北屯區,新平里,970,1071,456,113,569,57,626
公投第９案,臺中市,北屯區,陳平里,971,1372,548,158,706,52,758
公投第９案,臺中市,北屯區,陳平里,972,1415,630,160,790,59,849
公投第９案,臺中市,北屯區,陳平里,973,1789,834,195,1029,67,1096
公投第９案,臺中市,北屯區,忠平里,974,1907,915,206,1121,73,1194
公投第９案,臺中市,北屯區,忠平里,975,2008,909,217,1126,58,1184
公投第９案,臺中市,北屯區,大德里,976,1541,654,172,826,54,880
公投第９案,臺中市,北屯區,大德里,977,1669,746,196,942,50,992
公投第９案,臺中市,北屯區,大德里,978,1685,772,153,925,31,956
公投第９案,臺中市,北屯區,水湳里,979,1785,748,229,977,106,1083
公投第９案,臺中市,北屯區,水湳里,980,1596,726,183,909,70,979
公投第９案,臺中市,北屯區,水湳里,981,1731,756,225,981,66,1047
公投第９案,臺中市,北屯區,水湳里,982,1496,607,170,777,73,850
公投第９案,臺中市,北區,中正里,983,1437,550,175,725,34,759
公投第９案,臺中市,北區,六合里,984,1708,620,216,836,77,913
公投第９案,臺中市,北區,光大里,985,1051,403,103,506,37,543
公投第９案,臺中市,北區,光大里,986,996,421,124,545,38,583
公投第９案,臺中市,北區,文莊里,987,1504,700,132,832,31,863
公投第９案,臺中市,北區,文莊里,988,975,403,145,548,55,603
公投第９案,臺中市,北區,文莊里,989,886,388,99,487,35,522
公投第９案,臺中市,北區,大湖里,990,1276,433,105,538,35,573
公投第９案,臺中市,北區,大湖里,991,938,353,99,452,34,486
公投第９案,臺中市,北區,五常里,992,1404,550,147,697,71,768
公投第９案,臺中市,北區,錦平里,993,996,414,120,534,20,554
公投第９案,臺中市,北區,錦平里,994,869,312,126,438,56,494
公投第９案,臺中市,北區,新北里,995,704,332,80,412,20,432
公投第９案,臺中市,北區,新北里,996,979,386,107,493,28,521
公投第９案,臺中市,北區,新興里,997,773,310,78,388,16,404
公投第９案,臺中市,北區,新興里,998,759,354,78,432,20,452
公投第９案,臺中市,北區,樂英里,999,1438,687,114,801,46,847
公投第９案,臺中市,北區,樂英里,1000,1212,506,96,602,22,624
公投第９案,臺中市,北區,錦村里,1001,1731,711,193,904,45,949
公投第９案,臺中市,北區,錦村里,1002,1445,667,186,853,41,894
公投第９案,臺中市,北區,建成里,1003,1855,755,217,972,51,1023
公投第９案,臺中市,北區,建成里,1004,1728,653,160,813,59,872
公投第９案,臺中市,北區,建成里,1005,1878,768,155,923,44,967
公投第９案,臺中市,北區,建德里,1006,1793,668,186,854,81,935
公投第９案,臺中市,北區,建德里,1007,1555,868,12,880,19,899
公投第９案,臺中市,北區,錦洲里,1008,1761,660,168,828,30,858
公投第９案,臺中市,北區,錦洲里,1009,1579,676,151,827,39,866
公投第９案,臺中市,北區,錦祥里,1010,2192,854,241,1095,86,1181
公投第９案,臺中市,北區,錦祥里,1011,1560,670,196,866,64,930
公投第９案,臺中市,北區,金華里,1012,1476,643,160,803,46,849
公投第９案,臺中市,北區,金華里,1013,1006,482,115,597,27,624
公投第９案,臺中市,北區,金龍里,1014,1403,628,136,764,37,801
公投第９案,臺中市,北區,金龍里,1015,1446,604,133,737,25,762
公投第９案,臺中市,北區,金龍里,1016,1460,591,174,765,50,815
公投第９案,臺中市,北區,邱厝里,1017,1233,524,143,667,21,688
公投第９案,臺中市,北區,邱厝里,1018,1027,497,148,645,26,671
公投第９案,臺中市,北區,建興里,1019,1207,541,131,672,19,691
公投第９案,臺中市,北區,建興里,1020,1167,523,152,675,38,713
公投第９案,臺中市,北區,建興里,1021,1150,478,142,620,24,644
公投第９案,臺中市,北區,建興里,1022,1061,473,122,595,33,628
公投第９案,臺中市,北區,建興里,1023,1005,426,134,560,31,591
公投第９案,臺中市,北區,頂厝里,1024,1250,516,160,676,18,694
公投第９案,臺中市,北區,頂厝里,1025,1448,624,174,798,56,854
公投第９案,臺中市,北區,頂厝里,1026,1379,616,164,780,52,832
公投第９案,臺中市,北區,崇德里,1027,1652,722,180,902,55,957
公投第９案,臺中市,北區,崇德里,1028,1867,769,202,971,40,1011
公投第９案,臺中市,北區,賴厝里,1029,2078,412,112,524,24,548
公投第９案,臺中市,北區,賴厝里,1030,1562,716,185,901,44,945
公投第９案,臺中市,北區,賴厝里,1031,1430,650,137,787,36,823
公投第９案,臺中市,北區,賴福里,1032,2018,864,250,1114,44,1158
公投第９案,臺中市,北區,賴福里,1033,1710,657,177,834,28,862
公投第９案,臺中市,北區,賴興里,1034,1432,610,145,755,32,787
公投第９案,臺中市,北區,賴興里,1035,1157,555,125,680,26,706
公投第９案,臺中市,北區,賴興里,1036,1188,523,122,645,40,685
公投第９案,臺中市,北區,賴旺里,1037,1419,589,169,758,38,796
公投第９案,臺中市,北區,賴旺里,1038,1653,676,170,846,31,877
公投第９案,臺中市,北區,賴旺里,1039,1233,532,155,687,45,732
公投第９案,臺中市,北區,賴明里,1040,1243,543,145,688,26,714
公投第９案,臺中市,北區,賴明里,1041,1219,491,126,617,23,640
公投第９案,臺中市,北區,賴明里,1042,1272,544,170,714,45,759
公投第９案,臺中市,北區,梅川里,1043,1285,571,139,710,26,736
公投第９案,臺中市,北區,梅川里,1044,1780,751,221,972,39,1011
公投第９案,臺中市,北區,賴村里,1045,1461,571,146,717,28,745
公投第９案,臺中市,北區,賴村里,1046,1310,628,157,785,28,813
公投第９案,臺中市,北區,賴村里,1047,1669,710,157,867,31,898
公投第９案,臺中市,北區,育德里,1048,1932,827,217,1044,72,1116
公投第９案,臺中市,北區,育德里,1049,1682,703,200,903,29,932
公投第９案,臺中市,北區,淡溝里,1050,1891,702,253,955,29,984
公投第９案,臺中市,北區,淡溝里,1051,1882,794,200,994,71,1065
公投第９案,臺中市,北區,淡溝里,1052,1159,497,126,623,27,650
公投第９案,臺中市,北區,健行里,1053,1553,643,174,817,55,872
公投第９案,臺中市,北區,健行里,1054,1607,639,203,842,41,883
公投第９案,臺中市,北區,健行里,1055,1773,718,232,950,43,993
公投第９案,臺中市,北區,健行里,1056,1524,647,180,827,54,881
公投第９案,臺中市,北區,明德里,1057,1613,725,214,939,61,1000
公投第９案,臺中市,北區,明德里,1058,1877,837,199,1036,47,1083
公投第９案,臺中市,北區,明德里,1059,1792,749,218,967,65,1032
公投第９案,臺中市,北區,明新里,1060,1392,615,163,778,46,824
公投第９案,臺中市,北區,明新里,1061,1297,543,149,692,31,723
公投第９案,臺中市,北區,長青里,1062,1556,677,216,893,40,933
公投第９案,臺中市,北區,長青里,1063,1497,596,205,801,23,824
公投第９案,臺中市,北區,長青里,1064,1550,652,162,814,50,864
公投第９案,臺中市,北區,長青里,1065,1434,493,166,659,32,691
公投第９案,臺中市,北區,立人里,1066,1793,771,206,977,61,1038
公投第９案,臺中市,北區,立人里,1067,1866,775,232,1007,37,1044
公投第９案,臺中市,北區,中達里,1068,1346,578,156,734,64,798
公投第９案,臺中市,北區,中達里,1069,1267,536,135,671,58,729
公投第９案,臺中市,中區,綠川里,1070,1652,729,210,939,69,1008
公投第９案,臺中市,中區,繼光里,1071,1531,600,210,810,58,868
公投第９案,臺中市,中區,公園里,1072,1431,562,197,759,32,791
公投第９案,臺中市,中區,光復里,1073,1060,450,124,574,43,617
公投第９案,臺中市,中區,光復里,1074,982,382,115,497,51,548
公投第９案,臺中市,中區,大墩里,1075,1191,468,164,632,54,686
公投第９案,臺中市,中區,大墩里,1076,855,332,117,449,38,487
公投第９案,臺中市,中區,柳川里,1077,1135,384,119,503,28,531
公投第９案,臺中市,中區,柳川里,1078,705,287,91,378,18,396
公投第９案,臺中市,中區,大誠里,1079,1009,449,116,565,29,594
公投第９案,臺中市,中區,大誠里,1080,1304,498,168,666,70,736
公投第９案,臺中市,中區,中華里,1081,1841,650,192,842,36,878
公投第９案,臺中市,西區,三民里,1082,1400,393,88,481,32,513
公投第９案,臺中市,西區,三民里,1083,861,400,125,525,20,545
公投第９案,臺中市,西區,利民里,1084,1416,636,167,803,45,848
公投第９案,臺中市,西區,民生里,1085,1020,453,141,594,42,636
公投第９案,臺中市,西區,民生里,1086,778,370,115,485,28,513
公投第９案,臺中市,西區,廣民里,1087,1465,586,162,748,51,799
公投第９案,臺中市,西區,平和里,1088,1017,446,126,572,18,590
公投第９案,臺中市,西區,平和里,1089,868,392,115,507,21,528
公投第９案,臺中市,西區,東昇里,1090,1251,584,174,758,47,805
公投第９案,臺中市,西區,東昇里,1091,1044,490,153,643,42,685
公投第９案,臺中市,西區,公民里,1092,1487,630,184,814,39,853
公投第９案,臺中市,西區,公民里,1093,1573,668,188,856,51,907
公投第９案,臺中市,西區,公民里,1094,1731,759,214,973,59,1032
公投第９案,臺中市,西區,藍興里,1095,1209,551,142,693,27,720
公投第９案,臺中市,西區,藍興里,1096,1564,673,174,847,41,888
公投第９案,臺中市,西區,藍興里,1097,1175,534,145,679,40,719
公投第９案,臺中市,西區,公舘里,1098,1505,634,175,809,33,842
公投第９案,臺中市,西區,公舘里,1099,1418,629,181,810,38,848
公投第９案,臺中市,西區,公舘里,1100,1497,530,134,664,15,679
公投第９案,臺中市,西區,公舘里,1101,1260,545,169,714,40,754
公投第９案,臺中市,西區,安龍里,1102,1399,596,201,797,53,850
公投第９案,臺中市,西區,安龍里,1103,1447,597,183,780,41,821
公投第９案,臺中市,西區,吉龍里,1104,1683,711,220,931,58,989
公投第９案,臺中市,西區,吉龍里,1105,1585,694,190,884,60,944
公投第９案,臺中市,西區,吉龍里,1106,1557,681,204,885,43,928
公投第９案,臺中市,西區,吉龍里,1107,1663,672,181,853,51,904
公投第９案,臺中市,西區,土庫里,1108,1921,791,274,1065,57,1122
公投第９案,臺中市,西區,土庫里,1109,1952,739,224,963,52,1015
公投第９案,臺中市,西區,土庫里,1110,1708,700,206,906,47,953
公投第９案,臺中市,西區,大忠里,1111,1131,555,136,691,20,711
公投第９案,臺中市,西區,大忠里,1112,1916,798,207,1005,40,1045
公投第９案,臺中市,西區,大忠里,1113,1275,577,174,751,23,774
公投第９案,臺中市,西區,民龍里,1114,1822,711,181,892,54,946
公投第９案,臺中市,西區,民龍里,1115,1374,598,176,774,34,808
公投第９案,臺中市,西區,和龍里,1116,1129,432,153,585,69,654
公投第９案,臺中市,西區,和龍里,1117,1201,476,157,633,32,665
公投第９案,臺中市,西區,後龍里,1118,1639,660,204,864,68,932
公投第９案,臺中市,西區,後龍里,1119,1863,768,250,1018,72,1090
公投第９案,臺中市,西區,双龍里,1120,1287,643,145,788,33,821
公投第９案,臺中市,西區,双龍里,1121,1504,661,204,865,48,913
公投第９案,臺中市,西區,昇平里,1122,1308,544,177,721,43,764
公投第９案,臺中市,西區,昇平里,1123,1433,621,156,777,63,840
公投第９案,臺中市,西區,昇平里,1124,1450,591,190,781,37,818
公投第９案,臺中市,西區,昇平里,1125,1465,695,179,874,48,922
公投第９案,臺中市,西區,中興里,1126,1818,690,234,924,66,990
公投第９案,臺中市,西區,中興里,1127,1782,695,279,974,56,1030
公投第９案,臺中市,西區,公益里,1128,1428,583,218,801,54,855
公投第９案,臺中市,西區,公益里,1129,1366,531,154,685,41,726
公投第９案,臺中市,西區,公德里,1130,1498,626,179,805,38,843
公投第９案,臺中市,西區,公德里,1131,1350,632,142,774,45,819
公投第９案,臺中市,西區,公德里,1132,1339,640,138,778,25,803
公投第９案,臺中市,西區,公正里,1133,1613,733,183,916,44,960
公投第９案,臺中市,西區,公正里,1134,1454,633,166,799,49,848
公投第９案,臺中市,西區,公正里,1135,1597,708,210,918,33,951
公投第９案,臺中市,西區,公正里,1136,1411,667,177,844,49,893
公投第９案,臺中市,西區,公平里,1137,1493,635,185,820,62,882
公投第９案,臺中市,西區,公平里,1138,1600,746,189,935,42,977
公投第９案,臺中市,西區,公平里,1139,1710,698,212,910,57,967
公投第９案,臺中市,西區,忠明里,1140,1139,491,152,643,35,678
公投第９案,臺中市,西區,忠明里,1141,1105,493,143,636,39,675
公投第９案,臺中市,西區,忠明里,1142,1498,631,179,810,47,857
公投第９案,臺中市,西區,忠明里,1143,1921,691,213,904,39,943
公投第９案,臺中市,西區,忠誠里,1144,1340,535,192,727,58,785
公投第９案,臺中市,西區,忠誠里,1145,1536,684,207,891,33,924
公投第９案,臺中市,西區,忠誠里,1146,1361,536,193,729,76,805
公投第９案,臺中市,西區,忠誠里,1147,1430,693,176,869,28,897
公投第９案,臺中市,東區,新庄里,1148,1138,307,107,414,25,439
公投第９案,臺中市,東區,新庄里,1149,984,428,111,539,20,559
公投第９案,臺中市,東區,新庄里,1150,877,381,105,486,37,523
公投第９案,臺中市,東區,振興里,1151,1070,474,145,619,54,673
公投第９案,臺中市,東區,振興里,1152,1106,483,155,638,45,683
公投第９案,臺中市,東區,振興里,1153,953,384,139,523,54,577
公投第９案,臺中市,東區,東橋里,1154,1195,531,137,668,31,699
公投第９案,臺中市,東區,東橋里,1155,1251,518,136,654,55,709
公投第９案,臺中市,東區,東橋里,1156,1190,445,172,617,51,668
公投第９案,臺中市,東區,東興里,1157,1394,560,170,730,60,790
公投第９案,臺中市,東區,東興里,1158,1443,612,197,809,63,872
公投第９案,臺中市,東區,泉源里,1159,762,310,86,396,45,441
公投第９案,臺中市,東區,泉源里,1160,1140,533,141,674,49,723
公投第９案,臺中市,東區,干城里,1161,1211,481,204,685,69,754
公投第９案,臺中市,東區,干城里,1162,755,376,81,457,24,481
公投第９案,臺中市,東區,旱溪里,1163,1491,585,185,770,65,835
公投第９案,臺中市,東區,旱溪里,1164,1000,375,127,502,30,532
公投第９案,臺中市,東區,樂成里,1165,1114,449,171,620,58,678
公投第９案,臺中市,東區,樂成里,1166,1101,441,136,577,39,616
公投第９案,臺中市,東區,東門里,1167,1169,535,163,698,62,760
公投第９案,臺中市,東區,東門里,1168,1283,575,164,739,68,807
公投第９案,臺中市,東區,東門里,1169,1168,557,139,696,40,736
公投第９案,臺中市,東區,東門里,1170,1386,539,178,717,37,754
公投第９案,臺中市,東區,東門里,1171,1557,706,182,888,52,940
公投第９案,臺中市,東區,十甲里,1172,1380,547,200,747,67,814
公投第９案,臺中市,東區,十甲里,1173,1674,688,205,893,47,940
公投第９案,臺中市,東區,十甲里,1174,1604,764,190,954,43,997
公投第９案,臺中市,東區,東英里,1175,1815,815,228,1043,49,1092
公投第９案,臺中市,東區,東英里,1176,1700,698,190,888,57,945
公投第９案,臺中市,東區,東英里,1177,1592,668,182,850,59,909
公投第９案,臺中市,東區,東英里,1178,1850,732,214,946,72,1018
公投第９案,臺中市,東區,東南里,1179,1252,588,122,710,39,749
公投第９案,臺中市,東區,東南里,1180,1250,577,169,746,45,791
公投第９案,臺中市,東區,東南里,1181,1241,572,130,702,46,748
公投第９案,臺中市,東區,東勢里,1182,1318,496,165,661,46,707
公投第９案,臺中市,東區,東勢里,1183,1288,515,151,666,66,732
公投第９案,臺中市,東區,合作里,1184,1442,644,163,807,86,893
公投第９案,臺中市,東區,合作里,1185,1202,539,134,673,45,718
公投第９案,臺中市,東區,合作里,1186,1452,674,130,804,54,858
公投第９案,臺中市,東區,富仁里,1187,1480,636,150,786,40,826
公投第９案,臺中市,東區,富仁里,1188,1736,801,138,939,44,983
公投第９案,臺中市,東區,富仁里,1189,867,338,112,450,46,496
公投第９案,臺中市,東區,富台里,1190,1693,694,137,831,48,879
公投第９案,臺中市,東區,東信里,1191,1538,703,161,864,72,936
公投第９案,臺中市,東區,東信里,1192,1593,651,248,899,104,1003
公投第９案,臺中市,東區,東信里,1193,1481,620,165,785,23,808
公投第９案,臺中市,東區,東信里,1194,1414,668,150,818,46,864
公投第９案,臺中市,東區,東信里,1195,1297,541,131,672,46,718
公投第９案,臺中市,東區,東信里,1196,1394,568,199,767,65,832
公投第９案,臺中市,南區,長春里,1197,937,409,122,531,41,572
公投第９案,臺中市,南區,長春里,1198,1001,463,146,609,47,656
公投第９案,臺中市,南區,長榮里,1199,1249,598,157,755,66,821
公投第９案,臺中市,南區,長榮里,1200,1202,602,165,767,51,818
公投第９案,臺中市,南區,城隍里,1201,1130,497,139,636,78,714
公投第９案,臺中市,南區,城隍里,1202,1239,543,172,715,68,783
公投第９案,臺中市,南區,城隍里,1203,1238,508,161,669,58,727
公投第９案,臺中市,南區,國光里,1204,1272,551,177,728,60,788
公投第９案,臺中市,南區,國光里,1205,1273,554,166,720,46,766
公投第９案,臺中市,南區,國光里,1206,1317,539,195,734,72,806
公投第９案,臺中市,南區,南門里,1207,1160,577,170,747,42,789
公投第９案,臺中市,南區,南門里,1208,1205,541,184,725,60,785
公投第９案,臺中市,南區,南門里,1209,1111,486,149,635,46,681
公投第９案,臺中市,南區,德義里,1210,1407,661,210,871,58,929
公投第９案,臺中市,南區,德義里,1211,1419,615,188,803,51,854
公投第９案,臺中市,南區,積善里,1212,1157,520,152,672,61,733
公投第９案,臺中市,南區,積善里,1213,1415,619,142,761,40,801
公投第９案,臺中市,南區,江川里,1214,1289,608,177,785,64,849
公投第９案,臺中市,南區,江川里,1215,1454,620,201,821,55,876
公投第９案,臺中市,南區,新榮里,1216,1491,648,142,790,62,852
公投第９案,臺中市,南區,新榮里,1217,1394,640,161,801,27,828
公投第９案,臺中市,南區,新榮里,1218,1430,632,176,808,52,860
公投第９案,臺中市,南區,福興里,1219,1342,578,148,726,110,836
公投第９案,臺中市,南區,福興里,1220,1304,588,205,793,91,884
公投第９案,臺中市,南區,福興里,1221,1190,541,162,703,42,745
公投第９案,臺中市,南區,福平里,1222,1273,564,140,704,57,761
公投第９案,臺中市,南區,福平里,1223,1387,661,176,837,67,904
公投第９案,臺中市,南區,福平里,1224,1356,566,189,755,55,810
公投第９案,臺中市,南區,福平里,1225,1304,600,156,756,59,815
公投第９案,臺中市,南區,福順里,1226,1256,614,155,769,30,799
公投第９案,臺中市,南區,福順里,1227,1364,656,186,842,36,878
公投第９案,臺中市,南區,福順里,1228,1361,573,198,771,76,847
公投第９案,臺中市,南區,福順里,1229,1407,689,161,850,22,872
公投第９案,臺中市,南區,和平里,1230,1308,568,175,743,55,798
公投第９案,臺中市,南區,和平里,1231,1250,546,150,696,33,729
公投第９案,臺中市,南區,和平里,1232,1284,524,173,697,43,740
公投第９案,臺中市,南區,平和里,1233,1175,542,145,687,66,753
公投第９案,臺中市,南區,平和里,1234,1158,570,156,726,41,767
公投第９案,臺中市,南區,平和里,1235,1168,499,149,648,63,711
公投第９案,臺中市,南區,南和里,1236,1626,795,185,980,56,1036
公投第９案,臺中市,南區,南和里,1237,2115,646,191,837,39,876
公投第９案,臺中市,南區,南和里,1238,1805,788,178,966,39,1005
公投第９案,臺中市,南區,南和里,1239,1695,723,191,914,34,948
公投第９案,臺中市,南區,永興里,1240,1643,793,201,994,50,1044
公投第９案,臺中市,南區,永興里,1241,1423,647,200,847,45,892
公投第９案,臺中市,南區,永興里,1242,1542,689,183,872,51,923
公投第９案,臺中市,南區,永興里,1243,1533,712,177,889,6,895
公投第９案,臺中市,南區,永興里,1244,1531,745,180,925,64,989
公投第９案,臺中市,南區,永和里,1245,1392,553,157,710,36,746
公投第９案,臺中市,南區,永和里,1246,1592,706,161,867,44,911
公投第９案,臺中市,南區,永和里,1247,1431,655,190,845,48,893
公投第９案,臺中市,南區,樹義里,1248,1799,749,195,944,43,987
公投第９案,臺中市,南區,樹義里,1249,1708,829,202,1031,53,1084
公投第９案,臺中市,南區,樹義里,1250,1700,727,193,920,56,976
公投第９案,臺中市,南區,樹義里,1251,1751,874,178,1052,35,1087
公投第９案,臺中市,南區,樹義里,1252,2109,968,247,1215,59,1274
公投第９案,臺中市,南區,樹義里,1253,1697,736,212,948,55,1003
公投第９案,臺中市,南區,工學里,1254,1456,646,166,812,53,865
公投第９案,臺中市,南區,工學里,1255,1726,840,254,1094,53,1147
公投第９案,臺中市,南區,工學里,1256,1723,841,182,1023,57,1080
公投第９案,臺中市,南區,工學里,1257,1569,740,178,918,55,973
公投第９案,臺中市,南區,樹德里,1258,1274,576,179,755,38,793
公投第９案,臺中市,南區,樹德里,1259,1390,716,157,873,42,915
公投第９案,臺中市,南區,樹德里,1260,1295,679,157,836,30,866
公投第９案,臺中市,南區,樹德里,1261,1312,592,148,740,70,810
公投第９案,臺中市,南區,樹德里,1262,1417,689,179,868,33,901
公投第９案,臺中市,南區,樹德里,1263,1230,673,136,809,43,852
公投第９案,臺中市,南區,西川里,1264,1308,546,177,723,58,781
公投第９案,臺中市,南區,西川里,1265,1467,584,208,792,86,878
公投第９案,臺中市,南區,西川里,1266,1399,646,160,806,48,854
公投第９案,臺中市,南區,崇倫里,1267,1207,517,153,670,61,731
公投第９案,臺中市,南區,崇倫里,1268,1317,573,154,727,50,777
公投第９案,臺中市,南區,崇倫里,1269,1563,673,196,869,43,912
公投第９案,臺中市,南區,崇倫里,1270,1221,583,147,730,38,768
公投第９案,臺中市,太平區,太平里,1271,1821,685,226,911,84,995
公投第９案,臺中市,太平區,太平里,1272,1680,631,163,794,46,840
公投第９案,臺中市,太平區,太平里,1273,1947,831,210,1041,87,1128
公投第９案,臺中市,太平區,長億里,1274,1910,819,229,1048,94,1142
公投第９案,臺中市,太平區,長億里,1275,1894,641,317,958,49,1007
公投第９案,臺中市,太平區,長億里,1276,1953,819,203,1022,58,1080
公投第９案,臺中市,太平區,永成里,1277,1846,776,205,981,74,1055
公投第９案,臺中市,太平區,永成里,1278,1493,663,165,828,48,876
公投第９案,臺中市,太平區,永成里,1279,1605,668,174,842,55,897
公投第９案,臺中市,太平區,永成里,1280,1619,740,170,910,35,945
公投第９案,臺中市,太平區,中平里,1281,2011,799,205,1004,77,1081
公投第９案,臺中市,太平區,中平里,1282,2056,822,196,1018,38,1056
公投第９案,臺中市,太平區,中政里,1283,1876,764,179,943,73,1016
公投第９案,臺中市,太平區,中政里,1284,1815,725,186,911,70,981
公投第９案,臺中市,太平區,平安里,1285,1281,505,154,659,49,708
公投第９案,臺中市,太平區,平安里,1286,1004,459,121,580,66,646
公投第９案,臺中市,太平區,中興里,1287,1886,824,240,1064,66,1130
公投第９案,臺中市,太平區,中興里,1288,1431,606,193,799,63,862
公投第９案,臺中市,太平區,永平里,1289,1930,776,202,978,73,1051
公投第９案,臺中市,太平區,永平里,1290,2164,807,236,1043,82,1125
公投第９案,臺中市,太平區,東平里,1291,2048,843,188,1031,80,1111
公投第９案,臺中市,太平區,東平里,1292,2035,819,203,1022,62,1084
公投第９案,臺中市,太平區,成功里,1293,1685,641,206,847,86,933
公投第９案,臺中市,太平區,成功里,1294,2185,769,217,986,89,1075
公投第９案,臺中市,太平區,東和里,1295,1176,463,125,588,26,614
公投第９案,臺中市,太平區,東和里,1296,1597,664,169,833,52,885
公投第９案,臺中市,太平區,建國里,1297,1378,528,145,673,79,752
公投第９案,臺中市,太平區,建國里,1298,1546,616,179,795,39,834
公投第９案,臺中市,太平區,建興里,1299,1890,701,182,883,110,993
公投第９案,臺中市,太平區,建興里,1300,1053,422,112,534,60,594
公投第９案,臺中市,太平區,坪林里,1301,1582,704,171,875,80,955
公投第９案,臺中市,太平區,坪林里,1302,1699,783,156,939,60,999
公投第９案,臺中市,太平區,大興里,1303,1493,579,165,744,66,810
公投第９案,臺中市,太平區,大興里,1304,1063,401,109,510,47,557
公投第９案,臺中市,太平區,勤益里,1305,1117,498,126,624,50,674
公投第９案,臺中市,太平區,勤益里,1306,1084,515,90,605,45,650
公投第９案,臺中市,太平區,光華里,1307,1776,696,161,857,43,900
公投第９案,臺中市,太平區,光華里,1308,1729,712,179,891,46,937
公投第９案,臺中市,太平區,光華里,1309,1658,606,134,740,65,805
公投第９案,臺中市,太平區,光明里,1310,2010,836,167,1003,64,1067
公投第９案,臺中市,太平區,光明里,1311,1752,707,171,878,77,955
公投第９案,臺中市,太平區,中山里,1312,1654,761,173,934,83,1017
公投第９案,臺中市,太平區,中山里,1313,1951,600,128,728,41,769
公投第９案,臺中市,太平區,豐年里,1314,2170,1009,253,1262,87,1349
公投第９案,臺中市,太平區,豐年里,1315,2231,991,285,1276,57,1333
公投第９案,臺中市,太平區,宜欣里,1316,1623,739,134,873,39,912
公投第９案,臺中市,太平區,宜欣里,1317,1548,564,145,709,55,764
公投第９案,臺中市,太平區,宜欣里,1318,1442,596,141,737,58,795
公投第９案,臺中市,太平區,宜欣里,1319,1501,519,159,678,43,721
公投第９案,臺中市,太平區,宜佳里,1320,2025,740,193,933,27,960
公投第９案,臺中市,太平區,宜佳里,1321,1885,740,179,919,64,983
公投第９案,臺中市,太平區,宜佳里,1322,2155,764,215,979,73,1052
公投第９案,臺中市,太平區,宜昌里,1323,1775,644,197,841,41,882
公投第９案,臺中市,太平區,宜昌里,1324,2021,677,176,853,80,933
公投第９案,臺中市,太平區,新坪里,1325,2075,917,216,1133,75,1208
公投第９案,臺中市,太平區,新坪里,1326,1723,677,172,849,56,905
公投第９案,臺中市,太平區,新坪里,1327,2049,897,184,1081,58,1139
公投第９案,臺中市,太平區,新坪里,1328,1415,596,153,749,25,774
公投第９案,臺中市,太平區,新吉里,1329,1778,741,190,931,44,975
公投第９案,臺中市,太平區,新吉里,1330,1706,663,190,853,54,907
公投第９案,臺中市,太平區,新吉里,1331,2090,847,221,1068,50,1118
公投第９案,臺中市,太平區,新城里,1332,2093,796,194,990,50,1040
公投第９案,臺中市,太平區,新城里,1333,1688,612,144,756,36,792
公投第９案,臺中市,太平區,新城里,1334,1488,589,128,717,36,753
公投第９案,臺中市,太平區,新光里,1335,1667,623,173,796,53,849
公投第９案,臺中市,太平區,新光里,1336,1793,755,187,942,71,1013
公投第９案,臺中市,太平區,新光里,1337,1903,866,160,1026,40,1066
公投第９案,臺中市,太平區,新光里,1338,1834,758,204,962,61,1023
公投第９案,臺中市,太平區,新興里,1339,1526,638,134,772,35,807
公投第９案,臺中市,太平區,新興里,1340,1483,743,141,884,28,912
公投第９案,臺中市,太平區,新興里,1341,1694,754,166,920,31,951
公投第９案,臺中市,太平區,新高里,1342,1952,739,189,928,48,976
公投第９案,臺中市,太平區,新高里,1343,1995,837,195,1032,40,1072
公投第９案,臺中市,太平區,新高里,1344,1311,598,140,738,23,761
公投第９案,臺中市,太平區,新高里,1345,1537,782,178,960,56,1016
公投第９案,臺中市,太平區,新福里,1346,1974,756,66,822,57,879
公投第９案,臺中市,太平區,新福里,1347,1828,769,205,974,46,1020
公投第９案,臺中市,太平區,新福里,1348,2191,826,201,1027,41,1068
公投第９案,臺中市,太平區,頭汴里,1349,1825,697,183,880,93,973
公投第９案,臺中市,太平區,聖和里,1350,1559,560,176,736,12,748
公投第９案,臺中市,太平區,東汴里,1351,1225,486,117,603,81,684
公投第９案,臺中市,太平區,興隆里,1352,1678,725,162,887,60,947
公投第９案,臺中市,太平區,興隆里,1353,1501,530,168,698,100,798
公投第９案,臺中市,太平區,福隆里,1354,1450,651,194,845,0,845
公投第９案,臺中市,太平區,福隆里,1355,2126,799,226,1025,80,1105
公投第９案,臺中市,太平區,黃竹里,1356,699,309,92,401,47,448
公投第９案,臺中市,太平區,光隆里,1357,1428,487,156,643,27,670
公投第９案,臺中市,太平區,光隆里,1358,1666,698,187,885,82,967
公投第９案,臺中市,太平區,永隆里,1359,1241,489,160,649,44,693
公投第９案,臺中市,太平區,永隆里,1360,1266,569,139,708,69,777
公投第９案,臺中市,太平區,德隆里,1361,1166,498,124,622,45,667
公投第９案,臺中市,太平區,德隆里,1362,1790,793,187,980,77,1057
公投第９案,臺中市,太平區,德隆里,1363,1754,583,175,758,51,809
公投第９案,臺中市,大里區,東湖里,1364,1614,628,175,803,48,851
公投第９案,臺中市,大里區,東湖里,1365,1599,608,158,766,37,803
公投第９案,臺中市,大里區,東湖里,1366,1715,640,176,816,57,873
公投第９案,臺中市,大里區,東湖里,1367,1264,548,129,677,27,704
公投第９案,臺中市,大里區,東湖里,1368,1416,572,123,695,45,740
公投第９案,臺中市,大里區,東湖里,1369,1188,512,107,619,33,652
公投第９案,臺中市,大里區,東湖里,1370,1359,522,138,660,59,719
公投第９案,臺中市,大里區,西湖里,1371,1457,615,170,785,58,843
公投第９案,臺中市,大里區,西湖里,1372,1403,602,174,776,52,828
公投第９案,臺中市,大里區,大里里,1373,1697,668,186,854,65,919
公投第９案,臺中市,大里區,大里里,1374,1811,738,245,983,100,1083
公投第９案,臺中市,大里區,新里里,1375,1830,725,207,932,57,989
公投第９案,臺中市,大里區,新里里,1376,2228,653,169,822,109,931
公投第９案,臺中市,大里區,新里里,1377,1997,841,200,1041,89,1130
公投第９案,臺中市,大里區,新里里,1378,2033,1030,228,1258,38,1296
公投第９案,臺中市,大里區,新里里,1379,1835,767,243,1010,43,1053
公投第９案,臺中市,大里區,國光里,1380,1268,542,141,683,36,719
公投第９案,臺中市,大里區,國光里,1381,1645,716,176,892,57,949
公投第９案,臺中市,大里區,國光里,1382,1561,744,130,874,40,914
公投第９案,臺中市,大里區,國光里,1383,1301,656,154,810,32,842
公投第９案,臺中市,大里區,樹王里,1384,1621,629,176,805,71,876
公投第９案,臺中市,大里區,樹王里,1385,1797,660,235,895,76,971
公投第９案,臺中市,大里區,祥興里,1386,1230,498,103,601,39,640
公投第９案,臺中市,大里區,祥興里,1387,1488,616,145,761,55,816
公投第９案,臺中市,大里區,祥興里,1388,1459,554,173,727,72,799
公投第９案,臺中市,大里區,祥興里,1389,1647,696,173,869,64,933
公投第９案,臺中市,大里區,祥興里,1390,1100,488,140,628,68,696
公投第９案,臺中市,大里區,內新里,1391,1410,603,157,760,47,807
公投第９案,臺中市,大里區,內新里,1392,1807,716,167,883,74,957
公投第９案,臺中市,大里區,內新里,1393,1331,541,146,687,62,749
公投第９案,臺中市,大里區,內新里,1394,1801,755,167,922,45,967
公投第９案,臺中市,大里區,內新里,1395,1909,763,160,923,44,967
公投第９案,臺中市,大里區,中新里,1396,1699,620,163,783,77,860
公投第９案,臺中市,大里區,中新里,1397,1627,704,170,874,69,943
公投第９案,臺中市,大里區,中新里,1398,1912,775,192,967,72,1039
公投第９案,臺中市,大里區,東昇里,1399,1753,690,173,863,77,940
公投第９案,臺中市,大里區,東昇里,1400,1602,667,161,828,49,877
公投第９案,臺中市,大里區,大元里,1401,1144,445,156,601,66,667
公投第９案,臺中市,大里區,大元里,1402,1655,689,102,791,71,862
公投第９案,臺中市,大里區,大元里,1403,1438,580,178,758,47,805
公投第９案,臺中市,大里區,夏田里,1404,1000,415,118,533,61,594
公投第９案,臺中市,大里區,仁化里,1405,1711,697,187,884,72,956
公投第９案,臺中市,大里區,仁化里,1406,1698,723,131,854,11,865
公投第９案,臺中市,大里區,仁化里,1407,1914,762,227,989,86,1075
公投第９案,臺中市,大里區,仁化里,1408,1465,630,160,790,41,831
公投第９案,臺中市,大里區,仁化里,1409,1581,652,180,832,71,903
公投第９案,臺中市,大里區,仁德里,1410,1509,665,158,823,78,901
公投第９案,臺中市,大里區,仁德里,1411,1570,642,145,787,34,821
公投第９案,臺中市,大里區,仁德里,1412,1425,625,171,796,43,839
公投第９案,臺中市,大里區,仁德里,1413,1384,601,159,760,58,818
公投第９案,臺中市,大里區,健民里,1414,1204,414,135,549,33,582
公投第９案,臺中市,大里區,健民里,1415,1761,650,151,801,49,850
公投第９案,臺中市,大里區,健民里,1416,1473,555,113,668,33,701
公投第９案,臺中市,大里區,塗城里,1417,1675,693,194,887,61,948
公投第９案,臺中市,大里區,塗城里,1418,1755,765,159,924,64,988
公投第９案,臺中市,大里區,塗城里,1419,1593,657,188,845,97,942
公投第９案,臺中市,大里區,塗城里,1420,1799,707,215,922,74,996
公投第９案,臺中市,大里區,塗城里,1421,1606,647,179,826,82,908
公投第９案,臺中市,大里區,東興里,1422,1875,752,178,930,54,984
公投第９案,臺中市,大里區,東興里,1423,1670,685,208,893,62,955
公投第９案,臺中市,大里區,東興里,1424,1898,734,217,951,61,1012
公投第９案,臺中市,大里區,東興里,1425,1679,628,202,830,42,872
公投第９案,臺中市,大里區,大明里,1426,1373,554,135,689,58,747
公投第９案,臺中市,大里區,大明里,1427,1299,538,151,689,63,752
公投第９案,臺中市,大里區,大明里,1428,1430,632,136,768,45,813
公投第９案,臺中市,大里區,永隆里,1429,1805,869,220,1089,49,1138
公投第９案,臺中市,大里區,永隆里,1430,1806,900,225,1125,35,1160
公投第９案,臺中市,大里區,永隆里,1431,1826,918,209,1127,62,1189
公投第９案,臺中市,大里區,永隆里,1432,1805,931,203,1134,38,1172
公投第９案,臺中市,大里區,永隆里,1433,1907,915,182,1097,54,1151
公投第９案,臺中市,大里區,日新里,1434,1103,525,126,651,44,695
公投第９案,臺中市,大里區,日新里,1435,1419,591,140,731,64,795
公投第９案,臺中市,大里區,日新里,1436,1434,576,140,716,74,790
公投第９案,臺中市,大里區,西榮里,1437,1875,687,162,849,39,888
公投第９案,臺中市,大里區,西榮里,1438,1862,733,215,948,53,1001
公投第９案,臺中市,大里區,西榮里,1439,1850,766,178,944,35,979
公投第９案,臺中市,大里區,長榮里,1440,1622,700,176,876,56,932
公投第９案,臺中市,大里區,長榮里,1441,1638,736,196,932,76,1008
公投第９案,臺中市,大里區,長榮里,1442,1633,697,232,929,88,1017
公投第９案,臺中市,大里區,長榮里,1443,1662,706,196,902,45,947
公投第９案,臺中市,大里區,長榮里,1444,1917,894,195,1089,40,1129
公投第９案,臺中市,大里區,金城里,1445,1701,637,178,815,77,892
公投第９案,臺中市,大里區,金城里,1446,1549,589,174,763,68,831
公投第９案,臺中市,大里區,金城里,1447,1567,684,176,860,64,924
公投第９案,臺中市,大里區,金城里,1448,1614,676,180,856,59,915
公投第９案,臺中市,大里區,金城里,1449,1811,750,207,957,83,1040
公投第９案,臺中市,大里區,金城里,1450,1336,165,540,705,48,753
公投第９案,臺中市,大里區,立仁里,1451,1759,771,173,944,54,998
公投第９案,臺中市,大里區,立仁里,1452,1783,682,187,869,72,941
公投第９案,臺中市,大里區,立仁里,1453,1736,622,182,804,79,883
公投第９案,臺中市,大里區,立德里,1454,1874,754,217,971,76,1047
公投第９案,臺中市,大里區,立德里,1455,1889,770,211,981,85,1066
公投第９案,臺中市,大里區,立德里,1456,1947,795,220,1015,50,1065
公投第９案,臺中市,大里區,立德里,1457,1938,846,225,1071,60,1131
公投第９案,臺中市,大里區,新仁里,1458,1836,772,174,946,81,1027
公投第９案,臺中市,大里區,新仁里,1459,1913,763,203,966,79,1045
公投第９案,臺中市,大里區,新仁里,1460,1913,730,205,935,77,1012
公投第９案,臺中市,大里區,新仁里,1461,1937,765,173,938,60,998
公投第９案,臺中市,大里區,瑞城里,1462,1508,637,144,781,40,821
公投第９案,臺中市,大里區,瑞城里,1463,1340,603,143,746,30,776
公投第９案,臺中市,大里區,瑞城里,1464,1656,730,180,910,60,970
公投第９案,臺中市,大里區,瑞城里,1465,1290,552,131,683,51,734
公投第９案,臺中市,大里區,瑞城里,1466,1655,685,190,875,47,922
公投第９案,臺中市,大里區,瑞城里,1467,1260,460,128,588,24,612
公投第９案,臺中市,大里區,瑞城里,1468,1247,548,150,698,45,743
公投第９案,臺中市,大里區,瑞城里,1469,1548,595,171,766,98,864
公投第９案,臺中市,霧峰區,桐林里,1470,1205,559,150,709,34,743
公投第９案,臺中市,霧峰區,吉峰里,1471,1620,666,200,866,51,917
公投第９案,臺中市,霧峰區,吉峰里,1472,1559,713,180,893,61,954
公投第９案,臺中市,霧峰區,吉峰里,1473,1660,702,191,893,61,954
公投第９案,臺中市,霧峰區,吉峰里,1474,1602,734,191,925,50,975
公投第９案,臺中市,霧峰區,吉峰里,1475,1325,547,136,683,45,728
公投第９案,臺中市,霧峰區,吉峰里,1476,1515,669,164,833,57,890
公投第９案,臺中市,霧峰區,甲寅里,1477,1561,623,181,804,75,879
公投第９案,臺中市,霧峰區,甲寅里,1478,1691,656,190,846,62,908
公投第９案,臺中市,霧峰區,甲寅里,1479,1486,607,169,776,51,827
公投第９案,臺中市,霧峰區,本鄉里,1480,975,423,134,557,55,612
公投第９案,臺中市,霧峰區,本鄉里,1481,1358,656,127,783,64,847
公投第９案,臺中市,霧峰區,中正里,1482,1141,569,151,720,32,752
公投第９案,臺中市,霧峰區,中正里,1483,855,412,92,504,60,564
公投第９案,臺中市,霧峰區,錦榮里,1484,1202,513,135,648,72,720
公投第９案,臺中市,霧峰區,萊園里,1485,1078,437,117,554,46,600
公投第９案,臺中市,霧峰區,本堂里,1486,1456,644,182,826,69,895
公投第９案,臺中市,霧峰區,本堂里,1487,1573,817,101,918,42,960
公投第９案,臺中市,霧峰區,本堂里,1488,1591,728,159,887,51,938
公投第９案,臺中市,霧峰區,本堂里,1489,1214,600,117,717,62,779
公投第９案,臺中市,霧峰區,北柳里,1490,1267,528,132,660,63,723
公投第９案,臺中市,霧峰區,北柳里,1491,1277,558,133,691,66,757
公投第９案,臺中市,霧峰區,北柳里,1492,1366,551,173,724,54,778
公投第９案,臺中市,霧峰區,南柳里,1493,994,487,155,642,44,686
公投第９案,臺中市,霧峰區,南柳里,1494,863,385,117,502,39,541
公投第９案,臺中市,霧峰區,四德里,1495,1274,510,170,680,50,730
公投第９案,臺中市,霧峰區,四德里,1496,1162,473,136,609,71,680
公投第９案,臺中市,霧峰區,五福里,1497,1252,543,151,694,83,777
公投第９案,臺中市,霧峰區,五福里,1498,1322,569,159,728,61,789
公投第９案,臺中市,霧峰區,丁台里,1499,1116,475,164,639,64,703
公投第９案,臺中市,霧峰區,丁台里,1500,1156,470,180,650,77,727
公投第９案,臺中市,霧峰區,北勢里,1501,1147,526,133,659,61,720
公投第９案,臺中市,霧峰區,北勢里,1502,928,452,123,575,53,628
公投第９案,臺中市,霧峰區,南勢里,1503,1296,527,145,672,56,728
公投第９案,臺中市,霧峰區,萬豐里,1504,1314,493,152,645,69,714
公投第９案,臺中市,霧峰區,萬豐里,1505,1328,578,159,737,72,809
公投第９案,臺中市,霧峰區,舊正里,1506,989,406,117,523,67,590
公投第９案,臺中市,霧峰區,舊正里,1507,1088,496,128,624,66,690
公投第９案,臺中市,霧峰區,坑口里,1508,1363,637,140,777,73,850
公投第９案,臺中市,霧峰區,坑口里,1509,1573,703,182,885,79,964
公投第９案,臺中市,霧峰區,峰谷里,1510,1117,457,130,587,62,649
公投第９案,臺中市,霧峰區,六股里,1511,1342,603,183,786,71,857
公投第９案,臺中市,霧峰區,六股里,1512,1024,456,157,613,70,683
公投第９案,臺中市,東勢區,慶福里,1513,1299,524,128,652,70,722
公投第９案,臺中市,東勢區,慶東里,1514,1007,386,122,508,55,563
公投第９案,臺中市,東勢區,慶東里,1515,859,323,96,419,60,479
公投第９案,臺中市,東勢區,上城里,1516,991,432,130,562,86,648
公投第９案,臺中市,東勢區,下城里,1517,863,340,73,413,25,438
公投第９案,臺中市,東勢區,詒福里,1518,1628,638,160,798,113,911
公投第９案,臺中市,東勢區,新盛里,1519,1335,493,150,643,56,699
公投第９案,臺中市,東勢區,新盛里,1520,1092,516,136,652,47,699
公投第９案,臺中市,東勢區,新盛里,1521,1050,488,132,620,49,669
公投第９案,臺中市,東勢區,新盛里,1522,1431,605,151,756,60,816
公投第９案,臺中市,東勢區,福隆里,1523,1372,632,138,770,55,825
公投第９案,臺中市,東勢區,福隆里,1524,1412,645,151,796,43,839
公投第９案,臺中市,東勢區,福隆里,1525,878,361,76,437,80,517
公投第９案,臺中市,東勢區,隆興里,1526,1475,511,152,663,87,750
公投第９案,臺中市,東勢區,中嵙里,1527,872,374,70,444,24,468
公投第９案,臺中市,東勢區,中嵙里,1528,1006,392,104,496,71,567
公投第９案,臺中市,東勢區,泰昌里,1529,1222,528,124,652,28,680
公投第９案,臺中市,東勢區,泰昌里,1530,1228,573,166,739,70,809
公投第９案,臺中市,東勢區,泰昌里,1531,1036,468,123,591,34,625
公投第９案,臺中市,東勢區,上新里,1532,977,435,128,563,24,587
公投第９案,臺中市,東勢區,廣興里,1533,1395,597,113,710,50,760
公投第９案,臺中市,東勢區,延平里,1534,1169,513,138,651,88,739
公投第９案,臺中市,東勢區,延平里,1535,1027,473,108,581,61,642
公投第９案,臺中市,東勢區,南平里,1536,984,442,106,548,35,583
公投第９案,臺中市,東勢區,南平里,1537,866,464,81,545,42,587
公投第９案,臺中市,東勢區,東安里,1538,1031,429,105,534,102,636
公投第９案,臺中市,東勢區,中寧里,1539,865,431,86,517,58,575
公投第９案,臺中市,東勢區,北興里,1540,1357,643,149,792,70,862
公投第９案,臺中市,東勢區,粵寧里,1541,736,344,77,421,30,451
公投第９案,臺中市,東勢區,粵寧里,1542,1314,566,147,713,57,770
公投第９案,臺中市,東勢區,下新里,1543,1677,608,191,799,109,908
公投第９案,臺中市,東勢區,東新里,1544,950,442,98,540,35,575
公投第９案,臺中市,東勢區,東新里,1545,1007,463,117,580,45,625
公投第９案,臺中市,東勢區,興隆里,1546,1214,388,177,565,55,620
公投第９案,臺中市,東勢區,茂興里,1547,907,367,118,485,32,517
公投第９案,臺中市,東勢區,茂興里,1548,902,366,86,452,46,498
公投第９案,臺中市,東勢區,泰興里,1549,720,231,76,307,12,319
公投第９案,臺中市,東勢區,埤頭里,1550,666,219,74,293,12,305
公投第９案,臺中市,東勢區,明正里,1551,1361,537,147,684,59,743
公投第９案,臺中市,石岡區,石岡里,1552,1244,530,154,684,47,731
公投第９案,臺中市,石岡區,萬安里,1553,1539,631,173,804,57,861
公投第９案,臺中市,石岡區,九房里,1554,1202,512,157,669,41,710
公投第９案,臺中市,石岡區,金星里,1555,1272,486,143,629,68,697
公投第９案,臺中市,石岡區,龍興里,1556,652,279,78,357,34,391
公投第９案,臺中市,石岡區,萬興里,1557,1457,691,184,875,81,956
公投第９案,臺中市,石岡區,梅子里,1558,1836,731,228,959,76,1035
公投第９案,臺中市,石岡區,土牛里,1559,1001,415,115,530,56,586
公投第９案,臺中市,石岡區,德興里,1560,1448,637,201,838,54,892
公投第９案,臺中市,石岡區,和盛里,1561,1229,550,143,693,71,764
公投第９案,臺中市,新社區,新社里,1562,1011,429,106,535,25,560
公投第９案,臺中市,新社區,新社里,1563,1195,503,134,637,39,676
公投第９案,臺中市,新社區,新社里,1564,1053,504,103,607,23,630
公投第９案,臺中市,新社區,復盛里,1565,961,291,91,382,21,403
公投第９案,臺中市,新社區,復盛里,1566,919,372,85,457,16,473
公投第９案,臺中市,新社區,中正里,1567,1367,622,151,773,64,837
公投第９案,臺中市,新社區,月湖里,1568,1010,369,115,484,41,525
公投第９案,臺中市,新社區,崑山里,1569,1169,388,117,505,53,558
公投第９案,臺中市,新社區,大南里,1570,989,387,121,508,55,563
公投第９案,臺中市,新社區,大南里,1571,894,377,70,447,21,468
公投第９案,臺中市,新社區,永源里,1572,1033,415,90,505,28,533
公投第９案,臺中市,新社區,永源里,1573,1058,335,70,405,32,437
公投第９案,臺中市,新社區,永源里,1574,845,301,84,385,17,402
公投第９案,臺中市,新社區,中興里,1575,576,285,74,359,33,392
公投第９案,臺中市,新社區,協成里,1576,1229,450,115,565,60,625
公投第９案,臺中市,新社區,協成里,1577,890,285,85,370,34,404
公投第９案,臺中市,新社區,協成里,1578,781,275,90,365,30,395
公投第９案,臺中市,新社區,東興里,1579,1244,505,113,618,61,679
公投第９案,臺中市,新社區,慶西里,1580,213,51,18,69,10,79
公投第９案,臺中市,新社區,慶西里,1581,676,216,66,282,27,309
公投第９案,臺中市,新社區,中和里,1582,585,201,56,257,22,279
公投第９案,臺中市,新社區,福興里,1583,938,399,80,479,44,523
公投第９案,臺中市,新社區,福興里,1584,224,91,15,106,4,110
公投第９案,臺中市,和平區,南勢里,1585,956,426,141,567,47,614
公投第９案,臺中市,和平區,南勢里,1586,963,459,107,566,57,623
公投第９案,臺中市,和平區,天輪里,1587,456,182,63,245,14,259
公投第９案,臺中市,和平區,博愛里,1588,1011,486,104,590,46,636
公投第９案,臺中市,和平區,博愛里,1589,636,275,75,350,22,372
公投第９案,臺中市,和平區,自由里,1590,270,90,30,120,8,128
公投第９案,臺中市,和平區,自由里,1591,460,280,49,329,28,357
公投第９案,臺中市,和平區,自由里,1592,321,185,45,230,12,242
公投第９案,臺中市,和平區,達觀里,1593,783,365,94,459,31,490
公投第９案,臺中市,和平區,達觀里,1594,336,139,44,183,17,200
公投第９案,臺中市,和平區,中坑里,1595,451,238,59,297,9,306
公投第９案,臺中市,和平區,梨山里,1596,366,130,41,171,20,191
公投第９案,臺中市,和平區,梨山里,1597,771,272,47,319,12,331
公投第９案,臺中市,和平區,梨山里,1598,574,239,51,290,28,318
公投第９案,臺中市,和平區,梨山里,1599,274,116,35,151,18,169
公投第９案,臺中市,和平區,平等里,1600,157,64,16,80,6,86
公投第９案,臺中市,和平區,平等里,1601,713,273,50,323,18,341
公投第９案,臺南市,後壁區,後壁里,1,743,284,86,370,56,426
公投第９案,臺南市,後壁區,後壁里,2,898,310,92,402,19,421
公投第９案,臺南市,後壁區,侯伯里,3,786,240,76,316,48,364
公投第９案,臺南市,後壁區,侯伯里,4,534,152,67,219,53,272
公投第９案,臺南市,後壁區,嘉苳里,5,1034,351,110,461,68,529
公投第９案,臺南市,後壁區,嘉苳里,6,232,49,39,88,18,106
公投第９案,臺南市,後壁區,土溝里,7,479,150,47,197,36,233
公投第９案,臺南市,後壁區,土溝里,8,837,252,86,338,28,366
公投第９案,臺南市,後壁區,上茄苳里,9,1085,290,87,377,34,411
公投第９案,臺南市,後壁區,上茄苳里,10,1157,281,85,366,19,385
公投第９案,臺南市,後壁區,菁豐里,11,755,270,58,328,56,384
公投第９案,臺南市,後壁區,菁豐里,12,458,173,47,220,28,248
公投第９案,臺南市,後壁區,菁寮里,13,371,122,25,147,25,172
公投第９案,臺南市,後壁區,菁寮里,14,676,205,68,273,51,324
公投第９案,臺南市,後壁區,菁寮里,15,428,123,35,158,32,190
公投第９案,臺南市,後壁區,新嘉里,16,547,144,38,182,13,195
公投第９案,臺南市,後壁區,新嘉里,17,455,130,57,187,44,231
公投第９案,臺南市,後壁區,長短樹里,18,984,250,81,331,70,401
公投第９案,臺南市,後壁區,長短樹里,19,483,131,44,175,34,209
公投第９案,臺南市,後壁區,長短樹里,20,536,151,42,193,30,223
公投第９案,臺南市,後壁區,竹新里,21,958,233,62,295,8,303
公投第９案,臺南市,後壁區,竹新里,22,441,172,49,221,33,254
公投第９案,臺南市,後壁區,新東里,23,677,211,80,291,68,359
公投第９案,臺南市,後壁區,新東里,24,996,332,111,443,76,519
公投第９案,臺南市,後壁區,頂安里,25,1255,391,102,493,31,524
公投第９案,臺南市,後壁區,長安里,26,678,216,52,268,18,286
公投第９案,臺南市,後壁區,長安里,27,553,146,44,190,9,199
公投第９案,臺南市,後壁區,福安里,28,616,151,38,189,16,205
公投第９案,臺南市,後壁區,福安里,29,1189,380,121,501,25,526
公投第９案,臺南市,白河區,白河里,30,1176,410,139,549,72,621
公投第９案,臺南市,白河區,白河里,31,546,199,52,251,17,268
公投第９案,臺南市,白河區,永安里,32,859,319,111,430,30,460
公投第９案,臺南市,白河區,永安里,33,946,367,109,476,38,514
公投第９案,臺南市,白河區,永安里,34,1116,386,124,510,37,547
公投第９案,臺南市,白河區,外角里,35,1397,357,109,466,29,495
公投第９案,臺南市,白河區,庄內里,36,756,197,60,257,20,277
公投第９案,臺南市,白河區,庄內里,37,871,294,77,371,51,422
公投第９案,臺南市,白河區,秀祐里,38,897,314,92,406,34,440
公投第９案,臺南市,白河區,河東里,39,784,165,57,222,39,261
公投第９案,臺南市,白河區,河東里,40,572,158,56,214,17,231
公投第９案,臺南市,白河區,虎山里,41,457,102,24,126,7,133
公投第９案,臺南市,白河區,大林里,42,600,150,36,186,10,196
公投第９案,臺南市,白河區,崁頭里,43,375,74,26,100,6,106
公投第９案,臺南市,白河區,六溪里,44,508,82,33,115,10,125
公投第９案,臺南市,白河區,關嶺里,45,631,123,44,167,11,178
公投第９案,臺南市,白河區,關嶺里,46,391,74,25,99,12,111
公投第９案,臺南市,白河區,仙草里,47,799,167,59,226,12,238
公投第９案,臺南市,白河區,仙草里,48,506,109,30,139,14,153
公投第９案,臺南市,白河區,詔豐里,49,832,220,81,301,24,325
公投第９案,臺南市,白河區,詔豐里,50,1179,344,146,490,32,522
公投第９案,臺南市,白河區,大竹里,51,744,165,59,224,9,233
公投第９案,臺南市,白河區,大竹里,52,699,183,53,236,14,250
公投第９案,臺南市,白河區,廣蓮里,53,633,147,55,202,8,210
公投第９案,臺南市,白河區,廣蓮里,54,859,290,113,403,55,458
公投第９案,臺南市,白河區,竹門里,55,884,246,81,327,52,379
公投第９案,臺南市,白河區,崎內里,56,740,136,42,178,12,190
公投第９案,臺南市,白河區,昇安里,57,1334,362,131,493,50,543
公投第９案,臺南市,白河區,汴頭里,58,723,210,81,291,61,352
公投第９案,臺南市,白河區,內角里,59,682,220,92,312,61,373
公投第９案,臺南市,白河區,馬稠後里,60,855,283,111,394,44,438
公投第９案,臺南市,白河區,馬稠後里,61,543,128,62,190,21,211
公投第９案,臺南市,東山區,東山里,62,1401,406,156,562,62,624
公投第９案,臺南市,東山區,東中里,63,1185,342,88,430,34,464
公投第９案,臺南市,東山區,東中里,64,1303,366,105,471,54,525
公投第９案,臺南市,東山區,東正里,65,732,186,74,260,32,292
公投第９案,臺南市,東山區,東正里,66,721,169,67,236,34,270
公投第９案,臺南市,東山區,大客里,67,1104,226,124,350,47,397
公投第９案,臺南市,東山區,三榮里,68,943,269,66,335,27,362
公投第９案,臺南市,東山區,科里里,69,653,103,28,131,6,137
公投第９案,臺南市,東山區,科里里,70,596,167,50,217,69,286
公投第９案,臺南市,東山區,東河里,71,878,243,87,330,62,392
公投第９案,臺南市,東山區,聖賢里,72,771,173,92,265,54,319
公投第９案,臺南市,東山區,聖賢里,73,483,137,48,185,24,209
公投第９案,臺南市,東山區,聖賢里,74,640,224,62,286,33,319
公投第９案,臺南市,東山區,南溪里,75,425,63,28,91,3,94
公投第９案,臺南市,東山區,水雲里,76,394,99,28,127,17,144
公投第９案,臺南市,東山區,林安里,77,373,118,38,156,30,186
公投第９案,臺南市,東山區,東原里,78,1257,272,77,349,40,389
公投第９案,臺南市,東山區,東原里,79,887,140,44,184,8,192
公投第９案,臺南市,東山區,嶺南里,80,658,109,38,147,14,161
公投第９案,臺南市,東山區,南勢里,81,1101,202,82,284,24,308
公投第９案,臺南市,東山區,青山里,82,1057,176,68,244,16,260
公投第９案,臺南市,東山區,高原里,83,639,186,70,256,46,302
公投第９案,臺南市,東山區,高原里,84,270,70,37,107,10,117
公投第９案,臺南市,鹽水區,水秀里,85,1037,375,111,486,64,550
公投第９案,臺南市,鹽水區,水秀里,86,480,164,71,235,21,256
公投第９案,臺南市,鹽水區,津城里,87,636,270,78,348,30,378
公投第９案,臺南市,鹽水區,津城里,88,321,107,34,141,11,152
公投第９案,臺南市,鹽水區,津城里,89,497,204,54,258,36,294
公投第９案,臺南市,鹽水區,月港里,90,759,312,89,401,13,414
公投第９案,臺南市,鹽水區,月港里,91,341,124,20,144,18,162
公投第９案,臺南市,鹽水區,月港里,92,507,187,61,248,23,271
公投第９案,臺南市,鹽水區,橋南里,93,863,251,83,334,21,355
公投第９案,臺南市,鹽水區,橋南里,94,1373,424,161,585,24,609
公投第９案,臺南市,鹽水區,橋南里,95,1507,513,171,684,64,748
公投第９案,臺南市,鹽水區,岸內里,96,1374,489,170,659,67,726
公投第９案,臺南市,鹽水區,岸內里,97,1244,393,120,513,49,562
公投第９案,臺南市,鹽水區,岸內里,98,1022,378,103,481,53,534
公投第９案,臺南市,鹽水區,汫水里,99,921,204,79,283,40,323
公投第９案,臺南市,鹽水區,義中里,100,847,280,131,411,46,457
公投第９案,臺南市,鹽水區,義中里,101,736,166,44,210,7,217
公投第９案,臺南市,鹽水區,三明里,102,761,242,84,326,13,339
公投第９案,臺南市,鹽水區,三明里,103,285,91,35,126,10,136
公投第９案,臺南市,鹽水區,三明里,104,493,141,53,194,33,227
公投第９案,臺南市,鹽水區,文昌里,105,621,159,53,212,16,228
公投第９案,臺南市,鹽水區,文昌里,106,392,84,31,115,11,126
公投第９案,臺南市,鹽水區,歡雅里,107,925,286,100,386,27,413
公投第９案,臺南市,鹽水區,歡雅里,108,728,197,78,275,35,310
公投第９案,臺南市,鹽水區,三和里,109,214,44,17,61,19,80
公投第９案,臺南市,鹽水區,三和里,110,387,131,33,164,12,176
公投第９案,臺南市,鹽水區,三和里,111,301,88,41,129,21,150
公投第９案,臺南市,鹽水區,竹林里,112,755,182,76,258,27,285
公投第９案,臺南市,鹽水區,竹林里,113,365,84,41,125,19,144
公投第９案,臺南市,鹽水區,坔頭港里,114,935,260,103,363,31,394
公投第９案,臺南市,鹽水區,坔頭港里,115,494,142,48,190,25,215
公投第９案,臺南市,新營區,忠政里,116,1693,557,166,723,64,787
公投第９案,臺南市,新營區,忠政里,117,1561,640,166,806,62,868
公投第９案,臺南市,新營區,忠政里,118,1487,566,180,746,54,800
公投第９案,臺南市,新營區,民權里,119,1232,443,139,582,28,610
公投第９案,臺南市,新營區,民權里,120,1067,388,113,501,33,534
公投第９案,臺南市,新營區,三仙里,121,1419,436,155,591,32,623
公投第９案,臺南市,新營區,三仙里,122,1466,599,131,730,33,763
公投第９案,臺南市,新營區,永平里,123,932,376,134,510,55,565
公投第９案,臺南市,新營區,永平里,124,1099,336,124,460,25,485
公投第９案,臺南市,新營區,永平里,125,757,253,66,319,28,347
公投第９案,臺南市,新營區,大宏里,126,888,325,128,453,36,489
公投第９案,臺南市,新營區,大宏里,127,1115,391,133,524,16,540
公投第９案,臺南市,新營區,大宏里,128,937,324,83,407,21,428
公投第９案,臺南市,新營區,王公里,129,1387,489,155,644,36,680
公投第９案,臺南市,新營區,王公里,130,1526,557,148,705,43,748
公投第９案,臺南市,新營區,王公里,131,1301,545,145,690,33,723
公投第９案,臺南市,新營區,新東里,132,1538,627,179,806,58,864
公投第９案,臺南市,新營區,新東里,133,1584,635,171,806,47,853
公投第９案,臺南市,新營區,新東里,134,1583,693,162,855,37,892
公投第９案,臺南市,新營區,新東里,135,1530,630,164,794,32,826
公投第９案,臺南市,新營區,中營里,136,1193,500,139,639,44,683
公投第９案,臺南市,新營區,土庫里,137,1439,392,115,507,7,514
公投第９案,臺南市,新營區,興業里,138,1438,599,161,760,45,805
公投第９案,臺南市,新營區,興業里,139,359,137,52,189,20,209
公投第９案,臺南市,新營區,南興里,140,1233,352,110,462,29,491
公投第９案,臺南市,新營區,南興里,141,1227,381,95,476,17,493
公投第９案,臺南市,新營區,民生里,142,1320,425,116,541,23,564
公投第９案,臺南市,新營區,民生里,143,1930,566,177,743,21,764
公投第９案,臺南市,新營區,新北里,144,1501,565,170,735,52,787
公投第９案,臺南市,新營區,新北里,145,1475,539,139,678,37,715
公投第９案,臺南市,新營區,新北里,146,1753,686,188,874,55,929
公投第９案,臺南市,新營區,新南里,147,1748,621,188,809,36,845
公投第９案,臺南市,新營區,新南里,148,1741,656,175,831,47,878
公投第９案,臺南市,新營區,新南里,149,1433,505,142,647,24,671
公投第９案,臺南市,新營區,民榮里,150,1595,592,183,775,52,827
公投第９案,臺南市,新營區,民榮里,151,959,305,83,388,18,406
公投第９案,臺南市,新營區,民榮里,152,1865,624,192,816,70,886
公投第９案,臺南市,新營區,埤寮里,153,1678,510,182,692,87,779
公投第９案,臺南市,新營區,護鎮里,154,1373,430,127,557,59,616
公投第９案,臺南市,新營區,太南里,155,1431,348,140,488,27,515
公投第９案,臺南市,新營區,太南里,156,291,65,29,94,4,98
公投第９案,臺南市,新營區,太北里,157,1749,549,201,750,41,791
公投第９案,臺南市,新營區,南紙里,158,1862,618,168,786,42,828
公投第９案,臺南市,新營區,南紙里,159,1821,732,164,896,88,984
公投第９案,臺南市,新營區,嘉芳里,160,1845,621,169,790,56,846
公投第９案,臺南市,新營區,姑爺里,161,542,143,38,181,9,190
公投第９案,臺南市,新營區,姑爺里,162,402,102,29,131,3,134
公投第９案,臺南市,新營區,五興里,163,703,252,101,353,57,410
公投第９案,臺南市,新營區,五興里,164,941,283,100,383,35,418
公投第９案,臺南市,柳營區,士林里,165,1166,381,130,511,50,561
公投第９案,臺南市,柳營區,士林里,166,625,233,91,324,11,335
公投第９案,臺南市,柳營區,光福里,167,738,218,63,281,27,308
公投第９案,臺南市,柳營區,光福里,168,834,330,83,413,19,432
公投第９案,臺南市,柳營區,中埕里,169,1104,342,113,455,41,496
公投第９案,臺南市,柳營區,東昇里,170,1015,304,97,401,18,419
公投第９案,臺南市,柳營區,東昇里,171,1720,643,168,811,123,934
公投第９案,臺南市,柳營區,八翁里,172,1391,448,136,584,71,655
公投第９案,臺南市,柳營區,人和里,173,425,137,36,173,6,179
公投第９案,臺南市,柳營區,人和里,174,318,84,20,104,21,125
公投第９案,臺南市,柳營區,太康里,175,753,247,81,328,44,372
公投第９案,臺南市,柳營區,太康里,176,730,237,68,305,40,345
公投第９案,臺南市,柳營區,重溪里,177,725,234,77,311,38,349
公投第９案,臺南市,柳營區,重溪里,178,787,300,87,387,34,421
公投第９案,臺南市,柳營區,重溪里,179,297,105,32,137,33,170
公投第９案,臺南市,柳營區,篤農里,180,673,244,81,325,44,369
公投第９案,臺南市,柳營區,篤農里,181,640,227,67,294,64,358
公投第９案,臺南市,柳營區,大農里,182,660,169,82,251,31,282
公投第９案,臺南市,柳營區,神農里,183,1212,365,103,468,40,508
公投第９案,臺南市,柳營區,神農里,184,202,68,15,83,6,89
公投第９案,臺南市,柳營區,果毅里,185,1049,324,101,425,81,506
公投第９案,臺南市,柳營區,果毅里,186,158,47,23,70,1,71
公投第９案,臺南市,柳營區,旭山里,187,921,274,122,396,68,464
公投第９案,臺南市,柳營區,旭山里,188,504,143,45,188,22,210
公投第９案,臺南市,柳營區,旭山里,189,157,48,13,61,4,65
公投第９案,臺南市,北門區,永隆里,190,484,132,57,189,11,200
公投第９案,臺南市,北門區,永隆里,191,401,128,21,149,14,163
公投第９案,臺南市,北門區,北門里,192,456,117,29,146,7,153
公投第９案,臺南市,北門區,北門里,193,382,131,49,180,20,200
公投第９案,臺南市,北門區,玉港里,194,356,116,34,150,25,175
公投第９案,臺南市,北門區,玉港里,195,389,102,26,128,7,135
公投第９案,臺南市,北門區,保吉里,196,742,226,58,284,3,287
公投第９案,臺南市,北門區,保吉里,197,599,158,56,214,16,230
公投第９案,臺南市,北門區,蚵寮里,198,594,164,53,217,27,244
公投第９案,臺南市,北門區,蚵寮里,199,572,159,59,218,26,244
公投第９案,臺南市,北門區,蚵寮里,200,318,68,22,90,4,94
公投第９案,臺南市,北門區,雙春里,201,473,116,47,163,13,176
公投第９案,臺南市,北門區,錦湖里,202,954,190,75,265,14,279
公投第９案,臺南市,北門區,慈安里,203,737,267,84,351,37,388
公投第９案,臺南市,北門區,三光里,204,679,151,51,202,15,217
公投第９案,臺南市,北門區,三光里,205,521,129,39,168,29,197
公投第９案,臺南市,北門區,文山里,206,632,148,45,193,14,207
公投第９案,臺南市,北門區,文山里,207,636,161,41,202,10,212
公投第９案,臺南市,學甲區,秀昌里,208,862,293,130,423,57,480
公投第９案,臺南市,學甲區,秀昌里,209,611,258,69,327,8,335
公投第９案,臺南市,學甲區,秀昌里,210,936,329,113,442,30,472
公投第９案,臺南市,學甲區,明宜里,211,1066,307,145,452,46,498
公投第９案,臺南市,學甲區,明宜里,212,869,317,129,446,32,478
公投第９案,臺南市,學甲區,慈福里,213,635,233,55,288,35,323
公投第９案,臺南市,學甲區,慈福里,214,822,277,64,341,25,366
公投第９案,臺南市,學甲區,慈福里,215,443,137,31,168,18,186
公投第９案,臺南市,學甲區,仁得里,216,1370,519,124,643,43,686
公投第９案,臺南市,學甲區,仁得里,217,1117,440,112,552,50,602
公投第９案,臺南市,學甲區,仁得里,218,1365,476,128,604,77,681
公投第９案,臺南市,學甲區,新達里,219,1489,491,140,631,80,711
公投第９案,臺南市,學甲區,新達里,220,627,150,66,216,38,254
公投第９案,臺南市,學甲區,新榮里,221,1052,373,110,483,20,503
公投第９案,臺南市,學甲區,新榮里,222,1183,412,109,521,24,545
公投第９案,臺南市,學甲區,大灣里,223,979,273,91,364,25,389
公投第９案,臺南市,學甲區,豐和里,224,1241,359,133,492,62,554
公投第９案,臺南市,學甲區,中洲里,225,843,231,63,294,23,317
公投第９案,臺南市,學甲區,中洲里,226,580,186,58,244,36,280
公投第９案,臺南市,學甲區,光華里,227,832,214,56,270,21,291
公投第９案,臺南市,學甲區,光華里,228,406,99,39,138,4,142
公投第９案,臺南市,學甲區,宅港里,229,818,291,96,387,37,424
公投第９案,臺南市,學甲區,平和里,230,1052,264,99,363,19,382
公投第９案,臺南市,學甲區,三慶里,231,578,159,57,216,12,228
公投第９案,臺南市,學甲區,三慶里,232,430,105,43,148,20,168
公投第９案,臺南市,學甲區,三慶里,233,361,125,25,150,13,163
公投第９案,臺南市,將軍區,長榮里,234,1110,398,150,548,73,621
公投第９案,臺南市,將軍區,西甲里,235,1418,472,123,595,27,622
公投第９案,臺南市,將軍區,西甲里,236,969,294,105,399,26,425
公投第９案,臺南市,將軍區,忠嘉里,237,519,201,58,259,41,300
公投第９案,臺南市,將軍區,忠嘉里,238,1106,399,78,477,22,499
公投第９案,臺南市,將軍區,忠嘉里,239,542,153,73,226,42,268
公投第９案,臺南市,將軍區,忠嘉里,240,315,80,24,104,11,115
公投第９案,臺南市,將軍區,苓仔寮里,241,584,166,51,217,19,236
公投第９案,臺南市,將軍區,苓仔寮里,242,398,127,38,165,7,172
公投第９案,臺南市,將軍區,苓仔寮里,243,608,155,51,206,16,222
公投第９案,臺南市,將軍區,苓仔寮里,244,442,154,43,197,20,217
公投第９案,臺南市,將軍區,巷埔里,245,650,152,58,210,9,219
公投第９案,臺南市,將軍區,巷埔里,246,573,130,40,170,12,182
公投第９案,臺南市,將軍區,將軍里,247,617,149,47,196,10,206
公投第９案,臺南市,將軍區,將軍里,248,573,184,47,231,23,254
公投第９案,臺南市,將軍區,將軍里,249,434,142,44,186,26,212
公投第９案,臺南市,將軍區,玉山里,250,849,213,81,294,11,305
公投第９案,臺南市,將軍區,廣山里,251,645,177,49,226,30,256
公投第９案,臺南市,將軍區,長沙里,252,690,161,55,216,28,244
公投第９案,臺南市,將軍區,長沙里,253,663,132,45,177,6,183
公投第９案,臺南市,將軍區,平沙里,254,1175,286,87,373,28,401
公投第９案,臺南市,將軍區,鯤鯓里,255,837,193,57,250,30,280
公投第９案,臺南市,將軍區,鯤鯓里,256,1061,336,95,431,124,555
公投第９案,臺南市,將軍區,鯤溟里,257,976,218,59,277,24,301
公投第９案,臺南市,七股區,後港里,258,534,155,52,207,15,222
公投第９案,臺南市,七股區,後港里,259,508,182,52,234,18,252
公投第９案,臺南市,七股區,大潭里,260,665,157,42,199,6,205
公投第９案,臺南市,七股區,篤加里,261,834,244,64,308,22,330
公投第９案,臺南市,七股區,頂山里,262,810,192,85,277,18,295
公投第９案,臺南市,七股區,西寮里,263,480,112,29,141,10,151
公投第９案,臺南市,七股區,塩埕里,264,445,108,39,147,6,153
公投第９案,臺南市,七股區,中寮里,265,680,128,41,169,12,181
公投第９案,臺南市,七股區,龍山里,266,838,171,67,238,9,247
公投第９案,臺南市,七股區,龍山里,267,780,181,52,233,18,251
公投第９案,臺南市,七股區,溪南里,268,350,123,45,168,14,182
公投第９案,臺南市,七股區,七股里,269,907,335,115,450,69,519
公投第９案,臺南市,七股區,玉成里,270,780,243,52,295,20,315
公投第９案,臺南市,七股區,大埕里,271,1658,481,146,627,47,674
公投第９案,臺南市,七股區,大埕里,272,913,269,73,342,34,376
公投第９案,臺南市,七股區,樹林里,273,1202,389,138,527,63,590
公投第９案,臺南市,七股區,樹林里,274,696,174,56,230,9,239
公投第９案,臺南市,七股區,竹橋里,275,647,188,75,263,39,302
公投第９案,臺南市,七股區,竹橋里,276,622,261,73,334,51,385
公投第９案,臺南市,七股區,義合里,277,1175,430,147,577,88,665
公投第９案,臺南市,七股區,義合里,278,698,211,62,273,30,303
公投第９案,臺南市,七股區,永吉里,279,983,339,101,440,70,510
公投第９案,臺南市,七股區,三股里,280,1366,327,109,436,41,477
公投第９案,臺南市,七股區,十份里,281,1379,354,175,529,72,601
公投第９案,臺南市,佳里區,東寧里,282,1391,552,162,714,56,770
公投第９案,臺南市,佳里區,東寧里,283,829,338,106,444,35,479
公投第９案,臺南市,佳里區,忠仁里,284,1401,418,157,575,32,607
公投第９案,臺南市,佳里區,忠仁里,285,1452,449,130,579,21,600
公投第９案,臺南市,佳里區,鎮山里,286,1382,510,157,667,66,733
公投第９案,臺南市,佳里區,鎮山里,287,1463,557,151,708,61,769
公投第９案,臺南市,佳里區,鎮山里,288,1280,452,121,573,39,612
公投第９案,臺南市,佳里區,鎮山里,289,1486,551,182,733,71,804
公投第９案,臺南市,佳里區,安西里,290,1378,535,148,683,73,756
公投第９案,臺南市,佳里區,安西里,291,1505,570,172,742,60,802
公投第９案,臺南市,佳里區,安西里,292,1860,705,180,885,82,967
公投第９案,臺南市,佳里區,安西里,293,1134,414,123,537,96,633
公投第９案,臺南市,佳里區,文新里,294,1426,548,150,698,55,753
公投第９案,臺南市,佳里區,文新里,295,1779,672,187,859,64,923
公投第９案,臺南市,佳里區,文新里,296,1906,765,196,961,62,1023
公投第９案,臺南市,佳里區,建南里,297,1425,494,163,657,50,707
公投第９案,臺南市,佳里區,建南里,298,1255,466,136,602,51,653
公投第９案,臺南市,佳里區,建南里,299,1524,517,145,662,81,743
公投第９案,臺南市,佳里區,南勢里,300,1631,599,172,771,42,813
公投第９案,臺南市,佳里區,南勢里,301,1546,630,179,809,54,863
公投第９案,臺南市,佳里區,南勢里,302,1187,504,147,651,50,701
公投第９案,臺南市,佳里區,六安里,303,1381,512,148,660,48,708
公投第９案,臺南市,佳里區,六安里,304,1364,496,127,623,27,650
公投第９案,臺南市,佳里區,六安里,305,1314,491,151,642,33,675
公投第９案,臺南市,佳里區,佳化里,306,1164,419,160,579,54,633
公投第９案,臺南市,佳里區,佳化里,307,961,351,118,469,47,516
公投第９案,臺南市,佳里區,佳興里,308,1218,405,129,534,53,587
公投第９案,臺南市,佳里區,佳興里,309,919,327,119,446,20,466
公投第９案,臺南市,佳里區,營溪里,310,689,238,83,321,26,347
公投第９案,臺南市,佳里區,營溪里,311,383,118,35,153,16,169
公投第９案,臺南市,佳里區,海澄里,312,1507,514,145,659,55,714
公投第９案,臺南市,佳里區,海澄里,313,702,224,94,318,26,344
公投第９案,臺南市,佳里區,下營里,314,907,349,93,442,49,491
公投第９案,臺南市,佳里區,下營里,315,937,407,105,512,41,553
公投第９案,臺南市,佳里區,塭內里,316,1030,339,131,470,63,533
公投第９案,臺南市,佳里區,塭內里,317,981,332,118,450,53,503
公投第９案,臺南市,佳里區,塭內里,318,787,251,78,329,21,350
公投第９案,臺南市,佳里區,民安里,319,1513,539,153,692,67,759
公投第９案,臺南市,佳里區,子龍里,320,714,199,69,268,22,290
公投第９案,臺南市,佳里區,子龍里,321,745,240,88,328,39,367
公投第９案,臺南市,佳里區,子龍里,322,951,295,102,397,25,422
公投第９案,臺南市,西港區,西港里,323,933,322,102,424,17,441
公投第９案,臺南市,西港區,西港里,324,901,319,108,427,35,462
公投第９案,臺南市,西港區,西港里,325,1314,418,133,551,32,583
公投第９案,臺南市,西港區,慶安里,326,1349,475,140,615,73,688
公投第９案,臺南市,西港區,慶安里,327,1014,382,118,500,60,560
公投第９案,臺南市,西港區,慶安里,328,1900,488,181,669,34,703
公投第９案,臺南市,西港區,南海里,329,1663,509,157,666,55,721
公投第９案,臺南市,西港區,南海里,330,738,209,74,283,13,296
公投第９案,臺南市,西港區,港東里,331,1211,441,141,582,64,646
公投第９案,臺南市,西港區,港東里,332,382,112,40,152,28,180
公投第９案,臺南市,西港區,檨林里,333,786,241,62,303,21,324
公投第９案,臺南市,西港區,檨林里,334,838,268,81,349,14,363
公投第９案,臺南市,西港區,後營里,335,1449,392,132,524,46,570
公投第９案,臺南市,西港區,營西里,336,1479,395,126,521,31,552
公投第９案,臺南市,西港區,金砂里,337,763,270,80,350,72,422
公投第９案,臺南市,西港區,劉厝里,338,1297,393,98,491,30,521
公投第９案,臺南市,西港區,竹林里,339,1393,419,141,560,40,600
公投第９案,臺南市,西港區,永樂里,340,958,245,88,333,18,351
公投第９案,臺南市,西港區,永樂里,341,391,139,43,182,19,201
公投第９案,臺南市,西港區,新復里,342,805,275,87,362,59,421
公投第９案,臺南市,下營區,下營里,343,1558,438,134,572,48,620
公投第９案,臺南市,下營區,仁里里,344,1112,285,106,391,31,422
公投第９案,臺南市,下營區,仁里里,345,893,268,95,363,59,422
公投第９案,臺南市,下營區,宅內里,346,1623,433,149,582,51,633
公投第９案,臺南市,下營區,後街里,347,1568,510,159,669,94,763
公投第９案,臺南市,下營區,新興里,348,985,339,112,451,54,505
公投第９案,臺南市,下營區,新興里,349,953,305,72,377,18,395
公投第９案,臺南市,下營區,營前里,350,1031,321,104,425,32,457
公投第９案,臺南市,下營區,營前里,351,1077,411,117,528,68,596
公投第９案,臺南市,下營區,大吉里,352,703,175,57,232,48,280
公投第９案,臺南市,下營區,大吉里,353,854,258,62,320,19,339
公投第９案,臺南市,下營區,茅營里,354,1164,368,136,504,48,552
公投第９案,臺南市,下營區,茅營里,355,1091,319,104,423,25,448
公投第９案,臺南市,下營區,開化里,356,959,333,90,423,65,488
公投第９案,臺南市,下營區,開化里,357,935,306,87,393,31,424
公投第９案,臺南市,下營區,西連里,358,893,308,86,394,53,447
公投第９案,臺南市,下營區,賀建里,359,1293,451,124,575,94,669
公投第９案,臺南市,下營區,紅甲里,360,1185,359,153,512,112,624
公投第９案,臺南市,下營區,紅甲里,361,1070,256,82,338,19,357
公投第９案,臺南市,六甲區,六甲里,362,819,307,101,408,56,464
公投第９案,臺南市,六甲區,六甲里,363,645,222,71,293,20,313
公投第９案,臺南市,六甲區,六甲里,364,1444,466,140,606,37,643
公投第９案,臺南市,六甲區,甲東里,365,1554,402,171,573,58,631
公投第９案,臺南市,六甲區,甲東里,366,1171,311,117,428,52,480
公投第９案,臺南市,六甲區,甲南里,367,1351,436,142,578,69,647
公投第９案,臺南市,六甲區,七甲里,368,1010,284,110,394,71,465
公投第９案,臺南市,六甲區,七甲里,369,919,264,110,374,58,432
公投第９案,臺南市,六甲區,二甲里,370,1369,414,173,587,64,651
公投第９案,臺南市,六甲區,二甲里,371,976,341,94,435,66,501
公投第９案,臺南市,六甲區,二甲里,372,1015,374,124,498,51,549
公投第９案,臺南市,六甲區,水林里,373,1176,364,114,478,33,511
公投第９案,臺南市,六甲區,水林里,374,939,315,113,428,51,479
公投第９案,臺南市,六甲區,中社里,375,712,228,100,328,43,371
公投第９案,臺南市,六甲區,中社里,376,881,315,99,414,43,457
公投第９案,臺南市,六甲區,龜港里,377,1184,472,153,625,63,688
公投第９案,臺南市,六甲區,菁埔里,378,599,244,91,335,26,361
公投第９案,臺南市,六甲區,王爺里,379,759,160,50,210,8,218
公投第９案,臺南市,六甲區,大丘里,380,621,148,70,218,26,244
公投第９案,臺南市,麻豆區,新興里,381,1205,413,136,549,52,601
公投第９案,臺南市,麻豆區,新興里,382,660,234,99,333,35,368
公投第９案,臺南市,麻豆區,巷口里,383,523,175,82,257,18,275
公投第９案,臺南市,麻豆區,巷口里,384,1597,549,189,738,37,775
公投第９案,臺南市,麻豆區,東角里,385,1262,478,169,647,55,702
公投第９案,臺南市,麻豆區,東角里,386,1325,535,161,696,44,740
公投第９案,臺南市,麻豆區,晋江里,387,1384,454,164,618,37,655
公投第９案,臺南市,麻豆區,晋江里,388,1121,381,152,533,25,558
公投第９案,臺南市,麻豆區,中興里,389,1021,326,131,457,12,469
公投第９案,臺南市,麻豆區,中興里,390,954,301,119,420,43,463
公投第９案,臺南市,麻豆區,興農里,391,1513,449,154,603,28,631
公投第９案,臺南市,麻豆區,油車里,392,1726,523,173,696,42,738
公投第９案,臺南市,麻豆區,油車里,393,1804,653,177,830,60,890
公投第９案,臺南市,麻豆區,北勢里,394,1106,340,104,444,29,473
公投第９案,臺南市,麻豆區,大埕里,395,1503,498,185,683,48,731
公投第９案,臺南市,麻豆區,大埕里,396,1302,466,143,609,47,656
公投第９案,臺南市,麻豆區,清水里,397,645,211,74,285,17,302
公投第９案,臺南市,麻豆區,清水里,398,777,316,94,410,27,437
公投第９案,臺南市,麻豆區,南勢里,399,1612,502,169,671,48,719
公投第９案,臺南市,麻豆區,南勢里,400,718,222,61,283,17,300
公投第９案,臺南市,麻豆區,寮廍里,401,1656,481,146,627,33,660
公投第９案,臺南市,麻豆區,埤頭里,402,1355,419,178,597,69,666
公投第９案,臺南市,麻豆區,埤頭里,403,977,256,74,330,35,365
公投第９案,臺南市,麻豆區,海埔里,404,1012,302,102,404,32,436
公投第９案,臺南市,麻豆區,海埔里,405,626,224,81,305,22,327
公投第９案,臺南市,麻豆區,海埔里,406,467,97,29,126,5,131
公投第９案,臺南市,麻豆區,港尾里,407,1260,394,127,521,24,545
公投第９案,臺南市,麻豆區,麻口里,408,1111,378,138,516,41,557
公投第９案,臺南市,麻豆區,安業里,409,550,178,83,261,23,284
公投第９案,臺南市,麻豆區,安業里,410,798,265,95,360,43,403
公投第９案,臺南市,麻豆區,謝厝寮里,411,852,315,111,426,80,506
公投第９案,臺南市,麻豆區,謝厝寮里,412,830,235,70,305,11,316
公投第９案,臺南市,麻豆區,安正里,413,941,254,105,359,17,376
公投第９案,臺南市,麻豆區,井東里,414,1158,399,135,534,27,561
公投第９案,臺南市,麻豆區,井東里,415,612,180,70,250,10,260
公投第９案,臺南市,官田區,官田里,416,1104,364,87,451,17,468
公投第９案,臺南市,官田區,官田里,417,965,322,111,433,41,474
公投第９案,臺南市,官田區,二鎮里,418,1402,475,156,631,44,675
公投第９案,臺南市,官田區,二鎮里,419,1653,579,234,813,92,905
公投第９案,臺南市,官田區,烏山頭里,420,966,269,116,385,56,441
公投第９案,臺南市,官田區,烏山頭里,421,284,73,33,106,15,121
公投第９案,臺南市,官田區,大崎里,422,402,80,25,105,5,110
公投第９案,臺南市,官田區,隆田里,423,982,338,114,452,10,462
公投第９案,臺南市,官田區,隆田里,424,975,291,87,378,26,404
公投第９案,臺南市,官田區,隆本里,425,802,255,100,355,42,397
公投第９案,臺南市,官田區,隆本里,426,1118,401,149,550,47,597
公投第９案,臺南市,官田區,隆本里,427,1455,487,171,658,28,686
公投第９案,臺南市,官田區,南廍里,428,1208,410,147,557,29,586
公投第９案,臺南市,官田區,東西庄里,429,1293,388,132,520,59,579
公投第９案,臺南市,官田區,東西庄里,430,607,158,60,218,18,236
公投第９案,臺南市,官田區,渡拔里,431,501,144,65,209,30,239
公投第９案,臺南市,官田區,渡拔里,432,728,265,85,350,48,398
公投第９案,臺南市,官田區,渡拔里,433,842,255,103,358,19,377
公投第９案,臺南市,官田區,渡拔里,434,515,170,62,232,42,274
公投第９案,臺南市,官田區,社子里,435,873,245,62,307,19,326
公投第９案,臺南市,大內區,石湖里,436,759,208,68,276,46,322
公投第９案,臺南市,大內區,石湖里,437,262,59,22,81,2,83
公投第９案,臺南市,大內區,石林里,438,646,148,50,198,15,213
公投第９案,臺南市,大內區,石城里,439,1473,409,110,519,65,584
公投第９案,臺南市,大內區,內江里,440,915,324,96,420,71,491
公投第９案,臺南市,大內區,大內里,441,779,286,101,387,41,428
公投第９案,臺南市,大內區,內郭里,442,637,248,94,342,46,388
公投第９案,臺南市,大內區,頭社里,443,993,272,112,384,29,413
公投第９案,臺南市,大內區,環湖里,444,766,284,86,370,38,408
公投第９案,臺南市,大內區,二溪里,445,841,294,80,374,35,409
公投第９案,臺南市,大內區,曲溪里,446,583,186,56,242,41,283
公投第９案,臺南市,楠西區,楠西里,447,978,305,111,416,60,476
公投第９案,臺南市,楠西區,楠西里,448,870,326,104,430,42,472
公投第９案,臺南市,楠西區,灣丘里,449,1160,265,65,330,10,340
公投第９案,臺南市,楠西區,密枝里,450,699,196,59,255,27,282
公投第９案,臺南市,楠西區,照興里,451,990,254,65,319,15,334
公投第９案,臺南市,楠西區,鹿田里,452,928,281,78,359,32,391
公投第９案,臺南市,楠西區,龜丹里,453,660,210,58,268,44,312
公投第９案,臺南市,楠西區,東勢里,454,1187,394,106,500,76,576
公投第９案,臺南市,楠西區,東勢里,455,1056,341,98,439,35,474
公投第９案,臺南市,南化區,南化里,456,690,233,88,321,46,367
公投第９案,臺南市,南化區,南化里,457,695,243,81,324,57,381
公投第９案,臺南市,南化區,小崙里,458,806,231,87,318,38,356
公投第９案,臺南市,南化區,東和里,459,654,168,53,221,48,269
公投第９案,臺南市,南化區,西埔里,460,783,186,65,251,33,284
公投第９案,臺南市,南化區,中坑里,461,425,127,58,185,20,205
公投第９案,臺南市,南化區,北平里,462,559,185,57,242,32,274
公投第９案,臺南市,南化區,北寮里,463,1189,346,98,444,25,469
公投第９案,臺南市,南化區,玉山里,464,1044,361,130,491,35,526
公投第９案,臺南市,南化區,關山里,465,941,376,91,467,21,488
公投第９案,臺南市,玉井區,玉井里,466,1242,430,115,545,27,572
公投第９案,臺南市,玉井區,玉田里,467,1141,443,109,552,37,589
公投第９案,臺南市,玉井區,玉田里,468,698,223,79,302,21,323
公投第９案,臺南市,玉井區,玉田里,469,849,302,85,387,17,404
公投第９案,臺南市,玉井區,玉田里,470,949,371,86,457,50,507
公投第９案,臺南市,玉井區,中正里,471,618,210,68,278,23,301
公投第９案,臺南市,玉井區,中正里,472,594,181,38,219,10,229
公投第９案,臺南市,玉井區,竹圍里,473,927,280,73,353,21,374
公投第９案,臺南市,玉井區,竹圍里,474,512,166,56,222,49,271
公投第９案,臺南市,玉井區,沙田里,475,509,161,48,209,33,242
公投第９案,臺南市,玉井區,三埔里,476,496,186,51,237,24,261
公投第９案,臺南市,玉井區,三和里,477,759,234,69,303,15,318
公投第９案,臺南市,玉井區,望明里,478,669,168,58,226,12,238
公投第９案,臺南市,玉井區,望明里,479,787,229,89,318,64,382
公投第９案,臺南市,玉井區,層林里,480,620,180,57,237,46,283
公投第９案,臺南市,玉井區,豐里里,481,987,340,105,445,56,501
公投第９案,臺南市,左鎮區,光和里,482,392,130,37,167,20,187
公投第９案,臺南市,左鎮區,榮和里,483,644,230,64,294,41,335
公投第９案,臺南市,左鎮區,左鎮里,484,468,116,47,163,18,181
公投第９案,臺南市,左鎮區,中正里,485,753,181,84,265,47,312
公投第９案,臺南市,左鎮區,睦光里,486,345,103,31,134,23,157
公投第９案,臺南市,左鎮區,內庄里,487,393,112,39,151,13,164
公投第９案,臺南市,左鎮區,岡林里,488,420,122,38,160,13,173
公投第９案,臺南市,左鎮區,草山里,489,313,79,25,104,8,112
公投第９案,臺南市,左鎮區,二寮里,490,186,39,22,61,3,64
公投第９案,臺南市,左鎮區,澄山里,491,504,122,52,174,45,219
公投第９案,臺南市,善化區,東關里,492,1132,349,115,464,29,493
公投第９案,臺南市,善化區,坐駕里,493,1845,644,196,840,67,907
公投第９案,臺南市,善化區,坐駕里,494,2090,731,216,947,101,1048
公投第９案,臺南市,善化區,光文里,495,1582,619,170,789,83,872
公投第９案,臺南市,善化區,光文里,496,1901,710,248,958,85,1043
公投第９案,臺南市,善化區,光文里,497,1818,657,219,876,57,933
公投第９案,臺南市,善化區,文昌里,498,1639,602,174,776,71,847
公投第９案,臺南市,善化區,文昌里,499,1061,428,135,563,33,596
公投第９案,臺南市,善化區,南關里,500,1786,666,217,883,100,983
公投第９案,臺南市,善化區,頂街里,501,1147,416,127,543,42,585
公投第９案,臺南市,善化區,文正里,502,1581,531,180,711,74,785
公投第９案,臺南市,善化區,胡家里,503,1240,404,162,566,88,654
公投第９案,臺南市,善化區,胡厝里,504,1743,453,163,616,32,648
公投第９案,臺南市,善化區,什乃里,505,1246,459,173,632,63,695
公投第９案,臺南市,善化區,溪美里,506,961,327,104,431,28,459
公投第９案,臺南市,善化區,溪美里,507,938,310,97,407,16,423
公投第９案,臺南市,善化區,六分里,508,722,243,90,333,19,352
公投第９案,臺南市,善化區,六德里,509,1062,330,100,430,21,451
公投第９案,臺南市,善化區,田寮里,510,1715,579,193,772,95,867
公投第９案,臺南市,善化區,昌隆里,511,1120,361,118,479,56,535
公投第９案,臺南市,善化區,昌隆里,512,865,277,105,382,47,429
公投第９案,臺南市,善化區,牛庄里,513,1574,552,196,748,68,816
公投第９案,臺南市,善化區,嘉北里,514,1535,429,178,607,83,690
公投第９案,臺南市,善化區,嘉南里,515,1106,370,150,520,59,579
公投第９案,臺南市,善化區,小新里,516,1402,459,154,613,43,656
公投第９案,臺南市,善化區,小新里,517,1458,569,206,775,93,868
公投第９案,臺南市,善化區,小新里,518,1380,446,147,593,45,638
公投第９案,臺南市,善化區,蓮潭里,519,1232,491,141,632,10,642
公投第９案,臺南市,善化區,蓮潭里,520,1069,445,118,563,12,575
公投第９案,臺南市,安定區,蘇林里,521,1251,504,171,675,93,768
公投第９案,臺南市,安定區,蘇林里,522,899,328,94,422,48,470
公投第９案,臺南市,安定區,蘇厝里,523,1106,404,118,522,80,602
公投第９案,臺南市,安定區,蘇厝里,524,948,350,113,463,62,525
公投第９案,臺南市,安定區,安定里,525,1442,488,148,636,33,669
公投第９案,臺南市,安定區,安加里,526,1385,426,151,577,63,640
公投第９案,臺南市,安定區,安加里,527,801,321,86,407,51,458
公投第９案,臺南市,安定區,港尾里,528,736,213,84,297,36,333
公投第９案,臺南市,安定區,港尾里,529,781,285,74,359,42,401
公投第９案,臺南市,安定區,中榮里,530,795,306,92,398,20,418
公投第９案,臺南市,安定區,中榮里,531,862,343,108,451,53,504
公投第９案,臺南市,安定區,港口里,532,1487,530,137,667,27,694
公投第９案,臺南市,安定區,港口里,533,1385,497,148,645,29,674
公投第９案,臺南市,安定區,港南里,534,1518,489,151,640,34,674
公投第９案,臺南市,安定區,港南里,535,1094,447,127,574,62,636
公投第９案,臺南市,安定區,嘉同里,536,1590,573,196,769,109,878
公投第９案,臺南市,安定區,嘉同里,537,754,293,87,380,42,422
公投第９案,臺南市,安定區,中沙里,538,716,262,91,353,47,400
公投第９案,臺南市,安定區,新吉里,539,1492,573,175,748,63,811
公投第９案,臺南市,安定區,新吉里,540,943,358,114,472,43,515
公投第９案,臺南市,安定區,海寮里,541,1157,418,124,542,36,578
公投第９案,臺南市,安定區,海寮里,542,1384,502,158,660,107,767
公投第９案,臺南市,安定區,文科里,543,967,344,118,462,57,519
公投第９案,臺南市,安定區,文科里,544,611,216,79,295,26,321
公投第９案,臺南市,新市區,新市里,545,960,330,94,424,26,450
公投第９案,臺南市,新市區,新市里,546,1118,454,157,611,39,650
公投第９案,臺南市,新市區,新市里,547,850,297,89,386,28,414
公投第９案,臺南市,新市區,新和里,548,1241,489,114,603,58,661
公投第９案,臺南市,新市區,新和里,549,1297,508,151,659,41,700
公投第９案,臺南市,新市區,新和里,550,962,407,89,496,44,540
公投第９案,臺南市,新市區,新和里,551,1237,494,146,640,57,697
公投第９案,臺南市,新市區,新和里,552,1326,489,174,663,47,710
公投第９案,臺南市,新市區,社內里,553,1211,483,148,631,63,694
公投第９案,臺南市,新市區,社內里,554,1305,447,167,614,42,656
公投第９案,臺南市,新市區,大洲里,555,688,242,75,317,59,376
公投第９案,臺南市,新市區,豐華里,556,911,357,119,476,36,512
公投第９案,臺南市,新市區,三舍里,557,1525,493,169,662,57,719
公投第９案,臺南市,新市區,大營里,558,1091,335,78,413,6,419
公投第９案,臺南市,新市區,大營里,559,1122,417,118,535,28,563
公投第９案,臺南市,新市區,大營里,560,1049,377,95,472,31,503
公投第９案,臺南市,新市區,大社里,561,1564,504,130,634,22,656
公投第９案,臺南市,新市區,大社里,562,1515,566,188,754,54,808
公投第９案,臺南市,新市區,大社里,563,1378,465,169,634,39,673
公投第９案,臺南市,新市區,潭頂里,564,827,354,97,451,62,513
公投第９案,臺南市,新市區,潭頂里,565,960,392,124,516,93,609
公投第９案,臺南市,新市區,港墘里,566,951,323,117,440,58,498
公投第９案,臺南市,新市區,港墘里,567,1264,458,171,629,67,696
公投第９案,臺南市,新市區,港墘里,568,1173,421,133,554,42,596
公投第９案,臺南市,新市區,永就里,569,684,252,106,358,25,383
公投第９案,臺南市,新市區,永就里,570,1055,442,130,572,75,647
公投第９案,臺南市,新市區,永就里,571,1122,502,131,633,51,684
公投第９案,臺南市,山上區,明和里,572,855,226,77,303,54,357
公投第９案,臺南市,山上區,明和里,573,836,215,61,276,40,316
公投第９案,臺南市,山上區,南洲里,574,753,235,83,318,47,365
公投第９案,臺南市,山上區,南洲里,575,788,254,76,330,41,371
公投第９案,臺南市,山上區,山上里,576,984,337,104,441,48,489
公投第９案,臺南市,山上區,新莊里,577,972,266,109,375,8,383
公投第９案,臺南市,山上區,玉峯里,578,553,118,33,151,5,156
公投第９案,臺南市,山上區,平陽里,579,378,109,25,134,7,141
公投第９案,臺南市,山上區,豐德里,580,392,113,41,154,25,179
公投第９案,臺南市,新化區,武安里,581,746,329,85,414,38,452
公投第９案,臺南市,新化區,武安里,582,1102,445,163,608,41,649
公投第９案,臺南市,新化區,武安里,583,370,153,37,190,24,214
公投第９案,臺南市,新化區,武安里,584,947,360,132,492,75,567
公投第９案,臺南市,新化區,東榮里,585,1154,428,120,548,64,612
公投第９案,臺南市,新化區,東榮里,586,1082,406,131,537,70,607
公投第９案,臺南市,新化區,東榮里,587,1075,425,132,557,54,611
公投第９案,臺南市,新化區,東榮里,588,640,248,65,313,25,338
公投第９案,臺南市,新化區,護國里,589,410,128,52,180,20,200
公投第９案,臺南市,新化區,護國里,590,533,185,55,240,30,270
公投第９案,臺南市,新化區,護國里,591,836,300,103,403,27,430
公投第９案,臺南市,新化區,護國里,592,978,288,101,389,29,418
公投第９案,臺南市,新化區,太平里,593,1348,492,172,664,47,711
公投第９案,臺南市,新化區,太平里,594,1015,361,126,487,48,535
公投第９案,臺南市,新化區,太平里,595,1228,415,120,535,33,568
公投第９案,臺南市,新化區,太平里,596,789,303,99,402,50,452
公投第９案,臺南市,新化區,協興里,597,1022,346,125,471,25,496
公投第９案,臺南市,新化區,協興里,598,1021,355,103,458,23,481
公投第９案,臺南市,新化區,協興里,599,1229,493,147,640,66,706
公投第９案,臺南市,新化區,唪口里,600,1153,441,122,563,17,580
公投第９案,臺南市,新化區,唪口里,601,1012,294,92,386,19,405
公投第９案,臺南市,新化區,北勢里,602,1458,534,184,718,75,793
公投第９案,臺南市,新化區,豐榮里,603,1645,665,179,844,67,911
公投第９案,臺南市,新化區,豐榮里,604,1016,396,129,525,58,583
公投第９案,臺南市,新化區,豐榮里,605,559,195,62,257,10,267
公投第９案,臺南市,新化區,全興里,606,1222,475,161,636,43,679
公投第９案,臺南市,新化區,全興里,607,1562,656,196,852,64,916
公投第９案,臺南市,新化區,崙頂里,608,994,314,104,418,30,448
公投第９案,臺南市,新化區,崙頂里,609,1013,380,94,474,86,560
公投第９案,臺南市,新化區,知義里,610,1197,439,153,592,79,671
公投第９案,臺南市,新化區,知義里,611,1021,329,121,450,58,508
公投第９案,臺南市,新化區,山脚里,612,1428,434,131,565,82,647
公投第９案,臺南市,新化區,大坑里,613,456,120,56,176,39,215
公投第９案,臺南市,新化區,𦰡拔里,614,1037,390,129,519,58,577
公投第９案,臺南市,新化區,𦰡拔里,615,1097,403,116,519,93,612
公投第９案,臺南市,新化區,羊林里,616,902,315,123,438,59,497
公投第９案,臺南市,新化區,礁坑里,617,999,308,100,408,100,508
公投第９案,臺南市,安南區,東和里,618,2549,976,283,1259,42,1301
公投第９案,臺南市,安南區,󻕯南里,619,2321,773,283,1056,85,1141
公投第９案,臺南市,安南區,󻕯南里,620,2156,873,277,1150,78,1228
公投第９案,臺南市,安南區,州南里,621,1662,660,232,892,78,970
公投第９案,臺南市,安南區,州南里,622,1512,589,179,768,106,874
公投第９案,臺南市,安南區,州南里,623,1625,553,194,747,74,821
公投第９案,臺南市,安南區,安順里,624,2143,691,200,891,52,943
公投第９案,臺南市,安南區,安順里,625,2457,1002,238,1240,86,1326
公投第９案,臺南市,安南區,州北里,626,2148,810,277,1087,110,1197
公投第９案,臺南市,安南區,州北里,627,2364,972,147,1119,105,1224
公投第９案,臺南市,安南區,新順里,628,1868,608,181,789,73,862
公投第９案,臺南市,安南區,新順里,629,1797,734,217,951,86,1037
公投第９案,臺南市,安南區,新順里,630,2268,915,225,1140,73,1213
公投第９案,臺南市,安南區,頂安里,631,2291,686,241,927,85,1012
公投第９案,臺南市,安南區,頂安里,632,2255,826,232,1058,81,1139
公投第９案,臺南市,安南區,安慶里,633,1940,655,205,860,75,935
公投第９案,臺南市,安南區,安慶里,634,2013,770,234,1004,40,1044
公投第９案,臺南市,安南區,安慶里,635,2024,726,215,941,97,1038
公投第９案,臺南市,安南區,溪北里,636,1613,671,222,893,91,984
公投第９案,臺南市,安南區,溪北里,637,1178,416,129,545,43,588
公投第９案,臺南市,安南區,安和里,638,2143,787,241,1028,92,1120
公投第９案,臺南市,安南區,安西里,639,1721,632,243,875,89,964
公投第９案,臺南市,安南區,安西里,640,1773,716,222,938,68,1006
公投第９案,臺南市,安南區,溪頂里,641,1428,516,162,678,26,704
公投第９案,臺南市,安南區,溪頂里,642,1626,644,185,829,61,890
公投第９案,臺南市,安南區,溪頂里,643,1358,491,187,678,53,731
公投第９案,臺南市,安南區,安東里,644,1447,623,162,785,57,842
公投第９案,臺南市,安南區,安東里,645,1358,498,187,685,87,772
公投第９案,臺南市,安南區,鳳凰里,646,2116,716,236,952,51,1003
公投第９案,臺南市,安南區,鳳凰里,647,2321,756,265,1021,48,1069
公投第９案,臺南市,安南區,梅花里,648,2117,751,226,977,45,1022
公投第９案,臺南市,安南區,梅花里,649,1927,545,336,881,70,951
公投第９案,臺南市,安南區,理想里,650,2242,755,235,990,105,1095
公投第９案,臺南市,安南區,理想里,651,2334,806,232,1038,56,1094
公投第９案,臺南市,安南區,大安里,652,1822,693,212,905,85,990
公投第９案,臺南市,安南區,大安里,653,1813,668,230,898,111,1009
公投第９案,臺南市,安南區,原佃里,654,2188,795,242,1037,120,1157
公投第９案,臺南市,安南區,長安里,655,2399,831,246,1077,94,1171
公投第９案,臺南市,安南區,長安里,656,2247,709,241,950,80,1030
公投第９案,臺南市,安南區,公親里,657,1165,470,165,635,86,721
公投第９案,臺南市,安南區,布袋里,658,1539,532,179,711,54,765
公投第９案,臺南市,安南區,總頭里,659,1835,648,248,896,114,1010
公投第９案,臺南市,安南區,南興里,660,1797,639,234,873,95,968
公投第９案,臺南市,安南區,學東里,661,2223,719,253,972,108,1080
公投第９案,臺南市,安南區,公󻕯里,662,977,416,139,555,65,620
公投第９案,臺南市,安南區,佃東里,663,1642,543,174,717,38,755
公投第９案,臺南市,安南區,佃東里,664,1697,675,194,869,68,937
公投第９案,臺南市,安南區,佃西里,665,1966,647,205,852,55,907
公投第９案,臺南市,安南區,淵西里,666,1319,467,156,623,74,697
公投第９案,臺南市,安南區,淵西里,667,1909,638,211,849,82,931
公投第９案,臺南市,安南區,海西里,668,1763,653,220,873,71,944
公投第９案,臺南市,安南區,海西里,669,965,359,101,460,55,515
公投第９案,臺南市,安南區,海東里,670,1547,464,149,613,84,697
公投第９案,臺南市,安南區,海東里,671,1784,604,219,823,76,899
公投第９案,臺南市,安南區,海東里,672,2145,700,220,920,95,1015
公投第９案,臺南市,安南區,溪心里,673,2443,955,253,1208,84,1292
公投第９案,臺南市,安南區,溪心里,674,2565,806,255,1061,62,1123
公投第９案,臺南市,安南區,溪心里,675,2480,939,259,1198,88,1286
公投第９案,臺南市,安南區,淵東里,676,2349,704,241,945,109,1054
公投第９案,臺南市,安南區,淵東里,677,2168,775,280,1055,96,1151
公投第９案,臺南市,安南區,淵中里,678,1630,609,157,766,59,825
公投第９案,臺南市,安南區,淵中里,679,1675,510,161,671,55,726
公投第９案,臺南市,安南區,溪墘里,680,1627,704,187,891,118,1009
公投第９案,臺南市,安南區,溪墘里,681,1493,536,187,723,59,782
公投第９案,臺南市,安南區,海佃里,682,1397,511,194,705,79,784
公投第９案,臺南市,安南區,海佃里,683,1416,500,161,661,70,731
公投第９案,臺南市,安南區,海佃里,684,1460,553,160,713,29,742
公投第９案,臺南市,安南區,國安里,685,2222,710,200,910,53,963
公投第９案,臺南市,安南區,溪東里,686,2070,766,226,992,104,1096
公投第９案,臺南市,安南區,溪東里,687,1739,673,213,886,63,949
公投第９案,臺南市,安南區,安富里,688,1830,614,220,834,105,939
公投第９案,臺南市,安南區,安富里,689,1803,727,245,972,82,1054
公投第９案,臺南市,安南區,安富里,690,1800,692,246,938,77,1015
公投第９案,臺南市,安南區,幸福里,691,1815,575,203,778,73,851
公投第９案,臺南市,安南區,幸福里,692,1846,623,201,824,34,858
公投第９案,臺南市,安南區,海南里,693,905,354,146,500,52,552
公投第９案,臺南市,安南區,海南里,694,1073,432,142,574,80,654
公投第９案,臺南市,安南區,城東里,695,1579,623,209,832,80,912
公投第９案,臺南市,安南區,城南里,696,1876,624,225,849,115,964
公投第９案,臺南市,安南區,城南里,697,1194,406,140,546,53,599
公投第９案,臺南市,安南區,青草里,698,1475,390,123,513,30,543
公投第９案,臺南市,安南區,城西里,699,1380,466,154,620,23,643
公投第９案,臺南市,安南區,城北里,700,1462,448,168,616,30,646
公投第９案,臺南市,安南區,城中里,701,1044,427,106,533,69,602
公投第９案,臺南市,安南區,砂崙里,702,603,239,94,333,62,395
公投第９案,臺南市,安南區,砂崙里,703,690,275,92,367,31,398
公投第９案,臺南市,安南區,顯宮里,704,1447,510,152,662,53,715
公投第９案,臺南市,安南區,鹿耳里,705,910,414,133,547,50,597
公投第９案,臺南市,安南區,四草里,706,1850,599,192,791,90,881
公投第９案,臺南市,安南區,塩田里,707,1501,628,178,806,66,872
公投第９案,臺南市,永康區,五王里,708,1398,544,147,691,67,758
公投第９案,臺南市,永康區,五王里,709,1478,448,133,581,42,623
公投第９案,臺南市,永康區,五王里,710,1442,500,175,675,40,715
公投第９案,臺南市,永康區,五王里,711,1353,491,119,610,53,663
公投第９案,臺南市,永康區,三合里,712,1160,404,137,541,28,569
公投第９案,臺南市,永康區,三合里,713,1122,445,121,566,32,598
公投第９案,臺南市,永康區,三合里,714,1165,422,115,537,22,559
公投第９案,臺南市,永康區,六合里,715,1317,472,135,607,48,655
公投第９案,臺南市,永康區,六合里,716,1376,515,140,655,48,703
公投第９案,臺南市,永康區,六合里,717,1361,509,176,685,39,724
公投第９案,臺南市,永康區,六合里,718,1374,586,167,753,46,799
公投第９案,臺南市,永康區,網寮里,719,1709,565,185,750,77,827
公投第９案,臺南市,永康區,網寮里,720,1717,591,178,769,65,834
公投第９案,臺南市,永康區,網寮里,721,1759,586,196,782,57,839
公投第９案,臺南市,永康區,網寮里,722,1636,619,188,807,48,855
公投第９案,臺南市,永康區,二王里,723,1442,502,143,645,62,707
公投第９案,臺南市,永康區,二王里,724,1545,579,152,731,50,781
公投第９案,臺南市,永康區,二王里,725,1565,592,147,739,47,786
公投第９案,臺南市,永康區,二王里,726,1684,593,172,765,44,809
公投第９案,臺南市,永康區,二王里,727,1548,550,146,696,29,725
公投第９案,臺南市,永康區,永康里,728,1389,530,176,706,32,738
公投第９案,臺南市,永康區,永康里,729,1369,495,152,647,70,717
公投第９案,臺南市,永康區,永康里,730,1415,519,155,674,91,765
公投第９案,臺南市,永康區,永康里,731,1386,453,126,579,19,598
公投第９案,臺南市,永康區,永康里,732,1747,305,80,385,5,390
公投第９案,臺南市,永康區,永康里,733,1485,541,160,701,57,758
公投第９案,臺南市,永康區,埔園里,734,1747,623,173,796,91,887
公投第９案,臺南市,永康區,埔園里,735,1744,541,166,707,41,748
公投第９案,臺南市,永康區,埔園里,736,1797,612,166,778,45,823
公投第９案,臺南市,永康區,埔園里,737,1800,684,208,892,71,963
公投第９案,臺南市,永康區,龍埔里,738,1720,621,155,776,28,804
公投第９案,臺南市,永康區,龍埔里,739,1708,692,178,870,45,915
公投第９案,臺南市,永康區,正強里,740,1519,603,174,777,31,808
公投第９案,臺南市,永康區,正強里,741,1497,563,187,750,89,839
公投第９案,臺南市,永康區,正強里,742,1509,559,144,703,23,726
公投第９案,臺南市,永康區,正強里,743,1542,646,174,820,79,899
公投第９案,臺南市,永康區,正強里,744,1536,636,171,807,28,835
公投第９案,臺南市,永康區,大橋里,745,1531,571,191,762,61,823
公投第９案,臺南市,永康區,大橋里,746,1327,539,164,703,54,757
公投第９案,臺南市,永康區,大橋里,747,1456,546,159,705,30,735
公投第９案,臺南市,永康區,大橋里,748,1396,551,173,724,48,772
公投第９案,臺南市,永康區,東橋里,749,1636,563,225,788,52,840
公投第９案,臺南市,永康區,東橋里,750,1592,612,188,800,51,851
公投第９案,臺南市,永康區,東橋里,751,2017,712,208,920,35,955
公投第９案,臺南市,永康區,東橋里,752,672,231,99,330,21,351
公投第９案,臺南市,永康區,西橋里,753,1611,560,159,719,26,745
公投第９案,臺南市,永康區,西橋里,754,1502,562,169,731,60,791
公投第９案,臺南市,永康區,安康里,755,1660,551,154,705,21,726
公投第９案,臺南市,永康區,安康里,756,1561,482,165,647,34,681
公投第９案,臺南市,永康區,安康里,757,1590,520,192,712,29,741
公投第９案,臺南市,永康區,蔦松里,758,924,333,114,447,16,463
公投第９案,臺南市,永康區,蔦松里,759,938,393,106,499,33,532
公投第９案,臺南市,永康區,三民里,760,957,395,99,494,44,538
公投第９案,臺南市,永康區,三民里,761,496,164,70,234,42,276
公投第９案,臺南市,永康區,塩行里,762,1717,638,197,835,71,906
公投第９案,臺南市,永康區,塩行里,763,1615,528,167,695,49,744
公投第９案,臺南市,永康區,塩行里,764,1554,543,181,724,26,750
公投第９案,臺南市,永康區,塩興里,765,1196,414,122,536,23,559
公投第９案,臺南市,永康區,塩興里,766,1274,495,120,615,44,659
公投第９案,臺南市,永康區,塩興里,767,1215,469,137,606,44,650
公投第９案,臺南市,永康區,塩洲里,768,1457,571,133,704,32,736
公投第９案,臺南市,永康區,塩洲里,769,1451,568,147,715,22,737
公投第９案,臺南市,永康區,塩洲里,770,1423,466,166,632,51,683
公投第９案,臺南市,永康區,塩洲里,771,1394,539,163,702,42,744
公投第９案,臺南市,永康區,甲頂里,772,890,365,101,466,49,515
公投第９案,臺南市,永康區,甲頂里,773,1018,415,143,558,53,611
公投第９案,臺南市,永康區,甲頂里,774,368,143,50,193,21,214
公投第９案,臺南市,永康區,尚頂里,775,1208,497,163,660,53,713
公投第９案,臺南市,永康區,尚頂里,776,1187,379,152,531,39,570
公投第９案,臺南市,永康區,尚頂里,777,1381,525,140,665,35,700
公投第９案,臺南市,永康區,龍潭里,778,1405,514,151,665,65,730
公投第９案,臺南市,永康區,龍潭里,779,1445,481,173,654,68,722
公投第９案,臺南市,永康區,龍潭里,780,1687,607,174,781,68,849
公投第９案,臺南市,永康區,龍潭里,781,1535,487,152,639,41,680
公投第９案,臺南市,永康區,永明里,782,1542,613,167,780,55,835
公投第９案,臺南市,永康區,永明里,783,1618,619,163,782,34,816
公投第９案,臺南市,永康區,永明里,784,1338,562,143,705,36,741
公投第９案,臺南市,永康區,王行里,785,1285,497,151,648,86,734
公投第９案,臺南市,永康區,王行里,786,1240,458,123,581,33,614
公投第９案,臺南市,永康區,烏竹里,787,1343,463,149,612,58,670
公投第９案,臺南市,永康區,烏竹里,788,1327,531,170,701,60,761
公投第９案,臺南市,永康區,西勢里,789,1565,577,177,754,58,812
公投第９案,臺南市,永康區,西勢里,790,1476,570,163,733,89,822
公投第９案,臺南市,永康區,西勢里,791,1476,561,160,721,38,759
公投第９案,臺南市,永康區,西勢里,792,1463,579,201,780,53,833
公投第９案,臺南市,永康區,新樹里,793,983,380,112,492,80,572
公投第９案,臺南市,永康區,新樹里,794,1116,404,167,571,76,647
公投第９案,臺南市,永康區,大灣里,795,1117,399,113,512,75,587
公投第９案,臺南市,永康區,大灣里,796,1069,337,134,471,33,504
公投第９案,臺南市,永康區,大灣里,797,1180,524,130,654,43,697
公投第９案,臺南市,永康區,東灣里,798,1176,418,134,552,90,642
公投第９案,臺南市,永康區,東灣里,799,1158,391,159,550,56,606
公投第９案,臺南市,永康區,東灣里,800,1208,466,158,624,84,708
公投第９案,臺南市,永康區,西灣里,801,1501,524,184,708,91,799
公投第９案,臺南市,永康區,西灣里,802,1298,531,128,659,43,702
公投第９案,臺南市,永康區,西灣里,803,1542,558,170,728,34,762
公投第９案,臺南市,永康區,西灣里,804,1537,618,178,796,61,857
公投第９案,臺南市,永康區,西灣里,805,1359,584,168,752,67,819
公投第９案,臺南市,永康區,南灣里,806,1139,353,119,472,44,516
公投第９案,臺南市,永康區,南灣里,807,1158,393,134,527,46,573
公投第９案,臺南市,永康區,南灣里,808,1538,515,171,686,91,777
公投第９案,臺南市,永康區,崑山里,809,1166,395,112,507,32,539
公投第９案,臺南市,永康區,崑山里,810,1228,424,130,554,21,575
公投第９案,臺南市,永康區,崑山里,811,1200,453,157,610,59,669
公投第９案,臺南市,永康區,崑山里,812,1131,431,160,591,42,633
公投第９案,臺南市,永康區,崑山里,813,1147,396,152,548,32,580
公投第９案,臺南市,永康區,北灣里,814,1442,528,144,672,57,729
公投第９案,臺南市,永康區,北灣里,815,1325,455,144,599,33,632
公投第９案,臺南市,永康區,北灣里,816,1260,399,132,531,36,567
公投第９案,臺南市,永康區,北興里,817,1631,595,152,747,52,799
公投第９案,臺南市,永康區,北興里,818,1549,565,152,717,51,768
公投第９案,臺南市,永康區,北興里,819,1666,603,177,780,28,808
公投第９案,臺南市,永康區,復興里,820,1012,353,89,442,54,496
公投第９案,臺南市,永康區,復興里,821,976,304,91,395,26,421
公投第９案,臺南市,永康區,光復里,822,531,208,50,258,22,280
公投第９案,臺南市,永康區,建國里,823,859,349,71,420,52,472
公投第９案,臺南市,永康區,建國里,824,937,328,95,423,39,462
公投第９案,臺南市,永康區,復國里,825,1307,515,136,651,47,698
公投第９案,臺南市,永康區,復國里,826,1482,521,124,645,27,672
公投第９案,臺南市,永康區,復國里,827,1341,459,119,578,40,618
公投第９案,臺南市,永康區,復國里,828,1376,523,134,657,40,697
公投第９案,臺南市,永康區,復國里,829,1390,492,147,639,51,690
公投第９案,臺南市,永康區,復國里,830,1534,591,178,769,58,827
公投第９案,臺南市,永康區,復華里,831,1460,606,148,754,48,802
公投第９案,臺南市,永康區,復華里,832,1383,514,144,658,29,687
公投第９案,臺南市,永康區,復華里,833,1299,457,139,596,42,638
公投第９案,臺南市,永康區,復華里,834,1264,524,143,667,30,697
公投第９案,臺南市,永康區,復華里,835,1355,563,154,717,49,766
公投第９案,臺南市,永康區,復華里,836,1414,526,125,651,29,680
公投第９案,臺南市,永康區,復華里,837,1109,443,154,597,31,628
公投第９案,臺南市,永康區,神洲里,838,1151,424,117,541,47,588
公投第９案,臺南市,永康區,成功里,839,1026,501,114,615,45,660
公投第９案,臺南市,永康區,成功里,840,1071,379,101,480,24,504
公投第９案,臺南市,永康區,中華里,841,1387,611,192,803,65,868
公投第９案,臺南市,永康區,中華里,842,1377,569,192,761,42,803
公投第９案,臺南市,永康區,中興里,843,1687,641,191,832,62,894
公投第９案,臺南市,永康區,中興里,844,1700,602,200,802,41,843
公投第９案,臺南市,永康區,勝利里,845,1444,564,196,760,44,804
公投第９案,臺南市,永康區,勝利里,846,1485,552,155,707,46,753
公投第９案,臺南市,永康區,勝利里,847,1717,607,158,765,37,802
公投第９案,臺南市,永康區,勝利里,848,1701,563,183,746,50,796
公投第９案,臺南市,永康區,勝利里,849,1382,506,131,637,30,667
公投第９案,臺南市,北區,開元里,850,1793,643,186,829,79,908
公投第９案,臺南市,北區,開元里,851,1708,558,171,729,53,782
公投第９案,臺南市,北區,元寶里,852,997,379,109,488,21,509
公投第９案,臺南市,北區,元寶里,853,1452,465,143,608,42,650
公投第９案,臺南市,北區,元寶里,854,1351,481,159,640,21,661
公投第９案,臺南市,北區,合興里,855,1323,570,194,764,60,824
公投第９案,臺南市,北區,合興里,856,1073,409,138,547,35,582
公投第９案,臺南市,北區,合興里,857,1138,455,126,581,31,612
公投第９案,臺南市,北區,力行里,858,1189,434,135,569,46,615
公投第９案,臺南市,北區,力行里,859,1262,543,153,696,43,739
公投第９案,臺南市,北區,重興里,860,1017,443,122,565,30,595
公投第９案,臺南市,北區,重興里,861,847,307,94,401,24,425
公投第９案,臺南市,北區,東興里,862,1076,482,102,584,39,623
公投第９案,臺南市,北區,東興里,863,954,401,133,534,32,566
公投第９案,臺南市,北區,長勝里,864,1300,493,128,621,65,686
公投第９案,臺南市,北區,長勝里,865,1390,543,136,679,51,730
公投第９案,臺南市,北區,長勝里,866,1318,541,154,695,45,740
公投第９案,臺南市,北區,振興里,867,974,369,107,476,16,492
公投第９案,臺南市,北區,振興里,868,990,389,112,501,14,515
公投第９案,臺南市,北區,仁愛里,869,1016,411,165,576,27,603
公投第９案,臺南市,北區,仁愛里,870,1053,411,144,555,32,587
公投第９案,臺南市,北區,中樓里,871,1466,484,195,679,82,761
公投第９案,臺南市,北區,永祥里,872,1535,594,187,781,68,849
公投第９案,臺南市,北區,永祥里,873,1544,541,195,736,68,804
公投第９案,臺南市,北區,北門里,874,1760,697,205,902,72,974
公投第９案,臺南市,北區,北門里,875,1372,413,162,575,42,617
公投第９案,臺南市,北區,北門里,876,1002,426,127,553,33,586
公投第９案,臺南市,北區,北門里,877,1171,486,150,636,42,678
公投第９案,臺南市,北區,大光里,878,1285,471,115,586,24,610
公投第９案,臺南市,北區,大光里,879,1036,410,90,500,38,538
公投第９案,臺南市,北區,大光里,880,1392,568,133,701,45,746
公投第９案,臺南市,北區,大光里,881,1147,441,138,579,55,634
公投第９案,臺南市,北區,大興里,882,1526,477,143,620,38,658
公投第９案,臺南市,北區,大興里,883,1559,544,192,736,39,775
公投第９案,臺南市,北區,公園里,884,892,329,122,451,61,512
公投第９案,臺南市,北區,公園里,885,937,329,102,431,45,476
公投第９案,臺南市,北區,北華里,886,1449,538,200,738,91,829
公投第９案,臺南市,北區,北華里,887,1160,392,151,543,28,571
公投第９案,臺南市,北區,北華里,888,1567,385,142,527,66,593
公投第９案,臺南市,北區,長興里,889,1346,451,200,651,57,708
公投第９案,臺南市,北區,長興里,890,1451,492,153,645,16,661
公投第９案,臺南市,北區,小北里,891,1522,521,176,697,38,735
公投第９案,臺南市,北區,小北里,892,1278,479,129,608,25,633
公投第９案,臺南市,北區,小北里,893,1164,397,136,533,62,595
公投第９案,臺南市,北區,正覺里,894,1091,353,128,481,25,506
公投第９案,臺南市,北區,正覺里,895,993,334,122,456,33,489
公投第９案,臺南市,北區,正覺里,896,1119,337,113,450,35,485
公投第９案,臺南市,北區,成功里,897,1685,636,204,840,83,923
公投第９案,臺南市,北區,成功里,898,1368,513,162,675,23,698
公投第９案,臺南市,北區,成功里,899,1389,516,165,681,60,741
公投第９案,臺南市,北區,華德里,900,1469,603,184,787,29,816
公投第９案,臺南市,北區,華德里,901,1655,703,187,890,58,948
公投第９案,臺南市,北區,福德里,902,1261,520,164,684,29,713
公投第９案,臺南市,北區,福德里,903,1490,583,135,718,26,744
公投第９案,臺南市,北區,福德里,904,1436,605,178,783,43,826
公投第９案,臺南市,北區,成德里,905,1340,553,165,718,68,786
公投第９案,臺南市,北區,成德里,906,1464,547,201,748,44,792
公投第９案,臺南市,北區,成德里,907,1513,645,192,837,21,858
公投第９案,臺南市,北區,和順里,908,1709,684,211,895,30,925
公投第９案,臺南市,北區,和順里,909,1517,645,220,865,43,908
公投第９案,臺南市,北區,和順里,910,1598,579,208,787,34,821
公投第９案,臺南市,北區,立人里,911,1399,505,185,690,48,738
公投第９案,臺南市,北區,立人里,912,1214,431,152,583,51,634
公投第９案,臺南市,北區,雙安里,913,1064,427,142,569,26,595
公投第９案,臺南市,北區,雙安里,914,1148,491,158,649,52,701
公投第９案,臺南市,北區,文成里,915,1391,547,178,725,34,759
公投第９案,臺南市,北區,文成里,916,1584,636,182,818,46,864
公投第９案,臺南市,北區,元美里,917,1595,645,200,845,43,888
公投第９案,臺南市,北區,元美里,918,1397,537,166,703,29,732
公投第９案,臺南市,北區,文元里,919,1662,658,167,825,59,884
公投第９案,臺南市,北區,文元里,920,1634,598,180,778,31,809
公投第９案,臺南市,北區,大和里,921,1793,722,204,926,89,1015
公投第９案,臺南市,北區,大和里,922,1872,691,257,948,53,1001
公投第９案,臺南市,北區,大港里,923,1874,662,231,893,114,1007
公投第９案,臺南市,北區,大港里,924,1760,636,192,828,73,901
公投第９案,臺南市,北區,大港里,925,1753,626,196,822,67,889
公投第９案,臺南市,北區,大豐里,926,1502,449,145,594,39,633
公投第９案,臺南市,北區,大豐里,927,1470,555,176,731,50,781
公投第９案,臺南市,北區,大豐里,928,1319,461,158,619,87,706
公投第９案,臺南市,北區,賢北里,929,1876,748,213,961,73,1034
公投第９案,臺南市,北區,賢北里,930,1720,634,205,839,40,879
公投第９案,臺南市,中西區,赤嵌里,931,1332,470,209,679,55,734
公投第９案,臺南市,中西區,赤嵌里,932,1246,459,191,650,63,713
公投第９案,臺南市,中西區,赤嵌里,933,1276,435,174,609,59,668
公投第９案,臺南市,中西區,郡王里,934,1583,608,236,844,48,892
公投第９案,臺南市,中西區,郡王里,935,1464,569,216,785,49,834
公投第９案,臺南市,中西區,法華里,936,1234,481,128,609,21,630
公投第９案,臺南市,中西區,法華里,937,1368,558,183,741,44,785
公投第９案,臺南市,中西區,開山里,938,1322,434,148,582,32,614
公投第９案,臺南市,中西區,開山里,939,1216,428,158,586,54,640
公投第９案,臺南市,中西區,永華里,940,1289,441,183,624,38,662
公投第９案,臺南市,中西區,永華里,941,1237,477,168,645,47,692
公投第９案,臺南市,中西區,藥王里,942,1189,377,142,519,33,552
公投第９案,臺南市,中西區,藥王里,943,1201,447,172,619,56,675
公投第９案,臺南市,中西區,藥王里,944,1065,434,141,575,60,635
公投第９案,臺南市,中西區,光賢里,945,1055,424,125,549,48,597
公投第９案,臺南市,中西區,光賢里,946,1170,502,172,674,37,711
公投第９案,臺南市,中西區,光賢里,947,1280,567,151,718,40,758
公投第９案,臺南市,中西區,大涼里,948,1223,463,186,649,40,689
公投第９案,臺南市,中西區,大涼里,949,1292,518,164,682,68,750
公投第９案,臺南市,中西區,西湖里,950,993,413,142,555,21,576
公投第９案,臺南市,中西區,西湖里,951,1541,580,188,768,58,826
公投第９案,臺南市,中西區,西湖里,952,1652,694,233,927,59,986
公投第９案,臺南市,中西區,西湖里,953,1212,481,177,658,29,687
公投第９案,臺南市,中西區,西賢里,954,1621,607,243,850,70,920
公投第９案,臺南市,中西區,西賢里,955,1660,618,247,865,41,906
公投第９案,臺南市,中西區,西賢里,956,1595,592,215,807,60,867
公投第９案,臺南市,中西區,城隍里,957,1436,505,193,698,64,762
公投第９案,臺南市,中西區,城隍里,958,1265,482,193,675,48,723
公投第９案,臺南市,中西區,城隍里,959,856,364,111,475,51,526
公投第９案,臺南市,中西區,南美里,960,1168,410,166,576,45,621
公投第９案,臺南市,中西區,南美里,961,1134,448,162,610,50,660
公投第９案,臺南市,中西區,南美里,962,995,425,141,566,53,619
公投第９案,臺南市,中西區,南門里,963,1313,597,171,768,36,804
公投第９案,臺南市,中西區,南門里,964,1265,508,191,699,49,748
公投第９案,臺南市,中西區,小西門里,965,1215,429,172,601,48,649
公投第９案,臺南市,中西區,小西門里,966,1248,476,147,623,57,680
公投第９案,臺南市,中西區,小西門里,967,687,247,94,341,37,378
公投第９案,臺南市,中西區,五條港里,968,1139,430,141,571,63,634
公投第９案,臺南市,中西區,五條港里,969,971,390,131,521,46,567
公投第９案,臺南市,中西區,兌悅里,970,1254,355,131,486,58,544
公投第９案,臺南市,中西區,兌悅里,971,979,387,109,496,35,531
公投第９案,臺南市,中西區,兌悅里,972,1745,623,204,827,59,886
公投第９案,臺南市,中西區,淺草里,973,1074,358,170,528,51,579
公投第９案,臺南市,中西區,淺草里,974,1436,471,191,662,47,709
公投第９案,臺南市,中西區,府前里,975,865,306,138,444,46,490
公投第９案,臺南市,中西區,府前里,976,1164,418,171,589,48,637
公投第９案,臺南市,中西區,南廠里,977,1285,392,172,564,31,595
公投第９案,臺南市,中西區,南廠里,978,1078,383,160,543,48,591
公投第９案,臺南市,中西區,南廠里,979,1704,502,167,669,54,723
公投第９案,臺南市,中西區,西和里,980,1296,496,170,666,88,754
公投第９案,臺南市,中西區,西和里,981,1128,424,151,575,43,618
公投第９案,臺南市,中西區,西和里,982,1245,471,175,646,31,677
公投第９案,臺南市,安平區,文平里,983,1753,683,197,880,81,961
公投第９案,臺南市,安平區,文平里,984,1859,696,194,890,58,948
公投第９案,臺南市,安平區,文平里,985,1382,587,169,756,48,804
公投第９案,臺南市,安平區,建平里,986,2547,887,290,1177,76,1253
公投第９案,臺南市,安平區,建平里,987,2407,906,287,1193,56,1249
公投第９案,臺南市,安平區,怡平里,988,2070,677,209,886,49,935
公投第９案,臺南市,安平區,怡平里,989,2132,784,240,1024,40,1064
公投第９案,臺南市,安平區,華平里,990,1450,568,160,728,25,753
公投第９案,臺南市,安平區,華平里,991,1605,588,156,744,27,771
公投第９案,臺南市,安平區,華平里,992,1755,614,242,856,84,940
公投第９案,臺南市,安平區,平通里,993,1728,555,207,762,51,813
公投第９案,臺南市,安平區,平通里,994,1754,509,186,695,23,718
公投第９案,臺南市,安平區,平通里,995,1686,625,190,815,57,872
公投第９案,臺南市,安平區,平通里,996,1843,722,223,945,50,995
公投第９案,臺南市,安平區,億載里,997,1565,630,186,816,49,865
公投第９案,臺南市,安平區,億載里,998,1288,511,139,650,23,673
公投第９案,臺南市,安平區,育平里,999,1653,557,186,743,30,773
公投第９案,臺南市,安平區,育平里,1000,1697,612,165,777,25,802
公投第９案,臺南市,安平區,育平里,1001,2154,751,208,959,48,1007
公投第９案,臺南市,安平區,育平里,1002,2107,753,221,974,52,1026
公投第９案,臺南市,安平區,國平里,1003,1675,661,194,855,68,923
公投第９案,臺南市,安平區,國平里,1004,1979,682,268,950,64,1014
公投第９案,臺南市,安平區,國平里,1005,1602,565,194,759,33,792
公投第９案,臺南市,安平區,國平里,1006,1586,592,171,763,41,804
公投第９案,臺南市,安平區,漁光里,1007,438,126,44,170,9,179
公投第９案,臺南市,安平區,平安里,1008,1780,611,209,820,76,896
公投第９案,臺南市,安平區,平安里,1009,1623,509,203,712,45,757
公投第９案,臺南市,安平區,天妃里,1010,2157,710,240,950,101,1051
公投第９案,臺南市,安平區,天妃里,1011,1286,401,147,548,56,604
公投第９案,臺南市,安平區,王城里,1012,1492,502,195,697,86,783
公投第９案,臺南市,安平區,王城里,1013,1325,405,126,531,39,570
公投第９案,臺南市,安平區,金城里,1014,2001,694,204,898,91,989
公投第９案,臺南市,南區,大恩里,1015,1221,460,162,622,48,670
公投第９案,臺南市,南區,大恩里,1016,2171,708,212,920,85,1005
公投第９案,臺南市,南區,大林里,1017,1150,485,142,627,38,665
公投第９案,臺南市,南區,大林里,1018,1122,457,125,582,28,610
公投第９案,臺南市,南區,大忠里,1019,1444,485,144,629,53,682
公投第９案,臺南市,南區,大忠里,1020,1765,589,208,797,66,863
公投第９案,臺南市,南區,大忠里,1021,1298,510,163,673,58,731
公投第９案,臺南市,南區,新生里,1022,1458,609,157,766,38,804
公投第９案,臺南市,南區,新生里,1023,1940,740,146,886,34,920
公投第９案,臺南市,南區,竹溪里,1024,1637,592,222,814,56,870
公投第９案,臺南市,南區,明德里,1025,871,282,84,366,19,385
公投第９案,臺南市,南區,大成里,1026,589,229,83,312,22,334
公投第９案,臺南市,南區,大成里,1027,801,342,135,477,46,523
公投第９案,臺南市,南區,田寮里,1028,990,397,123,520,48,568
公投第９案,臺南市,南區,田寮里,1029,1222,525,156,681,56,737
公投第９案,臺南市,南區,田寮里,1030,997,383,132,515,84,599
公投第９案,臺南市,南區,新興里,1031,1204,410,144,554,35,589
公投第９案,臺南市,南區,新興里,1032,1570,482,189,671,30,701
公投第９案,臺南市,南區,再興里,1033,1222,449,167,616,54,670
公投第９案,臺南市,南區,再興里,1034,1076,362,102,464,28,492
公投第９案,臺南市,南區,廣州里,1035,1127,351,182,533,31,564
公投第９案,臺南市,南區,廣州里,1036,1135,412,147,559,60,619
公投第９案,臺南市,南區,新昌里,1037,1263,432,175,607,63,670
公投第９案,臺南市,南區,新昌里,1038,1014,364,97,461,33,494
公投第９案,臺南市,南區,文華里,1039,1491,557,205,762,70,832
公投第９案,臺南市,南區,文華里,1040,1815,658,203,861,52,913
公投第９案,臺南市,南區,文南里,1041,1398,466,181,647,23,670
公投第９案,臺南市,南區,文南里,1042,2107,645,192,837,52,889
公投第９案,臺南市,南區,文南里,1043,1587,670,210,880,55,935
公投第９案,臺南市,南區,金華里,1044,1626,550,236,786,78,864
公投第９案,臺南市,南區,金華里,1045,1761,564,209,773,43,816
公投第９案,臺南市,南區,金華里,1046,1630,583,205,788,78,866
公投第９案,臺南市,南區,國宅里,1047,1542,567,200,767,59,826
公投第９案,臺南市,南區,國宅里,1048,1464,510,168,678,91,769
公投第９案,臺南市,南區,鹽埕里,1049,1727,586,217,803,101,904
公投第９案,臺南市,南區,鹽埕里,1050,1085,419,166,585,59,644
公投第９案,臺南市,南區,鹽埕里,1051,939,327,108,435,18,453
公投第９案,臺南市,南區,光明里,1052,1419,422,165,587,87,674
公投第９案,臺南市,南區,光明里,1053,1333,467,137,604,63,667
公投第９案,臺南市,南區,光明里,1054,1465,471,188,659,67,726
公投第９案,臺南市,南區,明亮里,1055,1099,397,125,522,27,549
公投第９案,臺南市,南區,明亮里,1056,1133,381,126,507,28,535
公投第９案,臺南市,南區,明亮里,1057,1375,438,167,605,105,710
公投第９案,臺南市,南區,府南里,1058,1781,565,174,739,43,782
公投第９案,臺南市,南區,府南里,1059,1542,642,171,813,62,875
公投第９案,臺南市,南區,府南里,1060,1486,484,182,666,38,704
公投第９案,臺南市,南區,明興里,1061,1640,601,204,805,100,905
公投第９案,臺南市,南區,明興里,1062,1701,513,203,716,49,765
公投第９案,臺南市,南區,郡南里,1063,1541,474,167,641,108,749
公投第９案,臺南市,南區,郡南里,1064,2027,705,196,901,117,1018
公投第９案,臺南市,南區,建南里,1065,1774,703,239,942,85,1027
公投第９案,臺南市,南區,建南里,1066,1613,553,210,763,67,830
公投第９案,臺南市,南區,建南里,1067,1707,586,185,771,27,798
公投第９案,臺南市,南區,南都里,1068,1657,368,138,506,23,529
公投第９案,臺南市,南區,南都里,1069,1077,412,126,538,38,576
公投第９案,臺南市,南區,南華里,1070,1185,448,136,584,42,626
公投第９案,臺南市,南區,南華里,1071,1249,418,176,594,61,655
公投第９案,臺南市,南區,開南里,1072,1985,610,193,803,37,840
公投第９案,臺南市,南區,開南里,1073,2017,576,252,828,78,906
公投第９案,臺南市,南區,開南里,1074,1717,549,212,761,83,844
公投第９案,臺南市,南區,彰南里,1075,929,338,126,464,42,506
公投第９案,臺南市,南區,彰南里,1076,695,265,105,370,24,394
公投第９案,臺南市,南區,鯤鯓里,1077,997,297,92,389,31,420
公投第９案,臺南市,南區,鯤鯓里,1078,784,248,60,308,23,331
公投第９案,臺南市,南區,喜北里,1079,1119,432,136,568,80,648
公投第９案,臺南市,南區,喜北里,1080,1054,290,107,397,33,430
公投第９案,臺南市,南區,喜南里,1081,1245,380,164,544,95,639
公投第９案,臺南市,南區,喜東里,1082,2064,572,254,826,92,918
公投第９案,臺南市,南區,省躬里,1083,2056,569,175,744,27,771
公投第９案,臺南市,南區,省躬里,1084,1373,413,135,548,27,575
公投第９案,臺南市,南區,永寧里,1085,1002,261,106,367,39,406
公投第９案,臺南市,南區,永寧里,1086,760,260,106,366,72,438
公投第９案,臺南市,南區,松安里,1087,1031,338,140,478,82,560
公投第９案,臺南市,南區,松安里,1088,744,256,101,357,52,409
公投第９案,臺南市,南區,佛壇里,1089,1186,430,144,574,66,640
公投第９案,臺南市,南區,佛壇里,1090,1358,481,178,659,83,742
公投第９案,臺南市,南區,同安里,1091,897,257,107,364,29,393
公投第９案,臺南市,南區,同安里,1092,1265,446,143,589,68,657
公投第９案,臺南市,南區,興農里,1093,1093,326,123,449,41,490
公投第９案,臺南市,南區,興農里,1094,1016,404,94,498,34,532
公投第９案,臺南市,東區,崇信里,1095,2681,764,222,986,58,1044
公投第９案,臺南市,東區,崇信里,1096,1811,634,226,860,41,901
公投第９案,臺南市,東區,崇學里,1097,1491,631,215,846,85,931
公投第９案,臺南市,東區,崇學里,1098,1378,544,171,715,41,756
公投第９案,臺南市,東區,崇德里,1099,1552,625,190,815,57,872
公投第９案,臺南市,東區,崇德里,1100,1326,574,160,734,24,758
公投第９案,臺南市,東區,崇德里,1101,1594,622,202,824,70,894
公投第９案,臺南市,東區,崇善里,1102,1639,661,218,879,60,939
公投第９案,臺南市,東區,崇善里,1103,1724,638,219,857,66,923
公投第９案,臺南市,東區,崇善里,1104,1629,631,199,830,77,907
公投第９案,臺南市,東區,崇成里,1105,1399,564,151,715,33,748
公投第９案,臺南市,東區,崇成里,1106,1534,608,169,777,33,810
公投第９案,臺南市,東區,崇文里,1107,1656,669,220,889,43,932
公投第９案,臺南市,東區,崇文里,1108,1322,526,141,667,61,728
公投第９案,臺南市,東區,崇文里,1109,1620,657,184,841,31,872
公投第９案,臺南市,東區,崇文里,1110,1331,636,140,776,34,810
公投第９案,臺南市,東區,東智里,1111,1039,425,113,538,46,584
公投第９案,臺南市,東區,東智里,1112,1257,429,124,553,38,591
公投第９案,臺南市,東區,大智里,1113,2067,722,221,943,104,1047
公投第９案,臺南市,東區,大智里,1114,2153,886,193,1079,36,1115
公投第９案,臺南市,東區,大智里,1115,2363,928,233,1161,63,1224
公投第９案,臺南市,東區,德高里,1116,1427,545,188,733,48,781
公投第９案,臺南市,東區,德高里,1117,1555,633,178,811,40,851
公投第９案,臺南市,東區,仁和里,1118,2115,688,198,886,66,952
公投第９案,臺南市,東區,仁和里,1119,2340,824,247,1071,90,1161
公投第９案,臺南市,東區,和平里,1120,2474,830,293,1123,69,1192
公投第９案,臺南市,東區,和平里,1121,2391,893,273,1166,70,1236
公投第９案,臺南市,東區,虎尾里,1122,1673,634,236,870,49,919
公投第９案,臺南市,東區,虎尾里,1123,1594,578,201,779,47,826
公投第９案,臺南市,東區,虎尾里,1124,1607,673,187,860,60,920
公投第９案,臺南市,東區,裕聖里,1125,2087,898,262,1160,33,1193
公投第９案,臺南市,東區,裕聖里,1126,2369,1021,294,1315,32,1347
公投第９案,臺南市,東區,復興里,1127,1696,616,192,808,100,908
公投第９案,臺南市,東區,復興里,1128,1612,576,216,792,52,844
公投第９案,臺南市,東區,自強里,1129,1708,611,191,802,72,874
公投第９案,臺南市,東區,自強里,1130,1560,618,185,803,50,853
公投第９案,臺南市,東區,自強里,1131,1854,691,221,912,75,987
公投第９案,臺南市,東區,東聖里,1132,2278,761,279,1040,42,1082
公投第９案,臺南市,東區,關聖里,1133,2093,770,215,985,68,1053
公投第９案,臺南市,東區,關聖里,1134,2242,947,266,1213,64,1277
公投第９案,臺南市,東區,南聖里,1135,1152,473,156,629,61,690
公投第９案,臺南市,東區,南聖里,1136,1318,603,169,772,24,796
公投第９案,臺南市,東區,文聖里,1137,2200,855,251,1106,56,1162
公投第９案,臺南市,東區,文聖里,1138,1960,853,237,1090,41,1131
公投第９案,臺南市,東區,後甲里,1139,1489,537,191,728,49,777
公投第９案,臺南市,東區,後甲里,1140,1443,516,205,721,74,795
公投第９案,臺南市,東區,東光里,1141,1498,621,245,866,40,906
公投第９案,臺南市,東區,東光里,1142,1622,645,210,855,22,877
公投第９案,臺南市,東區,東光里,1143,1738,713,215,928,33,961
公投第９案,臺南市,東區,東明里,1144,1501,566,164,730,64,794
公投第９案,臺南市,東區,東明里,1145,1482,471,300,771,58,829
公投第９案,臺南市,東區,莊敬里,1146,1829,641,213,854,34,888
公投第９案,臺南市,東區,莊敬里,1147,1764,699,201,900,52,952
公投第９案,臺南市,東區,小東里,1148,1427,625,158,783,42,825
公投第９案,臺南市,東區,小東里,1149,1427,553,157,710,60,770
公投第９案,臺南市,東區,小東里,1150,1388,580,156,736,45,781
公投第９案,臺南市,東區,大學里,1151,1131,449,199,648,36,684
公投第９案,臺南市,東區,成大里,1152,1000,370,122,492,41,533
公投第９案,臺南市,東區,成大里,1153,996,398,116,514,39,553
公投第９案,臺南市,東區,東門里,1154,935,339,117,456,42,498
公投第９案,臺南市,東區,東門里,1155,947,322,160,482,63,545
公投第９案,臺南市,東區,圍下里,1156,1090,390,172,562,20,582
公投第９案,臺南市,東區,圍下里,1157,896,323,102,425,51,476
公投第９案,臺南市,東區,中西里,1158,1589,572,218,790,27,817
公投第９案,臺南市,東區,中西里,1159,1497,589,210,799,43,842
公投第９案,臺南市,東區,東安里,1160,1386,489,193,682,53,735
公投第９案,臺南市,東區,新東里,1161,1101,430,121,551,24,575
公投第９案,臺南市,東區,新東里,1162,1332,521,184,705,66,771
公投第９案,臺南市,東區,崇誨里,1163,1185,505,116,621,50,671
公投第９案,臺南市,東區,崇誨里,1164,1262,542,139,681,53,734
公投第９案,臺南市,東區,衛國里,1165,1517,556,157,713,46,759
公投第９案,臺南市,東區,裕農里,1166,1287,466,173,639,70,709
公投第９案,臺南市,東區,裕農里,1167,1657,648,197,845,71,916
公投第９案,臺南市,東區,富強里,1168,2238,833,273,1106,104,1210
公投第９案,臺南市,東區,富強里,1169,2246,812,269,1081,69,1150
公投第９案,臺南市,東區,富裕里,1170,2191,782,286,1068,58,1126
公投第９案,臺南市,東區,忠孝里,1171,2063,789,226,1015,59,1074
公投第９案,臺南市,東區,忠孝里,1172,2177,876,286,1162,84,1246
公投第９案,臺南市,東區,崇明里,1173,1863,761,240,1001,73,1074
公投第９案,臺南市,東區,崇明里,1174,2185,905,244,1149,40,1189
公投第９案,臺南市,東區,大福里,1175,1721,571,194,765,46,811
公投第９案,臺南市,東區,大德里,1176,1556,585,189,774,88,862
公投第９案,臺南市,東區,路東里,1177,1602,672,195,867,53,920
公投第９案,臺南市,東區,大同里,1178,1523,554,166,720,80,800
公投第９案,臺南市,東區,大同里,1179,1382,476,168,644,52,696
公投第９案,臺南市,東區,泉南里,1180,1486,545,205,750,36,786
公投第９案,臺南市,東區,泉南里,1181,1560,559,239,798,71,869
公投第９案,臺南市,東區,泉南里,1182,1684,568,198,766,72,838
公投第９案,臺南市,東區,龍山里,1183,1653,645,225,870,40,910
公投第９案,臺南市,東區,龍山里,1184,1554,592,221,813,26,839
公投第９案,臺南市,東區,龍山里,1185,1408,569,189,758,26,784
公投第９案,臺南市,東區,德光里,1186,2084,869,276,1145,39,1184
公投第９案,臺南市,東區,德光里,1187,1896,734,237,971,65,1036
公投第９案,臺南市,仁德區,太子里,1188,1318,498,152,650,71,721
公投第９案,臺南市,仁德區,太子里,1189,1406,533,155,688,80,768
公投第９案,臺南市,仁德區,太子里,1190,1465,517,159,676,86,762
公投第９案,臺南市,仁德區,太子里,1191,1192,463,176,639,78,717
公投第９案,臺南市,仁德區,土庫里,1192,1429,571,183,754,66,820
公投第９案,臺南市,仁德區,土庫里,1193,1320,429,176,605,118,723
公投第９案,臺南市,仁德區,一甲里,1194,1373,588,147,735,92,827
公投第９案,臺南市,仁德區,一甲里,1195,1330,532,168,700,59,759
公投第９案,臺南市,仁德區,仁德里,1196,1687,684,190,874,40,914
公投第９案,臺南市,仁德區,仁德里,1197,1491,529,168,697,57,754
公投第９案,臺南市,仁德區,仁德里,1198,1151,375,122,497,41,538
公投第９案,臺南市,仁德區,仁德里,1199,1407,573,118,691,24,715
公投第９案,臺南市,仁德區,仁德里,1200,1465,609,165,774,53,827
公投第９案,臺南市,仁德區,仁義里,1201,1335,520,178,698,49,747
公投第９案,臺南市,仁德區,仁義里,1202,1490,539,173,712,71,783
公投第９案,臺南市,仁德區,仁義里,1203,1453,628,164,792,58,850
公投第９案,臺南市,仁德區,仁義里,1204,990,328,127,455,27,482
公投第９案,臺南市,仁德區,仁義里,1205,1573,641,175,816,65,881
公投第９案,臺南市,仁德區,仁義里,1206,1031,372,125,497,69,566
公投第９案,臺南市,仁德區,仁義里,1207,1194,436,152,588,32,620
公投第９案,臺南市,仁德區,新田里,1208,1268,459,133,592,60,652
公投第９案,臺南市,仁德區,新田里,1209,929,338,129,467,42,509
公投第９案,臺南市,仁德區,新田里,1210,1145,387,106,493,16,509
公投第９案,臺南市,仁德區,後壁里,1211,1413,500,144,644,61,705
公投第９案,臺南市,仁德區,後壁里,1212,1465,526,171,697,89,786
公投第９案,臺南市,仁德區,後壁里,1213,1390,571,167,738,58,796
公投第９案,臺南市,仁德區,後壁里,1214,1396,486,208,694,70,764
公投第９案,臺南市,仁德區,後壁里,1215,1906,724,221,945,48,993
公投第９案,臺南市,仁德區,後壁里,1216,1546,595,141,736,36,772
公投第９案,臺南市,仁德區,上崙里,1217,1546,492,145,637,33,670
公投第９案,臺南市,仁德區,上崙里,1218,1399,546,146,692,51,743
公投第９案,臺南市,仁德區,上崙里,1219,1748,636,187,823,102,925
公投第９案,臺南市,仁德區,上崙里,1220,1140,458,144,602,43,645
公投第９案,臺南市,仁德區,文賢里,1221,1277,448,121,569,34,603
公投第９案,臺南市,仁德區,文賢里,1222,1019,478,121,599,44,643
公投第９案,臺南市,仁德區,保安里,1223,1414,484,136,620,34,654
公投第９案,臺南市,仁德區,保安里,1224,1349,433,129,562,33,595
公投第９案,臺南市,仁德區,成功里,1225,1471,530,146,676,31,707
公投第９案,臺南市,仁德區,成功里,1226,1324,482,142,624,20,644
公投第９案,臺南市,仁德區,成功里,1227,1310,481,90,571,51,622
公投第９案,臺南市,仁德區,成功里,1228,554,221,73,294,27,321
公投第９案,臺南市,仁德區,仁和里,1229,1395,601,104,705,43,748
公投第９案,臺南市,仁德區,仁愛里,1230,1264,503,98,601,18,619
公投第９案,臺南市,仁德區,二行里,1231,1180,424,105,529,87,616
公投第９案,臺南市,仁德區,二行里,1232,928,276,102,378,31,409
公投第９案,臺南市,仁德區,大甲里,1233,965,294,98,392,25,417
公投第９案,臺南市,仁德區,大甲里,1234,1119,351,110,461,35,496
公投第９案,臺南市,仁德區,中洲里,1235,1206,446,131,577,71,648
公投第９案,臺南市,仁德區,中洲里,1236,1466,474,127,601,44,645
公投第９案,臺南市,歸仁區,南保里,1237,1560,539,184,723,73,796
公投第９案,臺南市,歸仁區,南保里,1238,1383,578,177,755,80,835
公投第９案,臺南市,歸仁區,南保里,1239,1491,540,188,728,39,767
公投第９案,臺南市,歸仁區,南保里,1240,1482,474,180,654,71,725
公投第９案,臺南市,歸仁區,南興里,1241,1330,478,165,643,33,676
公投第９案,臺南市,歸仁區,南興里,1242,1399,560,171,731,49,780
公投第９案,臺南市,歸仁區,南興里,1243,1416,488,155,643,34,677
公投第９案,臺南市,歸仁區,六甲里,1244,1336,371,139,510,48,558
公投第９案,臺南市,歸仁區,六甲里,1245,1183,379,140,519,67,586
公投第９案,臺南市,歸仁區,六甲里,1246,1237,396,142,538,27,565
公投第９案,臺南市,歸仁區,歸南里,1247,1133,437,115,552,77,629
公投第９案,臺南市,歸仁區,歸南里,1248,1149,387,135,522,48,570
公投第９案,臺南市,歸仁區,後市里,1249,1105,416,121,537,7,544
公投第９案,臺南市,歸仁區,後市里,1250,1099,395,148,543,57,600
公投第９案,臺南市,歸仁區,後市里,1251,1082,417,123,540,88,628
公投第９案,臺南市,歸仁區,文化里,1252,1519,673,61,734,57,791
公投第９案,臺南市,歸仁區,文化里,1253,1467,580,181,761,73,834
公投第９案,臺南市,歸仁區,辜厝里,1254,1090,392,128,520,51,571
公投第９案,臺南市,歸仁區,辜厝里,1255,1131,383,131,514,37,551
公投第９案,臺南市,歸仁區,辜厝里,1256,1080,361,115,476,39,515
公投第９案,臺南市,歸仁區,新厝里,1257,1121,352,110,462,28,490
公投第９案,臺南市,歸仁區,新厝里,1258,1336,464,172,636,84,720
公投第９案,臺南市,歸仁區,許厝里,1259,1128,383,156,539,74,613
公投第９案,臺南市,歸仁區,許厝里,1260,1055,382,118,500,27,527
公投第９案,臺南市,歸仁區,許厝里,1261,1102,401,140,541,34,575
公投第９案,臺南市,歸仁區,看西里,1262,1068,417,112,529,49,578
公投第９案,臺南市,歸仁區,看西里,1263,1033,390,129,519,74,593
公投第９案,臺南市,歸仁區,看東里,1264,1772,492,137,629,44,673
公投第９案,臺南市,歸仁區,崙頂里,1265,1399,523,167,690,82,772
公投第９案,臺南市,歸仁區,崙頂里,1266,1544,584,154,738,33,771
公投第９案,臺南市,歸仁區,沙崙里,1267,684,220,58,278,12,290
公投第９案,臺南市,歸仁區,大潭里,1268,839,312,129,441,46,487
公投第９案,臺南市,歸仁區,大潭里,1269,1014,371,147,518,68,586
公投第９案,臺南市,歸仁區,武東里,1270,1906,512,138,650,40,690
公投第９案,臺南市,歸仁區,歸仁里,1271,1245,486,156,642,68,710
公投第９案,臺南市,歸仁區,歸仁里,1272,1048,380,133,513,43,556
公投第９案,臺南市,歸仁區,八甲里,1273,1175,410,127,537,29,566
公投第９案,臺南市,歸仁區,八甲里,1274,1411,473,138,611,31,642
公投第９案,臺南市,歸仁區,七甲里,1275,1514,621,179,800,55,855
公投第９案,臺南市,歸仁區,七甲里,1276,1678,627,199,826,77,903
公投第９案,臺南市,歸仁區,媽廟里,1277,949,354,121,475,31,506
公投第９案,臺南市,歸仁區,媽廟里,1278,1009,376,154,530,65,595
公投第９案,臺南市,歸仁區,西埔里,1279,984,445,131,576,5,581
公投第９案,臺南市,歸仁區,西埔里,1280,756,310,91,401,43,444
公投第９案,臺南市,歸仁區,大廟里,1281,1478,626,176,802,69,871
公投第９案,臺南市,歸仁區,大廟里,1282,1467,607,186,793,72,865
公投第９案,臺南市,關廟區,關廟里,1283,982,344,114,458,27,485
公投第９案,臺南市,關廟區,關廟里,1284,1156,459,157,616,45,661
公投第９案,臺南市,關廟區,山西里,1285,1006,320,111,431,33,464
公投第９案,臺南市,關廟區,山西里,1286,1043,409,162,571,59,630
公投第９案,臺南市,關廟區,香洋里,1287,1012,375,119,494,87,581
公投第９案,臺南市,關廟區,香洋里,1288,1013,312,100,412,23,435
公投第９案,臺南市,關廟區,香洋里,1289,1294,449,154,603,41,644
公投第９案,臺南市,關廟區,北勢里,1290,1264,413,164,577,46,623
公投第９案,臺南市,關廟區,北勢里,1291,1166,413,138,551,41,592
公投第９案,臺南市,關廟區,新埔里,1292,1018,335,107,442,20,462
公投第９案,臺南市,關廟區,新光里,1293,733,226,75,301,40,341
公投第９案,臺南市,關廟區,五甲里,1294,1093,449,129,578,32,610
公投第９案,臺南市,關廟區,五甲里,1295,1081,446,102,548,23,571
公投第９案,臺南市,關廟區,五甲里,1296,978,392,137,529,41,570
公投第９案,臺南市,關廟區,東勢里,1297,1116,358,116,474,31,505
公投第９案,臺南市,關廟區,東勢里,1298,972,353,116,469,48,517
公投第９案,臺南市,關廟區,東勢里,1299,1045,366,147,513,89,602
公投第９案,臺南市,關廟區,松腳里,1300,872,332,95,427,32,459
公投第９案,臺南市,關廟區,松腳里,1301,1007,395,136,531,37,568
公投第９案,臺南市,關廟區,花園里,1302,763,283,115,398,59,457
公投第９案,臺南市,關廟區,花園里,1303,630,240,60,300,34,334
公投第９案,臺南市,關廟區,花園里,1304,959,352,136,488,65,553
公投第９案,臺南市,關廟區,花園里,1305,1123,388,136,524,35,559
公投第９案,臺南市,關廟區,深坑里,1306,804,270,114,384,72,456
公投第９案,臺南市,關廟區,深坑里,1307,720,246,77,323,18,341
公投第９案,臺南市,關廟區,布袋里,1308,843,278,52,330,22,352
公投第９案,臺南市,關廟區,布袋里,1309,358,124,30,154,11,165
公投第９案,臺南市,關廟區,南雄里,1310,797,270,94,364,61,425
公投第９案,臺南市,關廟區,南雄里,1311,709,223,59,282,15,297
公投第９案,臺南市,關廟區,埤頭里,1312,904,277,104,381,20,401
公投第９案,臺南市,關廟區,埤頭里,1313,963,335,103,438,27,465
公投第９案,臺南市,關廟區,下湖里,1314,489,175,60,235,9,244
公投第９案,臺南市,龍崎區,崎頂里,1315,1047,353,113,466,67,533
公投第９案,臺南市,龍崎區,土崎里,1316,630,198,51,249,19,268
公投第９案,臺南市,龍崎區,中坑里,1317,141,34,12,46,3,49
公投第９案,臺南市,龍崎區,楠坑里,1318,367,114,45,159,15,174
公投第９案,臺南市,龍崎區,牛埔里,1319,337,116,34,150,10,160
公投第９案,臺南市,龍崎區,大坪里,1320,318,94,25,119,6,125
公投第９案,臺南市,龍崎區,龍船里,1321,427,162,25,187,26,213
公投第９案,臺南市,龍崎區,石𥕢里,1322,446,120,43,163,14,177
公投第９案,桃園市,桃園區,大林里,1,1593,564,184,748,57,805
公投第９案,桃園市,桃園區,大林里,2,1934,639,186,825,30,855
公投第９案,桃園市,桃園區,大林里,3,1661,686,170,856,59,915
公投第９案,桃園市,桃園區,大林里,4,1448,527,113,640,28,668
公投第９案,桃園市,桃園區,大樹里,5,1974,734,169,903,43,946
公投第９案,桃園市,桃園區,大樹里,6,1882,598,183,781,85,866
公投第９案,桃園市,桃園區,大豐里,7,1800,655,185,840,41,881
公投第９案,桃園市,桃園區,大豐里,8,1598,639,178,817,50,867
公投第９案,桃園市,桃園區,大豐里,9,1626,539,162,701,70,771
公投第９案,桃園市,桃園區,建國里,10,1590,574,142,716,48,764
公投第９案,桃園市,桃園區,建國里,11,1637,589,189,778,55,833
公投第９案,桃園市,桃園區,建國里,12,1943,667,215,882,71,953
公投第９案,桃園市,桃園區,雲林里,13,1482,569,163,732,44,776
公投第９案,桃園市,桃園區,雲林里,14,1423,558,170,728,46,774
公投第９案,桃園市,桃園區,雲林里,15,1509,602,170,772,55,827
公投第９案,桃園市,桃園區,雲林里,16,1567,675,142,817,34,851
公投第９案,桃園市,桃園區,福安里,17,1305,556,110,666,40,706
公投第９案,桃園市,桃園區,福安里,18,1416,514,129,643,39,682
公投第９案,桃園市,桃園區,福安里,19,1439,604,169,773,35,808
公投第９案,桃園市,桃園區,福林里,20,1399,551,182,733,48,781
公投第９案,桃園市,桃園區,福林里,21,1540,648,67,715,48,763
公投第９案,桃園市,桃園區,福林里,22,1638,608,154,762,39,801
公投第９案,桃園市,桃園區,福林里,23,1228,504,116,620,42,662
公投第９案,桃園市,桃園區,豐林里,24,1649,606,153,759,67,826
公投第９案,桃園市,桃園區,豐林里,25,1601,617,184,801,36,837
公投第９案,桃園市,桃園區,豐林里,26,1477,520,163,683,67,750
公投第９案,桃園市,桃園區,豐林里,27,1503,600,149,749,33,782
公投第９案,桃園市,桃園區,中和里,28,1375,532,173,705,89,794
公投第９案,桃園市,桃園區,中興里,29,1743,666,221,887,48,935
公投第９案,桃園市,桃園區,中興里,30,1862,623,219,842,69,911
公投第９案,桃園市,桃園區,中興里,31,1728,660,187,847,59,906
公投第９案,桃園市,桃園區,文化里,32,690,256,86,342,19,361
公投第９案,桃園市,桃園區,文昌里,33,852,364,117,481,33,514
公投第９案,桃園市,桃園區,文明里,34,1353,552,171,723,57,780
公投第９案,桃園市,桃園區,北門里,35,1698,477,129,606,26,632
公投第９案,桃園市,桃園區,民生里,36,1452,514,173,687,52,739
公投第９案,桃園市,桃園區,永興里,37,1681,619,186,805,62,867
公投第９案,桃園市,桃園區,光興里,38,1669,603,191,794,58,852
公投第９案,桃園市,桃園區,光興里,39,1530,622,192,814,56,870
公投第９案,桃園市,桃園區,光興里,40,1582,593,206,799,51,850
公投第９案,桃園市,桃園區,西門里,41,1587,575,147,722,44,766
公投第９案,桃園市,桃園區,西湖里,42,1451,566,176,742,67,809
公投第９案,桃園市,桃園區,武陵里,43,1582,508,166,674,49,723
公投第９案,桃園市,桃園區,長美里,44,1028,397,144,541,41,582
公投第９案,桃園市,桃園區,南門里,45,1934,682,222,904,62,966
公投第９案,桃園市,桃園區,南門里,46,1016,395,105,500,52,552
公投第９案,桃園市,桃園區,南門里,47,1079,412,136,548,35,583
公投第９案,桃園市,桃園區,南門里,48,1837,690,168,858,30,888
公投第９案,桃園市,桃園區,南華里,49,1390,513,176,689,58,747
公投第９案,桃園市,桃園區,中山里,50,1489,612,141,753,39,792
公投第９案,桃園市,桃園區,中山里,51,1821,795,192,987,21,1008
公投第９案,桃園市,桃園區,中山里,52,1563,576,133,709,22,731
公投第９案,桃園市,桃園區,中山里,53,1697,776,125,901,41,942
公投第９案,桃園市,桃園區,中平里,54,1740,722,180,902,37,939
公投第９案,桃園市,桃園區,中平里,55,1626,627,177,804,46,850
公投第９案,桃園市,桃園區,中平里,56,1239,541,131,672,15,687
公投第９案,桃園市,桃園區,中正里,57,1766,710,176,886,49,935
公投第９案,桃園市,桃園區,中正里,58,1555,604,174,778,53,831
公投第９案,桃園市,桃園區,中正里,59,1831,697,209,906,49,955
公投第９案,桃園市,桃園區,中成里,60,1115,477,151,628,37,665
公投第９案,桃園市,桃園區,中成里,61,1562,596,217,813,46,859
公投第９案,桃園市,桃園區,中成里,62,1744,702,148,850,46,896
公投第９案,桃園市,桃園區,中信里,63,1838,628,186,814,45,859
公投第９案,桃園市,桃園區,中信里,64,1889,739,216,955,70,1025
公投第９案,桃園市,桃園區,中信里,65,1985,687,195,882,57,939
公投第９案,桃園市,桃園區,中原里,66,1524,665,164,829,46,875
公投第９案,桃園市,桃園區,中原里,67,1425,655,176,831,41,872
公投第９案,桃園市,桃園區,中原里,68,1606,714,165,879,41,920
公投第９案,桃園市,桃園區,中泰里,69,2056,887,221,1108,33,1141
公投第９案,桃園市,桃園區,中泰里,70,2010,864,207,1071,35,1106
公投第９案,桃園市,桃園區,中聖里,71,2245,850,193,1043,59,1102
公投第９案,桃園市,桃園區,中聖里,72,1590,637,171,808,33,841
公投第９案,桃園市,桃園區,中聖里,73,1536,825,68,893,24,917
公投第９案,桃園市,桃園區,中路里,74,1949,694,194,888,53,941
公投第９案,桃園市,桃園區,中路里,75,1965,739,179,918,50,968
公投第９案,桃園市,桃園區,中德里,76,2414,803,226,1029,60,1089
公投第９案,桃園市,桃園區,中德里,77,1942,742,190,932,60,992
公投第９案,桃園市,桃園區,中德里,78,2156,806,236,1042,71,1113
公投第９案,桃園市,桃園區,文中里,79,1404,542,184,726,49,775
公投第９案,桃園市,桃園區,文中里,80,1194,542,123,665,36,701
公投第９案,桃園市,桃園區,玉山里,81,1449,576,186,762,69,831
公投第９案,桃園市,桃園區,玉山里,82,1803,602,193,795,80,875
公投第９案,桃園市,桃園區,玉山里,83,1692,636,209,845,53,898
公投第９案,桃園市,桃園區,泰山里,84,1913,727,207,934,52,986
公投第９案,桃園市,桃園區,泰山里,85,1815,734,157,891,48,939
公投第９案,桃園市,桃園區,龍山里,86,1173,415,118,533,52,585
公投第９案,桃園市,桃園區,龍山里,87,1162,440,88,528,26,554
公投第９案,桃園市,桃園區,龍山里,88,1194,365,116,481,72,553
公投第９案,桃園市,桃園區,龍安里,89,1695,658,187,845,48,893
公投第９案,桃園市,桃園區,龍安里,90,1797,673,188,861,36,897
公投第９案,桃園市,桃園區,龍安里,91,1592,642,136,778,36,814
公投第９案,桃園市,桃園區,龍岡里,92,1780,650,171,821,78,899
公投第９案,桃園市,桃園區,龍岡里,93,1904,680,153,833,39,872
公投第９案,桃園市,桃園區,龍岡里,94,2021,770,179,949,31,980
公投第９案,桃園市,桃園區,龍祥里,95,1545,603,144,747,48,795
公投第９案,桃園市,桃園區,龍祥里,96,1617,604,145,749,32,781
公投第９案,桃園市,桃園區,龍祥里,97,1683,662,152,814,34,848
公投第９案,桃園市,桃園區,龍壽里,98,1834,750,189,939,59,998
公投第９案,桃園市,桃園區,龍壽里,99,2055,707,214,921,39,960
公投第９案,桃園市,桃園區,龍壽里,100,1828,677,173,850,25,875
公投第９案,桃園市,桃園區,龍鳳里,101,1873,722,166,888,32,920
公投第９案,桃園市,桃園區,龍鳳里,102,3687,587,128,715,35,750
公投第９案,桃園市,桃園區,龍鳳里,103,1850,696,206,902,33,935
公投第９案,桃園市,桃園區,龍鳳里,104,1827,716,153,869,42,911
公投第９案,桃園市,桃園區,中埔里,105,1149,515,129,644,44,688
公投第９案,桃園市,桃園區,中埔里,106,1061,449,130,579,43,622
公投第９案,桃園市,桃園區,中寧里,107,1831,633,178,811,36,847
公投第９案,桃園市,桃園區,中寧里,108,2168,794,218,1012,56,1068
公投第９案,桃園市,桃園區,中寧里,109,1874,693,180,873,33,906
公投第９案,桃園市,桃園區,北埔里,110,1524,530,142,672,29,701
公投第９案,桃園市,桃園區,北埔里,111,1528,623,153,776,32,808
公投第９案,桃園市,桃園區,北埔里,112,1489,629,129,758,46,804
公投第９案,桃園市,桃園區,永安里,113,1308,489,136,625,55,680
公投第９案,桃園市,桃園區,永安里,114,1583,592,57,649,56,705
公投第９案,桃園市,桃園區,永安里,115,1618,633,197,830,50,880
公投第９案,桃園市,桃園區,同安里,116,2127,726,226,952,78,1030
公投第９案,桃園市,桃園區,同安里,117,2033,731,203,934,19,953
公投第９案,桃園市,桃園區,同安里,118,2098,824,193,1017,41,1058
公投第９案,桃園市,桃園區,同安里,119,2126,834,128,962,77,1039
公投第９案,桃園市,桃園區,同德里,120,1917,745,160,905,45,950
公投第９案,桃園市,桃園區,同德里,121,1997,741,176,917,53,970
公投第９案,桃園市,桃園區,同德里,122,1929,771,178,949,48,997
公投第９案,桃園市,桃園區,自強里,123,1691,637,183,820,38,858
公投第９案,桃園市,桃園區,自強里,124,1900,744,172,916,48,964
公投第９案,桃園市,桃園區,自強里,125,1761,689,187,876,59,935
公投第９案,桃園市,桃園區,自強里,126,1922,702,206,908,34,942
公投第９案,桃園市,桃園區,西埔里,127,1995,733,159,892,57,949
公投第９案,桃園市,桃園區,西埔里,128,1063,412,121,533,43,576
公投第９案,桃園市,桃園區,明德里,129,1412,548,136,684,46,730
公投第９案,桃園市,桃園區,明德里,130,1746,699,201,900,23,923
公投第９案,桃園市,桃園區,東埔里,131,1689,612,143,755,57,812
公投第９案,桃園市,桃園區,東埔里,132,1542,477,149,626,38,664
公投第９案,桃園市,桃園區,東埔里,133,1437,547,126,673,51,724
公投第９案,桃園市,桃園區,長安里,134,1679,621,173,794,36,830
公投第９案,桃園市,桃園區,長安里,135,1886,625,198,823,52,875
公投第９案,桃園市,桃園區,長德里,136,1657,656,176,832,59,891
公投第９案,桃園市,桃園區,長德里,137,1349,511,163,674,41,715
公投第９案,桃園市,桃園區,長德里,138,1805,708,184,892,44,936
公投第９案,桃園市,桃園區,信光里,139,1846,657,206,863,69,932
公投第９案,桃園市,桃園區,信光里,140,1644,514,219,733,43,776
公投第９案,桃園市,桃園區,信光里,141,1674,595,154,749,54,803
公投第９案,桃園市,桃園區,信光里,142,1737,647,189,836,46,882
公投第９案,桃園市,桃園區,南埔里,143,1566,605,183,788,48,836
公投第９案,桃園市,桃園區,南埔里,144,1517,611,160,771,39,810
公投第９案,桃園市,桃園區,南埔里,145,1619,556,153,709,32,741
公投第９案,桃園市,桃園區,莊敬里,146,1774,675,189,864,41,905
公投第９案,桃園市,桃園區,莊敬里,147,1666,664,167,831,32,863
公投第９案,桃園市,桃園區,莊敬里,148,1528,612,160,772,22,794
公投第９案,桃園市,桃園區,莊敬里,149,1709,622,196,818,51,869
公投第９案,桃園市,桃園區,莊敬里,150,1719,644,181,825,28,853
公投第９案,桃園市,桃園區,慈文里,151,1569,520,158,678,56,734
公投第９案,桃園市,桃園區,慈文里,152,1505,571,132,703,41,744
公投第９案,桃園市,桃園區,慈文里,153,1496,554,151,705,51,756
公投第９案,桃園市,桃園區,慈文里,154,1505,618,142,760,41,801
公投第９案,桃園市,桃園區,新埔里,155,1807,671,193,864,45,909
公投第９案,桃園市,桃園區,新埔里,156,1857,730,176,906,42,948
公投第９案,桃園市,桃園區,新埔里,157,1589,639,181,820,69,889
公投第９案,桃園市,桃園區,新埔里,158,2088,765,225,990,50,1040
公投第９案,桃園市,桃園區,新埔里,159,1893,730,181,911,35,946
公投第９案,桃園市,桃園區,瑞慶里,160,1303,443,104,547,36,583
公投第９案,桃園市,桃園區,瑞慶里,161,1416,561,153,714,37,751
公投第９案,桃園市,桃園區,瑞慶里,162,1351,499,128,627,35,662
公投第９案,桃園市,桃園區,瑞慶里,163,1659,622,151,773,43,816
公投第９案,桃園市,桃園區,寶安里,164,2103,797,180,977,42,1019
公投第９案,桃園市,桃園區,寶安里,165,1943,755,165,920,42,962
公投第９案,桃園市,桃園區,寶安里,166,1927,727,199,926,48,974
公投第９案,桃園市,桃園區,寶安里,167,1929,689,146,835,46,881
公投第９案,桃園市,桃園區,寶慶里,168,2204,938,243,1181,41,1222
公投第９案,桃園市,桃園區,寶慶里,169,2033,678,218,896,34,930
公投第９案,桃園市,桃園區,寶慶里,170,1656,687,137,824,20,844
公投第９案,桃園市,桃園區,三元里,171,1712,583,204,787,57,844
公投第９案,桃園市,桃園區,三元里,172,1738,630,184,814,57,871
公投第９案,桃園市,桃園區,三民里,173,1432,673,155,828,18,846
公投第９案,桃園市,桃園區,三民里,174,1421,631,153,784,44,828
公投第９案,桃園市,桃園區,三民里,175,1344,519,146,665,27,692
公投第９案,桃園市,桃園區,大有里,176,1942,649,213,862,37,899
公投第９案,桃園市,桃園區,大有里,177,2001,758,197,955,45,1000
公投第９案,桃園市,桃園區,大有里,178,1941,774,61,835,25,860
公投第９案,桃園市,桃園區,大業里,179,1702,649,194,843,46,889
公投第９案,桃園市,桃園區,大業里,180,1589,603,172,775,42,817
公投第９案,桃園市,桃園區,大業里,181,1544,600,151,751,34,785
公投第９案,桃園市,桃園區,大興里,182,1860,591,147,738,42,780
公投第９案,桃園市,桃園區,大興里,183,1726,635,175,810,56,866
公投第９案,桃園市,桃園區,大興里,184,1798,631,189,820,49,869
公投第９案,桃園市,桃園區,成功里,185,1925,719,205,924,39,963
公投第９案,桃園市,桃園區,成功里,186,1945,681,222,903,44,947
公投第９案,桃園市,桃園區,汴洲里,187,1764,587,185,772,53,825
公投第９案,桃園市,桃園區,汴洲里,188,1899,788,174,962,70,1032
公投第９案,桃園市,桃園區,汴洲里,189,1415,540,147,687,23,710
公投第９案,桃園市,桃園區,忠義里,190,1790,651,158,809,42,851
公投第９案,桃園市,桃園區,忠義里,191,1693,617,164,781,28,809
公投第９案,桃園市,桃園區,東山里,192,1916,665,205,870,48,918
公投第９案,桃園市,桃園區,東門里,193,1434,488,147,635,25,660
公投第９案,桃園市,桃園區,東門里,194,1494,609,186,795,39,834
公投第９案,桃園市,桃園區,青溪里,195,1311,490,165,655,63,718
公投第９案,桃園市,桃園區,青溪里,196,1476,542,185,727,43,770
公投第９案,桃園市,桃園區,青溪里,197,1484,598,180,778,53,831
公投第９案,桃園市,桃園區,春日里,198,1514,544,186,730,38,768
公投第９案,桃園市,桃園區,春日里,199,1446,532,150,682,74,756
公投第９案,桃園市,桃園區,春日里,200,1573,595,126,721,22,743
公投第９案,桃園市,桃園區,春日里,201,1564,538,150,688,36,724
公投第９案,桃園市,桃園區,朝陽里,202,1015,393,135,528,42,570
公投第９案,桃園市,桃園區,朝陽里,203,955,344,108,452,30,482
公投第９案,桃園市,桃園區,會稽里,204,1796,673,185,858,37,895
公投第９案,桃園市,桃園區,會稽里,205,1878,719,161,880,23,903
公投第９案,桃園市,桃園區,會稽里,206,1729,631,170,801,41,842
公投第９案,桃園市,桃園區,會稽里,207,1843,622,161,783,30,813
公投第９案,桃園市,桃園區,會稽里,208,1817,614,137,751,32,783
公投第９案,桃園市,桃園區,萬壽里,209,979,381,130,511,41,552
公投第９案,桃園市,桃園區,福元里,210,1363,535,156,691,34,725
公投第９案,桃園市,桃園區,福元里,211,1546,608,136,744,20,764
公投第９案,桃園市,桃園區,福元里,212,1308,518,107,625,31,656
公投第９案,桃園市,桃園區,寶山里,213,2164,783,222,1005,61,1066
公投第９案,桃園市,桃園區,寶山里,214,2020,692,213,905,63,968
公投第９案,桃園市,桃園區,寶山里,215,1924,645,157,802,52,854
公投第９案,桃園市,桃園區,寶山里,216,2088,701,196,897,41,938
公投第９案,桃園市,龜山區,精忠里,217,874,390,65,455,27,482
公投第９案,桃園市,龜山區,精忠里,218,2014,825,170,995,79,1074
公投第９案,桃園市,龜山區,精忠里,219,2145,796,204,1000,35,1035
公投第９案,桃園市,龜山區,陸光里,220,1744,785,106,891,58,949
公投第９案,桃園市,龜山區,陸光里,221,1885,770,154,924,58,982
公投第９案,桃園市,龜山區,中興里,222,1546,524,162,686,66,752
公投第９案,桃園市,龜山區,中興里,223,1684,592,173,765,71,836
公投第９案,桃園市,龜山區,中興里,224,1477,469,151,620,44,664
公投第９案,桃園市,龜山區,新興里,225,1528,664,135,799,58,857
公投第９案,桃園市,龜山區,新興里,226,1428,215,61,276,15,291
公投第９案,桃園市,龜山區,新路里,227,1525,609,169,778,62,840
公投第９案,桃園市,龜山區,新路里,228,1041,413,138,551,59,610
公投第９案,桃園市,龜山區,新路里,229,1404,496,150,646,36,682
公投第９案,桃園市,龜山區,新路里,230,1478,590,163,753,58,811
公投第９案,桃園市,龜山區,龜山里,231,2178,812,232,1044,64,1108
公投第９案,桃園市,龜山區,龜山里,232,1672,611,211,822,72,894
公投第９案,桃園市,龜山區,龜山里,233,1376,520,119,639,42,681
公投第９案,桃園市,龜山區,龜山里,234,1480,519,182,701,49,750
公投第９案,桃園市,龜山區,大同里,235,1258,505,146,651,40,691
公投第９案,桃園市,龜山區,大同里,236,1464,569,146,715,23,738
公投第９案,桃園市,龜山區,大同里,237,1844,625,202,827,95,922
公投第９案,桃園市,龜山區,大同里,238,1169,460,118,578,26,604
公投第９案,桃園市,龜山區,山頂里,239,1921,546,155,701,34,735
公投第９案,桃園市,龜山區,山頂里,240,1694,576,190,766,30,796
公投第９案,桃園市,龜山區,山頂里,241,1771,703,211,914,67,981
公投第９案,桃園市,龜山區,山德里,242,1665,546,182,728,61,789
公投第９案,桃園市,龜山區,山德里,243,1439,481,166,647,87,734
公投第９案,桃園市,龜山區,山德里,244,1728,546,158,704,70,774
公投第９案,桃園市,龜山區,山福里,245,1788,722,168,890,36,926
公投第９案,桃園市,龜山區,山福里,246,1465,498,146,644,52,696
公投第９案,桃園市,龜山區,幸福里,247,1659,509,144,653,37,690
公投第９案,桃園市,龜山區,幸福里,248,1693,538,153,691,34,725
公投第９案,桃園市,龜山區,幸福里,249,1818,512,140,652,26,678
公投第９案,桃園市,龜山區,龍壽里,250,1752,626,189,815,69,884
公投第９案,桃園市,龜山區,龍華里,251,1818,601,244,845,41,886
公投第９案,桃園市,龜山區,龍華里,252,1499,549,160,709,23,732
公投第９案,桃園市,龜山區,迴龍里,253,1916,714,187,901,53,954
公投第９案,桃園市,龜山區,迴龍里,254,1804,593,210,803,61,864
公投第９案,桃園市,龜山區,迴龍里,255,2127,720,236,956,36,992
公投第９案,桃園市,龜山區,嶺頂里,256,1005,351,134,485,49,534
公投第９案,桃園市,龜山區,嶺頂里,257,1449,578,162,740,39,779
公投第９案,桃園市,龜山區,嶺頂里,258,1498,481,177,658,61,719
公投第９案,桃園市,龜山區,新嶺里,259,2149,666,234,900,55,955
公投第９案,桃園市,龜山區,新嶺里,260,1771,487,137,624,30,654
公投第９案,桃園市,龜山區,兔坑里,261,841,299,95,394,34,428
公投第９案,桃園市,龜山區,兔坑里,262,2284,716,234,950,96,1046
公投第９案,桃園市,龜山區,兔坑里,263,1228,441,134,575,65,640
公投第９案,桃園市,龜山區,福源里,264,1979,574,150,724,56,780
公投第９案,桃園市,龜山區,舊路里,265,1378,433,146,579,40,619
公投第９案,桃園市,龜山區,舊路里,266,1061,365,119,484,49,533
公投第９案,桃園市,龜山區,大坑里,267,1917,666,175,841,62,903
公投第９案,桃園市,龜山區,楓福里,268,1540,674,188,862,42,904
公投第９案,桃園市,龜山區,楓福里,269,1433,627,119,746,28,774
公投第９案,桃園市,龜山區,楓樹里,270,1455,515,189,704,22,726
公投第９案,桃園市,龜山區,楓樹里,271,2280,876,269,1145,71,1216
公投第９案,桃園市,龜山區,樂善里,272,1668,594,204,798,43,841
公投第９案,桃園市,龜山區,樂善里,273,1885,656,185,841,43,884
公投第９案,桃園市,龜山區,長庚里,274,1849,682,186,868,28,896
公投第９案,桃園市,龜山區,長庚里,275,1704,654,258,912,30,942
公投第９案,桃園市,龜山區,公西里,276,1156,427,154,581,36,617
公投第９案,桃園市,龜山區,大崗里,277,2114,620,200,820,64,884
公投第９案,桃園市,龜山區,大崗里,278,1943,597,187,784,35,819
公投第９案,桃園市,龜山區,大湖里,279,1800,610,198,808,26,834
公投第９案,桃園市,龜山區,大湖里,280,2020,691,225,916,53,969
公投第９案,桃園市,龜山區,大湖里,281,1319,530,164,694,35,729
公投第９案,桃園市,龜山區,大華里,282,2229,856,265,1121,43,1164
公投第９案,桃園市,龜山區,大華里,283,1992,718,189,907,31,938
公投第９案,桃園市,龜山區,大華里,284,2237,787,206,993,59,1052
公投第９案,桃園市,龜山區,大華里,285,2133,805,192,997,31,1028
公投第９案,桃園市,龜山區,文化里,286,2187,773,267,1040,65,1105
公投第９案,桃園市,龜山區,文化里,287,1959,701,205,906,47,953
公投第９案,桃園市,龜山區,文化里,288,1910,623,204,827,41,868
公投第９案,桃園市,龜山區,南上里,289,1840,653,221,874,105,979
公投第９案,桃園市,龜山區,南美里,290,2266,852,228,1080,51,1131
公投第９案,桃園市,龜山區,文青里,291,2387,864,166,1030,29,1059
公投第９案,桃園市,龜山區,文青里,292,1692,596,153,749,36,785
公投第９案,桃園市,龜山區,文青里,293,904,348,98,446,14,460
公投第９案,桃園市,龜山區,文青里,294,1469,606,146,752,30,782
公投第９案,桃園市,八德區,興仁里,295,1761,582,173,755,74,829
公投第９案,桃園市,八德區,興仁里,296,1804,643,62,705,17,722
公投第９案,桃園市,八德區,興仁里,297,1813,362,112,474,36,510
公投第９案,桃園市,八德區,興仁里,298,1784,618,150,768,37,805
公投第９案,桃園市,八德區,福興里,299,2257,741,165,906,43,949
公投第９案,桃園市,八德區,福興里,300,1857,575,135,710,37,747
公投第９案,桃園市,八德區,福興里,301,2261,761,192,953,42,995
公投第９案,桃園市,八德區,福興里,302,1903,738,194,932,54,986
公投第９案,桃園市,八德區,瑞豐里,303,1955,734,197,931,46,977
公投第９案,桃園市,八德區,瑞豐里,304,1665,553,140,693,11,704
公投第９案,桃園市,八德區,瑞興里,305,1431,550,170,720,61,781
公投第９案,桃園市,八德區,瑞興里,306,1263,511,137,648,37,685
公投第９案,桃園市,八德區,瑞泰里,307,1583,643,168,811,71,882
公投第９案,桃園市,八德區,瑞泰里,308,1246,523,126,649,35,684
公投第９案,桃園市,八德區,瑞泰里,309,1356,547,142,689,32,721
公投第９案,桃園市,八德區,瑞發里,310,1630,655,175,830,74,904
公投第９案,桃園市,八德區,瑞發里,311,1586,558,120,678,42,720
公投第９案,桃園市,八德區,瑞德里,312,1649,608,165,773,88,861
公投第９案,桃園市,八德區,瑞德里,313,1910,643,161,804,87,891
公投第９案,桃園市,八德區,瑞祥里,314,1612,637,167,804,88,892
公投第９案,桃園市,八德區,瑞祥里,315,1640,660,140,800,47,847
公投第９案,桃園市,八德區,廣德里,316,1303,476,149,625,38,663
公投第９案,桃園市,八德區,廣德里,317,1413,599,149,748,61,809
公投第９案,桃園市,八德區,廣興里,318,1711,644,167,811,55,866
公投第９案,桃園市,八德區,廣興里,319,1562,614,136,750,83,833
公投第９案,桃園市,八德區,廣隆里,320,1735,693,137,830,52,882
公投第９案,桃園市,八德區,廣隆里,321,1658,643,156,799,45,844
公投第９案,桃園市,八德區,廣隆里,322,1022,445,118,563,49,612
公投第９案,桃園市,八德區,竹園里,323,1673,562,149,711,54,765
公投第９案,桃園市,八德區,竹園里,324,1741,648,150,798,37,835
公投第９案,桃園市,八德區,霄裡里,325,2110,799,189,988,78,1066
公投第９案,桃園市,八德區,龍友里,326,1145,480,97,577,27,604
公投第９案,桃園市,八德區,龍友里,327,1010,458,105,563,37,600
公投第９案,桃園市,八德區,茄明里,328,1848,610,157,767,27,794
公投第９案,桃園市,八德區,茄明里,329,1334,543,123,666,52,718
公投第９案,桃園市,八德區,茄明里,330,1349,449,107,556,27,583
公投第９案,桃園市,八德區,茄苳里,331,1341,569,150,719,42,761
公投第９案,桃園市,八德區,茄苳里,332,1178,504,122,626,55,681
公投第９案,桃園市,八德區,永豐里,333,1374,541,154,695,50,745
公投第９案,桃園市,八德區,永豐里,334,1462,490,173,663,72,735
公投第９案,桃園市,八德區,高明里,335,1943,596,176,772,71,843
公投第９案,桃園市,八德區,高明里,336,1928,528,161,689,73,762
公投第９案,桃園市,八德區,高城里,337,1403,463,155,618,32,650
公投第９案,桃園市,八德區,高城里,338,1672,580,159,739,63,802
公投第９案,桃園市,八德區,白鷺里,339,1947,636,202,838,53,891
公投第９案,桃園市,八德區,白鷺里,340,1200,491,121,612,45,657
公投第９案,桃園市,八德區,大湳里,341,1895,628,188,816,76,892
公投第９案,桃園市,八德區,大湳里,342,1988,646,203,849,66,915
公投第９案,桃園市,八德區,大發里,343,2006,737,220,957,83,1040
公投第９案,桃園市,八德區,大仁里,344,2061,696,187,883,13,896
公投第９案,桃園市,八德區,大仁里,345,2108,682,211,893,72,965
公投第９案,桃園市,八德區,大明里,346,1862,671,165,836,51,887
公投第９案,桃園市,八德區,大明里,347,1681,641,143,784,35,819
公投第９案,桃園市,八德區,大安里,348,1317,493,157,650,60,710
公投第９案,桃園市,八德區,大安里,349,2093,872,222,1094,68,1162
公投第９案,桃園市,八德區,大竹里,350,1499,605,184,789,63,852
公投第９案,桃園市,八德區,大興里,351,1782,677,180,857,52,909
公投第９案,桃園市,八德區,大興里,352,1763,683,180,863,31,894
公投第９案,桃園市,八德區,大愛里,353,1226,474,149,623,58,681
公投第９案,桃園市,八德區,大愛里,354,1311,547,135,682,40,722
公投第９案,桃園市,八德區,大華里,355,1170,500,123,623,38,661
公投第９案,桃園市,八德區,大華里,356,1313,561,114,675,37,712
公投第９案,桃園市,八德區,大順里,357,1186,510,111,621,28,649
公投第９案,桃園市,八德區,大順里,358,1481,539,134,673,48,721
公投第９案,桃園市,八德區,大和里,359,1998,765,193,958,62,1020
公投第９案,桃園市,八德區,大和里,360,916,385,94,479,31,510
公投第９案,桃園市,八德區,大和里,361,1943,705,169,874,55,929
公投第９案,桃園市,八德區,大和里,362,2076,818,135,953,42,995
公投第９案,桃園市,八德區,大昌里,363,1363,525,145,670,59,729
公投第９案,桃園市,八德區,大昌里,364,1491,579,158,737,52,789
公投第９案,桃園市,八德區,大信里,365,1474,555,157,712,71,783
公投第９案,桃園市,八德區,大信里,366,718,133,31,164,10,174
公投第９案,桃園市,八德區,大信里,367,1386,519,166,685,50,735
公投第９案,桃園市,八德區,陸光里,368,1487,574,129,703,71,774
公投第９案,桃園市,八德區,陸光里,369,1552,604,126,730,82,812
公投第９案,桃園市,八德區,陸光里,370,1255,446,98,544,71,615
公投第９案,桃園市,八德區,大同里,371,1505,628,151,779,58,837
公投第９案,桃園市,八德區,大慶里,372,1436,487,149,636,65,701
公投第９案,桃園市,八德區,大成里,373,1618,617,191,808,70,878
公投第９案,桃園市,八德區,大成里,374,1685,637,146,783,72,855
公投第９案,桃園市,八德區,大義里,375,1835,629,158,787,54,841
公投第９案,桃園市,八德區,大義里,376,1881,698,172,870,74,944
公投第９案,桃園市,八德區,大忠里,377,1766,630,158,788,46,834
公投第９案,桃園市,八德區,大智里,378,1817,639,192,831,87,918
公投第９案,桃園市,八德區,大智里,379,2198,923,174,1097,34,1131
公投第９案,桃園市,八德區,大宏里,380,1732,691,160,851,44,895
公投第９案,桃園市,八德區,大宏里,381,2089,840,197,1037,40,1077
公投第９案,桃園市,八德區,大正里,382,1257,504,135,639,37,676
公投第９案,桃園市,八德區,大正里,383,1267,464,135,599,56,655
公投第９案,桃園市,八德區,大正里,384,1427,634,111,745,22,767
公投第９案,桃園市,八德區,大福里,385,1685,718,199,917,53,970
公投第９案,桃園市,八德區,大福里,386,1748,688,196,884,60,944
公投第９案,桃園市,八德區,大福里,387,1650,906,167,1073,52,1125
公投第９案,桃園市,八德區,大強里,388,1478,579,154,733,54,787
公投第９案,桃園市,八德區,大強里,389,1607,657,155,812,53,865
公投第９案,桃園市,八德區,大勇里,390,1841,710,190,900,118,1018
公投第９案,桃園市,八德區,大勇里,391,2082,785,267,1052,13,1065
公投第９案,桃園市,八德區,大榮里,392,1959,641,192,833,66,899
公投第９案,桃園市,八德區,大千里,393,2209,849,222,1071,57,1128
公投第９案,桃園市,八德區,大漢里,394,1864,774,150,924,50,974
公投第９案,桃園市,八德區,大漢里,395,2000,710,194,904,68,972
公投第９案,桃園市,蘆竹區,新興里,396,1358,458,151,609,94,703
公投第９案,桃園市,蘆竹區,新興里,397,1538,493,192,685,88,773
公投第９案,桃園市,蘆竹區,中福里,398,2118,628,189,817,70,887
公投第９案,桃園市,蘆竹區,中福里,399,1673,677,182,859,69,928
公投第９案,桃園市,蘆竹區,上興里,400,1500,597,149,746,34,780
公投第９案,桃園市,蘆竹區,上興里,401,1699,677,176,853,54,907
公投第９案,桃園市,蘆竹區,中興里,402,2250,891,188,1079,58,1137
公投第９案,桃園市,蘆竹區,中興里,403,2354,806,200,1006,29,1035
公投第９案,桃園市,蘆竹區,新莊里,404,1446,492,126,618,32,650
公投第９案,桃園市,蘆竹區,新莊里,405,1623,527,166,693,62,755
公投第９案,桃園市,蘆竹區,新莊里,406,1747,628,155,783,37,820
公投第９案,桃園市,蘆竹區,上竹里,407,1988,720,226,946,73,1019
公投第９案,桃園市,蘆竹區,上竹里,408,1437,569,136,705,49,754
公投第９案,桃園市,蘆竹區,宏竹里,409,1532,596,187,783,69,852
公投第９案,桃園市,蘆竹區,宏竹里,410,1447,516,132,648,43,691
公投第９案,桃園市,蘆竹區,大竹里,411,2189,804,217,1021,66,1087
公投第９案,桃園市,蘆竹區,大竹里,412,2498,890,200,1090,64,1154
公投第９案,桃園市,蘆竹區,富竹里,413,1322,557,100,657,33,690
公投第９案,桃園市,蘆竹區,蘆竹里,414,1991,599,190,789,92,881
公投第９案,桃園市,蘆竹區,蘆竹里,415,2097,712,198,910,80,990
公投第９案,桃園市,蘆竹區,南興里,416,1558,628,176,804,43,847
公投第９案,桃園市,蘆竹區,南興里,417,1891,754,188,942,45,987
公投第９案,桃園市,蘆竹區,南興里,418,1590,568,164,732,40,772
公投第９案,桃園市,蘆竹區,福昌里,419,2404,788,230,1018,56,1074
公投第９案,桃園市,蘆竹區,福昌里,420,2522,979,222,1201,48,1249
公投第９案,桃園市,蘆竹區,福興里,421,1633,628,176,804,37,841
公投第９案,桃園市,蘆竹區,福興里,422,1715,664,169,833,48,881
公投第９案,桃園市,蘆竹區,正興里,423,2215,713,231,944,30,974
公投第９案,桃園市,蘆竹區,正興里,424,2029,734,204,938,42,980
公投第９案,桃園市,蘆竹區,順興里,425,1731,607,183,790,44,834
公投第９案,桃園市,蘆竹區,順興里,426,1820,702,182,884,38,922
公投第９案,桃園市,蘆竹區,蘆興里,427,1633,634,180,814,61,875
公投第９案,桃園市,蘆竹區,南榮里,428,1668,515,173,688,25,713
公投第９案,桃園市,蘆竹區,南榮里,429,1493,638,138,776,33,809
公投第９案,桃園市,蘆竹區,南崁里,430,1864,685,218,903,61,964
公投第９案,桃園市,蘆竹區,南崁里,431,1703,593,165,758,29,787
公投第９案,桃園市,蘆竹區,錦興里,432,1893,672,187,859,44,903
公投第９案,桃園市,蘆竹區,錦興里,433,1922,741,245,986,71,1057
公投第９案,桃園市,蘆竹區,興榮里,434,1393,553,147,700,40,740
公投第９案,桃園市,蘆竹區,興榮里,435,1338,521,171,692,42,734
公投第９案,桃園市,蘆竹區,錦中里,436,1688,667,153,820,35,855
公投第９案,桃園市,蘆竹區,錦中里,437,1462,516,180,696,57,753
公投第９案,桃園市,蘆竹區,長興里,438,1232,442,132,574,31,605
公投第９案,桃園市,蘆竹區,長興里,439,1356,483,116,599,45,644
公投第９案,桃園市,蘆竹區,五福里,440,1181,543,117,660,51,711
公投第９案,桃園市,蘆竹區,五福里,441,1199,473,113,586,22,608
公投第９案,桃園市,蘆竹區,中山里,442,1710,691,198,889,27,916
公投第９案,桃園市,蘆竹區,中山里,443,1423,552,130,682,41,723
公投第９案,桃園市,蘆竹區,福祿里,444,1522,592,179,771,44,815
公投第９案,桃園市,蘆竹區,福祿里,445,1639,647,193,840,34,874
公投第９案,桃園市,蘆竹區,羊稠里,446,2055,769,205,974,52,1026
公投第９案,桃園市,蘆竹區,羊稠里,447,2178,805,243,1048,38,1086
公投第９案,桃園市,蘆竹區,吉祥里,448,1709,672,195,867,44,911
公投第９案,桃園市,蘆竹區,長壽里,449,1667,697,167,864,53,917
公投第９案,桃園市,蘆竹區,長壽里,450,1745,737,166,903,35,938
公投第９案,桃園市,蘆竹區,長壽里,451,1967,815,207,1022,48,1070
公投第９案,桃園市,蘆竹區,吉祥里,452,1802,755,205,960,35,995
公投第９案,桃園市,蘆竹區,營盤里,453,2727,1006,253,1259,52,1311
公投第９案,桃園市,蘆竹區,營盤里,454,1868,649,176,825,38,863
公投第９案,桃園市,蘆竹區,營福里,455,1537,567,172,739,39,778
公投第９案,桃園市,蘆竹區,營福里,456,1616,605,201,806,38,844
公投第９案,桃園市,蘆竹區,瓦窯里,457,1483,619,183,802,54,856
公投第９案,桃園市,蘆竹區,瓦窯里,458,1689,647,150,797,50,847
公投第９案,桃園市,蘆竹區,內厝里,459,1318,395,109,504,56,560
公投第９案,桃園市,蘆竹區,內厝里,460,1203,503,159,662,95,757
公投第９案,桃園市,蘆竹區,山鼻里,461,1771,603,168,771,30,801
公投第９案,桃園市,蘆竹區,山腳里,462,1832,531,203,734,95,829
公投第９案,桃園市,蘆竹區,山腳里,463,1763,587,206,793,100,893
公投第９案,桃園市,蘆竹區,外社里,464,1497,526,53,579,20,599
公投第９案,桃園市,蘆竹區,坑子里,465,1671,671,196,867,121,988
公投第９案,桃園市,蘆竹區,坑口里,466,929,341,112,453,80,533
公投第９案,桃園市,蘆竹區,坑口里,467,1559,533,217,750,120,870
公投第９案,桃園市,蘆竹區,海湖里,468,1497,568,134,702,37,739
公投第９案,桃園市,蘆竹區,海湖里,469,1441,619,208,827,84,911
公投第９案,桃園市,蘆竹區,濱海里,470,1465,508,161,669,67,736
公投第９案,桃園市,蘆竹區,濱海里,471,1029,344,128,472,56,528
公投第９案,桃園市,大園區,大園里,472,1538,497,152,649,55,704
公投第９案,桃園市,大園區,大園里,473,1616,480,130,610,30,640
公投第９案,桃園市,大園區,大園里,474,1437,580,172,752,56,808
公投第９案,桃園市,大園區,大園里,475,1554,641,153,794,45,839
公投第９案,桃園市,大園區,田心里,476,1237,459,137,596,46,642
公投第９案,桃園市,大園區,田心里,477,1347,490,147,637,58,695
公投第９案,桃園市,大園區,田心里,478,1261,456,124,580,30,610
公投第９案,桃園市,大園區,田心里,479,1256,481,113,594,41,635
公投第９案,桃園市,大園區,田心里,480,1370,470,121,591,31,622
公投第９案,桃園市,大園區,溪海里,481,1610,520,171,691,47,738
公投第９案,桃園市,大園區,溪海里,482,1419,494,160,654,52,706
公投第９案,桃園市,大園區,溪海里,483,1588,466,127,593,26,619
公投第９案,桃園市,大園區,和平里,484,1612,594,158,752,50,802
公投第９案,桃園市,大園區,橫峰里,485,1440,510,155,665,47,712
公投第９案,桃園市,大園區,橫峰里,486,1326,438,157,595,49,644
公投第９案,桃園市,大園區,橫峰里,487,1455,605,156,761,57,818
公投第９案,桃園市,大園區,橫峰里,488,1562,611,166,777,60,837
公投第９案,桃園市,大園區,橫峰里,489,1284,541,136,677,36,713
公投第９案,桃園市,大園區,橫峰里,490,1454,525,142,667,20,687
公投第９案,桃園市,大園區,橫峰里,491,1490,599,137,736,22,758
公投第９案,桃園市,大園區,五權里,492,1617,516,151,667,47,714
公投第９案,桃園市,大園區,五權里,493,1594,558,181,739,86,825
公投第９案,桃園市,大園區,五權里,494,1650,614,172,786,58,844
公投第９案,桃園市,大園區,埔心里,495,1467,495,144,639,25,664
公投第９案,桃園市,大園區,埔心里,496,1494,540,163,703,37,740
公投第９案,桃園市,大園區,埔心里,497,1538,561,149,710,62,772
公投第９案,桃園市,大園區,埔心里,498,1397,506,140,646,27,673
公投第９案,桃園市,大園區,大海里,499,1637,572,155,727,29,756
公投第９案,桃園市,大園區,三石里,500,1452,498,143,641,58,699
公投第９案,桃園市,大園區,三石里,501,1414,587,164,751,58,809
公投第９案,桃園市,大園區,菓林里,502,1670,588,166,754,49,803
公投第９案,桃園市,大園區,菓林里,503,1701,568,52,620,28,648
公投第９案,桃園市,大園區,菓林里,504,1813,542,156,698,39,737
公投第９案,桃園市,大園區,菓林里,505,1687,552,168,720,46,766
公投第９案,桃園市,大園區,竹圍里,506,1650,652,148,800,16,816
公投第９案,桃園市,大園區,竹圍里,507,1556,649,166,815,49,864
公投第９案,桃園市,大園區,海口里,508,1844,575,192,767,44,811
公投第９案,桃園市,大園區,沙崙里,509,1336,451,142,593,60,653
公投第９案,桃園市,大園區,沙崙里,510,1414,521,199,720,64,784
公投第９案,桃園市,大園區,後厝里,511,1238,529,145,674,62,736
公投第９案,桃園市,大園區,後厝里,512,1227,518,166,684,57,741
公投第９案,桃園市,大園區,圳頭里,513,1199,414,134,548,29,577
公投第９案,桃園市,大園區,圳頭里,514,1349,424,153,577,26,603
公投第９案,桃園市,大園區,內海里,515,1120,414,112,526,29,555
公投第９案,桃園市,大園區,內海里,516,1080,398,120,518,28,546
公投第９案,桃園市,大園區,北港里,517,1341,475,136,611,46,657
公投第９案,桃園市,大園區,北港里,518,1345,502,168,670,41,711
公投第９案,桃園市,大園區,南港里,519,1565,518,139,657,48,705
公投第９案,桃園市,大園區,南港里,520,1519,504,130,634,23,657
公投第９案,桃園市,大園區,南港里,521,2130,726,200,926,59,985
公投第９案,桃園市,大溪區,興和里,522,1477,549,207,756,68,824
公投第９案,桃園市,大溪區,福仁里,523,1006,372,123,495,48,543
公投第９案,桃園市,大溪區,田心里,524,1553,563,171,734,81,815
公投第９案,桃園市,大溪區,田心里,525,1597,614,184,798,76,874
公投第９案,桃園市,大溪區,田心里,526,1358,493,168,661,66,727
公投第９案,桃園市,大溪區,一心里,527,1585,526,170,696,55,751
公投第９案,桃園市,大溪區,一心里,528,1612,606,187,793,43,836
公投第９案,桃園市,大溪區,一心里,529,1555,506,164,670,35,705
公投第９案,桃園市,大溪區,一德里,530,1282,558,169,727,43,770
公投第９案,桃園市,大溪區,一德里,531,1392,536,136,672,60,732
公投第９案,桃園市,大溪區,一德里,532,1422,478,184,662,57,719
公投第９案,桃園市,大溪區,一德里,533,1448,535,181,716,72,788
公投第９案,桃園市,大溪區,月眉里,534,1269,539,179,718,57,775
公投第９案,桃園市,大溪區,永福里,535,977,334,175,509,82,591
公投第９案,桃園市,大溪區,康安里,536,1359,520,175,695,58,753
公投第９案,桃園市,大溪區,義和里,537,1135,436,181,617,69,686
公投第９案,桃園市,大溪區,義和里,538,660,233,83,316,36,352
公投第９案,桃園市,大溪區,美華里,539,1056,351,133,484,38,522
公投第９案,桃園市,大溪區,美華里,540,1263,479,115,594,58,652
公投第９案,桃園市,大溪區,美華里,541,717,255,96,351,45,396
公投第９案,桃園市,大溪區,福安里,542,1299,364,143,507,25,532
公投第９案,桃園市,大溪區,福安里,543,976,377,106,483,56,539
公投第９案,桃園市,大溪區,復興里,544,938,348,103,451,52,503
公投第９案,桃園市,大溪區,新峰里,545,832,268,92,360,45,405
公投第９案,桃園市,大溪區,中新里,546,866,291,69,360,25,385
公投第９案,桃園市,大溪區,中新里,547,694,214,84,298,33,331
公投第９案,桃園市,大溪區,瑞興里,548,1410,451,169,620,42,662
公投第９案,桃園市,大溪區,瑞興里,549,1303,450,130,580,66,646
公投第９案,桃園市,大溪區,仁善里,550,1125,424,112,536,53,589
公投第９案,桃園市,大溪區,仁善里,551,1170,494,104,598,36,634
公投第９案,桃園市,大溪區,仁善里,552,1308,549,168,717,45,762
公投第９案,桃園市,大溪區,仁美里,553,1094,422,132,554,65,619
公投第９案,桃園市,大溪區,仁美里,554,2153,825,261,1086,59,1145
公投第９案,桃園市,大溪區,僑愛里,555,1173,540,91,631,46,677
公投第９案,桃園市,大溪區,僑愛里,556,1369,544,129,673,28,701
公投第９案,桃園市,大溪區,仁義里,557,1446,556,125,681,64,745
公投第９案,桃園市,大溪區,仁義里,558,1406,483,90,573,53,626
公投第９案,桃園市,大溪區,仁和里,559,1592,674,150,824,35,859
公投第９案,桃園市,大溪區,仁和里,560,1497,607,174,781,72,853
公投第９案,桃園市,大溪區,仁和里,561,1559,602,198,800,86,886
公投第９案,桃園市,大溪區,仁愛里,562,1684,653,148,801,24,825
公投第９案,桃園市,大溪區,仁愛里,563,1959,819,91,910,66,976
公投第９案,桃園市,大溪區,仁愛里,564,1369,552,154,706,73,779
公投第９案,桃園市,大溪區,仁武里,565,1431,590,141,731,66,797
公投第９案,桃園市,大溪區,仁武里,566,1657,492,129,621,32,653
公投第９案,桃園市,大溪區,仁文里,567,1387,426,139,565,28,593
公投第９案,桃園市,大溪區,仁文里,568,1085,410,109,519,50,569
公投第９案,桃園市,大溪區,仁文里,569,1403,577,164,741,54,795
公投第９案,桃園市,大溪區,南興里,570,1511,524,178,702,82,784
公投第９案,桃園市,大溪區,南興里,571,1719,507,202,709,88,797
公投第９案,桃園市,大溪區,南興里,572,1717,535,164,699,94,793
公投第９案,桃園市,大溪區,光明里,573,1207,433,141,574,76,650
公投第９案,桃園市,大溪區,光明里,574,1188,473,127,600,72,672
公投第９案,桃園市,大溪區,員林里,575,1514,516,159,675,33,708
公投第９案,桃園市,大溪區,三元里,576,1529,634,145,779,75,854
公投第９案,桃園市,大溪區,三元里,577,1260,545,154,699,43,742
公投第９案,桃園市,大溪區,瑞源里,578,831,360,92,452,19,471
公投第９案,桃園市,大溪區,瑞源里,579,1407,575,147,722,59,781
公投第９案,桃園市,大溪區,瑞源里,580,1494,509,142,651,70,721
公投第９案,桃園市,復興區,三民里,581,1991,766,224,990,111,1101
公投第９案,桃園市,復興區,澤仁里,582,1392,531,159,690,93,783
公投第９案,桃園市,復興區,霞雲里,583,564,214,60,274,19,293
公投第９案,桃園市,復興區,義盛里,584,716,237,77,314,28,342
公投第９案,桃園市,復興區,羅浮里,585,1016,443,126,569,57,626
公投第９案,桃園市,復興區,長興里,586,669,193,61,254,14,268
公投第９案,桃園市,復興區,奎輝里,587,760,268,63,331,23,354
公投第９案,桃園市,復興區,高義里,588,751,254,80,334,21,355
公投第９案,桃園市,復興區,三光里,589,683,188,37,225,7,232
公投第９案,桃園市,復興區,華陵里,590,1224,429,121,550,41,591
公投第９案,桃園市,中壢區,後寮里,591,1401,579,115,694,48,742
公投第９案,桃園市,中壢區,後寮里,592,1798,652,193,845,57,902
公投第９案,桃園市,中壢區,後寮里,593,1642,580,142,722,47,769
公投第９案,桃園市,中壢區,明德里,594,1670,664,161,825,61,886
公投第９案,桃園市,中壢區,明德里,595,1456,616,150,766,24,790
公投第９案,桃園市,中壢區,明德里,596,1531,710,154,864,48,912
公投第９案,桃園市,中壢區,至善里,597,1623,725,161,886,46,932
公投第９案,桃園市,中壢區,至善里,598,1953,742,108,850,39,889
公投第９案,桃園市,中壢區,龍慈里,599,1155,508,125,633,26,659
公投第９案,桃園市,中壢區,龍慈里,600,1800,653,141,794,47,841
公投第９案,桃園市,中壢區,龍慈里,601,1757,702,122,824,29,853
公投第９案,桃園市,中壢區,龍興里,602,1281,585,122,707,47,754
公投第９案,桃園市,中壢區,龍興里,603,1462,661,134,795,28,823
公投第９案,桃園市,中壢區,龍興里,604,1560,565,131,696,56,752
公投第９案,桃園市,中壢區,龍德里,605,1602,736,154,890,36,926
公投第９案,桃園市,中壢區,龍德里,606,1006,505,114,619,27,646
公投第９案,桃園市,中壢區,龍德里,607,1474,561,133,694,21,715
公投第９案,桃園市,中壢區,龍岡里,608,1627,647,144,791,93,884
公投第９案,桃園市,中壢區,龍岡里,609,1519,675,150,825,34,859
公投第９案,桃園市,中壢區,龍岡里,610,1526,630,143,773,76,849
公投第９案,桃園市,中壢區,龍東里,611,1618,650,145,795,78,873
公投第９案,桃園市,中壢區,龍東里,612,1554,744,109,853,51,904
公投第９案,桃園市,中壢區,龍東里,613,1706,725,129,854,69,923
公投第９案,桃園市,中壢區,龍昌里,614,1818,826,151,977,50,1027
公投第９案,桃園市,中壢區,龍昌里,615,1991,758,153,911,51,962
公投第９案,桃園市,中壢區,龍昌里,616,1609,674,141,815,28,843
公投第９案,桃園市,中壢區,龍平里,617,1329,528,66,594,38,632
公投第９案,桃園市,中壢區,龍平里,618,1587,580,132,712,83,795
公投第９案,桃園市,中壢區,仁美里,619,1955,775,163,938,41,979
公投第９案,桃園市,中壢區,仁美里,620,1711,652,187,839,46,885
公投第９案,桃園市,中壢區,仁美里,621,1712,652,156,808,62,870
公投第９案,桃園市,中壢區,仁福里,622,1448,649,134,783,53,836
公投第９案,桃園市,中壢區,仁福里,623,1605,598,174,772,45,817
公投第９案,桃園市,中壢區,仁福里,624,1633,632,102,734,14,748
公投第９案,桃園市,中壢區,華愛里,625,1795,789,162,951,63,1014
公投第９案,桃園市,中壢區,華愛里,626,1689,714,170,884,28,912
公投第９案,桃園市,中壢區,普仁里,627,1201,502,130,632,37,669
公投第９案,桃園市,中壢區,普仁里,628,1353,534,138,672,40,712
公投第９案,桃園市,中壢區,普仁里,629,1587,621,138,759,35,794
公投第９案,桃園市,中壢區,普忠里,630,1883,763,188,951,53,1004
公投第９案,桃園市,中壢區,普忠里,631,1448,571,145,716,24,740
公投第９案,桃園市,中壢區,普強里,632,1810,718,186,904,42,946
公投第９案,桃園市,中壢區,普強里,633,1916,722,188,910,70,980
公投第９案,桃園市,中壢區,普慶里,634,1177,541,97,638,31,669
公投第９案,桃園市,中壢區,普慶里,635,1410,628,157,785,47,832
公投第９案,桃園市,中壢區,信義里,636,1368,553,143,696,16,712
公投第９案,桃園市,中壢區,信義里,637,1424,672,131,803,43,846
公投第９案,桃園市,中壢區,信義里,638,1573,673,168,841,35,876
公投第９案,桃園市,中壢區,正義里,639,1152,492,126,618,27,645
公投第９案,桃園市,中壢區,正義里,640,1178,497,115,612,23,635
公投第９案,桃園市,中壢區,正義里,641,1966,728,201,929,60,989
公投第９案,桃園市,中壢區,普義里,642,3474,535,138,673,32,705
公投第９案,桃園市,中壢區,普義里,643,2099,904,165,1069,53,1122
公投第９案,桃園市,中壢區,德義里,644,1178,497,111,608,43,651
公投第９案,桃園市,中壢區,德義里,645,1397,644,151,795,62,857
公投第９案,桃園市,中壢區,仁義里,646,1669,687,191,878,44,922
公投第９案,桃園市,中壢區,仁義里,647,2087,793,184,977,49,1026
公投第９案,桃園市,中壢區,忠義里,648,1900,748,178,926,39,965
公投第９案,桃園市,中壢區,忠義里,649,1640,538,138,676,35,711
公投第９案,桃園市,中壢區,龍安里,650,994,453,109,562,30,592
公投第９案,桃園市,中壢區,龍安里,651,1131,574,106,680,49,729
公投第９案,桃園市,中壢區,仁愛里,652,1625,731,181,912,42,954
公投第９案,桃園市,中壢區,仁愛里,653,1384,622,201,823,38,861
公投第９案,桃園市,中壢區,仁德里,654,1588,643,159,802,53,855
公投第９案,桃園市,中壢區,仁德里,655,1445,621,123,744,36,780
公投第９案,桃園市,中壢區,仁和里,656,1743,615,138,753,42,795
公投第９案,桃園市,中壢區,仁和里,657,1812,682,142,824,33,857
公投第９案,桃園市,中壢區,仁祥里,658,1546,612,122,734,54,788
公投第９案,桃園市,中壢區,仁祥里,659,1290,505,137,642,44,686
公投第９案,桃園市,中壢區,華勛里,660,2145,813,144,957,87,1044
公投第９案,桃園市,中壢區,華勛里,661,1451,530,151,681,37,718
公投第９案,桃園市,中壢區,中堅里,662,1489,644,97,741,38,779
公投第９案,桃園市,中壢區,中堅里,663,827,352,78,430,31,461
公投第９案,桃園市,中壢區,中堅里,664,1442,578,129,707,38,745
公投第９案,桃園市,中壢區,興仁里,665,1842,690,152,842,26,868
公投第９案,桃園市,中壢區,興仁里,666,1520,560,110,670,32,702
公投第９案,桃園市,中壢區,中正里,667,1764,640,141,781,40,821
公投第９案,桃園市,中壢區,中正里,668,1488,673,127,800,26,826
公投第９案,桃園市,中壢區,中正里,669,1593,631,168,799,47,846
公投第９案,桃園市,中壢區,中山里,670,1505,604,168,772,31,803
公投第９案,桃園市,中壢區,中山里,671,1661,677,141,818,33,851
公投第９案,桃園市,中壢區,中山里,672,1492,666,122,788,26,814
公投第９案,桃園市,中壢區,篤行里,673,1249,455,138,593,24,617
公投第９案,桃園市,中壢區,篤行里,674,1257,554,118,672,30,702
公投第９案,桃園市,中壢區,自強里,675,1659,627,163,790,73,863
公投第９案,桃園市,中壢區,自強里,676,1815,762,181,943,46,989
公投第９案,桃園市,中壢區,中興里,677,1702,653,161,814,42,856
公投第９案,桃園市,中壢區,中興里,678,1541,761,25,786,20,806
公投第９案,桃園市,中壢區,自立里,679,1659,654,116,770,48,818
公投第９案,桃園市,中壢區,自立里,680,1874,728,147,875,81,956
公投第９案,桃園市,中壢區,自立里,681,1603,652,107,759,45,804
公投第９案,桃園市,中壢區,自信里,682,1735,667,169,836,40,876
公投第９案,桃園市,中壢區,自信里,683,1815,727,151,878,23,901
公投第９案,桃園市,中壢區,自信里,684,1873,600,150,750,33,783
公投第９案,桃園市,中壢區,莊敬里,685,1739,772,140,912,55,967
公投第９案,桃園市,中壢區,莊敬里,686,1709,648,150,798,41,839
公投第９案,桃園市,中壢區,自治里,687,1655,708,170,878,34,912
公投第９案,桃園市,中壢區,自治里,688,1664,735,108,843,37,880
公投第９案,桃園市,中壢區,內壢里,689,1087,391,109,500,18,518
公投第９案,桃園市,中壢區,內壢里,690,1065,434,115,549,51,600
公投第９案,桃園市,中壢區,成功里,691,1844,718,206,924,71,995
公投第９案,桃園市,中壢區,成功里,692,1220,420,107,527,52,579
公投第９案,桃園市,中壢區,成功里,693,1219,490,129,619,34,653
公投第９案,桃園市,中壢區,福德里,694,1260,471,173,644,48,692
公投第９案,桃園市,中壢區,福德里,695,1594,684,178,862,65,927
公投第９案,桃園市,中壢區,中原里,696,1733,675,184,859,78,937
公投第９案,桃園市,中壢區,中原里,697,1979,825,160,985,51,1036
公投第９案,桃園市,中壢區,忠孝里,698,1621,644,161,805,34,839
公投第９案,桃園市,中壢區,忠孝里,699,1391,561,177,738,38,776
公投第９案,桃園市,中壢區,忠孝里,700,1531,697,118,815,26,841
公投第９案,桃園市,中壢區,復興里,701,1943,723,168,891,67,958
公投第９案,桃園市,中壢區,復興里,702,1363,573,110,683,28,711
公投第９案,桃園市,中壢區,復興里,703,2172,766,184,950,52,1002
公投第９案,桃園市,中壢區,復興里,704,1798,704,130,834,45,879
公投第９案,桃園市,中壢區,復興里,705,1671,662,137,799,25,824
公投第９案,桃園市,中壢區,復華里,706,1969,750,162,912,60,972
公投第９案,桃園市,中壢區,復華里,707,1563,779,51,830,45,875
公投第９案,桃園市,中壢區,復華里,708,1762,749,172,921,53,974
公投第９案,桃園市,中壢區,文化里,709,1923,623,142,765,48,813
公投第９案,桃園市,中壢區,文化里,710,1572,680,156,836,56,892
公投第９案,桃園市,中壢區,文化里,711,1850,810,167,977,36,1013
公投第９案,桃園市,中壢區,文化里,712,1583,617,151,768,50,818
公投第９案,桃園市,中壢區,文化里,713,1735,672,167,839,50,889
公投第９案,桃園市,中壢區,和平里,714,1292,478,161,639,33,672
公投第９案,桃園市,中壢區,和平里,715,1265,514,120,634,23,657
公投第９案,桃園市,中壢區,內定里,716,1798,737,167,904,35,939
公投第９案,桃園市,中壢區,內定里,717,1822,777,205,982,57,1039
公投第９案,桃園市,中壢區,內定里,718,1613,665,160,825,25,850
公投第９案,桃園市,中壢區,內定里,719,1405,581,136,717,41,758
公投第９案,桃園市,中壢區,石頭里,720,1730,677,224,901,70,971
公投第９案,桃園市,中壢區,中央里,721,1384,653,165,818,30,848
公投第９案,桃園市,中壢區,中央里,722,1122,475,132,607,21,628
公投第９案,桃園市,中壢區,中央里,723,992,439,121,560,44,604
公投第９案,桃園市,中壢區,新興里,724,1820,675,200,875,46,921
公投第９案,桃園市,中壢區,新興里,725,1847,724,163,887,55,942
公投第９案,桃園市,中壢區,林森里,726,1302,571,134,705,52,757
公投第９案,桃園市,中壢區,林森里,727,1203,513,131,644,42,686
公投第９案,桃園市,中壢區,林森里,728,1226,577,168,745,47,792
公投第９案,桃園市,中壢區,振興里,729,1234,554,135,689,46,735
公投第９案,桃園市,中壢區,振興里,730,2023,756,143,899,53,952
公投第９案,桃園市,中壢區,振興里,731,1555,596,126,722,16,738
公投第９案,桃園市,中壢區,東興里,732,1951,728,197,925,54,979
公投第９案,桃園市,中壢區,東興里,733,1383,579,152,731,43,774
公投第９案,桃園市,中壢區,健行里,734,1164,545,103,648,54,702
公投第９案,桃園市,中壢區,健行里,735,1482,658,126,784,29,813
公投第９案,桃園市,中壢區,健行里,736,1770,731,166,897,48,945
公投第９案,桃園市,中壢區,水尾里,737,1703,722,200,922,66,988
公投第９案,桃園市,中壢區,水尾里,738,1841,717,179,896,75,971
公投第９案,桃園市,中壢區,金華里,739,1941,821,199,1020,41,1061
公投第９案,桃園市,中壢區,金華里,740,2029,896,172,1068,44,1112
公投第９案,桃園市,中壢區,忠福里,741,1636,740,157,897,38,935
公投第９案,桃園市,中壢區,忠福里,742,1528,698,134,832,38,870
公投第９案,桃園市,中壢區,忠福里,743,2289,805,227,1032,76,1108
公投第９案,桃園市,中壢區,忠福里,744,2020,728,211,939,45,984
公投第９案,桃園市,中壢區,幸福里,745,2027,811,191,1002,46,1048
公投第９案,桃園市,中壢區,幸福里,746,1883,671,135,806,26,832
公投第９案,桃園市,中壢區,幸福里,747,2080,786,185,971,57,1028
公投第９案,桃園市,中壢區,永福里,748,646,240,73,313,17,330
公投第９案,桃園市,中壢區,永福里,749,1780,833,215,1048,58,1106
公投第９案,桃園市,中壢區,永福里,750,1372,635,120,755,19,774
公投第９案,桃園市,中壢區,永福里,751,1668,715,192,907,44,951
公投第９案,桃園市,中壢區,青埔里,752,1987,778,179,957,34,991
公投第９案,桃園市,中壢區,青埔里,753,1520,638,147,785,24,809
公投第９案,桃園市,中壢區,新街里,754,852,325,104,429,36,465
公投第９案,桃園市,中壢區,新街里,755,1209,498,133,631,33,664
公投第９案,桃園市,中壢區,興南里,756,1481,565,151,716,84,800
公投第９案,桃園市,中壢區,興南里,757,1564,604,112,716,22,738
公投第９案,桃園市,中壢區,興國里,758,1957,784,225,1009,57,1066
公投第９案,桃園市,中壢區,興平里,759,1223,530,154,684,53,737
公投第９案,桃園市,中壢區,興平里,760,1182,487,139,626,43,669
公投第９案,桃園市,中壢區,興和里,761,1066,443,142,585,45,630
公投第９案,桃園市,中壢區,興和里,762,1701,742,168,910,58,968
公投第９案,桃園市,中壢區,永興里,763,943,359,96,455,44,499
公投第９案,桃園市,中壢區,中壢里,764,731,321,92,413,29,442
公投第９案,桃園市,中壢區,中榮里,765,851,334,103,437,50,487
公投第９案,桃園市,中壢區,中建里,766,1011,389,127,516,35,551
公投第９案,桃園市,中壢區,舊明里,767,1532,630,161,791,39,830
公投第９案,桃園市,中壢區,新明里,768,1028,421,99,520,37,557
公投第９案,桃園市,中壢區,新明里,769,1157,466,158,624,42,666
公投第９案,桃園市,中壢區,新明里,770,1591,580,192,772,50,822
公投第９案,桃園市,中壢區,光明里,771,2156,768,199,967,55,1022
公投第９案,桃園市,中壢區,光明里,772,1479,510,150,660,25,685
公投第９案,桃園市,中壢區,光明里,773,1780,731,155,886,44,930
公投第９案,桃園市,中壢區,永光里,774,1651,639,193,832,58,890
公投第９案,桃園市,中壢區,永光里,775,1870,756,203,959,41,1000
公投第９案,桃園市,中壢區,永光里,776,1913,674,168,842,27,869
公投第９案,桃園市,中壢區,三民里,777,1609,549,152,701,42,743
公投第９案,桃園市,中壢區,三民里,778,1539,585,149,734,27,761
公投第９案,桃園市,中壢區,五權里,779,1426,551,167,718,42,760
公投第９案,桃園市,中壢區,五權里,780,1618,583,154,737,37,774
公投第９案,桃園市,中壢區,五權里,781,1441,601,130,731,53,784
公投第９案,桃園市,中壢區,五權里,782,1528,679,144,823,23,846
公投第９案,桃園市,中壢區,五福里,783,1683,636,193,829,54,883
公投第９案,桃園市,中壢區,五福里,784,1945,787,211,998,76,1074
公投第９案,桃園市,中壢區,芝芭里,785,1534,577,158,735,63,798
公投第９案,桃園市,中壢區,芝芭里,786,1810,653,192,845,77,922
公投第９案,桃園市,中壢區,洽溪里,787,1097,386,124,510,52,562
公投第９案,桃園市,中壢區,洽溪里,788,1917,727,188,915,20,935
公投第９案,桃園市,中壢區,洽溪里,789,1858,708,193,901,51,952
公投第９案,桃園市,中壢區,內厝里,790,1576,651,158,809,38,847
公投第９案,桃園市,中壢區,內厝里,791,1478,624,163,787,43,830
公投第９案,桃園市,中壢區,內厝里,792,1589,621,180,801,39,840
公投第９案,桃園市,中壢區,月眉里,793,2037,761,249,1010,105,1115
公投第９案,桃園市,中壢區,月眉里,794,1158,524,135,659,40,699
公投第９案,桃園市,中壢區,月眉里,795,1967,787,203,990,72,1062
公投第９案,桃園市,中壢區,山東里,796,1830,699,153,852,75,927
公投第９案,桃園市,中壢區,山東里,797,1856,651,202,853,48,901
公投第９案,桃園市,中壢區,過嶺里,798,2068,730,219,949,78,1027
公投第９案,桃園市,中壢區,過嶺里,799,2152,675,163,838,53,891
公投第９案,桃園市,中壢區,過嶺里,800,2158,723,184,907,53,960
公投第９案,桃園市,平鎮區,平鎮里,801,1487,521,157,678,45,723
公投第９案,桃園市,平鎮區,平鎮里,802,1453,575,136,711,50,761
公投第９案,桃園市,平鎮區,平鎮里,803,1491,156,601,757,50,807
公投第９案,桃園市,平鎮區,鎮興里,804,1346,486,157,643,57,700
公投第９案,桃園市,平鎮區,鎮興里,805,1660,652,151,803,35,838
公投第９案,桃園市,平鎮區,南勢里,806,1921,677,165,842,39,881
公投第９案,桃園市,平鎮區,南勢里,807,1974,847,169,1016,52,1068
公投第９案,桃園市,平鎮區,南勢里,808,1867,726,170,896,37,933
公投第９案,桃園市,平鎮區,金星里,809,1786,754,124,878,40,918
公投第９案,桃園市,平鎮區,金星里,810,1634,529,127,656,29,685
公投第９案,桃園市,平鎮區,金星里,811,1080,458,103,561,21,582
公投第９案,桃園市,平鎮區,金星里,812,1514,616,153,769,28,797
公投第９案,桃園市,平鎮區,平安里,813,1918,653,153,806,79,885
公投第９案,桃園市,平鎮區,平安里,814,1182,445,141,586,73,659
公投第９案,桃園市,平鎮區,平安里,815,1667,615,150,765,39,804
公投第９案,桃園市,平鎮區,平南里,816,1640,606,135,741,33,774
公投第９案,桃園市,平鎮區,平南里,817,1603,637,149,786,34,820
公投第９案,桃園市,平鎮區,平南里,818,1556,703,137,840,13,853
公投第９案,桃園市,平鎮區,平南里,819,1697,659,134,793,37,830
公投第９案,桃園市,平鎮區,山峰里,820,1130,420,84,504,21,525
公投第９案,桃園市,平鎮區,山峰里,821,1196,490,94,584,43,627
公投第９案,桃園市,平鎮區,福林里,822,1685,678,141,819,53,872
公投第９案,桃園市,平鎮區,福林里,823,1532,682,152,834,44,878
公投第９案,桃園市,平鎮區,湧光里,824,1564,594,148,742,41,783
公投第９案,桃園市,平鎮區,湧光里,825,1824,622,113,735,24,759
公投第９案,桃園市,平鎮區,湧光里,826,1912,717,166,883,25,908
公投第９案,桃園市,平鎮區,莊敬里,827,1048,403,109,512,49,561
公投第９案,桃園市,平鎮區,莊敬里,828,1259,527,126,653,55,708
公投第９案,桃園市,平鎮區,莊敬里,829,1061,422,103,525,22,547
公投第９案,桃園市,平鎮區,莊敬里,830,1072,494,104,598,36,634
公投第９案,桃園市,平鎮區,湧豐里,831,1788,689,153,842,53,895
公投第９案,桃園市,平鎮區,湧安里,832,1510,619,137,756,39,795
公投第９案,桃園市,平鎮區,湧安里,833,1403,552,139,691,48,739
公投第９案,桃園市,平鎮區,湧安里,834,1407,561,156,717,50,767
公投第９案,桃園市,平鎮區,宋屋里,835,1901,773,183,956,60,1016
公投第９案,桃園市,平鎮區,宋屋里,836,1994,739,149,888,35,923
公投第９案,桃園市,平鎮區,平興里,837,1730,676,182,858,9,867
公投第９案,桃園市,平鎮區,平興里,838,1905,781,174,955,50,1005
公投第９案,桃園市,平鎮區,平興里,839,1723,728,173,901,30,931
公投第９案,桃園市,平鎮區,廣興里,840,1307,533,128,661,49,710
公投第９案,桃園市,平鎮區,廣興里,841,1337,545,140,685,49,734
公投第９案,桃園市,平鎮區,廣興里,842,980,486,113,599,36,635
公投第９案,桃園市,平鎮區,廣興里,843,1818,715,166,881,53,934
公投第９案,桃園市,平鎮區,廣達里,844,1463,593,164,757,46,803
公投第９案,桃園市,平鎮區,廣達里,845,1213,555,126,681,25,706
公投第９案,桃園市,平鎮區,廣達里,846,1085,449,116,565,51,616
公投第９案,桃園市,平鎮區,廣仁里,847,1458,547,135,682,34,716
公投第９案,桃園市,平鎮區,廣仁里,848,1408,555,167,722,51,773
公投第９案,桃園市,平鎮區,廣仁里,849,1396,504,164,668,51,719
公投第９案,桃園市,平鎮區,復旦里,850,1044,507,133,640,29,669
公投第９案,桃園市,平鎮區,復旦里,851,1124,482,114,596,15,611
公投第９案,桃園市,平鎮區,復旦里,852,1517,643,148,791,27,818
公投第９案,桃園市,平鎮區,復旦里,853,1571,619,172,791,24,815
公投第９案,桃園市,平鎮區,復興里,854,1752,770,170,940,32,972
公投第９案,桃園市,平鎮區,復興里,855,1434,671,154,825,30,855
公投第９案,桃園市,平鎮區,復興里,856,1710,754,183,937,44,981
公投第９案,桃園市,平鎮區,義民里,857,1555,663,159,822,33,855
公投第９案,桃園市,平鎮區,義民里,858,2051,726,193,919,42,961
公投第９案,桃園市,平鎮區,義民里,859,1477,592,167,759,28,787
公投第９案,桃園市,平鎮區,義興里,860,1501,610,146,756,22,778
公投第９案,桃園市,平鎮區,義興里,861,1405,569,147,716,58,774
公投第９案,桃園市,平鎮區,義興里,862,1656,634,177,811,68,879
公投第９案,桃園市,平鎮區,義興里,863,1921,694,161,855,33,888
公投第９案,桃園市,平鎮區,雙連里,864,1717,662,126,788,24,812
公投第９案,桃園市,平鎮區,雙連里,865,1319,522,152,674,41,715
公投第９案,桃園市,平鎮區,雙連里,866,1745,680,175,855,56,911
公投第９案,桃園市,平鎮區,高雙里,867,1721,689,193,882,62,944
公投第９案,桃園市,平鎮區,高雙里,868,1206,503,125,628,30,658
公投第９案,桃園市,平鎮區,高雙里,869,1202,604,146,750,28,778
公投第９案,桃園市,平鎮區,北勢里,870,1208,531,133,664,41,705
公投第９案,桃園市,平鎮區,北勢里,871,1267,558,139,697,47,744
公投第９案,桃園市,平鎮區,北華里,872,1094,489,97,586,23,609
公投第９案,桃園市,平鎮區,北華里,873,1394,593,173,766,52,818
公投第９案,桃園市,平鎮區,北華里,874,1215,574,118,692,17,709
公投第９案,桃園市,平鎮區,新勢里,875,1010,439,112,551,29,580
公投第９案,桃園市,平鎮區,新勢里,876,1261,521,145,666,28,694
公投第９案,桃園市,平鎮區,新勢里,877,1314,588,145,733,28,761
公投第９案,桃園市,平鎮區,北安里,878,722,301,83,384,38,422
公投第９案,桃園市,平鎮區,北安里,879,839,315,97,412,28,440
公投第９案,桃園市,平鎮區,新榮里,880,1399,569,147,716,29,745
公投第９案,桃園市,平鎮區,新榮里,881,1968,755,176,931,59,990
公投第９案,桃園市,平鎮區,新榮里,882,1672,702,157,859,33,892
公投第９案,桃園市,平鎮區,新富里,883,2213,442,183,625,24,649
公投第９案,桃園市,平鎮區,新富里,884,949,472,95,567,25,592
公投第９案,桃園市,平鎮區,新富里,885,1621,734,182,916,48,964
公投第９案,桃園市,平鎮區,新富里,886,1643,673,140,813,26,839
公投第９案,桃園市,平鎮區,新英里,887,1844,782,189,971,36,1007
公投第９案,桃園市,平鎮區,新英里,888,1752,732,178,910,35,945
公投第９案,桃園市,平鎮區,新貴里,889,1577,583,146,729,51,780
公投第９案,桃園市,平鎮區,新貴里,890,1517,673,135,808,31,839
公投第９案,桃園市,平鎮區,北興里,891,1039,447,131,578,32,610
公投第９案,桃園市,平鎮區,北興里,892,1318,584,145,729,47,776
公投第９案,桃園市,平鎮區,北興里,893,1636,671,150,821,45,866
公投第９案,桃園市,平鎮區,金陵里,894,1316,565,147,712,32,744
公投第９案,桃園市,平鎮區,金陵里,895,1474,609,181,790,27,817
公投第９案,桃園市,平鎮區,北貴里,896,1480,523,124,647,54,701
公投第９案,桃園市,平鎮區,北貴里,897,1330,564,105,669,27,696
公投第９案,桃園市,平鎮區,北貴里,898,1228,518,130,648,31,679
公投第９案,桃園市,平鎮區,北富里,899,1377,632,143,775,35,810
公投第９案,桃園市,平鎮區,北富里,900,1198,579,122,701,22,723
公投第９案,桃園市,平鎮區,北富里,901,1231,583,124,707,37,744
公投第９案,桃園市,平鎮區,建安里,902,1243,506,139,645,65,710
公投第９案,桃園市,平鎮區,建安里,903,1590,669,131,800,40,840
公投第９案,桃園市,平鎮區,建安里,904,1366,561,120,681,57,738
公投第９案,桃園市,平鎮區,華安里,905,1332,547,124,671,49,720
公投第９案,桃園市,平鎮區,華安里,906,1201,449,99,548,21,569
公投第９案,桃園市,平鎮區,華安里,907,1668,575,154,729,31,760
公投第９案,桃園市,平鎮區,東安里,908,1351,511,138,649,54,703
公投第９案,桃園市,平鎮區,東安里,909,1460,521,115,636,27,663
公投第９案,桃園市,平鎮區,新安里,910,1841,706,179,885,42,927
公投第９案,桃園市,平鎮區,新安里,911,1475,552,116,668,17,685
公投第９案,桃園市,平鎮區,新安里,912,1011,427,103,530,27,557
公投第９案,桃園市,平鎮區,東勢里,913,1052,381,97,478,34,512
公投第９案,桃園市,平鎮區,東勢里,914,1154,518,128,646,61,707
公投第９案,桃園市,平鎮區,東勢里,915,1645,629,148,777,25,802
公投第９案,桃園市,平鎮區,東勢里,916,1539,545,147,692,79,771
公投第９案,桃園市,平鎮區,龍恩里,917,1385,549,125,674,72,746
公投第９案,桃園市,平鎮區,龍恩里,918,1395,579,123,702,35,737
公投第９案,桃園市,平鎮區,東社里,919,1711,683,135,818,33,851
公投第９案,桃園市,平鎮區,東社里,920,1631,664,120,784,49,833
公投第９案,桃園市,平鎮區,忠貞里,921,1110,500,88,588,16,604
公投第９案,桃園市,平鎮區,貿易里,922,1931,854,143,997,49,1046
公投第９案,桃園市,平鎮區,龍興里,923,1127,453,116,569,50,619
公投第９案,桃園市,平鎮區,龍興里,924,1414,601,106,707,70,777
公投第９案,桃園市,平鎮區,中正里,925,1609,666,130,796,46,842
公投第９案,桃園市,楊梅區,仁美里,926,1269,514,139,653,55,708
公投第９案,桃園市,楊梅區,仁美里,927,1246,586,133,719,50,769
公投第９案,桃園市,楊梅區,仁美里,928,1408,653,125,778,40,818
公投第９案,桃園市,楊梅區,埔心里,929,1434,600,146,746,55,801
公投第９案,桃園市,楊梅區,光華里,930,1515,604,107,711,55,766
公投第９案,桃園市,楊梅區,光華里,931,1657,597,154,751,48,799
公投第９案,桃園市,楊梅區,金龍里,932,1137,498,113,611,34,645
公投第９案,桃園市,楊梅區,四維里,933,2211,877,180,1057,43,1100
公投第９案,桃園市,楊梅區,四維里,934,2008,772,187,959,35,994
公投第９案,桃園市,楊梅區,永平里,935,1911,776,181,957,41,998
公投第９案,桃園市,楊梅區,瑞塘里,936,1449,587,161,748,67,815
公投第９案,桃園市,楊梅區,瑞塘里,937,1877,650,161,811,56,867
公投第９案,桃園市,楊梅區,瑞塘里,938,1988,739,165,904,47,951
公投第９案,桃園市,楊梅區,瑞坪里,939,1931,809,178,987,28,1015
公投第９案,桃園市,楊梅區,瑞坪里,940,1938,752,159,911,44,955
公投第９案,桃園市,楊梅區,瑞坪里,941,1677,718,135,853,28,881
公投第９案,桃園市,楊梅區,梅溪里,942,1848,695,195,890,33,923
公投第９案,桃園市,楊梅區,梅溪里,943,1882,748,169,917,32,949
公投第９案,桃園市,楊梅區,瑞溪里,944,1541,479,103,582,20,602
公投第９案,桃園市,楊梅區,瑞溪里,945,1938,731,160,891,44,935
公投第９案,桃園市,楊梅區,金溪里,946,1562,535,144,679,14,693
公投第９案,桃園市,楊梅區,金溪里,947,2125,883,245,1128,55,1183
公投第９案,桃園市,楊梅區,三民里,948,1516,668,172,840,48,888
公投第９案,桃園市,楊梅區,三民里,949,1807,683,180,863,29,892
公投第９案,桃園市,楊梅區,楊明里,950,2101,770,178,948,43,991
公投第９案,桃園市,楊梅區,楊明里,951,2054,819,187,1006,62,1068
公投第９案,桃園市,楊梅區,楊明里,952,2226,814,176,990,34,1024
公投第９案,桃園市,楊梅區,裕成里,953,1405,588,148,736,14,750
公投第９案,桃園市,楊梅區,裕成里,954,1843,660,165,825,47,872
公投第９案,桃園市,楊梅區,裕新里,955,2324,785,195,980,50,1030
公投第９案,桃園市,楊梅區,大同里,956,1713,689,56,745,30,775
公投第９案,桃園市,楊梅區,大同里,957,1587,718,159,877,60,937
公投第９案,桃園市,楊梅區,中山里,958,1416,619,134,753,29,782
公投第９案,桃園市,楊梅區,中山里,959,1591,674,157,831,40,871
公投第９案,桃園市,楊梅區,楊梅里,960,1943,728,170,898,53,951
公投第９案,桃園市,楊梅區,楊梅里,961,1762,703,151,854,35,889
公投第９案,桃園市,楊梅區,楊江里,962,1083,447,92,539,35,574
公投第９案,桃園市,楊梅區,梅新里,963,2027,795,187,982,65,1047
公投第９案,桃園市,楊梅區,紅梅里,964,1274,523,142,665,62,727
公投第９案,桃園市,楊梅區,紅梅里,965,1359,607,121,728,54,782
公投第９案,桃園市,楊梅區,永寧里,966,2444,652,167,819,52,871
公投第９案,桃園市,楊梅區,永寧里,967,2298,787,173,960,36,996
公投第９案,桃園市,楊梅區,永寧里,968,2222,835,198,1033,49,1082
公投第９案,桃園市,楊梅區,大平里,969,1610,603,172,775,71,846
公投第９案,桃園市,楊梅區,大平里,970,1627,602,169,771,94,865
公投第９案,桃園市,楊梅區,秀才里,971,1589,651,169,820,50,870
公投第９案,桃園市,楊梅區,秀才里,972,1758,676,184,860,78,938
公投第９案,桃園市,楊梅區,東流里,973,1776,562,147,709,65,774
公投第９案,桃園市,楊梅區,東流里,974,1000,377,83,460,23,483
公投第９案,桃園市,楊梅區,豐野里,975,2290,807,160,967,76,1043
公投第９案,桃園市,楊梅區,豐野里,976,1551,581,189,770,48,818
公投第９案,桃園市,楊梅區,富岡里,977,1861,669,167,836,82,918
公投第９案,桃園市,楊梅區,富豐里,978,1141,353,129,482,54,536
公投第９案,桃園市,楊梅區,富豐里,979,1785,654,153,807,54,861
公投第９案,桃園市,楊梅區,員本里,980,1498,575,157,732,68,800
公投第９案,桃園市,楊梅區,員本里,981,1187,435,139,574,49,623
公投第９案,桃園市,楊梅區,三湖里,982,1270,498,151,649,56,705
公投第９案,桃園市,楊梅區,三湖里,983,1424,572,133,705,43,748
公投第９案,桃園市,楊梅區,頭湖里,984,1273,623,26,649,21,670
公投第９案,桃園市,楊梅區,頭湖里,985,1534,479,176,655,30,685
公投第９案,桃園市,楊梅區,上湖里,986,1783,587,157,744,70,814
公投第９案,桃園市,楊梅區,上湖里,987,1709,644,145,789,23,812
公投第９案,桃園市,楊梅區,上湖里,988,1920,646,174,820,64,884
公投第９案,桃園市,楊梅區,上田里,989,1194,486,109,595,31,626
公投第９案,桃園市,楊梅區,上田里,990,1408,595,124,719,24,743
公投第９案,桃園市,楊梅區,高山里,991,1737,578,158,736,34,770
公投第９案,桃園市,楊梅區,高山里,992,1920,759,143,902,38,940
公投第９案,桃園市,楊梅區,高上里,993,1234,461,154,615,34,649
公投第９案,桃園市,楊梅區,高上里,994,1491,615,154,769,60,829
公投第９案,桃園市,楊梅區,青山里,995,2020,729,168,897,45,942
公投第９案,桃園市,楊梅區,青山里,996,1863,638,164,802,33,835
公投第９案,桃園市,楊梅區,高榮里,997,1692,663,162,825,64,889
公投第９案,桃園市,楊梅區,高榮里,998,1686,658,161,819,32,851
公投第９案,桃園市,楊梅區,雙榮里,999,1626,670,156,826,62,888
公投第９案,桃園市,楊梅區,雙榮里,1000,1557,664,146,810,28,838
公投第９案,桃園市,楊梅區,新榮里,1001,1603,691,183,874,55,929
公投第９案,桃園市,楊梅區,新榮里,1002,1889,685,165,850,74,924
公投第９案,桃園市,楊梅區,水美里,1003,1448,630,136,766,31,797
公投第９案,桃園市,楊梅區,水美里,1004,1351,583,137,720,48,768
公投第９案,桃園市,楊梅區,水美里,1005,1313,549,142,691,70,761
公投第９案,桃園市,楊梅區,瑞原里,1006,1689,643,171,814,61,875
公投第９案,桃園市,楊梅區,瑞原里,1007,2063,723,191,914,44,958
公投第９案,桃園市,龍潭區,黃唐里,1008,1482,564,145,709,29,738
公投第９案,桃園市,龍潭區,黃唐里,1009,1528,600,132,732,39,771
公投第９案,桃園市,龍潭區,黃唐里,1010,1503,586,150,736,41,777
公投第９案,桃園市,龍潭區,永興里,1011,1568,562,180,742,52,794
公投第９案,桃園市,龍潭區,永興里,1012,1216,463,112,575,55,630
公投第９案,桃園市,龍潭區,中山里,1013,2088,700,182,882,67,949
公投第９案,桃園市,龍潭區,中山里,1014,1987,831,195,1026,86,1112
公投第９案,桃園市,龍潭區,中山里,1015,1586,692,173,865,43,908
公投第９案,桃園市,龍潭區,烏樹林里,1016,1221,427,147,574,44,618
公投第９案,桃園市,龍潭區,烏樹林里,1017,1134,476,121,597,46,643
公投第９案,桃園市,龍潭區,烏林里,1018,2081,731,192,923,56,979
公投第９案,桃園市,龍潭區,烏林里,1019,1925,673,170,843,43,886
公投第９案,桃園市,龍潭區,百年里,1020,2095,907,176,1083,40,1123
公投第９案,桃園市,龍潭區,百年里,1021,2040,941,166,1107,49,1156
公投第９案,桃園市,龍潭區,凌雲里,1022,1790,615,207,822,58,880
公投第９案,桃園市,龍潭區,凌雲里,1023,1872,702,218,920,100,1020
公投第９案,桃園市,龍潭區,龍祥里,1024,1726,704,194,898,74,972
公投第９案,桃園市,龍潭區,龍祥里,1025,1792,709,192,901,67,968
公投第９案,桃園市,龍潭區,八德里,1026,1398,576,127,703,32,735
公投第９案,桃園市,龍潭區,八德里,1027,1345,487,145,632,34,666
公投第９案,桃園市,龍潭區,八德里,1028,1409,575,147,722,48,770
公投第９案,桃園市,龍潭區,聖德里,1029,1362,482,122,604,35,639
公投第９案,桃園市,龍潭區,聖德里,1030,1650,672,210,882,53,935
公投第９案,桃園市,龍潭區,上林里,1031,1597,605,173,778,51,829
公投第９案,桃園市,龍潭區,上林里,1032,1410,548,165,713,13,726
公投第９案,桃園市,龍潭區,上林里,1033,1275,533,131,664,53,717
公投第９案,桃園市,龍潭區,龍潭里,1034,1909,822,206,1028,65,1093
公投第９案,桃園市,龍潭區,龍星里,1035,2024,878,178,1056,33,1089
公投第９案,桃園市,龍潭區,龍星里,1036,2002,832,201,1033,45,1078
公投第９案,桃園市,龍潭區,中正里,1037,1786,773,180,953,54,1007
公投第９案,桃園市,龍潭區,中正里,1038,1756,726,179,905,41,946
公投第９案,桃園市,龍潭區,中正里,1039,1830,808,155,963,34,997
公投第９案,桃園市,龍潭區,上華里,1040,1697,808,158,966,32,998
公投第９案,桃園市,龍潭區,上華里,1041,1519,660,127,787,43,830
公投第９案,桃園市,龍潭區,九龍里,1042,1805,693,150,843,36,879
公投第９案,桃園市,龍潭區,九龍里,1043,1792,646,135,781,31,812
公投第９案,桃園市,龍潭區,武漢里,1044,1500,637,171,808,67,875
公投第９案,桃園市,龍潭區,祥和里,1045,1427,529,136,665,29,694
公投第９案,桃園市,龍潭區,東興里,1046,1444,468,136,604,46,650
公投第９案,桃園市,龍潭區,東興里,1047,1321,496,127,623,48,671
公投第９案,桃園市,龍潭區,東興里,1048,1215,569,128,697,30,727
公投第９案,桃園市,龍潭區,中興里,1049,1297,511,133,644,50,694
公投第９案,桃園市,龍潭區,中興里,1050,1407,526,118,644,18,662
公投第９案,桃園市,龍潭區,中興里,1051,1564,573,151,724,45,769
公投第９案,桃園市,龍潭區,北興里,1052,1317,494,139,633,64,697
公投第９案,桃園市,龍潭區,北興里,1053,1023,374,87,461,47,508
公投第９案,桃園市,龍潭區,佳安里,1054,1721,683,190,873,47,920
公投第９案,桃園市,龍潭區,佳安里,1055,1764,762,147,909,69,978
公投第９案,桃園市,龍潭區,三坑里,1056,1499,580,160,740,65,805
公投第９案,桃園市,龍潭區,大平里,1057,2151,774,180,954,47,1001
公投第９案,桃園市,龍潭區,三林里,1058,1524,667,150,817,31,848
公投第９案,桃園市,龍潭區,三林里,1059,1456,670,165,835,26,861
公投第９案,桃園市,龍潭區,建林里,1060,1847,915,148,1063,39,1102
公投第９案,桃園市,龍潭區,建林里,1061,1899,903,179,1082,43,1125
公投第９案,桃園市,龍潭區,富林里,1062,1725,849,45,894,36,930
公投第９案,桃園市,龍潭區,富林里,1063,1665,784,177,961,51,1012
公投第９案,桃園市,龍潭區,高平里,1064,1649,620,156,776,38,814
公投第９案,桃園市,龍潭區,高平里,1065,1539,565,118,683,51,734
公投第９案,桃園市,龍潭區,高原里,1066,1541,645,181,826,54,880
公投第９案,桃園市,龍潭區,高原里,1067,1375,534,162,696,53,749
公投第９案,桃園市,龍潭區,高原里,1068,1453,604,147,751,31,782
公投第９案,桃園市,龍潭區,三和里,1069,1074,437,130,567,43,610
公投第９案,桃園市,龍潭區,三和里,1070,1299,593,135,728,22,750
公投第９案,桃園市,龍潭區,三水里,1071,678,223,67,290,29,319
公投第９案,桃園市,新屋區,新屋里,1072,1306,586,144,730,25,755
公投第９案,桃園市,新屋區,新屋里,1073,1556,614,206,820,43,863
公投第９案,桃園市,新屋區,新生里,1074,1849,809,235,1044,72,1116
公投第９案,桃園市,新屋區,新生里,1075,2096,897,199,1096,84,1180
公投第９案,桃園市,新屋區,後湖里,1076,1517,578,170,748,48,796
公投第９案,桃園市,新屋區,清華里,1077,2095,879,247,1126,63,1189
公投第９案,桃園市,新屋區,清華里,1078,1856,631,186,817,45,862
公投第９案,桃園市,新屋區,石磊里,1079,1986,801,211,1012,73,1085
公投第９案,桃園市,新屋區,東明里,1080,1425,495,129,624,49,673
公投第９案,桃園市,新屋區,社子里,1081,1385,505,136,641,41,682
公投第９案,桃園市,新屋區,埔頂里,1082,1271,541,187,728,54,782
公投第９案,桃園市,新屋區,埔頂里,1083,1271,493,151,644,38,682
公投第９案,桃園市,新屋區,九斗里,1084,1234,481,172,653,49,702
公投第９案,桃園市,新屋區,九斗里,1085,1085,417,138,555,50,605
公投第９案,桃園市,新屋區,頭洲里,1086,1992,847,177,1024,48,1072
公投第９案,桃園市,新屋區,頭洲里,1087,2032,865,243,1108,81,1189
公投第９案,桃園市,新屋區,大坡里,1088,1291,503,144,647,55,702
公投第９案,桃園市,新屋區,望間里,1089,1401,594,154,748,41,789
公投第９案,桃園市,新屋區,後庄里,1090,1106,470,130,600,47,647
公投第９案,桃園市,新屋區,蚵間里,1091,908,318,115,433,25,458
公投第９案,桃園市,新屋區,深圳里,1092,663,280,86,366,42,408
公投第９案,桃園市,新屋區,槺榔里,1093,1088,402,119,521,57,578
公投第９案,桃園市,新屋區,笨港里,1094,1050,467,144,611,56,667
公投第９案,桃園市,新屋區,永安里,1095,896,380,102,482,25,507
公投第９案,桃園市,新屋區,永安里,1096,1369,577,152,729,88,817
公投第９案,桃園市,新屋區,永興里,1097,995,339,105,444,39,483
公投第９案,桃園市,新屋區,下埔里,1098,741,297,80,377,27,404
公投第９案,桃園市,新屋區,石牌里,1099,943,380,135,515,67,582
公投第９案,桃園市,新屋區,下田里,1100,1714,642,180,822,79,901
公投第９案,桃園市,新屋區,赤欄里,1101,1340,536,137,673,22,695
公投第９案,桃園市,觀音區,觀音里,1102,1371,454,132,586,39,625
公投第９案,桃園市,觀音區,觀音里,1103,1362,420,110,530,27,557
公投第９案,桃園市,觀音區,白玉里,1104,997,306,157,463,67,530
公投第９案,桃園市,觀音區,廣興里,1105,1407,497,120,617,32,649
公投第９案,桃園市,觀音區,大潭里,1106,1692,671,169,840,31,871
公投第９案,桃園市,觀音區,保生里,1107,1279,503,117,620,27,647
公投第９案,桃園市,觀音區,保生里,1108,791,300,85,385,20,405
公投第９案,桃園市,觀音區,武威里,1109,892,355,110,465,38,503
公投第９案,桃園市,觀音區,三和里,1110,886,403,103,506,26,532
公投第９案,桃園市,觀音區,新興里,1111,712,291,68,359,39,398
公投第９案,桃園市,觀音區,坑尾里,1112,1609,533,170,703,109,812
公投第９案,桃園市,觀音區,金湖里,1113,1274,478,174,652,54,706
公投第９案,桃園市,觀音區,金湖里,1114,1351,442,114,556,20,576
公投第９案,桃園市,觀音區,藍埔里,1115,1262,534,134,668,60,728
公投第９案,桃園市,觀音區,藍埔里,1116,1242,515,125,640,66,706
公投第９案,桃園市,觀音區,大同里,1117,1461,545,163,708,69,777
公投第９案,桃園市,觀音區,大同里,1118,1613,597,180,777,43,820
公投第９案,桃園市,觀音區,大堀里,1119,1479,575,163,738,53,791
公投第９案,桃園市,觀音區,崙坪里,1120,1552,516,171,687,57,744
公投第９案,桃園市,觀音區,崙坪里,1121,1517,444,273,717,35,752
公投第９案,桃園市,觀音區,崙坪里,1122,1691,604,169,773,62,835
公投第９案,桃園市,觀音區,富源里,1123,1157,486,124,610,21,631
公投第９案,桃園市,觀音區,富源里,1124,1455,644,48,692,49,741
公投第９案,桃園市,觀音區,富源里,1125,1150,482,99,581,26,607
公投第９案,桃園市,觀音區,上大里,1126,1112,435,139,574,50,624
公投第９案,桃園市,觀音區,上大里,1127,1251,469,118,587,20,607
公投第９案,桃園市,觀音區,新坡里,1128,1446,528,159,687,91,778
公投第９案,桃園市,觀音區,新坡里,1129,1493,508,179,687,101,788
公投第９案,桃園市,觀音區,廣福里,1130,1339,502,134,636,66,702
公投第９案,桃園市,觀音區,廣福里,1131,1137,489,124,613,43,656
公投第９案,桃園市,觀音區,塔腳里,1132,1043,379,107,486,40,526
公投第９案,桃園市,觀音區,保障里,1133,993,323,110,433,27,460
公投第９案,桃園市,觀音區,保障里,1134,975,339,120,459,26,485
公投第９案,桃園市,觀音區,草漯里,1135,2029,628,181,809,53,862
公投第９案,桃園市,觀音區,草新里,1136,1765,701,201,902,42,944
公投第９案,桃園市,觀音區,草新里,1137,1809,692,179,871,49,920
公投第９案,桃園市,觀音區,草新里,1138,1869,667,189,856,42,898
公投第９案,桃園市,觀音區,樹林里,1139,1870,603,153,756,56,812
公投第９案,桃園市,觀音區,樹林里,1140,1932,493,155,648,40,688
公投第９案,桃園市,觀音區,富林里,1141,899,257,95,352,13,365
公投第９案,桃園市,觀音區,富林里,1142,985,317,77,394,15,409
